county,office,candidate,party,precinct,mail_votes,early_votes,elec_day_votes,total_votes,district
Adair,Governor,Chris Powell,LIB,10001,0,2,14,16,
Adair,Governor,Kevin Stitt,REP,10001,7,10,148,165,
Adair,Governor,Drew Edmondson,DEM,10001,0,7,92,99,
Adair,Lieutenant Governor,Matt Pinnell,REP,10001,7,11,162,180,
Adair,Lieutenant Governor,Anastasia Pittman,DEM,10001,0,7,73,80,
Adair,Lieutenant Governor,Ivan Holmes,IND,10001,0,1,13,14,
Adair,State Auditor,John Yeutter,LIB,10001,1,5,48,54,
Adair,State Auditor,Cindy Byrd,REP,10001,7,12,186,205,
Adair,Attorney General,Mike Hunter,REP,10001,8,11,173,192,
Adair,Attorney General,Mark Myles,DEM,10001,0,8,75,83,
Adair,State Treasurer,Randy Mcdaniel,REP,10001,8,14,191,213,
Adair,State Treasurer,Charles De Coune,IND,10001,0,2,45,47,
Adair,Superintendent of Public Instruction,Joy Hofmeister,REP,10001,7,7,117,131,
Adair,Superintendent of Public Instruction,John Cox,DEM,10001,1,8,118,127,
Adair,Superintendent of Public Instruction,Larry Huff,IND,10001,0,3,18,21,
Adair,Commissioner of Labor,Leslie Osborn,REP,10001,8,8,158,174,
Adair,Commissioner of Labor,Fred Dorrell,DEM,10001,0,9,74,83,
Adair,Commissioner of Labor,Brandt Dismukes,IND,10001,0,1,15,16,
Adair,Insurance Commissioner,Glen Mulready,REP,10001,7,11,164,182,
Adair,Insurance Commissioner,Kimberly Fobbs,DEM,10001,0,7,81,88,
Adair,Corporation Commissioner,Bob Anthony,REP,10001,6,9,151,166,
Adair,Corporation Commissioner,Ashley Nicole Mccray,DEM,10001,1,7,80,88,
Adair,Corporation Commissioner,Jackie Short,IND,10001,0,1,15,16,
Adair,U.S. House,Richard Castaldo,LIB,10001,0,1,10,11,2
Adair,U.S. House,Markwayne Mullin,REP,10001,7,7,160,174,2
Adair,U.S. House,Jason Nichols,DEM,10001,0,8,75,83,2
Adair,U.S. House,John Foreman,IND,10001,0,2,9,11,2
Adair,State House,David Hardin,REP,10001,8,11,157,176,86
Adair,State House,Rhonda Cox,DEM,10001,0,7,99,106,86
Adair,Governor,Chris Powell,LIB,10002,0,0,5,5,
Adair,Governor,Kevin Stitt,REP,10002,5,12,147,164,
Adair,Governor,Drew Edmondson,DEM,10002,0,2,71,73,
Adair,Lieutenant Governor,Matt Pinnell,REP,10002,5,12,152,169,
Adair,Lieutenant Governor,Anastasia Pittman,DEM,10002,0,2,56,58,
Adair,Lieutenant Governor,Ivan Holmes,IND,10002,0,0,14,14,
Adair,State Auditor,John Yeutter,LIB,10002,0,2,47,49,
Adair,State Auditor,Cindy Byrd,REP,10002,5,12,163,180,
Adair,Attorney General,Mike Hunter,REP,10002,4,13,160,177,
Adair,Attorney General,Mark Myles,DEM,10002,1,1,59,61,
Adair,State Treasurer,Randy Mcdaniel,REP,10002,3,12,165,180,
Adair,State Treasurer,Charles De Coune,IND,10002,1,2,42,45,
Adair,Superintendent of Public Instruction,Joy Hofmeister,REP,10002,3,10,135,148,
Adair,Superintendent of Public Instruction,John Cox,DEM,10002,1,4,70,75,
Adair,Superintendent of Public Instruction,Larry Huff,IND,10002,1,0,18,19,
Adair,Commissioner of Labor,Leslie Osborn,REP,10002,4,12,149,165,
Adair,Commissioner of Labor,Fred Dorrell,DEM,10002,1,2,61,64,
Adair,Commissioner of Labor,Brandt Dismukes,IND,10002,0,0,8,8,
Adair,Insurance Commissioner,Glen Mulready,REP,10002,4,12,151,167,
Adair,Insurance Commissioner,Kimberly Fobbs,DEM,10002,1,2,66,69,
Adair,Corporation Commissioner,Bob Anthony,REP,10002,4,12,142,158,
Adair,Corporation Commissioner,Ashley Nicole Mccray,DEM,10002,0,2,66,68,
Adair,Corporation Commissioner,Jackie Short,IND,10002,1,0,11,12,
Adair,U.S. House,Richard Castaldo,LIB,10002,1,0,5,6,2
Adair,U.S. House,Markwayne Mullin,REP,10002,4,13,143,160,2
Adair,U.S. House,Jason Nichols,DEM,10002,0,1,61,62,2
Adair,U.S. House,John Foreman,IND,10002,0,0,14,14,2
Adair,State House,David Hardin,REP,10002,5,12,153,170,86
Adair,State House,Rhonda Cox,DEM,10002,0,2,70,72,86
Adair,Governor,Chris Powell,LIB,10003,0,0,8,8,
Adair,Governor,Kevin Stitt,REP,10003,5,0,78,83,
Adair,Governor,Drew Edmondson,DEM,10003,3,0,34,37,
Adair,Lieutenant Governor,Matt Pinnell,REP,10003,7,0,82,89,
Adair,Lieutenant Governor,Anastasia Pittman,DEM,10003,1,0,29,30,
Adair,Lieutenant Governor,Ivan Holmes,IND,10003,0,0,9,9,
Adair,State Auditor,John Yeutter,LIB,10003,1,0,36,37,
Adair,State Auditor,Cindy Byrd,REP,10003,7,0,79,86,
Adair,Attorney General,Mike Hunter,REP,10003,7,0,83,90,
Adair,Attorney General,Mark Myles,DEM,10003,1,0,36,37,
Adair,State Treasurer,Randy Mcdaniel,REP,10003,7,0,85,92,
Adair,State Treasurer,Charles De Coune,IND,10003,1,0,29,30,
Adair,Superintendent of Public Instruction,Joy Hofmeister,REP,10003,7,0,66,73,
Adair,Superintendent of Public Instruction,John Cox,DEM,10003,1,0,35,36,
Adair,Superintendent of Public Instruction,Larry Huff,IND,10003,0,0,18,18,
Adair,Commissioner of Labor,Leslie Osborn,REP,10003,7,0,74,81,
Adair,Commissioner of Labor,Fred Dorrell,DEM,10003,1,0,36,37,
Adair,Commissioner of Labor,Brandt Dismukes,IND,10003,0,0,9,9,
Adair,Insurance Commissioner,Glen Mulready,REP,10003,7,0,81,88,
Adair,Insurance Commissioner,Kimberly Fobbs,DEM,10003,1,0,39,40,
Adair,Corporation Commissioner,Bob Anthony,REP,10003,6,0,72,78,
Adair,Corporation Commissioner,Ashley Nicole Mccray,DEM,10003,2,0,35,37,
Adair,Corporation Commissioner,Jackie Short,IND,10003,0,0,13,13,
Adair,U.S. House,Richard Castaldo,LIB,10003,0,0,4,4,2
Adair,U.S. House,Markwayne Mullin,REP,10003,6,0,81,87,2
Adair,U.S. House,Jason Nichols,DEM,10003,2,0,29,31,2
Adair,U.S. House,John Foreman,IND,10003,0,0,7,7,2
Adair,State House,David Hardin,REP,10003,7,0,74,81,86
Adair,State House,Rhonda Cox,DEM,10003,1,0,45,46,86
Adair,Governor,Chris Powell,LIB,10004,0,2,11,13,
Adair,Governor,Kevin Stitt,REP,10004,8,18,113,139,
Adair,Governor,Drew Edmondson,DEM,10004,3,8,62,73,
Adair,Lieutenant Governor,Matt Pinnell,REP,10004,8,15,121,144,
Adair,Lieutenant Governor,Anastasia Pittman,DEM,10004,4,11,52,67,
Adair,Lieutenant Governor,Ivan Holmes,IND,10004,0,1,12,13,
Adair,State Auditor,John Yeutter,LIB,10004,3,7,48,58,
Adair,State Auditor,Cindy Byrd,REP,10004,8,20,123,151,
Adair,Attorney General,Mike Hunter,REP,10004,8,19,125,152,
Adair,Attorney General,Mark Myles,DEM,10004,4,7,57,68,
Adair,State Treasurer,Randy Mcdaniel,REP,10004,9,19,132,160,
Adair,State Treasurer,Charles De Coune,IND,10004,1,8,34,43,
Adair,Superintendent of Public Instruction,Joy Hofmeister,REP,10004,7,17,88,112,
Adair,Superintendent of Public Instruction,John Cox,DEM,10004,4,7,83,94,
Adair,Superintendent of Public Instruction,Larry Huff,IND,10004,1,3,14,18,
Adair,Commissioner of Labor,Leslie Osborn,REP,10004,8,15,113,136,
Adair,Commissioner of Labor,Fred Dorrell,DEM,10004,4,10,60,74,
Adair,Commissioner of Labor,Brandt Dismukes,IND,10004,0,2,8,10,
Adair,Insurance Commissioner,Glen Mulready,REP,10004,8,18,117,143,
Adair,Insurance Commissioner,Kimberly Fobbs,DEM,10004,4,9,64,77,
Adair,Corporation Commissioner,Bob Anthony,REP,10004,8,16,114,138,
Adair,Corporation Commissioner,Ashley Nicole Mccray,DEM,10004,3,10,59,72,
Adair,Corporation Commissioner,Jackie Short,IND,10004,1,1,8,10,
Adair,U.S. House,Richard Castaldo,LIB,10004,1,2,3,6,2
Adair,U.S. House,Markwayne Mullin,REP,10004,9,11,113,133,2
Adair,U.S. House,Jason Nichols,DEM,10004,2,12,62,76,2
Adair,U.S. House,John Foreman,IND,10004,0,3,8,11,2
Adair,State House,David Hardin,REP,10004,7,14,112,133,86
Adair,State House,Rhonda Cox,DEM,10004,5,13,75,93,86
Adair,Governor,Chris Powell,LIB,10005,0,0,10,10,
Adair,Governor,Kevin Stitt,REP,10005,7,9,113,129,
Adair,Governor,Drew Edmondson,DEM,10005,0,7,50,57,
Adair,Lieutenant Governor,Matt Pinnell,REP,10005,7,9,125,141,
Adair,Lieutenant Governor,Anastasia Pittman,DEM,10005,0,6,39,45,
Adair,Lieutenant Governor,Ivan Holmes,IND,10005,0,1,8,9,
Adair,State Auditor,John Yeutter,LIB,10005,0,4,32,36,
Adair,State Auditor,Cindy Byrd,REP,10005,7,10,132,149,
Adair,Attorney General,Mike Hunter,REP,10005,7,10,125,142,
Adair,Attorney General,Mark Myles,DEM,10005,0,6,45,51,
Adair,State Treasurer,Randy Mcdaniel,REP,10005,7,10,138,155,
Adair,State Treasurer,Charles De Coune,IND,10005,0,4,24,28,
Adair,Superintendent of Public Instruction,Joy Hofmeister,REP,10005,4,7,92,103,
Adair,Superintendent of Public Instruction,John Cox,DEM,10005,3,6,70,79,
Adair,Superintendent of Public Instruction,Larry Huff,IND,10005,0,3,10,13,
Adair,Commissioner of Labor,Leslie Osborn,REP,10005,6,8,113,127,
Adair,Commissioner of Labor,Fred Dorrell,DEM,10005,1,5,43,49,
Adair,Commissioner of Labor,Brandt Dismukes,IND,10005,0,2,12,14,
Adair,Insurance Commissioner,Glen Mulready,REP,10005,7,8,114,129,
Adair,Insurance Commissioner,Kimberly Fobbs,DEM,10005,0,7,54,61,
Adair,Corporation Commissioner,Bob Anthony,REP,10005,7,10,116,133,
Adair,Corporation Commissioner,Ashley Nicole Mccray,DEM,10005,0,5,48,53,
Adair,Corporation Commissioner,Jackie Short,IND,10005,0,1,6,7,
Adair,U.S. House,Richard Castaldo,LIB,10005,0,0,4,4,2
Adair,U.S. House,Markwayne Mullin,REP,10005,7,9,123,139,2
Adair,U.S. House,Jason Nichols,DEM,10005,0,7,41,48,2
Adair,U.S. House,John Foreman,IND,10005,0,0,7,7,2
Adair,State House,David Hardin,REP,10005,5,11,110,126,86
Adair,State House,Rhonda Cox,DEM,10005,2,5,62,69,86
Adair,Governor,Chris Powell,LIB,10006,1,1,17,19,
Adair,Governor,Kevin Stitt,REP,10006,3,8,225,236,
Adair,Governor,Drew Edmondson,DEM,10006,3,23,130,156,
Adair,Lieutenant Governor,Matt Pinnell,REP,10006,4,8,248,260,
Adair,Lieutenant Governor,Anastasia Pittman,DEM,10006,3,23,106,132,
Adair,Lieutenant Governor,Ivan Holmes,IND,10006,0,1,12,13,
Adair,State Auditor,John Yeutter,LIB,10006,1,16,104,121,
Adair,State Auditor,Cindy Byrd,REP,10006,6,13,251,270,
Adair,Attorney General,Mike Hunter,REP,10006,4,12,280,296,
Adair,Attorney General,Mark Myles,DEM,10006,3,19,87,109,
Adair,State Treasurer,Randy Mcdaniel,REP,10006,4,14,278,296,
Adair,State Treasurer,Charles De Coune,IND,10006,3,16,72,91,
Adair,Superintendent of Public Instruction,Joy Hofmeister,REP,10006,5,7,195,207,
Adair,Superintendent of Public Instruction,John Cox,DEM,10006,2,24,157,183,
Adair,Superintendent of Public Instruction,Larry Huff,IND,10006,0,1,18,19,
Adair,Commissioner of Labor,Leslie Osborn,REP,10006,2,6,238,246,
Adair,Commissioner of Labor,Fred Dorrell,DEM,10006,4,26,113,143,
Adair,Commissioner of Labor,Brandt Dismukes,IND,10006,1,0,14,15,
Adair,Insurance Commissioner,Glen Mulready,REP,10006,3,6,242,251,
Adair,Insurance Commissioner,Kimberly Fobbs,DEM,10006,4,25,122,151,
Adair,Corporation Commissioner,Bob Anthony,REP,10006,3,7,240,250,
Adair,Corporation Commissioner,Ashley Nicole Mccray,DEM,10006,4,25,106,135,
Adair,Corporation Commissioner,Jackie Short,IND,10006,0,0,16,16,
Adair,U.S. House,Richard Castaldo,LIB,10006,0,0,9,9,2
Adair,U.S. House,Markwayne Mullin,REP,10006,3,5,237,245,2
Adair,U.S. House,Jason Nichols,DEM,10006,3,27,115,145,2
Adair,U.S. House,John Foreman,IND,10006,1,0,8,9,2
Adair,State House,David Hardin,REP,10006,2,8,245,255,86
Adair,State House,Rhonda Cox,DEM,10006,4,24,124,152,86
Adair,Governor,Chris Powell,LIB,10007,0,2,20,22,
Adair,Governor,Kevin Stitt,REP,10007,1,14,210,225,
Adair,Governor,Drew Edmondson,DEM,10007,9,13,166,188,
Adair,Lieutenant Governor,Matt Pinnell,REP,10007,2,17,230,249,
Adair,Lieutenant Governor,Anastasia Pittman,DEM,10007,8,10,143,161,
Adair,Lieutenant Governor,Ivan Holmes,IND,10007,0,1,22,23,
Adair,State Auditor,John Yeutter,LIB,10007,7,5,98,110,
Adair,State Auditor,Cindy Byrd,REP,10007,2,19,271,292,
Adair,Attorney General,Mike Hunter,REP,10007,3,16,247,266,
Adair,Attorney General,Mark Myles,DEM,10007,7,12,144,163,
Adair,State Treasurer,Randy Mcdaniel,REP,10007,3,19,267,289,
Adair,State Treasurer,Charles De Coune,IND,10007,5,5,97,107,
Adair,Superintendent of Public Instruction,Joy Hofmeister,REP,10007,4,10,165,179,
Adair,Superintendent of Public Instruction,John Cox,DEM,10007,6,17,193,216,
Adair,Superintendent of Public Instruction,Larry Huff,IND,10007,0,2,36,38,
Adair,Commissioner of Labor,Leslie Osborn,REP,10007,3,15,215,233,
Adair,Commissioner of Labor,Fred Dorrell,DEM,10007,7,13,159,179,
Adair,Commissioner of Labor,Brandt Dismukes,IND,10007,0,0,14,14,
Adair,Insurance Commissioner,Glen Mulready,REP,10007,2,17,219,238,
Adair,Insurance Commissioner,Kimberly Fobbs,DEM,10007,8,11,171,190,
Adair,Corporation Commissioner,Bob Anthony,REP,10007,4,17,216,237,
Adair,Corporation Commissioner,Ashley Nicole Mccray,DEM,10007,6,11,153,170,
Adair,Corporation Commissioner,Jackie Short,IND,10007,0,0,20,20,
Adair,U.S. House,Richard Castaldo,LIB,10007,0,0,12,12,2
Adair,U.S. House,Markwayne Mullin,REP,10007,1,16,219,236,2
Adair,U.S. House,Jason Nichols,DEM,10007,9,14,151,174,2
Adair,U.S. House,John Foreman,IND,10007,0,0,13,13,2
Adair,State House,David Hardin,REP,10007,4,14,224,242,86
Adair,State House,Rhonda Cox,DEM,10007,6,16,171,193,86
Adair,Governor,Chris Powell,LIB,10008,0,0,12,12,
Adair,Governor,Kevin Stitt,REP,10008,2,12,183,197,
Adair,Governor,Drew Edmondson,DEM,10008,2,11,88,101,
Adair,Lieutenant Governor,Matt Pinnell,REP,10008,2,13,205,220,
Adair,Lieutenant Governor,Anastasia Pittman,DEM,10008,2,10,67,79,
Adair,Lieutenant Governor,Ivan Holmes,IND,10008,0,0,9,9,
Adair,State Auditor,John Yeutter,LIB,10008,0,7,41,48,
Adair,State Auditor,Cindy Byrd,REP,10008,4,13,224,241,
Adair,Attorney General,Mike Hunter,REP,10008,2,10,222,234,
Adair,Attorney General,Mark Myles,DEM,10008,2,13,62,77,
Adair,State Treasurer,Randy Mcdaniel,REP,10008,4,12,231,247,
Adair,State Treasurer,Charles De Coune,IND,10008,0,7,37,44,
Adair,Superintendent of Public Instruction,Joy Hofmeister,REP,10008,2,11,152,165,
Adair,Superintendent of Public Instruction,John Cox,DEM,10008,2,10,112,124,
Adair,Superintendent of Public Instruction,Larry Huff,IND,10008,0,2,18,20,
Adair,Commissioner of Labor,Leslie Osborn,REP,10008,2,12,197,211,
Adair,Commissioner of Labor,Fred Dorrell,DEM,10008,2,9,74,85,
Adair,Commissioner of Labor,Brandt Dismukes,IND,10008,0,2,10,12,
Adair,Insurance Commissioner,Glen Mulready,REP,10008,2,9,202,213,
Adair,Insurance Commissioner,Kimberly Fobbs,DEM,10008,2,12,79,93,
Adair,Corporation Commissioner,Bob Anthony,REP,10008,2,9,194,205,
Adair,Corporation Commissioner,Ashley Nicole Mccray,DEM,10008,1,11,75,87,
Adair,Corporation Commissioner,Jackie Short,IND,10008,0,2,14,16,
Adair,U.S. House,Richard Castaldo,LIB,10008,0,0,1,1,2
Adair,U.S. House,Markwayne Mullin,REP,10008,3,11,192,206,2
Adair,U.S. House,Jason Nichols,DEM,10008,1,11,81,93,2
Adair,U.S. House,John Foreman,IND,10008,0,0,11,11,2
Adair,State House,David Hardin,REP,10008,3,11,198,212,86
Adair,State House,Rhonda Cox,DEM,10008,1,11,84,96,86
Adair,Governor,Chris Powell,LIB,10010,0,1,6,7,
Adair,Governor,Kevin Stitt,REP,10010,1,1,52,54,
Adair,Governor,Drew Edmondson,DEM,10010,0,5,32,37,
Adair,Lieutenant Governor,Matt Pinnell,REP,10010,1,3,57,61,
Adair,Lieutenant Governor,Anastasia Pittman,DEM,10010,0,3,31,34,
Adair,Lieutenant Governor,Ivan Holmes,IND,10010,0,1,3,4,
Adair,State Auditor,John Yeutter,LIB,10010,1,3,25,29,
Adair,State Auditor,Cindy Byrd,REP,10010,0,3,60,63,
Adair,Attorney General,Mike Hunter,REP,10010,1,3,59,63,
Adair,Attorney General,Mark Myles,DEM,10010,0,4,33,37,
Adair,State Treasurer,Randy Mcdaniel,REP,10010,0,3,64,67,
Adair,State Treasurer,Charles De Coune,IND,10010,1,2,23,26,
Adair,Superintendent of Public Instruction,Joy Hofmeister,REP,10010,1,0,39,40,
Adair,Superintendent of Public Instruction,John Cox,DEM,10010,0,6,46,52,
Adair,Superintendent of Public Instruction,Larry Huff,IND,10010,0,1,7,8,
Adair,Commissioner of Labor,Leslie Osborn,REP,10010,1,2,51,54,
Adair,Commissioner of Labor,Fred Dorrell,DEM,10010,0,3,37,40,
Adair,Commissioner of Labor,Brandt Dismukes,IND,10010,0,1,3,4,
Adair,Insurance Commissioner,Glen Mulready,REP,10010,1,3,51,55,
Adair,Insurance Commissioner,Kimberly Fobbs,DEM,10010,0,4,39,43,
Adair,Corporation Commissioner,Bob Anthony,REP,10010,1,3,47,51,
Adair,Corporation Commissioner,Ashley Nicole Mccray,DEM,10010,0,3,37,40,
Adair,Corporation Commissioner,Jackie Short,IND,10010,0,0,7,7,
Adair,U.S. House,Richard Castaldo,LIB,10010,0,0,3,3,2
Adair,U.S. House,Markwayne Mullin,REP,10010,1,2,58,61,2
Adair,U.S. House,Jason Nichols,DEM,10010,0,4,29,33,2
Adair,U.S. House,John Foreman,IND,10010,0,1,2,3,2
Adair,State House,David Hardin,REP,10010,1,4,48,53,86
Adair,State House,Rhonda Cox,DEM,10010,0,3,44,47,86
Adair,Governor,Chris Powell,LIB,10011,1,1,9,11,
Adair,Governor,Kevin Stitt,REP,10011,6,3,76,85,
Adair,Governor,Drew Edmondson,DEM,10011,0,2,34,36,
Adair,Lieutenant Governor,Matt Pinnell,REP,10011,7,4,86,97,
Adair,Lieutenant Governor,Anastasia Pittman,DEM,10011,0,2,24,26,
Adair,Lieutenant Governor,Ivan Holmes,IND,10011,0,0,6,6,
Adair,State Auditor,John Yeutter,LIB,10011,1,0,19,20,
Adair,State Auditor,Cindy Byrd,REP,10011,6,6,94,106,
Adair,Attorney General,Mike Hunter,REP,10011,7,4,87,98,
Adair,Attorney General,Mark Myles,DEM,10011,0,2,29,31,
Adair,State Treasurer,Randy Mcdaniel,REP,10011,7,3,93,103,
Adair,State Treasurer,Charles De Coune,IND,10011,0,2,22,24,
Adair,Superintendent of Public Instruction,Joy Hofmeister,REP,10011,5,2,59,66,
Adair,Superintendent of Public Instruction,John Cox,DEM,10011,2,4,45,51,
Adair,Superintendent of Public Instruction,Larry Huff,IND,10011,0,0,14,14,
Adair,Commissioner of Labor,Leslie Osborn,REP,10011,5,4,71,80,
Adair,Commissioner of Labor,Fred Dorrell,DEM,10011,2,2,32,36,
Adair,Commissioner of Labor,Brandt Dismukes,IND,10011,0,0,9,9,
Adair,Insurance Commissioner,Glen Mulready,REP,10011,7,4,77,88,
Adair,Insurance Commissioner,Kimberly Fobbs,DEM,10011,0,2,37,39,
Adair,Corporation Commissioner,Bob Anthony,REP,10011,7,5,80,92,
Adair,Corporation Commissioner,Ashley Nicole Mccray,DEM,10011,0,1,28,29,
Adair,Corporation Commissioner,Jackie Short,IND,10011,0,0,6,6,
Adair,U.S. House,Richard Castaldo,LIB,10011,1,0,3,4,2
Adair,U.S. House,Markwayne Mullin,REP,10011,6,4,75,85,2
Adair,U.S. House,Jason Nichols,DEM,10011,0,2,32,34,2
Adair,U.S. House,John Foreman,IND,10011,0,0,9,9,2
Adair,State House,David Hardin,REP,10011,7,4,78,89,86
Adair,State House,Rhonda Cox,DEM,10011,0,2,42,44,86
Adair,Governor,Chris Powell,LIB,10012,1,2,8,11,
Adair,Governor,Kevin Stitt,REP,10012,2,17,193,212,
Adair,Governor,Drew Edmondson,DEM,10012,4,5,84,93,
Adair,Lieutenant Governor,Matt Pinnell,REP,10012,3,19,207,229,
Adair,Lieutenant Governor,Anastasia Pittman,DEM,10012,2,5,69,76,
Adair,Lieutenant Governor,Ivan Holmes,IND,10012,2,0,7,9,
Adair,State Auditor,John Yeutter,LIB,10012,1,7,56,64,
Adair,State Auditor,Cindy Byrd,REP,10012,6,17,201,224,
Adair,Attorney General,Mike Hunter,REP,10012,4,18,214,236,
Adair,Attorney General,Mark Myles,DEM,10012,3,6,69,78,
Adair,State Treasurer,Randy Mcdaniel,REP,10012,6,19,215,240,
Adair,State Treasurer,Charles De Coune,IND,10012,1,5,47,53,
Adair,Superintendent of Public Instruction,Joy Hofmeister,REP,10012,3,14,148,165,
Adair,Superintendent of Public Instruction,John Cox,DEM,10012,4,9,113,126,
Adair,Superintendent of Public Instruction,Larry Huff,IND,10012,0,1,23,24,
Adair,Commissioner of Labor,Leslie Osborn,REP,10012,4,18,190,212,
Adair,Commissioner of Labor,Fred Dorrell,DEM,10012,3,5,79,87,
Adair,Commissioner of Labor,Brandt Dismukes,IND,10012,0,1,12,13,
Adair,Insurance Commissioner,Glen Mulready,REP,10012,2,19,203,224,
Adair,Insurance Commissioner,Kimberly Fobbs,DEM,10012,5,5,80,90,
Adair,Corporation Commissioner,Bob Anthony,REP,10012,3,19,190,212,
Adair,Corporation Commissioner,Ashley Nicole Mccray,DEM,10012,3,4,76,83,
Adair,Corporation Commissioner,Jackie Short,IND,10012,1,1,16,18,
Adair,U.S. House,Richard Castaldo,LIB,10012,0,2,6,8,2
Adair,U.S. House,Markwayne Mullin,REP,10012,4,18,194,216,2
Adair,U.S. House,Jason Nichols,DEM,10012,3,4,79,86,2
Adair,U.S. House,John Foreman,IND,10012,0,0,5,5,2
Adair,State House,David Hardin,REP,10012,3,16,191,210,86
Adair,State House,Rhonda Cox,DEM,10012,4,8,92,104,86
Adair,Governor,Chris Powell,LIB,10013,0,0,13,13,
Adair,Governor,Kevin Stitt,REP,10013,2,7,128,137,
Adair,Governor,Drew Edmondson,DEM,10013,9,8,84,101,
Adair,Lieutenant Governor,Matt Pinnell,REP,10013,2,9,142,153,
Adair,Lieutenant Governor,Anastasia Pittman,DEM,10013,9,6,75,90,
Adair,Lieutenant Governor,Ivan Holmes,IND,10013,0,0,7,7,
Adair,State Auditor,John Yeutter,LIB,10013,0,4,40,44,
Adair,State Auditor,Cindy Byrd,REP,10013,4,9,163,176,
Adair,Attorney General,Mike Hunter,REP,10013,4,10,153,167,
Adair,Attorney General,Mark Myles,DEM,10013,7,5,71,83,
Adair,State Treasurer,Randy Mcdaniel,REP,10013,4,11,164,179,
Adair,State Treasurer,Charles De Coune,IND,10013,0,2,39,41,
Adair,Superintendent of Public Instruction,Joy Hofmeister,REP,10013,3,3,112,118,
Adair,Superintendent of Public Instruction,John Cox,DEM,10013,8,10,101,119,
Adair,Superintendent of Public Instruction,Larry Huff,IND,10013,0,2,10,12,
Adair,Commissioner of Labor,Leslie Osborn,REP,10013,4,10,135,149,
Adair,Commissioner of Labor,Fred Dorrell,DEM,10013,7,5,80,92,
Adair,Commissioner of Labor,Brandt Dismukes,IND,10013,0,0,7,7,
Adair,Insurance Commissioner,Glen Mulready,REP,10013,2,7,138,147,
Adair,Insurance Commissioner,Kimberly Fobbs,DEM,10013,9,8,87,104,
Adair,Corporation Commissioner,Bob Anthony,REP,10013,2,10,130,142,
Adair,Corporation Commissioner,Ashley Nicole Mccray,DEM,10013,9,5,86,100,
Adair,Corporation Commissioner,Jackie Short,IND,10013,0,0,7,7,
Adair,U.S. House,Richard Castaldo,LIB,10013,0,0,3,3,2
Adair,U.S. House,Markwayne Mullin,REP,10013,3,11,141,155,2
Adair,U.S. House,Jason Nichols,DEM,10013,7,4,77,88,2
Adair,U.S. House,John Foreman,IND,10013,0,0,5,5,2
Adair,State House,David Hardin,REP,10013,4,7,139,150,86
Adair,State House,Rhonda Cox,DEM,10013,7,8,87,102,86
Adair,Governor,Chris Powell,LIB,10014,0,4,15,19,
Adair,Governor,Kevin Stitt,REP,10014,2,18,161,181,
Adair,Governor,Drew Edmondson,DEM,10014,6,24,162,192,
Adair,Lieutenant Governor,Matt Pinnell,REP,10014,3,21,203,227,
Adair,Lieutenant Governor,Anastasia Pittman,DEM,10014,5,20,119,144,
Adair,Lieutenant Governor,Ivan Holmes,IND,10014,0,5,16,21,
Adair,State Auditor,John Yeutter,LIB,10014,2,13,97,112,
Adair,State Auditor,Cindy Byrd,REP,10014,4,30,219,253,
Adair,Attorney General,Mike Hunter,REP,10014,3,25,209,237,
Adair,Attorney General,Mark Myles,DEM,10014,5,20,124,149,
Adair,State Treasurer,Randy Mcdaniel,REP,10014,4,31,235,270,
Adair,State Treasurer,Charles De Coune,IND,10014,2,12,81,95,
Adair,Superintendent of Public Instruction,Joy Hofmeister,REP,10014,1,13,136,150,
Adair,Superintendent of Public Instruction,John Cox,DEM,10014,7,29,179,215,
Adair,Superintendent of Public Instruction,Larry Huff,IND,10014,0,4,20,24,
Adair,Commissioner of Labor,Leslie Osborn,REP,10014,2,19,184,205,
Adair,Commissioner of Labor,Fred Dorrell,DEM,10014,5,24,136,165,
Adair,Commissioner of Labor,Brandt Dismukes,IND,10014,1,3,13,17,
Adair,Insurance Commissioner,Glen Mulready,REP,10014,2,20,198,220,
Adair,Insurance Commissioner,Kimberly Fobbs,DEM,10014,6,24,138,168,
Adair,Corporation Commissioner,Bob Anthony,REP,10014,2,23,194,219,
Adair,Corporation Commissioner,Ashley Nicole Mccray,DEM,10014,5,19,120,144,
Adair,Corporation Commissioner,Jackie Short,IND,10014,0,4,22,26,
Adair,U.S. House,Richard Castaldo,LIB,10014,0,1,9,10,2
Adair,U.S. House,Markwayne Mullin,REP,10014,3,21,198,222,2
Adair,U.S. House,Jason Nichols,DEM,10014,5,22,123,150,2
Adair,U.S. House,John Foreman,IND,10014,0,2,7,9,2
Adair,State House,David Hardin,REP,10014,3,19,184,206,86
Adair,State House,Rhonda Cox,DEM,10014,5,27,153,185,86
Adair,Governor,Chris Powell,LIB,10016,0,3,13,16,
Adair,Governor,Kevin Stitt,REP,10016,6,7,201,214,
Adair,Governor,Drew Edmondson,DEM,10016,2,7,68,77,
Adair,Lieutenant Governor,Matt Pinnell,REP,10016,6,12,221,239,
Adair,Lieutenant Governor,Anastasia Pittman,DEM,10016,2,5,47,54,
Adair,Lieutenant Governor,Ivan Holmes,IND,10016,0,0,9,9,
Adair,State Auditor,John Yeutter,LIB,10016,1,7,42,50,
Adair,State Auditor,Cindy Byrd,REP,10016,6,9,222,237,
Adair,Attorney General,Mike Hunter,REP,10016,6,12,229,247,
Adair,Attorney General,Mark Myles,DEM,10016,2,5,47,54,
Adair,State Treasurer,Randy Mcdaniel,REP,10016,6,12,222,240,
Adair,State Treasurer,Charles De Coune,IND,10016,1,4,43,48,
Adair,Superintendent of Public Instruction,Joy Hofmeister,REP,10016,6,11,189,206,
Adair,Superintendent of Public Instruction,John Cox,DEM,10016,2,5,75,82,
Adair,Superintendent of Public Instruction,Larry Huff,IND,10016,0,1,17,18,
Adair,Commissioner of Labor,Leslie Osborn,REP,10016,6,11,214,231,
Adair,Commissioner of Labor,Fred Dorrell,DEM,10016,2,4,54,60,
Adair,Commissioner of Labor,Brandt Dismukes,IND,10016,0,2,8,10,
Adair,Insurance Commissioner,Glen Mulready,REP,10016,6,12,217,235,
Adair,Insurance Commissioner,Kimberly Fobbs,DEM,10016,2,5,60,67,
Adair,Corporation Commissioner,Bob Anthony,REP,10016,6,11,207,224,
Adair,Corporation Commissioner,Ashley Nicole Mccray,DEM,10016,2,5,57,64,
Adair,Corporation Commissioner,Jackie Short,IND,10016,0,1,11,12,
Adair,U.S. House,Richard Castaldo,LIB,10016,0,3,6,9,2
Adair,U.S. House,Markwayne Mullin,REP,10016,6,9,211,226,2
Adair,U.S. House,Jason Nichols,DEM,10016,2,5,55,62,2
Adair,U.S. House,John Foreman,IND,10016,0,0,9,9,2
Adair,State House,David Hardin,REP,10016,6,11,207,224,86
Adair,State House,Rhonda Cox,DEM,10016,2,6,70,78,86
Adair,Governor,Chris Powell,LIB,10017,0,0,20,20,
Adair,Governor,Kevin Stitt,REP,10017,1,14,309,324,
Adair,Governor,Drew Edmondson,DEM,10017,3,5,103,111,
Adair,Lieutenant Governor,Matt Pinnell,REP,10017,2,14,315,331,
Adair,Lieutenant Governor,Anastasia Pittman,DEM,10017,2,5,100,107,
Adair,Lieutenant Governor,Ivan Holmes,IND,10017,0,0,16,16,
Adair,State Auditor,John Yeutter,LIB,10017,1,1,82,84,
Adair,State Auditor,Cindy Byrd,REP,10017,2,15,331,348,
Adair,Attorney General,Mike Hunter,REP,10017,2,14,322,338,
Adair,Attorney General,Mark Myles,DEM,10017,2,5,109,116,
Adair,State Treasurer,Randy Mcdaniel,REP,10017,1,15,317,333,
Adair,State Treasurer,Charles De Coune,IND,10017,2,2,90,94,
Adair,Superintendent of Public Instruction,Joy Hofmeister,REP,10017,1,11,257,269,
Adair,Superintendent of Public Instruction,John Cox,DEM,10017,3,7,125,135,
Adair,Superintendent of Public Instruction,Larry Huff,IND,10017,0,1,48,49,
Adair,Commissioner of Labor,Leslie Osborn,REP,10017,2,14,284,300,
Adair,Commissioner of Labor,Fred Dorrell,DEM,10017,2,5,114,121,
Adair,Commissioner of Labor,Brandt Dismukes,IND,10017,0,0,26,26,
Adair,Insurance Commissioner,Glen Mulready,REP,10017,1,14,310,325,
Adair,Insurance Commissioner,Kimberly Fobbs,DEM,10017,3,4,114,121,
Adair,Corporation Commissioner,Bob Anthony,REP,10017,1,13,283,297,
Adair,Corporation Commissioner,Ashley Nicole Mccray,DEM,10017,3,5,108,116,
Adair,Corporation Commissioner,Jackie Short,IND,10017,0,0,33,33,
Adair,U.S. House,Richard Castaldo,LIB,10017,0,0,5,5,2
Adair,U.S. House,Markwayne Mullin,REP,10017,1,15,311,327,2
Adair,U.S. House,Jason Nichols,DEM,10017,3,4,93,100,2
Adair,U.S. House,John Foreman,IND,10017,0,0,24,24,2
Adair,State House,David Hardin,REP,10017,1,12,301,314,86
Adair,State House,Rhonda Cox,DEM,10017,3,7,130,140,86
Adair,Governor,Chris Powell,LIB,10018,1,1,11,13,
Adair,Governor,Kevin Stitt,REP,10018,3,15,241,259,
Adair,Governor,Drew Edmondson,DEM,10018,5,10,144,159,
Adair,Lieutenant Governor,Matt Pinnell,REP,10018,3,13,256,272,
Adair,Lieutenant Governor,Anastasia Pittman,DEM,10018,5,13,121,139,
Adair,Lieutenant Governor,Ivan Holmes,IND,10018,1,0,14,15,
Adair,State Auditor,John Yeutter,LIB,10018,3,3,92,98,
Adair,State Auditor,Cindy Byrd,REP,10018,6,21,283,310,
Adair,Attorney General,Mike Hunter,REP,10018,4,15,281,300,
Adair,Attorney General,Mark Myles,DEM,10018,5,10,112,127,
Adair,State Treasurer,Randy Mcdaniel,REP,10018,4,21,293,318,
Adair,State Treasurer,Charles De Coune,IND,10018,4,4,85,93,
Adair,Superintendent of Public Instruction,Joy Hofmeister,REP,10018,4,14,193,211,
Adair,Superintendent of Public Instruction,John Cox,DEM,10018,5,12,169,186,
Adair,Superintendent of Public Instruction,Larry Huff,IND,10018,0,0,31,31,
Adair,Commissioner of Labor,Leslie Osborn,REP,10018,3,15,239,257,
Adair,Commissioner of Labor,Fred Dorrell,DEM,10018,5,10,124,139,
Adair,Commissioner of Labor,Brandt Dismukes,IND,10018,1,0,26,27,
Adair,Insurance Commissioner,Glen Mulready,REP,10018,4,14,245,263,
Adair,Insurance Commissioner,Kimberly Fobbs,DEM,10018,5,11,145,161,
Adair,Corporation Commissioner,Bob Anthony,REP,10018,4,12,246,262,
Adair,Corporation Commissioner,Ashley Nicole Mccray,DEM,10018,5,13,119,137,
Adair,Corporation Commissioner,Jackie Short,IND,10018,0,0,23,23,
Adair,U.S. House,Richard Castaldo,LIB,10018,0,0,6,6,2
Adair,U.S. House,Markwayne Mullin,REP,10018,4,17,268,289,2
Adair,U.S. House,Jason Nichols,DEM,10018,5,8,111,124,2
Adair,U.S. House,John Foreman,IND,10018,0,1,11,12,2
Adair,State House,David Hardin,REP,10018,4,13,208,225,86
Adair,State House,Rhonda Cox,DEM,10018,5,13,184,202,86
Adair,Governor,Chris Powell,LIB,10019,2,3,21,26,
Adair,Governor,Kevin Stitt,REP,10019,7,16,360,383,
Adair,Governor,Drew Edmondson,DEM,10019,5,7,143,155,
Adair,Lieutenant Governor,Matt Pinnell,REP,10019,8,19,383,410,
Adair,Lieutenant Governor,Anastasia Pittman,DEM,10019,4,5,121,130,
Adair,Lieutenant Governor,Ivan Holmes,IND,10019,2,2,16,20,
Adair,State Auditor,John Yeutter,LIB,10019,4,6,109,119,
Adair,State Auditor,Cindy Byrd,REP,10019,11,19,391,421,
Adair,Attorney General,Mike Hunter,REP,10019,9,19,399,427,
Adair,Attorney General,Mark Myles,DEM,10019,6,6,121,133,
Adair,State Treasurer,Randy Mcdaniel,REP,10019,10,21,408,439,
Adair,State Treasurer,Charles De Coune,IND,10019,5,3,94,102,
Adair,Superintendent of Public Instruction,Joy Hofmeister,REP,10019,8,15,293,316,
Adair,Superintendent of Public Instruction,John Cox,DEM,10019,6,9,187,202,
Adair,Superintendent of Public Instruction,Larry Huff,IND,10019,1,2,43,46,
Adair,Commissioner of Labor,Leslie Osborn,REP,10019,8,17,359,384,
Adair,Commissioner of Labor,Fred Dorrell,DEM,10019,4,7,125,136,
Adair,Commissioner of Labor,Brandt Dismukes,IND,10019,3,2,33,38,
Adair,Insurance Commissioner,Glen Mulready,REP,10019,10,21,371,402,
Adair,Insurance Commissioner,Kimberly Fobbs,DEM,10019,5,5,147,157,
Adair,Corporation Commissioner,Bob Anthony,REP,10019,10,19,356,385,
Adair,Corporation Commissioner,Ashley Nicole Mccray,DEM,10019,3,5,130,138,
Adair,Corporation Commissioner,Jackie Short,IND,10019,2,2,34,38,
Adair,U.S. House,Richard Castaldo,LIB,10019,1,1,6,8,2
Adair,U.S. House,Markwayne Mullin,REP,10019,9,16,376,401,2
Adair,U.S. House,Jason Nichols,DEM,10019,5,9,126,140,2
Adair,U.S. House,John Foreman,IND,10019,0,0,18,18,2
Adair,State House,David Hardin,REP,10019,9,19,323,351,86
Adair,State House,Rhonda Cox,DEM,10019,5,6,201,212,86
Alfalfa,Governor,Chris Powell,LIB,20110,0,0,5,5,
Alfalfa,Governor,Kevin Stitt,REP,20110,4,10,116,130,
Alfalfa,Governor,Drew Edmondson,DEM,20110,2,1,19,22,
Alfalfa,Lieutenant Governor,Matt Pinnell,REP,20110,3,11,124,138,
Alfalfa,Lieutenant Governor,Anastasia Pittman,DEM,20110,2,0,12,14,
Alfalfa,Lieutenant Governor,Ivan Holmes,IND,20110,1,0,3,4,
Alfalfa,State Auditor,John Yeutter,LIB,20110,1,0,9,10,
Alfalfa,State Auditor,Cindy Byrd,REP,20110,4,11,129,144,
Alfalfa,Attorney General,Mike Hunter,REP,20110,5,10,126,141,
Alfalfa,Attorney General,Mark Myles,DEM,20110,0,1,13,14,
Alfalfa,State Treasurer,Randy Mcdaniel,REP,20110,3,11,128,142,
Alfalfa,State Treasurer,Charles De Coune,IND,20110,2,0,11,13,
Alfalfa,Superintendent of Public Instruction,Joy Hofmeister,REP,20110,5,10,120,135,
Alfalfa,Superintendent of Public Instruction,John Cox,DEM,20110,0,0,14,14,
Alfalfa,Superintendent of Public Instruction,Larry Huff,IND,20110,1,0,4,5,
Alfalfa,Commissioner of Labor,Leslie Osborn,REP,20110,5,11,117,133,
Alfalfa,Commissioner of Labor,Fred Dorrell,DEM,20110,0,0,14,14,
Alfalfa,Commissioner of Labor,Brandt Dismukes,IND,20110,1,0,7,8,
Alfalfa,Insurance Commissioner,Glen Mulready,REP,20110,5,11,122,138,
Alfalfa,Insurance Commissioner,Kimberly Fobbs,DEM,20110,0,0,17,17,
Alfalfa,Corporation Commissioner,Bob Anthony,REP,20110,5,11,121,137,
Alfalfa,Corporation Commissioner,Ashley Nicole Mccray,DEM,20110,0,0,11,11,
Alfalfa,Corporation Commissioner,Jackie Short,IND,20110,1,0,7,8,
Alfalfa,U.S. House,Frank Lucas,REP,20110,6,11,129,146,3
Alfalfa,U.S. House,Frankie Robbins,DEM,20110,0,0,10,10,3
Alfalfa,Governor,Chris Powell,LIB,20120,0,0,6,6,
Alfalfa,Governor,Kevin Stitt,REP,20120,9,5,107,121,
Alfalfa,Governor,Drew Edmondson,DEM,20120,0,3,29,32,
Alfalfa,Lieutenant Governor,Matt Pinnell,REP,20120,9,7,121,137,
Alfalfa,Lieutenant Governor,Anastasia Pittman,DEM,20120,0,0,14,14,
Alfalfa,Lieutenant Governor,Ivan Holmes,IND,20120,0,1,7,8,
Alfalfa,State Auditor,John Yeutter,LIB,20120,1,0,18,19,
Alfalfa,State Auditor,Cindy Byrd,REP,20120,8,8,120,136,
Alfalfa,Attorney General,Mike Hunter,REP,20120,8,7,120,135,
Alfalfa,Attorney General,Mark Myles,DEM,20120,1,1,22,24,
Alfalfa,State Treasurer,Randy Mcdaniel,REP,20120,9,6,125,140,
Alfalfa,State Treasurer,Charles De Coune,IND,20120,0,2,12,14,
Alfalfa,Superintendent of Public Instruction,Joy Hofmeister,REP,20120,7,6,104,117,
Alfalfa,Superintendent of Public Instruction,John Cox,DEM,20120,2,1,22,25,
Alfalfa,Superintendent of Public Instruction,Larry Huff,IND,20120,0,1,16,17,
Alfalfa,Commissioner of Labor,Leslie Osborn,REP,20120,9,7,113,129,
Alfalfa,Commissioner of Labor,Fred Dorrell,DEM,20120,0,1,16,17,
Alfalfa,Commissioner of Labor,Brandt Dismukes,IND,20120,0,0,9,9,
Alfalfa,Insurance Commissioner,Glen Mulready,REP,20120,9,7,120,136,
Alfalfa,Insurance Commissioner,Kimberly Fobbs,DEM,20120,0,1,18,19,
Alfalfa,Corporation Commissioner,Bob Anthony,REP,20120,6,5,107,118,
Alfalfa,Corporation Commissioner,Ashley Nicole Mccray,DEM,20120,2,2,20,24,
Alfalfa,Corporation Commissioner,Jackie Short,IND,20120,1,1,14,16,
Alfalfa,U.S. House,Frank Lucas,REP,20120,8,5,123,136,3
Alfalfa,U.S. House,Frankie Robbins,DEM,20120,1,3,19,23,3
Alfalfa,Governor,Chris Powell,LIB,20140,0,3,12,15,
Alfalfa,Governor,Kevin Stitt,REP,20140,5,24,180,209,
Alfalfa,Governor,Drew Edmondson,DEM,20140,3,7,79,89,
Alfalfa,Lieutenant Governor,Matt Pinnell,REP,20140,5,27,220,252,
Alfalfa,Lieutenant Governor,Anastasia Pittman,DEM,20140,3,5,41,49,
Alfalfa,Lieutenant Governor,Ivan Holmes,IND,20140,0,2,9,11,
Alfalfa,State Auditor,John Yeutter,LIB,20140,0,3,30,33,
Alfalfa,State Auditor,Cindy Byrd,REP,20140,6,29,237,272,
Alfalfa,Attorney General,Mike Hunter,REP,20140,6,25,217,248,
Alfalfa,Attorney General,Mark Myles,DEM,20140,2,9,49,60,
Alfalfa,State Treasurer,Randy Mcdaniel,REP,20140,6,29,244,279,
Alfalfa,State Treasurer,Charles De Coune,IND,20140,0,4,23,27,
Alfalfa,Superintendent of Public Instruction,Joy Hofmeister,REP,20140,6,27,208,241,
Alfalfa,Superintendent of Public Instruction,John Cox,DEM,20140,2,6,45,53,
Alfalfa,Superintendent of Public Instruction,Larry Huff,IND,20140,0,1,19,20,
Alfalfa,Commissioner of Labor,Leslie Osborn,REP,20140,6,28,209,243,
Alfalfa,Commissioner of Labor,Fred Dorrell,DEM,20140,2,4,43,49,
Alfalfa,Commissioner of Labor,Brandt Dismukes,IND,20140,0,2,12,14,
Alfalfa,Insurance Commissioner,Glen Mulready,REP,20140,6,26,211,243,
Alfalfa,Insurance Commissioner,Kimberly Fobbs,DEM,20140,2,8,53,63,
Alfalfa,Corporation Commissioner,Bob Anthony,REP,20140,6,25,208,239,
Alfalfa,Corporation Commissioner,Ashley Nicole Mccray,DEM,20140,2,7,46,55,
Alfalfa,Corporation Commissioner,Jackie Short,IND,20140,0,2,15,17,
Alfalfa,U.S. House,Frank Lucas,REP,20140,6,27,227,260,3
Alfalfa,U.S. House,Frankie Robbins,DEM,20140,2,7,42,51,3
Alfalfa,Governor,Chris Powell,LIB,20220,0,0,14,14,
Alfalfa,Governor,Kevin Stitt,REP,20220,7,32,208,247,
Alfalfa,Governor,Drew Edmondson,DEM,20220,6,20,72,98,
Alfalfa,Lieutenant Governor,Matt Pinnell,REP,20220,8,44,232,284,
Alfalfa,Lieutenant Governor,Anastasia Pittman,DEM,20220,4,6,47,57,
Alfalfa,Lieutenant Governor,Ivan Holmes,IND,20220,1,1,12,14,
Alfalfa,State Auditor,John Yeutter,LIB,20220,2,3,31,36,
Alfalfa,State Auditor,Cindy Byrd,REP,20220,9,47,252,308,
Alfalfa,Attorney General,Mike Hunter,REP,20220,7,42,239,288,
Alfalfa,Attorney General,Mark Myles,DEM,20220,6,10,52,68,
Alfalfa,State Treasurer,Randy Mcdaniel,REP,20220,9,48,246,303,
Alfalfa,State Treasurer,Charles De Coune,IND,20220,4,3,36,43,
Alfalfa,Superintendent of Public Instruction,Joy Hofmeister,REP,20220,9,37,215,261,
Alfalfa,Superintendent of Public Instruction,John Cox,DEM,20220,3,10,48,61,
Alfalfa,Superintendent of Public Instruction,Larry Huff,IND,20220,1,3,29,33,
Alfalfa,Commissioner of Labor,Leslie Osborn,REP,20220,8,42,229,279,
Alfalfa,Commissioner of Labor,Fred Dorrell,DEM,20220,4,11,44,59,
Alfalfa,Commissioner of Labor,Brandt Dismukes,IND,20220,1,0,14,15,
Alfalfa,Insurance Commissioner,Glen Mulready,REP,20220,8,45,236,289,
Alfalfa,Insurance Commissioner,Kimberly Fobbs,DEM,20220,5,6,48,59,
Alfalfa,Corporation Commissioner,Bob Anthony,REP,20220,7,46,220,273,
Alfalfa,Corporation Commissioner,Ashley Nicole Mccray,DEM,20220,5,4,53,62,
Alfalfa,Corporation Commissioner,Jackie Short,IND,20220,1,2,13,16,
Alfalfa,U.S. House,Frank Lucas,REP,20220,8,48,247,303,3
Alfalfa,U.S. House,Frankie Robbins,DEM,20220,5,5,44,54,3
Alfalfa,Governor,Chris Powell,LIB,20230,0,0,13,13,
Alfalfa,Governor,Kevin Stitt,REP,20230,6,15,148,169,
Alfalfa,Governor,Drew Edmondson,DEM,20230,2,1,51,54,
Alfalfa,Lieutenant Governor,Matt Pinnell,REP,20230,6,15,159,180,
Alfalfa,Lieutenant Governor,Anastasia Pittman,DEM,20230,2,1,43,46,
Alfalfa,Lieutenant Governor,Ivan Holmes,IND,20230,0,0,8,8,
Alfalfa,State Auditor,John Yeutter,LIB,20230,2,0,29,31,
Alfalfa,State Auditor,Cindy Byrd,REP,20230,6,15,175,196,
Alfalfa,Attorney General,Mike Hunter,REP,20230,6,15,169,190,
Alfalfa,Attorney General,Mark Myles,DEM,20230,2,1,42,45,
Alfalfa,State Treasurer,Randy Mcdaniel,REP,20230,6,14,168,188,
Alfalfa,State Treasurer,Charles De Coune,IND,20230,2,1,36,39,
Alfalfa,Superintendent of Public Instruction,Joy Hofmeister,REP,20230,4,13,151,168,
Alfalfa,Superintendent of Public Instruction,John Cox,DEM,20230,2,3,41,46,
Alfalfa,Superintendent of Public Instruction,Larry Huff,IND,20230,2,0,19,21,
Alfalfa,Commissioner of Labor,Leslie Osborn,REP,20230,5,15,169,189,
Alfalfa,Commissioner of Labor,Fred Dorrell,DEM,20230,2,1,34,37,
Alfalfa,Commissioner of Labor,Brandt Dismukes,IND,20230,1,0,9,10,
Alfalfa,Insurance Commissioner,Glen Mulready,REP,20230,6,15,173,194,
Alfalfa,Insurance Commissioner,Kimberly Fobbs,DEM,20230,2,1,37,40,
Alfalfa,Corporation Commissioner,Bob Anthony,REP,20230,5,15,158,178,
Alfalfa,Corporation Commissioner,Ashley Nicole Mccray,DEM,20230,2,1,39,42,
Alfalfa,Corporation Commissioner,Jackie Short,IND,20230,1,0,14,15,
Alfalfa,U.S. House,Frank Lucas,REP,20230,6,15,174,195,3
Alfalfa,U.S. House,Frankie Robbins,DEM,20230,2,1,37,40,3
Alfalfa,Governor,Chris Powell,LIB,20310,0,0,13,13,
Alfalfa,Governor,Kevin Stitt,REP,20310,5,10,198,213,
Alfalfa,Governor,Drew Edmondson,DEM,20310,5,2,54,61,
Alfalfa,Lieutenant Governor,Matt Pinnell,REP,20310,6,11,222,239,
Alfalfa,Lieutenant Governor,Anastasia Pittman,DEM,20310,3,1,31,35,
Alfalfa,Lieutenant Governor,Ivan Holmes,IND,20310,1,0,10,11,
Alfalfa,State Auditor,John Yeutter,LIB,20310,3,1,29,33,
Alfalfa,State Auditor,Cindy Byrd,REP,20310,6,11,229,246,
Alfalfa,Attorney General,Mike Hunter,REP,20310,7,8,220,235,
Alfalfa,Attorney General,Mark Myles,DEM,20310,3,4,42,49,
Alfalfa,State Treasurer,Randy Mcdaniel,REP,20310,7,11,227,245,
Alfalfa,State Treasurer,Charles De Coune,IND,20310,2,1,30,33,
Alfalfa,Superintendent of Public Instruction,Joy Hofmeister,REP,20310,5,9,198,212,
Alfalfa,Superintendent of Public Instruction,John Cox,DEM,20310,3,3,43,49,
Alfalfa,Superintendent of Public Instruction,Larry Huff,IND,20310,2,0,20,22,
Alfalfa,Commissioner of Labor,Leslie Osborn,REP,20310,7,10,203,220,
Alfalfa,Commissioner of Labor,Fred Dorrell,DEM,20310,2,2,42,46,
Alfalfa,Commissioner of Labor,Brandt Dismukes,IND,20310,0,0,13,13,
Alfalfa,Insurance Commissioner,Glen Mulready,REP,20310,6,11,212,229,
Alfalfa,Insurance Commissioner,Kimberly Fobbs,DEM,20310,3,1,50,54,
Alfalfa,Corporation Commissioner,Bob Anthony,REP,20310,6,10,213,229,
Alfalfa,Corporation Commissioner,Ashley Nicole Mccray,DEM,20310,3,2,35,40,
Alfalfa,Corporation Commissioner,Jackie Short,IND,20310,1,0,13,14,
Alfalfa,U.S. House,Frank Lucas,REP,20310,6,11,237,254,3
Alfalfa,U.S. House,Frankie Robbins,DEM,20310,4,1,28,33,3
Alfalfa,Governor,Chris Powell,LIB,20320,1,0,6,7,
Alfalfa,Governor,Kevin Stitt,REP,20320,4,2,106,112,
Alfalfa,Governor,Drew Edmondson,DEM,20320,0,0,19,19,
Alfalfa,Lieutenant Governor,Matt Pinnell,REP,20320,4,2,117,123,
Alfalfa,Lieutenant Governor,Anastasia Pittman,DEM,20320,1,0,12,13,
Alfalfa,Lieutenant Governor,Ivan Holmes,IND,20320,0,0,2,2,
Alfalfa,State Auditor,John Yeutter,LIB,20320,0,0,15,15,
Alfalfa,State Auditor,Cindy Byrd,REP,20320,5,2,114,121,
Alfalfa,Attorney General,Mike Hunter,REP,20320,4,2,114,120,
Alfalfa,Attorney General,Mark Myles,DEM,20320,1,0,17,18,
Alfalfa,State Treasurer,Randy Mcdaniel,REP,20320,5,2,119,126,
Alfalfa,State Treasurer,Charles De Coune,IND,20320,0,0,10,10,
Alfalfa,Superintendent of Public Instruction,Joy Hofmeister,REP,20320,5,2,96,103,
Alfalfa,Superintendent of Public Instruction,John Cox,DEM,20320,0,0,23,23,
Alfalfa,Superintendent of Public Instruction,Larry Huff,IND,20320,0,0,11,11,
Alfalfa,Commissioner of Labor,Leslie Osborn,REP,20320,4,2,110,116,
Alfalfa,Commissioner of Labor,Fred Dorrell,DEM,20320,1,0,14,15,
Alfalfa,Commissioner of Labor,Brandt Dismukes,IND,20320,0,0,7,7,
Alfalfa,Insurance Commissioner,Glen Mulready,REP,20320,4,2,116,122,
Alfalfa,Insurance Commissioner,Kimberly Fobbs,DEM,20320,1,0,15,16,
Alfalfa,Corporation Commissioner,Bob Anthony,REP,20320,4,2,100,106,
Alfalfa,Corporation Commissioner,Ashley Nicole Mccray,DEM,20320,1,0,24,25,
Alfalfa,Corporation Commissioner,Jackie Short,IND,20320,0,0,7,7,
Alfalfa,U.S. House,Frank Lucas,REP,20320,4,2,109,115,3
Alfalfa,U.S. House,Frankie Robbins,DEM,20320,1,0,22,23,3
Alfalfa,Governor,Chris Powell,LIB,20330,0,1,3,4,
Alfalfa,Governor,Kevin Stitt,REP,20330,1,7,124,132,
Alfalfa,Governor,Drew Edmondson,DEM,20330,0,1,15,16,
Alfalfa,Lieutenant Governor,Matt Pinnell,REP,20330,1,8,130,139,
Alfalfa,Lieutenant Governor,Anastasia Pittman,DEM,20330,0,1,9,10,
Alfalfa,Lieutenant Governor,Ivan Holmes,IND,20330,0,0,3,3,
Alfalfa,State Auditor,John Yeutter,LIB,20330,0,0,9,9,
Alfalfa,State Auditor,Cindy Byrd,REP,20330,1,8,131,140,
Alfalfa,Attorney General,Mike Hunter,REP,20330,1,7,124,132,
Alfalfa,Attorney General,Mark Myles,DEM,20330,0,2,18,20,
Alfalfa,State Treasurer,Randy Mcdaniel,REP,20330,1,7,132,140,
Alfalfa,State Treasurer,Charles De Coune,IND,20330,0,1,8,9,
Alfalfa,Superintendent of Public Instruction,Joy Hofmeister,REP,20330,1,6,119,126,
Alfalfa,Superintendent of Public Instruction,John Cox,DEM,20330,0,3,15,18,
Alfalfa,Superintendent of Public Instruction,Larry Huff,IND,20330,0,0,8,8,
Alfalfa,Commissioner of Labor,Leslie Osborn,REP,20330,1,7,128,136,
Alfalfa,Commissioner of Labor,Fred Dorrell,DEM,20330,0,1,10,11,
Alfalfa,Commissioner of Labor,Brandt Dismukes,IND,20330,0,1,3,4,
Alfalfa,Insurance Commissioner,Glen Mulready,REP,20330,1,8,125,134,
Alfalfa,Insurance Commissioner,Kimberly Fobbs,DEM,20330,0,1,16,17,
Alfalfa,Corporation Commissioner,Bob Anthony,REP,20330,1,8,127,136,
Alfalfa,Corporation Commissioner,Ashley Nicole Mccray,DEM,20330,0,1,12,13,
Alfalfa,Corporation Commissioner,Jackie Short,IND,20330,0,0,3,3,
Alfalfa,U.S. House,Frank Lucas,REP,20330,1,6,131,138,3
Alfalfa,U.S. House,Frankie Robbins,DEM,20330,0,3,11,14,3
Atoka,Governor,Chris Powell,LIB,30001,1,2,8,11,
Atoka,Governor,Kevin Stitt,REP,30001,2,67,205,274,
Atoka,Governor,Drew Edmondson,DEM,30001,5,37,104,146,
Atoka,Lieutenant Governor,Matt Pinnell,REP,30001,3,66,216,285,
Atoka,Lieutenant Governor,Anastasia Pittman,DEM,30001,4,38,80,122,
Atoka,Lieutenant Governor,Ivan Holmes,IND,30001,1,1,11,13,
Atoka,State Auditor,John Yeutter,LIB,30001,0,19,34,53,
Atoka,State Auditor,Cindy Byrd,REP,30001,5,76,263,344,
Atoka,Attorney General,Mike Hunter,REP,30001,2,65,229,296,
Atoka,Attorney General,Mark Myles,DEM,30001,4,39,75,118,
Atoka,State Treasurer,Randy Mcdaniel,REP,30001,6,73,258,337,
Atoka,State Treasurer,Charles De Coune,IND,30001,0,24,36,60,
Atoka,Superintendent of Public Instruction,Joy Hofmeister,REP,30001,2,60,204,266,
Atoka,Superintendent of Public Instruction,John Cox,DEM,30001,3,36,91,130,
Atoka,Superintendent of Public Instruction,Larry Huff,IND,30001,0,7,15,22,
Atoka,Commissioner of Labor,Leslie Osborn,REP,30001,3,62,220,285,
Atoka,Commissioner of Labor,Fred Dorrell,DEM,30001,2,37,80,119,
Atoka,Commissioner of Labor,Brandt Dismukes,IND,30001,0,4,7,11,
Atoka,Insurance Commissioner,Glen Mulready,REP,30001,1,66,215,282,
Atoka,Insurance Commissioner,Kimberly Fobbs,DEM,30001,5,35,90,130,
Atoka,Corporation Commissioner,Bob Anthony,REP,30001,2,64,219,285,
Atoka,Corporation Commissioner,Ashley Nicole Mccray,DEM,30001,3,40,78,121,
Atoka,Corporation Commissioner,Jackie Short,IND,30001,0,0,11,11,
Atoka,U.S. House,Richard Castaldo,LIB,30001,1,0,4,5,2
Atoka,U.S. House,Markwayne Mullin,REP,30001,3,69,234,306,2
Atoka,U.S. House,Jason Nichols,DEM,30001,2,35,65,102,2
Atoka,U.S. House,John Foreman,IND,30001,0,1,9,10,2
Atoka,State Senate,David Bullard,REP,30001,3,64,223,290,6
Atoka,State Senate,Arnold Bourne,DEM,30001,2,40,85,127,6
Atoka,State House,Charles Mccall,REP,30001,7,82,251,340,22
Atoka,State House,Wayne Eidson,DEM,30001,1,22,58,81,22
Atoka,State House,Renae Ward,IND,30001,0,3,4,7,22
Atoka,Governor,Chris Powell,LIB,30002,0,0,4,4,
Atoka,Governor,Kevin Stitt,REP,30002,8,53,189,250,
Atoka,Governor,Drew Edmondson,DEM,30002,7,17,51,75,
Atoka,Lieutenant Governor,Matt Pinnell,REP,30002,7,56,196,259,
Atoka,Lieutenant Governor,Anastasia Pittman,DEM,30002,7,14,40,61,
Atoka,Lieutenant Governor,Ivan Holmes,IND,30002,0,0,7,7,
Atoka,State Auditor,John Yeutter,LIB,30002,1,4,25,30,
Atoka,State Auditor,Cindy Byrd,REP,30002,11,63,206,280,
Atoka,Attorney General,Mike Hunter,REP,30002,7,56,191,254,
Atoka,Attorney General,Mark Myles,DEM,30002,7,12,49,68,
Atoka,State Treasurer,Randy Mcdaniel,REP,30002,8,56,201,265,
Atoka,State Treasurer,Charles De Coune,IND,30002,4,9,27,40,
Atoka,Superintendent of Public Instruction,Joy Hofmeister,REP,30002,8,56,173,237,
Atoka,Superintendent of Public Instruction,John Cox,DEM,30002,7,12,51,70,
Atoka,Superintendent of Public Instruction,Larry Huff,IND,30002,0,2,21,23,
Atoka,Commissioner of Labor,Leslie Osborn,REP,30002,7,55,179,241,
Atoka,Commissioner of Labor,Fred Dorrell,DEM,30002,7,15,47,69,
Atoka,Commissioner of Labor,Brandt Dismukes,IND,30002,0,0,15,15,
Atoka,Insurance Commissioner,Glen Mulready,REP,30002,8,56,187,251,
Atoka,Insurance Commissioner,Kimberly Fobbs,DEM,30002,6,12,52,70,
Atoka,Corporation Commissioner,Bob Anthony,REP,30002,8,54,183,245,
Atoka,Corporation Commissioner,Ashley Nicole Mccray,DEM,30002,6,12,45,63,
Atoka,Corporation Commissioner,Jackie Short,IND,30002,0,3,11,14,
Atoka,U.S. House,Richard Castaldo,LIB,30002,0,0,3,3,2
Atoka,U.S. House,Markwayne Mullin,REP,30002,9,55,196,260,2
Atoka,U.S. House,Jason Nichols,DEM,30002,6,14,40,60,2
Atoka,U.S. House,John Foreman,IND,30002,0,1,4,5,2
Atoka,State Senate,David Bullard,REP,30002,8,57,184,249,6
Atoka,State Senate,Arnold Bourne,DEM,30002,6,13,59,78,6
Atoka,State House,Charles Mccall,REP,30002,10,58,211,279,22
Atoka,State House,Wayne Eidson,DEM,30002,5,12,31,48,22
Atoka,State House,Renae Ward,IND,30002,0,0,3,3,22
Atoka,Governor,Chris Powell,LIB,30003,0,1,4,5,
Atoka,Governor,Kevin Stitt,REP,30003,5,37,106,148,
Atoka,Governor,Drew Edmondson,DEM,30003,2,22,76,100,
Atoka,Lieutenant Governor,Matt Pinnell,REP,30003,5,36,111,152,
Atoka,Lieutenant Governor,Anastasia Pittman,DEM,30003,2,23,65,90,
Atoka,Lieutenant Governor,Ivan Holmes,IND,30003,0,1,6,7,
Atoka,State Auditor,John Yeutter,LIB,30003,1,11,28,40,
Atoka,State Auditor,Cindy Byrd,REP,30003,5,43,141,189,
Atoka,Attorney General,Mike Hunter,REP,30003,5,37,118,160,
Atoka,Attorney General,Mark Myles,DEM,30003,2,21,63,86,
Atoka,State Treasurer,Randy Mcdaniel,REP,30003,5,48,135,188,
Atoka,State Treasurer,Charles De Coune,IND,30003,1,8,36,45,
Atoka,Superintendent of Public Instruction,Joy Hofmeister,REP,30003,4,28,100,132,
Atoka,Superintendent of Public Instruction,John Cox,DEM,30003,2,26,72,100,
Atoka,Superintendent of Public Instruction,Larry Huff,IND,30003,0,5,9,14,
Atoka,Commissioner of Labor,Leslie Osborn,REP,30003,4,36,115,155,
Atoka,Commissioner of Labor,Fred Dorrell,DEM,30003,2,23,61,86,
Atoka,Commissioner of Labor,Brandt Dismukes,IND,30003,0,1,4,5,
Atoka,Insurance Commissioner,Glen Mulready,REP,30003,5,37,113,155,
Atoka,Insurance Commissioner,Kimberly Fobbs,DEM,30003,2,23,69,94,
Atoka,Corporation Commissioner,Bob Anthony,REP,30003,5,37,111,153,
Atoka,Corporation Commissioner,Ashley Nicole Mccray,DEM,30003,2,22,69,93,
Atoka,Corporation Commissioner,Jackie Short,IND,30003,0,1,3,4,
Atoka,U.S. House,Richard Castaldo,LIB,30003,0,0,2,2,2
Atoka,U.S. House,Markwayne Mullin,REP,30003,5,44,126,175,2
Atoka,U.S. House,Jason Nichols,DEM,30003,2,15,54,71,2
Atoka,U.S. House,John Foreman,IND,30003,0,1,3,4,2
Atoka,State Senate,David Bullard,REP,30003,5,37,109,151,6
Atoka,State Senate,Arnold Bourne,DEM,30003,2,23,73,98,6
Atoka,State House,Charles Mccall,REP,30003,5,46,147,198,22
Atoka,State House,Wayne Eidson,DEM,30003,2,14,36,52,22
Atoka,State House,Renae Ward,IND,30003,0,0,5,5,22
Atoka,Governor,Chris Powell,LIB,30006,0,1,3,4,
Atoka,Governor,Kevin Stitt,REP,30006,6,39,108,153,
Atoka,Governor,Drew Edmondson,DEM,30006,5,22,47,74,
Atoka,Lieutenant Governor,Matt Pinnell,REP,30006,6,45,112,163,
Atoka,Lieutenant Governor,Anastasia Pittman,DEM,30006,5,18,38,61,
Atoka,Lieutenant Governor,Ivan Holmes,IND,30006,0,0,6,6,
Atoka,State Auditor,John Yeutter,LIB,30006,3,7,16,26,
Atoka,State Auditor,Cindy Byrd,REP,30006,8,48,130,186,
Atoka,Attorney General,Mike Hunter,REP,30006,6,44,112,162,
Atoka,Attorney General,Mark Myles,DEM,30006,5,19,43,67,
Atoka,State Treasurer,Randy Mcdaniel,REP,30006,6,52,122,180,
Atoka,State Treasurer,Charles De Coune,IND,30006,5,3,24,32,
Atoka,Superintendent of Public Instruction,Joy Hofmeister,REP,30006,6,40,101,147,
Atoka,Superintendent of Public Instruction,John Cox,DEM,30006,5,21,39,65,
Atoka,Superintendent of Public Instruction,Larry Huff,IND,30006,0,2,17,19,
Atoka,Commissioner of Labor,Leslie Osborn,REP,30006,6,44,111,161,
Atoka,Commissioner of Labor,Fred Dorrell,DEM,30006,5,17,40,62,
Atoka,Commissioner of Labor,Brandt Dismukes,IND,30006,0,1,5,6,
Atoka,Insurance Commissioner,Glen Mulready,REP,30006,6,43,112,161,
Atoka,Insurance Commissioner,Kimberly Fobbs,DEM,30006,5,19,42,66,
Atoka,Corporation Commissioner,Bob Anthony,REP,30006,6,40,108,154,
Atoka,Corporation Commissioner,Ashley Nicole Mccray,DEM,30006,5,21,39,65,
Atoka,Corporation Commissioner,Jackie Short,IND,30006,0,1,9,10,
Atoka,U.S. House,Richard Castaldo,LIB,30006,0,0,0,0,2
Atoka,U.S. House,Markwayne Mullin,REP,30006,6,48,120,174,2
Atoka,U.S. House,Jason Nichols,DEM,30006,5,14,33,52,2
Atoka,U.S. House,John Foreman,IND,30006,0,1,4,5,2
Atoka,State Senate,David Bullard,REP,30006,6,42,111,159,6
Atoka,State Senate,Arnold Bourne,DEM,30006,5,21,46,72,6
Atoka,State House,Charles Mccall,REP,30006,6,50,115,171,22
Atoka,State House,Wayne Eidson,DEM,30006,5,12,33,50,22
Atoka,State House,Renae Ward,IND,30006,0,0,10,10,22
Atoka,Governor,Chris Powell,LIB,30007,1,3,5,9,
Atoka,Governor,Kevin Stitt,REP,30007,7,36,213,256,
Atoka,Governor,Drew Edmondson,DEM,30007,1,9,109,119,
Atoka,Lieutenant Governor,Matt Pinnell,REP,30007,7,39,238,284,
Atoka,Lieutenant Governor,Anastasia Pittman,DEM,30007,0,7,82,89,
Atoka,Lieutenant Governor,Ivan Holmes,IND,30007,1,2,6,9,
Atoka,State Auditor,John Yeutter,LIB,30007,0,1,44,45,
Atoka,State Auditor,Cindy Byrd,REP,30007,8,42,268,318,
Atoka,Attorney General,Mike Hunter,REP,30007,8,39,234,281,
Atoka,Attorney General,Mark Myles,DEM,30007,1,9,89,99,
Atoka,State Treasurer,Randy Mcdaniel,REP,30007,8,39,268,315,
Atoka,State Treasurer,Charles De Coune,IND,30007,1,4,48,53,
Atoka,Superintendent of Public Instruction,Joy Hofmeister,REP,30007,7,34,222,263,
Atoka,Superintendent of Public Instruction,John Cox,DEM,30007,1,9,82,92,
Atoka,Superintendent of Public Instruction,Larry Huff,IND,30007,1,2,21,24,
Atoka,Commissioner of Labor,Leslie Osborn,REP,30007,6,38,227,271,
Atoka,Commissioner of Labor,Fred Dorrell,DEM,30007,2,8,83,93,
Atoka,Commissioner of Labor,Brandt Dismukes,IND,30007,1,2,11,14,
Atoka,Insurance Commissioner,Glen Mulready,REP,30007,8,38,230,276,
Atoka,Insurance Commissioner,Kimberly Fobbs,DEM,30007,1,9,91,101,
Atoka,Corporation Commissioner,Bob Anthony,REP,30007,8,34,226,268,
Atoka,Corporation Commissioner,Ashley Nicole Mccray,DEM,30007,1,9,88,98,
Atoka,Corporation Commissioner,Jackie Short,IND,30007,0,5,10,15,
Atoka,U.S. House,Richard Castaldo,LIB,30007,0,1,1,2,2
Atoka,U.S. House,Markwayne Mullin,REP,30007,9,40,250,299,2
Atoka,U.S. House,Jason Nichols,DEM,30007,0,7,69,76,2
Atoka,U.S. House,John Foreman,IND,30007,0,0,7,7,2
Atoka,State Senate,David Bullard,REP,30007,8,36,232,276,6
Atoka,State Senate,Arnold Bourne,DEM,30007,1,10,93,104,6
Atoka,State House,Charles Mccall,REP,30007,8,37,253,298,22
Atoka,State House,Wayne Eidson,DEM,30007,1,7,66,74,22
Atoka,State House,Renae Ward,IND,30007,0,3,8,11,22
Atoka,Governor,Chris Powell,LIB,30008,0,2,11,13,
Atoka,Governor,Kevin Stitt,REP,30008,11,54,369,434,
Atoka,Governor,Drew Edmondson,DEM,30008,6,16,155,177,
Atoka,Lieutenant Governor,Matt Pinnell,REP,30008,12,59,397,468,
Atoka,Lieutenant Governor,Anastasia Pittman,DEM,30008,5,11,111,127,
Atoka,Lieutenant Governor,Ivan Holmes,IND,30008,0,2,17,19,
Atoka,State Auditor,John Yeutter,LIB,30008,3,4,69,76,
Atoka,State Auditor,Cindy Byrd,REP,30008,12,62,434,508,
Atoka,Attorney General,Mike Hunter,REP,30008,12,57,404,473,
Atoka,Attorney General,Mark Myles,DEM,30008,5,13,118,136,
Atoka,State Treasurer,Randy Mcdaniel,REP,30008,12,60,429,501,
Atoka,State Treasurer,Charles De Coune,IND,30008,5,5,78,88,
Atoka,Superintendent of Public Instruction,Joy Hofmeister,REP,30008,12,56,381,449,
Atoka,Superintendent of Public Instruction,John Cox,DEM,30008,5,12,104,121,
Atoka,Superintendent of Public Instruction,Larry Huff,IND,30008,0,4,47,51,
Atoka,Commissioner of Labor,Leslie Osborn,REP,30008,12,59,380,451,
Atoka,Commissioner of Labor,Fred Dorrell,DEM,30008,5,10,119,134,
Atoka,Commissioner of Labor,Brandt Dismukes,IND,30008,0,2,22,24,
Atoka,Insurance Commissioner,Glen Mulready,REP,30008,12,57,383,452,
Atoka,Insurance Commissioner,Kimberly Fobbs,DEM,30008,5,13,134,152,
Atoka,Corporation Commissioner,Bob Anthony,REP,30008,12,55,379,446,
Atoka,Corporation Commissioner,Ashley Nicole Mccray,DEM,30008,5,11,119,135,
Atoka,Corporation Commissioner,Jackie Short,IND,30008,0,5,25,30,
Atoka,U.S. House,Richard Castaldo,LIB,30008,0,3,3,6,2
Atoka,U.S. House,Markwayne Mullin,REP,30008,12,56,414,482,2
Atoka,U.S. House,Jason Nichols,DEM,30008,5,12,105,122,2
Atoka,U.S. House,John Foreman,IND,30008,0,1,11,12,2
Atoka,State Senate,David Bullard,REP,30008,12,57,388,457,6
Atoka,State Senate,Arnold Bourne,DEM,30008,5,14,144,163,6
Atoka,State House,Charles Mccall,REP,30008,12,58,406,476,22
Atoka,State House,Wayne Eidson,DEM,30008,5,10,102,117,22
Atoka,State House,Renae Ward,IND,30008,0,3,28,31,22
Atoka,Governor,Chris Powell,LIB,30009,0,1,11,12,
Atoka,Governor,Kevin Stitt,REP,30009,9,45,170,224,
Atoka,Governor,Drew Edmondson,DEM,30009,7,29,67,103,
Atoka,Lieutenant Governor,Matt Pinnell,REP,30009,9,46,188,243,
Atoka,Lieutenant Governor,Anastasia Pittman,DEM,30009,7,19,47,73,
Atoka,Lieutenant Governor,Ivan Holmes,IND,30009,0,5,10,15,
Atoka,State Auditor,John Yeutter,LIB,30009,0,8,20,28,
Atoka,State Auditor,Cindy Byrd,REP,30009,10,65,209,284,
Atoka,Attorney General,Mike Hunter,REP,30009,9,48,184,241,
Atoka,Attorney General,Mark Myles,DEM,30009,5,24,53,82,
Atoka,State Treasurer,Randy Mcdaniel,REP,30009,10,61,202,273,
Atoka,State Treasurer,Charles De Coune,IND,30009,0,10,29,39,
Atoka,Superintendent of Public Instruction,Joy Hofmeister,REP,30009,8,38,160,206,
Atoka,Superintendent of Public Instruction,John Cox,DEM,30009,7,31,70,108,
Atoka,Superintendent of Public Instruction,Larry Huff,IND,30009,0,4,15,19,
Atoka,Commissioner of Labor,Leslie Osborn,REP,30009,10,43,181,234,
Atoka,Commissioner of Labor,Fred Dorrell,DEM,30009,4,27,50,81,
Atoka,Commissioner of Labor,Brandt Dismukes,IND,30009,0,3,7,10,
Atoka,Insurance Commissioner,Glen Mulready,REP,30009,9,46,189,244,
Atoka,Insurance Commissioner,Kimberly Fobbs,DEM,30009,4,25,48,77,
Atoka,Corporation Commissioner,Bob Anthony,REP,30009,8,45,175,228,
Atoka,Corporation Commissioner,Ashley Nicole Mccray,DEM,30009,6,24,54,84,
Atoka,Corporation Commissioner,Jackie Short,IND,30009,0,2,8,10,
Atoka,U.S. House,Richard Castaldo,LIB,30009,0,2,2,4,2
Atoka,U.S. House,Markwayne Mullin,REP,30009,10,52,196,258,2
Atoka,U.S. House,Jason Nichols,DEM,30009,6,19,39,64,2
Atoka,U.S. House,John Foreman,IND,30009,0,2,4,6,2
Atoka,State Senate,David Bullard,REP,30009,9,45,176,230,6
Atoka,State Senate,Arnold Bourne,DEM,30009,6,27,64,97,6
Atoka,State House,Charles Mccall,REP,30009,11,61,202,274,22
Atoka,State House,Wayne Eidson,DEM,30009,4,13,40,57,22
Atoka,State House,Renae Ward,IND,30009,1,1,10,12,22
Atoka,Governor,Chris Powell,LIB,30010,1,0,4,5,
Atoka,Governor,Kevin Stitt,REP,30010,2,2,79,83,
Atoka,Governor,Drew Edmondson,DEM,30010,0,3,19,22,
Atoka,Lieutenant Governor,Matt Pinnell,REP,30010,2,3,85,90,
Atoka,Lieutenant Governor,Anastasia Pittman,DEM,30010,1,2,12,15,
Atoka,Lieutenant Governor,Ivan Holmes,IND,30010,0,0,4,4,
Atoka,State Auditor,John Yeutter,LIB,30010,1,0,18,19,
Atoka,State Auditor,Cindy Byrd,REP,30010,2,4,83,89,
Atoka,Attorney General,Mike Hunter,REP,30010,2,3,87,92,
Atoka,Attorney General,Mark Myles,DEM,30010,1,2,14,17,
Atoka,State Treasurer,Randy Mcdaniel,REP,30010,3,2,91,96,
Atoka,State Treasurer,Charles De Coune,IND,30010,0,2,11,13,
Atoka,Superintendent of Public Instruction,Joy Hofmeister,REP,30010,2,1,72,75,
Atoka,Superintendent of Public Instruction,John Cox,DEM,30010,1,2,16,19,
Atoka,Superintendent of Public Instruction,Larry Huff,IND,30010,0,2,14,16,
Atoka,Commissioner of Labor,Leslie Osborn,REP,30010,2,1,79,82,
Atoka,Commissioner of Labor,Fred Dorrell,DEM,30010,1,2,15,18,
Atoka,Commissioner of Labor,Brandt Dismukes,IND,30010,0,2,7,9,
Atoka,Insurance Commissioner,Glen Mulready,REP,30010,2,2,85,89,
Atoka,Insurance Commissioner,Kimberly Fobbs,DEM,30010,1,3,13,17,
Atoka,Corporation Commissioner,Bob Anthony,REP,30010,2,0,79,81,
Atoka,Corporation Commissioner,Ashley Nicole Mccray,DEM,30010,1,3,14,18,
Atoka,Corporation Commissioner,Jackie Short,IND,30010,0,2,6,8,
Atoka,U.S. House,Richard Castaldo,LIB,30010,0,0,1,1,2
Atoka,U.S. House,Markwayne Mullin,REP,30010,2,0,86,88,2
Atoka,U.S. House,Jason Nichols,DEM,30010,1,3,11,15,2
Atoka,U.S. House,John Foreman,IND,30010,0,2,3,5,2
Atoka,State House,Justin Humphrey,REP,30010,2,2,80,84,19
Atoka,State House,Lewis Collins,DEM,30010,1,3,22,26,19
Atoka,Governor,Chris Powell,LIB,30011,1,5,7,13,
Atoka,Governor,Kevin Stitt,REP,30011,5,113,327,445,
Atoka,Governor,Drew Edmondson,DEM,30011,4,59,118,181,
Atoka,Lieutenant Governor,Matt Pinnell,REP,30011,7,121,326,454,
Atoka,Lieutenant Governor,Anastasia Pittman,DEM,30011,3,48,106,157,
Atoka,Lieutenant Governor,Ivan Holmes,IND,30011,0,4,14,18,
Atoka,State Auditor,John Yeutter,LIB,30011,2,27,61,90,
Atoka,State Auditor,Cindy Byrd,REP,30011,7,133,362,502,
Atoka,Attorney General,Mike Hunter,REP,30011,7,115,329,451,
Atoka,Attorney General,Mark Myles,DEM,30011,2,53,113,168,
Atoka,State Treasurer,Randy Mcdaniel,REP,30011,7,132,362,501,
Atoka,State Treasurer,Charles De Coune,IND,30011,2,23,65,90,
Atoka,Superintendent of Public Instruction,Joy Hofmeister,REP,30011,7,90,281,378,
Atoka,Superintendent of Public Instruction,John Cox,DEM,30011,2,64,137,203,
Atoka,Superintendent of Public Instruction,Larry Huff,IND,30011,0,11,31,42,
Atoka,Commissioner of Labor,Leslie Osborn,REP,30011,7,110,303,420,
Atoka,Commissioner of Labor,Fred Dorrell,DEM,30011,2,55,126,183,
Atoka,Commissioner of Labor,Brandt Dismukes,IND,30011,0,5,14,19,
Atoka,Insurance Commissioner,Glen Mulready,REP,30011,7,110,309,426,
Atoka,Insurance Commissioner,Kimberly Fobbs,DEM,30011,2,56,129,187,
Atoka,Corporation Commissioner,Bob Anthony,REP,30011,7,107,301,415,
Atoka,Corporation Commissioner,Ashley Nicole Mccray,DEM,30011,2,48,116,166,
Atoka,Corporation Commissioner,Jackie Short,IND,30011,0,10,23,33,
Atoka,U.S. House,Richard Castaldo,LIB,30011,0,3,6,9,2
Atoka,U.S. House,Markwayne Mullin,REP,30011,7,119,337,463,2
Atoka,U.S. House,Jason Nichols,DEM,30011,2,49,94,145,2
Atoka,U.S. House,John Foreman,IND,30011,0,4,13,17,2
Atoka,State Senate,David Bullard,REP,30011,7,115,320,442,6
Atoka,State Senate,Arnold Bourne,DEM,30011,2,54,128,184,6
Atoka,State House,Justin Humphrey,REP,30011,9,131,351,491,19
Atoka,State House,Lewis Collins,DEM,30011,1,41,101,143,19
Atoka,Governor,Chris Powell,LIB,30012,0,0,7,7,
Atoka,Governor,Kevin Stitt,REP,30012,1,29,174,204,
Atoka,Governor,Drew Edmondson,DEM,30012,0,0,44,44,
Atoka,Lieutenant Governor,Matt Pinnell,REP,30012,1,25,180,206,
Atoka,Lieutenant Governor,Anastasia Pittman,DEM,30012,0,3,34,37,
Atoka,Lieutenant Governor,Ivan Holmes,IND,30012,0,0,9,9,
Atoka,State Auditor,John Yeutter,LIB,30012,0,3,34,37,
Atoka,State Auditor,Cindy Byrd,REP,30012,1,25,178,204,
Atoka,Attorney General,Mike Hunter,REP,30012,1,27,188,216,
Atoka,Attorney General,Mark Myles,DEM,30012,0,2,37,39,
Atoka,State Treasurer,Randy Mcdaniel,REP,30012,1,27,191,219,
Atoka,State Treasurer,Charles De Coune,IND,30012,0,1,25,26,
Atoka,Superintendent of Public Instruction,Joy Hofmeister,REP,30012,1,19,163,183,
Atoka,Superintendent of Public Instruction,John Cox,DEM,30012,0,5,43,48,
Atoka,Superintendent of Public Instruction,Larry Huff,IND,30012,0,5,16,21,
Atoka,Commissioner of Labor,Leslie Osborn,REP,30012,1,26,173,200,
Atoka,Commissioner of Labor,Fred Dorrell,DEM,30012,0,1,39,40,
Atoka,Commissioner of Labor,Brandt Dismukes,IND,30012,0,2,10,12,
Atoka,Insurance Commissioner,Glen Mulready,REP,30012,1,28,178,207,
Atoka,Insurance Commissioner,Kimberly Fobbs,DEM,30012,0,1,43,44,
Atoka,Corporation Commissioner,Bob Anthony,REP,30012,1,21,161,183,
Atoka,Corporation Commissioner,Ashley Nicole Mccray,DEM,30012,0,6,41,47,
Atoka,Corporation Commissioner,Jackie Short,IND,30012,0,2,18,20,
Atoka,U.S. House,Richard Castaldo,LIB,30012,0,0,0,0,2
Atoka,U.S. House,Markwayne Mullin,REP,30012,1,28,184,213,2
Atoka,U.S. House,Jason Nichols,DEM,30012,0,1,38,39,2
Atoka,U.S. House,John Foreman,IND,30012,0,0,3,3,2
Atoka,State House,Justin Humphrey,REP,30012,1,25,170,196,19
Atoka,State House,Lewis Collins,DEM,30012,0,4,55,59,19
Atoka,Governor,Chris Powell,LIB,30013,0,3,3,6,
Atoka,Governor,Kevin Stitt,REP,30013,5,7,164,176,
Atoka,Governor,Drew Edmondson,DEM,30013,2,5,65,72,
Atoka,Lieutenant Governor,Matt Pinnell,REP,30013,4,8,172,184,
Atoka,Lieutenant Governor,Anastasia Pittman,DEM,30013,3,6,48,57,
Atoka,Lieutenant Governor,Ivan Holmes,IND,30013,0,0,5,5,
Atoka,State Auditor,John Yeutter,LIB,30013,1,5,26,32,
Atoka,State Auditor,Cindy Byrd,REP,30013,5,10,193,208,
Atoka,Attorney General,Mike Hunter,REP,30013,4,8,180,192,
Atoka,Attorney General,Mark Myles,DEM,30013,3,6,46,55,
Atoka,State Treasurer,Randy Mcdaniel,REP,30013,4,10,199,213,
Atoka,State Treasurer,Charles De Coune,IND,30013,2,3,18,23,
Atoka,Superintendent of Public Instruction,Joy Hofmeister,REP,30013,3,7,134,144,
Atoka,Superintendent of Public Instruction,John Cox,DEM,30013,4,6,78,88,
Atoka,Superintendent of Public Instruction,Larry Huff,IND,30013,0,1,14,15,
Atoka,Commissioner of Labor,Leslie Osborn,REP,30013,5,9,161,175,
Atoka,Commissioner of Labor,Fred Dorrell,DEM,30013,2,5,50,57,
Atoka,Commissioner of Labor,Brandt Dismukes,IND,30013,0,0,11,11,
Atoka,Insurance Commissioner,Glen Mulready,REP,30013,4,7,166,177,
Atoka,Insurance Commissioner,Kimberly Fobbs,DEM,30013,3,7,55,65,
Atoka,Corporation Commissioner,Bob Anthony,REP,30013,4,6,162,172,
Atoka,Corporation Commissioner,Ashley Nicole Mccray,DEM,30013,3,6,45,54,
Atoka,Corporation Commissioner,Jackie Short,IND,30013,0,2,17,19,
Atoka,U.S. House,Richard Castaldo,LIB,30013,0,2,2,4,2
Atoka,U.S. House,Markwayne Mullin,REP,30013,4,9,191,204,2
Atoka,U.S. House,Jason Nichols,DEM,30013,3,3,33,39,2
Atoka,U.S. House,John Foreman,IND,30013,0,0,3,3,2
Atoka,State House,Justin Humphrey,REP,30013,5,10,182,197,19
Atoka,State House,Lewis Collins,DEM,30013,2,4,47,53,19
Atoka,Governor,Chris Powell,LIB,30014,0,0,2,2,
Atoka,Governor,Kevin Stitt,REP,30014,0,0,75,75,
Atoka,Governor,Drew Edmondson,DEM,30014,1,2,20,23,
Atoka,Lieutenant Governor,Matt Pinnell,REP,30014,0,0,73,73,
Atoka,Lieutenant Governor,Anastasia Pittman,DEM,30014,0,2,19,21,
Atoka,Lieutenant Governor,Ivan Holmes,IND,30014,1,0,3,4,
Atoka,State Auditor,John Yeutter,LIB,30014,1,0,12,13,
Atoka,State Auditor,Cindy Byrd,REP,30014,0,0,80,80,
Atoka,Attorney General,Mike Hunter,REP,30014,0,0,72,72,
Atoka,Attorney General,Mark Myles,DEM,30014,1,2,22,25,
Atoka,State Treasurer,Randy Mcdaniel,REP,30014,1,0,82,83,
Atoka,State Treasurer,Charles De Coune,IND,30014,0,0,10,10,
Atoka,Superintendent of Public Instruction,Joy Hofmeister,REP,30014,1,0,55,56,
Atoka,Superintendent of Public Instruction,John Cox,DEM,30014,0,2,32,34,
Atoka,Superintendent of Public Instruction,Larry Huff,IND,30014,0,0,8,8,
Atoka,Commissioner of Labor,Leslie Osborn,REP,30014,1,0,70,71,
Atoka,Commissioner of Labor,Fred Dorrell,DEM,30014,0,2,20,22,
Atoka,Commissioner of Labor,Brandt Dismukes,IND,30014,0,0,5,5,
Atoka,Insurance Commissioner,Glen Mulready,REP,30014,1,0,72,73,
Atoka,Insurance Commissioner,Kimberly Fobbs,DEM,30014,0,2,22,24,
Atoka,Corporation Commissioner,Bob Anthony,REP,30014,0,0,68,68,
Atoka,Corporation Commissioner,Ashley Nicole Mccray,DEM,30014,0,2,20,22,
Atoka,Corporation Commissioner,Jackie Short,IND,30014,1,0,7,8,
Atoka,U.S. House,Richard Castaldo,LIB,30014,0,0,3,3,2
Atoka,U.S. House,Markwayne Mullin,REP,30014,0,0,75,75,2
Atoka,U.S. House,Jason Nichols,DEM,30014,0,2,15,17,2
Atoka,U.S. House,John Foreman,IND,30014,1,0,3,4,2
Atoka,State House,Justin Humphrey,REP,30014,0,0,78,78,19
Atoka,State House,Lewis Collins,DEM,30014,0,2,19,21,19
Atoka,Governor,Chris Powell,LIB,30015,0,0,1,1,
Atoka,Governor,Kevin Stitt,REP,30015,0,4,45,49,
Atoka,Governor,Drew Edmondson,DEM,30015,0,5,11,16,
Atoka,Lieutenant Governor,Matt Pinnell,REP,30015,0,4,45,49,
Atoka,Lieutenant Governor,Anastasia Pittman,DEM,30015,0,5,10,15,
Atoka,Lieutenant Governor,Ivan Holmes,IND,30015,0,0,2,2,
Atoka,State Auditor,John Yeutter,LIB,30015,0,2,8,10,
Atoka,State Auditor,Cindy Byrd,REP,30015,0,4,48,52,
Atoka,Attorney General,Mike Hunter,REP,30015,0,3,44,47,
Atoka,Attorney General,Mark Myles,DEM,30015,0,6,13,19,
Atoka,State Treasurer,Randy Mcdaniel,REP,30015,0,5,48,53,
Atoka,State Treasurer,Charles De Coune,IND,30015,0,1,8,9,
Atoka,Superintendent of Public Instruction,Joy Hofmeister,REP,30015,0,3,38,41,
Atoka,Superintendent of Public Instruction,John Cox,DEM,30015,0,6,16,22,
Atoka,Superintendent of Public Instruction,Larry Huff,IND,30015,0,0,3,3,
Atoka,Commissioner of Labor,Leslie Osborn,REP,30015,0,3,39,42,
Atoka,Commissioner of Labor,Fred Dorrell,DEM,30015,0,6,14,20,
Atoka,Commissioner of Labor,Brandt Dismukes,IND,30015,0,0,4,4,
Atoka,Insurance Commissioner,Glen Mulready,REP,30015,0,3,42,45,
Atoka,Insurance Commissioner,Kimberly Fobbs,DEM,30015,0,6,15,21,
Atoka,Corporation Commissioner,Bob Anthony,REP,30015,0,3,40,43,
Atoka,Corporation Commissioner,Ashley Nicole Mccray,DEM,30015,0,6,13,19,
Atoka,Corporation Commissioner,Jackie Short,IND,30015,0,0,4,4,
Atoka,U.S. House,Richard Castaldo,LIB,30015,0,0,0,0,2
Atoka,U.S. House,Markwayne Mullin,REP,30015,0,4,45,49,2
Atoka,U.S. House,Jason Nichols,DEM,30015,0,5,10,15,2
Atoka,U.S. House,John Foreman,IND,30015,0,0,2,2,2
Atoka,State House,Justin Humphrey,REP,30015,0,5,46,51,19
Atoka,State House,Lewis Collins,DEM,30015,0,4,11,15,19
Atoka,Governor,Chris Powell,LIB,30016,0,0,0,0,
Atoka,Governor,Kevin Stitt,REP,30016,0,0,0,0,
Atoka,Governor,Drew Edmondson,DEM,30016,0,0,0,0,
Atoka,Lieutenant Governor,Matt Pinnell,REP,30016,0,0,0,0,
Atoka,Lieutenant Governor,Anastasia Pittman,DEM,30016,0,0,0,0,
Atoka,Lieutenant Governor,Ivan Holmes,IND,30016,0,0,0,0,
Atoka,State Auditor,John Yeutter,LIB,30016,0,0,0,0,
Atoka,State Auditor,Cindy Byrd,REP,30016,0,0,0,0,
Atoka,Attorney General,Mike Hunter,REP,30016,0,0,0,0,
Atoka,Attorney General,Mark Myles,DEM,30016,0,0,0,0,
Atoka,State Treasurer,Randy Mcdaniel,REP,30016,0,0,0,0,
Atoka,State Treasurer,Charles De Coune,IND,30016,0,0,0,0,
Atoka,Superintendent of Public Instruction,Joy Hofmeister,REP,30016,0,0,0,0,
Atoka,Superintendent of Public Instruction,John Cox,DEM,30016,0,0,0,0,
Atoka,Superintendent of Public Instruction,Larry Huff,IND,30016,0,0,0,0,
Atoka,Commissioner of Labor,Leslie Osborn,REP,30016,0,0,0,0,
Atoka,Commissioner of Labor,Fred Dorrell,DEM,30016,0,0,0,0,
Atoka,Commissioner of Labor,Brandt Dismukes,IND,30016,0,0,0,0,
Atoka,Insurance Commissioner,Glen Mulready,REP,30016,0,0,0,0,
Atoka,Insurance Commissioner,Kimberly Fobbs,DEM,30016,0,0,0,0,
Atoka,Corporation Commissioner,Bob Anthony,REP,30016,0,0,0,0,
Atoka,Corporation Commissioner,Ashley Nicole Mccray,DEM,30016,0,0,0,0,
Atoka,Corporation Commissioner,Jackie Short,IND,30016,0,0,0,0,
Atoka,U.S. House,Richard Castaldo,LIB,30016,0,0,0,0,2
Atoka,U.S. House,Markwayne Mullin,REP,30016,0,0,0,0,2
Atoka,U.S. House,Jason Nichols,DEM,30016,0,0,0,0,2
Atoka,U.S. House,John Foreman,IND,30016,0,0,0,0,2
Atoka,State Senate,David Bullard,REP,30016,0,0,0,0,6
Atoka,State Senate,Arnold Bourne,DEM,30016,0,0,0,0,6
Atoka,State House,Justin Humphrey,REP,30016,0,0,0,0,19
Atoka,State House,Lewis Collins,DEM,30016,0,0,0,0,19
Atoka,Governor,Chris Powell,LIB,30017,0,0,0,0,
Atoka,Governor,Kevin Stitt,REP,30017,0,0,0,0,
Atoka,Governor,Drew Edmondson,DEM,30017,0,0,0,0,
Atoka,Lieutenant Governor,Matt Pinnell,REP,30017,0,0,0,0,
Atoka,Lieutenant Governor,Anastasia Pittman,DEM,30017,0,0,0,0,
Atoka,Lieutenant Governor,Ivan Holmes,IND,30017,0,0,0,0,
Atoka,State Auditor,John Yeutter,LIB,30017,0,0,0,0,
Atoka,State Auditor,Cindy Byrd,REP,30017,0,0,0,0,
Atoka,Attorney General,Mike Hunter,REP,30017,0,0,0,0,
Atoka,Attorney General,Mark Myles,DEM,30017,0,0,0,0,
Atoka,State Treasurer,Randy Mcdaniel,REP,30017,0,0,0,0,
Atoka,State Treasurer,Charles De Coune,IND,30017,0,0,0,0,
Atoka,Superintendent of Public Instruction,Joy Hofmeister,REP,30017,0,0,0,0,
Atoka,Superintendent of Public Instruction,John Cox,DEM,30017,0,0,0,0,
Atoka,Superintendent of Public Instruction,Larry Huff,IND,30017,0,0,0,0,
Atoka,Commissioner of Labor,Leslie Osborn,REP,30017,0,0,0,0,
Atoka,Commissioner of Labor,Fred Dorrell,DEM,30017,0,0,0,0,
Atoka,Commissioner of Labor,Brandt Dismukes,IND,30017,0,0,0,0,
Atoka,Insurance Commissioner,Glen Mulready,REP,30017,0,0,0,0,
Atoka,Insurance Commissioner,Kimberly Fobbs,DEM,30017,0,0,0,0,
Atoka,Corporation Commissioner,Bob Anthony,REP,30017,0,0,0,0,
Atoka,Corporation Commissioner,Ashley Nicole Mccray,DEM,30017,0,0,0,0,
Atoka,Corporation Commissioner,Jackie Short,IND,30017,0,0,0,0,
Atoka,U.S. House,Richard Castaldo,LIB,30017,0,0,0,0,2
Atoka,U.S. House,Markwayne Mullin,REP,30017,0,0,0,0,2
Atoka,U.S. House,Jason Nichols,DEM,30017,0,0,0,0,2
Atoka,U.S. House,John Foreman,IND,30017,0,0,0,0,2
Atoka,State Senate,David Bullard,REP,30017,0,0,0,0,6
Atoka,State Senate,Arnold Bourne,DEM,30017,0,0,0,0,6
Atoka,State House,Justin Humphrey,REP,30017,0,0,0,0,19
Atoka,State House,Lewis Collins,DEM,30017,0,0,0,0,19
Atoka,Governor,Chris Powell,LIB,30018,0,0,0,0,
Atoka,Governor,Kevin Stitt,REP,30018,0,0,0,0,
Atoka,Governor,Drew Edmondson,DEM,30018,0,0,0,0,
Atoka,Lieutenant Governor,Matt Pinnell,REP,30018,0,0,0,0,
Atoka,Lieutenant Governor,Anastasia Pittman,DEM,30018,0,0,0,0,
Atoka,Lieutenant Governor,Ivan Holmes,IND,30018,0,0,0,0,
Atoka,State Auditor,John Yeutter,LIB,30018,0,0,0,0,
Atoka,State Auditor,Cindy Byrd,REP,30018,0,0,0,0,
Atoka,Attorney General,Mike Hunter,REP,30018,0,0,0,0,
Atoka,Attorney General,Mark Myles,DEM,30018,0,0,0,0,
Atoka,State Treasurer,Randy Mcdaniel,REP,30018,0,0,0,0,
Atoka,State Treasurer,Charles De Coune,IND,30018,0,0,0,0,
Atoka,Superintendent of Public Instruction,Joy Hofmeister,REP,30018,0,0,0,0,
Atoka,Superintendent of Public Instruction,John Cox,DEM,30018,0,0,0,0,
Atoka,Superintendent of Public Instruction,Larry Huff,IND,30018,0,0,0,0,
Atoka,Commissioner of Labor,Leslie Osborn,REP,30018,0,0,0,0,
Atoka,Commissioner of Labor,Fred Dorrell,DEM,30018,0,0,0,0,
Atoka,Commissioner of Labor,Brandt Dismukes,IND,30018,0,0,0,0,
Atoka,Insurance Commissioner,Glen Mulready,REP,30018,0,0,0,0,
Atoka,Insurance Commissioner,Kimberly Fobbs,DEM,30018,0,0,0,0,
Atoka,Corporation Commissioner,Bob Anthony,REP,30018,0,0,0,0,
Atoka,Corporation Commissioner,Ashley Nicole Mccray,DEM,30018,0,0,0,0,
Atoka,Corporation Commissioner,Jackie Short,IND,30018,0,0,0,0,
Atoka,U.S. House,Richard Castaldo,LIB,30018,0,0,0,0,2
Atoka,U.S. House,Markwayne Mullin,REP,30018,0,0,0,0,2
Atoka,U.S. House,Jason Nichols,DEM,30018,0,0,0,0,2
Atoka,U.S. House,John Foreman,IND,30018,0,0,0,0,2
Atoka,State House,Justin Humphrey,REP,30018,0,0,0,0,19
Atoka,State House,Lewis Collins,DEM,30018,0,0,0,0,19
Atoka,Governor,Chris Powell,LIB,30019,0,0,3,3,
Atoka,Governor,Kevin Stitt,REP,30019,1,0,17,18,
Atoka,Governor,Drew Edmondson,DEM,30019,0,0,3,3,
Atoka,Lieutenant Governor,Matt Pinnell,REP,30019,1,0,19,20,
Atoka,Lieutenant Governor,Anastasia Pittman,DEM,30019,0,0,1,1,
Atoka,Lieutenant Governor,Ivan Holmes,IND,30019,0,0,3,3,
Atoka,State Auditor,John Yeutter,LIB,30019,0,0,4,4,
Atoka,State Auditor,Cindy Byrd,REP,30019,1,0,19,20,
Atoka,Attorney General,Mike Hunter,REP,30019,1,0,20,21,
Atoka,Attorney General,Mark Myles,DEM,30019,0,0,3,3,
Atoka,State Treasurer,Randy Mcdaniel,REP,30019,1,0,19,20,
Atoka,State Treasurer,Charles De Coune,IND,30019,0,0,4,4,
Atoka,Superintendent of Public Instruction,Joy Hofmeister,REP,30019,1,0,17,18,
Atoka,Superintendent of Public Instruction,John Cox,DEM,30019,0,0,3,3,
Atoka,Superintendent of Public Instruction,Larry Huff,IND,30019,0,0,3,3,
Atoka,Commissioner of Labor,Leslie Osborn,REP,30019,1,0,19,20,
Atoka,Commissioner of Labor,Fred Dorrell,DEM,30019,0,0,2,2,
Atoka,Commissioner of Labor,Brandt Dismukes,IND,30019,0,0,2,2,
Atoka,Insurance Commissioner,Glen Mulready,REP,30019,1,0,21,22,
Atoka,Insurance Commissioner,Kimberly Fobbs,DEM,30019,0,0,2,2,
Atoka,Corporation Commissioner,Bob Anthony,REP,30019,1,0,19,20,
Atoka,Corporation Commissioner,Ashley Nicole Mccray,DEM,30019,0,0,2,2,
Atoka,Corporation Commissioner,Jackie Short,IND,30019,0,0,2,2,
Atoka,U.S. House,Richard Castaldo,LIB,30019,0,0,1,1,2
Atoka,U.S. House,Markwayne Mullin,REP,30019,1,0,20,21,2
Atoka,U.S. House,Jason Nichols,DEM,30019,0,0,1,1,2
Atoka,U.S. House,John Foreman,IND,30019,0,0,1,1,2
Atoka,State Senate,David Bullard,REP,30019,1,0,21,22,6
Atoka,State Senate,Arnold Bourne,DEM,30019,0,0,2,2,6
Atoka,State House,Justin Humphrey,REP,30019,1,0,21,22,19
Atoka,State House,Lewis Collins,DEM,30019,0,0,2,2,19
Beaver,Governor,Chris Powell,LIB,40011,0,0,0,0,
Beaver,Governor,Kevin Stitt,REP,40011,7,10,127,144,
Beaver,Governor,Drew Edmondson,DEM,40011,3,4,9,16,
Beaver,Lieutenant Governor,Matt Pinnell,REP,40011,7,10,130,147,
Beaver,Lieutenant Governor,Anastasia Pittman,DEM,40011,3,4,5,12,
Beaver,Lieutenant Governor,Ivan Holmes,IND,40011,0,0,1,1,
Beaver,State Auditor,John Yeutter,LIB,40011,1,3,7,11,
Beaver,State Auditor,Cindy Byrd,REP,40011,7,11,125,143,
Beaver,Attorney General,Mike Hunter,REP,40011,7,10,131,148,
Beaver,Attorney General,Mark Myles,DEM,40011,3,4,5,12,
Beaver,State Treasurer,Randy Mcdaniel,REP,40011,8,11,132,151,
Beaver,State Treasurer,Charles De Coune,IND,40011,0,3,3,6,
Beaver,Superintendent of Public Instruction,Joy Hofmeister,REP,40011,7,11,122,140,
Beaver,Superintendent of Public Instruction,John Cox,DEM,40011,3,3,7,13,
Beaver,Superintendent of Public Instruction,Larry Huff,IND,40011,0,0,6,6,
Beaver,Commissioner of Labor,Leslie Osborn,REP,40011,7,10,129,146,
Beaver,Commissioner of Labor,Fred Dorrell,DEM,40011,3,4,5,12,
Beaver,Commissioner of Labor,Brandt Dismukes,IND,40011,0,0,2,2,
Beaver,Insurance Commissioner,Glen Mulready,REP,40011,5,12,127,144,
Beaver,Insurance Commissioner,Kimberly Fobbs,DEM,40011,5,2,8,15,
Beaver,Corporation Commissioner,Bob Anthony,REP,40011,5,10,121,136,
Beaver,Corporation Commissioner,Ashley Nicole Mccray,DEM,40011,5,4,11,20,
Beaver,Corporation Commissioner,Jackie Short,IND,40011,0,0,4,4,
Beaver,U.S. House,Frank Lucas,REP,40011,7,10,132,149,3
Beaver,U.S. House,Frankie Robbins,DEM,40011,3,4,4,11,3
Beaver,State House,Kenton Patzkowsky,REP,40011,5,10,119,134,61
Beaver,State House,Ashley Lehnert,DEM,40011,5,4,17,26,61
Beaver,Governor,Chris Powell,LIB,40013,0,0,5,5,
Beaver,Governor,Kevin Stitt,REP,40013,10,4,81,95,
Beaver,Governor,Drew Edmondson,DEM,40013,0,2,4,6,
Beaver,Lieutenant Governor,Matt Pinnell,REP,40013,10,5,83,98,
Beaver,Lieutenant Governor,Anastasia Pittman,DEM,40013,0,1,4,5,
Beaver,Lieutenant Governor,Ivan Holmes,IND,40013,0,0,1,1,
Beaver,State Auditor,John Yeutter,LIB,40013,1,1,3,5,
Beaver,State Auditor,Cindy Byrd,REP,40013,8,5,85,98,
Beaver,Attorney General,Mike Hunter,REP,40013,7,6,86,99,
Beaver,Attorney General,Mark Myles,DEM,40013,1,0,3,4,
Beaver,State Treasurer,Randy Mcdaniel,REP,40013,9,5,84,98,
Beaver,State Treasurer,Charles De Coune,IND,40013,0,1,4,5,
Beaver,Superintendent of Public Instruction,Joy Hofmeister,REP,40013,10,3,74,87,
Beaver,Superintendent of Public Instruction,John Cox,DEM,40013,0,2,8,10,
Beaver,Superintendent of Public Instruction,Larry Huff,IND,40013,0,1,8,9,
Beaver,Commissioner of Labor,Leslie Osborn,REP,40013,9,5,80,94,
Beaver,Commissioner of Labor,Fred Dorrell,DEM,40013,0,0,5,5,
Beaver,Commissioner of Labor,Brandt Dismukes,IND,40013,0,1,3,4,
Beaver,Insurance Commissioner,Glen Mulready,REP,40013,8,6,80,94,
Beaver,Insurance Commissioner,Kimberly Fobbs,DEM,40013,1,0,8,9,
Beaver,Corporation Commissioner,Bob Anthony,REP,40013,6,5,77,88,
Beaver,Corporation Commissioner,Ashley Nicole Mccray,DEM,40013,3,1,4,8,
Beaver,Corporation Commissioner,Jackie Short,IND,40013,0,0,8,8,
Beaver,U.S. House,Frank Lucas,REP,40013,10,6,88,104,3
Beaver,U.S. House,Frankie Robbins,DEM,40013,0,0,2,2,3
Beaver,State House,Kenton Patzkowsky,REP,40013,5,5,68,78,61
Beaver,State House,Ashley Lehnert,DEM,40013,5,1,22,28,61
Beaver,Governor,Chris Powell,LIB,40023,1,7,23,31,
Beaver,Governor,Kevin Stitt,REP,40023,34,101,362,497,
Beaver,Governor,Drew Edmondson,DEM,40023,5,31,86,122,
Beaver,Lieutenant Governor,Matt Pinnell,REP,40023,35,113,397,545,
Beaver,Lieutenant Governor,Anastasia Pittman,DEM,40023,4,23,53,80,
Beaver,Lieutenant Governor,Ivan Holmes,IND,40023,1,3,18,22,
Beaver,State Auditor,John Yeutter,LIB,40023,3,10,47,60,
Beaver,State Auditor,Cindy Byrd,REP,40023,34,121,411,566,
Beaver,Attorney General,Mike Hunter,REP,40023,36,114,408,558,
Beaver,Attorney General,Mark Myles,DEM,40023,3,25,57,85,
Beaver,State Treasurer,Randy Mcdaniel,REP,40023,37,117,403,557,
Beaver,State Treasurer,Charles De Coune,IND,40023,2,14,49,65,
Beaver,Superintendent of Public Instruction,Joy Hofmeister,REP,40023,28,100,346,474,
Beaver,Superintendent of Public Instruction,John Cox,DEM,40023,8,32,69,109,
Beaver,Superintendent of Public Instruction,Larry Huff,IND,40023,3,7,44,54,
Beaver,Commissioner of Labor,Leslie Osborn,REP,40023,35,114,383,532,
Beaver,Commissioner of Labor,Fred Dorrell,DEM,40023,3,22,53,78,
Beaver,Commissioner of Labor,Brandt Dismukes,IND,40023,1,3,26,30,
Beaver,Insurance Commissioner,Glen Mulready,REP,40023,37,112,397,546,
Beaver,Insurance Commissioner,Kimberly Fobbs,DEM,40023,3,26,62,91,
Beaver,Corporation Commissioner,Bob Anthony,REP,40023,35,109,374,518,
Beaver,Corporation Commissioner,Ashley Nicole Mccray,DEM,40023,3,23,65,91,
Beaver,Corporation Commissioner,Jackie Short,IND,40023,2,6,25,33,
Beaver,U.S. House,Frank Lucas,REP,40023,37,115,413,565,3
Beaver,U.S. House,Frankie Robbins,DEM,40023,3,24,54,81,3
Beaver,State House,Kenton Patzkowsky,REP,40023,32,84,309,425,61
Beaver,State House,Ashley Lehnert,DEM,40023,8,54,160,222,61
Beaver,Governor,Chris Powell,LIB,40025,1,0,4,5,
Beaver,Governor,Kevin Stitt,REP,40025,4,9,106,119,
Beaver,Governor,Drew Edmondson,DEM,40025,0,2,27,29,
Beaver,Lieutenant Governor,Matt Pinnell,REP,40025,5,11,105,121,
Beaver,Lieutenant Governor,Anastasia Pittman,DEM,40025,0,0,20,20,
Beaver,Lieutenant Governor,Ivan Holmes,IND,40025,0,0,9,9,
Beaver,State Auditor,John Yeutter,LIB,40025,1,0,14,15,
Beaver,State Auditor,Cindy Byrd,REP,40025,4,11,112,127,
Beaver,Attorney General,Mike Hunter,REP,40025,4,11,109,124,
Beaver,Attorney General,Mark Myles,DEM,40025,1,0,25,26,
Beaver,State Treasurer,Randy Mcdaniel,REP,40025,4,11,109,124,
Beaver,State Treasurer,Charles De Coune,IND,40025,1,0,18,19,
Beaver,Superintendent of Public Instruction,Joy Hofmeister,REP,40025,4,11,103,118,
Beaver,Superintendent of Public Instruction,John Cox,DEM,40025,0,0,24,24,
Beaver,Superintendent of Public Instruction,Larry Huff,IND,40025,1,0,6,7,
Beaver,Commissioner of Labor,Leslie Osborn,REP,40025,5,11,105,121,
Beaver,Commissioner of Labor,Fred Dorrell,DEM,40025,0,0,22,22,
Beaver,Commissioner of Labor,Brandt Dismukes,IND,40025,0,0,5,5,
Beaver,Insurance Commissioner,Glen Mulready,REP,40025,5,11,104,120,
Beaver,Insurance Commissioner,Kimberly Fobbs,DEM,40025,0,0,28,28,
Beaver,Corporation Commissioner,Bob Anthony,REP,40025,5,11,96,112,
Beaver,Corporation Commissioner,Ashley Nicole Mccray,DEM,40025,0,0,27,27,
Beaver,Corporation Commissioner,Jackie Short,IND,40025,0,0,11,11,
Beaver,U.S. House,Frank Lucas,REP,40025,5,12,114,131,3
Beaver,U.S. House,Frankie Robbins,DEM,40025,0,0,23,23,3
Beaver,State House,Kenton Patzkowsky,REP,40025,4,10,92,106,61
Beaver,State House,Ashley Lehnert,DEM,40025,1,2,46,49,61
Beaver,Governor,Chris Powell,LIB,40026,0,0,1,1,
Beaver,Governor,Kevin Stitt,REP,40026,2,4,32,38,
Beaver,Governor,Drew Edmondson,DEM,40026,0,0,6,6,
Beaver,Lieutenant Governor,Matt Pinnell,REP,40026,2,3,33,38,
Beaver,Lieutenant Governor,Anastasia Pittman,DEM,40026,0,1,5,6,
Beaver,Lieutenant Governor,Ivan Holmes,IND,40026,0,0,1,1,
Beaver,State Auditor,John Yeutter,LIB,40026,0,0,2,2,
Beaver,State Auditor,Cindy Byrd,REP,40026,2,4,34,40,
Beaver,Attorney General,Mike Hunter,REP,40026,2,3,31,36,
Beaver,Attorney General,Mark Myles,DEM,40026,0,1,8,9,
Beaver,State Treasurer,Randy Mcdaniel,REP,40026,2,4,32,38,
Beaver,State Treasurer,Charles De Coune,IND,40026,0,0,4,4,
Beaver,Superintendent of Public Instruction,Joy Hofmeister,REP,40026,0,3,25,28,
Beaver,Superintendent of Public Instruction,John Cox,DEM,40026,2,1,10,13,
Beaver,Superintendent of Public Instruction,Larry Huff,IND,40026,0,0,4,4,
Beaver,Commissioner of Labor,Leslie Osborn,REP,40026,2,3,33,38,
Beaver,Commissioner of Labor,Fred Dorrell,DEM,40026,0,1,5,6,
Beaver,Commissioner of Labor,Brandt Dismukes,IND,40026,0,0,0,0,
Beaver,Insurance Commissioner,Glen Mulready,REP,40026,2,3,34,39,
Beaver,Insurance Commissioner,Kimberly Fobbs,DEM,40026,0,1,5,6,
Beaver,Corporation Commissioner,Bob Anthony,REP,40026,2,3,31,36,
Beaver,Corporation Commissioner,Ashley Nicole Mccray,DEM,40026,0,1,4,5,
Beaver,Corporation Commissioner,Jackie Short,IND,40026,0,0,3,3,
Beaver,U.S. House,Frank Lucas,REP,40026,2,3,33,38,3
Beaver,U.S. House,Frankie Robbins,DEM,40026,0,1,6,7,3
Beaver,State House,Kenton Patzkowsky,REP,40026,2,1,26,29,61
Beaver,State House,Ashley Lehnert,DEM,40026,0,3,12,15,61
Beaver,Governor,Chris Powell,LIB,40031,0,2,4,6,
Beaver,Governor,Kevin Stitt,REP,40031,5,14,167,186,
Beaver,Governor,Drew Edmondson,DEM,40031,2,1,16,19,
Beaver,Lieutenant Governor,Matt Pinnell,REP,40031,6,15,169,190,
Beaver,Lieutenant Governor,Anastasia Pittman,DEM,40031,0,1,11,12,
Beaver,Lieutenant Governor,Ivan Holmes,IND,40031,0,1,6,7,
Beaver,State Auditor,John Yeutter,LIB,40031,0,1,9,10,
Beaver,State Auditor,Cindy Byrd,REP,40031,6,16,172,194,
Beaver,Attorney General,Mike Hunter,REP,40031,6,15,172,193,
Beaver,Attorney General,Mark Myles,DEM,40031,0,2,10,12,
Beaver,State Treasurer,Randy Mcdaniel,REP,40031,6,16,166,188,
Beaver,State Treasurer,Charles De Coune,IND,40031,0,1,13,14,
Beaver,Superintendent of Public Instruction,Joy Hofmeister,REP,40031,6,14,148,168,
Beaver,Superintendent of Public Instruction,John Cox,DEM,40031,0,2,24,26,
Beaver,Superintendent of Public Instruction,Larry Huff,IND,40031,0,1,12,13,
Beaver,Commissioner of Labor,Leslie Osborn,REP,40031,5,15,167,187,
Beaver,Commissioner of Labor,Fred Dorrell,DEM,40031,1,1,9,11,
Beaver,Commissioner of Labor,Brandt Dismukes,IND,40031,0,1,5,6,
Beaver,Insurance Commissioner,Glen Mulready,REP,40031,3,16,165,184,
Beaver,Insurance Commissioner,Kimberly Fobbs,DEM,40031,2,1,15,18,
Beaver,Corporation Commissioner,Bob Anthony,REP,40031,5,17,161,183,
Beaver,Corporation Commissioner,Ashley Nicole Mccray,DEM,40031,1,0,14,15,
Beaver,Corporation Commissioner,Jackie Short,IND,40031,0,0,6,6,
Beaver,U.S. House,Frank Lucas,REP,40031,7,15,174,196,3
Beaver,U.S. House,Frankie Robbins,DEM,40031,0,2,14,16,3
Beaver,State House,Kenton Patzkowsky,REP,40031,6,10,143,159,61
Beaver,State House,Ashley Lehnert,DEM,40031,1,7,44,52,61
Beaver,Governor,Chris Powell,LIB,40033,0,0,25,25,
Beaver,Governor,Kevin Stitt,REP,40033,20,16,339,375,
Beaver,Governor,Drew Edmondson,DEM,40033,2,2,70,74,
Beaver,Lieutenant Governor,Matt Pinnell,REP,40033,19,18,372,409,
Beaver,Lieutenant Governor,Anastasia Pittman,DEM,40033,3,0,48,51,
Beaver,Lieutenant Governor,Ivan Holmes,IND,40033,0,0,10,10,
Beaver,State Auditor,John Yeutter,LIB,40033,1,1,40,42,
Beaver,State Auditor,Cindy Byrd,REP,40033,21,17,388,426,
Beaver,Attorney General,Mike Hunter,REP,40033,19,18,380,417,
Beaver,Attorney General,Mark Myles,DEM,40033,3,0,49,52,
Beaver,State Treasurer,Randy Mcdaniel,REP,40033,21,18,377,416,
Beaver,State Treasurer,Charles De Coune,IND,40033,1,0,49,50,
Beaver,Superintendent of Public Instruction,Joy Hofmeister,REP,40033,18,15,333,366,
Beaver,Superintendent of Public Instruction,John Cox,DEM,40033,3,0,66,69,
Beaver,Superintendent of Public Instruction,Larry Huff,IND,40033,0,3,29,32,
Beaver,Commissioner of Labor,Leslie Osborn,REP,40033,19,18,368,405,
Beaver,Commissioner of Labor,Fred Dorrell,DEM,40033,3,0,42,45,
Beaver,Commissioner of Labor,Brandt Dismukes,IND,40033,0,0,17,17,
Beaver,Insurance Commissioner,Glen Mulready,REP,40033,19,16,370,405,
Beaver,Insurance Commissioner,Kimberly Fobbs,DEM,40033,3,2,56,61,
Beaver,Corporation Commissioner,Bob Anthony,REP,40033,21,16,351,388,
Beaver,Corporation Commissioner,Ashley Nicole Mccray,DEM,40033,1,1,49,51,
Beaver,Corporation Commissioner,Jackie Short,IND,40033,0,0,28,28,
Beaver,U.S. House,Frank Lucas,REP,40033,19,18,388,425,3
Beaver,U.S. House,Frankie Robbins,DEM,40033,3,0,44,47,3
Beaver,State House,Kenton Patzkowsky,REP,40033,16,14,263,293,61
Beaver,State House,Ashley Lehnert,DEM,40033,6,4,169,179,61
Beckham,Governor,Chris Powell,LIB,50111,0,5,25,30,
Beckham,Governor,Kevin Stitt,REP,50111,8,57,346,411,
Beckham,Governor,Drew Edmondson,DEM,50111,8,28,131,167,
Beckham,Lieutenant Governor,Matt Pinnell,REP,50111,9,62,379,450,
Beckham,Lieutenant Governor,Anastasia Pittman,DEM,50111,7,25,101,133,
Beckham,Lieutenant Governor,Ivan Holmes,IND,50111,1,3,19,23,
Beckham,State Auditor,John Yeutter,LIB,50111,4,12,73,89,
Beckham,State Auditor,Cindy Byrd,REP,50111,10,68,403,481,
Beckham,Attorney General,Mike Hunter,REP,50111,7,62,397,466,
Beckham,Attorney General,Mark Myles,DEM,50111,10,26,100,136,
Beckham,State Treasurer,Randy Mcdaniel,REP,50111,9,65,412,486,
Beckham,State Treasurer,Charles De Coune,IND,50111,5,15,70,90,
Beckham,Superintendent of Public Instruction,Joy Hofmeister,REP,50111,7,53,372,432,
Beckham,Superintendent of Public Instruction,John Cox,DEM,50111,10,30,88,128,
Beckham,Superintendent of Public Instruction,Larry Huff,IND,50111,0,7,35,42,
Beckham,Commissioner of Labor,Leslie Osborn,REP,50111,8,63,374,445,
Beckham,Commissioner of Labor,Fred Dorrell,DEM,50111,9,20,99,128,
Beckham,Commissioner of Labor,Brandt Dismukes,IND,50111,0,6,14,20,
Beckham,Insurance Commissioner,Glen Mulready,REP,50111,10,61,374,445,
Beckham,Insurance Commissioner,Kimberly Fobbs,DEM,50111,7,26,117,150,
Beckham,Corporation Commissioner,Bob Anthony,REP,50111,8,60,364,432,
Beckham,Corporation Commissioner,Ashley Nicole Mccray,DEM,50111,8,23,98,129,
Beckham,Corporation Commissioner,Jackie Short,IND,50111,1,5,32,38,
Beckham,U.S. House,Frank Lucas,REP,50111,8,68,420,496,3
Beckham,U.S. House,Frankie Robbins,DEM,50111,9,21,79,109,3
Beckham,State House,Todd Russ,REP,50111,6,43,280,329,55
Beckham,State House,Dennis Dugger,DEM,50111,11,47,217,275,55
Beckham,Governor,Chris Powell,LIB,50112,0,0,9,9,
Beckham,Governor,Kevin Stitt,REP,50112,6,12,189,207,
Beckham,Governor,Drew Edmondson,DEM,50112,2,10,47,59,
Beckham,Lieutenant Governor,Matt Pinnell,REP,50112,6,14,200,220,
Beckham,Lieutenant Governor,Anastasia Pittman,DEM,50112,1,7,32,40,
Beckham,Lieutenant Governor,Ivan Holmes,IND,50112,1,0,13,14,
Beckham,State Auditor,John Yeutter,LIB,50112,0,4,30,34,
Beckham,State Auditor,Cindy Byrd,REP,50112,7,16,206,229,
Beckham,Attorney General,Mike Hunter,REP,50112,6,14,198,218,
Beckham,Attorney General,Mark Myles,DEM,50112,1,7,47,55,
Beckham,State Treasurer,Randy Mcdaniel,REP,50112,7,15,205,227,
Beckham,State Treasurer,Charles De Coune,IND,50112,0,4,33,37,
Beckham,Superintendent of Public Instruction,Joy Hofmeister,REP,50112,6,14,177,197,
Beckham,Superintendent of Public Instruction,John Cox,DEM,50112,1,6,45,52,
Beckham,Superintendent of Public Instruction,Larry Huff,IND,50112,1,1,23,25,
Beckham,Commissioner of Labor,Leslie Osborn,REP,50112,7,15,181,203,
Beckham,Commissioner of Labor,Fred Dorrell,DEM,50112,1,6,47,54,
Beckham,Commissioner of Labor,Brandt Dismukes,IND,50112,0,0,15,15,
Beckham,Insurance Commissioner,Glen Mulready,REP,50112,7,13,196,216,
Beckham,Insurance Commissioner,Kimberly Fobbs,DEM,50112,1,8,45,54,
Beckham,Corporation Commissioner,Bob Anthony,REP,50112,6,16,175,197,
Beckham,Corporation Commissioner,Ashley Nicole Mccray,DEM,50112,1,4,52,57,
Beckham,Corporation Commissioner,Jackie Short,IND,50112,1,2,17,20,
Beckham,U.S. House,Frank Lucas,REP,50112,4,19,213,236,3
Beckham,U.S. House,Frankie Robbins,DEM,50112,4,3,32,39,3
Beckham,State House,Todd Russ,REP,50112,7,14,173,194,55
Beckham,State House,Dennis Dugger,DEM,50112,1,8,71,80,55
Beckham,Governor,Chris Powell,LIB,50115,0,3,1,4,
Beckham,Governor,Kevin Stitt,REP,50115,4,38,58,100,
Beckham,Governor,Drew Edmondson,DEM,50115,1,3,18,22,
Beckham,Lieutenant Governor,Matt Pinnell,REP,50115,4,39,59,102,
Beckham,Lieutenant Governor,Anastasia Pittman,DEM,50115,0,4,17,21,
Beckham,Lieutenant Governor,Ivan Holmes,IND,50115,0,1,1,2,
Beckham,State Auditor,John Yeutter,LIB,50115,0,2,10,12,
Beckham,State Auditor,Cindy Byrd,REP,50115,4,41,61,106,
Beckham,Attorney General,Mike Hunter,REP,50115,3,34,58,95,
Beckham,Attorney General,Mark Myles,DEM,50115,1,10,19,30,
Beckham,State Treasurer,Randy Mcdaniel,REP,50115,4,39,64,107,
Beckham,State Treasurer,Charles De Coune,IND,50115,0,5,5,10,
Beckham,Superintendent of Public Instruction,Joy Hofmeister,REP,50115,4,34,58,96,
Beckham,Superintendent of Public Instruction,John Cox,DEM,50115,1,3,15,19,
Beckham,Superintendent of Public Instruction,Larry Huff,IND,50115,0,6,3,9,
Beckham,Commissioner of Labor,Leslie Osborn,REP,50115,3,37,54,94,
Beckham,Commissioner of Labor,Fred Dorrell,DEM,50115,1,5,21,27,
Beckham,Commissioner of Labor,Brandt Dismukes,IND,50115,0,2,0,2,
Beckham,Insurance Commissioner,Glen Mulready,REP,50115,4,41,55,100,
Beckham,Insurance Commissioner,Kimberly Fobbs,DEM,50115,1,3,21,25,
Beckham,Corporation Commissioner,Bob Anthony,REP,50115,3,34,49,86,
Beckham,Corporation Commissioner,Ashley Nicole Mccray,DEM,50115,2,4,19,25,
Beckham,Corporation Commissioner,Jackie Short,IND,50115,0,5,8,13,
Beckham,U.S. House,Frank Lucas,REP,50115,5,39,61,105,3
Beckham,U.S. House,Frankie Robbins,DEM,50115,0,5,16,21,3
Beckham,State House,Todd Russ,REP,50115,4,22,39,65,55
Beckham,State House,Dennis Dugger,DEM,50115,1,21,36,58,55
Beckham,Governor,Chris Powell,LIB,50141,0,0,21,21,
Beckham,Governor,Kevin Stitt,REP,50141,14,32,349,395,
Beckham,Governor,Drew Edmondson,DEM,50141,8,3,134,145,
Beckham,Lieutenant Governor,Matt Pinnell,REP,50141,14,34,374,422,
Beckham,Lieutenant Governor,Anastasia Pittman,DEM,50141,5,2,105,112,
Beckham,Lieutenant Governor,Ivan Holmes,IND,50141,1,0,22,23,
Beckham,State Auditor,John Yeutter,LIB,50141,3,2,80,85,
Beckham,State Auditor,Cindy Byrd,REP,50141,18,34,406,458,
Beckham,Attorney General,Mike Hunter,REP,50141,16,35,392,443,
Beckham,Attorney General,Mark Myles,DEM,50141,5,1,105,111,
Beckham,State Treasurer,Randy Mcdaniel,REP,50141,16,34,408,458,
Beckham,State Treasurer,Charles De Coune,IND,50141,6,2,78,86,
Beckham,Superintendent of Public Instruction,Joy Hofmeister,REP,50141,16,34,365,415,
Beckham,Superintendent of Public Instruction,John Cox,DEM,50141,4,1,104,109,
Beckham,Superintendent of Public Instruction,Larry Huff,IND,50141,2,1,30,33,
Beckham,Commissioner of Labor,Leslie Osborn,REP,50141,14,33,382,429,
Beckham,Commissioner of Labor,Fred Dorrell,DEM,50141,6,3,94,103,
Beckham,Commissioner of Labor,Brandt Dismukes,IND,50141,1,0,21,22,
Beckham,Insurance Commissioner,Glen Mulready,REP,50141,14,34,379,427,
Beckham,Insurance Commissioner,Kimberly Fobbs,DEM,50141,8,2,116,126,
Beckham,Corporation Commissioner,Bob Anthony,REP,50141,13,33,357,403,
Beckham,Corporation Commissioner,Ashley Nicole Mccray,DEM,50141,7,2,110,119,
Beckham,Corporation Commissioner,Jackie Short,IND,50141,2,1,33,36,
Beckham,U.S. House,Frank Lucas,REP,50141,15,32,406,453,3
Beckham,U.S. House,Frankie Robbins,DEM,50141,7,4,97,108,3
Beckham,State House,Todd Russ,REP,50141,10,25,230,265,55
Beckham,State House,Dennis Dugger,DEM,50141,12,11,275,298,55
Beckham,Governor,Chris Powell,LIB,50231,0,1,15,16,
Beckham,Governor,Kevin Stitt,REP,50231,5,8,208,221,
Beckham,Governor,Drew Edmondson,DEM,50231,2,2,54,58,
Beckham,Lieutenant Governor,Matt Pinnell,REP,50231,5,8,222,235,
Beckham,Lieutenant Governor,Anastasia Pittman,DEM,50231,2,3,44,49,
Beckham,Lieutenant Governor,Ivan Holmes,IND,50231,0,0,9,9,
Beckham,State Auditor,John Yeutter,LIB,50231,0,1,36,37,
Beckham,State Auditor,Cindy Byrd,REP,50231,7,10,234,251,
Beckham,Attorney General,Mike Hunter,REP,50231,6,8,223,237,
Beckham,Attorney General,Mark Myles,DEM,50231,1,3,52,56,
Beckham,State Treasurer,Randy Mcdaniel,REP,50231,6,9,235,250,
Beckham,State Treasurer,Charles De Coune,IND,50231,1,2,36,39,
Beckham,Superintendent of Public Instruction,Joy Hofmeister,REP,50231,6,6,220,232,
Beckham,Superintendent of Public Instruction,John Cox,DEM,50231,1,5,37,43,
Beckham,Superintendent of Public Instruction,Larry Huff,IND,50231,0,0,20,20,
Beckham,Commissioner of Labor,Leslie Osborn,REP,50231,7,8,217,232,
Beckham,Commissioner of Labor,Fred Dorrell,DEM,50231,0,3,44,47,
Beckham,Commissioner of Labor,Brandt Dismukes,IND,50231,0,0,13,13,
Beckham,Insurance Commissioner,Glen Mulready,REP,50231,3,7,220,230,
Beckham,Insurance Commissioner,Kimberly Fobbs,DEM,50231,4,4,52,60,
Beckham,Corporation Commissioner,Bob Anthony,REP,50231,5,7,209,221,
Beckham,Corporation Commissioner,Ashley Nicole Mccray,DEM,50231,2,3,50,55,
Beckham,Corporation Commissioner,Jackie Short,IND,50231,0,1,15,16,
Beckham,U.S. House,Frank Lucas,REP,50231,7,8,238,253,3
Beckham,U.S. House,Frankie Robbins,DEM,50231,0,3,38,41,3
Beckham,Governor,Chris Powell,LIB,50232,0,0,2,2,
Beckham,Governor,Kevin Stitt,REP,50232,4,1,60,65,
Beckham,Governor,Drew Edmondson,DEM,50232,0,1,14,15,
Beckham,Lieutenant Governor,Matt Pinnell,REP,50232,4,1,65,70,
Beckham,Lieutenant Governor,Anastasia Pittman,DEM,50232,0,1,8,9,
Beckham,Lieutenant Governor,Ivan Holmes,IND,50232,0,0,2,2,
Beckham,State Auditor,John Yeutter,LIB,50232,0,0,8,8,
Beckham,State Auditor,Cindy Byrd,REP,50232,4,2,63,69,
Beckham,Attorney General,Mike Hunter,REP,50232,4,2,65,71,
Beckham,Attorney General,Mark Myles,DEM,50232,0,0,11,11,
Beckham,State Treasurer,Randy Mcdaniel,REP,50232,4,2,64,70,
Beckham,State Treasurer,Charles De Coune,IND,50232,0,0,8,8,
Beckham,Superintendent of Public Instruction,Joy Hofmeister,REP,50232,4,1,54,59,
Beckham,Superintendent of Public Instruction,John Cox,DEM,50232,0,0,13,13,
Beckham,Superintendent of Public Instruction,Larry Huff,IND,50232,0,1,9,10,
Beckham,Commissioner of Labor,Leslie Osborn,REP,50232,4,2,65,71,
Beckham,Commissioner of Labor,Fred Dorrell,DEM,50232,0,0,7,7,
Beckham,Commissioner of Labor,Brandt Dismukes,IND,50232,0,0,2,2,
Beckham,Insurance Commissioner,Glen Mulready,REP,50232,4,1,61,66,
Beckham,Insurance Commissioner,Kimberly Fobbs,DEM,50232,0,1,12,13,
Beckham,Corporation Commissioner,Bob Anthony,REP,50232,4,1,51,56,
Beckham,Corporation Commissioner,Ashley Nicole Mccray,DEM,50232,0,0,16,16,
Beckham,Corporation Commissioner,Jackie Short,IND,50232,0,1,8,9,
Beckham,U.S. House,Frank Lucas,REP,50232,4,2,65,71,3
Beckham,U.S. House,Frankie Robbins,DEM,50232,0,0,11,11,3
Beckham,State House,Todd Russ,REP,50232,2,1,36,39,55
Beckham,State House,Dennis Dugger,DEM,50232,2,1,40,43,55
Beckham,Governor,Chris Powell,LIB,50235,0,1,48,49,
Beckham,Governor,Kevin Stitt,REP,50235,27,58,828,913,
Beckham,Governor,Drew Edmondson,DEM,50235,12,27,284,323,
Beckham,Lieutenant Governor,Matt Pinnell,REP,50235,31,62,905,998,
Beckham,Lieutenant Governor,Anastasia Pittman,DEM,50235,6,24,204,234,
Beckham,Lieutenant Governor,Ivan Holmes,IND,50235,3,1,44,48,
Beckham,State Auditor,John Yeutter,LIB,50235,6,11,177,194,
Beckham,State Auditor,Cindy Byrd,REP,50235,34,72,945,1051,
Beckham,Attorney General,Mike Hunter,REP,50235,32,67,915,1014,
Beckham,Attorney General,Mark Myles,DEM,50235,8,19,233,260,
Beckham,State Treasurer,Randy Mcdaniel,REP,50235,32,70,928,1030,
Beckham,State Treasurer,Charles De Coune,IND,50235,8,13,193,214,
Beckham,Superintendent of Public Instruction,Joy Hofmeister,REP,50235,31,59,828,918,
Beckham,Superintendent of Public Instruction,John Cox,DEM,50235,5,24,207,236,
Beckham,Superintendent of Public Instruction,Larry Huff,IND,50235,4,4,117,125,
Beckham,Commissioner of Labor,Leslie Osborn,REP,50235,33,71,880,984,
Beckham,Commissioner of Labor,Fred Dorrell,DEM,50235,4,15,210,229,
Beckham,Commissioner of Labor,Brandt Dismukes,IND,50235,2,1,50,53,
Beckham,Insurance Commissioner,Glen Mulready,REP,50235,32,63,881,976,
Beckham,Insurance Commissioner,Kimberly Fobbs,DEM,50235,8,23,263,294,
Beckham,Corporation Commissioner,Bob Anthony,REP,50235,32,60,845,937,
Beckham,Corporation Commissioner,Ashley Nicole Mccray,DEM,50235,4,26,234,264,
Beckham,Corporation Commissioner,Jackie Short,IND,50235,4,1,74,79,
Beckham,U.S. House,Frank Lucas,REP,50235,36,70,962,1068,3
Beckham,U.S. House,Frankie Robbins,DEM,50235,4,17,201,222,3
Beckham,State House,Todd Russ,REP,50235,24,42,593,659,55
Beckham,State House,Dennis Dugger,DEM,50235,15,44,567,626,55
Beckham,Governor,Chris Powell,LIB,50242,0,0,15,15,
Beckham,Governor,Kevin Stitt,REP,50242,4,9,152,165,
Beckham,Governor,Drew Edmondson,DEM,50242,1,2,44,47,
Beckham,Lieutenant Governor,Matt Pinnell,REP,50242,4,9,158,171,
Beckham,Lieutenant Governor,Anastasia Pittman,DEM,50242,0,2,44,46,
Beckham,Lieutenant Governor,Ivan Holmes,IND,50242,1,0,7,8,
Beckham,State Auditor,John Yeutter,LIB,50242,0,1,25,26,
Beckham,State Auditor,Cindy Byrd,REP,50242,5,9,170,184,
Beckham,Attorney General,Mike Hunter,REP,50242,5,9,163,177,
Beckham,Attorney General,Mark Myles,DEM,50242,0,2,42,44,
Beckham,State Treasurer,Randy Mcdaniel,REP,50242,5,10,164,179,
Beckham,State Treasurer,Charles De Coune,IND,50242,0,0,30,30,
Beckham,Superintendent of Public Instruction,Joy Hofmeister,REP,50242,4,8,162,174,
Beckham,Superintendent of Public Instruction,John Cox,DEM,50242,0,2,32,34,
Beckham,Superintendent of Public Instruction,Larry Huff,IND,50242,1,1,16,18,
Beckham,Commissioner of Labor,Leslie Osborn,REP,50242,5,9,162,176,
Beckham,Commissioner of Labor,Fred Dorrell,DEM,50242,0,2,37,39,
Beckham,Commissioner of Labor,Brandt Dismukes,IND,50242,0,0,8,8,
Beckham,Insurance Commissioner,Glen Mulready,REP,50242,4,7,157,168,
Beckham,Insurance Commissioner,Kimberly Fobbs,DEM,50242,1,4,53,58,
Beckham,Corporation Commissioner,Bob Anthony,REP,50242,5,9,150,164,
Beckham,Corporation Commissioner,Ashley Nicole Mccray,DEM,50242,0,2,53,55,
Beckham,Corporation Commissioner,Jackie Short,IND,50242,0,0,7,7,
Beckham,U.S. House,Frank Lucas,REP,50242,5,9,172,186,3
Beckham,U.S. House,Frankie Robbins,DEM,50242,0,2,37,39,3
Beckham,State House,Todd Russ,REP,50242,4,6,98,108,55
Beckham,State House,Dennis Dugger,DEM,50242,1,5,110,116,55
Beckham,Governor,Chris Powell,LIB,50320,0,1,27,28,
Beckham,Governor,Kevin Stitt,REP,50320,10,15,231,256,
Beckham,Governor,Drew Edmondson,DEM,50320,3,4,74,81,
Beckham,Lieutenant Governor,Matt Pinnell,REP,50320,10,16,244,270,
Beckham,Lieutenant Governor,Anastasia Pittman,DEM,50320,3,4,65,72,
Beckham,Lieutenant Governor,Ivan Holmes,IND,50320,0,0,14,14,
Beckham,State Auditor,John Yeutter,LIB,50320,2,2,53,57,
Beckham,State Auditor,Cindy Byrd,REP,50320,11,18,258,287,
Beckham,Attorney General,Mike Hunter,REP,50320,10,17,248,275,
Beckham,Attorney General,Mark Myles,DEM,50320,3,3,73,79,
Beckham,State Treasurer,Randy Mcdaniel,REP,50320,12,17,259,288,
Beckham,State Treasurer,Charles De Coune,IND,50320,1,3,49,53,
Beckham,Superintendent of Public Instruction,Joy Hofmeister,REP,50320,11,18,222,251,
Beckham,Superintendent of Public Instruction,John Cox,DEM,50320,2,1,73,76,
Beckham,Superintendent of Public Instruction,Larry Huff,IND,50320,0,1,33,34,
Beckham,Commissioner of Labor,Leslie Osborn,REP,50320,11,17,237,265,
Beckham,Commissioner of Labor,Fred Dorrell,DEM,50320,2,3,73,78,
Beckham,Commissioner of Labor,Brandt Dismukes,IND,50320,0,0,14,14,
Beckham,Insurance Commissioner,Glen Mulready,REP,50320,10,16,243,269,
Beckham,Insurance Commissioner,Kimberly Fobbs,DEM,50320,3,4,81,88,
Beckham,Corporation Commissioner,Bob Anthony,REP,50320,10,17,222,249,
Beckham,Corporation Commissioner,Ashley Nicole Mccray,DEM,50320,2,1,75,78,
Beckham,Corporation Commissioner,Jackie Short,IND,50320,1,2,27,30,
Beckham,U.S. House,Frank Lucas,REP,50320,11,18,267,296,3
Beckham,U.S. House,Frankie Robbins,DEM,50320,2,2,61,65,3
Beckham,State House,Todd Russ,REP,50320,10,14,186,210,55
Beckham,State House,Dennis Dugger,DEM,50320,3,6,142,151,55
Beckham,Governor,Chris Powell,LIB,50330,0,2,19,21,
Beckham,Governor,Kevin Stitt,REP,50330,10,22,208,240,
Beckham,Governor,Drew Edmondson,DEM,50330,0,3,42,45,
Beckham,Lieutenant Governor,Matt Pinnell,REP,50330,10,24,231,265,
Beckham,Lieutenant Governor,Anastasia Pittman,DEM,50330,0,3,33,36,
Beckham,Lieutenant Governor,Ivan Holmes,IND,50330,0,0,6,6,
Beckham,State Auditor,John Yeutter,LIB,50330,1,1,29,31,
Beckham,State Auditor,Cindy Byrd,REP,50330,9,24,240,273,
Beckham,Attorney General,Mike Hunter,REP,50330,9,24,233,266,
Beckham,Attorney General,Mark Myles,DEM,50330,1,3,36,40,
Beckham,State Treasurer,Randy Mcdaniel,REP,50330,10,24,248,282,
Beckham,State Treasurer,Charles De Coune,IND,50330,0,1,21,22,
Beckham,Superintendent of Public Instruction,Joy Hofmeister,REP,50330,8,23,219,250,
Beckham,Superintendent of Public Instruction,John Cox,DEM,50330,1,4,26,31,
Beckham,Superintendent of Public Instruction,Larry Huff,IND,50330,1,0,22,23,
Beckham,Commissioner of Labor,Leslie Osborn,REP,50330,10,23,233,266,
Beckham,Commissioner of Labor,Fred Dorrell,DEM,50330,0,4,26,30,
Beckham,Commissioner of Labor,Brandt Dismukes,IND,50330,0,0,11,11,
Beckham,Insurance Commissioner,Glen Mulready,REP,50330,10,24,230,264,
Beckham,Insurance Commissioner,Kimberly Fobbs,DEM,50330,0,3,36,39,
Beckham,Corporation Commissioner,Bob Anthony,REP,50330,9,21,227,257,
Beckham,Corporation Commissioner,Ashley Nicole Mccray,DEM,50330,1,5,30,36,
Beckham,Corporation Commissioner,Jackie Short,IND,50330,0,1,10,11,
Beckham,U.S. House,Frank Lucas,REP,50330,10,24,241,275,3
Beckham,U.S. House,Frankie Robbins,DEM,50330,0,3,29,32,3
Beckham,State House,Todd Russ,REP,50330,8,17,145,170,55
Beckham,State House,Dennis Dugger,DEM,50330,2,10,125,137,55
Beckham,Governor,Chris Powell,LIB,50332,0,1,17,18,
Beckham,Governor,Kevin Stitt,REP,50332,16,22,513,551,
Beckham,Governor,Drew Edmondson,DEM,50332,9,7,185,201,
Beckham,Lieutenant Governor,Matt Pinnell,REP,50332,20,22,557,599,
Beckham,Lieutenant Governor,Anastasia Pittman,DEM,50332,4,8,139,151,
Beckham,Lieutenant Governor,Ivan Holmes,IND,50332,1,0,15,16,
Beckham,State Auditor,John Yeutter,LIB,50332,2,3,85,90,
Beckham,State Auditor,Cindy Byrd,REP,50332,22,26,612,660,
Beckham,Attorney General,Mike Hunter,REP,50332,21,22,584,627,
Beckham,Attorney General,Mark Myles,DEM,50332,4,8,126,138,
Beckham,State Treasurer,Randy Mcdaniel,REP,50332,20,27,602,649,
Beckham,State Treasurer,Charles De Coune,IND,50332,2,2,90,94,
Beckham,Superintendent of Public Instruction,Joy Hofmeister,REP,50332,18,22,518,558,
Beckham,Superintendent of Public Instruction,John Cox,DEM,50332,7,7,131,145,
Beckham,Superintendent of Public Instruction,Larry Huff,IND,50332,0,1,57,58,
Beckham,Commissioner of Labor,Leslie Osborn,REP,50332,16,25,547,588,
Beckham,Commissioner of Labor,Fred Dorrell,DEM,50332,9,5,129,143,
Beckham,Commissioner of Labor,Brandt Dismukes,IND,50332,0,0,26,26,
Beckham,Insurance Commissioner,Glen Mulready,REP,50332,17,21,555,593,
Beckham,Insurance Commissioner,Kimberly Fobbs,DEM,50332,7,9,147,163,
Beckham,Corporation Commissioner,Bob Anthony,REP,50332,17,19,530,566,
Beckham,Corporation Commissioner,Ashley Nicole Mccray,DEM,50332,6,9,136,151,
Beckham,Corporation Commissioner,Jackie Short,IND,50332,2,2,42,46,
Beckham,U.S. House,Frank Lucas,REP,50332,21,26,604,651,3
Beckham,U.S. House,Frankie Robbins,DEM,50332,4,4,110,118,3
Beckham,Governor,Chris Powell,LIB,50333,2,0,27,29,
Beckham,Governor,Kevin Stitt,REP,50333,24,23,385,432,
Beckham,Governor,Drew Edmondson,DEM,50333,12,8,177,197,
Beckham,Lieutenant Governor,Matt Pinnell,REP,50333,28,23,436,487,
Beckham,Lieutenant Governor,Anastasia Pittman,DEM,50333,9,6,137,152,
Beckham,Lieutenant Governor,Ivan Holmes,IND,50333,1,2,18,21,
Beckham,State Auditor,John Yeutter,LIB,50333,4,4,111,119,
Beckham,State Auditor,Cindy Byrd,REP,50333,31,27,454,512,
Beckham,Attorney General,Mike Hunter,REP,50333,30,23,434,487,
Beckham,Attorney General,Mark Myles,DEM,50333,8,8,155,171,
Beckham,State Treasurer,Randy Mcdaniel,REP,50333,30,26,467,523,
Beckham,State Treasurer,Charles De Coune,IND,50333,6,5,96,107,
Beckham,Superintendent of Public Instruction,Joy Hofmeister,REP,50333,29,23,411,463,
Beckham,Superintendent of Public Instruction,John Cox,DEM,50333,7,7,134,148,
Beckham,Superintendent of Public Instruction,Larry Huff,IND,50333,2,1,44,47,
Beckham,Commissioner of Labor,Leslie Osborn,REP,50333,29,26,425,480,
Beckham,Commissioner of Labor,Fred Dorrell,DEM,50333,7,5,134,146,
Beckham,Commissioner of Labor,Brandt Dismukes,IND,50333,2,0,27,29,
Beckham,Insurance Commissioner,Glen Mulready,REP,50333,28,23,424,475,
Beckham,Insurance Commissioner,Kimberly Fobbs,DEM,50333,10,8,159,177,
Beckham,Corporation Commissioner,Bob Anthony,REP,50333,24,23,403,450,
Beckham,Corporation Commissioner,Ashley Nicole Mccray,DEM,50333,11,6,148,165,
Beckham,Corporation Commissioner,Jackie Short,IND,50333,3,1,38,42,
Beckham,U.S. House,Frank Lucas,REP,50333,30,27,456,513,3
Beckham,U.S. House,Frankie Robbins,DEM,50333,8,4,134,146,3
Beckham,Governor,Chris Powell,LIB,50343,0,0,6,6,
Beckham,Governor,Kevin Stitt,REP,50343,4,20,81,105,
Beckham,Governor,Drew Edmondson,DEM,50343,4,13,19,36,
Beckham,Lieutenant Governor,Matt Pinnell,REP,50343,4,19,89,112,
Beckham,Lieutenant Governor,Anastasia Pittman,DEM,50343,4,13,14,31,
Beckham,Lieutenant Governor,Ivan Holmes,IND,50343,0,0,3,3,
Beckham,State Auditor,John Yeutter,LIB,50343,1,5,11,17,
Beckham,State Auditor,Cindy Byrd,REP,50343,5,25,90,120,
Beckham,Attorney General,Mike Hunter,REP,50343,4,18,91,113,
Beckham,Attorney General,Mark Myles,DEM,50343,4,14,14,32,
Beckham,State Treasurer,Randy Mcdaniel,REP,50343,4,21,91,116,
Beckham,State Treasurer,Charles De Coune,IND,50343,2,8,11,21,
Beckham,Superintendent of Public Instruction,Joy Hofmeister,REP,50343,4,20,89,113,
Beckham,Superintendent of Public Instruction,John Cox,DEM,50343,4,11,10,25,
Beckham,Superintendent of Public Instruction,Larry Huff,IND,50343,0,1,6,7,
Beckham,Commissioner of Labor,Leslie Osborn,REP,50343,5,18,86,109,
Beckham,Commissioner of Labor,Fred Dorrell,DEM,50343,3,12,16,31,
Beckham,Commissioner of Labor,Brandt Dismukes,IND,50343,0,2,2,4,
Beckham,Insurance Commissioner,Glen Mulready,REP,50343,4,21,91,116,
Beckham,Insurance Commissioner,Kimberly Fobbs,DEM,50343,4,11,14,29,
Beckham,Corporation Commissioner,Bob Anthony,REP,50343,5,23,88,116,
Beckham,Corporation Commissioner,Ashley Nicole Mccray,DEM,50343,3,8,14,25,
Beckham,Corporation Commissioner,Jackie Short,IND,50343,0,1,5,6,
Beckham,U.S. House,Frank Lucas,REP,50343,5,21,91,117,3
Beckham,U.S. House,Frankie Robbins,DEM,50343,3,12,16,31,3
Beckham,State House,Todd Russ,REP,50343,4,16,74,94,55
Beckham,State House,Dennis Dugger,DEM,50343,4,17,32,53,55
Blaine,Governor,Chris Powell,LIB,60002,0,0,12,12,
Blaine,Governor,Kevin Stitt,REP,60002,10,8,401,419,
Blaine,Governor,Drew Edmondson,DEM,60002,7,6,88,101,
Blaine,Lieutenant Governor,Matt Pinnell,REP,60002,12,7,422,441,
Blaine,Lieutenant Governor,Anastasia Pittman,DEM,60002,3,7,64,74,
Blaine,Lieutenant Governor,Ivan Holmes,IND,60002,2,0,14,16,
Blaine,State Auditor,John Yeutter,LIB,60002,1,1,60,62,
Blaine,State Auditor,Cindy Byrd,REP,60002,15,10,433,458,
Blaine,Attorney General,Mike Hunter,REP,60002,14,8,428,450,
Blaine,Attorney General,Mark Myles,DEM,60002,3,6,71,80,
Blaine,State Treasurer,Randy Mcdaniel,REP,60002,17,10,445,472,
Blaine,State Treasurer,Charles De Coune,IND,60002,0,1,48,49,
Blaine,Superintendent of Public Instruction,Joy Hofmeister,REP,60002,13,6,375,394,
Blaine,Superintendent of Public Instruction,John Cox,DEM,60002,2,8,87,97,
Blaine,Superintendent of Public Instruction,Larry Huff,IND,60002,2,0,37,39,
Blaine,Commissioner of Labor,Leslie Osborn,REP,60002,16,8,415,439,
Blaine,Commissioner of Labor,Fred Dorrell,DEM,60002,1,6,56,63,
Blaine,Commissioner of Labor,Brandt Dismukes,IND,60002,0,0,21,21,
Blaine,Insurance Commissioner,Glen Mulready,REP,60002,12,6,406,424,
Blaine,Insurance Commissioner,Kimberly Fobbs,DEM,60002,5,8,83,96,
Blaine,Corporation Commissioner,Bob Anthony,REP,60002,14,9,408,431,
Blaine,Corporation Commissioner,Ashley Nicole Mccray,DEM,60002,3,5,70,78,
Blaine,Corporation Commissioner,Jackie Short,IND,60002,0,0,17,17,
Blaine,U.S. House,Frank Lucas,REP,60002,16,7,444,467,3
Blaine,U.S. House,Frankie Robbins,DEM,60002,1,7,56,64,3
Blaine,Governor,Chris Powell,LIB,60007,0,2,23,25,
Blaine,Governor,Kevin Stitt,REP,60007,10,17,306,333,
Blaine,Governor,Drew Edmondson,DEM,60007,6,1,103,110,
Blaine,Lieutenant Governor,Matt Pinnell,REP,60007,12,17,336,365,
Blaine,Lieutenant Governor,Anastasia Pittman,DEM,60007,4,1,81,86,
Blaine,Lieutenant Governor,Ivan Holmes,IND,60007,0,2,11,13,
Blaine,State Auditor,John Yeutter,LIB,60007,1,3,65,69,
Blaine,State Auditor,Cindy Byrd,REP,60007,13,17,352,382,
Blaine,Attorney General,Mike Hunter,REP,60007,10,16,335,361,
Blaine,Attorney General,Mark Myles,DEM,60007,6,4,92,102,
Blaine,State Treasurer,Randy Mcdaniel,REP,60007,13,17,350,380,
Blaine,State Treasurer,Charles De Coune,IND,60007,2,3,62,67,
Blaine,Superintendent of Public Instruction,Joy Hofmeister,REP,60007,12,14,289,315,
Blaine,Superintendent of Public Instruction,John Cox,DEM,60007,2,0,91,93,
Blaine,Superintendent of Public Instruction,Larry Huff,IND,60007,1,6,49,56,
Blaine,Commissioner of Labor,Leslie Osborn,REP,60007,13,16,323,352,
Blaine,Commissioner of Labor,Fred Dorrell,DEM,60007,3,1,79,83,
Blaine,Commissioner of Labor,Brandt Dismukes,IND,60007,0,3,25,28,
Blaine,Insurance Commissioner,Glen Mulready,REP,60007,11,18,319,348,
Blaine,Insurance Commissioner,Kimberly Fobbs,DEM,60007,4,1,102,107,
Blaine,Corporation Commissioner,Bob Anthony,REP,60007,12,16,305,333,
Blaine,Corporation Commissioner,Ashley Nicole Mccray,DEM,60007,2,3,93,98,
Blaine,Corporation Commissioner,Jackie Short,IND,60007,1,1,28,30,
Blaine,U.S. House,Frank Lucas,REP,60007,14,18,352,384,3
Blaine,U.S. House,Frankie Robbins,DEM,60007,2,1,79,82,3
Blaine,Governor,Chris Powell,LIB,60010,2,2,9,13,
Blaine,Governor,Kevin Stitt,REP,60010,5,18,125,148,
Blaine,Governor,Drew Edmondson,DEM,60010,7,10,85,102,
Blaine,Lieutenant Governor,Matt Pinnell,REP,60010,9,22,138,169,
Blaine,Lieutenant Governor,Anastasia Pittman,DEM,60010,5,6,63,74,
Blaine,Lieutenant Governor,Ivan Holmes,IND,60010,0,2,15,17,
Blaine,State Auditor,John Yeutter,LIB,60010,1,4,42,47,
Blaine,State Auditor,Cindy Byrd,REP,60010,12,24,159,195,
Blaine,Attorney General,Mike Hunter,REP,60010,12,24,141,177,
Blaine,Attorney General,Mark Myles,DEM,60010,2,6,70,78,
Blaine,State Treasurer,Randy Mcdaniel,REP,60010,12,24,155,191,
Blaine,State Treasurer,Charles De Coune,IND,60010,1,5,45,51,
Blaine,Superintendent of Public Instruction,Joy Hofmeister,REP,60010,8,22,134,164,
Blaine,Superintendent of Public Instruction,John Cox,DEM,60010,6,6,66,78,
Blaine,Superintendent of Public Instruction,Larry Huff,IND,60010,0,2,15,17,
Blaine,Commissioner of Labor,Leslie Osborn,REP,60010,13,23,140,176,
Blaine,Commissioner of Labor,Fred Dorrell,DEM,60010,1,6,60,67,
Blaine,Commissioner of Labor,Brandt Dismukes,IND,60010,0,1,11,12,
Blaine,Insurance Commissioner,Glen Mulready,REP,60010,9,22,138,169,
Blaine,Insurance Commissioner,Kimberly Fobbs,DEM,60010,5,8,70,83,
Blaine,Corporation Commissioner,Bob Anthony,REP,60010,11,20,124,155,
Blaine,Corporation Commissioner,Ashley Nicole Mccray,DEM,60010,3,7,77,87,
Blaine,Corporation Commissioner,Jackie Short,IND,60010,0,3,14,17,
Blaine,U.S. House,Frank Lucas,REP,60010,13,24,154,191,3
Blaine,U.S. House,Frankie Robbins,DEM,60010,1,6,62,69,3
Blaine,Governor,Chris Powell,LIB,60011,0,4,5,9,
Blaine,Governor,Kevin Stitt,REP,60011,1,3,70,74,
Blaine,Governor,Drew Edmondson,DEM,60011,5,15,90,110,
Blaine,Lieutenant Governor,Matt Pinnell,REP,60011,2,7,72,81,
Blaine,Lieutenant Governor,Anastasia Pittman,DEM,60011,4,12,89,105,
Blaine,Lieutenant Governor,Ivan Holmes,IND,60011,0,3,4,7,
Blaine,State Auditor,John Yeutter,LIB,60011,2,10,48,60,
Blaine,State Auditor,Cindy Byrd,REP,60011,1,10,105,116,
Blaine,Attorney General,Mike Hunter,REP,60011,2,8,76,86,
Blaine,Attorney General,Mark Myles,DEM,60011,4,13,89,106,
Blaine,State Treasurer,Randy Mcdaniel,REP,60011,2,11,91,104,
Blaine,State Treasurer,Charles De Coune,IND,60011,2,8,63,73,
Blaine,Superintendent of Public Instruction,Joy Hofmeister,REP,60011,1,7,81,89,
Blaine,Superintendent of Public Instruction,John Cox,DEM,60011,4,12,72,88,
Blaine,Superintendent of Public Instruction,Larry Huff,IND,60011,0,3,12,15,
Blaine,Commissioner of Labor,Leslie Osborn,REP,60011,1,6,75,82,
Blaine,Commissioner of Labor,Fred Dorrell,DEM,60011,4,11,80,95,
Blaine,Commissioner of Labor,Brandt Dismukes,IND,60011,1,5,10,16,
Blaine,Insurance Commissioner,Glen Mulready,REP,60011,1,9,78,88,
Blaine,Insurance Commissioner,Kimberly Fobbs,DEM,60011,4,13,87,104,
Blaine,Corporation Commissioner,Bob Anthony,REP,60011,1,6,68,75,
Blaine,Corporation Commissioner,Ashley Nicole Mccray,DEM,60011,4,13,85,102,
Blaine,Corporation Commissioner,Jackie Short,IND,60011,0,3,12,15,
Blaine,U.S. House,Frank Lucas,REP,60011,2,10,82,94,3
Blaine,U.S. House,Frankie Robbins,DEM,60011,4,12,83,99,3
Blaine,Governor,Chris Powell,LIB,60012,1,2,26,29,
Blaine,Governor,Kevin Stitt,REP,60012,27,62,370,459,
Blaine,Governor,Drew Edmondson,DEM,60012,17,34,187,238,
Blaine,Lieutenant Governor,Matt Pinnell,REP,60012,30,76,415,521,
Blaine,Lieutenant Governor,Anastasia Pittman,DEM,60012,10,22,143,175,
Blaine,Lieutenant Governor,Ivan Holmes,IND,60012,4,0,21,25,
Blaine,State Auditor,John Yeutter,LIB,60012,10,9,94,113,
Blaine,State Auditor,Cindy Byrd,REP,60012,33,83,465,581,
Blaine,Attorney General,Mike Hunter,REP,60012,31,75,429,535,
Blaine,Attorney General,Mark Myles,DEM,60012,13,21,149,183,
Blaine,State Treasurer,Randy Mcdaniel,REP,60012,32,81,456,569,
Blaine,State Treasurer,Charles De Coune,IND,60012,11,10,104,125,
Blaine,Superintendent of Public Instruction,Joy Hofmeister,REP,60012,27,69,394,490,
Blaine,Superintendent of Public Instruction,John Cox,DEM,60012,11,27,130,168,
Blaine,Superintendent of Public Instruction,Larry Huff,IND,60012,5,2,55,62,
Blaine,Commissioner of Labor,Leslie Osborn,REP,60012,31,73,407,511,
Blaine,Commissioner of Labor,Fred Dorrell,DEM,60012,10,20,128,158,
Blaine,Commissioner of Labor,Brandt Dismukes,IND,60012,3,3,36,42,
Blaine,Insurance Commissioner,Glen Mulready,REP,60012,33,75,407,515,
Blaine,Insurance Commissioner,Kimberly Fobbs,DEM,60012,11,22,165,198,
Blaine,Corporation Commissioner,Bob Anthony,REP,60012,30,71,382,483,
Blaine,Corporation Commissioner,Ashley Nicole Mccray,DEM,60012,12,24,162,198,
Blaine,Corporation Commissioner,Jackie Short,IND,60012,3,3,32,38,
Blaine,U.S. House,Frank Lucas,REP,60012,33,81,460,574,3
Blaine,U.S. House,Frankie Robbins,DEM,60012,10,17,120,147,3
Blaine,Governor,Chris Powell,LIB,60016,0,0,7,7,
Blaine,Governor,Kevin Stitt,REP,60016,1,9,67,77,
Blaine,Governor,Drew Edmondson,DEM,60016,0,7,32,39,
Blaine,Lieutenant Governor,Matt Pinnell,REP,60016,1,9,86,96,
Blaine,Lieutenant Governor,Anastasia Pittman,DEM,60016,0,7,15,22,
Blaine,Lieutenant Governor,Ivan Holmes,IND,60016,0,0,5,5,
Blaine,State Auditor,John Yeutter,LIB,60016,0,0,9,9,
Blaine,State Auditor,Cindy Byrd,REP,60016,1,15,88,104,
Blaine,Attorney General,Mike Hunter,REP,60016,1,11,85,97,
Blaine,Attorney General,Mark Myles,DEM,60016,0,5,19,24,
Blaine,State Treasurer,Randy Mcdaniel,REP,60016,1,13,94,108,
Blaine,State Treasurer,Charles De Coune,IND,60016,0,2,5,7,
Blaine,Superintendent of Public Instruction,Joy Hofmeister,REP,60016,1,13,73,87,
Blaine,Superintendent of Public Instruction,John Cox,DEM,60016,0,3,18,21,
Blaine,Superintendent of Public Instruction,Larry Huff,IND,60016,0,0,14,14,
Blaine,Commissioner of Labor,Leslie Osborn,REP,60016,1,11,81,93,
Blaine,Commissioner of Labor,Fred Dorrell,DEM,60016,0,5,15,20,
Blaine,Commissioner of Labor,Brandt Dismukes,IND,60016,0,0,6,6,
Blaine,Insurance Commissioner,Glen Mulready,REP,60016,1,10,81,92,
Blaine,Insurance Commissioner,Kimberly Fobbs,DEM,60016,0,6,21,27,
Blaine,Corporation Commissioner,Bob Anthony,REP,60016,1,8,74,83,
Blaine,Corporation Commissioner,Ashley Nicole Mccray,DEM,60016,0,8,25,33,
Blaine,Corporation Commissioner,Jackie Short,IND,60016,0,0,5,5,
Blaine,U.S. House,Frank Lucas,REP,60016,1,13,90,104,3
Blaine,U.S. House,Frankie Robbins,DEM,60016,0,3,16,19,3
Blaine,Governor,Chris Powell,LIB,60017,0,1,20,21,
Blaine,Governor,Kevin Stitt,REP,60017,6,13,193,212,
Blaine,Governor,Drew Edmondson,DEM,60017,1,5,131,137,
Blaine,Lieutenant Governor,Matt Pinnell,REP,60017,7,15,204,226,
Blaine,Lieutenant Governor,Anastasia Pittman,DEM,60017,1,3,115,119,
Blaine,Lieutenant Governor,Ivan Holmes,IND,60017,0,1,25,26,
Blaine,State Auditor,John Yeutter,LIB,60017,0,5,99,104,
Blaine,State Auditor,Cindy Byrd,REP,60017,7,13,239,259,
Blaine,Attorney General,Mike Hunter,REP,60017,6,10,232,248,
Blaine,Attorney General,Mark Myles,DEM,60017,1,7,113,121,
Blaine,State Treasurer,Randy Mcdaniel,REP,60017,7,16,237,260,
Blaine,State Treasurer,Charles De Coune,IND,60017,0,2,100,102,
Blaine,Superintendent of Public Instruction,Joy Hofmeister,REP,60017,7,10,199,216,
Blaine,Superintendent of Public Instruction,John Cox,DEM,60017,1,3,110,114,
Blaine,Superintendent of Public Instruction,Larry Huff,IND,60017,0,6,37,43,
Blaine,Commissioner of Labor,Leslie Osborn,REP,60017,7,15,215,237,
Blaine,Commissioner of Labor,Fred Dorrell,DEM,60017,1,3,105,109,
Blaine,Commissioner of Labor,Brandt Dismukes,IND,60017,0,1,22,23,
Blaine,Insurance Commissioner,Glen Mulready,REP,60017,7,15,218,240,
Blaine,Insurance Commissioner,Kimberly Fobbs,DEM,60017,1,4,124,129,
Blaine,Corporation Commissioner,Bob Anthony,REP,60017,7,14,191,212,
Blaine,Corporation Commissioner,Ashley Nicole Mccray,DEM,60017,1,3,118,122,
Blaine,Corporation Commissioner,Jackie Short,IND,60017,0,2,32,34,
Blaine,U.S. House,Frank Lucas,REP,60017,7,16,231,254,3
Blaine,U.S. House,Frankie Robbins,DEM,60017,1,3,113,117,3
Blaine,Governor,Chris Powell,LIB,60020,1,0,3,4,
Blaine,Governor,Kevin Stitt,REP,60020,11,0,174,185,
Blaine,Governor,Drew Edmondson,DEM,60020,0,1,42,43,
Blaine,Lieutenant Governor,Matt Pinnell,REP,60020,11,0,181,192,
Blaine,Lieutenant Governor,Anastasia Pittman,DEM,60020,1,1,30,32,
Blaine,Lieutenant Governor,Ivan Holmes,IND,60020,0,0,4,4,
Blaine,State Auditor,John Yeutter,LIB,60020,1,0,12,13,
Blaine,State Auditor,Cindy Byrd,REP,60020,11,1,199,211,
Blaine,Attorney General,Mike Hunter,REP,60020,11,0,182,193,
Blaine,Attorney General,Mark Myles,DEM,60020,1,1,31,33,
Blaine,State Treasurer,Randy Mcdaniel,REP,60020,11,0,189,200,
Blaine,State Treasurer,Charles De Coune,IND,60020,1,1,22,24,
Blaine,Superintendent of Public Instruction,Joy Hofmeister,REP,60020,11,0,167,178,
Blaine,Superintendent of Public Instruction,John Cox,DEM,60020,1,1,27,29,
Blaine,Superintendent of Public Instruction,Larry Huff,IND,60020,0,0,18,18,
Blaine,Commissioner of Labor,Leslie Osborn,REP,60020,11,0,175,186,
Blaine,Commissioner of Labor,Fred Dorrell,DEM,60020,1,1,22,24,
Blaine,Commissioner of Labor,Brandt Dismukes,IND,60020,0,0,14,14,
Blaine,Insurance Commissioner,Glen Mulready,REP,60020,10,0,170,180,
Blaine,Insurance Commissioner,Kimberly Fobbs,DEM,60020,2,1,40,43,
Blaine,Corporation Commissioner,Bob Anthony,REP,60020,11,0,173,184,
Blaine,Corporation Commissioner,Ashley Nicole Mccray,DEM,60020,1,1,26,28,
Blaine,Corporation Commissioner,Jackie Short,IND,60020,0,0,12,12,
Blaine,U.S. House,Frank Lucas,REP,60020,11,0,191,202,3
Blaine,U.S. House,Frankie Robbins,DEM,60020,1,1,23,25,3
Blaine,Governor,Chris Powell,LIB,60022,0,0,3,3,
Blaine,Governor,Kevin Stitt,REP,60022,0,3,31,34,
Blaine,Governor,Drew Edmondson,DEM,60022,0,0,9,9,
Blaine,Lieutenant Governor,Matt Pinnell,REP,60022,0,3,35,38,
Blaine,Lieutenant Governor,Anastasia Pittman,DEM,60022,0,0,5,5,
Blaine,Lieutenant Governor,Ivan Holmes,IND,60022,0,0,2,2,
Blaine,State Auditor,John Yeutter,LIB,60022,0,0,6,6,
Blaine,State Auditor,Cindy Byrd,REP,60022,0,3,34,37,
Blaine,Attorney General,Mike Hunter,REP,60022,0,3,36,39,
Blaine,Attorney General,Mark Myles,DEM,60022,0,0,6,6,
Blaine,State Treasurer,Randy Mcdaniel,REP,60022,0,3,35,38,
Blaine,State Treasurer,Charles De Coune,IND,60022,0,0,6,6,
Blaine,Superintendent of Public Instruction,Joy Hofmeister,REP,60022,0,2,31,33,
Blaine,Superintendent of Public Instruction,John Cox,DEM,60022,0,0,7,7,
Blaine,Superintendent of Public Instruction,Larry Huff,IND,60022,0,1,5,6,
Blaine,Commissioner of Labor,Leslie Osborn,REP,60022,0,3,34,37,
Blaine,Commissioner of Labor,Fred Dorrell,DEM,60022,0,0,7,7,
Blaine,Commissioner of Labor,Brandt Dismukes,IND,60022,0,0,2,2,
Blaine,Insurance Commissioner,Glen Mulready,REP,60022,0,3,31,34,
Blaine,Insurance Commissioner,Kimberly Fobbs,DEM,60022,0,0,10,10,
Blaine,Corporation Commissioner,Bob Anthony,REP,60022,0,3,31,34,
Blaine,Corporation Commissioner,Ashley Nicole Mccray,DEM,60022,0,0,7,7,
Blaine,Corporation Commissioner,Jackie Short,IND,60022,0,0,4,4,
Blaine,U.S. House,Frank Lucas,REP,60022,0,3,37,40,3
Blaine,U.S. House,Frankie Robbins,DEM,60022,0,0,6,6,3
Bryan,Governor,Chris Powell,LIB,70003,0,2,23,25,
Bryan,Governor,Kevin Stitt,REP,70003,13,32,245,290,
Bryan,Governor,Drew Edmondson,DEM,70003,12,28,193,233,
Bryan,Lieutenant Governor,Matt Pinnell,REP,70003,12,39,272,323,
Bryan,Lieutenant Governor,Anastasia Pittman,DEM,70003,12,23,162,197,
Bryan,Lieutenant Governor,Ivan Holmes,IND,70003,0,0,23,23,
Bryan,State Auditor,John Yeutter,LIB,70003,5,9,107,121,
Bryan,State Auditor,Cindy Byrd,REP,70003,17,46,318,381,
Bryan,Attorney General,Mike Hunter,REP,70003,13,40,282,335,
Bryan,Attorney General,Mark Myles,DEM,70003,12,21,175,208,
Bryan,State Treasurer,Randy Mcdaniel,REP,70003,17,42,304,363,
Bryan,State Treasurer,Charles De Coune,IND,70003,5,12,118,135,
Bryan,Superintendent of Public Instruction,Joy Hofmeister,REP,70003,18,40,266,324,
Bryan,Superintendent of Public Instruction,John Cox,DEM,70003,7,22,154,183,
Bryan,Superintendent of Public Instruction,Larry Huff,IND,70003,0,0,36,36,
Bryan,Commissioner of Labor,Leslie Osborn,REP,70003,14,39,271,324,
Bryan,Commissioner of Labor,Fred Dorrell,DEM,70003,11,21,158,190,
Bryan,Commissioner of Labor,Brandt Dismukes,IND,70003,0,0,25,25,
Bryan,Insurance Commissioner,Glen Mulready,REP,70003,14,39,270,323,
Bryan,Insurance Commissioner,Kimberly Fobbs,DEM,70003,10,23,186,219,
Bryan,Corporation Commissioner,Bob Anthony,REP,70003,13,39,260,312,
Bryan,Corporation Commissioner,Ashley Nicole Mccray,DEM,70003,11,22,167,200,
Bryan,Corporation Commissioner,Jackie Short,IND,70003,0,1,29,30,
Bryan,U.S. House,Richard Castaldo,LIB,70003,0,0,12,12,2
Bryan,U.S. House,Markwayne Mullin,REP,70003,13,40,262,315,2
Bryan,U.S. House,Jason Nichols,DEM,70003,12,21,171,204,2
Bryan,U.S. House,John Foreman,IND,70003,0,1,14,15,2
Bryan,State Senate,David Bullard,REP,70003,13,35,246,294,6
Bryan,State Senate,Arnold Bourne,DEM,70003,12,27,213,252,6
Bryan,Governor,Chris Powell,LIB,70004,0,2,28,30,
Bryan,Governor,Kevin Stitt,REP,70004,9,47,268,324,
Bryan,Governor,Drew Edmondson,DEM,70004,11,28,193,232,
Bryan,Lieutenant Governor,Matt Pinnell,REP,70004,9,48,293,350,
Bryan,Lieutenant Governor,Anastasia Pittman,DEM,70004,9,27,165,201,
Bryan,Lieutenant Governor,Ivan Holmes,IND,70004,2,1,23,26,
Bryan,State Auditor,John Yeutter,LIB,70004,4,14,111,129,
Bryan,State Auditor,Cindy Byrd,REP,70004,10,57,337,404,
Bryan,Attorney General,Mike Hunter,REP,70004,10,53,313,376,
Bryan,Attorney General,Mark Myles,DEM,70004,10,23,169,202,
Bryan,State Treasurer,Randy Mcdaniel,REP,70004,9,53,330,392,
Bryan,State Treasurer,Charles De Coune,IND,70004,7,18,116,141,
Bryan,Superintendent of Public Instruction,Joy Hofmeister,REP,70004,8,52,282,342,
Bryan,Superintendent of Public Instruction,John Cox,DEM,70004,12,20,154,186,
Bryan,Superintendent of Public Instruction,Larry Huff,IND,70004,0,4,46,50,
Bryan,Commissioner of Labor,Leslie Osborn,REP,70004,9,44,290,343,
Bryan,Commissioner of Labor,Fred Dorrell,DEM,70004,10,27,164,201,
Bryan,Commissioner of Labor,Brandt Dismukes,IND,70004,1,5,26,32,
Bryan,Insurance Commissioner,Glen Mulready,REP,70004,9,47,299,355,
Bryan,Insurance Commissioner,Kimberly Fobbs,DEM,70004,11,28,176,215,
Bryan,Corporation Commissioner,Bob Anthony,REP,70004,9,44,286,339,
Bryan,Corporation Commissioner,Ashley Nicole Mccray,DEM,70004,9,27,167,203,
Bryan,Corporation Commissioner,Jackie Short,IND,70004,1,4,26,31,
Bryan,U.S. House,Richard Castaldo,LIB,70004,0,0,13,13,2
Bryan,U.S. House,Markwayne Mullin,REP,70004,10,50,295,355,2
Bryan,U.S. House,Jason Nichols,DEM,70004,9,24,158,191,2
Bryan,U.S. House,John Foreman,IND,70004,0,3,18,21,2
Bryan,State Senate,David Bullard,REP,70004,9,45,266,320,6
Bryan,State Senate,Arnold Bourne,DEM,70004,11,32,218,261,6
Bryan,Governor,Chris Powell,LIB,70005,1,2,18,21,
Bryan,Governor,Kevin Stitt,REP,70005,8,37,298,343,
Bryan,Governor,Drew Edmondson,DEM,70005,17,35,235,287,
Bryan,Lieutenant Governor,Matt Pinnell,REP,70005,9,40,322,371,
Bryan,Lieutenant Governor,Anastasia Pittman,DEM,70005,14,31,205,250,
Bryan,Lieutenant Governor,Ivan Holmes,IND,70005,2,2,21,25,
Bryan,State Auditor,John Yeutter,LIB,70005,8,19,142,169,
Bryan,State Auditor,Cindy Byrd,REP,70005,11,44,370,425,
Bryan,Attorney General,Mike Hunter,REP,70005,10,42,325,377,
Bryan,Attorney General,Mark Myles,DEM,70005,16,32,217,265,
Bryan,State Treasurer,Randy Mcdaniel,REP,70005,9,44,350,403,
Bryan,State Treasurer,Charles De Coune,IND,70005,10,20,156,186,
Bryan,Superintendent of Public Instruction,Joy Hofmeister,REP,70005,10,38,312,360,
Bryan,Superintendent of Public Instruction,John Cox,DEM,70005,15,36,190,241,
Bryan,Superintendent of Public Instruction,Larry Huff,IND,70005,1,0,38,39,
Bryan,Commissioner of Labor,Leslie Osborn,REP,70005,10,42,324,376,
Bryan,Commissioner of Labor,Fred Dorrell,DEM,70005,15,30,195,240,
Bryan,Commissioner of Labor,Brandt Dismukes,IND,70005,1,1,22,24,
Bryan,Insurance Commissioner,Glen Mulready,REP,70005,10,41,318,369,
Bryan,Insurance Commissioner,Kimberly Fobbs,DEM,70005,16,32,226,274,
Bryan,Corporation Commissioner,Bob Anthony,REP,70005,9,42,307,358,
Bryan,Corporation Commissioner,Ashley Nicole Mccray,DEM,70005,16,29,208,253,
Bryan,Corporation Commissioner,Jackie Short,IND,70005,1,2,30,33,
Bryan,U.S. House,Richard Castaldo,LIB,70005,0,1,17,18,2
Bryan,U.S. House,Markwayne Mullin,REP,70005,9,43,322,374,2
Bryan,U.S. House,Jason Nichols,DEM,70005,15,29,196,240,2
Bryan,U.S. House,John Foreman,IND,70005,2,1,14,17,2
Bryan,State Senate,David Bullard,REP,70005,9,37,282,328,6
Bryan,State Senate,Arnold Bourne,DEM,70005,16,37,268,321,6
Bryan,Governor,Chris Powell,LIB,70008,1,3,17,21,
Bryan,Governor,Kevin Stitt,REP,70008,11,64,333,408,
Bryan,Governor,Drew Edmondson,DEM,70008,20,27,222,269,
Bryan,Lieutenant Governor,Matt Pinnell,REP,70008,11,67,350,428,
Bryan,Lieutenant Governor,Anastasia Pittman,DEM,70008,19,25,197,241,
Bryan,Lieutenant Governor,Ivan Holmes,IND,70008,1,1,18,20,
Bryan,State Auditor,John Yeutter,LIB,70008,6,14,117,137,
Bryan,State Auditor,Cindy Byrd,REP,70008,16,70,409,495,
Bryan,Attorney General,Mike Hunter,REP,70008,15,68,373,456,
Bryan,Attorney General,Mark Myles,DEM,70008,18,25,194,237,
Bryan,State Treasurer,Randy Mcdaniel,REP,70008,14,69,405,488,
Bryan,State Treasurer,Charles De Coune,IND,70008,7,15,123,145,
Bryan,Superintendent of Public Instruction,Joy Hofmeister,REP,70008,11,66,342,419,
Bryan,Superintendent of Public Instruction,John Cox,DEM,70008,18,25,194,237,
Bryan,Superintendent of Public Instruction,Larry Huff,IND,70008,1,2,30,33,
Bryan,Commissioner of Labor,Leslie Osborn,REP,70008,12,68,349,429,
Bryan,Commissioner of Labor,Fred Dorrell,DEM,70008,17,21,193,231,
Bryan,Commissioner of Labor,Brandt Dismukes,IND,70008,1,3,23,27,
Bryan,Insurance Commissioner,Glen Mulready,REP,70008,9,68,356,433,
Bryan,Insurance Commissioner,Kimberly Fobbs,DEM,70008,22,25,207,254,
Bryan,Corporation Commissioner,Bob Anthony,REP,70008,12,67,348,427,
Bryan,Corporation Commissioner,Ashley Nicole Mccray,DEM,70008,17,23,194,234,
Bryan,Corporation Commissioner,Jackie Short,IND,70008,1,3,23,27,
Bryan,U.S. House,Richard Castaldo,LIB,70008,0,3,13,16,2
Bryan,U.S. House,Markwayne Mullin,REP,70008,14,66,350,430,2
Bryan,U.S. House,Jason Nichols,DEM,70008,17,24,194,235,2
Bryan,U.S. House,John Foreman,IND,70008,2,2,12,16,2
Bryan,State Senate,David Bullard,REP,70008,12,65,316,393,6
Bryan,State Senate,Arnold Bourne,DEM,70008,21,30,254,305,6
Bryan,Governor,Chris Powell,LIB,70010,0,0,11,11,
Bryan,Governor,Kevin Stitt,REP,70010,4,19,221,244,
Bryan,Governor,Drew Edmondson,DEM,70010,7,16,92,115,
Bryan,Lieutenant Governor,Matt Pinnell,REP,70010,4,21,229,254,
Bryan,Lieutenant Governor,Anastasia Pittman,DEM,70010,6,13,91,110,
Bryan,Lieutenant Governor,Ivan Holmes,IND,70010,1,1,3,5,
Bryan,State Auditor,John Yeutter,LIB,70010,6,4,37,47,
Bryan,State Auditor,Cindy Byrd,REP,70010,5,27,241,273,
Bryan,Attorney General,Mike Hunter,REP,70010,4,21,235,260,
Bryan,Attorney General,Mark Myles,DEM,70010,7,14,87,108,
Bryan,State Treasurer,Randy Mcdaniel,REP,70010,5,24,231,260,
Bryan,State Treasurer,Charles De Coune,IND,70010,6,7,43,56,
Bryan,Superintendent of Public Instruction,Joy Hofmeister,REP,70010,5,25,210,240,
Bryan,Superintendent of Public Instruction,John Cox,DEM,70010,5,8,94,107,
Bryan,Superintendent of Public Instruction,Larry Huff,IND,70010,1,2,20,23,
Bryan,Commissioner of Labor,Leslie Osborn,REP,70010,4,22,211,237,
Bryan,Commissioner of Labor,Fred Dorrell,DEM,70010,6,11,90,107,
Bryan,Commissioner of Labor,Brandt Dismukes,IND,70010,1,2,17,20,
Bryan,Insurance Commissioner,Glen Mulready,REP,70010,4,22,222,248,
Bryan,Insurance Commissioner,Kimberly Fobbs,DEM,70010,7,13,97,117,
Bryan,Corporation Commissioner,Bob Anthony,REP,70010,4,24,209,237,
Bryan,Corporation Commissioner,Ashley Nicole Mccray,DEM,70010,6,9,94,109,
Bryan,Corporation Commissioner,Jackie Short,IND,70010,1,2,18,21,
Bryan,U.S. House,Richard Castaldo,LIB,70010,1,0,5,6,2
Bryan,U.S. House,Markwayne Mullin,REP,70010,4,24,221,249,2
Bryan,U.S. House,Jason Nichols,DEM,70010,6,11,81,98,2
Bryan,U.S. House,John Foreman,IND,70010,0,0,16,16,2
Bryan,State Senate,David Bullard,REP,70010,4,21,194,219,6
Bryan,State Senate,Arnold Bourne,DEM,70010,7,14,128,149,6
Bryan,Governor,Chris Powell,LIB,70011,0,0,8,8,
Bryan,Governor,Kevin Stitt,REP,70011,3,0,93,96,
Bryan,Governor,Drew Edmondson,DEM,70011,0,4,38,42,
Bryan,Lieutenant Governor,Matt Pinnell,REP,70011,2,0,98,100,
Bryan,Lieutenant Governor,Anastasia Pittman,DEM,70011,1,3,35,39,
Bryan,Lieutenant Governor,Ivan Holmes,IND,70011,0,1,5,6,
Bryan,State Auditor,John Yeutter,LIB,70011,0,1,19,20,
Bryan,State Auditor,Cindy Byrd,REP,70011,3,2,103,108,
Bryan,Attorney General,Mike Hunter,REP,70011,3,1,95,99,
Bryan,Attorney General,Mark Myles,DEM,70011,0,3,41,44,
Bryan,State Treasurer,Randy Mcdaniel,REP,70011,3,2,102,107,
Bryan,State Treasurer,Charles De Coune,IND,70011,0,1,18,19,
Bryan,Superintendent of Public Instruction,Joy Hofmeister,REP,70011,3,1,89,93,
Bryan,Superintendent of Public Instruction,John Cox,DEM,70011,0,2,40,42,
Bryan,Superintendent of Public Instruction,Larry Huff,IND,70011,0,1,9,10,
Bryan,Commissioner of Labor,Leslie Osborn,REP,70011,3,0,97,100,
Bryan,Commissioner of Labor,Fred Dorrell,DEM,70011,0,3,36,39,
Bryan,Commissioner of Labor,Brandt Dismukes,IND,70011,0,1,5,6,
Bryan,Insurance Commissioner,Glen Mulready,REP,70011,3,0,94,97,
Bryan,Insurance Commissioner,Kimberly Fobbs,DEM,70011,0,4,40,44,
Bryan,Corporation Commissioner,Bob Anthony,REP,70011,3,0,93,96,
Bryan,Corporation Commissioner,Ashley Nicole Mccray,DEM,70011,0,3,34,37,
Bryan,Corporation Commissioner,Jackie Short,IND,70011,0,1,9,10,
Bryan,U.S. House,Richard Castaldo,LIB,70011,1,0,2,3,2
Bryan,U.S. House,Markwayne Mullin,REP,70011,2,1,106,109,2
Bryan,U.S. House,Jason Nichols,DEM,70011,0,3,28,31,2
Bryan,U.S. House,John Foreman,IND,70011,0,0,4,4,2
Bryan,State Senate,David Bullard,REP,70011,3,0,87,90,6
Bryan,State Senate,Arnold Bourne,DEM,70011,0,4,51,55,6
Bryan,State House,Justin Humphrey,REP,70011,3,0,91,94,19
Bryan,State House,Lewis Collins,DEM,70011,0,3,44,47,19
Bryan,Governor,Chris Powell,LIB,70013,0,0,13,13,
Bryan,Governor,Kevin Stitt,REP,70013,7,10,283,300,
Bryan,Governor,Drew Edmondson,DEM,70013,3,3,107,113,
Bryan,Lieutenant Governor,Matt Pinnell,REP,70013,8,10,296,314,
Bryan,Lieutenant Governor,Anastasia Pittman,DEM,70013,2,3,78,83,
Bryan,Lieutenant Governor,Ivan Holmes,IND,70013,0,0,18,18,
Bryan,State Auditor,John Yeutter,LIB,70013,1,0,54,55,
Bryan,State Auditor,Cindy Byrd,REP,70013,9,13,322,344,
Bryan,Attorney General,Mike Hunter,REP,70013,8,11,310,329,
Bryan,Attorney General,Mark Myles,DEM,70013,2,2,84,88,
Bryan,State Treasurer,Randy Mcdaniel,REP,70013,8,13,321,342,
Bryan,State Treasurer,Charles De Coune,IND,70013,1,0,52,53,
Bryan,Superintendent of Public Instruction,Joy Hofmeister,REP,70013,8,10,264,282,
Bryan,Superintendent of Public Instruction,John Cox,DEM,70013,2,3,85,90,
Bryan,Superintendent of Public Instruction,Larry Huff,IND,70013,0,0,43,43,
Bryan,Commissioner of Labor,Leslie Osborn,REP,70013,8,10,289,307,
Bryan,Commissioner of Labor,Fred Dorrell,DEM,70013,2,3,83,88,
Bryan,Commissioner of Labor,Brandt Dismukes,IND,70013,0,0,13,13,
Bryan,Insurance Commissioner,Glen Mulready,REP,70013,7,9,296,312,
Bryan,Insurance Commissioner,Kimberly Fobbs,DEM,70013,3,4,95,102,
Bryan,Corporation Commissioner,Bob Anthony,REP,70013,8,10,287,305,
Bryan,Corporation Commissioner,Ashley Nicole Mccray,DEM,70013,2,3,83,88,
Bryan,Corporation Commissioner,Jackie Short,IND,70013,0,0,24,24,
Bryan,U.S. House,Richard Castaldo,LIB,70013,0,0,9,9,2
Bryan,U.S. House,Markwayne Mullin,REP,70013,7,12,305,324,2
Bryan,U.S. House,Jason Nichols,DEM,70013,3,1,77,81,2
Bryan,U.S. House,John Foreman,IND,70013,0,0,8,8,2
Bryan,State Senate,David Bullard,REP,70013,6,10,301,317,6
Bryan,State Senate,Arnold Bourne,DEM,70013,4,3,100,107,6
Bryan,State House,Justin Humphrey,REP,70013,9,10,306,325,19
Bryan,State House,Lewis Collins,DEM,70013,1,3,98,102,19
Bryan,Governor,Chris Powell,LIB,70014,0,0,5,5,
Bryan,Governor,Kevin Stitt,REP,70014,2,21,162,185,
Bryan,Governor,Drew Edmondson,DEM,70014,1,9,60,70,
Bryan,Lieutenant Governor,Matt Pinnell,REP,70014,1,23,176,200,
Bryan,Lieutenant Governor,Anastasia Pittman,DEM,70014,1,7,43,51,
Bryan,Lieutenant Governor,Ivan Holmes,IND,70014,1,0,6,7,
Bryan,State Auditor,John Yeutter,LIB,70014,0,5,27,32,
Bryan,State Auditor,Cindy Byrd,REP,70014,2,24,190,216,
Bryan,Attorney General,Mike Hunter,REP,70014,2,23,179,204,
Bryan,Attorney General,Mark Myles,DEM,70014,1,7,48,56,
Bryan,State Treasurer,Randy Mcdaniel,REP,70014,2,23,192,217,
Bryan,State Treasurer,Charles De Coune,IND,70014,0,7,23,30,
Bryan,Superintendent of Public Instruction,Joy Hofmeister,REP,70014,1,21,174,196,
Bryan,Superintendent of Public Instruction,John Cox,DEM,70014,1,7,42,50,
Bryan,Superintendent of Public Instruction,Larry Huff,IND,70014,1,2,10,13,
Bryan,Commissioner of Labor,Leslie Osborn,REP,70014,1,22,175,198,
Bryan,Commissioner of Labor,Fred Dorrell,DEM,70014,0,8,40,48,
Bryan,Commissioner of Labor,Brandt Dismukes,IND,70014,1,0,11,12,
Bryan,Insurance Commissioner,Glen Mulready,REP,70014,2,23,174,199,
Bryan,Insurance Commissioner,Kimberly Fobbs,DEM,70014,0,7,50,57,
Bryan,Corporation Commissioner,Bob Anthony,REP,70014,1,24,165,190,
Bryan,Corporation Commissioner,Ashley Nicole Mccray,DEM,70014,0,6,46,52,
Bryan,Corporation Commissioner,Jackie Short,IND,70014,1,0,13,14,
Bryan,U.S. House,Richard Castaldo,LIB,70014,0,0,3,3,2
Bryan,U.S. House,Markwayne Mullin,REP,70014,1,21,173,195,2
Bryan,U.S. House,Jason Nichols,DEM,70014,1,9,42,52,2
Bryan,U.S. House,John Foreman,IND,70014,1,0,9,10,2
Bryan,State Senate,David Bullard,REP,70014,2,20,152,174,6
Bryan,State Senate,Arnold Bourne,DEM,70014,1,10,76,87,6
Bryan,State House,Justin Humphrey,REP,70014,2,22,179,203,19
Bryan,State House,Lewis Collins,DEM,70014,1,8,48,57,19
Bryan,Governor,Chris Powell,LIB,70015,0,0,8,8,
Bryan,Governor,Kevin Stitt,REP,70015,11,23,294,328,
Bryan,Governor,Drew Edmondson,DEM,70015,6,14,138,158,
Bryan,Lieutenant Governor,Matt Pinnell,REP,70015,11,26,303,340,
Bryan,Lieutenant Governor,Anastasia Pittman,DEM,70015,6,10,116,132,
Bryan,Lieutenant Governor,Ivan Holmes,IND,70015,0,0,15,15,
Bryan,State Auditor,John Yeutter,LIB,70015,3,4,76,83,
Bryan,State Auditor,Cindy Byrd,REP,70015,12,30,327,369,
Bryan,Attorney General,Mike Hunter,REP,70015,12,30,314,356,
Bryan,Attorney General,Mark Myles,DEM,70015,5,7,117,129,
Bryan,State Treasurer,Randy Mcdaniel,REP,70015,11,31,333,375,
Bryan,State Treasurer,Charles De Coune,IND,70015,2,4,70,76,
Bryan,Superintendent of Public Instruction,Joy Hofmeister,REP,70015,10,29,294,333,
Bryan,Superintendent of Public Instruction,John Cox,DEM,70015,5,8,122,135,
Bryan,Superintendent of Public Instruction,Larry Huff,IND,70015,2,0,18,20,
Bryan,Commissioner of Labor,Leslie Osborn,REP,70015,12,27,290,329,
Bryan,Commissioner of Labor,Fred Dorrell,DEM,70015,5,9,127,141,
Bryan,Commissioner of Labor,Brandt Dismukes,IND,70015,0,0,12,12,
Bryan,Insurance Commissioner,Glen Mulready,REP,70015,10,24,299,333,
Bryan,Insurance Commissioner,Kimberly Fobbs,DEM,70015,7,12,132,151,
Bryan,Corporation Commissioner,Bob Anthony,REP,70015,11,26,301,338,
Bryan,Corporation Commissioner,Ashley Nicole Mccray,DEM,70015,6,10,118,134,
Bryan,Corporation Commissioner,Jackie Short,IND,70015,0,0,12,12,
Bryan,U.S. House,Richard Castaldo,LIB,70015,1,0,8,9,2
Bryan,U.S. House,Markwayne Mullin,REP,70015,10,26,308,344,2
Bryan,U.S. House,Jason Nichols,DEM,70015,6,10,111,127,2
Bryan,U.S. House,John Foreman,IND,70015,0,1,8,9,2
Bryan,State Senate,David Bullard,REP,70015,11,23,271,305,6
Bryan,State Senate,Arnold Bourne,DEM,70015,6,13,166,185,6
Bryan,State House,Justin Humphrey,REP,70015,11,26,305,342,19
Bryan,State House,Lewis Collins,DEM,70015,6,11,128,145,19
Bryan,Governor,Chris Powell,LIB,70017,0,0,9,9,
Bryan,Governor,Kevin Stitt,REP,70017,1,7,205,213,
Bryan,Governor,Drew Edmondson,DEM,70017,1,1,116,118,
Bryan,Lieutenant Governor,Matt Pinnell,REP,70017,1,7,234,242,
Bryan,Lieutenant Governor,Anastasia Pittman,DEM,70017,1,1,80,82,
Bryan,Lieutenant Governor,Ivan Holmes,IND,70017,0,0,16,16,
Bryan,State Auditor,John Yeutter,LIB,70017,1,0,51,52,
Bryan,State Auditor,Cindy Byrd,REP,70017,1,7,257,265,
Bryan,Attorney General,Mike Hunter,REP,70017,1,7,232,240,
Bryan,Attorney General,Mark Myles,DEM,70017,1,1,96,98,
Bryan,State Treasurer,Randy Mcdaniel,REP,70017,1,7,254,262,
Bryan,State Treasurer,Charles De Coune,IND,70017,1,0,55,56,
Bryan,Superintendent of Public Instruction,Joy Hofmeister,REP,70017,1,7,215,223,
Bryan,Superintendent of Public Instruction,John Cox,DEM,70017,1,1,87,89,
Bryan,Superintendent of Public Instruction,Larry Huff,IND,70017,0,0,29,29,
Bryan,Commissioner of Labor,Leslie Osborn,REP,70017,1,7,213,221,
Bryan,Commissioner of Labor,Fred Dorrell,DEM,70017,1,1,93,95,
Bryan,Commissioner of Labor,Brandt Dismukes,IND,70017,0,0,22,22,
Bryan,Insurance Commissioner,Glen Mulready,REP,70017,1,7,226,234,
Bryan,Insurance Commissioner,Kimberly Fobbs,DEM,70017,1,1,100,102,
Bryan,Corporation Commissioner,Bob Anthony,REP,70017,1,7,219,227,
Bryan,Corporation Commissioner,Ashley Nicole Mccray,DEM,70017,1,1,84,86,
Bryan,Corporation Commissioner,Jackie Short,IND,70017,0,0,24,24,
Bryan,U.S. House,Richard Castaldo,LIB,70017,0,0,7,7,2
Bryan,U.S. House,Markwayne Mullin,REP,70017,1,7,232,240,2
Bryan,U.S. House,Jason Nichols,DEM,70017,1,1,78,80,2
Bryan,U.S. House,John Foreman,IND,70017,0,0,13,13,2
Bryan,State Senate,David Bullard,REP,70017,1,7,179,187,6
Bryan,State Senate,Arnold Bourne,DEM,70017,1,1,151,153,6
Bryan,Governor,Chris Powell,LIB,70018,0,0,10,10,
Bryan,Governor,Kevin Stitt,REP,70018,16,47,441,504,
Bryan,Governor,Drew Edmondson,DEM,70018,6,11,178,195,
Bryan,Lieutenant Governor,Matt Pinnell,REP,70018,16,49,465,530,
Bryan,Lieutenant Governor,Anastasia Pittman,DEM,70018,6,9,150,165,
Bryan,Lieutenant Governor,Ivan Holmes,IND,70018,0,0,14,14,
Bryan,State Auditor,John Yeutter,LIB,70018,2,6,87,95,
Bryan,State Auditor,Cindy Byrd,REP,70018,18,46,505,569,
Bryan,Attorney General,Mike Hunter,REP,70018,16,50,480,546,
Bryan,Attorney General,Mark Myles,DEM,70018,6,8,148,162,
Bryan,State Treasurer,Randy Mcdaniel,REP,70018,16,49,501,566,
Bryan,State Treasurer,Charles De Coune,IND,70018,3,4,91,98,
Bryan,Superintendent of Public Instruction,Joy Hofmeister,REP,70018,13,47,429,489,
Bryan,Superintendent of Public Instruction,John Cox,DEM,70018,6,9,146,161,
Bryan,Superintendent of Public Instruction,Larry Huff,IND,70018,2,2,53,57,
Bryan,Commissioner of Labor,Leslie Osborn,REP,70018,17,48,452,517,
Bryan,Commissioner of Labor,Fred Dorrell,DEM,70018,5,9,144,158,
Bryan,Commissioner of Labor,Brandt Dismukes,IND,70018,0,1,28,29,
Bryan,Insurance Commissioner,Glen Mulready,REP,70018,16,48,459,523,
Bryan,Insurance Commissioner,Kimberly Fobbs,DEM,70018,6,10,165,181,
Bryan,Corporation Commissioner,Bob Anthony,REP,70018,16,48,443,507,
Bryan,Corporation Commissioner,Ashley Nicole Mccray,DEM,70018,5,10,147,162,
Bryan,Corporation Commissioner,Jackie Short,IND,70018,1,0,34,35,
Bryan,U.S. House,Richard Castaldo,LIB,70018,0,0,10,10,2
Bryan,U.S. House,Markwayne Mullin,REP,70018,15,48,459,522,2
Bryan,U.S. House,Jason Nichols,DEM,70018,6,9,144,159,2
Bryan,U.S. House,John Foreman,IND,70018,1,0,18,19,2
Bryan,State Senate,David Bullard,REP,70018,16,47,408,471,6
Bryan,State Senate,Arnold Bourne,DEM,70018,6,11,223,240,6
Bryan,Governor,Chris Powell,LIB,70019,0,2,6,8,
Bryan,Governor,Kevin Stitt,REP,70019,12,40,327,379,
Bryan,Governor,Drew Edmondson,DEM,70019,6,11,160,177,
Bryan,Lieutenant Governor,Matt Pinnell,REP,70019,12,40,363,415,
Bryan,Lieutenant Governor,Anastasia Pittman,DEM,70019,6,11,117,134,
Bryan,Lieutenant Governor,Ivan Holmes,IND,70019,0,2,9,11,
Bryan,State Auditor,John Yeutter,LIB,70019,2,3,62,67,
Bryan,State Auditor,Cindy Byrd,REP,70019,13,44,395,452,
Bryan,Attorney General,Mike Hunter,REP,70019,12,42,371,425,
Bryan,Attorney General,Mark Myles,DEM,70019,6,10,114,130,
Bryan,State Treasurer,Randy Mcdaniel,REP,70019,11,43,382,436,
Bryan,State Treasurer,Charles De Coune,IND,70019,4,5,76,85,
Bryan,Superintendent of Public Instruction,Joy Hofmeister,REP,70019,11,41,341,393,
Bryan,Superintendent of Public Instruction,John Cox,DEM,70019,6,10,127,143,
Bryan,Superintendent of Public Instruction,Larry Huff,IND,70019,1,2,25,28,
Bryan,Commissioner of Labor,Leslie Osborn,REP,70019,11,40,346,397,
Bryan,Commissioner of Labor,Fred Dorrell,DEM,70019,6,10,123,139,
Bryan,Commissioner of Labor,Brandt Dismukes,IND,70019,1,2,20,23,
Bryan,Insurance Commissioner,Glen Mulready,REP,70019,12,40,350,402,
Bryan,Insurance Commissioner,Kimberly Fobbs,DEM,70019,6,12,136,154,
Bryan,Corporation Commissioner,Bob Anthony,REP,70019,12,38,347,397,
Bryan,Corporation Commissioner,Ashley Nicole Mccray,DEM,70019,6,13,125,144,
Bryan,Corporation Commissioner,Jackie Short,IND,70019,0,1,14,15,
Bryan,U.S. House,Richard Castaldo,LIB,70019,0,0,12,12,2
Bryan,U.S. House,Markwayne Mullin,REP,70019,12,41,363,416,2
Bryan,U.S. House,Jason Nichols,DEM,70019,6,10,109,125,2
Bryan,U.S. House,John Foreman,IND,70019,0,2,6,8,2
Bryan,State Senate,David Bullard,REP,70019,11,40,309,360,6
Bryan,State Senate,Arnold Bourne,DEM,70019,7,13,181,201,6
Bryan,Governor,Chris Powell,LIB,70020,2,0,20,22,
Bryan,Governor,Kevin Stitt,REP,70020,8,16,276,300,
Bryan,Governor,Drew Edmondson,DEM,70020,7,3,124,134,
Bryan,Lieutenant Governor,Matt Pinnell,REP,70020,10,17,289,316,
Bryan,Lieutenant Governor,Anastasia Pittman,DEM,70020,7,2,117,126,
Bryan,Lieutenant Governor,Ivan Holmes,IND,70020,0,0,12,12,
Bryan,State Auditor,John Yeutter,LIB,70020,4,2,76,82,
Bryan,State Auditor,Cindy Byrd,REP,70020,11,17,306,334,
Bryan,Attorney General,Mike Hunter,REP,70020,10,17,297,324,
Bryan,Attorney General,Mark Myles,DEM,70020,7,2,120,129,
Bryan,State Treasurer,Randy Mcdaniel,REP,70020,11,16,303,330,
Bryan,State Treasurer,Charles De Coune,IND,70020,4,3,76,83,
Bryan,Superintendent of Public Instruction,Joy Hofmeister,REP,70020,10,15,281,306,
Bryan,Superintendent of Public Instruction,John Cox,DEM,70020,7,3,107,117,
Bryan,Superintendent of Public Instruction,Larry Huff,IND,70020,0,1,28,29,
Bryan,Commissioner of Labor,Leslie Osborn,REP,70020,10,16,278,304,
Bryan,Commissioner of Labor,Fred Dorrell,DEM,70020,7,3,120,130,
Bryan,Commissioner of Labor,Brandt Dismukes,IND,70020,0,0,18,18,
Bryan,Insurance Commissioner,Glen Mulready,REP,70020,10,16,299,325,
Bryan,Insurance Commissioner,Kimberly Fobbs,DEM,70020,7,3,120,130,
Bryan,Corporation Commissioner,Bob Anthony,REP,70020,11,17,280,308,
Bryan,Corporation Commissioner,Ashley Nicole Mccray,DEM,70020,6,2,118,126,
Bryan,Corporation Commissioner,Jackie Short,IND,70020,0,0,18,18,
Bryan,U.S. House,Richard Castaldo,LIB,70020,0,0,4,4,2
Bryan,U.S. House,Markwayne Mullin,REP,70020,10,17,295,322,2
Bryan,U.S. House,Jason Nichols,DEM,70020,7,2,111,120,2
Bryan,U.S. House,John Foreman,IND,70020,0,0,10,10,2
Bryan,State Senate,David Bullard,REP,70020,10,17,290,317,6
Bryan,State Senate,Arnold Bourne,DEM,70020,7,2,127,136,6
Bryan,Governor,Chris Powell,LIB,70021,0,0,10,10,
Bryan,Governor,Kevin Stitt,REP,70021,7,36,314,357,
Bryan,Governor,Drew Edmondson,DEM,70021,3,16,139,158,
Bryan,Lieutenant Governor,Matt Pinnell,REP,70021,7,35,341,383,
Bryan,Lieutenant Governor,Anastasia Pittman,DEM,70021,3,15,105,123,
Bryan,Lieutenant Governor,Ivan Holmes,IND,70021,0,1,14,15,
Bryan,State Auditor,John Yeutter,LIB,70021,2,7,44,53,
Bryan,State Auditor,Cindy Byrd,REP,70021,8,41,395,444,
Bryan,Attorney General,Mike Hunter,REP,70021,8,37,353,398,
Bryan,Attorney General,Mark Myles,DEM,70021,2,14,108,124,
Bryan,State Treasurer,Randy Mcdaniel,REP,70021,7,41,388,436,
Bryan,State Treasurer,Charles De Coune,IND,70021,3,9,50,62,
Bryan,Superintendent of Public Instruction,Joy Hofmeister,REP,70021,7,35,343,385,
Bryan,Superintendent of Public Instruction,John Cox,DEM,70021,3,15,100,118,
Bryan,Superintendent of Public Instruction,Larry Huff,IND,70021,0,0,18,18,
Bryan,Commissioner of Labor,Leslie Osborn,REP,70021,8,37,343,388,
Bryan,Commissioner of Labor,Fred Dorrell,DEM,70021,2,13,100,115,
Bryan,Commissioner of Labor,Brandt Dismukes,IND,70021,0,0,11,11,
Bryan,Insurance Commissioner,Glen Mulready,REP,70021,8,35,341,384,
Bryan,Insurance Commissioner,Kimberly Fobbs,DEM,70021,2,16,114,132,
Bryan,Corporation Commissioner,Bob Anthony,REP,70021,8,34,343,385,
Bryan,Corporation Commissioner,Ashley Nicole Mccray,DEM,70021,2,16,99,117,
Bryan,Corporation Commissioner,Jackie Short,IND,70021,0,1,15,16,
Bryan,U.S. House,Richard Castaldo,LIB,70021,0,0,10,10,2
Bryan,U.S. House,Markwayne Mullin,REP,70021,7,38,334,379,2
Bryan,U.S. House,Jason Nichols,DEM,70021,3,14,110,127,2
Bryan,U.S. House,John Foreman,IND,70021,0,0,9,9,2
Bryan,State Senate,David Bullard,REP,70021,6,34,287,327,6
Bryan,State Senate,Arnold Bourne,DEM,70021,4,18,176,198,6
Bryan,Governor,Chris Powell,LIB,70022,0,1,12,13,
Bryan,Governor,Kevin Stitt,REP,70022,5,31,429,465,
Bryan,Governor,Drew Edmondson,DEM,70022,7,11,184,202,
Bryan,Lieutenant Governor,Matt Pinnell,REP,70022,5,31,452,488,
Bryan,Lieutenant Governor,Anastasia Pittman,DEM,70022,6,11,149,166,
Bryan,Lieutenant Governor,Ivan Holmes,IND,70022,0,0,21,21,
Bryan,State Auditor,John Yeutter,LIB,70022,0,7,91,98,
Bryan,State Auditor,Cindy Byrd,REP,70022,6,32,469,507,
Bryan,Attorney General,Mike Hunter,REP,70022,5,31,450,486,
Bryan,Attorney General,Mark Myles,DEM,70022,7,12,169,188,
Bryan,State Treasurer,Randy Mcdaniel,REP,70022,5,33,465,503,
Bryan,State Treasurer,Charles De Coune,IND,70022,1,6,94,101,
Bryan,Superintendent of Public Instruction,Joy Hofmeister,REP,70022,5,32,432,469,
Bryan,Superintendent of Public Instruction,John Cox,DEM,70022,7,11,157,175,
Bryan,Superintendent of Public Instruction,Larry Huff,IND,70022,0,0,34,34,
Bryan,Commissioner of Labor,Leslie Osborn,REP,70022,7,32,435,474,
Bryan,Commissioner of Labor,Fred Dorrell,DEM,70022,5,11,156,172,
Bryan,Commissioner of Labor,Brandt Dismukes,IND,70022,0,0,24,24,
Bryan,Insurance Commissioner,Glen Mulready,REP,70022,5,31,445,481,
Bryan,Insurance Commissioner,Kimberly Fobbs,DEM,70022,6,12,171,189,
Bryan,Corporation Commissioner,Bob Anthony,REP,70022,6,31,427,464,
Bryan,Corporation Commissioner,Ashley Nicole Mccray,DEM,70022,5,12,165,182,
Bryan,Corporation Commissioner,Jackie Short,IND,70022,0,0,21,21,
Bryan,U.S. House,Richard Castaldo,LIB,70022,1,1,9,11,2
Bryan,U.S. House,Markwayne Mullin,REP,70022,4,30,450,484,2
Bryan,U.S. House,Jason Nichols,DEM,70022,6,12,152,170,2
Bryan,U.S. House,John Foreman,IND,70022,0,0,14,14,2
Bryan,State Senate,David Bullard,REP,70022,5,30,431,466,6
Bryan,State Senate,Arnold Bourne,DEM,70022,7,13,189,209,6
Bryan,Governor,Chris Powell,LIB,70023,0,0,6,6,
Bryan,Governor,Kevin Stitt,REP,70023,2,3,178,183,
Bryan,Governor,Drew Edmondson,DEM,70023,0,3,76,79,
Bryan,Lieutenant Governor,Matt Pinnell,REP,70023,1,4,191,196,
Bryan,Lieutenant Governor,Anastasia Pittman,DEM,70023,1,2,62,65,
Bryan,Lieutenant Governor,Ivan Holmes,IND,70023,0,0,7,7,
Bryan,State Auditor,John Yeutter,LIB,70023,0,1,35,36,
Bryan,State Auditor,Cindy Byrd,REP,70023,2,4,200,206,
Bryan,Attorney General,Mike Hunter,REP,70023,2,4,187,193,
Bryan,Attorney General,Mark Myles,DEM,70023,0,2,69,71,
Bryan,State Treasurer,Randy Mcdaniel,REP,70023,2,2,194,198,
Bryan,State Treasurer,Charles De Coune,IND,70023,0,3,36,39,
Bryan,Superintendent of Public Instruction,Joy Hofmeister,REP,70023,2,2,175,179,
Bryan,Superintendent of Public Instruction,John Cox,DEM,70023,0,4,68,72,
Bryan,Superintendent of Public Instruction,Larry Huff,IND,70023,0,0,12,12,
Bryan,Commissioner of Labor,Leslie Osborn,REP,70023,2,2,175,179,
Bryan,Commissioner of Labor,Fred Dorrell,DEM,70023,0,4,73,77,
Bryan,Commissioner of Labor,Brandt Dismukes,IND,70023,0,0,8,8,
Bryan,Insurance Commissioner,Glen Mulready,REP,70023,2,3,186,191,
Bryan,Insurance Commissioner,Kimberly Fobbs,DEM,70023,0,3,70,73,
Bryan,Corporation Commissioner,Bob Anthony,REP,70023,2,3,177,182,
Bryan,Corporation Commissioner,Ashley Nicole Mccray,DEM,70023,0,3,65,68,
Bryan,Corporation Commissioner,Jackie Short,IND,70023,0,0,14,14,
Bryan,U.S. House,Richard Castaldo,LIB,70023,0,0,4,4,2
Bryan,U.S. House,Markwayne Mullin,REP,70023,1,2,183,186,2
Bryan,U.S. House,Jason Nichols,DEM,70023,1,4,69,74,2
Bryan,U.S. House,John Foreman,IND,70023,0,0,3,3,2
Bryan,State Senate,David Bullard,REP,70023,2,3,160,165,6
Bryan,State Senate,Arnold Bourne,DEM,70023,0,3,97,100,6
Bryan,Governor,Chris Powell,LIB,70025,0,1,23,24,
Bryan,Governor,Kevin Stitt,REP,70025,13,59,403,475,
Bryan,Governor,Drew Edmondson,DEM,70025,10,18,201,229,
Bryan,Lieutenant Governor,Matt Pinnell,REP,70025,15,60,430,505,
Bryan,Lieutenant Governor,Anastasia Pittman,DEM,70025,8,15,178,201,
Bryan,Lieutenant Governor,Ivan Holmes,IND,70025,0,2,16,18,
Bryan,State Auditor,John Yeutter,LIB,70025,4,6,111,121,
Bryan,State Auditor,Cindy Byrd,REP,70025,17,61,464,542,
Bryan,Attorney General,Mike Hunter,REP,70025,17,61,436,514,
Bryan,Attorney General,Mark Myles,DEM,70025,6,16,187,209,
Bryan,State Treasurer,Randy Mcdaniel,REP,70025,16,63,459,538,
Bryan,State Treasurer,Charles De Coune,IND,70025,5,3,116,124,
Bryan,Superintendent of Public Instruction,Joy Hofmeister,REP,70025,15,55,416,486,
Bryan,Superintendent of Public Instruction,John Cox,DEM,70025,8,19,162,189,
Bryan,Superintendent of Public Instruction,Larry Huff,IND,70025,0,3,41,44,
Bryan,Commissioner of Labor,Leslie Osborn,REP,70025,17,57,417,491,
Bryan,Commissioner of Labor,Fred Dorrell,DEM,70025,6,18,172,196,
Bryan,Commissioner of Labor,Brandt Dismukes,IND,70025,0,2,27,29,
Bryan,Insurance Commissioner,Glen Mulready,REP,70025,16,62,421,499,
Bryan,Insurance Commissioner,Kimberly Fobbs,DEM,70025,7,15,200,222,
Bryan,Corporation Commissioner,Bob Anthony,REP,70025,18,58,406,482,
Bryan,Corporation Commissioner,Ashley Nicole Mccray,DEM,70025,5,17,176,198,
Bryan,Corporation Commissioner,Jackie Short,IND,70025,0,2,36,38,
Bryan,U.S. House,Richard Castaldo,LIB,70025,0,1,13,14,2
Bryan,U.S. House,Markwayne Mullin,REP,70025,15,60,408,483,2
Bryan,U.S. House,Jason Nichols,DEM,70025,8,17,183,208,2
Bryan,U.S. House,John Foreman,IND,70025,0,0,20,20,2
Bryan,State Senate,David Bullard,REP,70025,15,59,401,475,6
Bryan,State Senate,Arnold Bourne,DEM,70025,8,18,226,252,6
Bryan,Governor,Chris Powell,LIB,70026,1,1,1,3,
Bryan,Governor,Kevin Stitt,REP,70026,2,19,244,265,
Bryan,Governor,Drew Edmondson,DEM,70026,10,21,119,150,
Bryan,Lieutenant Governor,Matt Pinnell,REP,70026,3,20,267,290,
Bryan,Lieutenant Governor,Anastasia Pittman,DEM,70026,9,19,84,112,
Bryan,Lieutenant Governor,Ivan Holmes,IND,70026,1,2,11,14,
Bryan,State Auditor,John Yeutter,LIB,70026,7,8,40,55,
Bryan,State Auditor,Cindy Byrd,REP,70026,5,25,301,331,
Bryan,Attorney General,Mike Hunter,REP,70026,4,21,270,295,
Bryan,Attorney General,Mark Myles,DEM,70026,9,20,91,120,
Bryan,State Treasurer,Randy Mcdaniel,REP,70026,3,23,286,312,
Bryan,State Treasurer,Charles De Coune,IND,70026,9,10,52,71,
Bryan,Superintendent of Public Instruction,Joy Hofmeister,REP,70026,3,19,254,276,
Bryan,Superintendent of Public Instruction,John Cox,DEM,70026,9,18,87,114,
Bryan,Superintendent of Public Instruction,Larry Huff,IND,70026,1,4,19,24,
Bryan,Commissioner of Labor,Leslie Osborn,REP,70026,6,20,268,294,
Bryan,Commissioner of Labor,Fred Dorrell,DEM,70026,7,14,82,103,
Bryan,Commissioner of Labor,Brandt Dismukes,IND,70026,0,5,8,13,
Bryan,Insurance Commissioner,Glen Mulready,REP,70026,4,21,266,291,
Bryan,Insurance Commissioner,Kimberly Fobbs,DEM,70026,9,20,93,122,
Bryan,Corporation Commissioner,Bob Anthony,REP,70026,3,19,257,279,
Bryan,Corporation Commissioner,Ashley Nicole Mccray,DEM,70026,7,17,88,112,
Bryan,Corporation Commissioner,Jackie Short,IND,70026,3,5,14,22,
Bryan,U.S. House,Richard Castaldo,LIB,70026,1,2,5,8,2
Bryan,U.S. House,Markwayne Mullin,REP,70026,3,22,255,280,2
Bryan,U.S. House,Jason Nichols,DEM,70026,9,17,93,119,2
Bryan,U.S. House,John Foreman,IND,70026,0,0,10,10,2
Bryan,State Senate,David Bullard,REP,70026,4,21,231,256,6
Bryan,State Senate,Arnold Bourne,DEM,70026,9,20,131,160,6
Bryan,Governor,Chris Powell,LIB,70027,1,1,13,15,
Bryan,Governor,Kevin Stitt,REP,70027,8,55,381,444,
Bryan,Governor,Drew Edmondson,DEM,70027,9,17,195,221,
Bryan,Lieutenant Governor,Matt Pinnell,REP,70027,9,58,400,467,
Bryan,Lieutenant Governor,Anastasia Pittman,DEM,70027,8,15,165,188,
Bryan,Lieutenant Governor,Ivan Holmes,IND,70027,1,0,20,21,
Bryan,State Auditor,John Yeutter,LIB,70027,5,5,87,97,
Bryan,State Auditor,Cindy Byrd,REP,70027,10,62,466,538,
Bryan,Attorney General,Mike Hunter,REP,70027,9,59,411,479,
Bryan,Attorney General,Mark Myles,DEM,70027,9,14,172,195,
Bryan,State Treasurer,Randy Mcdaniel,REP,70027,9,61,447,517,
Bryan,State Treasurer,Charles De Coune,IND,70027,6,6,105,117,
Bryan,Superintendent of Public Instruction,Joy Hofmeister,REP,70027,8,57,381,446,
Bryan,Superintendent of Public Instruction,John Cox,DEM,70027,10,14,158,182,
Bryan,Superintendent of Public Instruction,Larry Huff,IND,70027,0,2,46,48,
Bryan,Commissioner of Labor,Leslie Osborn,REP,70027,9,56,389,454,
Bryan,Commissioner of Labor,Fred Dorrell,DEM,70027,9,13,148,170,
Bryan,Commissioner of Labor,Brandt Dismukes,IND,70027,0,4,38,42,
Bryan,Insurance Commissioner,Glen Mulready,REP,70027,9,58,398,465,
Bryan,Insurance Commissioner,Kimberly Fobbs,DEM,70027,9,14,178,201,
Bryan,Corporation Commissioner,Bob Anthony,REP,70027,9,54,390,453,
Bryan,Corporation Commissioner,Ashley Nicole Mccray,DEM,70027,9,17,158,184,
Bryan,Corporation Commissioner,Jackie Short,IND,70027,0,2,29,31,
Bryan,U.S. House,Richard Castaldo,LIB,70027,0,1,10,11,2
Bryan,U.S. House,Markwayne Mullin,REP,70027,9,57,390,456,2
Bryan,U.S. House,Jason Nichols,DEM,70027,9,14,170,193,2
Bryan,U.S. House,John Foreman,IND,70027,0,1,19,20,2
Bryan,State Senate,David Bullard,REP,70027,8,52,372,432,6
Bryan,State Senate,Arnold Bourne,DEM,70027,10,21,217,248,6
Bryan,Governor,Chris Powell,LIB,70028,1,1,14,16,
Bryan,Governor,Kevin Stitt,REP,70028,8,26,300,334,
Bryan,Governor,Drew Edmondson,DEM,70028,1,13,138,152,
Bryan,Lieutenant Governor,Matt Pinnell,REP,70028,9,27,332,368,
Bryan,Lieutenant Governor,Anastasia Pittman,DEM,70028,1,12,104,117,
Bryan,Lieutenant Governor,Ivan Holmes,IND,70028,0,1,10,11,
Bryan,State Auditor,John Yeutter,LIB,70028,2,7,56,65,
Bryan,State Auditor,Cindy Byrd,REP,70028,8,32,370,410,
Bryan,Attorney General,Mike Hunter,REP,70028,9,27,340,376,
Bryan,Attorney General,Mark Myles,DEM,70028,1,13,104,118,
Bryan,State Treasurer,Randy Mcdaniel,REP,70028,8,32,368,408,
Bryan,State Treasurer,Charles De Coune,IND,70028,2,7,58,67,
Bryan,Superintendent of Public Instruction,Joy Hofmeister,REP,70028,9,32,317,358,
Bryan,Superintendent of Public Instruction,John Cox,DEM,70028,1,7,105,113,
Bryan,Superintendent of Public Instruction,Larry Huff,IND,70028,0,1,23,24,
Bryan,Commissioner of Labor,Leslie Osborn,REP,70028,9,27,310,346,
Bryan,Commissioner of Labor,Fred Dorrell,DEM,70028,1,11,117,129,
Bryan,Commissioner of Labor,Brandt Dismukes,IND,70028,0,2,16,18,
Bryan,Insurance Commissioner,Glen Mulready,REP,70028,8,27,320,355,
Bryan,Insurance Commissioner,Kimberly Fobbs,DEM,70028,2,13,125,140,
Bryan,Corporation Commissioner,Bob Anthony,REP,70028,8,27,318,353,
Bryan,Corporation Commissioner,Ashley Nicole Mccray,DEM,70028,1,12,110,123,
Bryan,Corporation Commissioner,Jackie Short,IND,70028,1,1,17,19,
Bryan,U.S. House,Richard Castaldo,LIB,70028,0,0,9,9,2
Bryan,U.S. House,Markwayne Mullin,REP,70028,9,28,327,364,2
Bryan,U.S. House,Jason Nichols,DEM,70028,1,11,107,119,2
Bryan,U.S. House,John Foreman,IND,70028,0,1,8,9,2
Bryan,State Senate,David Bullard,REP,70028,8,25,299,332,6
Bryan,State Senate,Arnold Bourne,DEM,70028,2,15,155,172,6
Bryan,Governor,Chris Powell,LIB,70029,0,0,4,4,
Bryan,Governor,Kevin Stitt,REP,70029,0,3,78,81,
Bryan,Governor,Drew Edmondson,DEM,70029,0,3,59,62,
Bryan,Lieutenant Governor,Matt Pinnell,REP,70029,0,3,90,93,
Bryan,Lieutenant Governor,Anastasia Pittman,DEM,70029,0,1,46,47,
Bryan,Lieutenant Governor,Ivan Holmes,IND,70029,0,0,2,2,
Bryan,State Auditor,John Yeutter,LIB,70029,0,0,28,28,
Bryan,State Auditor,Cindy Byrd,REP,70029,0,5,92,97,
Bryan,Attorney General,Mike Hunter,REP,70029,0,4,83,87,
Bryan,Attorney General,Mark Myles,DEM,70029,0,0,54,54,
Bryan,State Treasurer,Randy Mcdaniel,REP,70029,0,3,91,94,
Bryan,State Treasurer,Charles De Coune,IND,70029,0,0,28,28,
Bryan,Superintendent of Public Instruction,Joy Hofmeister,REP,70029,0,5,82,87,
Bryan,Superintendent of Public Instruction,John Cox,DEM,70029,0,0,51,51,
Bryan,Superintendent of Public Instruction,Larry Huff,IND,70029,0,0,4,4,
Bryan,Commissioner of Labor,Leslie Osborn,REP,70029,0,2,85,87,
Bryan,Commissioner of Labor,Fred Dorrell,DEM,70029,0,1,51,52,
Bryan,Commissioner of Labor,Brandt Dismukes,IND,70029,0,0,1,1,
Bryan,Insurance Commissioner,Glen Mulready,REP,70029,0,2,84,86,
Bryan,Insurance Commissioner,Kimberly Fobbs,DEM,70029,0,1,52,53,
Bryan,Corporation Commissioner,Bob Anthony,REP,70029,0,3,85,88,
Bryan,Corporation Commissioner,Ashley Nicole Mccray,DEM,70029,0,0,47,47,
Bryan,Corporation Commissioner,Jackie Short,IND,70029,0,0,5,5,
Bryan,U.S. House,Richard Castaldo,LIB,70029,0,0,0,0,2
Bryan,U.S. House,Markwayne Mullin,REP,70029,0,5,82,87,2
Bryan,U.S. House,Jason Nichols,DEM,70029,0,0,53,53,2
Bryan,U.S. House,John Foreman,IND,70029,0,0,3,3,2
Bryan,State Senate,David Bullard,REP,70029,0,3,86,89,6
Bryan,State Senate,Arnold Bourne,DEM,70029,0,3,55,58,6
Bryan,State House,Justin Humphrey,REP,70029,0,4,86,90,19
Bryan,State House,Lewis Collins,DEM,70029,0,1,52,53,19
Bryan,Governor,Chris Powell,LIB,70033,0,7,13,20,
Bryan,Governor,Kevin Stitt,REP,70033,34,118,631,783,
Bryan,Governor,Drew Edmondson,DEM,70033,19,50,281,350,
Bryan,Lieutenant Governor,Matt Pinnell,REP,70033,37,137,685,859,
Bryan,Lieutenant Governor,Anastasia Pittman,DEM,70033,16,36,209,261,
Bryan,Lieutenant Governor,Ivan Holmes,IND,70033,0,2,26,28,
Bryan,State Auditor,John Yeutter,LIB,70033,12,21,135,168,
Bryan,State Auditor,Cindy Byrd,REP,70033,35,139,752,926,
Bryan,Attorney General,Mike Hunter,REP,70033,37,139,700,876,
Bryan,Attorney General,Mark Myles,DEM,70033,16,35,212,263,
Bryan,State Treasurer,Randy Mcdaniel,REP,70033,36,141,728,905,
Bryan,State Treasurer,Charles De Coune,IND,70033,12,20,156,188,
Bryan,Superintendent of Public Instruction,Joy Hofmeister,REP,70033,29,123,645,797,
Bryan,Superintendent of Public Instruction,John Cox,DEM,70033,22,40,201,263,
Bryan,Superintendent of Public Instruction,Larry Huff,IND,70033,2,9,67,78,
Bryan,Commissioner of Labor,Leslie Osborn,REP,70033,28,120,665,813,
Bryan,Commissioner of Labor,Fred Dorrell,DEM,70033,22,42,198,262,
Bryan,Commissioner of Labor,Brandt Dismukes,IND,70033,3,8,42,53,
Bryan,Insurance Commissioner,Glen Mulready,REP,70033,33,136,666,835,
Bryan,Insurance Commissioner,Kimberly Fobbs,DEM,70033,20,38,243,301,
Bryan,Corporation Commissioner,Bob Anthony,REP,70033,35,127,644,806,
Bryan,Corporation Commissioner,Ashley Nicole Mccray,DEM,70033,17,40,219,276,
Bryan,Corporation Commissioner,Jackie Short,IND,70033,1,7,48,56,
Bryan,U.S. House,Richard Castaldo,LIB,70033,0,5,20,25,2
Bryan,U.S. House,Markwayne Mullin,REP,70033,32,126,639,797,2
Bryan,U.S. House,Jason Nichols,DEM,70033,20,42,235,297,2
Bryan,U.S. House,John Foreman,IND,70033,1,2,27,30,2
Bryan,State Senate,David Bullard,REP,70033,30,117,587,734,6
Bryan,State Senate,Arnold Bourne,DEM,70033,23,58,332,413,6
Caddo,Governor,Chris Powell,LIB,80012,0,0,16,16,
Caddo,Governor,Kevin Stitt,REP,80012,1,5,63,69,
Caddo,Governor,Drew Edmondson,DEM,80012,4,5,159,168,
Caddo,Lieutenant Governor,Matt Pinnell,REP,80012,3,6,67,76,
Caddo,Lieutenant Governor,Anastasia Pittman,DEM,80012,2,3,165,170,
Caddo,Lieutenant Governor,Ivan Holmes,IND,80012,0,1,6,7,
Caddo,State Auditor,John Yeutter,LIB,80012,1,4,120,125,
Caddo,State Auditor,Cindy Byrd,REP,80012,4,6,100,110,
Caddo,Attorney General,Mike Hunter,REP,80012,3,5,68,76,
Caddo,Attorney General,Mark Myles,DEM,80012,2,5,169,176,
Caddo,State Treasurer,Randy Mcdaniel,REP,80012,4,6,83,93,
Caddo,State Treasurer,Charles De Coune,IND,80012,1,4,135,140,
Caddo,Superintendent of Public Instruction,Joy Hofmeister,REP,80012,0,6,69,75,
Caddo,Superintendent of Public Instruction,John Cox,DEM,80012,5,4,149,158,
Caddo,Superintendent of Public Instruction,Larry Huff,IND,80012,0,0,21,21,
Caddo,Commissioner of Labor,Leslie Osborn,REP,80012,1,5,69,75,
Caddo,Commissioner of Labor,Fred Dorrell,DEM,80012,4,5,156,165,
Caddo,Commissioner of Labor,Brandt Dismukes,IND,80012,0,0,13,13,
Caddo,Insurance Commissioner,Glen Mulready,REP,80012,3,6,71,80,
Caddo,Insurance Commissioner,Kimberly Fobbs,DEM,80012,2,4,166,172,
Caddo,Corporation Commissioner,Bob Anthony,REP,80012,2,4,61,67,
Caddo,Corporation Commissioner,Ashley Nicole Mccray,DEM,80012,3,6,160,169,
Caddo,Corporation Commissioner,Jackie Short,IND,80012,0,0,16,16,
Caddo,U.S. House,Frank Lucas,REP,80012,2,6,72,80,3
Caddo,U.S. House,Frankie Robbins,DEM,80012,3,4,166,173,3
Caddo,State House,Charles Wells,REP,80012,0,1,47,48,56
Caddo,State House,David Perryman,DEM,80012,5,9,190,204,56
Caddo,Governor,Chris Powell,LIB,80022,0,1,11,12,
Caddo,Governor,Kevin Stitt,REP,80022,4,20,89,113,
Caddo,Governor,Drew Edmondson,DEM,80022,3,8,169,180,
Caddo,Lieutenant Governor,Matt Pinnell,REP,80022,3,20,99,122,
Caddo,Lieutenant Governor,Anastasia Pittman,DEM,80022,3,7,158,168,
Caddo,Lieutenant Governor,Ivan Holmes,IND,80022,1,2,12,15,
Caddo,State Auditor,John Yeutter,LIB,80022,3,4,92,99,
Caddo,State Auditor,Cindy Byrd,REP,80022,4,23,151,178,
Caddo,Attorney General,Mike Hunter,REP,80022,3,21,113,137,
Caddo,Attorney General,Mark Myles,DEM,80022,4,8,155,167,
Caddo,State Treasurer,Randy Mcdaniel,REP,80022,4,22,140,166,
Caddo,State Treasurer,Charles De Coune,IND,80022,3,6,103,112,
Caddo,Superintendent of Public Instruction,Joy Hofmeister,REP,80022,3,21,95,119,
Caddo,Superintendent of Public Instruction,John Cox,DEM,80022,3,6,144,153,
Caddo,Superintendent of Public Instruction,Larry Huff,IND,80022,1,2,28,31,
Caddo,Commissioner of Labor,Leslie Osborn,REP,80022,4,21,104,129,
Caddo,Commissioner of Labor,Fred Dorrell,DEM,80022,3,7,154,164,
Caddo,Commissioner of Labor,Brandt Dismukes,IND,80022,0,0,9,9,
Caddo,Insurance Commissioner,Glen Mulready,REP,80022,4,18,106,128,
Caddo,Insurance Commissioner,Kimberly Fobbs,DEM,80022,3,10,160,173,
Caddo,Corporation Commissioner,Bob Anthony,REP,80022,3,18,104,125,
Caddo,Corporation Commissioner,Ashley Nicole Mccray,DEM,80022,3,7,153,163,
Caddo,Corporation Commissioner,Jackie Short,IND,80022,1,3,11,15,
Caddo,U.S. House,Frank Lucas,REP,80022,4,22,123,149,3
Caddo,U.S. House,Frankie Robbins,DEM,80022,3,7,145,155,3
Caddo,State House,Charles Wells,REP,80022,3,15,71,89,56
Caddo,State House,David Perryman,DEM,80022,4,14,194,212,56
Caddo,Governor,Chris Powell,LIB,80031,0,0,7,7,
Caddo,Governor,Kevin Stitt,REP,80031,0,8,54,62,
Caddo,Governor,Drew Edmondson,DEM,80031,2,5,124,131,
Caddo,Lieutenant Governor,Matt Pinnell,REP,80031,0,9,56,65,
Caddo,Lieutenant Governor,Anastasia Pittman,DEM,80031,2,4,116,122,
Caddo,Lieutenant Governor,Ivan Holmes,IND,80031,0,0,14,14,
Caddo,State Auditor,John Yeutter,LIB,80031,0,1,81,82,
Caddo,State Auditor,Cindy Byrd,REP,80031,1,11,86,98,
Caddo,Attorney General,Mike Hunter,REP,80031,0,8,65,73,
Caddo,Attorney General,Mark Myles,DEM,80031,2,5,117,124,
Caddo,State Treasurer,Randy Mcdaniel,REP,80031,0,10,79,89,
Caddo,State Treasurer,Charles De Coune,IND,80031,0,2,87,89,
Caddo,Superintendent of Public Instruction,Joy Hofmeister,REP,80031,0,9,66,75,
Caddo,Superintendent of Public Instruction,John Cox,DEM,80031,2,3,107,112,
Caddo,Superintendent of Public Instruction,Larry Huff,IND,80031,0,1,10,11,
Caddo,Commissioner of Labor,Leslie Osborn,REP,80031,1,9,56,66,
Caddo,Commissioner of Labor,Fred Dorrell,DEM,80031,1,4,117,122,
Caddo,Commissioner of Labor,Brandt Dismukes,IND,80031,0,0,8,8,
Caddo,Insurance Commissioner,Glen Mulready,REP,80031,0,8,58,66,
Caddo,Insurance Commissioner,Kimberly Fobbs,DEM,80031,2,5,122,129,
Caddo,Corporation Commissioner,Bob Anthony,REP,80031,0,10,54,64,
Caddo,Corporation Commissioner,Ashley Nicole Mccray,DEM,80031,2,3,117,122,
Caddo,Corporation Commissioner,Jackie Short,IND,80031,0,0,12,12,
Caddo,U.S. House,Frank Lucas,REP,80031,1,9,71,81,3
Caddo,U.S. House,Frankie Robbins,DEM,80031,1,4,111,116,3
Caddo,State House,Charles Wells,REP,80031,0,5,33,38,56
Caddo,State House,David Perryman,DEM,80031,2,8,151,161,56
Caddo,Governor,Chris Powell,LIB,80041,0,3,15,18,
Caddo,Governor,Kevin Stitt,REP,80041,4,35,228,267,
Caddo,Governor,Drew Edmondson,DEM,80041,11,27,243,281,
Caddo,Lieutenant Governor,Matt Pinnell,REP,80041,4,43,266,313,
Caddo,Lieutenant Governor,Anastasia Pittman,DEM,80041,7,21,203,231,
Caddo,Lieutenant Governor,Ivan Holmes,IND,80041,2,0,16,18,
Caddo,State Auditor,John Yeutter,LIB,80041,5,14,137,156,
Caddo,State Auditor,Cindy Byrd,REP,80041,8,49,313,370,
Caddo,Attorney General,Mike Hunter,REP,80041,6,43,274,323,
Caddo,Attorney General,Mark Myles,DEM,80041,7,21,211,239,
Caddo,State Treasurer,Randy Mcdaniel,REP,80041,8,52,298,358,
Caddo,State Treasurer,Charles De Coune,IND,80041,4,11,152,167,
Caddo,Superintendent of Public Instruction,Joy Hofmeister,REP,80041,6,41,241,288,
Caddo,Superintendent of Public Instruction,John Cox,DEM,80041,6,22,208,236,
Caddo,Superintendent of Public Instruction,Larry Huff,IND,80041,1,1,33,35,
Caddo,Commissioner of Labor,Leslie Osborn,REP,80041,9,45,254,308,
Caddo,Commissioner of Labor,Fred Dorrell,DEM,80041,4,19,204,227,
Caddo,Commissioner of Labor,Brandt Dismukes,IND,80041,0,0,21,21,
Caddo,Insurance Commissioner,Glen Mulready,REP,80041,3,39,246,288,
Caddo,Insurance Commissioner,Kimberly Fobbs,DEM,80041,8,25,233,266,
Caddo,Corporation Commissioner,Bob Anthony,REP,80041,5,37,255,297,
Caddo,Corporation Commissioner,Ashley Nicole Mccray,DEM,80041,7,27,199,233,
Caddo,Corporation Commissioner,Jackie Short,IND,80041,3,0,26,29,
Caddo,U.S. House,Frank Lucas,REP,80041,10,42,286,338,3
Caddo,U.S. House,Frankie Robbins,DEM,80041,3,22,200,225,3
Caddo,State House,Charles Wells,REP,80041,3,20,157,180,56
Caddo,State House,David Perryman,DEM,80041,10,44,329,383,56
Caddo,Governor,Chris Powell,LIB,80051,0,4,12,16,
Caddo,Governor,Kevin Stitt,REP,80051,9,36,247,292,
Caddo,Governor,Drew Edmondson,DEM,80051,6,54,414,474,
Caddo,Lieutenant Governor,Matt Pinnell,REP,80051,9,51,324,384,
Caddo,Lieutenant Governor,Anastasia Pittman,DEM,80051,5,39,328,372,
Caddo,Lieutenant Governor,Ivan Holmes,IND,80051,1,4,20,25,
Caddo,State Auditor,John Yeutter,LIB,80051,4,28,219,251,
Caddo,State Auditor,Cindy Byrd,REP,80051,10,61,403,474,
Caddo,Attorney General,Mike Hunter,REP,80051,7,45,330,382,
Caddo,Attorney General,Mark Myles,DEM,80051,8,48,341,397,
Caddo,State Treasurer,Randy Mcdaniel,REP,80051,8,58,390,456,
Caddo,State Treasurer,Charles De Coune,IND,80051,6,30,232,268,
Caddo,Superintendent of Public Instruction,Joy Hofmeister,REP,80051,9,48,297,354,
Caddo,Superintendent of Public Instruction,John Cox,DEM,80051,5,40,318,363,
Caddo,Superintendent of Public Instruction,Larry Huff,IND,80051,1,6,55,62,
Caddo,Commissioner of Labor,Leslie Osborn,REP,80051,10,51,302,363,
Caddo,Commissioner of Labor,Fred Dorrell,DEM,80051,5,39,337,381,
Caddo,Commissioner of Labor,Brandt Dismukes,IND,80051,0,2,27,29,
Caddo,Insurance Commissioner,Glen Mulready,REP,80051,9,48,295,352,
Caddo,Insurance Commissioner,Kimberly Fobbs,DEM,80051,6,45,375,426,
Caddo,Corporation Commissioner,Bob Anthony,REP,80051,9,52,309,370,
Caddo,Corporation Commissioner,Ashley Nicole Mccray,DEM,80051,6,42,331,379,
Caddo,Corporation Commissioner,Jackie Short,IND,80051,0,0,31,31,
Caddo,U.S. House,Frank Lucas,REP,80051,7,52,369,428,3
Caddo,U.S. House,Frankie Robbins,DEM,80051,8,42,306,356,3
Caddo,State House,Charles Wells,REP,80051,6,25,135,166,56
Caddo,State House,David Perryman,DEM,80051,9,69,540,618,56
Caddo,Governor,Chris Powell,LIB,80102,1,0,19,20,
Caddo,Governor,Kevin Stitt,REP,80102,18,13,331,362,
Caddo,Governor,Drew Edmondson,DEM,80102,10,5,263,278,
Caddo,Lieutenant Governor,Matt Pinnell,REP,80102,20,15,375,410,
Caddo,Lieutenant Governor,Anastasia Pittman,DEM,80102,8,4,202,214,
Caddo,Lieutenant Governor,Ivan Holmes,IND,80102,0,0,29,29,
Caddo,State Auditor,John Yeutter,LIB,80102,3,5,148,156,
Caddo,State Auditor,Cindy Byrd,REP,80102,22,13,420,455,
Caddo,Attorney General,Mike Hunter,REP,80102,19,11,387,417,
Caddo,Attorney General,Mark Myles,DEM,80102,9,6,215,230,
Caddo,State Treasurer,Randy Mcdaniel,REP,80102,20,13,426,459,
Caddo,State Treasurer,Charles De Coune,IND,80102,5,4,140,149,
Caddo,Superintendent of Public Instruction,Joy Hofmeister,REP,80102,19,10,348,377,
Caddo,Superintendent of Public Instruction,John Cox,DEM,80102,7,8,218,233,
Caddo,Superintendent of Public Instruction,Larry Huff,IND,80102,2,1,41,44,
Caddo,Commissioner of Labor,Leslie Osborn,REP,80102,20,14,370,404,
Caddo,Commissioner of Labor,Fred Dorrell,DEM,80102,8,3,205,216,
Caddo,Commissioner of Labor,Brandt Dismukes,IND,80102,0,0,27,27,
Caddo,Insurance Commissioner,Glen Mulready,REP,80102,20,13,356,389,
Caddo,Insurance Commissioner,Kimberly Fobbs,DEM,80102,7,5,243,255,
Caddo,Corporation Commissioner,Bob Anthony,REP,80102,21,15,355,391,
Caddo,Corporation Commissioner,Ashley Nicole Mccray,DEM,80102,8,3,212,223,
Caddo,Corporation Commissioner,Jackie Short,IND,80102,0,0,38,38,
Caddo,U.S. House,Frank Lucas,REP,80102,22,14,419,455,3
Caddo,U.S. House,Frankie Robbins,DEM,80102,7,4,187,198,3
Caddo,Governor,Chris Powell,LIB,80509,1,4,13,18,
Caddo,Governor,Kevin Stitt,REP,80509,1,10,175,186,
Caddo,Governor,Drew Edmondson,DEM,80509,2,0,104,106,
Caddo,Lieutenant Governor,Matt Pinnell,REP,80509,2,11,194,207,
Caddo,Lieutenant Governor,Anastasia Pittman,DEM,80509,1,0,83,84,
Caddo,Lieutenant Governor,Ivan Holmes,IND,80509,1,3,12,16,
Caddo,State Auditor,John Yeutter,LIB,80509,1,3,52,56,
Caddo,State Auditor,Cindy Byrd,REP,80509,3,11,217,231,
Caddo,Attorney General,Mike Hunter,REP,80509,2,11,196,209,
Caddo,Attorney General,Mark Myles,DEM,80509,2,3,94,99,
Caddo,State Treasurer,Randy Mcdaniel,REP,80509,3,11,208,222,
Caddo,State Treasurer,Charles De Coune,IND,80509,1,3,61,65,
Caddo,Superintendent of Public Instruction,Joy Hofmeister,REP,80509,1,10,176,187,
Caddo,Superintendent of Public Instruction,John Cox,DEM,80509,0,1,87,88,
Caddo,Superintendent of Public Instruction,Larry Huff,IND,80509,3,3,28,34,
Caddo,Commissioner of Labor,Leslie Osborn,REP,80509,3,9,189,201,
Caddo,Commissioner of Labor,Fred Dorrell,DEM,80509,0,1,86,87,
Caddo,Commissioner of Labor,Brandt Dismukes,IND,80509,1,4,13,18,
Caddo,Insurance Commissioner,Glen Mulready,REP,80509,2,11,182,195,
Caddo,Insurance Commissioner,Kimberly Fobbs,DEM,80509,2,3,107,112,
Caddo,Corporation Commissioner,Bob Anthony,REP,80509,4,9,187,200,
Caddo,Corporation Commissioner,Ashley Nicole Mccray,DEM,80509,0,1,87,88,
Caddo,Corporation Commissioner,Jackie Short,IND,80509,0,4,15,19,
Caddo,U.S. House,Frank Lucas,REP,80509,3,12,192,207,3
Caddo,U.S. House,Frankie Robbins,DEM,80509,1,2,98,101,3
Caddo,State House,Toni Hasenbeck,REP,80509,2,7,128,137,65
Caddo,State House,Brandon Thompson,DEM,80509,2,7,166,175,65
Caddo,Governor,Chris Powell,LIB,80510,0,1,18,19,
Caddo,Governor,Kevin Stitt,REP,80510,9,17,297,323,
Caddo,Governor,Drew Edmondson,DEM,80510,5,9,164,178,
Caddo,Lieutenant Governor,Matt Pinnell,REP,80510,12,22,341,375,
Caddo,Lieutenant Governor,Anastasia Pittman,DEM,80510,2,4,114,120,
Caddo,Lieutenant Governor,Ivan Holmes,IND,80510,0,1,21,22,
Caddo,State Auditor,John Yeutter,LIB,80510,1,4,78,83,
Caddo,State Auditor,Cindy Byrd,REP,80510,12,23,382,417,
Caddo,Attorney General,Mike Hunter,REP,80510,9,22,350,381,
Caddo,Attorney General,Mark Myles,DEM,80510,5,5,124,134,
Caddo,State Treasurer,Randy Mcdaniel,REP,80510,13,24,378,415,
Caddo,State Treasurer,Charles De Coune,IND,80510,0,3,79,82,
Caddo,Superintendent of Public Instruction,Joy Hofmeister,REP,80510,9,21,305,335,
Caddo,Superintendent of Public Instruction,John Cox,DEM,80510,5,5,129,139,
Caddo,Superintendent of Public Instruction,Larry Huff,IND,80510,0,1,42,43,
Caddo,Commissioner of Labor,Leslie Osborn,REP,80510,10,21,325,356,
Caddo,Commissioner of Labor,Fred Dorrell,DEM,80510,4,5,121,130,
Caddo,Commissioner of Labor,Brandt Dismukes,IND,80510,0,0,21,21,
Caddo,Insurance Commissioner,Glen Mulready,REP,80510,12,20,344,376,
Caddo,Insurance Commissioner,Kimberly Fobbs,DEM,80510,2,6,125,133,
Caddo,Corporation Commissioner,Bob Anthony,REP,80510,12,21,334,367,
Caddo,Corporation Commissioner,Ashley Nicole Mccray,DEM,80510,2,6,114,122,
Caddo,Corporation Commissioner,Jackie Short,IND,80510,0,0,26,26,
Caddo,U.S. House,Frank Lucas,REP,80510,9,22,369,400,3
Caddo,U.S. House,Frankie Robbins,DEM,80510,5,5,107,117,3
Caddo,State House,Toni Hasenbeck,REP,80510,5,14,163,182,65
Caddo,State House,Brandon Thompson,DEM,80510,9,13,318,340,65
Caddo,Governor,Chris Powell,LIB,80511,0,0,25,25,
Caddo,Governor,Kevin Stitt,REP,80511,15,9,361,385,
Caddo,Governor,Drew Edmondson,DEM,80511,6,12,274,292,
Caddo,Lieutenant Governor,Matt Pinnell,REP,80511,15,11,406,432,
Caddo,Lieutenant Governor,Anastasia Pittman,DEM,80511,6,10,234,250,
Caddo,Lieutenant Governor,Ivan Holmes,IND,80511,0,0,16,16,
Caddo,State Auditor,John Yeutter,LIB,80511,6,5,145,156,
Caddo,State Auditor,Cindy Byrd,REP,80511,15,12,470,497,
Caddo,Attorney General,Mike Hunter,REP,80511,16,8,426,450,
Caddo,Attorney General,Mark Myles,DEM,80511,5,13,228,246,
Caddo,State Treasurer,Randy Mcdaniel,REP,80511,16,12,452,480,
Caddo,State Treasurer,Charles De Coune,IND,80511,5,5,163,173,
Caddo,Superintendent of Public Instruction,Joy Hofmeister,REP,80511,14,12,386,412,
Caddo,Superintendent of Public Instruction,John Cox,DEM,80511,6,8,221,235,
Caddo,Superintendent of Public Instruction,Larry Huff,IND,80511,1,1,46,48,
Caddo,Commissioner of Labor,Leslie Osborn,REP,80511,15,7,402,424,
Caddo,Commissioner of Labor,Fred Dorrell,DEM,80511,5,12,225,242,
Caddo,Commissioner of Labor,Brandt Dismukes,IND,80511,1,2,22,25,
Caddo,Insurance Commissioner,Glen Mulready,REP,80511,13,6,386,405,
Caddo,Insurance Commissioner,Kimberly Fobbs,DEM,80511,8,15,263,286,
Caddo,Corporation Commissioner,Bob Anthony,REP,80511,12,6,372,390,
Caddo,Corporation Commissioner,Ashley Nicole Mccray,DEM,80511,6,13,250,269,
Caddo,Corporation Commissioner,Jackie Short,IND,80511,3,2,31,36,
Caddo,U.S. House,Frank Lucas,REP,80511,17,11,441,469,3
Caddo,U.S. House,Frankie Robbins,DEM,80511,4,10,212,226,3
Caddo,State House,Toni Hasenbeck,REP,80511,13,7,358,378,65
Caddo,State House,Brandon Thompson,DEM,80511,7,14,298,319,65
Caddo,Governor,Chris Powell,LIB,80712,0,1,10,11,
Caddo,Governor,Kevin Stitt,REP,80712,0,5,180,185,
Caddo,Governor,Drew Edmondson,DEM,80712,6,7,196,209,
Caddo,Lieutenant Governor,Matt Pinnell,REP,80712,2,8,243,253,
Caddo,Lieutenant Governor,Anastasia Pittman,DEM,80712,5,3,133,141,
Caddo,Lieutenant Governor,Ivan Holmes,IND,80712,0,2,12,14,
Caddo,State Auditor,John Yeutter,LIB,80712,1,2,85,88,
Caddo,State Auditor,Cindy Byrd,REP,80712,4,11,279,294,
Caddo,Attorney General,Mike Hunter,REP,80712,3,7,249,259,
Caddo,Attorney General,Mark Myles,DEM,80712,4,6,138,148,
Caddo,State Treasurer,Randy Mcdaniel,REP,80712,2,12,280,294,
Caddo,State Treasurer,Charles De Coune,IND,80712,3,1,83,87,
Caddo,Superintendent of Public Instruction,Joy Hofmeister,REP,80712,2,7,225,234,
Caddo,Superintendent of Public Instruction,John Cox,DEM,80712,3,4,130,137,
Caddo,Superintendent of Public Instruction,Larry Huff,IND,80712,1,2,33,36,
Caddo,Commissioner of Labor,Leslie Osborn,REP,80712,2,8,222,232,
Caddo,Commissioner of Labor,Fred Dorrell,DEM,80712,4,4,147,155,
Caddo,Commissioner of Labor,Brandt Dismukes,IND,80712,0,1,12,13,
Caddo,Insurance Commissioner,Glen Mulready,REP,80712,2,8,225,235,
Caddo,Insurance Commissioner,Kimberly Fobbs,DEM,80712,4,5,155,164,
Caddo,Corporation Commissioner,Bob Anthony,REP,80712,2,7,237,246,
Caddo,Corporation Commissioner,Ashley Nicole Mccray,DEM,80712,4,5,132,141,
Caddo,Corporation Commissioner,Jackie Short,IND,80712,0,1,17,18,
Caddo,U.S. House,Frank Lucas,REP,80712,3,9,282,294,3
Caddo,U.S. House,Frankie Robbins,DEM,80712,4,4,106,114,3
Caddo,State House,Charles Wells,REP,80712,1,1,106,108,56
Caddo,State House,David Perryman,DEM,80712,6,12,284,302,56
Caddo,Governor,Chris Powell,LIB,80715,0,2,0,2,
Caddo,Governor,Kevin Stitt,REP,80715,1,4,51,56,
Caddo,Governor,Drew Edmondson,DEM,80715,1,0,32,33,
Caddo,Lieutenant Governor,Matt Pinnell,REP,80715,1,5,54,60,
Caddo,Lieutenant Governor,Anastasia Pittman,DEM,80715,1,1,25,27,
Caddo,Lieutenant Governor,Ivan Holmes,IND,80715,0,0,5,5,
Caddo,State Auditor,John Yeutter,LIB,80715,0,2,22,24,
Caddo,State Auditor,Cindy Byrd,REP,80715,2,4,56,62,
Caddo,Attorney General,Mike Hunter,REP,80715,1,5,58,64,
Caddo,Attorney General,Mark Myles,DEM,80715,1,1,25,27,
Caddo,State Treasurer,Randy Mcdaniel,REP,80715,1,4,62,67,
Caddo,State Treasurer,Charles De Coune,IND,80715,1,2,17,20,
Caddo,Superintendent of Public Instruction,Joy Hofmeister,REP,80715,1,4,57,62,
Caddo,Superintendent of Public Instruction,John Cox,DEM,80715,1,1,21,23,
Caddo,Superintendent of Public Instruction,Larry Huff,IND,80715,0,1,6,7,
Caddo,Commissioner of Labor,Leslie Osborn,REP,80715,1,4,54,59,
Caddo,Commissioner of Labor,Fred Dorrell,DEM,80715,1,1,27,29,
Caddo,Commissioner of Labor,Brandt Dismukes,IND,80715,0,1,3,4,
Caddo,Insurance Commissioner,Glen Mulready,REP,80715,1,4,56,61,
Caddo,Insurance Commissioner,Kimberly Fobbs,DEM,80715,1,2,28,31,
Caddo,Corporation Commissioner,Bob Anthony,REP,80715,1,4,52,57,
Caddo,Corporation Commissioner,Ashley Nicole Mccray,DEM,80715,1,2,29,32,
Caddo,Corporation Commissioner,Jackie Short,IND,80715,0,0,3,3,
Caddo,U.S. House,Frank Lucas,REP,80715,2,6,60,68,3
Caddo,U.S. House,Frankie Robbins,DEM,80715,0,0,24,24,3
Caddo,State House,Charles Wells,REP,80715,0,2,25,27,56
Caddo,State House,David Perryman,DEM,80715,2,4,59,65,56
Caddo,Governor,Chris Powell,LIB,80810,0,1,5,6,
Caddo,Governor,Kevin Stitt,REP,80810,5,9,100,114,
Caddo,Governor,Drew Edmondson,DEM,80810,0,2,45,47,
Caddo,Lieutenant Governor,Matt Pinnell,REP,80810,5,10,116,131,
Caddo,Lieutenant Governor,Anastasia Pittman,DEM,80810,2,2,31,35,
Caddo,Lieutenant Governor,Ivan Holmes,IND,80810,0,0,1,1,
Caddo,State Auditor,John Yeutter,LIB,80810,0,1,26,27,
Caddo,State Auditor,Cindy Byrd,REP,80810,6,10,117,133,
Caddo,Attorney General,Mike Hunter,REP,80810,4,10,109,123,
Caddo,Attorney General,Mark Myles,DEM,80810,3,2,38,43,
Caddo,State Treasurer,Randy Mcdaniel,REP,80810,5,10,118,133,
Caddo,State Treasurer,Charles De Coune,IND,80810,2,1,25,28,
Caddo,Superintendent of Public Instruction,Joy Hofmeister,REP,80810,7,10,86,103,
Caddo,Superintendent of Public Instruction,John Cox,DEM,80810,0,2,53,55,
Caddo,Superintendent of Public Instruction,Larry Huff,IND,80810,0,0,9,9,
Caddo,Commissioner of Labor,Leslie Osborn,REP,80810,5,10,107,122,
Caddo,Commissioner of Labor,Fred Dorrell,DEM,80810,1,1,37,39,
Caddo,Commissioner of Labor,Brandt Dismukes,IND,80810,1,1,4,6,
Caddo,Insurance Commissioner,Glen Mulready,REP,80810,6,10,102,118,
Caddo,Insurance Commissioner,Kimberly Fobbs,DEM,80810,1,2,41,44,
Caddo,Corporation Commissioner,Bob Anthony,REP,80810,4,10,106,120,
Caddo,Corporation Commissioner,Ashley Nicole Mccray,DEM,80810,1,2,37,40,
Caddo,Corporation Commissioner,Jackie Short,IND,80810,2,0,4,6,
Caddo,U.S. House,Frank Lucas,REP,80810,7,10,117,134,3
Caddo,U.S. House,Frankie Robbins,DEM,80810,0,2,31,33,3
Caddo,State House,Charles Wells,REP,80810,2,8,47,57,56
Caddo,State House,David Perryman,DEM,80810,5,4,101,110,56
Caddo,Governor,Chris Powell,LIB,80811,0,0,10,10,
Caddo,Governor,Kevin Stitt,REP,80811,4,10,144,158,
Caddo,Governor,Drew Edmondson,DEM,80811,6,21,68,95,
Caddo,Lieutenant Governor,Matt Pinnell,REP,80811,7,17,154,178,
Caddo,Lieutenant Governor,Anastasia Pittman,DEM,80811,3,14,61,78,
Caddo,Lieutenant Governor,Ivan Holmes,IND,80811,0,0,7,7,
Caddo,State Auditor,John Yeutter,LIB,80811,3,4,32,39,
Caddo,State Auditor,Cindy Byrd,REP,80811,7,21,178,206,
Caddo,Attorney General,Mike Hunter,REP,80811,8,12,154,174,
Caddo,Attorney General,Mark Myles,DEM,80811,2,19,68,89,
Caddo,State Treasurer,Randy Mcdaniel,REP,80811,9,22,173,204,
Caddo,State Treasurer,Charles De Coune,IND,80811,1,3,36,40,
Caddo,Superintendent of Public Instruction,Joy Hofmeister,REP,80811,7,17,139,163,
Caddo,Superintendent of Public Instruction,John Cox,DEM,80811,3,14,67,84,
Caddo,Superintendent of Public Instruction,Larry Huff,IND,80811,0,0,15,15,
Caddo,Commissioner of Labor,Leslie Osborn,REP,80811,9,18,150,177,
Caddo,Commissioner of Labor,Fred Dorrell,DEM,80811,1,13,65,79,
Caddo,Commissioner of Labor,Brandt Dismukes,IND,80811,0,0,7,7,
Caddo,Insurance Commissioner,Glen Mulready,REP,80811,7,13,149,169,
Caddo,Insurance Commissioner,Kimberly Fobbs,DEM,80811,3,18,71,92,
Caddo,Corporation Commissioner,Bob Anthony,REP,80811,6,13,141,160,
Caddo,Corporation Commissioner,Ashley Nicole Mccray,DEM,80811,4,18,72,94,
Caddo,Corporation Commissioner,Jackie Short,IND,80811,0,0,9,9,
Caddo,U.S. House,Frank Lucas,REP,80811,9,20,167,196,3
Caddo,U.S. House,Frankie Robbins,DEM,80811,1,11,56,68,3
Caddo,State House,Charles Wells,REP,80811,4,4,89,97,56
Caddo,State House,David Perryman,DEM,80811,6,27,133,166,56
Caddo,Governor,Chris Powell,LIB,80812,0,1,13,14,
Caddo,Governor,Kevin Stitt,REP,80812,4,5,92,101,
Caddo,Governor,Drew Edmondson,DEM,80812,6,3,58,67,
Caddo,Lieutenant Governor,Matt Pinnell,REP,80812,4,7,107,118,
Caddo,Lieutenant Governor,Anastasia Pittman,DEM,80812,6,2,44,52,
Caddo,Lieutenant Governor,Ivan Holmes,IND,80812,0,0,10,10,
Caddo,State Auditor,John Yeutter,LIB,80812,1,3,33,37,
Caddo,State Auditor,Cindy Byrd,REP,80812,7,6,108,121,
Caddo,Attorney General,Mike Hunter,REP,80812,4,7,104,115,
Caddo,Attorney General,Mark Myles,DEM,80812,6,2,57,65,
Caddo,State Treasurer,Randy Mcdaniel,REP,80812,6,7,118,131,
Caddo,State Treasurer,Charles De Coune,IND,80812,2,2,22,26,
Caddo,Superintendent of Public Instruction,Joy Hofmeister,REP,80812,7,7,99,113,
Caddo,Superintendent of Public Instruction,John Cox,DEM,80812,2,2,44,48,
Caddo,Superintendent of Public Instruction,Larry Huff,IND,80812,1,0,18,19,
Caddo,Commissioner of Labor,Leslie Osborn,REP,80812,5,7,98,110,
Caddo,Commissioner of Labor,Fred Dorrell,DEM,80812,5,2,50,57,
Caddo,Commissioner of Labor,Brandt Dismukes,IND,80812,0,0,12,12,
Caddo,Insurance Commissioner,Glen Mulready,REP,80812,7,7,103,117,
Caddo,Insurance Commissioner,Kimberly Fobbs,DEM,80812,3,2,56,61,
Caddo,Corporation Commissioner,Bob Anthony,REP,80812,3,7,93,103,
Caddo,Corporation Commissioner,Ashley Nicole Mccray,DEM,80812,7,2,53,62,
Caddo,Corporation Commissioner,Jackie Short,IND,80812,0,0,14,14,
Caddo,U.S. House,Frank Lucas,REP,80812,7,6,118,131,3
Caddo,U.S. House,Frankie Robbins,DEM,80812,3,3,43,49,3
Caddo,State House,Charles Wells,REP,80812,4,4,68,76,56
Caddo,State House,David Perryman,DEM,80812,6,5,93,104,56
Caddo,Governor,Chris Powell,LIB,81009,1,1,6,8,
Caddo,Governor,Kevin Stitt,REP,81009,5,6,145,156,
Caddo,Governor,Drew Edmondson,DEM,81009,0,5,46,51,
Caddo,Lieutenant Governor,Matt Pinnell,REP,81009,6,8,146,160,
Caddo,Lieutenant Governor,Anastasia Pittman,DEM,81009,0,4,42,46,
Caddo,Lieutenant Governor,Ivan Holmes,IND,81009,0,0,6,6,
Caddo,State Auditor,John Yeutter,LIB,81009,1,1,34,36,
Caddo,State Auditor,Cindy Byrd,REP,81009,5,9,153,167,
Caddo,Attorney General,Mike Hunter,REP,81009,5,8,146,159,
Caddo,Attorney General,Mark Myles,DEM,81009,1,4,47,52,
Caddo,State Treasurer,Randy Mcdaniel,REP,81009,5,8,149,162,
Caddo,State Treasurer,Charles De Coune,IND,81009,0,2,37,39,
Caddo,Superintendent of Public Instruction,Joy Hofmeister,REP,81009,4,7,133,144,
Caddo,Superintendent of Public Instruction,John Cox,DEM,81009,2,5,42,49,
Caddo,Superintendent of Public Instruction,Larry Huff,IND,81009,0,0,19,19,
Caddo,Commissioner of Labor,Leslie Osborn,REP,81009,5,9,144,158,
Caddo,Commissioner of Labor,Fred Dorrell,DEM,81009,1,3,35,39,
Caddo,Commissioner of Labor,Brandt Dismukes,IND,81009,0,0,14,14,
Caddo,Insurance Commissioner,Glen Mulready,REP,81009,5,8,142,155,
Caddo,Insurance Commissioner,Kimberly Fobbs,DEM,81009,1,4,51,56,
Caddo,Corporation Commissioner,Bob Anthony,REP,81009,4,8,131,143,
Caddo,Corporation Commissioner,Ashley Nicole Mccray,DEM,81009,0,4,49,53,
Caddo,Corporation Commissioner,Jackie Short,IND,81009,2,0,12,14,
Caddo,U.S. House,Frank Lucas,REP,81009,5,8,151,164,3
Caddo,U.S. House,Frankie Robbins,DEM,81009,1,3,44,48,3
Caddo,State House,Charles Wells,REP,81009,4,7,121,132,56
Caddo,State House,David Perryman,DEM,81009,2,5,74,81,56
Caddo,Governor,Chris Powell,LIB,81010,0,0,12,12,
Caddo,Governor,Kevin Stitt,REP,81010,4,9,207,220,
Caddo,Governor,Drew Edmondson,DEM,81010,6,7,101,114,
Caddo,Lieutenant Governor,Matt Pinnell,REP,81010,5,12,236,253,
Caddo,Lieutenant Governor,Anastasia Pittman,DEM,81010,4,5,71,80,
Caddo,Lieutenant Governor,Ivan Holmes,IND,81010,1,0,12,13,
Caddo,State Auditor,John Yeutter,LIB,81010,1,2,46,49,
Caddo,State Auditor,Cindy Byrd,REP,81010,8,14,248,270,
Caddo,Attorney General,Mike Hunter,REP,81010,8,11,236,255,
Caddo,Attorney General,Mark Myles,DEM,81010,2,6,82,90,
Caddo,State Treasurer,Randy Mcdaniel,REP,81010,7,11,255,273,
Caddo,State Treasurer,Charles De Coune,IND,81010,2,5,35,42,
Caddo,Superintendent of Public Instruction,Joy Hofmeister,REP,81010,6,11,210,227,
Caddo,Superintendent of Public Instruction,John Cox,DEM,81010,2,5,87,94,
Caddo,Superintendent of Public Instruction,Larry Huff,IND,81010,2,1,20,23,
Caddo,Commissioner of Labor,Leslie Osborn,REP,81010,7,13,217,237,
Caddo,Commissioner of Labor,Fred Dorrell,DEM,81010,2,4,88,94,
Caddo,Commissioner of Labor,Brandt Dismukes,IND,81010,1,0,9,10,
Caddo,Insurance Commissioner,Glen Mulready,REP,81010,7,11,216,234,
Caddo,Insurance Commissioner,Kimberly Fobbs,DEM,81010,3,6,96,105,
Caddo,Corporation Commissioner,Bob Anthony,REP,81010,7,11,219,237,
Caddo,Corporation Commissioner,Ashley Nicole Mccray,DEM,81010,3,4,84,91,
Caddo,Corporation Commissioner,Jackie Short,IND,81010,0,2,15,17,
Caddo,U.S. House,Frank Lucas,REP,81010,7,15,250,272,3
Caddo,U.S. House,Frankie Robbins,DEM,81010,3,2,68,73,3
Caddo,State House,Charles Wells,REP,81010,5,7,124,136,56
Caddo,State House,David Perryman,DEM,81010,5,10,194,209,56
Caddo,Governor,Chris Powell,LIB,81011,1,0,9,10,
Caddo,Governor,Kevin Stitt,REP,81011,5,2,165,172,
Caddo,Governor,Drew Edmondson,DEM,81011,2,0,76,78,
Caddo,Lieutenant Governor,Matt Pinnell,REP,81011,4,2,180,186,
Caddo,Lieutenant Governor,Anastasia Pittman,DEM,81011,1,0,61,62,
Caddo,Lieutenant Governor,Ivan Holmes,IND,81011,3,0,9,12,
Caddo,State Auditor,John Yeutter,LIB,81011,1,0,37,38,
Caddo,State Auditor,Cindy Byrd,REP,81011,6,2,189,197,
Caddo,Attorney General,Mike Hunter,REP,81011,5,2,183,190,
Caddo,Attorney General,Mark Myles,DEM,81011,3,0,65,68,
Caddo,State Treasurer,Randy Mcdaniel,REP,81011,4,2,197,203,
Caddo,State Treasurer,Charles De Coune,IND,81011,2,0,29,31,
Caddo,Superintendent of Public Instruction,Joy Hofmeister,REP,81011,5,2,155,162,
Caddo,Superintendent of Public Instruction,John Cox,DEM,81011,2,0,68,70,
Caddo,Superintendent of Public Instruction,Larry Huff,IND,81011,1,0,25,26,
Caddo,Commissioner of Labor,Leslie Osborn,REP,81011,6,2,176,184,
Caddo,Commissioner of Labor,Fred Dorrell,DEM,81011,2,0,62,64,
Caddo,Commissioner of Labor,Brandt Dismukes,IND,81011,0,0,10,10,
Caddo,Insurance Commissioner,Glen Mulready,REP,81011,5,2,178,185,
Caddo,Insurance Commissioner,Kimberly Fobbs,DEM,81011,3,0,69,72,
Caddo,Corporation Commissioner,Bob Anthony,REP,81011,5,2,168,175,
Caddo,Corporation Commissioner,Ashley Nicole Mccray,DEM,81011,2,0,72,74,
Caddo,Corporation Commissioner,Jackie Short,IND,81011,1,0,8,9,
Caddo,U.S. House,Frank Lucas,REP,81011,6,2,200,208,3
Caddo,U.S. House,Frankie Robbins,DEM,81011,2,0,50,52,3
Caddo,Governor,Chris Powell,LIB,81013,0,0,12,12,
Caddo,Governor,Kevin Stitt,REP,81013,19,0,143,162,
Caddo,Governor,Drew Edmondson,DEM,81013,12,0,59,71,
Caddo,Lieutenant Governor,Matt Pinnell,REP,81013,22,0,157,179,
Caddo,Lieutenant Governor,Anastasia Pittman,DEM,81013,9,0,50,59,
Caddo,Lieutenant Governor,Ivan Holmes,IND,81013,0,0,7,7,
Caddo,State Auditor,John Yeutter,LIB,81013,3,0,27,30,
Caddo,State Auditor,Cindy Byrd,REP,81013,23,0,174,197,
Caddo,Attorney General,Mike Hunter,REP,81013,22,0,162,184,
Caddo,Attorney General,Mark Myles,DEM,81013,9,0,52,61,
Caddo,State Treasurer,Randy Mcdaniel,REP,81013,22,0,172,194,
Caddo,State Treasurer,Charles De Coune,IND,81013,4,0,29,33,
Caddo,Superintendent of Public Instruction,Joy Hofmeister,REP,81013,16,0,145,161,
Caddo,Superintendent of Public Instruction,John Cox,DEM,81013,13,0,51,64,
Caddo,Superintendent of Public Instruction,Larry Huff,IND,81013,2,0,18,20,
Caddo,Commissioner of Labor,Leslie Osborn,REP,81013,22,0,147,169,
Caddo,Commissioner of Labor,Fred Dorrell,DEM,81013,9,0,57,66,
Caddo,Commissioner of Labor,Brandt Dismukes,IND,81013,0,0,9,9,
Caddo,Insurance Commissioner,Glen Mulready,REP,81013,20,0,158,178,
Caddo,Insurance Commissioner,Kimberly Fobbs,DEM,81013,10,0,56,66,
Caddo,Corporation Commissioner,Bob Anthony,REP,81013,17,0,143,160,
Caddo,Corporation Commissioner,Ashley Nicole Mccray,DEM,81013,13,0,53,66,
Caddo,Corporation Commissioner,Jackie Short,IND,81013,1,0,18,19,
Caddo,U.S. House,Frank Lucas,REP,81013,21,0,168,189,3
Caddo,U.S. House,Frankie Robbins,DEM,81013,10,0,46,56,3
Caddo,Governor,Chris Powell,LIB,81111,2,0,29,31,
Caddo,Governor,Kevin Stitt,REP,81111,7,9,484,500,
Caddo,Governor,Drew Edmondson,DEM,81111,4,1,139,144,
Caddo,Lieutenant Governor,Matt Pinnell,REP,81111,8,8,524,540,
Caddo,Lieutenant Governor,Anastasia Pittman,DEM,81111,4,1,98,103,
Caddo,Lieutenant Governor,Ivan Holmes,IND,81111,1,1,26,28,
Caddo,State Auditor,John Yeutter,LIB,81111,1,1,75,77,
Caddo,State Auditor,Cindy Byrd,REP,81111,11,9,552,572,
Caddo,Attorney General,Mike Hunter,REP,81111,8,9,534,551,
Caddo,Attorney General,Mark Myles,DEM,81111,5,1,114,120,
Caddo,State Treasurer,Randy Mcdaniel,REP,81111,9,9,561,579,
Caddo,State Treasurer,Charles De Coune,IND,81111,3,1,68,72,
Caddo,Superintendent of Public Instruction,Joy Hofmeister,REP,81111,8,7,453,468,
Caddo,Superintendent of Public Instruction,John Cox,DEM,81111,5,3,146,154,
Caddo,Superintendent of Public Instruction,Larry Huff,IND,81111,0,0,48,48,
Caddo,Commissioner of Labor,Leslie Osborn,REP,81111,9,9,510,528,
Caddo,Commissioner of Labor,Fred Dorrell,DEM,81111,4,0,106,110,
Caddo,Commissioner of Labor,Brandt Dismukes,IND,81111,0,1,25,26,
Caddo,Insurance Commissioner,Glen Mulready,REP,81111,10,7,532,549,
Caddo,Insurance Commissioner,Kimberly Fobbs,DEM,81111,3,3,114,120,
Caddo,Corporation Commissioner,Bob Anthony,REP,81111,9,8,507,524,
Caddo,Corporation Commissioner,Ashley Nicole Mccray,DEM,81111,3,1,107,111,
Caddo,Corporation Commissioner,Jackie Short,IND,81111,1,1,35,37,
Caddo,U.S. House,Frank Lucas,REP,81111,9,9,559,577,3
Caddo,U.S. House,Frankie Robbins,DEM,81111,4,1,87,92,3
Caddo,Governor,Chris Powell,LIB,81213,0,0,5,5,
Caddo,Governor,Kevin Stitt,REP,81213,10,0,154,164,
Caddo,Governor,Drew Edmondson,DEM,81213,0,0,46,46,
Caddo,Lieutenant Governor,Matt Pinnell,REP,81213,10,0,163,173,
Caddo,Lieutenant Governor,Anastasia Pittman,DEM,81213,0,0,32,32,
Caddo,Lieutenant Governor,Ivan Holmes,IND,81213,0,0,8,8,
Caddo,State Auditor,John Yeutter,LIB,81213,0,0,24,24,
Caddo,State Auditor,Cindy Byrd,REP,81213,10,0,174,184,
Caddo,Attorney General,Mike Hunter,REP,81213,10,0,174,184,
Caddo,Attorney General,Mark Myles,DEM,81213,0,0,29,29,
Caddo,State Treasurer,Randy Mcdaniel,REP,81213,10,0,174,184,
Caddo,State Treasurer,Charles De Coune,IND,81213,0,0,21,21,
Caddo,Superintendent of Public Instruction,Joy Hofmeister,REP,81213,7,0,155,162,
Caddo,Superintendent of Public Instruction,John Cox,DEM,81213,2,0,30,32,
Caddo,Superintendent of Public Instruction,Larry Huff,IND,81213,1,0,16,17,
Caddo,Commissioner of Labor,Leslie Osborn,REP,81213,8,0,159,167,
Caddo,Commissioner of Labor,Fred Dorrell,DEM,81213,2,0,31,33,
Caddo,Commissioner of Labor,Brandt Dismukes,IND,81213,0,0,8,8,
Caddo,Insurance Commissioner,Glen Mulready,REP,81213,10,0,163,173,
Caddo,Insurance Commissioner,Kimberly Fobbs,DEM,81213,0,0,38,38,
Caddo,Corporation Commissioner,Bob Anthony,REP,81213,10,0,150,160,
Caddo,Corporation Commissioner,Ashley Nicole Mccray,DEM,81213,0,0,38,38,
Caddo,Corporation Commissioner,Jackie Short,IND,81213,0,0,14,14,
Caddo,U.S. House,Frank Lucas,REP,81213,10,0,171,181,3
Caddo,U.S. House,Frankie Robbins,DEM,81213,0,0,32,32,3
Canadian,Governor,Chris Powell,LIB,90100,0,0,29,29,
Canadian,Governor,Kevin Stitt,REP,90100,6,49,363,418,
Canadian,Governor,Drew Edmondson,DEM,90100,7,31,181,219,
Canadian,Lieutenant Governor,Matt Pinnell,REP,90100,6,57,392,455,
Canadian,Lieutenant Governor,Anastasia Pittman,DEM,90100,7,19,143,169,
Canadian,Lieutenant Governor,Ivan Holmes,IND,90100,0,2,33,35,
Canadian,State Auditor,John Yeutter,LIB,90100,2,13,112,127,
Canadian,State Auditor,Cindy Byrd,REP,90100,9,60,432,501,
Canadian,Attorney General,Mike Hunter,REP,90100,6,60,403,469,
Canadian,Attorney General,Mark Myles,DEM,90100,7,19,161,187,
Canadian,State Treasurer,Randy Mcdaniel,REP,90100,6,62,421,489,
Canadian,State Treasurer,Charles De Coune,IND,90100,5,11,120,136,
Canadian,Superintendent of Public Instruction,Joy Hofmeister,REP,90100,3,51,358,412,
Canadian,Superintendent of Public Instruction,John Cox,DEM,90100,9,23,142,174,
Canadian,Superintendent of Public Instruction,Larry Huff,IND,90100,1,6,69,76,
Canadian,Commissioner of Labor,Leslie Osborn,REP,90100,6,57,392,455,
Canadian,Commissioner of Labor,Fred Dorrell,DEM,90100,7,21,132,160,
Canadian,Commissioner of Labor,Brandt Dismukes,IND,90100,0,1,38,39,
Canadian,Insurance Commissioner,Glen Mulready,REP,90100,7,58,396,461,
Canadian,Insurance Commissioner,Kimberly Fobbs,DEM,90100,6,21,164,191,
Canadian,Corporation Commissioner,Bob Anthony,REP,90100,4,56,370,430,
Canadian,Corporation Commissioner,Ashley Nicole Mccray,DEM,90100,8,20,149,177,
Canadian,Corporation Commissioner,Jackie Short,IND,90100,1,3,45,49,
Canadian,U.S. House,Frank Lucas,REP,90100,5,58,424,487,3
Canadian,U.S. House,Frankie Robbins,DEM,90100,8,22,143,173,3
Canadian,Governor,Chris Powell,LIB,90102,0,0,7,7,
Canadian,Governor,Kevin Stitt,REP,90102,4,10,89,103,
Canadian,Governor,Drew Edmondson,DEM,90102,0,6,50,56,
Canadian,Lieutenant Governor,Matt Pinnell,REP,90102,4,11,111,126,
Canadian,Lieutenant Governor,Anastasia Pittman,DEM,90102,0,4,31,35,
Canadian,Lieutenant Governor,Ivan Holmes,IND,90102,0,1,3,4,
Canadian,State Auditor,John Yeutter,LIB,90102,1,2,27,30,
Canadian,State Auditor,Cindy Byrd,REP,90102,3,11,117,131,
Canadian,Attorney General,Mike Hunter,REP,90102,4,10,107,121,
Canadian,Attorney General,Mark Myles,DEM,90102,0,6,37,43,
Canadian,State Treasurer,Randy Mcdaniel,REP,90102,4,11,114,129,
Canadian,State Treasurer,Charles De Coune,IND,90102,0,3,28,31,
Canadian,Superintendent of Public Instruction,Joy Hofmeister,REP,90102,4,10,102,116,
Canadian,Superintendent of Public Instruction,John Cox,DEM,90102,0,4,31,35,
Canadian,Superintendent of Public Instruction,Larry Huff,IND,90102,0,2,13,15,
Canadian,Commissioner of Labor,Leslie Osborn,REP,90102,3,12,112,127,
Canadian,Commissioner of Labor,Fred Dorrell,DEM,90102,1,3,27,31,
Canadian,Commissioner of Labor,Brandt Dismukes,IND,90102,0,1,5,6,
Canadian,Insurance Commissioner,Glen Mulready,REP,90102,4,9,104,117,
Canadian,Insurance Commissioner,Kimberly Fobbs,DEM,90102,0,6,41,47,
Canadian,Corporation Commissioner,Bob Anthony,REP,90102,4,8,101,113,
Canadian,Corporation Commissioner,Ashley Nicole Mccray,DEM,90102,0,6,36,42,
Canadian,Corporation Commissioner,Jackie Short,IND,90102,0,1,8,9,
Canadian,U.S. House,Frank Lucas,REP,90102,4,10,112,126,3
Canadian,U.S. House,Frankie Robbins,DEM,90102,0,6,34,40,3
Canadian,Governor,Chris Powell,LIB,90106,1,5,32,38,
Canadian,Governor,Kevin Stitt,REP,90106,15,57,334,406,
Canadian,Governor,Drew Edmondson,DEM,90106,12,47,273,332,
Canadian,Lieutenant Governor,Matt Pinnell,REP,90106,16,65,390,471,
Canadian,Lieutenant Governor,Anastasia Pittman,DEM,90106,11,41,220,272,
Canadian,Lieutenant Governor,Ivan Holmes,IND,90106,2,3,27,32,
Canadian,State Auditor,John Yeutter,LIB,90106,6,23,149,178,
Canadian,State Auditor,Cindy Byrd,REP,90106,20,80,442,542,
Canadian,Attorney General,Mike Hunter,REP,90106,15,75,421,511,
Canadian,Attorney General,Mark Myles,DEM,90106,14,33,214,261,
Canadian,State Treasurer,Randy Mcdaniel,REP,90106,19,81,435,535,
Canadian,State Treasurer,Charles De Coune,IND,90106,8,23,158,189,
Canadian,Superintendent of Public Instruction,Joy Hofmeister,REP,90106,16,75,411,502,
Canadian,Superintendent of Public Instruction,John Cox,DEM,90106,11,25,177,213,
Canadian,Superintendent of Public Instruction,Larry Huff,IND,90106,2,8,44,54,
Canadian,Commissioner of Labor,Leslie Osborn,REP,90106,17,70,407,494,
Canadian,Commissioner of Labor,Fred Dorrell,DEM,90106,11,35,182,228,
Canadian,Commissioner of Labor,Brandt Dismukes,IND,90106,1,4,37,42,
Canadian,Insurance Commissioner,Glen Mulready,REP,90106,17,68,403,488,
Canadian,Insurance Commissioner,Kimberly Fobbs,DEM,90106,12,40,222,274,
Canadian,Corporation Commissioner,Bob Anthony,REP,90106,15,68,374,457,
Canadian,Corporation Commissioner,Ashley Nicole Mccray,DEM,90106,12,35,222,269,
Canadian,Corporation Commissioner,Jackie Short,IND,90106,2,5,31,38,
Canadian,U.S. House,Frank Lucas,REP,90106,18,71,425,514,3
Canadian,U.S. House,Frankie Robbins,DEM,90106,11,38,209,258,3
Canadian,Governor,Chris Powell,LIB,90107,0,1,8,9,
Canadian,Governor,Kevin Stitt,REP,90107,2,20,168,190,
Canadian,Governor,Drew Edmondson,DEM,90107,3,9,94,106,
Canadian,Lieutenant Governor,Matt Pinnell,REP,90107,2,22,191,215,
Canadian,Lieutenant Governor,Anastasia Pittman,DEM,90107,3,7,70,80,
Canadian,Lieutenant Governor,Ivan Holmes,IND,90107,0,0,9,9,
Canadian,State Auditor,John Yeutter,LIB,90107,0,5,56,61,
Canadian,State Auditor,Cindy Byrd,REP,90107,3,23,200,226,
Canadian,Attorney General,Mike Hunter,REP,90107,3,26,188,217,
Canadian,Attorney General,Mark Myles,DEM,90107,2,4,82,88,
Canadian,State Treasurer,Randy Mcdaniel,REP,90107,3,27,203,233,
Canadian,State Treasurer,Charles De Coune,IND,90107,0,1,54,55,
Canadian,Superintendent of Public Instruction,Joy Hofmeister,REP,90107,3,18,167,188,
Canadian,Superintendent of Public Instruction,John Cox,DEM,90107,2,8,71,81,
Canadian,Superintendent of Public Instruction,Larry Huff,IND,90107,0,4,29,33,
Canadian,Commissioner of Labor,Leslie Osborn,REP,90107,3,23,192,218,
Canadian,Commissioner of Labor,Fred Dorrell,DEM,90107,2,7,68,77,
Canadian,Commissioner of Labor,Brandt Dismukes,IND,90107,0,0,9,9,
Canadian,Insurance Commissioner,Glen Mulready,REP,90107,3,19,188,210,
Canadian,Insurance Commissioner,Kimberly Fobbs,DEM,90107,2,9,77,88,
Canadian,Corporation Commissioner,Bob Anthony,REP,90107,3,24,174,201,
Canadian,Corporation Commissioner,Ashley Nicole Mccray,DEM,90107,2,5,73,80,
Canadian,Corporation Commissioner,Jackie Short,IND,90107,0,1,21,22,
Canadian,U.S. House,Frank Lucas,REP,90107,3,24,191,218,3
Canadian,U.S. House,Frankie Robbins,DEM,90107,2,6,76,84,3
Canadian,Governor,Chris Powell,LIB,90109,0,0,4,4,
Canadian,Governor,Kevin Stitt,REP,90109,4,15,56,75,
Canadian,Governor,Drew Edmondson,DEM,90109,2,4,44,50,
Canadian,Lieutenant Governor,Matt Pinnell,REP,90109,4,16,65,85,
Canadian,Lieutenant Governor,Anastasia Pittman,DEM,90109,2,3,28,33,
Canadian,Lieutenant Governor,Ivan Holmes,IND,90109,0,0,8,8,
Canadian,State Auditor,John Yeutter,LIB,90109,1,1,24,26,
Canadian,State Auditor,Cindy Byrd,REP,90109,5,18,75,98,
Canadian,Attorney General,Mike Hunter,REP,90109,4,16,74,94,
Canadian,Attorney General,Mark Myles,DEM,90109,2,3,27,32,
Canadian,State Treasurer,Randy Mcdaniel,REP,90109,4,18,72,94,
Canadian,State Treasurer,Charles De Coune,IND,90109,2,1,25,28,
Canadian,Superintendent of Public Instruction,Joy Hofmeister,REP,90109,5,14,66,85,
Canadian,Superintendent of Public Instruction,John Cox,DEM,90109,1,3,25,29,
Canadian,Superintendent of Public Instruction,Larry Huff,IND,90109,0,2,11,13,
Canadian,Commissioner of Labor,Leslie Osborn,REP,90109,4,16,64,84,
Canadian,Commissioner of Labor,Fred Dorrell,DEM,90109,1,2,26,29,
Canadian,Commissioner of Labor,Brandt Dismukes,IND,90109,1,1,10,12,
Canadian,Insurance Commissioner,Glen Mulready,REP,90109,5,16,65,86,
Canadian,Insurance Commissioner,Kimberly Fobbs,DEM,90109,1,3,34,38,
Canadian,Corporation Commissioner,Bob Anthony,REP,90109,4,17,65,86,
Canadian,Corporation Commissioner,Ashley Nicole Mccray,DEM,90109,1,2,31,34,
Canadian,Corporation Commissioner,Jackie Short,IND,90109,1,0,7,8,
Canadian,U.S. House,Frank Lucas,REP,90109,5,16,71,92,3
Canadian,U.S. House,Frankie Robbins,DEM,90109,1,2,29,32,3
Canadian,Governor,Chris Powell,LIB,90114,0,2,27,29,
Canadian,Governor,Kevin Stitt,REP,90114,27,38,279,344,
Canadian,Governor,Drew Edmondson,DEM,90114,13,20,178,211,
Canadian,Lieutenant Governor,Matt Pinnell,REP,90114,28,47,319,394,
Canadian,Lieutenant Governor,Anastasia Pittman,DEM,90114,12,12,145,169,
Canadian,Lieutenant Governor,Ivan Holmes,IND,90114,0,1,18,19,
Canadian,State Auditor,John Yeutter,LIB,90114,6,13,104,123,
Canadian,State Auditor,Cindy Byrd,REP,90114,31,43,361,435,
Canadian,Attorney General,Mike Hunter,REP,90114,28,44,330,402,
Canadian,Attorney General,Mark Myles,DEM,90114,12,15,150,177,
Canadian,State Treasurer,Randy Mcdaniel,REP,90114,32,45,356,433,
Canadian,State Treasurer,Charles De Coune,IND,90114,5,11,110,126,
Canadian,Superintendent of Public Instruction,Joy Hofmeister,REP,90114,27,41,316,384,
Canadian,Superintendent of Public Instruction,John Cox,DEM,90114,13,13,119,145,
Canadian,Superintendent of Public Instruction,Larry Huff,IND,90114,0,5,45,50,
Canadian,Commissioner of Labor,Leslie Osborn,REP,90114,33,45,325,403,
Canadian,Commissioner of Labor,Fred Dorrell,DEM,90114,7,13,127,147,
Canadian,Commissioner of Labor,Brandt Dismukes,IND,90114,0,1,26,27,
Canadian,Insurance Commissioner,Glen Mulready,REP,90114,32,44,325,401,
Canadian,Insurance Commissioner,Kimberly Fobbs,DEM,90114,8,14,155,177,
Canadian,Corporation Commissioner,Bob Anthony,REP,90114,29,46,322,397,
Canadian,Corporation Commissioner,Ashley Nicole Mccray,DEM,90114,11,13,129,153,
Canadian,Corporation Commissioner,Jackie Short,IND,90114,0,0,30,30,
Canadian,U.S. House,Frank Lucas,REP,90114,29,48,340,417,3
Canadian,U.S. House,Frankie Robbins,DEM,90114,11,12,140,163,3
Canadian,Governor,Chris Powell,LIB,90116,0,4,46,50,
Canadian,Governor,Kevin Stitt,REP,90116,17,47,291,355,
Canadian,Governor,Drew Edmondson,DEM,90116,9,66,318,393,
Canadian,Lieutenant Governor,Matt Pinnell,REP,90116,16,53,345,414,
Canadian,Lieutenant Governor,Anastasia Pittman,DEM,90116,9,58,278,345,
Canadian,Lieutenant Governor,Ivan Holmes,IND,90116,1,4,27,32,
Canadian,State Auditor,John Yeutter,LIB,90116,5,35,202,242,
Canadian,State Auditor,Cindy Byrd,REP,90116,17,63,400,480,
Canadian,Attorney General,Mike Hunter,REP,90116,17,62,362,441,
Canadian,Attorney General,Mark Myles,DEM,90116,9,53,285,347,
Canadian,State Treasurer,Randy Mcdaniel,REP,90116,17,61,384,462,
Canadian,State Treasurer,Charles De Coune,IND,90116,5,37,216,258,
Canadian,Superintendent of Public Instruction,Joy Hofmeister,REP,90116,17,51,338,406,
Canadian,Superintendent of Public Instruction,John Cox,DEM,90116,8,53,245,306,
Canadian,Superintendent of Public Instruction,Larry Huff,IND,90116,1,12,67,80,
Canadian,Commissioner of Labor,Leslie Osborn,REP,90116,18,57,352,427,
Canadian,Commissioner of Labor,Fred Dorrell,DEM,90116,8,52,253,313,
Canadian,Commissioner of Labor,Brandt Dismukes,IND,90116,0,6,36,42,
Canadian,Insurance Commissioner,Glen Mulready,REP,90116,18,54,339,411,
Canadian,Insurance Commissioner,Kimberly Fobbs,DEM,90116,8,60,302,370,
Canadian,Corporation Commissioner,Bob Anthony,REP,90116,15,50,326,391,
Canadian,Corporation Commissioner,Ashley Nicole Mccray,DEM,90116,10,54,268,332,
Canadian,Corporation Commissioner,Jackie Short,IND,90116,0,11,51,62,
Canadian,U.S. House,Frank Lucas,REP,90116,18,56,376,450,3
Canadian,U.S. House,Frankie Robbins,DEM,90116,8,61,276,345,3
Canadian,Governor,Chris Powell,LIB,90124,2,4,41,47,
Canadian,Governor,Kevin Stitt,REP,90124,13,61,447,521,
Canadian,Governor,Drew Edmondson,DEM,90124,12,54,331,397,
Canadian,Lieutenant Governor,Matt Pinnell,REP,90124,14,68,509,591,
Canadian,Lieutenant Governor,Anastasia Pittman,DEM,90124,10,46,264,320,
Canadian,Lieutenant Governor,Ivan Holmes,IND,90124,3,7,39,49,
Canadian,State Auditor,John Yeutter,LIB,90124,6,28,200,234,
Canadian,State Auditor,Cindy Byrd,REP,90124,20,90,557,667,
Canadian,Attorney General,Mike Hunter,REP,90124,19,74,534,627,
Canadian,Attorney General,Mark Myles,DEM,90124,8,46,272,326,
Canadian,State Treasurer,Randy Mcdaniel,REP,90124,19,83,554,656,
Canadian,State Treasurer,Charles De Coune,IND,90124,6,33,205,244,
Canadian,Superintendent of Public Instruction,Joy Hofmeister,REP,90124,18,75,480,573,
Canadian,Superintendent of Public Instruction,John Cox,DEM,90124,8,38,239,285,
Canadian,Superintendent of Public Instruction,Larry Huff,IND,90124,1,7,87,95,
Canadian,Commissioner of Labor,Leslie Osborn,REP,90124,18,75,501,594,
Canadian,Commissioner of Labor,Fred Dorrell,DEM,90124,8,39,246,293,
Canadian,Commissioner of Labor,Brandt Dismukes,IND,90124,1,7,49,57,
Canadian,Insurance Commissioner,Glen Mulready,REP,90124,17,67,509,593,
Canadian,Insurance Commissioner,Kimberly Fobbs,DEM,90124,10,51,289,350,
Canadian,Corporation Commissioner,Bob Anthony,REP,90124,16,73,486,575,
Canadian,Corporation Commissioner,Ashley Nicole Mccray,DEM,90124,10,43,254,307,
Canadian,Corporation Commissioner,Jackie Short,IND,90124,1,4,63,68,
Canadian,U.S. House,Frank Lucas,REP,90124,19,81,556,656,3
Canadian,U.S. House,Frankie Robbins,DEM,90124,8,40,250,298,3
Canadian,Governor,Chris Powell,LIB,90200,9,2,94,105,
Canadian,Governor,Kevin Stitt,REP,90200,177,77,1598,1852,
Canadian,Governor,Drew Edmondson,DEM,90200,134,66,1189,1389,
Canadian,Lieutenant Governor,Matt Pinnell,REP,90200,203,87,1877,2167,
Canadian,Lieutenant Governor,Anastasia Pittman,DEM,90200,101,53,865,1019,
Canadian,Lieutenant Governor,Ivan Holmes,IND,90200,10,6,111,127,
Canadian,State Auditor,John Yeutter,LIB,90200,56,34,595,685,
Canadian,State Auditor,Cindy Byrd,REP,90200,242,99,2093,2434,
Canadian,Attorney General,Mike Hunter,REP,90200,207,90,1968,2265,
Canadian,Attorney General,Mark Myles,DEM,90200,108,55,875,1038,
Canadian,State Treasurer,Randy Mcdaniel,REP,90200,219,94,1977,2290,
Canadian,State Treasurer,Charles De Coune,IND,90200,83,40,723,846,
Canadian,Superintendent of Public Instruction,Joy Hofmeister,REP,90200,207,87,1861,2155,
Canadian,Superintendent of Public Instruction,John Cox,DEM,90200,86,47,757,890,
Canadian,Superintendent of Public Instruction,Larry Huff,IND,90200,21,9,227,257,
Canadian,Commissioner of Labor,Leslie Osborn,REP,90200,222,81,1926,2229,
Canadian,Commissioner of Labor,Fred Dorrell,DEM,90200,76,55,748,879,
Canadian,Commissioner of Labor,Brandt Dismukes,IND,90200,13,7,138,158,
Canadian,Insurance Commissioner,Glen Mulready,REP,90200,205,83,1862,2150,
Canadian,Insurance Commissioner,Kimberly Fobbs,DEM,90200,104,61,945,1110,
Canadian,Corporation Commissioner,Bob Anthony,REP,90200,192,86,1810,2088,
Canadian,Corporation Commissioner,Ashley Nicole Mccray,DEM,90200,98,51,845,994,
Canadian,Corporation Commissioner,Jackie Short,IND,90200,23,7,163,193,
Canadian,U.S. House,Frank Lucas,REP,90200,211,85,1953,2249,3
Canadian,U.S. House,Frankie Robbins,DEM,90200,104,60,882,1046,3
Canadian,State Senate,Stephanie Bice,REP,90200,223,91,1956,2270,22
Canadian,State Senate,William Andrews,DEM,90200,89,55,867,1011,22
Canadian,State House,Denise Crosswhite Hader,REP,90200,202,80,1816,2098,41
Canadian,State House,Jennie Scott,DEM,90200,114,64,1018,1196,41
Canadian,Governor,Chris Powell,LIB,90201,1,1,33,35,
Canadian,Governor,Kevin Stitt,REP,90201,44,33,588,665,
Canadian,Governor,Drew Edmondson,DEM,90201,27,8,241,276,
Canadian,Lieutenant Governor,Matt Pinnell,REP,90201,52,37,657,746,
Canadian,Lieutenant Governor,Anastasia Pittman,DEM,90201,18,5,161,184,
Canadian,Lieutenant Governor,Ivan Holmes,IND,90201,1,1,36,38,
Canadian,State Auditor,John Yeutter,LIB,90201,8,8,130,146,
Canadian,State Auditor,Cindy Byrd,REP,90201,56,33,679,768,
Canadian,Attorney General,Mike Hunter,REP,90201,43,36,666,745,
Canadian,Attorney General,Mark Myles,DEM,90201,27,7,182,216,
Canadian,State Treasurer,Randy Mcdaniel,REP,90201,51,38,658,747,
Canadian,State Treasurer,Charles De Coune,IND,90201,14,4,146,164,
Canadian,Superintendent of Public Instruction,Joy Hofmeister,REP,90201,39,32,605,676,
Canadian,Superintendent of Public Instruction,John Cox,DEM,90201,28,7,158,193,
Canadian,Superintendent of Public Instruction,Larry Huff,IND,90201,5,4,90,99,
Canadian,Commissioner of Labor,Leslie Osborn,REP,90201,50,36,635,721,
Canadian,Commissioner of Labor,Fred Dorrell,DEM,90201,21,4,158,183,
Canadian,Commissioner of Labor,Brandt Dismukes,IND,90201,0,3,46,49,
Canadian,Insurance Commissioner,Glen Mulready,REP,90201,48,38,656,742,
Canadian,Insurance Commissioner,Kimberly Fobbs,DEM,90201,23,5,185,213,
Canadian,Corporation Commissioner,Bob Anthony,REP,90201,45,37,602,684,
Canadian,Corporation Commissioner,Ashley Nicole Mccray,DEM,90201,21,5,172,198,
Canadian,Corporation Commissioner,Jackie Short,IND,90201,4,1,71,76,
Canadian,U.S. House,Frank Lucas,REP,90201,49,36,700,785,3
Canadian,U.S. House,Frankie Robbins,DEM,90201,21,6,155,182,3
Canadian,Governor,Chris Powell,LIB,90202,1,2,19,22,
Canadian,Governor,Kevin Stitt,REP,90202,17,22,262,301,
Canadian,Governor,Drew Edmondson,DEM,90202,7,2,73,82,
Canadian,Lieutenant Governor,Matt Pinnell,REP,90202,20,24,286,330,
Canadian,Lieutenant Governor,Anastasia Pittman,DEM,90202,4,2,55,61,
Canadian,Lieutenant Governor,Ivan Holmes,IND,90202,1,0,13,14,
Canadian,State Auditor,John Yeutter,LIB,90202,4,1,48,53,
Canadian,State Auditor,Cindy Byrd,REP,90202,21,24,298,343,
Canadian,Attorney General,Mike Hunter,REP,90202,20,24,296,340,
Canadian,Attorney General,Mark Myles,DEM,90202,5,2,57,64,
Canadian,State Treasurer,Randy Mcdaniel,REP,90202,19,23,291,333,
Canadian,State Treasurer,Charles De Coune,IND,90202,6,2,53,61,
Canadian,Superintendent of Public Instruction,Joy Hofmeister,REP,90202,19,22,258,299,
Canadian,Superintendent of Public Instruction,John Cox,DEM,90202,3,4,64,71,
Canadian,Superintendent of Public Instruction,Larry Huff,IND,90202,2,0,32,34,
Canadian,Commissioner of Labor,Leslie Osborn,REP,90202,19,23,284,326,
Canadian,Commissioner of Labor,Fred Dorrell,DEM,90202,4,2,50,56,
Canadian,Commissioner of Labor,Brandt Dismukes,IND,90202,2,0,19,21,
Canadian,Insurance Commissioner,Glen Mulready,REP,90202,20,25,293,338,
Canadian,Insurance Commissioner,Kimberly Fobbs,DEM,90202,5,1,59,65,
Canadian,Corporation Commissioner,Bob Anthony,REP,90202,16,23,280,319,
Canadian,Corporation Commissioner,Ashley Nicole Mccray,DEM,90202,5,2,52,59,
Canadian,Corporation Commissioner,Jackie Short,IND,90202,4,1,23,28,
Canadian,U.S. House,Frank Lucas,REP,90202,21,25,301,347,3
Canadian,U.S. House,Frankie Robbins,DEM,90202,4,1,53,58,3
Canadian,Governor,Chris Powell,LIB,90204,3,0,47,50,
Canadian,Governor,Kevin Stitt,REP,90204,46,29,514,589,
Canadian,Governor,Drew Edmondson,DEM,90204,25,29,366,420,
Canadian,Lieutenant Governor,Matt Pinnell,REP,90204,50,39,611,700,
Canadian,Lieutenant Governor,Anastasia Pittman,DEM,90204,21,18,267,306,
Canadian,Lieutenant Governor,Ivan Holmes,IND,90204,2,0,42,44,
Canadian,State Auditor,John Yeutter,LIB,90204,20,17,194,231,
Canadian,State Auditor,Cindy Byrd,REP,90204,53,39,673,765,
Canadian,Attorney General,Mike Hunter,REP,90204,53,35,636,724,
Canadian,Attorney General,Mark Myles,DEM,90204,19,23,280,322,
Canadian,State Treasurer,Randy Mcdaniel,REP,90204,52,34,653,739,
Canadian,State Treasurer,Charles De Coune,IND,90204,20,21,213,254,
Canadian,Superintendent of Public Instruction,Joy Hofmeister,REP,90204,54,37,594,685,
Canadian,Superintendent of Public Instruction,John Cox,DEM,90204,11,18,245,274,
Canadian,Superintendent of Public Instruction,Larry Huff,IND,90204,8,2,81,91,
Canadian,Commissioner of Labor,Leslie Osborn,REP,90204,55,37,630,722,
Canadian,Commissioner of Labor,Fred Dorrell,DEM,90204,16,19,231,266,
Canadian,Commissioner of Labor,Brandt Dismukes,IND,90204,1,2,47,50,
Canadian,Insurance Commissioner,Glen Mulready,REP,90204,52,37,623,712,
Canadian,Insurance Commissioner,Kimberly Fobbs,DEM,90204,21,21,283,325,
Canadian,Corporation Commissioner,Bob Anthony,REP,90204,49,32,581,662,
Canadian,Corporation Commissioner,Ashley Nicole Mccray,DEM,90204,18,23,262,303,
Canadian,Corporation Commissioner,Jackie Short,IND,90204,6,3,64,73,
Canadian,U.S. House,Frank Lucas,REP,90204,54,34,645,733,3
Canadian,U.S. House,Frankie Robbins,DEM,90204,21,24,271,316,3
Canadian,State Senate,Stephanie Bice,REP,90204,56,36,648,740,22
Canadian,State Senate,William Andrews,DEM,90204,18,22,263,303,22
Canadian,Governor,Chris Powell,LIB,90206,3,3,46,52,
Canadian,Governor,Kevin Stitt,REP,90206,29,24,702,755,
Canadian,Governor,Drew Edmondson,DEM,90206,42,24,465,531,
Canadian,Lieutenant Governor,Matt Pinnell,REP,90206,34,29,794,857,
Canadian,Lieutenant Governor,Anastasia Pittman,DEM,90206,35,21,342,398,
Canadian,Lieutenant Governor,Ivan Holmes,IND,90206,4,1,60,65,
Canadian,State Auditor,John Yeutter,LIB,90206,21,8,253,282,
Canadian,State Auditor,Cindy Byrd,REP,90206,48,36,872,956,
Canadian,Attorney General,Mike Hunter,REP,90206,43,34,836,913,
Canadian,Attorney General,Mark Myles,DEM,90206,30,16,362,408,
Canadian,State Treasurer,Randy Mcdaniel,REP,90206,47,32,824,903,
Canadian,State Treasurer,Charles De Coune,IND,90206,23,13,297,333,
Canadian,Superintendent of Public Instruction,Joy Hofmeister,REP,90206,43,30,794,867,
Canadian,Superintendent of Public Instruction,John Cox,DEM,90206,25,17,312,354,
Canadian,Superintendent of Public Instruction,Larry Huff,IND,90206,6,4,92,102,
Canadian,Commissioner of Labor,Leslie Osborn,REP,90206,44,30,809,883,
Canadian,Commissioner of Labor,Fred Dorrell,DEM,90206,25,18,309,352,
Canadian,Commissioner of Labor,Brandt Dismukes,IND,90206,4,3,63,70,
Canadian,Insurance Commissioner,Glen Mulready,REP,90206,42,32,803,877,
Canadian,Insurance Commissioner,Kimberly Fobbs,DEM,90206,31,19,387,437,
Canadian,Corporation Commissioner,Bob Anthony,REP,90206,39,28,764,831,
Canadian,Corporation Commissioner,Ashley Nicole Mccray,DEM,90206,26,19,344,389,
Canadian,Corporation Commissioner,Jackie Short,IND,90206,7,4,85,96,
Canadian,U.S. House,Frank Lucas,REP,90206,43,31,849,923,3
Canadian,U.S. House,Frankie Robbins,DEM,90206,30,19,345,394,3
Canadian,State Senate,Stephanie Bice,REP,90206,43,29,839,911,22
Canadian,State Senate,William Andrews,DEM,90206,30,21,352,403,22
Canadian,Governor,Chris Powell,LIB,90208,3,1,50,54,
Canadian,Governor,Kevin Stitt,REP,90208,39,10,523,572,
Canadian,Governor,Drew Edmondson,DEM,90208,35,22,383,440,
Canadian,Lieutenant Governor,Matt Pinnell,REP,90208,41,16,609,666,
Canadian,Lieutenant Governor,Anastasia Pittman,DEM,90208,29,16,299,344,
Canadian,Lieutenant Governor,Ivan Holmes,IND,90208,6,1,43,50,
Canadian,State Auditor,John Yeutter,LIB,90208,17,14,228,259,
Canadian,State Auditor,Cindy Byrd,REP,90208,51,18,669,738,
Canadian,Attorney General,Mike Hunter,REP,90208,42,15,631,688,
Canadian,Attorney General,Mark Myles,DEM,90208,33,18,315,366,
Canadian,State Treasurer,Randy Mcdaniel,REP,90208,42,16,637,695,
Canadian,State Treasurer,Charles De Coune,IND,90208,28,16,261,305,
Canadian,Superintendent of Public Instruction,Joy Hofmeister,REP,90208,34,13,588,635,
Canadian,Superintendent of Public Instruction,John Cox,DEM,90208,34,14,258,306,
Canadian,Superintendent of Public Instruction,Larry Huff,IND,90208,7,6,104,117,
Canadian,Commissioner of Labor,Leslie Osborn,REP,90208,40,14,614,668,
Canadian,Commissioner of Labor,Fred Dorrell,DEM,90208,31,17,262,310,
Canadian,Commissioner of Labor,Brandt Dismukes,IND,90208,3,2,66,71,
Canadian,Insurance Commissioner,Glen Mulready,REP,90208,40,16,621,677,
Canadian,Insurance Commissioner,Kimberly Fobbs,DEM,90208,34,17,316,367,
Canadian,Corporation Commissioner,Bob Anthony,REP,90208,43,15,584,642,
Canadian,Corporation Commissioner,Ashley Nicole Mccray,DEM,90208,30,15,290,335,
Canadian,Corporation Commissioner,Jackie Short,IND,90208,3,3,74,80,
Canadian,U.S. House,Frank Lucas,REP,90208,39,18,640,697,3
Canadian,U.S. House,Frankie Robbins,DEM,90208,37,15,311,363,3
Canadian,State Senate,Stephanie Bice,REP,90208,44,19,641,704,22
Canadian,State Senate,William Andrews,DEM,90208,29,14,304,347,22
Canadian,State House,Jay Steagall,REP,90208,42,14,628,684,43
Canadian,State House,Chantelle Cory,DEM,90208,32,19,319,370,43
Canadian,Governor,Chris Powell,LIB,90209,0,0,1,1,
Canadian,Governor,Kevin Stitt,REP,90209,0,1,18,19,
Canadian,Governor,Drew Edmondson,DEM,90209,3,0,20,23,
Canadian,Lieutenant Governor,Matt Pinnell,REP,90209,0,1,21,22,
Canadian,Lieutenant Governor,Anastasia Pittman,DEM,90209,3,0,15,18,
Canadian,Lieutenant Governor,Ivan Holmes,IND,90209,0,0,2,2,
Canadian,State Auditor,John Yeutter,LIB,90209,3,0,12,15,
Canadian,State Auditor,Cindy Byrd,REP,90209,0,1,25,26,
Canadian,Attorney General,Mike Hunter,REP,90209,0,1,22,23,
Canadian,Attorney General,Mark Myles,DEM,90209,3,0,16,19,
Canadian,State Treasurer,Randy Mcdaniel,REP,90209,0,1,23,24,
Canadian,State Treasurer,Charles De Coune,IND,90209,3,0,13,16,
Canadian,Superintendent of Public Instruction,Joy Hofmeister,REP,90209,0,1,17,18,
Canadian,Superintendent of Public Instruction,John Cox,DEM,90209,3,0,17,20,
Canadian,Superintendent of Public Instruction,Larry Huff,IND,90209,0,0,4,4,
Canadian,Commissioner of Labor,Leslie Osborn,REP,90209,0,1,17,18,
Canadian,Commissioner of Labor,Fred Dorrell,DEM,90209,3,0,20,23,
Canadian,Commissioner of Labor,Brandt Dismukes,IND,90209,0,0,1,1,
Canadian,Insurance Commissioner,Glen Mulready,REP,90209,0,1,19,20,
Canadian,Insurance Commissioner,Kimberly Fobbs,DEM,90209,3,0,19,22,
Canadian,Corporation Commissioner,Bob Anthony,REP,90209,0,1,18,19,
Canadian,Corporation Commissioner,Ashley Nicole Mccray,DEM,90209,3,0,16,19,
Canadian,Corporation Commissioner,Jackie Short,IND,90209,0,0,4,4,
Canadian,U.S. House,Frank Lucas,REP,90209,0,1,23,24,3
Canadian,U.S. House,Frankie Robbins,DEM,90209,3,0,15,18,3
Canadian,State Senate,Stephanie Bice,REP,90209,0,1,23,24,22
Canadian,State Senate,William Andrews,DEM,90209,3,0,15,18,22
Canadian,Governor,Chris Powell,LIB,90210,4,1,11,16,
Canadian,Governor,Kevin Stitt,REP,90210,17,31,318,366,
Canadian,Governor,Drew Edmondson,DEM,90210,18,13,168,199,
Canadian,Lieutenant Governor,Matt Pinnell,REP,90210,26,34,358,418,
Canadian,Lieutenant Governor,Anastasia Pittman,DEM,90210,13,11,113,137,
Canadian,Lieutenant Governor,Ivan Holmes,IND,90210,0,0,19,19,
Canadian,State Auditor,John Yeutter,LIB,90210,6,8,69,83,
Canadian,State Auditor,Cindy Byrd,REP,90210,26,36,393,455,
Canadian,Attorney General,Mike Hunter,REP,90210,23,38,371,432,
Canadian,Attorney General,Mark Myles,DEM,90210,16,7,119,142,
Canadian,State Treasurer,Randy Mcdaniel,REP,90210,26,36,388,450,
Canadian,State Treasurer,Charles De Coune,IND,90210,7,9,75,91,
Canadian,Superintendent of Public Instruction,Joy Hofmeister,REP,90210,20,37,334,391,
Canadian,Superintendent of Public Instruction,John Cox,DEM,90210,18,6,106,130,
Canadian,Superintendent of Public Instruction,Larry Huff,IND,90210,1,1,49,51,
Canadian,Commissioner of Labor,Leslie Osborn,REP,90210,24,36,368,428,
Canadian,Commissioner of Labor,Fred Dorrell,DEM,90210,14,9,96,119,
Canadian,Commissioner of Labor,Brandt Dismukes,IND,90210,0,0,21,21,
Canadian,Insurance Commissioner,Glen Mulready,REP,90210,24,33,368,425,
Canadian,Insurance Commissioner,Kimberly Fobbs,DEM,90210,14,12,116,142,
Canadian,Corporation Commissioner,Bob Anthony,REP,90210,27,33,350,410,
Canadian,Corporation Commissioner,Ashley Nicole Mccray,DEM,90210,11,11,109,131,
Canadian,Corporation Commissioner,Jackie Short,IND,90210,1,1,26,28,
Canadian,U.S. House,Frank Lucas,REP,90210,26,35,384,445,3
Canadian,U.S. House,Frankie Robbins,DEM,90210,13,10,104,127,3
Canadian,State House,Jay Steagall,REP,90210,26,35,371,432,43
Canadian,State House,Chantelle Cory,DEM,90210,14,10,115,139,43
Canadian,Governor,Chris Powell,LIB,90211,2,2,20,24,
Canadian,Governor,Kevin Stitt,REP,90211,35,19,440,494,
Canadian,Governor,Drew Edmondson,DEM,90211,30,12,234,276,
Canadian,Lieutenant Governor,Matt Pinnell,REP,90211,43,21,499,563,
Canadian,Lieutenant Governor,Anastasia Pittman,DEM,90211,23,12,161,196,
Canadian,Lieutenant Governor,Ivan Holmes,IND,90211,0,0,27,27,
Canadian,State Auditor,John Yeutter,LIB,90211,11,7,127,145,
Canadian,State Auditor,Cindy Byrd,REP,90211,49,26,532,607,
Canadian,Attorney General,Mike Hunter,REP,90211,40,23,510,573,
Canadian,Attorney General,Mark Myles,DEM,90211,25,10,177,212,
Canadian,State Treasurer,Randy Mcdaniel,REP,90211,43,20,512,575,
Canadian,State Treasurer,Charles De Coune,IND,90211,18,13,145,176,
Canadian,Superintendent of Public Instruction,Joy Hofmeister,REP,90211,42,20,479,541,
Canadian,Superintendent of Public Instruction,John Cox,DEM,90211,16,9,143,168,
Canadian,Superintendent of Public Instruction,Larry Huff,IND,90211,8,4,60,72,
Canadian,Commissioner of Labor,Leslie Osborn,REP,90211,47,22,508,577,
Canadian,Commissioner of Labor,Fred Dorrell,DEM,90211,18,10,140,168,
Canadian,Commissioner of Labor,Brandt Dismukes,IND,90211,2,1,35,38,
Canadian,Insurance Commissioner,Glen Mulready,REP,90211,44,20,489,553,
Canadian,Insurance Commissioner,Kimberly Fobbs,DEM,90211,21,13,187,221,
Canadian,Corporation Commissioner,Bob Anthony,REP,90211,38,19,462,519,
Canadian,Corporation Commissioner,Ashley Nicole Mccray,DEM,90211,24,10,158,192,
Canadian,Corporation Commissioner,Jackie Short,IND,90211,5,3,58,66,
Canadian,U.S. House,Frank Lucas,REP,90211,42,21,508,571,3
Canadian,U.S. House,Frankie Robbins,DEM,90211,24,12,176,212,3
Canadian,Governor,Chris Powell,LIB,90214,1,2,34,37,
Canadian,Governor,Kevin Stitt,REP,90214,32,22,528,582,
Canadian,Governor,Drew Edmondson,DEM,90214,27,26,359,412,
Canadian,Lieutenant Governor,Matt Pinnell,REP,90214,39,33,617,689,
Canadian,Lieutenant Governor,Anastasia Pittman,DEM,90214,19,17,267,303,
Canadian,Lieutenant Governor,Ivan Holmes,IND,90214,2,0,32,34,
Canadian,State Auditor,John Yeutter,LIB,90214,11,12,213,236,
Canadian,State Auditor,Cindy Byrd,REP,90214,48,34,665,747,
Canadian,Attorney General,Mike Hunter,REP,90214,43,30,629,702,
Canadian,Attorney General,Mark Myles,DEM,90214,16,20,281,317,
Canadian,State Treasurer,Randy Mcdaniel,REP,90214,43,32,646,721,
Canadian,State Treasurer,Charles De Coune,IND,90214,16,13,233,262,
Canadian,Superintendent of Public Instruction,Joy Hofmeister,REP,90214,43,27,584,654,
Canadian,Superintendent of Public Instruction,John Cox,DEM,90214,14,18,228,260,
Canadian,Superintendent of Public Instruction,Larry Huff,IND,90214,1,4,100,105,
Canadian,Commissioner of Labor,Leslie Osborn,REP,90214,41,31,606,678,
Canadian,Commissioner of Labor,Fred Dorrell,DEM,90214,15,17,244,276,
Canadian,Commissioner of Labor,Brandt Dismukes,IND,90214,2,1,52,55,
Canadian,Insurance Commissioner,Glen Mulready,REP,90214,37,28,601,666,
Canadian,Insurance Commissioner,Kimberly Fobbs,DEM,90214,21,21,305,347,
Canadian,Corporation Commissioner,Bob Anthony,REP,90214,42,32,576,650,
Canadian,Corporation Commissioner,Ashley Nicole Mccray,DEM,90214,16,15,259,290,
Canadian,Corporation Commissioner,Jackie Short,IND,90214,1,2,74,77,
Canadian,U.S. House,Frank Lucas,REP,90214,45,32,641,718,3
Canadian,U.S. House,Frankie Robbins,DEM,90214,15,18,271,304,3
Canadian,State Senate,Stephanie Bice,REP,90214,47,29,636,712,22
Canadian,State Senate,William Andrews,DEM,90214,13,21,269,303,22
Canadian,State House,Jay Steagall,REP,90214,42,29,626,697,43
Canadian,State House,Chantelle Cory,DEM,90214,18,20,282,320,43
Canadian,Governor,Chris Powell,LIB,90215,7,3,59,69,
Canadian,Governor,Kevin Stitt,REP,90215,70,60,740,870,
Canadian,Governor,Drew Edmondson,DEM,90215,57,19,471,547,
Canadian,Lieutenant Governor,Matt Pinnell,REP,90215,78,63,840,981,
Canadian,Lieutenant Governor,Anastasia Pittman,DEM,90215,55,17,368,440,
Canadian,Lieutenant Governor,Ivan Holmes,IND,90215,1,2,57,60,
Canadian,State Auditor,John Yeutter,LIB,90215,35,13,298,346,
Canadian,State Auditor,Cindy Byrd,REP,90215,90,68,900,1058,
Canadian,Attorney General,Mike Hunter,REP,90215,74,61,872,1007,
Canadian,Attorney General,Mark Myles,DEM,90215,59,21,387,467,
Canadian,State Treasurer,Randy Mcdaniel,REP,90215,86,64,872,1022,
Canadian,State Treasurer,Charles De Coune,IND,90215,40,17,329,386,
Canadian,Superintendent of Public Instruction,Joy Hofmeister,REP,90215,88,53,808,949,
Canadian,Superintendent of Public Instruction,John Cox,DEM,90215,37,21,328,386,
Canadian,Superintendent of Public Instruction,Larry Huff,IND,90215,9,6,127,142,
Canadian,Commissioner of Labor,Leslie Osborn,REP,90215,83,60,848,991,
Canadian,Commissioner of Labor,Fred Dorrell,DEM,90215,45,19,325,389,
Canadian,Commissioner of Labor,Brandt Dismukes,IND,90215,5,3,81,89,
Canadian,Insurance Commissioner,Glen Mulready,REP,90215,77,60,850,987,
Canadian,Insurance Commissioner,Kimberly Fobbs,DEM,90215,56,22,395,473,
Canadian,Corporation Commissioner,Bob Anthony,REP,90215,74,57,789,920,
Canadian,Corporation Commissioner,Ashley Nicole Mccray,DEM,90215,52,19,371,442,
Canadian,Corporation Commissioner,Jackie Short,IND,90215,5,6,88,99,
Canadian,U.S. House,Frank Lucas,REP,90215,79,62,876,1017,3
Canadian,U.S. House,Frankie Robbins,DEM,90215,55,20,378,453,3
Canadian,State House,Jay Steagall,REP,90215,78,61,874,1013,43
Canadian,State House,Chantelle Cory,DEM,90215,52,21,374,447,43
Canadian,Governor,Chris Powell,LIB,90216,6,3,48,57,
Canadian,Governor,Kevin Stitt,REP,90216,90,60,807,957,
Canadian,Governor,Drew Edmondson,DEM,90216,51,34,470,555,
Canadian,Lieutenant Governor,Matt Pinnell,REP,90216,104,69,953,1126,
Canadian,Lieutenant Governor,Anastasia Pittman,DEM,90216,39,24,327,390,
Canadian,Lieutenant Governor,Ivan Holmes,IND,90216,4,2,40,46,
Canadian,State Auditor,John Yeutter,LIB,90216,22,17,203,242,
Canadian,State Auditor,Cindy Byrd,REP,90216,112,71,1031,1214,
Canadian,Attorney General,Mike Hunter,REP,90216,109,69,964,1142,
Canadian,Attorney General,Mark Myles,DEM,90216,38,27,349,414,
Canadian,State Treasurer,Randy Mcdaniel,REP,90216,111,66,984,1161,
Canadian,State Treasurer,Charles De Coune,IND,90216,24,21,245,290,
Canadian,Superintendent of Public Instruction,Joy Hofmeister,REP,90216,106,69,920,1095,
Canadian,Superintendent of Public Instruction,John Cox,DEM,90216,32,24,286,342,
Canadian,Superintendent of Public Instruction,Larry Huff,IND,90216,9,3,108,120,
Canadian,Commissioner of Labor,Leslie Osborn,REP,90216,108,66,972,1146,
Canadian,Commissioner of Labor,Fred Dorrell,DEM,90216,33,24,276,333,
Canadian,Commissioner of Labor,Brandt Dismukes,IND,90216,5,4,52,61,
Canadian,Insurance Commissioner,Glen Mulready,REP,90216,110,65,948,1123,
Canadian,Insurance Commissioner,Kimberly Fobbs,DEM,90216,37,27,349,413,
Canadian,Corporation Commissioner,Bob Anthony,REP,90216,103,62,921,1086,
Canadian,Corporation Commissioner,Ashley Nicole Mccray,DEM,90216,34,28,322,384,
Canadian,Corporation Commissioner,Jackie Short,IND,90216,9,3,67,79,
Canadian,U.S. House,Frank Lucas,REP,90216,109,72,999,1180,3
Canadian,U.S. House,Frankie Robbins,DEM,90216,38,24,316,378,3
Canadian,State Senate,Stephanie Bice,REP,90216,111,69,981,1161,22
Canadian,State Senate,William Andrews,DEM,90216,35,26,328,389,22
Canadian,State House,Jay Steagall,REP,90216,109,68,950,1127,43
Canadian,State House,Chantelle Cory,DEM,90216,37,27,361,425,43
Canadian,Governor,Chris Powell,LIB,90217,3,2,60,65,
Canadian,Governor,Kevin Stitt,REP,90217,83,46,788,917,
Canadian,Governor,Drew Edmondson,DEM,90217,40,35,526,601,
Canadian,Lieutenant Governor,Matt Pinnell,REP,90217,84,50,919,1053,
Canadian,Lieutenant Governor,Anastasia Pittman,DEM,90217,38,32,389,459,
Canadian,Lieutenant Governor,Ivan Holmes,IND,90217,3,1,63,67,
Canadian,State Auditor,John Yeutter,LIB,90217,21,20,301,342,
Canadian,State Auditor,Cindy Byrd,REP,90217,99,52,993,1144,
Canadian,Attorney General,Mike Hunter,REP,90217,91,49,946,1086,
Canadian,Attorney General,Mark Myles,DEM,90217,35,33,414,482,
Canadian,State Treasurer,Randy Mcdaniel,REP,90217,90,51,938,1079,
Canadian,State Treasurer,Charles De Coune,IND,90217,29,20,347,396,
Canadian,Superintendent of Public Instruction,Joy Hofmeister,REP,90217,88,53,873,1014,
Canadian,Superintendent of Public Instruction,John Cox,DEM,90217,32,26,362,420,
Canadian,Superintendent of Public Instruction,Larry Huff,IND,90217,5,2,124,131,
Canadian,Commissioner of Labor,Leslie Osborn,REP,90217,84,50,914,1048,
Canadian,Commissioner of Labor,Fred Dorrell,DEM,90217,31,30,335,396,
Canadian,Commissioner of Labor,Brandt Dismukes,IND,90217,7,2,98,107,
Canadian,Insurance Commissioner,Glen Mulready,REP,90217,87,47,898,1032,
Canadian,Insurance Commissioner,Kimberly Fobbs,DEM,90217,38,32,448,518,
Canadian,Corporation Commissioner,Bob Anthony,REP,90217,84,46,857,987,
Canadian,Corporation Commissioner,Ashley Nicole Mccray,DEM,90217,35,33,395,463,
Canadian,Corporation Commissioner,Jackie Short,IND,90217,6,2,103,111,
Canadian,U.S. House,Frank Lucas,REP,90217,95,49,960,1104,3
Canadian,U.S. House,Frankie Robbins,DEM,90217,30,32,407,469,3
Canadian,State Senate,Stephanie Bice,REP,90217,87,50,944,1081,22
Canadian,State Senate,William Andrews,DEM,90217,37,31,409,477,22
Canadian,State House,Jay Steagall,REP,90217,86,49,925,1060,43
Canadian,State House,Chantelle Cory,DEM,90217,38,33,428,499,43
Canadian,Governor,Chris Powell,LIB,90218,5,3,38,46,
Canadian,Governor,Kevin Stitt,REP,90218,27,24,515,566,
Canadian,Governor,Drew Edmondson,DEM,90218,33,24,288,345,
Canadian,Lieutenant Governor,Matt Pinnell,REP,90218,37,30,576,643,
Canadian,Lieutenant Governor,Anastasia Pittman,DEM,90218,24,17,231,272,
Canadian,Lieutenant Governor,Ivan Holmes,IND,90218,2,4,33,39,
Canadian,State Auditor,John Yeutter,LIB,90218,15,13,171,199,
Canadian,State Auditor,Cindy Byrd,REP,90218,44,35,633,712,
Canadian,Attorney General,Mike Hunter,REP,90218,34,32,594,660,
Canadian,Attorney General,Mark Myles,DEM,90218,29,19,242,290,
Canadian,State Treasurer,Randy Mcdaniel,REP,90218,39,29,602,670,
Canadian,State Treasurer,Charles De Coune,IND,90218,19,18,200,237,
Canadian,Superintendent of Public Instruction,Joy Hofmeister,REP,90218,35,31,561,627,
Canadian,Superintendent of Public Instruction,John Cox,DEM,90218,25,18,201,244,
Canadian,Superintendent of Public Instruction,Larry Huff,IND,90218,4,1,72,77,
Canadian,Commissioner of Labor,Leslie Osborn,REP,90218,34,26,590,650,
Canadian,Commissioner of Labor,Fred Dorrell,DEM,90218,24,21,196,241,
Canadian,Commissioner of Labor,Brandt Dismukes,IND,90218,4,4,44,52,
Canadian,Insurance Commissioner,Glen Mulready,REP,90218,35,27,595,657,
Canadian,Insurance Commissioner,Kimberly Fobbs,DEM,90218,27,24,231,282,
Canadian,Corporation Commissioner,Bob Anthony,REP,90218,38,29,553,620,
Canadian,Corporation Commissioner,Ashley Nicole Mccray,DEM,90218,22,17,230,269,
Canadian,Corporation Commissioner,Jackie Short,IND,90218,3,5,48,56,
Canadian,U.S. House,Frank Lucas,REP,90218,39,30,597,666,3
Canadian,U.S. House,Frankie Robbins,DEM,90218,24,21,240,285,3
Canadian,State Senate,Stephanie Bice,REP,90218,38,28,598,664,22
Canadian,State Senate,William Andrews,DEM,90218,24,23,228,275,22
Canadian,State House,Jay Steagall,REP,90218,36,26,605,667,43
Canadian,State House,Chantelle Cory,DEM,90218,26,25,226,277,43
Canadian,Governor,Chris Powell,LIB,90220,4,1,49,54,
Canadian,Governor,Kevin Stitt,REP,90220,72,62,943,1077,
Canadian,Governor,Drew Edmondson,DEM,90220,59,46,610,715,
Canadian,Lieutenant Governor,Matt Pinnell,REP,90220,92,70,1068,1230,
Canadian,Lieutenant Governor,Anastasia Pittman,DEM,90220,40,35,452,527,
Canadian,Lieutenant Governor,Ivan Holmes,IND,90220,2,3,68,73,
Canadian,State Auditor,John Yeutter,LIB,90220,31,28,314,373,
Canadian,State Auditor,Cindy Byrd,REP,90220,99,75,1196,1370,
Canadian,Attorney General,Mike Hunter,REP,90220,81,66,1111,1258,
Canadian,Attorney General,Mark Myles,DEM,90220,52,41,471,564,
Canadian,State Treasurer,Randy Mcdaniel,REP,90220,95,73,1133,1301,
Canadian,State Treasurer,Charles De Coune,IND,90220,35,29,370,434,
Canadian,Superintendent of Public Instruction,Joy Hofmeister,REP,90220,90,69,1051,1210,
Canadian,Superintendent of Public Instruction,John Cox,DEM,90220,34,28,411,473,
Canadian,Superintendent of Public Instruction,Larry Huff,IND,90220,10,11,126,147,
Canadian,Commissioner of Labor,Leslie Osborn,REP,90220,91,67,1096,1254,
Canadian,Commissioner of Labor,Fred Dorrell,DEM,90220,35,31,400,466,
Canadian,Commissioner of Labor,Brandt Dismukes,IND,90220,8,9,71,88,
Canadian,Insurance Commissioner,Glen Mulready,REP,90220,88,69,1078,1235,
Canadian,Insurance Commissioner,Kimberly Fobbs,DEM,90220,44,37,482,563,
Canadian,Corporation Commissioner,Bob Anthony,REP,90220,84,65,1005,1154,
Canadian,Corporation Commissioner,Ashley Nicole Mccray,DEM,90220,39,34,460,533,
Canadian,Corporation Commissioner,Jackie Short,IND,90220,12,7,107,126,
Canadian,U.S. House,Frank Lucas,REP,90220,95,67,1128,1290,3
Canadian,U.S. House,Frankie Robbins,DEM,90220,40,40,453,533,3
Canadian,State Senate,Stephanie Bice,REP,90220,89,71,1111,1271,22
Canadian,State Senate,William Andrews,DEM,90220,46,33,459,538,22
Canadian,State House,Jay Steagall,REP,90220,88,68,1071,1227,43
Canadian,State House,Chantelle Cory,DEM,90220,47,38,494,579,43
Canadian,Governor,Chris Powell,LIB,90221,4,3,45,52,
Canadian,Governor,Kevin Stitt,REP,90221,36,15,575,626,
Canadian,Governor,Drew Edmondson,DEM,90221,41,29,379,449,
Canadian,Lieutenant Governor,Matt Pinnell,REP,90221,44,17,662,723,
Canadian,Lieutenant Governor,Anastasia Pittman,DEM,90221,35,26,290,351,
Canadian,Lieutenant Governor,Ivan Holmes,IND,90221,1,2,41,44,
Canadian,State Auditor,John Yeutter,LIB,90221,23,14,206,243,
Canadian,State Auditor,Cindy Byrd,REP,90221,47,26,729,802,
Canadian,Attorney General,Mike Hunter,REP,90221,44,20,680,744,
Canadian,Attorney General,Mark Myles,DEM,90221,33,25,306,364,
Canadian,State Treasurer,Randy Mcdaniel,REP,90221,45,22,700,767,
Canadian,State Treasurer,Charles De Coune,IND,90221,23,19,232,274,
Canadian,Superintendent of Public Instruction,Joy Hofmeister,REP,90221,42,21,612,675,
Canadian,Superintendent of Public Instruction,John Cox,DEM,90221,32,20,262,314,
Canadian,Superintendent of Public Instruction,Larry Huff,IND,90221,4,3,110,117,
Canadian,Commissioner of Labor,Leslie Osborn,REP,90221,41,22,675,738,
Canadian,Commissioner of Labor,Fred Dorrell,DEM,90221,32,20,250,302,
Canadian,Commissioner of Labor,Brandt Dismukes,IND,90221,3,2,54,59,
Canadian,Insurance Commissioner,Glen Mulready,REP,90221,44,18,646,708,
Canadian,Insurance Commissioner,Kimberly Fobbs,DEM,90221,33,26,330,389,
Canadian,Corporation Commissioner,Bob Anthony,REP,90221,37,19,595,651,
Canadian,Corporation Commissioner,Ashley Nicole Mccray,DEM,90221,36,23,309,368,
Canadian,Corporation Commissioner,Jackie Short,IND,90221,3,2,81,86,
Canadian,U.S. House,Frank Lucas,REP,90221,46,19,675,740,3
Canadian,U.S. House,Frankie Robbins,DEM,90221,32,25,306,363,3
Canadian,State House,Jay Steagall,REP,90221,42,18,666,726,43
Canadian,State House,Chantelle Cory,DEM,90221,34,26,317,377,43
Canadian,Governor,Chris Powell,LIB,90223,5,4,56,65,
Canadian,Governor,Kevin Stitt,REP,90223,52,29,771,852,
Canadian,Governor,Drew Edmondson,DEM,90223,59,23,544,626,
Canadian,Lieutenant Governor,Matt Pinnell,REP,90223,56,37,871,964,
Canadian,Lieutenant Governor,Anastasia Pittman,DEM,90223,49,19,422,490,
Canadian,Lieutenant Governor,Ivan Holmes,IND,90223,9,2,65,76,
Canadian,State Auditor,John Yeutter,LIB,90223,29,14,305,348,
Canadian,State Auditor,Cindy Byrd,REP,90223,71,37,960,1068,
Canadian,Attorney General,Mike Hunter,REP,90223,62,36,891,989,
Canadian,Attorney General,Mark Myles,DEM,90223,48,22,463,533,
Canadian,State Treasurer,Randy Mcdaniel,REP,90223,65,41,899,1005,
Canadian,State Treasurer,Charles De Coune,IND,90223,38,13,360,411,
Canadian,Superintendent of Public Instruction,Joy Hofmeister,REP,90223,55,36,800,891,
Canadian,Superintendent of Public Instruction,John Cox,DEM,90223,49,17,407,473,
Canadian,Superintendent of Public Instruction,Larry Huff,IND,90223,9,5,147,161,
Canadian,Commissioner of Labor,Leslie Osborn,REP,90223,61,37,895,993,
Canadian,Commissioner of Labor,Fred Dorrell,DEM,90223,42,20,378,440,
Canadian,Commissioner of Labor,Brandt Dismukes,IND,90223,7,1,73,81,
Canadian,Insurance Commissioner,Glen Mulready,REP,90223,56,37,864,957,
Canadian,Insurance Commissioner,Kimberly Fobbs,DEM,90223,53,20,476,549,
Canadian,Corporation Commissioner,Bob Anthony,REP,90223,55,38,818,911,
Canadian,Corporation Commissioner,Ashley Nicole Mccray,DEM,90223,45,17,426,488,
Canadian,Corporation Commissioner,Jackie Short,IND,90223,10,3,102,115,
Canadian,U.S. House,Frank Lucas,REP,90223,62,39,905,1006,3
Canadian,U.S. House,Frankie Robbins,DEM,90223,47,19,447,513,3
Canadian,State House,Jay Steagall,REP,90223,59,38,887,984,43
Canadian,State House,Chantelle Cory,DEM,90223,48,19,457,524,43
Canadian,Governor,Chris Powell,LIB,90224,4,2,33,39,
Canadian,Governor,Kevin Stitt,REP,90224,43,27,533,603,
Canadian,Governor,Drew Edmondson,DEM,90224,33,31,362,426,
Canadian,Lieutenant Governor,Matt Pinnell,REP,90224,47,30,603,680,
Canadian,Lieutenant Governor,Anastasia Pittman,DEM,90224,28,29,279,336,
Canadian,Lieutenant Governor,Ivan Holmes,IND,90224,4,1,37,42,
Canadian,State Auditor,John Yeutter,LIB,90224,22,15,207,244,
Canadian,State Auditor,Cindy Byrd,REP,90224,53,42,651,746,
Canadian,Attorney General,Mike Hunter,REP,90224,49,37,612,698,
Canadian,Attorney General,Mark Myles,DEM,90224,28,23,297,348,
Canadian,State Treasurer,Randy Mcdaniel,REP,90224,51,38,633,722,
Canadian,State Treasurer,Charles De Coune,IND,90224,23,19,224,266,
Canadian,Superintendent of Public Instruction,Joy Hofmeister,REP,90224,47,41,571,659,
Canadian,Superintendent of Public Instruction,John Cox,DEM,90224,26,18,266,310,
Canadian,Superintendent of Public Instruction,Larry Huff,IND,90224,4,1,82,87,
Canadian,Commissioner of Labor,Leslie Osborn,REP,90224,51,43,605,699,
Canadian,Commissioner of Labor,Fred Dorrell,DEM,90224,23,17,254,294,
Canadian,Commissioner of Labor,Brandt Dismukes,IND,90224,3,0,48,51,
Canadian,Insurance Commissioner,Glen Mulready,REP,90224,49,33,614,696,
Canadian,Insurance Commissioner,Kimberly Fobbs,DEM,90224,28,27,292,347,
Canadian,Corporation Commissioner,Bob Anthony,REP,90224,44,35,561,640,
Canadian,Corporation Commissioner,Ashley Nicole Mccray,DEM,90224,26,24,284,334,
Canadian,Corporation Commissioner,Jackie Short,IND,90224,6,1,64,71,
Canadian,U.S. House,Frank Lucas,REP,90224,49,37,629,715,3
Canadian,U.S. House,Frankie Robbins,DEM,90224,29,23,280,332,3
Canadian,State House,Jay Steagall,REP,90224,49,35,615,699,43
Canadian,State House,Chantelle Cory,DEM,90224,29,25,294,348,43
Canadian,Governor,Chris Powell,LIB,90225,1,0,28,29,
Canadian,Governor,Kevin Stitt,REP,90225,49,24,460,533,
Canadian,Governor,Drew Edmondson,DEM,90225,27,20,349,396,
Canadian,Lieutenant Governor,Matt Pinnell,REP,90225,50,27,529,606,
Canadian,Lieutenant Governor,Anastasia Pittman,DEM,90225,23,17,270,310,
Canadian,Lieutenant Governor,Ivan Holmes,IND,90225,4,0,34,38,
Canadian,State Auditor,John Yeutter,LIB,90225,9,12,181,202,
Canadian,State Auditor,Cindy Byrd,REP,90225,64,28,604,696,
Canadian,Attorney General,Mike Hunter,REP,90225,49,28,543,620,
Canadian,Attorney General,Mark Myles,DEM,90225,27,16,289,332,
Canadian,State Treasurer,Randy Mcdaniel,REP,90225,56,27,561,644,
Canadian,State Treasurer,Charles De Coune,IND,90225,17,12,227,256,
Canadian,Superintendent of Public Instruction,Joy Hofmeister,REP,90225,52,27,484,563,
Canadian,Superintendent of Public Instruction,John Cox,DEM,90225,21,15,263,299,
Canadian,Superintendent of Public Instruction,Larry Huff,IND,90225,5,2,86,93,
Canadian,Commissioner of Labor,Leslie Osborn,REP,90225,57,31,540,628,
Canadian,Commissioner of Labor,Fred Dorrell,DEM,90225,19,11,244,274,
Canadian,Commissioner of Labor,Brandt Dismukes,IND,90225,1,1,45,47,
Canadian,Insurance Commissioner,Glen Mulready,REP,90225,48,26,530,604,
Canadian,Insurance Commissioner,Kimberly Fobbs,DEM,90225,28,17,294,339,
Canadian,Corporation Commissioner,Bob Anthony,REP,90225,51,23,498,572,
Canadian,Corporation Commissioner,Ashley Nicole Mccray,DEM,90225,22,15,273,310,
Canadian,Corporation Commissioner,Jackie Short,IND,90225,3,5,56,64,
Canadian,U.S. House,Frank Lucas,REP,90225,53,30,544,627,3
Canadian,U.S. House,Frankie Robbins,DEM,90225,23,14,286,323,3
Canadian,State House,Brian Hill,REP,90225,50,24,475,549,47
Canadian,State House,Sarah Carnes,DEM,90225,26,20,356,402,47
Canadian,Governor,Chris Powell,LIB,90226,0,1,12,13,
Canadian,Governor,Kevin Stitt,REP,90226,18,5,218,241,
Canadian,Governor,Drew Edmondson,DEM,90226,7,1,71,79,
Canadian,Lieutenant Governor,Matt Pinnell,REP,90226,21,6,244,271,
Canadian,Lieutenant Governor,Anastasia Pittman,DEM,90226,4,1,51,56,
Canadian,Lieutenant Governor,Ivan Holmes,IND,90226,0,0,7,7,
Canadian,State Auditor,John Yeutter,LIB,90226,9,1,38,48,
Canadian,State Auditor,Cindy Byrd,REP,90226,15,6,257,278,
Canadian,Attorney General,Mike Hunter,REP,90226,21,5,247,273,
Canadian,Attorney General,Mark Myles,DEM,90226,4,2,56,62,
Canadian,State Treasurer,Randy Mcdaniel,REP,90226,19,6,254,279,
Canadian,State Treasurer,Charles De Coune,IND,90226,5,1,40,46,
Canadian,Superintendent of Public Instruction,Joy Hofmeister,REP,90226,11,4,217,232,
Canadian,Superintendent of Public Instruction,John Cox,DEM,90226,10,2,49,61,
Canadian,Superintendent of Public Instruction,Larry Huff,IND,90226,4,1,35,40,
Canadian,Commissioner of Labor,Leslie Osborn,REP,90226,15,5,242,262,
Canadian,Commissioner of Labor,Fred Dorrell,DEM,90226,8,2,36,46,
Canadian,Commissioner of Labor,Brandt Dismukes,IND,90226,2,0,23,25,
Canadian,Insurance Commissioner,Glen Mulready,REP,90226,20,6,243,269,
Canadian,Insurance Commissioner,Kimberly Fobbs,DEM,90226,5,1,59,65,
Canadian,Corporation Commissioner,Bob Anthony,REP,90226,16,5,219,240,
Canadian,Corporation Commissioner,Ashley Nicole Mccray,DEM,90226,7,2,55,64,
Canadian,Corporation Commissioner,Jackie Short,IND,90226,2,0,26,28,
Canadian,U.S. House,Frank Lucas,REP,90226,16,6,260,282,3
Canadian,U.S. House,Frankie Robbins,DEM,90226,9,1,43,53,3
Canadian,Governor,Chris Powell,LIB,90227,6,1,62,69,
Canadian,Governor,Kevin Stitt,REP,90227,113,65,822,1000,
Canadian,Governor,Drew Edmondson,DEM,90227,78,60,589,727,
Canadian,Lieutenant Governor,Matt Pinnell,REP,90227,122,85,936,1143,
Canadian,Lieutenant Governor,Anastasia Pittman,DEM,90227,67,38,457,562,
Canadian,Lieutenant Governor,Ivan Holmes,IND,90227,6,1,65,72,
Canadian,State Auditor,John Yeutter,LIB,90227,45,19,283,347,
Canadian,State Auditor,Cindy Byrd,REP,90227,139,97,1071,1307,
Canadian,Attorney General,Mike Hunter,REP,90227,128,88,981,1197,
Canadian,Attorney General,Mark Myles,DEM,90227,67,34,477,578,
Canadian,State Treasurer,Randy Mcdaniel,REP,90227,130,92,992,1214,
Canadian,State Treasurer,Charles De Coune,IND,90227,52,23,364,439,
Canadian,Superintendent of Public Instruction,Joy Hofmeister,REP,90227,129,84,944,1157,
Canadian,Superintendent of Public Instruction,John Cox,DEM,90227,47,33,398,478,
Canadian,Superintendent of Public Instruction,Larry Huff,IND,90227,18,7,126,151,
Canadian,Commissioner of Labor,Leslie Osborn,REP,90227,130,91,1002,1223,
Canadian,Commissioner of Labor,Fred Dorrell,DEM,90227,53,30,369,452,
Canadian,Commissioner of Labor,Brandt Dismukes,IND,90227,11,1,83,95,
Canadian,Insurance Commissioner,Glen Mulready,REP,90227,125,82,945,1152,
Canadian,Insurance Commissioner,Kimberly Fobbs,DEM,90227,66,38,501,605,
Canadian,Corporation Commissioner,Bob Anthony,REP,90227,125,77,899,1101,
Canadian,Corporation Commissioner,Ashley Nicole Mccray,DEM,90227,53,40,459,552,
Canadian,Corporation Commissioner,Jackie Short,IND,90227,16,6,101,123,
Canadian,U.S. House,Frank Lucas,REP,90227,140,89,1008,1237,3
Canadian,U.S. House,Frankie Robbins,DEM,90227,54,32,449,535,3
Canadian,State House,Brian Hill,REP,90227,116,74,881,1071,47
Canadian,State House,Sarah Carnes,DEM,90227,78,50,576,704,47
Canadian,Governor,Chris Powell,LIB,90228,0,0,18,18,
Canadian,Governor,Kevin Stitt,REP,90228,15,17,249,281,
Canadian,Governor,Drew Edmondson,DEM,90228,17,14,227,258,
Canadian,Lieutenant Governor,Matt Pinnell,REP,90228,17,17,297,331,
Canadian,Lieutenant Governor,Anastasia Pittman,DEM,90228,15,13,170,198,
Canadian,Lieutenant Governor,Ivan Holmes,IND,90228,0,1,22,23,
Canadian,State Auditor,John Yeutter,LIB,90228,8,11,126,145,
Canadian,State Auditor,Cindy Byrd,REP,90228,24,18,330,372,
Canadian,Attorney General,Mike Hunter,REP,90228,18,17,300,335,
Canadian,Attorney General,Mark Myles,DEM,90228,14,14,186,214,
Canadian,State Treasurer,Randy Mcdaniel,REP,90228,21,17,307,345,
Canadian,State Treasurer,Charles De Coune,IND,90228,11,12,152,175,
Canadian,Superintendent of Public Instruction,Joy Hofmeister,REP,90228,14,13,272,299,
Canadian,Superintendent of Public Instruction,John Cox,DEM,90228,13,13,176,202,
Canadian,Superintendent of Public Instruction,Larry Huff,IND,90228,5,5,41,51,
Canadian,Commissioner of Labor,Leslie Osborn,REP,90228,17,17,298,332,
Canadian,Commissioner of Labor,Fred Dorrell,DEM,90228,11,14,150,175,
Canadian,Commissioner of Labor,Brandt Dismukes,IND,90228,4,0,39,43,
Canadian,Insurance Commissioner,Glen Mulready,REP,90228,18,16,294,328,
Canadian,Insurance Commissioner,Kimberly Fobbs,DEM,90228,14,15,190,219,
Canadian,Corporation Commissioner,Bob Anthony,REP,90228,18,16,268,302,
Canadian,Corporation Commissioner,Ashley Nicole Mccray,DEM,90228,12,14,179,205,
Canadian,Corporation Commissioner,Jackie Short,IND,90228,2,1,37,40,
Canadian,U.S. House,Frank Lucas,REP,90228,18,17,300,335,3
Canadian,U.S. House,Frankie Robbins,DEM,90228,14,14,186,214,3
Canadian,State House,Jay Steagall,REP,90228,18,17,287,322,43
Canadian,State House,Chantelle Cory,DEM,90228,14,14,197,225,43
Canadian,Governor,Chris Powell,LIB,90300,4,1,39,44,
Canadian,Governor,Kevin Stitt,REP,90300,54,31,619,704,
Canadian,Governor,Drew Edmondson,DEM,90300,29,16,306,351,
Canadian,Lieutenant Governor,Matt Pinnell,REP,90300,62,38,695,795,
Canadian,Lieutenant Governor,Anastasia Pittman,DEM,90300,24,8,224,256,
Canadian,Lieutenant Governor,Ivan Holmes,IND,90300,1,2,38,41,
Canadian,State Auditor,John Yeutter,LIB,90300,9,9,187,205,
Canadian,State Auditor,Cindy Byrd,REP,90300,77,36,719,832,
Canadian,Attorney General,Mike Hunter,REP,90300,67,34,701,802,
Canadian,Attorney General,Mark Myles,DEM,90300,21,13,248,282,
Canadian,State Treasurer,Randy Mcdaniel,REP,90300,74,36,721,831,
Canadian,State Treasurer,Charles De Coune,IND,90300,13,9,183,205,
Canadian,Superintendent of Public Instruction,Joy Hofmeister,REP,90300,58,32,639,729,
Canadian,Superintendent of Public Instruction,John Cox,DEM,90300,20,14,209,243,
Canadian,Superintendent of Public Instruction,Larry Huff,IND,90300,10,1,103,114,
Canadian,Commissioner of Labor,Leslie Osborn,REP,90300,71,36,694,801,
Canadian,Commissioner of Labor,Fred Dorrell,DEM,90300,15,12,199,226,
Canadian,Commissioner of Labor,Brandt Dismukes,IND,90300,2,0,60,62,
Canadian,Insurance Commissioner,Glen Mulready,REP,90300,68,34,689,791,
Canadian,Insurance Commissioner,Kimberly Fobbs,DEM,90300,19,13,255,287,
Canadian,Corporation Commissioner,Bob Anthony,REP,90300,62,34,643,739,
Canadian,Corporation Commissioner,Ashley Nicole Mccray,DEM,90300,16,8,235,259,
Canadian,Corporation Commissioner,Jackie Short,IND,90300,10,5,66,81,
Canadian,U.S. House,Tom Cole,REP,90300,63,36,687,786,4
Canadian,U.S. House,Mary Brannon,DEM,90300,20,9,220,249,4
Canadian,U.S. House,Ruby Peters,IND,90300,5,2,46,53,4
Canadian,State House,Brian Hill,REP,90300,67,32,641,740,47
Canadian,State House,Sarah Carnes,DEM,90300,20,15,304,339,47
Canadian,Governor,Chris Powell,LIB,90301,3,2,60,65,
Canadian,Governor,Kevin Stitt,REP,90301,65,45,1004,1114,
Canadian,Governor,Drew Edmondson,DEM,90301,60,19,501,580,
Canadian,Lieutenant Governor,Matt Pinnell,REP,90301,78,49,1114,1241,
Canadian,Lieutenant Governor,Anastasia Pittman,DEM,90301,48,16,376,440,
Canadian,Lieutenant Governor,Ivan Holmes,IND,90301,2,1,61,64,
Canadian,State Auditor,John Yeutter,LIB,90301,20,10,284,314,
Canadian,State Auditor,Cindy Byrd,REP,90301,91,51,1191,1333,
Canadian,Attorney General,Mike Hunter,REP,90301,76,49,1155,1280,
Canadian,Attorney General,Mark Myles,DEM,90301,50,17,385,452,
Canadian,State Treasurer,Randy Mcdaniel,REP,90301,77,52,1152,1281,
Canadian,State Treasurer,Charles De Coune,IND,90301,35,9,316,360,
Canadian,Superintendent of Public Instruction,Joy Hofmeister,REP,90301,75,45,1066,1186,
Canadian,Superintendent of Public Instruction,John Cox,DEM,90301,46,16,339,401,
Canadian,Superintendent of Public Instruction,Larry Huff,IND,90301,6,5,141,152,
Canadian,Commissioner of Labor,Leslie Osborn,REP,90301,78,48,1149,1275,
Canadian,Commissioner of Labor,Fred Dorrell,DEM,90301,42,15,295,352,
Canadian,Commissioner of Labor,Brandt Dismukes,IND,90301,7,3,90,100,
Canadian,Insurance Commissioner,Glen Mulready,REP,90301,79,49,1109,1237,
Canadian,Insurance Commissioner,Kimberly Fobbs,DEM,90301,48,17,412,477,
Canadian,Corporation Commissioner,Bob Anthony,REP,90301,71,48,1047,1166,
Canadian,Corporation Commissioner,Ashley Nicole Mccray,DEM,90301,48,16,363,427,
Canadian,Corporation Commissioner,Jackie Short,IND,90301,6,2,114,122,
Canadian,U.S. House,Tom Cole,REP,90301,76,49,1121,1246,4
Canadian,U.S. House,Mary Brannon,DEM,90301,48,17,359,424,4
Canadian,U.S. House,Ruby Peters,IND,90301,4,0,69,73,4
Canadian,State House,Brian Hill,REP,90301,71,48,1031,1150,47
Canadian,State House,Sarah Carnes,DEM,90301,55,18,509,582,47
Canadian,Governor,Chris Powell,LIB,90302,3,3,58,64,
Canadian,Governor,Kevin Stitt,REP,90302,55,14,753,822,
Canadian,Governor,Drew Edmondson,DEM,90302,45,17,370,432,
Canadian,Lieutenant Governor,Matt Pinnell,REP,90302,64,17,847,928,
Canadian,Lieutenant Governor,Anastasia Pittman,DEM,90302,38,13,269,320,
Canadian,Lieutenant Governor,Ivan Holmes,IND,90302,1,4,59,64,
Canadian,State Auditor,John Yeutter,LIB,90302,24,14,222,260,
Canadian,State Auditor,Cindy Byrd,REP,90302,73,18,895,986,
Canadian,Attorney General,Mike Hunter,REP,90302,68,20,872,960,
Canadian,Attorney General,Mark Myles,DEM,90302,35,14,297,346,
Canadian,State Treasurer,Randy Mcdaniel,REP,90302,70,17,891,978,
Canadian,State Treasurer,Charles De Coune,IND,90302,27,15,230,272,
Canadian,Superintendent of Public Instruction,Joy Hofmeister,REP,90302,62,14,796,872,
Canadian,Superintendent of Public Instruction,John Cox,DEM,90302,31,13,251,295,
Canadian,Superintendent of Public Instruction,Larry Huff,IND,90302,10,7,125,142,
Canadian,Commissioner of Labor,Leslie Osborn,REP,90302,66,19,856,941,
Canadian,Commissioner of Labor,Fred Dorrell,DEM,90302,33,12,232,277,
Canadian,Commissioner of Labor,Brandt Dismukes,IND,90302,4,3,79,86,
Canadian,Insurance Commissioner,Glen Mulready,REP,90302,65,17,863,945,
Canadian,Insurance Commissioner,Kimberly Fobbs,DEM,90302,38,17,298,353,
Canadian,Corporation Commissioner,Bob Anthony,REP,90302,64,18,797,879,
Canadian,Corporation Commissioner,Ashley Nicole Mccray,DEM,90302,33,13,283,329,
Canadian,Corporation Commissioner,Jackie Short,IND,90302,6,3,85,94,
Canadian,U.S. House,Tom Cole,REP,90302,64,16,863,943,4
Canadian,U.S. House,Mary Brannon,DEM,90302,33,15,261,309,4
Canadian,U.S. House,Ruby Peters,IND,90302,5,3,52,60,4
Canadian,State House,Brian Hill,REP,90302,60,15,772,847,47
Canadian,State House,Sarah Carnes,DEM,90302,41,19,398,458,47
Canadian,Governor,Chris Powell,LIB,90303,2,0,65,67,
Canadian,Governor,Kevin Stitt,REP,90303,132,74,1181,1387,
Canadian,Governor,Drew Edmondson,DEM,90303,99,56,581,736,
Canadian,Lieutenant Governor,Matt Pinnell,REP,90303,156,85,1300,1541,
Canadian,Lieutenant Governor,Anastasia Pittman,DEM,90303,67,39,458,564,
Canadian,Lieutenant Governor,Ivan Holmes,IND,90303,6,6,58,70,
Canadian,State Auditor,John Yeutter,LIB,90303,44,28,311,383,
Canadian,State Auditor,Cindy Byrd,REP,90303,175,89,1411,1675,
Canadian,Attorney General,Mike Hunter,REP,90303,154,82,1344,1580,
Canadian,Attorney General,Mark Myles,DEM,90303,74,48,453,575,
Canadian,State Treasurer,Randy Mcdaniel,REP,90303,161,78,1352,1591,
Canadian,State Treasurer,Charles De Coune,IND,90303,61,41,365,467,
Canadian,Superintendent of Public Instruction,Joy Hofmeister,REP,90303,154,83,1222,1459,
Canadian,Superintendent of Public Instruction,John Cox,DEM,90303,63,36,410,509,
Canadian,Superintendent of Public Instruction,Larry Huff,IND,90303,12,10,165,187,
Canadian,Commissioner of Labor,Leslie Osborn,REP,90303,164,88,1339,1591,
Canadian,Commissioner of Labor,Fred Dorrell,DEM,90303,54,39,364,457,
Canadian,Commissioner of Labor,Brandt Dismukes,IND,90303,8,3,89,100,
Canadian,Insurance Commissioner,Glen Mulready,REP,90303,149,80,1304,1533,
Canadian,Insurance Commissioner,Kimberly Fobbs,DEM,90303,77,48,485,610,
Canadian,Corporation Commissioner,Bob Anthony,REP,90303,137,80,1239,1456,
Canadian,Corporation Commissioner,Ashley Nicole Mccray,DEM,90303,79,44,435,558,
Canadian,Corporation Commissioner,Jackie Short,IND,90303,10,6,117,133,
Canadian,U.S. House,Frank Lucas,REP,90303,157,80,1334,1571,3
Canadian,U.S. House,Frankie Robbins,DEM,90303,73,50,462,585,3
Canadian,State House,Brian Hill,REP,90303,144,82,1212,1438,47
Canadian,State House,Sarah Carnes,DEM,90303,82,46,581,709,47
Canadian,Governor,Chris Powell,LIB,90304,3,1,50,54,
Canadian,Governor,Kevin Stitt,REP,90304,24,18,596,638,
Canadian,Governor,Drew Edmondson,DEM,90304,22,13,328,363,
Canadian,Lieutenant Governor,Matt Pinnell,REP,90304,26,15,670,711,
Canadian,Lieutenant Governor,Anastasia Pittman,DEM,90304,18,13,268,299,
Canadian,Lieutenant Governor,Ivan Holmes,IND,90304,5,4,36,45,
Canadian,State Auditor,John Yeutter,LIB,90304,14,11,191,216,
Canadian,State Auditor,Cindy Byrd,REP,90304,30,18,721,769,
Canadian,Attorney General,Mike Hunter,REP,90304,29,18,673,720,
Canadian,Attorney General,Mark Myles,DEM,90304,19,14,299,332,
Canadian,State Treasurer,Randy Mcdaniel,REP,90304,27,21,694,742,
Canadian,State Treasurer,Charles De Coune,IND,90304,17,10,216,243,
Canadian,Superintendent of Public Instruction,Joy Hofmeister,REP,90304,27,17,616,660,
Canadian,Superintendent of Public Instruction,John Cox,DEM,90304,18,12,244,274,
Canadian,Superintendent of Public Instruction,Larry Huff,IND,90304,4,3,107,114,
Canadian,Commissioner of Labor,Leslie Osborn,REP,90304,26,19,672,717,
Canadian,Commissioner of Labor,Fred Dorrell,DEM,90304,19,10,231,260,
Canadian,Commissioner of Labor,Brandt Dismukes,IND,90304,4,3,63,70,
Canadian,Insurance Commissioner,Glen Mulready,REP,90304,26,20,667,713,
Canadian,Insurance Commissioner,Kimberly Fobbs,DEM,90304,22,12,297,331,
Canadian,Corporation Commissioner,Bob Anthony,REP,90304,26,14,624,664,
Canadian,Corporation Commissioner,Ashley Nicole Mccray,DEM,90304,17,14,278,309,
Canadian,Corporation Commissioner,Jackie Short,IND,90304,5,4,67,76,
Canadian,U.S. House,Tom Cole,REP,90304,27,16,677,720,4
Canadian,U.S. House,Mary Brannon,DEM,90304,17,14,251,282,4
Canadian,U.S. House,Ruby Peters,IND,90304,3,2,46,51,4
Canadian,State House,Brian Hill,REP,90304,24,17,617,658,47
Canadian,State House,Sarah Carnes,DEM,90304,25,15,349,389,47
Canadian,Governor,Chris Powell,LIB,90306,2,2,72,76,
Canadian,Governor,Kevin Stitt,REP,90306,92,46,1080,1218,
Canadian,Governor,Drew Edmondson,DEM,90306,51,26,531,608,
Canadian,Lieutenant Governor,Matt Pinnell,REP,90306,102,51,1191,1344,
Canadian,Lieutenant Governor,Anastasia Pittman,DEM,90306,39,22,412,473,
Canadian,Lieutenant Governor,Ivan Holmes,IND,90306,4,1,73,78,
Canadian,State Auditor,John Yeutter,LIB,90306,19,12,300,331,
Canadian,State Auditor,Cindy Byrd,REP,90306,118,54,1275,1447,
Canadian,Attorney General,Mike Hunter,REP,90306,104,49,1221,1374,
Canadian,Attorney General,Mark Myles,DEM,90306,40,24,448,512,
Canadian,State Treasurer,Randy Mcdaniel,REP,90306,107,53,1243,1403,
Canadian,State Treasurer,Charles De Coune,IND,90306,30,12,339,381,
Canadian,Superintendent of Public Instruction,Joy Hofmeister,REP,90306,93,50,1145,1288,
Canadian,Superintendent of Public Instruction,John Cox,DEM,90306,40,20,380,440,
Canadian,Superintendent of Public Instruction,Larry Huff,IND,90306,12,3,145,160,
Canadian,Commissioner of Labor,Leslie Osborn,REP,90306,100,54,1235,1389,
Canadian,Commissioner of Labor,Fred Dorrell,DEM,90306,36,17,348,401,
Canadian,Commissioner of Labor,Brandt Dismukes,IND,90306,8,2,87,97,
Canadian,Insurance Commissioner,Glen Mulready,REP,90306,100,54,1203,1357,
Canadian,Insurance Commissioner,Kimberly Fobbs,DEM,90306,44,20,452,516,
Canadian,Corporation Commissioner,Bob Anthony,REP,90306,93,52,1137,1282,
Canadian,Corporation Commissioner,Ashley Nicole Mccray,DEM,90306,40,19,410,469,
Canadian,Corporation Commissioner,Jackie Short,IND,90306,12,3,119,134,
Canadian,U.S. House,Tom Cole,REP,90306,102,52,1199,1353,4
Canadian,U.S. House,Mary Brannon,DEM,90306,40,19,402,461,4
Canadian,U.S. House,Ruby Peters,IND,90306,2,3,71,76,4
Canadian,State House,Brian Hill,REP,90306,98,48,1097,1243,47
Canadian,State House,Sarah Carnes,DEM,90306,47,26,567,640,47
Canadian,Governor,Chris Powell,LIB,90308,4,0,11,15,
Canadian,Governor,Kevin Stitt,REP,90308,16,19,279,314,
Canadian,Governor,Drew Edmondson,DEM,90308,7,3,87,97,
Canadian,Lieutenant Governor,Matt Pinnell,REP,90308,20,21,298,339,
Canadian,Lieutenant Governor,Anastasia Pittman,DEM,90308,3,1,60,64,
Canadian,Lieutenant Governor,Ivan Holmes,IND,90308,4,0,16,20,
Canadian,State Auditor,John Yeutter,LIB,90308,4,1,63,68,
Canadian,State Auditor,Cindy Byrd,REP,90308,20,21,307,348,
Canadian,Attorney General,Mike Hunter,REP,90308,21,20,308,349,
Canadian,Attorney General,Mark Myles,DEM,90308,6,2,65,73,
Canadian,State Treasurer,Randy Mcdaniel,REP,90308,18,22,301,341,
Canadian,State Treasurer,Charles De Coune,IND,90308,3,0,68,71,
Canadian,Superintendent of Public Instruction,Joy Hofmeister,REP,90308,17,20,283,320,
Canadian,Superintendent of Public Instruction,John Cox,DEM,90308,6,2,57,65,
Canadian,Superintendent of Public Instruction,Larry Huff,IND,90308,4,0,33,37,
Canadian,Commissioner of Labor,Leslie Osborn,REP,90308,19,19,298,336,
Canadian,Commissioner of Labor,Fred Dorrell,DEM,90308,3,2,52,57,
Canadian,Commissioner of Labor,Brandt Dismukes,IND,90308,5,0,22,27,
Canadian,Insurance Commissioner,Glen Mulready,REP,90308,16,21,302,339,
Canadian,Insurance Commissioner,Kimberly Fobbs,DEM,90308,9,1,67,77,
Canadian,Corporation Commissioner,Bob Anthony,REP,90308,18,19,290,327,
Canadian,Corporation Commissioner,Ashley Nicole Mccray,DEM,90308,4,3,58,65,
Canadian,Corporation Commissioner,Jackie Short,IND,90308,5,0,24,29,
Canadian,U.S. House,Frank Lucas,REP,90308,21,20,314,355,3
Canadian,U.S. House,Frankie Robbins,DEM,90308,6,2,59,67,3
Canadian,State House,Brian Hill,REP,90308,19,19,290,328,47
Canadian,State House,Sarah Carnes,DEM,90308,8,3,82,93,47
Canadian,Governor,Chris Powell,LIB,90309,0,0,4,4,
Canadian,Governor,Kevin Stitt,REP,90309,5,2,64,71,
Canadian,Governor,Drew Edmondson,DEM,90309,2,2,24,28,
Canadian,Lieutenant Governor,Matt Pinnell,REP,90309,6,2,74,82,
Canadian,Lieutenant Governor,Anastasia Pittman,DEM,90309,1,2,15,18,
Canadian,Lieutenant Governor,Ivan Holmes,IND,90309,0,0,3,3,
Canadian,State Auditor,John Yeutter,LIB,90309,1,1,14,16,
Canadian,State Auditor,Cindy Byrd,REP,90309,6,3,76,85,
Canadian,Attorney General,Mike Hunter,REP,90309,6,3,78,87,
Canadian,Attorney General,Mark Myles,DEM,90309,1,1,14,16,
Canadian,State Treasurer,Randy Mcdaniel,REP,90309,5,4,72,81,
Canadian,State Treasurer,Charles De Coune,IND,90309,2,0,17,19,
Canadian,Superintendent of Public Instruction,Joy Hofmeister,REP,90309,3,4,66,73,
Canadian,Superintendent of Public Instruction,John Cox,DEM,90309,2,0,15,17,
Canadian,Superintendent of Public Instruction,Larry Huff,IND,90309,2,0,11,13,
Canadian,Commissioner of Labor,Leslie Osborn,REP,90309,4,4,70,78,
Canadian,Commissioner of Labor,Fred Dorrell,DEM,90309,2,0,15,17,
Canadian,Commissioner of Labor,Brandt Dismukes,IND,90309,1,0,7,8,
Canadian,Insurance Commissioner,Glen Mulready,REP,90309,6,3,74,83,
Canadian,Insurance Commissioner,Kimberly Fobbs,DEM,90309,1,1,17,19,
Canadian,Corporation Commissioner,Bob Anthony,REP,90309,4,3,65,72,
Canadian,Corporation Commissioner,Ashley Nicole Mccray,DEM,90309,2,1,19,22,
Canadian,Corporation Commissioner,Jackie Short,IND,90309,1,0,8,9,
Canadian,U.S. House,Tom Cole,REP,90309,6,4,73,83,4
Canadian,U.S. House,Mary Brannon,DEM,90309,1,0,14,15,4
Canadian,U.S. House,Ruby Peters,IND,90309,0,0,5,5,4
Canadian,State House,Brian Hill,REP,90309,4,2,68,74,47
Canadian,State House,Sarah Carnes,DEM,90309,3,2,23,28,47
Canadian,Governor,Chris Powell,LIB,90398,0,0,0,0,
Canadian,Governor,Kevin Stitt,REP,90398,0,0,0,0,
Canadian,Governor,Drew Edmondson,DEM,90398,0,0,0,0,
Canadian,Lieutenant Governor,Matt Pinnell,REP,90398,0,0,0,0,
Canadian,Lieutenant Governor,Anastasia Pittman,DEM,90398,0,0,0,0,
Canadian,Lieutenant Governor,Ivan Holmes,IND,90398,0,0,0,0,
Canadian,State Auditor,John Yeutter,LIB,90398,0,0,0,0,
Canadian,State Auditor,Cindy Byrd,REP,90398,0,0,0,0,
Canadian,Attorney General,Mike Hunter,REP,90398,0,0,0,0,
Canadian,Attorney General,Mark Myles,DEM,90398,0,0,0,0,
Canadian,State Treasurer,Randy Mcdaniel,REP,90398,0,0,0,0,
Canadian,State Treasurer,Charles De Coune,IND,90398,0,0,0,0,
Canadian,Superintendent of Public Instruction,Joy Hofmeister,REP,90398,0,0,0,0,
Canadian,Superintendent of Public Instruction,John Cox,DEM,90398,0,0,0,0,
Canadian,Superintendent of Public Instruction,Larry Huff,IND,90398,0,0,0,0,
Canadian,Commissioner of Labor,Leslie Osborn,REP,90398,0,0,0,0,
Canadian,Commissioner of Labor,Fred Dorrell,DEM,90398,0,0,0,0,
Canadian,Commissioner of Labor,Brandt Dismukes,IND,90398,0,0,0,0,
Canadian,Insurance Commissioner,Glen Mulready,REP,90398,0,0,0,0,
Canadian,Insurance Commissioner,Kimberly Fobbs,DEM,90398,0,0,0,0,
Canadian,Corporation Commissioner,Bob Anthony,REP,90398,0,0,0,0,
Canadian,Corporation Commissioner,Ashley Nicole Mccray,DEM,90398,0,0,0,0,
Canadian,Corporation Commissioner,Jackie Short,IND,90398,0,0,0,0,
Canadian,U.S. House,Tom Cole,REP,90398,0,0,0,0,4
Canadian,U.S. House,Mary Brannon,DEM,90398,0,0,0,0,4
Canadian,U.S. House,Ruby Peters,IND,90398,0,0,0,0,4
Canadian,State House,Brian Hill,REP,90398,0,0,0,0,47
Canadian,State House,Sarah Carnes,DEM,90398,0,0,0,0,47
Canadian,Governor,Chris Powell,LIB,90399,0,0,0,0,
Canadian,Governor,Kevin Stitt,REP,90399,0,0,0,0,
Canadian,Governor,Drew Edmondson,DEM,90399,0,0,0,0,
Canadian,Lieutenant Governor,Matt Pinnell,REP,90399,0,0,0,0,
Canadian,Lieutenant Governor,Anastasia Pittman,DEM,90399,0,0,0,0,
Canadian,Lieutenant Governor,Ivan Holmes,IND,90399,0,0,0,0,
Canadian,State Auditor,John Yeutter,LIB,90399,0,0,0,0,
Canadian,State Auditor,Cindy Byrd,REP,90399,0,0,0,0,
Canadian,Attorney General,Mike Hunter,REP,90399,0,0,0,0,
Canadian,Attorney General,Mark Myles,DEM,90399,0,0,0,0,
Canadian,State Treasurer,Randy Mcdaniel,REP,90399,0,0,0,0,
Canadian,State Treasurer,Charles De Coune,IND,90399,0,0,0,0,
Canadian,Superintendent of Public Instruction,Joy Hofmeister,REP,90399,0,0,0,0,
Canadian,Superintendent of Public Instruction,John Cox,DEM,90399,0,0,0,0,
Canadian,Superintendent of Public Instruction,Larry Huff,IND,90399,0,0,0,0,
Canadian,Commissioner of Labor,Leslie Osborn,REP,90399,0,0,0,0,
Canadian,Commissioner of Labor,Fred Dorrell,DEM,90399,0,0,0,0,
Canadian,Commissioner of Labor,Brandt Dismukes,IND,90399,0,0,0,0,
Canadian,Insurance Commissioner,Glen Mulready,REP,90399,0,0,0,0,
Canadian,Insurance Commissioner,Kimberly Fobbs,DEM,90399,0,0,0,0,
Canadian,Corporation Commissioner,Bob Anthony,REP,90399,0,0,0,0,
Canadian,Corporation Commissioner,Ashley Nicole Mccray,DEM,90399,0,0,0,0,
Canadian,Corporation Commissioner,Jackie Short,IND,90399,0,0,0,0,
Canadian,U.S. House,Tom Cole,REP,90399,0,0,0,0,4
Canadian,U.S. House,Mary Brannon,DEM,90399,0,0,0,0,4
Canadian,U.S. House,Ruby Peters,IND,90399,0,0,0,0,4
Canadian,State House,Brian Hill,REP,90399,0,0,0,0,47
Canadian,State House,Sarah Carnes,DEM,90399,0,0,0,0,47
Canadian,Governor,Chris Powell,LIB,90400,3,1,36,40,
Canadian,Governor,Kevin Stitt,REP,90400,18,27,393,438,
Canadian,Governor,Drew Edmondson,DEM,90400,9,8,131,148,
Canadian,Lieutenant Governor,Matt Pinnell,REP,90400,23,27,445,495,
Canadian,Lieutenant Governor,Anastasia Pittman,DEM,90400,6,8,89,103,
Canadian,Lieutenant Governor,Ivan Holmes,IND,90400,0,1,23,24,
Canadian,State Auditor,John Yeutter,LIB,90400,4,9,96,109,
Canadian,State Auditor,Cindy Byrd,REP,90400,26,27,453,506,
Canadian,Attorney General,Mike Hunter,REP,90400,22,28,440,490,
Canadian,Attorney General,Mark Myles,DEM,90400,8,8,118,134,
Canadian,State Treasurer,Randy Mcdaniel,REP,90400,23,32,460,515,
Canadian,State Treasurer,Charles De Coune,IND,90400,6,4,89,99,
Canadian,Superintendent of Public Instruction,Joy Hofmeister,REP,90400,18,26,407,451,
Canadian,Superintendent of Public Instruction,John Cox,DEM,90400,11,8,84,103,
Canadian,Superintendent of Public Instruction,Larry Huff,IND,90400,0,2,68,70,
Canadian,Commissioner of Labor,Leslie Osborn,REP,90400,24,32,444,500,
Canadian,Commissioner of Labor,Fred Dorrell,DEM,90400,5,4,68,77,
Canadian,Commissioner of Labor,Brandt Dismukes,IND,90400,1,0,40,41,
Canadian,Insurance Commissioner,Glen Mulready,REP,90400,20,26,427,473,
Canadian,Insurance Commissioner,Kimberly Fobbs,DEM,90400,9,10,124,143,
Canadian,Corporation Commissioner,Bob Anthony,REP,90400,19,27,407,453,
Canadian,Corporation Commissioner,Ashley Nicole Mccray,DEM,90400,10,7,102,119,
Canadian,Corporation Commissioner,Jackie Short,IND,90400,1,2,46,49,
Canadian,U.S. House,Frank Lucas,REP,90400,21,28,466,515,3
Canadian,U.S. House,Frankie Robbins,DEM,90400,9,8,92,109,3
Canadian,Governor,Chris Powell,LIB,90403,0,0,10,10,
Canadian,Governor,Kevin Stitt,REP,90403,8,13,170,191,
Canadian,Governor,Drew Edmondson,DEM,90403,4,1,62,67,
Canadian,Lieutenant Governor,Matt Pinnell,REP,90403,10,14,181,205,
Canadian,Lieutenant Governor,Anastasia Pittman,DEM,90403,2,0,53,55,
Canadian,Lieutenant Governor,Ivan Holmes,IND,90403,0,0,8,8,
Canadian,State Auditor,John Yeutter,LIB,90403,2,1,47,50,
Canadian,State Auditor,Cindy Byrd,REP,90403,10,13,182,205,
Canadian,Attorney General,Mike Hunter,REP,90403,10,14,184,208,
Canadian,Attorney General,Mark Myles,DEM,90403,2,0,58,60,
Canadian,State Treasurer,Randy Mcdaniel,REP,90403,10,14,178,202,
Canadian,State Treasurer,Charles De Coune,IND,90403,2,0,50,52,
Canadian,Superintendent of Public Instruction,Joy Hofmeister,REP,90403,10,14,164,188,
Canadian,Superintendent of Public Instruction,John Cox,DEM,90403,2,0,46,48,
Canadian,Superintendent of Public Instruction,Larry Huff,IND,90403,0,0,30,30,
Canadian,Commissioner of Labor,Leslie Osborn,REP,90403,11,13,176,200,
Canadian,Commissioner of Labor,Fred Dorrell,DEM,90403,1,0,51,52,
Canadian,Commissioner of Labor,Brandt Dismukes,IND,90403,0,0,13,13,
Canadian,Insurance Commissioner,Glen Mulready,REP,90403,9,14,180,203,
Canadian,Insurance Commissioner,Kimberly Fobbs,DEM,90403,3,0,62,65,
Canadian,Corporation Commissioner,Bob Anthony,REP,90403,10,13,170,193,
Canadian,Corporation Commissioner,Ashley Nicole Mccray,DEM,90403,2,1,50,53,
Canadian,Corporation Commissioner,Jackie Short,IND,90403,0,0,22,22,
Canadian,U.S. House,Frank Lucas,REP,90403,10,14,190,214,3
Canadian,U.S. House,Frankie Robbins,DEM,90403,2,0,54,56,3
Canadian,Governor,Chris Powell,LIB,90404,0,0,5,5,
Canadian,Governor,Kevin Stitt,REP,90404,4,10,104,118,
Canadian,Governor,Drew Edmondson,DEM,90404,2,6,43,51,
Canadian,Lieutenant Governor,Matt Pinnell,REP,90404,3,12,117,132,
Canadian,Lieutenant Governor,Anastasia Pittman,DEM,90404,1,2,30,33,
Canadian,Lieutenant Governor,Ivan Holmes,IND,90404,0,2,5,7,
Canadian,State Auditor,John Yeutter,LIB,90404,1,1,30,32,
Canadian,State Auditor,Cindy Byrd,REP,90404,3,14,118,135,
Canadian,Attorney General,Mike Hunter,REP,90404,2,11,114,127,
Canadian,Attorney General,Mark Myles,DEM,90404,1,5,37,43,
Canadian,State Treasurer,Randy Mcdaniel,REP,90404,3,12,117,132,
Canadian,State Treasurer,Charles De Coune,IND,90404,1,3,30,34,
Canadian,Superintendent of Public Instruction,Joy Hofmeister,REP,90404,2,11,98,111,
Canadian,Superintendent of Public Instruction,John Cox,DEM,90404,2,4,41,47,
Canadian,Superintendent of Public Instruction,Larry Huff,IND,90404,0,1,12,13,
Canadian,Commissioner of Labor,Leslie Osborn,REP,90404,2,14,119,135,
Canadian,Commissioner of Labor,Fred Dorrell,DEM,90404,1,2,26,29,
Canadian,Commissioner of Labor,Brandt Dismukes,IND,90404,0,0,6,6,
Canadian,Insurance Commissioner,Glen Mulready,REP,90404,1,10,117,128,
Canadian,Insurance Commissioner,Kimberly Fobbs,DEM,90404,2,6,33,41,
Canadian,Corporation Commissioner,Bob Anthony,REP,90404,1,10,113,124,
Canadian,Corporation Commissioner,Ashley Nicole Mccray,DEM,90404,2,6,29,37,
Canadian,Corporation Commissioner,Jackie Short,IND,90404,0,0,8,8,
Canadian,U.S. House,Frank Lucas,REP,90404,3,10,121,134,3
Canadian,U.S. House,Frankie Robbins,DEM,90404,1,6,30,37,3
Canadian,Governor,Chris Powell,LIB,90406,1,2,5,8,
Canadian,Governor,Kevin Stitt,REP,90406,2,4,82,88,
Canadian,Governor,Drew Edmondson,DEM,90406,1,3,43,47,
Canadian,Lieutenant Governor,Matt Pinnell,REP,90406,4,4,95,103,
Canadian,Lieutenant Governor,Anastasia Pittman,DEM,90406,0,5,33,38,
Canadian,Lieutenant Governor,Ivan Holmes,IND,90406,0,0,2,2,
Canadian,State Auditor,John Yeutter,LIB,90406,0,4,27,31,
Canadian,State Auditor,Cindy Byrd,REP,90406,4,4,95,103,
Canadian,Attorney General,Mike Hunter,REP,90406,3,4,90,97,
Canadian,Attorney General,Mark Myles,DEM,90406,1,5,39,45,
Canadian,State Treasurer,Randy Mcdaniel,REP,90406,4,4,99,107,
Canadian,State Treasurer,Charles De Coune,IND,90406,0,5,21,26,
Canadian,Superintendent of Public Instruction,Joy Hofmeister,REP,90406,2,3,75,80,
Canadian,Superintendent of Public Instruction,John Cox,DEM,90406,2,5,41,48,
Canadian,Superintendent of Public Instruction,Larry Huff,IND,90406,0,1,13,14,
Canadian,Commissioner of Labor,Leslie Osborn,REP,90406,3,4,89,96,
Canadian,Commissioner of Labor,Fred Dorrell,DEM,90406,1,4,34,39,
Canadian,Commissioner of Labor,Brandt Dismukes,IND,90406,0,1,5,6,
Canadian,Insurance Commissioner,Glen Mulready,REP,90406,3,4,90,97,
Canadian,Insurance Commissioner,Kimberly Fobbs,DEM,90406,1,5,38,44,
Canadian,Corporation Commissioner,Bob Anthony,REP,90406,3,4,81,88,
Canadian,Corporation Commissioner,Ashley Nicole Mccray,DEM,90406,1,5,37,43,
Canadian,Corporation Commissioner,Jackie Short,IND,90406,0,0,10,10,
Canadian,U.S. House,Frank Lucas,REP,90406,4,4,97,105,3
Canadian,U.S. House,Frankie Robbins,DEM,90406,0,5,32,37,3
Canadian,Governor,Chris Powell,LIB,90408,0,0,18,18,
Canadian,Governor,Kevin Stitt,REP,90408,2,8,145,155,
Canadian,Governor,Drew Edmondson,DEM,90408,1,5,77,83,
Canadian,Lieutenant Governor,Matt Pinnell,REP,90408,2,8,164,174,
Canadian,Lieutenant Governor,Anastasia Pittman,DEM,90408,1,5,57,63,
Canadian,Lieutenant Governor,Ivan Holmes,IND,90408,0,0,19,19,
Canadian,State Auditor,John Yeutter,LIB,90408,1,1,43,45,
Canadian,State Auditor,Cindy Byrd,REP,90408,2,9,185,196,
Canadian,Attorney General,Mike Hunter,REP,90408,2,7,176,185,
Canadian,Attorney General,Mark Myles,DEM,90408,1,6,61,68,
Canadian,State Treasurer,Randy Mcdaniel,REP,90408,2,8,186,196,
Canadian,State Treasurer,Charles De Coune,IND,90408,1,3,46,50,
Canadian,Superintendent of Public Instruction,Joy Hofmeister,REP,90408,2,6,156,164,
Canadian,Superintendent of Public Instruction,John Cox,DEM,90408,1,5,57,63,
Canadian,Superintendent of Public Instruction,Larry Huff,IND,90408,0,2,25,27,
Canadian,Commissioner of Labor,Leslie Osborn,REP,90408,2,8,169,179,
Canadian,Commissioner of Labor,Fred Dorrell,DEM,90408,1,5,46,52,
Canadian,Commissioner of Labor,Brandt Dismukes,IND,90408,0,0,18,18,
Canadian,Insurance Commissioner,Glen Mulready,REP,90408,2,8,166,176,
Canadian,Insurance Commissioner,Kimberly Fobbs,DEM,90408,1,5,70,76,
Canadian,Corporation Commissioner,Bob Anthony,REP,90408,2,7,150,159,
Canadian,Corporation Commissioner,Ashley Nicole Mccray,DEM,90408,1,6,58,65,
Canadian,Corporation Commissioner,Jackie Short,IND,90408,0,0,28,28,
Canadian,U.S. House,Frank Lucas,REP,90408,2,8,183,193,3
Canadian,U.S. House,Frankie Robbins,DEM,90408,1,5,54,60,3
Canadian,Governor,Chris Powell,LIB,90409,0,0,1,1,
Canadian,Governor,Kevin Stitt,REP,90409,2,2,25,29,
Canadian,Governor,Drew Edmondson,DEM,90409,1,0,7,8,
Canadian,Lieutenant Governor,Matt Pinnell,REP,90409,2,2,29,33,
Canadian,Lieutenant Governor,Anastasia Pittman,DEM,90409,1,0,4,5,
Canadian,Lieutenant Governor,Ivan Holmes,IND,90409,0,0,0,0,
Canadian,State Auditor,John Yeutter,LIB,90409,0,0,2,2,
Canadian,State Auditor,Cindy Byrd,REP,90409,3,2,31,36,
Canadian,Attorney General,Mike Hunter,REP,90409,3,2,29,34,
Canadian,Attorney General,Mark Myles,DEM,90409,0,0,3,3,
Canadian,State Treasurer,Randy Mcdaniel,REP,90409,3,2,31,36,
Canadian,State Treasurer,Charles De Coune,IND,90409,0,0,2,2,
Canadian,Superintendent of Public Instruction,Joy Hofmeister,REP,90409,3,2,27,32,
Canadian,Superintendent of Public Instruction,John Cox,DEM,90409,0,0,4,4,
Canadian,Superintendent of Public Instruction,Larry Huff,IND,90409,0,0,1,1,
Canadian,Commissioner of Labor,Leslie Osborn,REP,90409,3,2,29,34,
Canadian,Commissioner of Labor,Fred Dorrell,DEM,90409,0,0,2,2,
Canadian,Commissioner of Labor,Brandt Dismukes,IND,90409,0,0,2,2,
Canadian,Insurance Commissioner,Glen Mulready,REP,90409,2,2,29,33,
Canadian,Insurance Commissioner,Kimberly Fobbs,DEM,90409,1,0,3,4,
Canadian,Corporation Commissioner,Bob Anthony,REP,90409,2,2,26,30,
Canadian,Corporation Commissioner,Ashley Nicole Mccray,DEM,90409,1,0,5,6,
Canadian,Corporation Commissioner,Jackie Short,IND,90409,0,0,2,2,
Canadian,U.S. House,Frank Lucas,REP,90409,3,2,30,35,3
Canadian,U.S. House,Frankie Robbins,DEM,90409,0,0,3,3,3
Canadian,Governor,Chris Powell,LIB,90502,0,0,4,4,
Canadian,Governor,Kevin Stitt,REP,90502,2,5,121,128,
Canadian,Governor,Drew Edmondson,DEM,90502,2,2,50,54,
Canadian,Lieutenant Governor,Matt Pinnell,REP,90502,2,7,141,150,
Canadian,Lieutenant Governor,Anastasia Pittman,DEM,90502,2,0,29,31,
Canadian,Lieutenant Governor,Ivan Holmes,IND,90502,0,0,5,5,
Canadian,State Auditor,John Yeutter,LIB,90502,0,0,31,31,
Canadian,State Auditor,Cindy Byrd,REP,90502,4,7,140,151,
Canadian,Attorney General,Mike Hunter,REP,90502,2,7,137,146,
Canadian,Attorney General,Mark Myles,DEM,90502,2,0,37,39,
Canadian,State Treasurer,Randy Mcdaniel,REP,90502,4,7,146,157,
Canadian,State Treasurer,Charles De Coune,IND,90502,0,0,25,25,
Canadian,Superintendent of Public Instruction,Joy Hofmeister,REP,90502,2,6,123,131,
Canadian,Superintendent of Public Instruction,John Cox,DEM,90502,2,0,33,35,
Canadian,Superintendent of Public Instruction,Larry Huff,IND,90502,0,1,17,18,
Canadian,Commissioner of Labor,Leslie Osborn,REP,90502,4,7,134,145,
Canadian,Commissioner of Labor,Fred Dorrell,DEM,90502,0,0,33,33,
Canadian,Commissioner of Labor,Brandt Dismukes,IND,90502,0,0,5,5,
Canadian,Insurance Commissioner,Glen Mulready,REP,90502,2,7,141,150,
Canadian,Insurance Commissioner,Kimberly Fobbs,DEM,90502,2,0,31,33,
Canadian,Corporation Commissioner,Bob Anthony,REP,90502,4,5,123,132,
Canadian,Corporation Commissioner,Ashley Nicole Mccray,DEM,90502,0,1,41,42,
Canadian,Corporation Commissioner,Jackie Short,IND,90502,0,1,9,10,
Canadian,U.S. House,Frank Lucas,REP,90502,4,7,143,154,3
Canadian,U.S. House,Frankie Robbins,DEM,90502,0,0,29,29,3
Canadian,Governor,Chris Powell,LIB,90503,3,0,12,15,
Canadian,Governor,Kevin Stitt,REP,90503,13,8,212,233,
Canadian,Governor,Drew Edmondson,DEM,90503,1,0,74,75,
Canadian,Lieutenant Governor,Matt Pinnell,REP,90503,13,8,236,257,
Canadian,Lieutenant Governor,Anastasia Pittman,DEM,90503,1,0,48,49,
Canadian,Lieutenant Governor,Ivan Holmes,IND,90503,3,0,14,17,
Canadian,State Auditor,John Yeutter,LIB,90503,4,0,40,44,
Canadian,State Auditor,Cindy Byrd,REP,90503,13,8,244,265,
Canadian,Attorney General,Mike Hunter,REP,90503,13,8,241,262,
Canadian,Attorney General,Mark Myles,DEM,90503,3,0,56,59,
Canadian,State Treasurer,Randy Mcdaniel,REP,90503,15,8,241,264,
Canadian,State Treasurer,Charles De Coune,IND,90503,1,0,43,44,
Canadian,Superintendent of Public Instruction,Joy Hofmeister,REP,90503,10,8,223,241,
Canadian,Superintendent of Public Instruction,John Cox,DEM,90503,2,0,39,41,
Canadian,Superintendent of Public Instruction,Larry Huff,IND,90503,4,0,35,39,
Canadian,Commissioner of Labor,Leslie Osborn,REP,90503,13,8,238,259,
Canadian,Commissioner of Labor,Fred Dorrell,DEM,90503,2,0,44,46,
Canadian,Commissioner of Labor,Brandt Dismukes,IND,90503,2,0,12,14,
Canadian,Insurance Commissioner,Glen Mulready,REP,90503,13,8,238,259,
Canadian,Insurance Commissioner,Kimberly Fobbs,DEM,90503,3,0,55,58,
Canadian,Corporation Commissioner,Bob Anthony,REP,90503,14,8,232,254,
Canadian,Corporation Commissioner,Ashley Nicole Mccray,DEM,90503,1,0,43,44,
Canadian,Corporation Commissioner,Jackie Short,IND,90503,1,0,20,21,
Canadian,U.S. House,Frank Lucas,REP,90503,15,8,249,272,3
Canadian,U.S. House,Frankie Robbins,DEM,90503,1,0,47,48,3
Canadian,State Senate,Stephanie Bice,REP,90503,16,8,246,270,22
Canadian,State Senate,William Andrews,DEM,90503,0,0,51,51,22
Canadian,Governor,Chris Powell,LIB,90504,4,1,47,52,
Canadian,Governor,Kevin Stitt,REP,90504,53,29,1055,1137,
Canadian,Governor,Drew Edmondson,DEM,90504,30,15,532,577,
Canadian,Lieutenant Governor,Matt Pinnell,REP,90504,61,33,1202,1296,
Canadian,Lieutenant Governor,Anastasia Pittman,DEM,90504,23,11,356,390,
Canadian,Lieutenant Governor,Ivan Holmes,IND,90504,3,1,62,66,
Canadian,State Auditor,John Yeutter,LIB,90504,14,11,251,276,
Canadian,State Auditor,Cindy Byrd,REP,90504,69,33,1303,1405,
Canadian,Attorney General,Mike Hunter,REP,90504,58,34,1265,1357,
Canadian,Attorney General,Mark Myles,DEM,90504,28,11,351,390,
Canadian,State Treasurer,Randy Mcdaniel,REP,90504,70,34,1254,1358,
Canadian,State Treasurer,Charles De Coune,IND,90504,15,10,297,322,
Canadian,Superintendent of Public Instruction,Joy Hofmeister,REP,90504,61,37,1138,1236,
Canadian,Superintendent of Public Instruction,John Cox,DEM,90504,20,6,316,342,
Canadian,Superintendent of Public Instruction,Larry Huff,IND,90504,5,2,161,168,
Canadian,Commissioner of Labor,Leslie Osborn,REP,90504,68,33,1199,1300,
Canadian,Commissioner of Labor,Fred Dorrell,DEM,90504,17,10,314,341,
Canadian,Commissioner of Labor,Brandt Dismukes,IND,90504,1,1,79,81,
Canadian,Insurance Commissioner,Glen Mulready,REP,90504,62,33,1198,1293,
Canadian,Insurance Commissioner,Kimberly Fobbs,DEM,90504,24,11,392,427,
Canadian,Corporation Commissioner,Bob Anthony,REP,90504,61,35,1157,1253,
Canadian,Corporation Commissioner,Ashley Nicole Mccray,DEM,90504,22,9,337,368,
Canadian,Corporation Commissioner,Jackie Short,IND,90504,5,0,104,109,
Canadian,U.S. House,Frank Lucas,REP,90504,66,34,1254,1354,3
Canadian,U.S. House,Frankie Robbins,DEM,90504,23,11,355,389,3
Canadian,State Senate,Stephanie Bice,REP,90504,62,34,1256,1352,22
Canadian,State Senate,William Andrews,DEM,90504,26,10,353,389,22
Canadian,State House,Denise Crosswhite Hader,REP,90504,57,31,1178,1266,41
Canadian,State House,Jennie Scott,DEM,90504,30,14,436,480,41
Canadian,Governor,Chris Powell,LIB,90506,8,2,60,70,
Canadian,Governor,Kevin Stitt,REP,90506,140,57,1298,1495,
Canadian,Governor,Drew Edmondson,DEM,90506,95,29,779,903,
Canadian,Lieutenant Governor,Matt Pinnell,REP,90506,159,68,1544,1771,
Canadian,Lieutenant Governor,Anastasia Pittman,DEM,90506,76,19,506,601,
Canadian,Lieutenant Governor,Ivan Holmes,IND,90506,8,1,62,71,
Canadian,State Auditor,John Yeutter,LIB,90506,51,20,396,467,
Canadian,State Auditor,Cindy Byrd,REP,90506,181,64,1614,1859,
Canadian,Attorney General,Mike Hunter,REP,90506,163,67,1562,1792,
Canadian,Attorney General,Mark Myles,DEM,90506,78,21,530,629,
Canadian,State Treasurer,Randy Mcdaniel,REP,90506,162,68,1554,1784,
Canadian,State Treasurer,Charles De Coune,IND,90506,65,15,433,513,
Canadian,Superintendent of Public Instruction,Joy Hofmeister,REP,90506,163,66,1444,1673,
Canadian,Superintendent of Public Instruction,John Cox,DEM,90506,65,19,467,551,
Canadian,Superintendent of Public Instruction,Larry Huff,IND,90506,13,3,185,201,
Canadian,Commissioner of Labor,Leslie Osborn,REP,90506,169,68,1535,1772,
Canadian,Commissioner of Labor,Fred Dorrell,DEM,90506,64,17,433,514,
Canadian,Commissioner of Labor,Brandt Dismukes,IND,90506,9,2,90,101,
Canadian,Insurance Commissioner,Glen Mulready,REP,90506,155,66,1487,1708,
Canadian,Insurance Commissioner,Kimberly Fobbs,DEM,90506,83,19,565,667,
Canadian,Corporation Commissioner,Bob Anthony,REP,90506,153,63,1413,1629,
Canadian,Corporation Commissioner,Ashley Nicole Mccray,DEM,90506,78,19,507,604,
Canadian,Corporation Commissioner,Jackie Short,IND,90506,11,6,146,163,
Canadian,U.S. House,Frank Lucas,REP,90506,162,68,1591,1821,3
Canadian,U.S. House,Frankie Robbins,DEM,90506,79,20,507,606,3
Canadian,State Senate,Stephanie Bice,REP,90506,172,69,1574,1815,22
Canadian,State Senate,William Andrews,DEM,90506,70,19,506,595,22
Canadian,State House,Denise Crosswhite Hader,REP,90506,146,64,1476,1686,41
Canadian,State House,Jennie Scott,DEM,90506,94,24,619,737,41
Carter,Governor,Chris Powell,LIB,100001,1,4,26,31,
Carter,Governor,Kevin Stitt,REP,100001,8,30,214,252,
Carter,Governor,Drew Edmondson,DEM,100001,14,42,208,264,
Carter,Lieutenant Governor,Matt Pinnell,REP,100001,10,34,238,282,
Carter,Lieutenant Governor,Anastasia Pittman,DEM,100001,13,37,189,239,
Carter,Lieutenant Governor,Ivan Holmes,IND,100001,0,5,17,22,
Carter,State Auditor,John Yeutter,LIB,100001,7,19,124,150,
Carter,State Auditor,Cindy Byrd,REP,100001,12,42,270,324,
Carter,Attorney General,Mike Hunter,REP,100001,9,39,254,302,
Carter,Attorney General,Mark Myles,DEM,100001,14,37,190,241,
Carter,State Treasurer,Randy Mcdaniel,REP,100001,9,37,262,308,
Carter,State Treasurer,Charles De Coune,IND,100001,10,25,132,167,
Carter,Superintendent of Public Instruction,Joy Hofmeister,REP,100001,7,30,231,268,
Carter,Superintendent of Public Instruction,John Cox,DEM,100001,14,36,178,228,
Carter,Superintendent of Public Instruction,Larry Huff,IND,100001,2,10,35,47,
Carter,Commissioner of Labor,Leslie Osborn,REP,100001,10,37,241,288,
Carter,Commissioner of Labor,Fred Dorrell,DEM,100001,12,38,177,227,
Carter,Commissioner of Labor,Brandt Dismukes,IND,100001,1,1,24,26,
Carter,Insurance Commissioner,Glen Mulready,REP,100001,8,33,237,278,
Carter,Insurance Commissioner,Kimberly Fobbs,DEM,100001,14,43,206,263,
Carter,Corporation Commissioner,Bob Anthony,REP,100001,10,35,230,275,
Carter,Corporation Commissioner,Ashley Nicole Mccray,DEM,100001,12,35,185,232,
Carter,Corporation Commissioner,Jackie Short,IND,100001,0,6,28,34,
Carter,U.S. House,Tom Cole,REP,100001,10,39,246,295,4
Carter,U.S. House,Mary Brannon,DEM,100001,12,35,175,222,4
Carter,U.S. House,Ruby Peters,IND,100001,1,2,22,25,4
Carter,State Senate,Frank Simpson,REP,100001,10,40,239,289,14
Carter,State Senate,Justin Arledge,DEM,100001,13,36,206,255,14
Carter,State House,Tammy Townley,REP,100001,9,37,221,267,48
Carter,State House,Cheryl Key,DEM,100001,13,38,223,274,48
Carter,Governor,Chris Powell,LIB,100002,1,4,22,27,
Carter,Governor,Kevin Stitt,REP,100002,14,54,322,390,
Carter,Governor,Drew Edmondson,DEM,100002,22,40,224,286,
Carter,Lieutenant Governor,Matt Pinnell,REP,100002,16,61,349,426,
Carter,Lieutenant Governor,Anastasia Pittman,DEM,100002,19,31,191,241,
Carter,Lieutenant Governor,Ivan Holmes,IND,100002,4,5,21,30,
Carter,State Auditor,John Yeutter,LIB,100002,7,20,132,159,
Carter,State Auditor,Cindy Byrd,REP,100002,20,68,382,470,
Carter,Attorney General,Mike Hunter,REP,100002,18,62,359,439,
Carter,Attorney General,Mark Myles,DEM,100002,20,35,204,259,
Carter,State Treasurer,Randy Mcdaniel,REP,100002,18,68,373,459,
Carter,State Treasurer,Charles De Coune,IND,100002,8,23,136,167,
Carter,Superintendent of Public Instruction,Joy Hofmeister,REP,100002,11,58,321,390,
Carter,Superintendent of Public Instruction,John Cox,DEM,100002,27,33,196,256,
Carter,Superintendent of Public Instruction,Larry Huff,IND,100002,1,6,46,53,
Carter,Commissioner of Labor,Leslie Osborn,REP,100002,16,60,337,413,
Carter,Commissioner of Labor,Fred Dorrell,DEM,100002,19,29,194,242,
Carter,Commissioner of Labor,Brandt Dismukes,IND,100002,3,6,26,35,
Carter,Insurance Commissioner,Glen Mulready,REP,100002,16,63,339,418,
Carter,Insurance Commissioner,Kimberly Fobbs,DEM,100002,20,32,213,265,
Carter,Corporation Commissioner,Bob Anthony,REP,100002,19,59,334,412,
Carter,Corporation Commissioner,Ashley Nicole Mccray,DEM,100002,18,34,191,243,
Carter,Corporation Commissioner,Jackie Short,IND,100002,2,3,32,37,
Carter,U.S. House,Tom Cole,REP,100002,20,61,364,445,4
Carter,U.S. House,Mary Brannon,DEM,100002,17,33,182,232,4
Carter,U.S. House,Ruby Peters,IND,100002,2,4,21,27,4
Carter,State Senate,Frank Simpson,REP,100002,18,64,349,431,14
Carter,State Senate,Justin Arledge,DEM,100002,20,34,219,273,14
Carter,State House,Tammy Townley,REP,100002,14,54,319,387,48
Carter,State House,Cheryl Key,DEM,100002,24,44,248,316,48
Carter,Governor,Chris Powell,LIB,100007,0,0,7,7,
Carter,Governor,Kevin Stitt,REP,100007,0,7,52,59,
Carter,Governor,Drew Edmondson,DEM,100007,17,48,288,353,
Carter,Lieutenant Governor,Matt Pinnell,REP,100007,0,9,49,58,
Carter,Lieutenant Governor,Anastasia Pittman,DEM,100007,16,46,290,352,
Carter,Lieutenant Governor,Ivan Holmes,IND,100007,0,0,6,6,
Carter,State Auditor,John Yeutter,LIB,100007,10,24,106,140,
Carter,State Auditor,Cindy Byrd,REP,100007,1,15,69,85,
Carter,Attorney General,Mike Hunter,REP,100007,0,9,54,63,
Carter,Attorney General,Mark Myles,DEM,100007,17,46,290,353,
Carter,State Treasurer,Randy Mcdaniel,REP,100007,0,14,65,79,
Carter,State Treasurer,Charles De Coune,IND,100007,12,25,109,146,
Carter,Superintendent of Public Instruction,Joy Hofmeister,REP,100007,0,9,55,64,
Carter,Superintendent of Public Instruction,John Cox,DEM,100007,15,43,275,333,
Carter,Superintendent of Public Instruction,Larry Huff,IND,100007,1,2,14,17,
Carter,Commissioner of Labor,Leslie Osborn,REP,100007,0,9,58,67,
Carter,Commissioner of Labor,Fred Dorrell,DEM,100007,15,44,282,341,
Carter,Commissioner of Labor,Brandt Dismukes,IND,100007,2,1,4,7,
Carter,Insurance Commissioner,Glen Mulready,REP,100007,0,9,55,64,
Carter,Insurance Commissioner,Kimberly Fobbs,DEM,100007,17,46,289,352,
Carter,Corporation Commissioner,Bob Anthony,REP,100007,0,8,52,60,
Carter,Corporation Commissioner,Ashley Nicole Mccray,DEM,100007,17,45,284,346,
Carter,Corporation Commissioner,Jackie Short,IND,100007,0,2,8,10,
Carter,U.S. House,Tom Cole,REP,100007,0,10,59,69,4
Carter,U.S. House,Mary Brannon,DEM,100007,16,43,274,333,4
Carter,U.S. House,Ruby Peters,IND,100007,1,2,12,15,4
Carter,State Senate,Frank Simpson,REP,100007,0,10,58,68,14
Carter,State Senate,Justin Arledge,DEM,100007,17,45,287,349,14
Carter,State House,Tammy Townley,REP,100007,0,7,50,57,48
Carter,State House,Cheryl Key,DEM,100007,17,48,297,362,48
Carter,Governor,Chris Powell,LIB,100011,0,2,18,20,
Carter,Governor,Kevin Stitt,REP,100011,5,30,152,187,
Carter,Governor,Drew Edmondson,DEM,100011,7,38,125,170,
Carter,Lieutenant Governor,Matt Pinnell,REP,100011,6,35,166,207,
Carter,Lieutenant Governor,Anastasia Pittman,DEM,100011,5,34,113,152,
Carter,Lieutenant Governor,Ivan Holmes,IND,100011,1,0,15,16,
Carter,State Auditor,John Yeutter,LIB,100011,2,22,83,107,
Carter,State Auditor,Cindy Byrd,REP,100011,7,40,185,232,
Carter,Attorney General,Mike Hunter,REP,100011,6,32,171,209,
Carter,Attorney General,Mark Myles,DEM,100011,6,37,121,164,
Carter,State Treasurer,Randy Mcdaniel,REP,100011,6,35,184,225,
Carter,State Treasurer,Charles De Coune,IND,100011,4,27,84,115,
Carter,Superintendent of Public Instruction,Joy Hofmeister,REP,100011,6,33,161,200,
Carter,Superintendent of Public Instruction,John Cox,DEM,100011,5,35,107,147,
Carter,Superintendent of Public Instruction,Larry Huff,IND,100011,1,2,24,27,
Carter,Commissioner of Labor,Leslie Osborn,REP,100011,6,35,162,203,
Carter,Commissioner of Labor,Fred Dorrell,DEM,100011,6,32,108,146,
Carter,Commissioner of Labor,Brandt Dismukes,IND,100011,0,2,20,22,
Carter,Insurance Commissioner,Glen Mulready,REP,100011,6,32,165,203,
Carter,Insurance Commissioner,Kimberly Fobbs,DEM,100011,6,37,124,167,
Carter,Corporation Commissioner,Bob Anthony,REP,100011,6,35,157,198,
Carter,Corporation Commissioner,Ashley Nicole Mccray,DEM,100011,5,33,115,153,
Carter,Corporation Commissioner,Jackie Short,IND,100011,1,2,18,21,
Carter,U.S. House,Tom Cole,REP,100011,7,33,171,211,4
Carter,U.S. House,Mary Brannon,DEM,100011,5,36,105,146,4
Carter,U.S. House,Ruby Peters,IND,100011,0,1,18,19,4
Carter,State Senate,Frank Simpson,REP,100011,6,30,163,199,14
Carter,State Senate,Justin Arledge,DEM,100011,6,40,131,177,14
Carter,State House,Tammy Townley,REP,100011,5,31,154,190,48
Carter,State House,Cheryl Key,DEM,100011,7,39,140,186,48
Carter,Governor,Chris Powell,LIB,100014,0,0,12,12,
Carter,Governor,Kevin Stitt,REP,100014,10,45,166,221,
Carter,Governor,Drew Edmondson,DEM,100014,3,19,105,127,
Carter,Lieutenant Governor,Matt Pinnell,REP,100014,9,48,173,230,
Carter,Lieutenant Governor,Anastasia Pittman,DEM,100014,3,15,95,113,
Carter,Lieutenant Governor,Ivan Holmes,IND,100014,1,0,13,14,
Carter,State Auditor,John Yeutter,LIB,100014,2,9,72,83,
Carter,State Auditor,Cindy Byrd,REP,100014,9,51,194,254,
Carter,Attorney General,Mike Hunter,REP,100014,10,48,179,237,
Carter,Attorney General,Mark Myles,DEM,100014,3,16,101,120,
Carter,State Treasurer,Randy Mcdaniel,REP,100014,9,50,191,250,
Carter,State Treasurer,Charles De Coune,IND,100014,2,11,74,87,
Carter,Superintendent of Public Instruction,Joy Hofmeister,REP,100014,9,48,161,218,
Carter,Superintendent of Public Instruction,John Cox,DEM,100014,3,16,98,117,
Carter,Superintendent of Public Instruction,Larry Huff,IND,100014,0,0,23,23,
Carter,Commissioner of Labor,Leslie Osborn,REP,100014,9,45,172,226,
Carter,Commissioner of Labor,Fred Dorrell,DEM,100014,3,19,96,118,
Carter,Commissioner of Labor,Brandt Dismukes,IND,100014,0,0,12,12,
Carter,Insurance Commissioner,Glen Mulready,REP,100014,9,47,173,229,
Carter,Insurance Commissioner,Kimberly Fobbs,DEM,100014,3,17,108,128,
Carter,Corporation Commissioner,Bob Anthony,REP,100014,9,48,169,226,
Carter,Corporation Commissioner,Ashley Nicole Mccray,DEM,100014,3,16,94,113,
Carter,Corporation Commissioner,Jackie Short,IND,100014,0,0,17,17,
Carter,U.S. House,Tom Cole,REP,100014,9,48,179,236,4
Carter,U.S. House,Mary Brannon,DEM,100014,3,15,85,103,4
Carter,U.S. House,Ruby Peters,IND,100014,1,1,17,19,4
Carter,State Senate,Frank Simpson,REP,100014,10,47,173,230,14
Carter,State Senate,Justin Arledge,DEM,100014,3,17,108,128,14
Carter,State House,Tammy Townley,REP,100014,9,46,162,217,48
Carter,State House,Cheryl Key,DEM,100014,3,18,119,140,48
Carter,Governor,Chris Powell,LIB,100015,0,3,30,33,
Carter,Governor,Kevin Stitt,REP,100015,14,74,335,423,
Carter,Governor,Drew Edmondson,DEM,100015,17,57,187,261,
Carter,Lieutenant Governor,Matt Pinnell,REP,100015,14,81,360,455,
Carter,Lieutenant Governor,Anastasia Pittman,DEM,100015,16,52,168,236,
Carter,Lieutenant Governor,Ivan Holmes,IND,100015,1,1,21,23,
Carter,State Auditor,John Yeutter,LIB,100015,10,27,121,158,
Carter,State Auditor,Cindy Byrd,REP,100015,15,90,387,492,
Carter,Attorney General,Mike Hunter,REP,100015,14,78,371,463,
Carter,Attorney General,Mark Myles,DEM,100015,17,56,175,248,
Carter,State Treasurer,Randy Mcdaniel,REP,100015,16,85,383,484,
Carter,State Treasurer,Charles De Coune,IND,100015,8,33,122,163,
Carter,Superintendent of Public Instruction,Joy Hofmeister,REP,100015,11,81,344,436,
Carter,Superintendent of Public Instruction,John Cox,DEM,100015,19,48,159,226,
Carter,Superintendent of Public Instruction,Larry Huff,IND,100015,1,5,39,45,
Carter,Commissioner of Labor,Leslie Osborn,REP,100015,13,75,355,443,
Carter,Commissioner of Labor,Fred Dorrell,DEM,100015,17,54,149,220,
Carter,Commissioner of Labor,Brandt Dismukes,IND,100015,1,4,36,41,
Carter,Insurance Commissioner,Glen Mulready,REP,100015,14,78,351,443,
Carter,Insurance Commissioner,Kimberly Fobbs,DEM,100015,17,55,194,266,
Carter,Corporation Commissioner,Bob Anthony,REP,100015,14,72,346,432,
Carter,Corporation Commissioner,Ashley Nicole Mccray,DEM,100015,17,56,165,238,
Carter,Corporation Commissioner,Jackie Short,IND,100015,0,5,33,38,
Carter,U.S. House,Tom Cole,REP,100015,15,73,366,454,4
Carter,U.S. House,Mary Brannon,DEM,100015,16,54,160,230,4
Carter,U.S. House,Ruby Peters,IND,100015,0,6,23,29,4
Carter,State Senate,Frank Simpson,REP,100015,13,77,350,440,14
Carter,State Senate,Justin Arledge,DEM,100015,18,56,195,269,14
Carter,State House,Tammy Townley,REP,100015,13,73,337,423,48
Carter,State House,Cheryl Key,DEM,100015,18,61,209,288,48
Carter,Governor,Chris Powell,LIB,100017,0,2,10,12,
Carter,Governor,Kevin Stitt,REP,100017,9,62,315,386,
Carter,Governor,Drew Edmondson,DEM,100017,4,25,162,191,
Carter,Lieutenant Governor,Matt Pinnell,REP,100017,10,65,332,407,
Carter,Lieutenant Governor,Anastasia Pittman,DEM,100017,3,22,143,168,
Carter,Lieutenant Governor,Ivan Holmes,IND,100017,0,2,12,14,
Carter,State Auditor,John Yeutter,LIB,100017,2,13,88,103,
Carter,State Auditor,Cindy Byrd,REP,100017,10,71,361,442,
Carter,Attorney General,Mike Hunter,REP,100017,10,68,339,417,
Carter,Attorney General,Mark Myles,DEM,100017,3,21,146,170,
Carter,State Treasurer,Randy Mcdaniel,REP,100017,10,69,350,429,
Carter,State Treasurer,Charles De Coune,IND,100017,2,17,95,114,
Carter,Superintendent of Public Instruction,Joy Hofmeister,REP,100017,10,66,314,390,
Carter,Superintendent of Public Instruction,John Cox,DEM,100017,2,20,142,164,
Carter,Superintendent of Public Instruction,Larry Huff,IND,100017,1,3,27,31,
Carter,Commissioner of Labor,Leslie Osborn,REP,100017,10,66,318,394,
Carter,Commissioner of Labor,Fred Dorrell,DEM,100017,2,20,148,170,
Carter,Commissioner of Labor,Brandt Dismukes,IND,100017,1,3,14,18,
Carter,Insurance Commissioner,Glen Mulready,REP,100017,10,68,327,405,
Carter,Insurance Commissioner,Kimberly Fobbs,DEM,100017,3,20,154,177,
Carter,Corporation Commissioner,Bob Anthony,REP,100017,10,65,330,405,
Carter,Corporation Commissioner,Ashley Nicole Mccray,DEM,100017,3,21,138,162,
Carter,Corporation Commissioner,Jackie Short,IND,100017,0,3,13,16,
Carter,U.S. House,Tom Cole,REP,100017,10,69,337,416,4
Carter,U.S. House,Mary Brannon,DEM,100017,3,18,134,155,4
Carter,U.S. House,Ruby Peters,IND,100017,0,2,13,15,4
Carter,State Senate,Frank Simpson,REP,100017,10,70,329,409,14
Carter,State Senate,Justin Arledge,DEM,100017,3,18,161,182,14
Carter,State House,Tammy Townley,REP,100017,9,66,312,387,48
Carter,State House,Cheryl Key,DEM,100017,4,23,177,204,48
Carter,Governor,Chris Powell,LIB,100019,0,11,26,37,
Carter,Governor,Kevin Stitt,REP,100019,52,241,871,1164,
Carter,Governor,Drew Edmondson,DEM,100019,25,122,281,428,
Carter,Lieutenant Governor,Matt Pinnell,REP,100019,52,271,920,1243,
Carter,Lieutenant Governor,Anastasia Pittman,DEM,100019,23,95,222,340,
Carter,Lieutenant Governor,Ivan Holmes,IND,100019,2,5,27,34,
Carter,State Auditor,John Yeutter,LIB,100019,15,56,148,219,
Carter,State Auditor,Cindy Byrd,REP,100019,56,288,969,1313,
Carter,Attorney General,Mike Hunter,REP,100019,54,272,923,1249,
Carter,Attorney General,Mark Myles,DEM,100019,23,100,239,362,
Carter,State Treasurer,Randy Mcdaniel,REP,100019,53,285,956,1294,
Carter,State Treasurer,Charles De Coune,IND,100019,19,58,159,236,
Carter,Superintendent of Public Instruction,Joy Hofmeister,REP,100019,44,249,886,1179,
Carter,Superintendent of Public Instruction,John Cox,DEM,100019,22,103,225,350,
Carter,Superintendent of Public Instruction,Larry Huff,IND,100019,10,19,54,83,
Carter,Commissioner of Labor,Leslie Osborn,REP,100019,47,257,904,1208,
Carter,Commissioner of Labor,Fred Dorrell,DEM,100019,23,102,221,346,
Carter,Commissioner of Labor,Brandt Dismukes,IND,100019,5,7,27,39,
Carter,Insurance Commissioner,Glen Mulready,REP,100019,51,255,888,1194,
Carter,Insurance Commissioner,Kimberly Fobbs,DEM,100019,25,109,264,398,
Carter,Corporation Commissioner,Bob Anthony,REP,100019,49,257,889,1195,
Carter,Corporation Commissioner,Ashley Nicole Mccray,DEM,100019,20,96,227,343,
Carter,Corporation Commissioner,Jackie Short,IND,100019,7,13,40,60,
Carter,U.S. House,Tom Cole,REP,100019,53,272,934,1259,4
Carter,U.S. House,Mary Brannon,DEM,100019,21,92,214,327,4
Carter,U.S. House,Ruby Peters,IND,100019,3,7,25,35,4
Carter,State Senate,Frank Simpson,REP,100019,51,264,889,1204,14
Carter,State Senate,Justin Arledge,DEM,100019,25,109,280,414,14
Carter,State House,Tammy Townley,REP,100019,51,230,823,1104,48
Carter,State House,Cheryl Key,DEM,100019,25,142,347,514,48
Carter,Governor,Chris Powell,LIB,100020,0,3,20,23,
Carter,Governor,Kevin Stitt,REP,100020,7,35,329,371,
Carter,Governor,Drew Edmondson,DEM,100020,9,30,232,271,
Carter,Lieutenant Governor,Matt Pinnell,REP,100020,7,36,357,400,
Carter,Lieutenant Governor,Anastasia Pittman,DEM,100020,9,30,199,238,
Carter,Lieutenant Governor,Ivan Holmes,IND,100020,0,0,21,21,
Carter,State Auditor,John Yeutter,LIB,100020,5,15,135,155,
Carter,State Auditor,Cindy Byrd,REP,100020,10,41,396,447,
Carter,Attorney General,Mike Hunter,REP,100020,7,38,361,406,
Carter,Attorney General,Mark Myles,DEM,100020,9,28,212,249,
Carter,State Treasurer,Randy Mcdaniel,REP,100020,9,38,387,434,
Carter,State Treasurer,Charles De Coune,IND,100020,6,21,144,171,
Carter,Superintendent of Public Instruction,Joy Hofmeister,REP,100020,8,33,338,379,
Carter,Superintendent of Public Instruction,John Cox,DEM,100020,8,29,204,241,
Carter,Superintendent of Public Instruction,Larry Huff,IND,100020,0,4,37,41,
Carter,Commissioner of Labor,Leslie Osborn,REP,100020,8,34,343,385,
Carter,Commissioner of Labor,Fred Dorrell,DEM,100020,8,28,209,245,
Carter,Commissioner of Labor,Brandt Dismukes,IND,100020,0,3,22,25,
Carter,Insurance Commissioner,Glen Mulready,REP,100020,7,33,348,388,
Carter,Insurance Commissioner,Kimberly Fobbs,DEM,100020,9,33,221,263,
Carter,Corporation Commissioner,Bob Anthony,REP,100020,8,33,342,383,
Carter,Corporation Commissioner,Ashley Nicole Mccray,DEM,100020,8,28,197,233,
Carter,Corporation Commissioner,Jackie Short,IND,100020,0,4,34,38,
Carter,U.S. House,Tom Cole,REP,100020,8,34,371,413,4
Carter,U.S. House,Mary Brannon,DEM,100020,8,30,185,223,4
Carter,U.S. House,Ruby Peters,IND,100020,0,2,22,24,4
Carter,State Senate,Frank Simpson,REP,100020,8,33,362,403,14
Carter,State Senate,Justin Arledge,DEM,100020,8,35,218,261,14
Carter,State House,Tammy Townley,REP,100020,7,33,331,371,48
Carter,State House,Cheryl Key,DEM,100020,9,34,249,292,48
Carter,Governor,Chris Powell,LIB,100024,0,1,23,24,
Carter,Governor,Kevin Stitt,REP,100024,10,106,490,606,
Carter,Governor,Drew Edmondson,DEM,100024,15,50,185,250,
Carter,Lieutenant Governor,Matt Pinnell,REP,100024,10,111,520,641,
Carter,Lieutenant Governor,Anastasia Pittman,DEM,100024,14,46,165,225,
Carter,Lieutenant Governor,Ivan Holmes,IND,100024,1,1,12,14,
Carter,State Auditor,John Yeutter,LIB,100024,10,15,103,128,
Carter,State Auditor,Cindy Byrd,REP,100024,12,128,546,686,
Carter,Attorney General,Mike Hunter,REP,100024,11,113,538,662,
Carter,Attorney General,Mark Myles,DEM,100024,14,42,154,210,
Carter,State Treasurer,Randy Mcdaniel,REP,100024,12,124,544,680,
Carter,State Treasurer,Charles De Coune,IND,100024,10,20,102,132,
Carter,Superintendent of Public Instruction,Joy Hofmeister,REP,100024,11,111,495,617,
Carter,Superintendent of Public Instruction,John Cox,DEM,100024,13,43,150,206,
Carter,Superintendent of Public Instruction,Larry Huff,IND,100024,1,3,47,51,
Carter,Commissioner of Labor,Leslie Osborn,REP,100024,11,110,524,645,
Carter,Commissioner of Labor,Fred Dorrell,DEM,100024,14,45,148,207,
Carter,Commissioner of Labor,Brandt Dismukes,IND,100024,0,2,20,22,
Carter,Insurance Commissioner,Glen Mulready,REP,100024,11,108,518,637,
Carter,Insurance Commissioner,Kimberly Fobbs,DEM,100024,14,49,169,232,
Carter,Corporation Commissioner,Bob Anthony,REP,100024,12,109,517,638,
Carter,Corporation Commissioner,Ashley Nicole Mccray,DEM,100024,12,41,156,209,
Carter,Corporation Commissioner,Jackie Short,IND,100024,1,7,21,29,
Carter,U.S. House,Tom Cole,REP,100024,11,118,539,668,4
Carter,U.S. House,Mary Brannon,DEM,100024,13,40,139,192,4
Carter,U.S. House,Ruby Peters,IND,100024,1,0,17,18,4
Carter,State Senate,Frank Simpson,REP,100024,13,112,520,645,14
Carter,State Senate,Justin Arledge,DEM,100024,12,46,173,231,14
Carter,State House,Tammy Townley,REP,100024,9,102,486,597,48
Carter,State House,Cheryl Key,DEM,100024,16,57,207,280,48
Carter,Governor,Chris Powell,LIB,100025,0,2,9,11,
Carter,Governor,Kevin Stitt,REP,100025,5,32,169,206,
Carter,Governor,Drew Edmondson,DEM,100025,3,6,67,76,
Carter,Lieutenant Governor,Matt Pinnell,REP,100025,7,33,192,232,
Carter,Lieutenant Governor,Anastasia Pittman,DEM,100025,0,5,50,55,
Carter,Lieutenant Governor,Ivan Holmes,IND,100025,0,2,1,3,
Carter,State Auditor,John Yeutter,LIB,100025,0,3,35,38,
Carter,State Auditor,Cindy Byrd,REP,100025,7,36,193,236,
Carter,Attorney General,Mike Hunter,REP,100025,7,34,194,235,
Carter,Attorney General,Mark Myles,DEM,100025,0,6,47,53,
Carter,State Treasurer,Randy Mcdaniel,REP,100025,7,36,202,245,
Carter,State Treasurer,Charles De Coune,IND,100025,0,3,28,31,
Carter,Superintendent of Public Instruction,Joy Hofmeister,REP,100025,8,30,172,210,
Carter,Superintendent of Public Instruction,John Cox,DEM,100025,0,6,54,60,
Carter,Superintendent of Public Instruction,Larry Huff,IND,100025,0,4,15,19,
Carter,Commissioner of Labor,Leslie Osborn,REP,100025,8,34,179,221,
Carter,Commissioner of Labor,Fred Dorrell,DEM,100025,0,5,53,58,
Carter,Commissioner of Labor,Brandt Dismukes,IND,100025,0,1,8,9,
Carter,Insurance Commissioner,Glen Mulready,REP,100025,7,35,179,221,
Carter,Insurance Commissioner,Kimberly Fobbs,DEM,100025,0,5,60,65,
Carter,Corporation Commissioner,Bob Anthony,REP,100025,7,33,176,216,
Carter,Corporation Commissioner,Ashley Nicole Mccray,DEM,100025,1,4,54,59,
Carter,Corporation Commissioner,Jackie Short,IND,100025,0,3,9,12,
Carter,U.S. House,Tom Cole,REP,100025,8,34,188,230,4
Carter,U.S. House,Mary Brannon,DEM,100025,0,5,50,55,4
Carter,U.S. House,Ruby Peters,IND,100025,0,1,3,4,4
Carter,State Senate,Frank Simpson,REP,100025,8,35,187,230,14
Carter,State Senate,Justin Arledge,DEM,100025,0,5,54,59,14
Carter,State House,Tommy Hardin,REP,100025,7,32,178,217,49
Carter,State House,Miranda Shelton,DEM,100025,1,8,62,71,49
Carter,Governor,Chris Powell,LIB,100026,0,0,5,5,
Carter,Governor,Kevin Stitt,REP,100026,2,18,118,138,
Carter,Governor,Drew Edmondson,DEM,100026,4,2,68,74,
Carter,Lieutenant Governor,Matt Pinnell,REP,100026,2,17,123,142,
Carter,Lieutenant Governor,Anastasia Pittman,DEM,100026,4,2,59,65,
Carter,Lieutenant Governor,Ivan Holmes,IND,100026,0,0,7,7,
Carter,State Auditor,John Yeutter,LIB,100026,2,3,36,41,
Carter,State Auditor,Cindy Byrd,REP,100026,2,16,137,155,
Carter,Attorney General,Mike Hunter,REP,100026,2,16,125,143,
Carter,Attorney General,Mark Myles,DEM,100026,4,3,64,71,
Carter,State Treasurer,Randy Mcdaniel,REP,100026,2,16,135,153,
Carter,State Treasurer,Charles De Coune,IND,100026,2,3,38,43,
Carter,Superintendent of Public Instruction,Joy Hofmeister,REP,100026,2,16,118,136,
Carter,Superintendent of Public Instruction,John Cox,DEM,100026,4,3,58,65,
Carter,Superintendent of Public Instruction,Larry Huff,IND,100026,0,0,14,14,
Carter,Commissioner of Labor,Leslie Osborn,REP,100026,1,16,117,134,
Carter,Commissioner of Labor,Fred Dorrell,DEM,100026,4,3,62,69,
Carter,Commissioner of Labor,Brandt Dismukes,IND,100026,0,0,9,9,
Carter,Insurance Commissioner,Glen Mulready,REP,100026,2,14,126,142,
Carter,Insurance Commissioner,Kimberly Fobbs,DEM,100026,4,5,62,71,
Carter,Corporation Commissioner,Bob Anthony,REP,100026,2,16,117,135,
Carter,Corporation Commissioner,Ashley Nicole Mccray,DEM,100026,4,1,66,71,
Carter,Corporation Commissioner,Jackie Short,IND,100026,0,3,7,10,
Carter,U.S. House,Tom Cole,REP,100026,2,17,128,147,4
Carter,U.S. House,Mary Brannon,DEM,100026,4,2,57,63,4
Carter,U.S. House,Ruby Peters,IND,100026,0,1,5,6,4
Carter,State Senate,Frank Simpson,REP,100026,1,15,133,149,14
Carter,State Senate,Justin Arledge,DEM,100026,5,5,57,67,14
Carter,State House,Tammy Townley,REP,100026,2,14,117,133,48
Carter,State House,Cheryl Key,DEM,100026,4,5,72,81,48
Carter,Governor,Chris Powell,LIB,100030,1,0,11,12,
Carter,Governor,Kevin Stitt,REP,100030,3,16,149,168,
Carter,Governor,Drew Edmondson,DEM,100030,1,1,49,51,
Carter,Lieutenant Governor,Matt Pinnell,REP,100030,4,16,158,178,
Carter,Lieutenant Governor,Anastasia Pittman,DEM,100030,1,1,41,43,
Carter,Lieutenant Governor,Ivan Holmes,IND,100030,0,0,10,10,
Carter,State Auditor,John Yeutter,LIB,100030,1,0,28,29,
Carter,State Auditor,Cindy Byrd,REP,100030,4,17,170,191,
Carter,Attorney General,Mike Hunter,REP,100030,3,16,166,185,
Carter,Attorney General,Mark Myles,DEM,100030,2,1,42,45,
Carter,State Treasurer,Randy Mcdaniel,REP,100030,4,17,178,199,
Carter,State Treasurer,Charles De Coune,IND,100030,1,0,18,19,
Carter,Superintendent of Public Instruction,Joy Hofmeister,REP,100030,1,16,140,157,
Carter,Superintendent of Public Instruction,John Cox,DEM,100030,3,1,52,56,
Carter,Superintendent of Public Instruction,Larry Huff,IND,100030,1,0,17,18,
Carter,Commissioner of Labor,Leslie Osborn,REP,100030,2,16,151,169,
Carter,Commissioner of Labor,Fred Dorrell,DEM,100030,1,1,47,49,
Carter,Commissioner of Labor,Brandt Dismukes,IND,100030,2,0,9,11,
Carter,Insurance Commissioner,Glen Mulready,REP,100030,4,15,156,175,
Carter,Insurance Commissioner,Kimberly Fobbs,DEM,100030,1,2,51,54,
Carter,Corporation Commissioner,Bob Anthony,REP,100030,3,16,153,172,
Carter,Corporation Commissioner,Ashley Nicole Mccray,DEM,100030,1,1,43,45,
Carter,Corporation Commissioner,Jackie Short,IND,100030,1,0,13,14,
Carter,U.S. House,Tom Cole,REP,100030,3,16,165,184,4
Carter,U.S. House,Mary Brannon,DEM,100030,1,1,39,41,4
Carter,U.S. House,Ruby Peters,IND,100030,1,0,7,8,4
Carter,State Senate,Frank Simpson,REP,100030,4,16,158,178,14
Carter,State Senate,Justin Arledge,DEM,100030,1,1,53,55,14
Carter,State House,Tommy Hardin,REP,100030,3,16,156,175,49
Carter,State House,Miranda Shelton,DEM,100030,2,1,55,58,49
Carter,Governor,Chris Powell,LIB,100031,2,1,37,40,
Carter,Governor,Kevin Stitt,REP,100031,21,81,737,839,
Carter,Governor,Drew Edmondson,DEM,100031,12,60,226,298,
Carter,Lieutenant Governor,Matt Pinnell,REP,100031,23,86,763,872,
Carter,Lieutenant Governor,Anastasia Pittman,DEM,100031,12,54,193,259,
Carter,Lieutenant Governor,Ivan Holmes,IND,100031,0,0,38,38,
Carter,State Auditor,John Yeutter,LIB,100031,6,26,152,184,
Carter,State Auditor,Cindy Byrd,REP,100031,24,100,806,930,
Carter,Attorney General,Mike Hunter,REP,100031,24,88,792,904,
Carter,Attorney General,Mark Myles,DEM,100031,11,51,199,261,
Carter,State Treasurer,Randy Mcdaniel,REP,100031,24,97,811,932,
Carter,State Treasurer,Charles De Coune,IND,100031,8,31,141,180,
Carter,Superintendent of Public Instruction,Joy Hofmeister,REP,100031,22,88,741,851,
Carter,Superintendent of Public Instruction,John Cox,DEM,100031,10,48,183,241,
Carter,Superintendent of Public Instruction,Larry Huff,IND,100031,2,5,67,74,
Carter,Commissioner of Labor,Leslie Osborn,REP,100031,22,80,763,865,
Carter,Commissioner of Labor,Fred Dorrell,DEM,100031,8,53,186,247,
Carter,Commissioner of Labor,Brandt Dismukes,IND,100031,3,6,34,43,
Carter,Insurance Commissioner,Glen Mulready,REP,100031,24,84,760,868,
Carter,Insurance Commissioner,Kimberly Fobbs,DEM,100031,10,55,222,287,
Carter,Corporation Commissioner,Bob Anthony,REP,100031,23,84,743,850,
Carter,Corporation Commissioner,Ashley Nicole Mccray,DEM,100031,9,48,192,249,
Carter,Corporation Commissioner,Jackie Short,IND,100031,2,8,51,61,
Carter,U.S. House,Tom Cole,REP,100031,24,89,788,901,4
Carter,U.S. House,Mary Brannon,DEM,100031,11,52,183,246,4
Carter,U.S. House,Ruby Peters,IND,100031,0,1,26,27,4
Carter,State Senate,Frank Simpson,REP,100031,22,90,764,876,14
Carter,State Senate,Justin Arledge,DEM,100031,13,51,227,291,14
Carter,State House,Tommy Hardin,REP,100031,24,81,728,833,49
Carter,State House,Miranda Shelton,DEM,100031,11,59,266,336,49
Carter,Governor,Chris Powell,LIB,100032,0,1,6,7,
Carter,Governor,Kevin Stitt,REP,100032,3,17,126,146,
Carter,Governor,Drew Edmondson,DEM,100032,0,7,70,77,
Carter,Lieutenant Governor,Matt Pinnell,REP,100032,2,18,130,150,
Carter,Lieutenant Governor,Anastasia Pittman,DEM,100032,0,7,62,69,
Carter,Lieutenant Governor,Ivan Holmes,IND,100032,1,0,9,10,
Carter,State Auditor,John Yeutter,LIB,100032,2,6,49,57,
Carter,State Auditor,Cindy Byrd,REP,100032,1,18,133,152,
Carter,Attorney General,Mike Hunter,REP,100032,3,18,135,156,
Carter,Attorney General,Mark Myles,DEM,100032,0,7,67,74,
Carter,State Treasurer,Randy Mcdaniel,REP,100032,3,19,137,159,
Carter,State Treasurer,Charles De Coune,IND,100032,0,5,44,49,
Carter,Superintendent of Public Instruction,Joy Hofmeister,REP,100032,2,17,120,139,
Carter,Superintendent of Public Instruction,John Cox,DEM,100032,0,7,64,71,
Carter,Superintendent of Public Instruction,Larry Huff,IND,100032,1,1,15,17,
Carter,Commissioner of Labor,Leslie Osborn,REP,100032,3,17,125,145,
Carter,Commissioner of Labor,Fred Dorrell,DEM,100032,0,8,64,72,
Carter,Commissioner of Labor,Brandt Dismukes,IND,100032,0,0,11,11,
Carter,Insurance Commissioner,Glen Mulready,REP,100032,3,17,131,151,
Carter,Insurance Commissioner,Kimberly Fobbs,DEM,100032,0,8,68,76,
Carter,Corporation Commissioner,Bob Anthony,REP,100032,3,16,124,143,
Carter,Corporation Commissioner,Ashley Nicole Mccray,DEM,100032,0,9,66,75,
Carter,Corporation Commissioner,Jackie Short,IND,100032,0,0,10,10,
Carter,U.S. House,Tom Cole,REP,100032,2,17,136,155,4
Carter,U.S. House,Mary Brannon,DEM,100032,0,8,62,70,4
Carter,U.S. House,Ruby Peters,IND,100032,1,0,3,4,4
Carter,State Senate,Frank Simpson,REP,100032,3,17,133,153,14
Carter,State Senate,Justin Arledge,DEM,100032,0,8,67,75,14
Carter,State House,Tammy Townley,REP,100032,2,17,124,143,48
Carter,State House,Cheryl Key,DEM,100032,1,8,78,87,48
Carter,Governor,Chris Powell,LIB,100033,1,0,16,17,
Carter,Governor,Kevin Stitt,REP,100033,6,15,262,283,
Carter,Governor,Drew Edmondson,DEM,100033,7,11,88,106,
Carter,Lieutenant Governor,Matt Pinnell,REP,100033,6,15,276,297,
Carter,Lieutenant Governor,Anastasia Pittman,DEM,100033,8,9,76,93,
Carter,Lieutenant Governor,Ivan Holmes,IND,100033,0,2,10,12,
Carter,State Auditor,John Yeutter,LIB,100033,0,5,52,57,
Carter,State Auditor,Cindy Byrd,REP,100033,11,18,298,327,
Carter,Attorney General,Mike Hunter,REP,100033,8,16,280,304,
Carter,Attorney General,Mark Myles,DEM,100033,6,10,80,96,
Carter,State Treasurer,Randy Mcdaniel,REP,100033,10,16,296,322,
Carter,State Treasurer,Charles De Coune,IND,100033,1,7,54,62,
Carter,Superintendent of Public Instruction,Joy Hofmeister,REP,100033,9,16,268,293,
Carter,Superintendent of Public Instruction,John Cox,DEM,100033,5,9,72,86,
Carter,Superintendent of Public Instruction,Larry Huff,IND,100033,0,1,24,25,
Carter,Commissioner of Labor,Leslie Osborn,REP,100033,7,16,268,291,
Carter,Commissioner of Labor,Fred Dorrell,DEM,100033,6,9,79,94,
Carter,Commissioner of Labor,Brandt Dismukes,IND,100033,1,1,16,18,
Carter,Insurance Commissioner,Glen Mulready,REP,100033,7,16,270,293,
Carter,Insurance Commissioner,Kimberly Fobbs,DEM,100033,6,10,88,104,
Carter,Corporation Commissioner,Bob Anthony,REP,100033,6,18,265,289,
Carter,Corporation Commissioner,Ashley Nicole Mccray,DEM,100033,7,8,82,97,
Carter,Corporation Commissioner,Jackie Short,IND,100033,0,0,16,16,
Carter,U.S. House,Tom Cole,REP,100033,7,16,276,299,4
Carter,U.S. House,Mary Brannon,DEM,100033,6,9,71,86,4
Carter,U.S. House,Ruby Peters,IND,100033,0,1,16,17,4
Carter,State Senate,Frank Simpson,REP,100033,7,16,277,300,14
Carter,State Senate,Justin Arledge,DEM,100033,6,10,88,104,14
Carter,State House,Tammy Townley,REP,100033,7,14,267,288,48
Carter,State House,Cheryl Key,DEM,100033,7,10,97,114,48
Carter,Governor,Chris Powell,LIB,100034,0,0,22,22,
Carter,Governor,Kevin Stitt,REP,100034,5,34,361,400,
Carter,Governor,Drew Edmondson,DEM,100034,5,10,146,161,
Carter,Lieutenant Governor,Matt Pinnell,REP,100034,5,37,383,425,
Carter,Lieutenant Governor,Anastasia Pittman,DEM,100034,3,7,124,134,
Carter,Lieutenant Governor,Ivan Holmes,IND,100034,2,0,22,24,
Carter,State Auditor,John Yeutter,LIB,100034,4,8,87,99,
Carter,State Auditor,Cindy Byrd,REP,100034,5,36,417,458,
Carter,Attorney General,Mike Hunter,REP,100034,5,35,384,424,
Carter,Attorney General,Mark Myles,DEM,100034,5,8,143,156,
Carter,State Treasurer,Randy Mcdaniel,REP,100034,5,35,403,443,
Carter,State Treasurer,Charles De Coune,IND,100034,4,8,104,116,
Carter,Superintendent of Public Instruction,Joy Hofmeister,REP,100034,5,33,360,398,
Carter,Superintendent of Public Instruction,John Cox,DEM,100034,5,6,123,134,
Carter,Superintendent of Public Instruction,Larry Huff,IND,100034,0,5,45,50,
Carter,Commissioner of Labor,Leslie Osborn,REP,100034,5,30,365,400,
Carter,Commissioner of Labor,Fred Dorrell,DEM,100034,4,7,133,144,
Carter,Commissioner of Labor,Brandt Dismukes,IND,100034,0,4,29,33,
Carter,Insurance Commissioner,Glen Mulready,REP,100034,5,32,366,403,
Carter,Insurance Commissioner,Kimberly Fobbs,DEM,100034,5,12,159,176,
Carter,Corporation Commissioner,Bob Anthony,REP,100034,5,32,361,398,
Carter,Corporation Commissioner,Ashley Nicole Mccray,DEM,100034,5,11,141,157,
Carter,Corporation Commissioner,Jackie Short,IND,100034,0,1,25,26,
Carter,U.S. House,Tom Cole,REP,100034,5,34,391,430,4
Carter,U.S. House,Mary Brannon,DEM,100034,3,8,122,133,4
Carter,U.S. House,Ruby Peters,IND,100034,2,0,17,19,4
Carter,State Senate,Frank Simpson,REP,100034,5,34,377,416,14
Carter,State Senate,Justin Arledge,DEM,100034,5,10,152,167,14
Carter,State House,Tommy Hardin,REP,100034,5,30,352,387,49
Carter,State House,Miranda Shelton,DEM,100034,5,13,176,194,49
Carter,Governor,Chris Powell,LIB,100039,0,1,11,12,
Carter,Governor,Kevin Stitt,REP,100039,3,11,180,194,
Carter,Governor,Drew Edmondson,DEM,100039,0,7,55,62,
Carter,Lieutenant Governor,Matt Pinnell,REP,100039,2,10,198,210,
Carter,Lieutenant Governor,Anastasia Pittman,DEM,100039,1,9,35,45,
Carter,Lieutenant Governor,Ivan Holmes,IND,100039,0,0,12,12,
Carter,State Auditor,John Yeutter,LIB,100039,0,5,29,34,
Carter,State Auditor,Cindy Byrd,REP,100039,3,13,206,222,
Carter,Attorney General,Mike Hunter,REP,100039,3,12,206,221,
Carter,Attorney General,Mark Myles,DEM,100039,0,7,39,46,
Carter,State Treasurer,Randy Mcdaniel,REP,100039,3,14,211,228,
Carter,State Treasurer,Charles De Coune,IND,100039,0,4,26,30,
Carter,Superintendent of Public Instruction,Joy Hofmeister,REP,100039,3,12,192,207,
Carter,Superintendent of Public Instruction,John Cox,DEM,100039,0,5,36,41,
Carter,Superintendent of Public Instruction,Larry Huff,IND,100039,0,2,18,20,
Carter,Commissioner of Labor,Leslie Osborn,REP,100039,3,13,195,211,
Carter,Commissioner of Labor,Fred Dorrell,DEM,100039,0,5,37,42,
Carter,Commissioner of Labor,Brandt Dismukes,IND,100039,0,1,11,12,
Carter,Insurance Commissioner,Glen Mulready,REP,100039,3,13,199,215,
Carter,Insurance Commissioner,Kimberly Fobbs,DEM,100039,0,6,41,47,
Carter,Corporation Commissioner,Bob Anthony,REP,100039,3,10,191,204,
Carter,Corporation Commissioner,Ashley Nicole Mccray,DEM,100039,0,8,40,48,
Carter,Corporation Commissioner,Jackie Short,IND,100039,0,1,14,15,
Carter,U.S. House,Tom Cole,REP,100039,3,12,208,223,4
Carter,U.S. House,Mary Brannon,DEM,100039,0,7,30,37,4
Carter,U.S. House,Ruby Peters,IND,100039,0,0,8,8,4
Carter,State Senate,Frank Simpson,REP,100039,3,11,201,215,14
Carter,State Senate,Justin Arledge,DEM,100039,0,8,46,54,14
Carter,State House,Tammy Townley,REP,100039,3,11,196,210,48
Carter,State House,Cheryl Key,DEM,100039,0,8,50,58,48
Carter,Governor,Chris Powell,LIB,100041,1,0,27,28,
Carter,Governor,Kevin Stitt,REP,100041,14,15,459,488,
Carter,Governor,Drew Edmondson,DEM,100041,4,3,148,155,
Carter,Lieutenant Governor,Matt Pinnell,REP,100041,14,14,491,519,
Carter,Lieutenant Governor,Anastasia Pittman,DEM,100041,5,4,124,133,
Carter,Lieutenant Governor,Ivan Holmes,IND,100041,0,0,17,17,
Carter,State Auditor,John Yeutter,LIB,100041,2,1,72,75,
Carter,State Auditor,Cindy Byrd,REP,100041,16,15,524,555,
Carter,Attorney General,Mike Hunter,REP,100041,14,15,507,536,
Carter,Attorney General,Mark Myles,DEM,100041,5,3,121,129,
Carter,State Treasurer,Randy Mcdaniel,REP,100041,14,15,523,552,
Carter,State Treasurer,Charles De Coune,IND,100041,4,2,74,80,
Carter,Superintendent of Public Instruction,Joy Hofmeister,REP,100041,15,16,443,474,
Carter,Superintendent of Public Instruction,John Cox,DEM,100041,3,2,138,143,
Carter,Superintendent of Public Instruction,Larry Huff,IND,100041,1,0,48,49,
Carter,Commissioner of Labor,Leslie Osborn,REP,100041,14,15,480,509,
Carter,Commissioner of Labor,Fred Dorrell,DEM,100041,5,3,119,127,
Carter,Commissioner of Labor,Brandt Dismukes,IND,100041,0,0,26,26,
Carter,Insurance Commissioner,Glen Mulready,REP,100041,15,15,486,516,
Carter,Insurance Commissioner,Kimberly Fobbs,DEM,100041,4,3,138,145,
Carter,Corporation Commissioner,Bob Anthony,REP,100041,13,14,471,498,
Carter,Corporation Commissioner,Ashley Nicole Mccray,DEM,100041,6,4,124,134,
Carter,Corporation Commissioner,Jackie Short,IND,100041,0,0,34,34,
Carter,U.S. House,Tom Cole,REP,100041,14,14,503,531,4
Carter,U.S. House,Mary Brannon,DEM,100041,4,3,107,114,4
Carter,U.S. House,Ruby Peters,IND,100041,1,1,20,22,4
Carter,State Senate,Frank Simpson,REP,100041,15,15,495,525,14
Carter,State Senate,Justin Arledge,DEM,100041,4,3,136,143,14
Carter,State House,Tammy Townley,REP,100041,15,14,485,514,48
Carter,State House,Cheryl Key,DEM,100041,4,4,149,157,48
Carter,Governor,Chris Powell,LIB,100051,0,0,5,5,
Carter,Governor,Kevin Stitt,REP,100051,2,7,144,153,
Carter,Governor,Drew Edmondson,DEM,100051,1,3,84,88,
Carter,Lieutenant Governor,Matt Pinnell,REP,100051,2,8,148,158,
Carter,Lieutenant Governor,Anastasia Pittman,DEM,100051,1,2,78,81,
Carter,Lieutenant Governor,Ivan Holmes,IND,100051,0,0,6,6,
Carter,State Auditor,John Yeutter,LIB,100051,1,2,57,60,
Carter,State Auditor,Cindy Byrd,REP,100051,2,8,154,164,
Carter,Attorney General,Mike Hunter,REP,100051,2,8,145,155,
Carter,Attorney General,Mark Myles,DEM,100051,1,2,85,88,
Carter,State Treasurer,Randy Mcdaniel,REP,100051,2,8,154,164,
Carter,State Treasurer,Charles De Coune,IND,100051,1,2,54,57,
Carter,Superintendent of Public Instruction,Joy Hofmeister,REP,100051,1,8,135,144,
Carter,Superintendent of Public Instruction,John Cox,DEM,100051,1,2,85,88,
Carter,Superintendent of Public Instruction,Larry Huff,IND,100051,1,0,12,13,
Carter,Commissioner of Labor,Leslie Osborn,REP,100051,0,8,140,148,
Carter,Commissioner of Labor,Fred Dorrell,DEM,100051,1,2,84,87,
Carter,Commissioner of Labor,Brandt Dismukes,IND,100051,2,0,7,9,
Carter,Insurance Commissioner,Glen Mulready,REP,100051,2,7,145,154,
Carter,Insurance Commissioner,Kimberly Fobbs,DEM,100051,1,3,86,90,
Carter,Corporation Commissioner,Bob Anthony,REP,100051,1,8,141,150,
Carter,Corporation Commissioner,Ashley Nicole Mccray,DEM,100051,2,2,86,90,
Carter,Corporation Commissioner,Jackie Short,IND,100051,0,0,6,6,
Carter,U.S. House,Tom Cole,REP,100051,2,8,152,162,4
Carter,U.S. House,Mary Brannon,DEM,100051,1,2,77,80,4
Carter,U.S. House,Ruby Peters,IND,100051,0,0,3,3,4
Carter,State Senate,Frank Simpson,REP,100051,2,8,150,160,14
Carter,State Senate,Justin Arledge,DEM,100051,1,2,82,85,14
Carter,State House,Tammy Townley,REP,100051,2,7,156,165,48
Carter,State House,Cheryl Key,DEM,100051,1,3,77,81,48
Carter,Governor,Chris Powell,LIB,100052,0,0,9,9,
Carter,Governor,Kevin Stitt,REP,100052,7,9,283,299,
Carter,Governor,Drew Edmondson,DEM,100052,2,5,55,62,
Carter,Lieutenant Governor,Matt Pinnell,REP,100052,9,10,296,315,
Carter,Lieutenant Governor,Anastasia Pittman,DEM,100052,0,4,46,50,
Carter,Lieutenant Governor,Ivan Holmes,IND,100052,0,0,4,4,
Carter,State Auditor,John Yeutter,LIB,100052,0,2,35,37,
Carter,State Auditor,Cindy Byrd,REP,100052,9,10,303,322,
Carter,Attorney General,Mike Hunter,REP,100052,9,9,294,312,
Carter,Attorney General,Mark Myles,DEM,100052,0,5,52,57,
Carter,State Treasurer,Randy Mcdaniel,REP,100052,9,9,305,323,
Carter,State Treasurer,Charles De Coune,IND,100052,0,3,31,34,
Carter,Superintendent of Public Instruction,Joy Hofmeister,REP,100052,9,8,273,290,
Carter,Superintendent of Public Instruction,John Cox,DEM,100052,0,5,56,61,
Carter,Superintendent of Public Instruction,Larry Huff,IND,100052,0,1,17,18,
Carter,Commissioner of Labor,Leslie Osborn,REP,100052,7,9,278,294,
Carter,Commissioner of Labor,Fred Dorrell,DEM,100052,2,5,57,64,
Carter,Commissioner of Labor,Brandt Dismukes,IND,100052,0,0,8,8,
Carter,Insurance Commissioner,Glen Mulready,REP,100052,9,9,279,297,
Carter,Insurance Commissioner,Kimberly Fobbs,DEM,100052,0,5,66,71,
Carter,Corporation Commissioner,Bob Anthony,REP,100052,9,9,283,301,
Carter,Corporation Commissioner,Ashley Nicole Mccray,DEM,100052,0,5,50,55,
Carter,Corporation Commissioner,Jackie Short,IND,100052,0,0,15,15,
Carter,U.S. House,Tom Cole,REP,100052,9,8,297,314,4
Carter,U.S. House,Mary Brannon,DEM,100052,0,6,45,51,4
Carter,U.S. House,Ruby Peters,IND,100052,0,0,6,6,4
Carter,State Senate,Frank Simpson,REP,100052,9,9,294,312,14
Carter,State Senate,Justin Arledge,DEM,100052,0,5,53,58,14
Carter,State House,Tammy Townley,REP,100052,7,8,306,321,48
Carter,State House,Cheryl Key,DEM,100052,2,6,44,52,48
Carter,Governor,Chris Powell,LIB,100061,0,1,6,7,
Carter,Governor,Kevin Stitt,REP,100061,4,36,243,283,
Carter,Governor,Drew Edmondson,DEM,100061,2,10,108,120,
Carter,Lieutenant Governor,Matt Pinnell,REP,100061,5,40,264,309,
Carter,Lieutenant Governor,Anastasia Pittman,DEM,100061,1,5,83,89,
Carter,Lieutenant Governor,Ivan Holmes,IND,100061,0,2,6,8,
Carter,State Auditor,John Yeutter,LIB,100061,1,1,50,52,
Carter,State Auditor,Cindy Byrd,REP,100061,5,42,278,325,
Carter,Attorney General,Mike Hunter,REP,100061,5,41,273,319,
Carter,Attorney General,Mark Myles,DEM,100061,1,6,78,85,
Carter,State Treasurer,Randy Mcdaniel,REP,100061,5,43,282,330,
Carter,State Treasurer,Charles De Coune,IND,100061,1,1,44,46,
Carter,Superintendent of Public Instruction,Joy Hofmeister,REP,100061,5,37,260,302,
Carter,Superintendent of Public Instruction,John Cox,DEM,100061,1,8,74,83,
Carter,Superintendent of Public Instruction,Larry Huff,IND,100061,0,2,19,21,
Carter,Commissioner of Labor,Leslie Osborn,REP,100061,4,42,262,308,
Carter,Commissioner of Labor,Fred Dorrell,DEM,100061,1,5,76,82,
Carter,Commissioner of Labor,Brandt Dismukes,IND,100061,1,0,10,11,
Carter,Insurance Commissioner,Glen Mulready,REP,100061,5,37,257,299,
Carter,Insurance Commissioner,Kimberly Fobbs,DEM,100061,1,10,91,102,
Carter,Corporation Commissioner,Bob Anthony,REP,100061,5,37,246,288,
Carter,Corporation Commissioner,Ashley Nicole Mccray,DEM,100061,1,6,85,92,
Carter,Corporation Commissioner,Jackie Short,IND,100061,0,4,16,20,
Carter,U.S. House,Tom Cole,REP,100061,5,40,263,308,4
Carter,U.S. House,Mary Brannon,DEM,100061,1,7,82,90,4
Carter,U.S. House,Ruby Peters,IND,100061,0,0,9,9,4
Carter,State Senate,Frank Simpson,REP,100061,5,41,254,300,14
Carter,State Senate,Justin Arledge,DEM,100061,1,6,100,107,14
Carter,State House,Tommy Hardin,REP,100061,5,36,239,280,49
Carter,State House,Miranda Shelton,DEM,100061,1,11,115,127,49
Carter,Governor,Chris Powell,LIB,100062,0,2,17,19,
Carter,Governor,Kevin Stitt,REP,100062,9,49,407,465,
Carter,Governor,Drew Edmondson,DEM,100062,6,25,154,185,
Carter,Lieutenant Governor,Matt Pinnell,REP,100062,9,56,426,491,
Carter,Lieutenant Governor,Anastasia Pittman,DEM,100062,6,18,121,145,
Carter,Lieutenant Governor,Ivan Holmes,IND,100062,0,1,25,26,
Carter,State Auditor,John Yeutter,LIB,100062,5,10,80,95,
Carter,State Auditor,Cindy Byrd,REP,100062,8,58,452,518,
Carter,Attorney General,Mike Hunter,REP,100062,8,57,430,495,
Carter,Attorney General,Mark Myles,DEM,100062,7,19,138,164,
Carter,State Treasurer,Randy Mcdaniel,REP,100062,7,56,442,505,
Carter,State Treasurer,Charles De Coune,IND,100062,7,13,88,108,
Carter,Superintendent of Public Instruction,Joy Hofmeister,REP,100062,6,59,406,471,
Carter,Superintendent of Public Instruction,John Cox,DEM,100062,7,17,127,151,
Carter,Superintendent of Public Instruction,Larry Huff,IND,100062,2,0,33,35,
Carter,Commissioner of Labor,Leslie Osborn,REP,100062,7,55,414,476,
Carter,Commissioner of Labor,Fred Dorrell,DEM,100062,6,17,117,140,
Carter,Commissioner of Labor,Brandt Dismukes,IND,100062,2,2,33,37,
Carter,Insurance Commissioner,Glen Mulready,REP,100062,6,50,405,461,
Carter,Insurance Commissioner,Kimberly Fobbs,DEM,100062,9,24,161,194,
Carter,Corporation Commissioner,Bob Anthony,REP,100062,9,54,399,462,
Carter,Corporation Commissioner,Ashley Nicole Mccray,DEM,100062,5,18,132,155,
Carter,Corporation Commissioner,Jackie Short,IND,100062,1,3,35,39,
Carter,U.S. House,Tom Cole,REP,100062,9,57,437,503,4
Carter,U.S. House,Mary Brannon,DEM,100062,6,16,110,132,4
Carter,U.S. House,Ruby Peters,IND,100062,0,1,27,28,4
Carter,State Senate,Frank Simpson,REP,100062,8,58,424,490,14
Carter,State Senate,Justin Arledge,DEM,100062,7,17,151,175,14
Carter,State House,Tommy Hardin,REP,100062,9,52,413,474,49
Carter,State House,Miranda Shelton,DEM,100062,6,24,162,192,49
Carter,Governor,Chris Powell,LIB,100063,0,2,22,24,
Carter,Governor,Kevin Stitt,REP,100063,9,55,503,567,
Carter,Governor,Drew Edmondson,DEM,100063,2,26,171,199,
Carter,Lieutenant Governor,Matt Pinnell,REP,100063,10,57,535,602,
Carter,Lieutenant Governor,Anastasia Pittman,DEM,100063,1,23,139,163,
Carter,Lieutenant Governor,Ivan Holmes,IND,100063,0,2,21,23,
Carter,State Auditor,John Yeutter,LIB,100063,1,14,95,110,
Carter,State Auditor,Cindy Byrd,REP,100063,10,64,571,645,
Carter,Attorney General,Mike Hunter,REP,100063,10,57,550,617,
Carter,Attorney General,Mark Myles,DEM,100063,1,24,143,168,
Carter,State Treasurer,Randy Mcdaniel,REP,100063,9,60,572,641,
Carter,State Treasurer,Charles De Coune,IND,100063,2,18,91,111,
Carter,Superintendent of Public Instruction,Joy Hofmeister,REP,100063,10,57,514,581,
Carter,Superintendent of Public Instruction,John Cox,DEM,100063,1,21,140,162,
Carter,Superintendent of Public Instruction,Larry Huff,IND,100063,0,4,40,44,
Carter,Commissioner of Labor,Leslie Osborn,REP,100063,10,62,519,591,
Carter,Commissioner of Labor,Fred Dorrell,DEM,100063,1,18,147,166,
Carter,Commissioner of Labor,Brandt Dismukes,IND,100063,0,2,28,30,
Carter,Insurance Commissioner,Glen Mulready,REP,100063,10,60,527,597,
Carter,Insurance Commissioner,Kimberly Fobbs,DEM,100063,1,22,166,189,
Carter,Corporation Commissioner,Bob Anthony,REP,100063,11,56,508,575,
Carter,Corporation Commissioner,Ashley Nicole Mccray,DEM,100063,1,23,147,171,
Carter,Corporation Commissioner,Jackie Short,IND,100063,0,3,38,41,
Carter,U.S. House,Tom Cole,REP,100063,11,57,555,623,4
Carter,U.S. House,Mary Brannon,DEM,100063,0,22,126,148,4
Carter,U.S. House,Ruby Peters,IND,100063,0,3,14,17,4
Carter,State Senate,Frank Simpson,REP,100063,10,55,539,604,14
Carter,State Senate,Justin Arledge,DEM,100063,1,27,156,184,14
Carter,State House,Tommy Hardin,REP,100063,10,55,516,581,49
Carter,State House,Miranda Shelton,DEM,100063,0,27,178,205,49
Carter,Governor,Chris Powell,LIB,100071,1,1,23,25,
Carter,Governor,Kevin Stitt,REP,100071,6,8,388,402,
Carter,Governor,Drew Edmondson,DEM,100071,2,3,125,130,
Carter,Lieutenant Governor,Matt Pinnell,REP,100071,6,10,410,426,
Carter,Lieutenant Governor,Anastasia Pittman,DEM,100071,3,1,111,115,
Carter,Lieutenant Governor,Ivan Holmes,IND,100071,0,0,13,13,
Carter,State Auditor,John Yeutter,LIB,100071,2,1,61,64,
Carter,State Auditor,Cindy Byrd,REP,100071,7,10,456,473,
Carter,Attorney General,Mike Hunter,REP,100071,6,10,425,441,
Carter,Attorney General,Mark Myles,DEM,100071,3,1,108,112,
Carter,State Treasurer,Randy Mcdaniel,REP,100071,6,9,441,456,
Carter,State Treasurer,Charles De Coune,IND,100071,3,2,74,79,
Carter,Superintendent of Public Instruction,Joy Hofmeister,REP,100071,6,7,386,399,
Carter,Superintendent of Public Instruction,John Cox,DEM,100071,2,1,113,116,
Carter,Superintendent of Public Instruction,Larry Huff,IND,100071,1,3,32,36,
Carter,Commissioner of Labor,Leslie Osborn,REP,100071,6,10,413,429,
Carter,Commissioner of Labor,Fred Dorrell,DEM,100071,3,1,98,102,
Carter,Commissioner of Labor,Brandt Dismukes,IND,100071,0,0,18,18,
Carter,Insurance Commissioner,Glen Mulready,REP,100071,6,10,413,429,
Carter,Insurance Commissioner,Kimberly Fobbs,DEM,100071,3,1,119,123,
Carter,Corporation Commissioner,Bob Anthony,REP,100071,6,9,404,419,
Carter,Corporation Commissioner,Ashley Nicole Mccray,DEM,100071,2,1,103,106,
Carter,Corporation Commissioner,Jackie Short,IND,100071,1,1,26,28,
Carter,U.S. House,Tom Cole,REP,100071,6,10,426,442,4
Carter,U.S. House,Mary Brannon,DEM,100071,3,1,95,99,4
Carter,U.S. House,Ruby Peters,IND,100071,0,0,13,13,4
Carter,State Senate,Frank Simpson,REP,100071,6,10,406,422,14
Carter,State Senate,Justin Arledge,DEM,100071,3,1,126,130,14
Carter,State House,Tammy Townley,REP,100071,6,10,403,419,48
Carter,State House,Cheryl Key,DEM,100071,3,2,132,137,48
Cherokee,Governor,Chris Powell,LIB,110001,3,6,29,38,
Cherokee,Governor,Kevin Stitt,REP,110001,11,60,200,271,
Cherokee,Governor,Drew Edmondson,DEM,110001,13,124,458,595,
Cherokee,Lieutenant Governor,Matt Pinnell,REP,110001,12,68,259,339,
Cherokee,Lieutenant Governor,Anastasia Pittman,DEM,110001,12,114,370,496,
Cherokee,Lieutenant Governor,Ivan Holmes,IND,110001,1,7,52,60,
Cherokee,State Auditor,John Yeutter,LIB,110001,15,106,386,507,
Cherokee,State Auditor,Cindy Byrd,REP,110001,9,70,247,326,
Cherokee,Attorney General,Mike Hunter,REP,110001,11,69,275,355,
Cherokee,Attorney General,Mark Myles,DEM,110001,15,121,400,536,
Cherokee,State Treasurer,Randy Mcdaniel,REP,110001,14,84,281,379,
Cherokee,State Treasurer,Charles De Coune,IND,110001,9,89,341,439,
Cherokee,Superintendent of Public Instruction,Joy Hofmeister,REP,110001,13,63,230,306,
Cherokee,Superintendent of Public Instruction,John Cox,DEM,110001,10,112,402,524,
Cherokee,Superintendent of Public Instruction,Larry Huff,IND,110001,3,13,48,64,
Cherokee,Commissioner of Labor,Leslie Osborn,REP,110001,13,65,248,326,
Cherokee,Commissioner of Labor,Fred Dorrell,DEM,110001,10,112,364,486,
Cherokee,Commissioner of Labor,Brandt Dismukes,IND,110001,1,11,57,69,
Cherokee,Insurance Commissioner,Glen Mulready,REP,110001,15,68,261,344,
Cherokee,Insurance Commissioner,Kimberly Fobbs,DEM,110001,11,121,409,541,
Cherokee,Corporation Commissioner,Bob Anthony,REP,110001,15,68,232,315,
Cherokee,Corporation Commissioner,Ashley Nicole Mccray,DEM,110001,10,111,379,500,
Cherokee,Corporation Commissioner,Jackie Short,IND,110001,1,9,63,73,
Cherokee,U.S. House,Richard Castaldo,LIB,110001,0,3,21,24,2
Cherokee,U.S. House,Markwayne Mullin,REP,110001,13,69,227,309,2
Cherokee,U.S. House,Jason Nichols,DEM,110001,11,111,416,538,2
Cherokee,U.S. House,John Foreman,IND,110001,2,7,21,30,2
Cherokee,Governor,Chris Powell,LIB,110002,3,15,32,50,
Cherokee,Governor,Kevin Stitt,REP,110002,29,175,387,591,
Cherokee,Governor,Drew Edmondson,DEM,110002,54,277,462,793,
Cherokee,Lieutenant Governor,Matt Pinnell,REP,110002,35,220,454,709,
Cherokee,Lieutenant Governor,Anastasia Pittman,DEM,110002,48,225,377,650,
Cherokee,Lieutenant Governor,Ivan Holmes,IND,110002,4,20,42,66,
Cherokee,State Auditor,John Yeutter,LIB,110002,33,185,411,629,
Cherokee,State Auditor,Cindy Byrd,REP,110002,41,245,422,708,
Cherokee,Attorney General,Mike Hunter,REP,110002,44,235,482,761,
Cherokee,Attorney General,Mark Myles,DEM,110002,43,228,388,659,
Cherokee,State Treasurer,Randy Mcdaniel,REP,110002,38,244,505,787,
Cherokee,State Treasurer,Charles De Coune,IND,110002,35,180,308,523,
Cherokee,Superintendent of Public Instruction,Joy Hofmeister,REP,110002,38,213,401,652,
Cherokee,Superintendent of Public Instruction,John Cox,DEM,110002,44,237,387,668,
Cherokee,Superintendent of Public Instruction,Larry Huff,IND,110002,5,16,84,105,
Cherokee,Commissioner of Labor,Leslie Osborn,REP,110002,35,217,433,685,
Cherokee,Commissioner of Labor,Fred Dorrell,DEM,110002,45,223,374,642,
Cherokee,Commissioner of Labor,Brandt Dismukes,IND,110002,6,19,52,77,
Cherokee,Insurance Commissioner,Glen Mulready,REP,110002,37,213,459,709,
Cherokee,Insurance Commissioner,Kimberly Fobbs,DEM,110002,50,248,400,698,
Cherokee,Corporation Commissioner,Bob Anthony,REP,110002,33,214,431,678,
Cherokee,Corporation Commissioner,Ashley Nicole Mccray,DEM,110002,50,227,381,658,
Cherokee,Corporation Commissioner,Jackie Short,IND,110002,4,22,52,78,
Cherokee,U.S. House,Richard Castaldo,LIB,110002,1,12,16,29,2
Cherokee,U.S. House,Markwayne Mullin,REP,110002,33,200,419,652,2
Cherokee,U.S. House,Jason Nichols,DEM,110002,49,238,409,696,2
Cherokee,U.S. House,John Foreman,IND,110002,3,17,32,52,2
Cherokee,Governor,Chris Powell,LIB,110003,1,15,29,45,
Cherokee,Governor,Kevin Stitt,REP,110003,20,151,369,540,
Cherokee,Governor,Drew Edmondson,DEM,110003,37,247,323,607,
Cherokee,Lieutenant Governor,Matt Pinnell,REP,110003,19,178,410,607,
Cherokee,Lieutenant Governor,Anastasia Pittman,DEM,110003,36,211,267,514,
Cherokee,Lieutenant Governor,Ivan Holmes,IND,110003,3,22,37,62,
Cherokee,State Auditor,John Yeutter,LIB,110003,30,196,268,494,
Cherokee,State Auditor,Cindy Byrd,REP,110003,23,182,425,630,
Cherokee,Attorney General,Mike Hunter,REP,110003,24,197,429,650,
Cherokee,Attorney General,Mark Myles,DEM,110003,32,212,283,527,
Cherokee,State Treasurer,Randy Mcdaniel,REP,110003,24,210,458,692,
Cherokee,State Treasurer,Charles De Coune,IND,110003,29,170,223,422,
Cherokee,Superintendent of Public Instruction,Joy Hofmeister,REP,110003,22,159,377,558,
Cherokee,Superintendent of Public Instruction,John Cox,DEM,110003,33,220,278,531,
Cherokee,Superintendent of Public Instruction,Larry Huff,IND,110003,3,32,57,92,
Cherokee,Commissioner of Labor,Leslie Osborn,REP,110003,19,172,401,592,
Cherokee,Commissioner of Labor,Fred Dorrell,DEM,110003,36,213,260,509,
Cherokee,Commissioner of Labor,Brandt Dismukes,IND,110003,3,24,44,71,
Cherokee,Insurance Commissioner,Glen Mulready,REP,110003,20,179,412,611,
Cherokee,Insurance Commissioner,Kimberly Fobbs,DEM,110003,37,231,292,560,
Cherokee,Corporation Commissioner,Bob Anthony,REP,110003,19,175,390,584,
Cherokee,Corporation Commissioner,Ashley Nicole Mccray,DEM,110003,34,212,272,518,
Cherokee,Corporation Commissioner,Jackie Short,IND,110003,4,23,47,74,
Cherokee,U.S. House,Richard Castaldo,LIB,110003,2,6,12,20,2
Cherokee,U.S. House,Markwayne Mullin,REP,110003,21,167,381,569,2
Cherokee,U.S. House,Jason Nichols,DEM,110003,34,223,289,546,2
Cherokee,U.S. House,John Foreman,IND,110003,1,16,35,52,2
Cherokee,Governor,Chris Powell,LIB,110004,0,17,35,52,
Cherokee,Governor,Kevin Stitt,REP,110004,18,151,233,402,
Cherokee,Governor,Drew Edmondson,DEM,110004,23,237,483,743,
Cherokee,Lieutenant Governor,Matt Pinnell,REP,110004,19,183,292,494,
Cherokee,Lieutenant Governor,Anastasia Pittman,DEM,110004,21,202,399,622,
Cherokee,Lieutenant Governor,Ivan Holmes,IND,110004,1,17,51,69,
Cherokee,State Auditor,John Yeutter,LIB,110004,15,196,375,586,
Cherokee,State Auditor,Cindy Byrd,REP,110004,18,175,319,512,
Cherokee,Attorney General,Mike Hunter,REP,110004,19,196,335,550,
Cherokee,Attorney General,Mark Myles,DEM,110004,22,203,407,632,
Cherokee,State Treasurer,Randy Mcdaniel,REP,110004,21,207,333,561,
Cherokee,State Treasurer,Charles De Coune,IND,110004,14,159,357,530,
Cherokee,Superintendent of Public Instruction,Joy Hofmeister,REP,110004,18,155,247,420,
Cherokee,Superintendent of Public Instruction,John Cox,DEM,110004,19,219,429,667,
Cherokee,Superintendent of Public Instruction,Larry Huff,IND,110004,4,29,69,102,
Cherokee,Commissioner of Labor,Leslie Osborn,REP,110004,19,178,290,487,
Cherokee,Commissioner of Labor,Fred Dorrell,DEM,110004,21,198,383,602,
Cherokee,Commissioner of Labor,Brandt Dismukes,IND,110004,1,19,62,82,
Cherokee,Insurance Commissioner,Glen Mulready,REP,110004,21,183,311,515,
Cherokee,Insurance Commissioner,Kimberly Fobbs,DEM,110004,20,207,423,650,
Cherokee,Corporation Commissioner,Bob Anthony,REP,110004,20,169,278,467,
Cherokee,Corporation Commissioner,Ashley Nicole Mccray,DEM,110004,20,205,387,612,
Cherokee,Corporation Commissioner,Jackie Short,IND,110004,1,19,68,88,
Cherokee,U.S. House,Richard Castaldo,LIB,110004,0,10,18,28,2
Cherokee,U.S. House,Markwayne Mullin,REP,110004,19,176,255,450,2
Cherokee,U.S. House,Jason Nichols,DEM,110004,20,206,447,673,2
Cherokee,U.S. House,John Foreman,IND,110004,2,12,31,45,2
Cherokee,Governor,Chris Powell,LIB,110005,1,0,11,12,
Cherokee,Governor,Kevin Stitt,REP,110005,1,12,57,70,
Cherokee,Governor,Drew Edmondson,DEM,110005,8,24,96,128,
Cherokee,Lieutenant Governor,Matt Pinnell,REP,110005,2,13,70,85,
Cherokee,Lieutenant Governor,Anastasia Pittman,DEM,110005,8,21,84,113,
Cherokee,Lieutenant Governor,Ivan Holmes,IND,110005,0,2,9,11,
Cherokee,State Auditor,John Yeutter,LIB,110005,8,15,90,113,
Cherokee,State Auditor,Cindy Byrd,REP,110005,1,15,63,79,
Cherokee,Attorney General,Mike Hunter,REP,110005,3,14,69,86,
Cherokee,Attorney General,Mark Myles,DEM,110005,7,21,93,121,
Cherokee,State Treasurer,Randy Mcdaniel,REP,110005,4,16,83,103,
Cherokee,State Treasurer,Charles De Coune,IND,110005,5,15,68,88,
Cherokee,Superintendent of Public Instruction,Joy Hofmeister,REP,110005,3,9,56,68,
Cherokee,Superintendent of Public Instruction,John Cox,DEM,110005,6,24,92,122,
Cherokee,Superintendent of Public Instruction,Larry Huff,IND,110005,1,3,14,18,
Cherokee,Commissioner of Labor,Leslie Osborn,REP,110005,2,14,61,77,
Cherokee,Commissioner of Labor,Fred Dorrell,DEM,110005,7,21,86,114,
Cherokee,Commissioner of Labor,Brandt Dismukes,IND,110005,0,0,10,10,
Cherokee,Insurance Commissioner,Glen Mulready,REP,110005,2,11,64,77,
Cherokee,Insurance Commissioner,Kimberly Fobbs,DEM,110005,7,25,95,127,
Cherokee,Corporation Commissioner,Bob Anthony,REP,110005,4,13,64,81,
Cherokee,Corporation Commissioner,Ashley Nicole Mccray,DEM,110005,5,21,86,112,
Cherokee,Corporation Commissioner,Jackie Short,IND,110005,1,2,10,13,
Cherokee,U.S. House,Richard Castaldo,LIB,110005,1,0,5,6,2
Cherokee,U.S. House,Markwayne Mullin,REP,110005,1,14,54,69,2
Cherokee,U.S. House,Jason Nichols,DEM,110005,7,22,96,125,2
Cherokee,U.S. House,John Foreman,IND,110005,0,0,9,9,2
Cherokee,Governor,Chris Powell,LIB,110006,0,2,15,17,
Cherokee,Governor,Kevin Stitt,REP,110006,10,34,141,185,
Cherokee,Governor,Drew Edmondson,DEM,110006,7,53,149,209,
Cherokee,Lieutenant Governor,Matt Pinnell,REP,110006,11,43,184,238,
Cherokee,Lieutenant Governor,Anastasia Pittman,DEM,110006,6,44,108,158,
Cherokee,Lieutenant Governor,Ivan Holmes,IND,110006,0,2,10,12,
Cherokee,State Auditor,John Yeutter,LIB,110006,4,37,109,150,
Cherokee,State Auditor,Cindy Byrd,REP,110006,11,43,180,234,
Cherokee,Attorney General,Mike Hunter,REP,110006,10,42,182,234,
Cherokee,Attorney General,Mark Myles,DEM,110006,7,46,114,167,
Cherokee,State Treasurer,Randy Mcdaniel,REP,110006,9,46,189,244,
Cherokee,State Treasurer,Charles De Coune,IND,110006,5,34,97,136,
Cherokee,Superintendent of Public Instruction,Joy Hofmeister,REP,110006,6,43,147,196,
Cherokee,Superintendent of Public Instruction,John Cox,DEM,110006,9,42,129,180,
Cherokee,Superintendent of Public Instruction,Larry Huff,IND,110006,1,4,25,30,
Cherokee,Commissioner of Labor,Leslie Osborn,REP,110006,9,41,167,217,
Cherokee,Commissioner of Labor,Fred Dorrell,DEM,110006,6,45,112,163,
Cherokee,Commissioner of Labor,Brandt Dismukes,IND,110006,1,2,17,20,
Cherokee,Insurance Commissioner,Glen Mulready,REP,110006,11,41,177,229,
Cherokee,Insurance Commissioner,Kimberly Fobbs,DEM,110006,6,48,118,172,
Cherokee,Corporation Commissioner,Bob Anthony,REP,110006,7,43,172,222,
Cherokee,Corporation Commissioner,Ashley Nicole Mccray,DEM,110006,8,46,106,160,
Cherokee,Corporation Commissioner,Jackie Short,IND,110006,1,0,17,18,
Cherokee,U.S. House,Richard Castaldo,LIB,110006,0,1,5,6,2
Cherokee,U.S. House,Markwayne Mullin,REP,110006,10,41,163,214,2
Cherokee,U.S. House,Jason Nichols,DEM,110006,7,46,124,177,2
Cherokee,U.S. House,John Foreman,IND,110006,0,1,10,11,2
Cherokee,Governor,Chris Powell,LIB,110007,0,0,2,2,
Cherokee,Governor,Kevin Stitt,REP,110007,3,8,21,32,
Cherokee,Governor,Drew Edmondson,DEM,110007,2,16,46,64,
Cherokee,Lieutenant Governor,Matt Pinnell,REP,110007,1,8,38,47,
Cherokee,Lieutenant Governor,Anastasia Pittman,DEM,110007,2,16,29,47,
Cherokee,Lieutenant Governor,Ivan Holmes,IND,110007,2,0,1,3,
Cherokee,State Auditor,John Yeutter,LIB,110007,3,16,30,49,
Cherokee,State Auditor,Cindy Byrd,REP,110007,2,8,35,45,
Cherokee,Attorney General,Mike Hunter,REP,110007,3,8,40,51,
Cherokee,Attorney General,Mark Myles,DEM,110007,2,16,29,47,
Cherokee,State Treasurer,Randy Mcdaniel,REP,110007,4,8,40,52,
Cherokee,State Treasurer,Charles De Coune,IND,110007,1,15,26,42,
Cherokee,Superintendent of Public Instruction,Joy Hofmeister,REP,110007,1,9,24,34,
Cherokee,Superintendent of Public Instruction,John Cox,DEM,110007,4,14,42,60,
Cherokee,Superintendent of Public Instruction,Larry Huff,IND,110007,0,0,3,3,
Cherokee,Commissioner of Labor,Leslie Osborn,REP,110007,3,9,30,42,
Cherokee,Commissioner of Labor,Fred Dorrell,DEM,110007,2,12,34,48,
Cherokee,Commissioner of Labor,Brandt Dismukes,IND,110007,0,2,4,6,
Cherokee,Insurance Commissioner,Glen Mulready,REP,110007,4,9,39,52,
Cherokee,Insurance Commissioner,Kimberly Fobbs,DEM,110007,1,15,29,45,
Cherokee,Corporation Commissioner,Bob Anthony,REP,110007,2,9,38,49,
Cherokee,Corporation Commissioner,Ashley Nicole Mccray,DEM,110007,1,15,26,42,
Cherokee,Corporation Commissioner,Jackie Short,IND,110007,2,0,3,5,
Cherokee,U.S. House,Richard Castaldo,LIB,110007,0,1,2,3,2
Cherokee,U.S. House,Markwayne Mullin,REP,110007,1,9,28,38,2
Cherokee,U.S. House,Jason Nichols,DEM,110007,2,14,36,52,2
Cherokee,U.S. House,John Foreman,IND,110007,2,1,3,6,2
Cherokee,Governor,Chris Powell,LIB,110008,1,4,12,17,
Cherokee,Governor,Kevin Stitt,REP,110008,2,24,110,136,
Cherokee,Governor,Drew Edmondson,DEM,110008,9,33,128,170,
Cherokee,Lieutenant Governor,Matt Pinnell,REP,110008,2,28,129,159,
Cherokee,Lieutenant Governor,Anastasia Pittman,DEM,110008,9,31,101,141,
Cherokee,Lieutenant Governor,Ivan Holmes,IND,110008,1,2,20,23,
Cherokee,State Auditor,John Yeutter,LIB,110008,7,29,117,153,
Cherokee,State Auditor,Cindy Byrd,REP,110008,1,26,120,147,
Cherokee,Attorney General,Mike Hunter,REP,110008,2,30,134,166,
Cherokee,Attorney General,Mark Myles,DEM,110008,9,31,114,154,
Cherokee,State Treasurer,Randy Mcdaniel,REP,110008,2,30,129,161,
Cherokee,State Treasurer,Charles De Coune,IND,110008,6,26,104,136,
Cherokee,Superintendent of Public Instruction,Joy Hofmeister,REP,110008,1,34,101,136,
Cherokee,Superintendent of Public Instruction,John Cox,DEM,110008,9,23,122,154,
Cherokee,Superintendent of Public Instruction,Larry Huff,IND,110008,1,4,27,32,
Cherokee,Commissioner of Labor,Leslie Osborn,REP,110008,2,26,113,141,
Cherokee,Commissioner of Labor,Fred Dorrell,DEM,110008,7,30,113,150,
Cherokee,Commissioner of Labor,Brandt Dismukes,IND,110008,2,5,20,27,
Cherokee,Insurance Commissioner,Glen Mulready,REP,110008,2,27,124,153,
Cherokee,Insurance Commissioner,Kimberly Fobbs,DEM,110008,10,34,120,164,
Cherokee,Corporation Commissioner,Bob Anthony,REP,110008,1,25,124,150,
Cherokee,Corporation Commissioner,Ashley Nicole Mccray,DEM,110008,9,35,105,149,
Cherokee,Corporation Commissioner,Jackie Short,IND,110008,2,1,17,20,
Cherokee,U.S. House,Richard Castaldo,LIB,110008,0,1,7,8,2
Cherokee,U.S. House,Markwayne Mullin,REP,110008,3,24,112,139,2
Cherokee,U.S. House,Jason Nichols,DEM,110008,9,33,119,161,2
Cherokee,U.S. House,John Foreman,IND,110008,0,3,10,13,2
Cherokee,State House,David Hardin,REP,110008,2,29,120,151,86
Cherokee,State House,Rhonda Cox,DEM,110008,10,31,128,169,86
Cherokee,Governor,Chris Powell,LIB,110009,0,1,23,24,
Cherokee,Governor,Kevin Stitt,REP,110009,18,31,337,386,
Cherokee,Governor,Drew Edmondson,DEM,110009,18,29,186,233,
Cherokee,Lieutenant Governor,Matt Pinnell,REP,110009,22,33,355,410,
Cherokee,Lieutenant Governor,Anastasia Pittman,DEM,110009,14,23,159,196,
Cherokee,Lieutenant Governor,Ivan Holmes,IND,110009,0,3,29,32,
Cherokee,State Auditor,John Yeutter,LIB,110009,6,16,139,161,
Cherokee,State Auditor,Cindy Byrd,REP,110009,23,39,371,433,
Cherokee,Attorney General,Mike Hunter,REP,110009,24,42,363,429,
Cherokee,Attorney General,Mark Myles,DEM,110009,11,18,177,206,
Cherokee,State Treasurer,Randy Mcdaniel,REP,110009,21,37,359,417,
Cherokee,State Treasurer,Charles De Coune,IND,110009,8,18,149,175,
Cherokee,Superintendent of Public Instruction,Joy Hofmeister,REP,110009,21,30,340,391,
Cherokee,Superintendent of Public Instruction,John Cox,DEM,110009,14,19,173,206,
Cherokee,Superintendent of Public Instruction,Larry Huff,IND,110009,1,11,32,44,
Cherokee,Commissioner of Labor,Leslie Osborn,REP,110009,21,36,341,398,
Cherokee,Commissioner of Labor,Fred Dorrell,DEM,110009,13,19,166,198,
Cherokee,Commissioner of Labor,Brandt Dismukes,IND,110009,1,4,29,34,
Cherokee,Insurance Commissioner,Glen Mulready,REP,110009,21,37,349,407,
Cherokee,Insurance Commissioner,Kimberly Fobbs,DEM,110009,14,22,185,221,
Cherokee,Corporation Commissioner,Bob Anthony,REP,110009,20,39,340,399,
Cherokee,Corporation Commissioner,Ashley Nicole Mccray,DEM,110009,13,18,160,191,
Cherokee,Corporation Commissioner,Jackie Short,IND,110009,2,2,37,41,
Cherokee,U.S. House,Richard Castaldo,LIB,110009,0,2,12,14,2
Cherokee,U.S. House,Markwayne Mullin,REP,110009,21,33,344,398,2
Cherokee,U.S. House,Jason Nichols,DEM,110009,13,24,171,208,2
Cherokee,U.S. House,John Foreman,IND,110009,1,2,15,18,2
Cherokee,Governor,Chris Powell,LIB,110010,2,3,34,39,
Cherokee,Governor,Kevin Stitt,REP,110010,24,66,420,510,
Cherokee,Governor,Drew Edmondson,DEM,110010,22,88,416,526,
Cherokee,Lieutenant Governor,Matt Pinnell,REP,110010,23,71,493,587,
Cherokee,Lieutenant Governor,Anastasia Pittman,DEM,110010,22,82,334,438,
Cherokee,Lieutenant Governor,Ivan Holmes,IND,110010,3,3,35,41,
Cherokee,State Auditor,John Yeutter,LIB,110010,14,63,300,377,
Cherokee,State Auditor,Cindy Byrd,REP,110010,29,80,513,622,
Cherokee,Attorney General,Mike Hunter,REP,110010,27,75,513,615,
Cherokee,Attorney General,Mark Myles,DEM,110010,21,79,347,447,
Cherokee,State Treasurer,Randy Mcdaniel,REP,110010,30,90,551,671,
Cherokee,State Treasurer,Charles De Coune,IND,110010,13,56,260,329,
Cherokee,Superintendent of Public Instruction,Joy Hofmeister,REP,110010,27,67,437,531,
Cherokee,Superintendent of Public Instruction,John Cox,DEM,110010,20,81,362,463,
Cherokee,Superintendent of Public Instruction,Larry Huff,IND,110010,1,9,64,74,
Cherokee,Commissioner of Labor,Leslie Osborn,REP,110010,21,74,456,551,
Cherokee,Commissioner of Labor,Fred Dorrell,DEM,110010,25,79,347,451,
Cherokee,Commissioner of Labor,Brandt Dismukes,IND,110010,2,3,51,56,
Cherokee,Insurance Commissioner,Glen Mulready,REP,110010,23,75,477,575,
Cherokee,Insurance Commissioner,Kimberly Fobbs,DEM,110010,25,81,376,482,
Cherokee,Corporation Commissioner,Bob Anthony,REP,110010,27,70,463,560,
Cherokee,Corporation Commissioner,Ashley Nicole Mccray,DEM,110010,19,79,344,442,
Cherokee,Corporation Commissioner,Jackie Short,IND,110010,2,7,54,63,
Cherokee,U.S. House,Richard Castaldo,LIB,110010,1,3,18,22,2
Cherokee,U.S. House,Markwayne Mullin,REP,110010,24,66,463,553,2
Cherokee,U.S. House,Jason Nichols,DEM,110010,22,84,352,458,2
Cherokee,U.S. House,John Foreman,IND,110010,1,4,34,39,2
Cherokee,Governor,Chris Powell,LIB,110011,0,4,13,17,
Cherokee,Governor,Kevin Stitt,REP,110011,4,28,126,158,
Cherokee,Governor,Drew Edmondson,DEM,110011,8,26,102,136,
Cherokee,Lieutenant Governor,Matt Pinnell,REP,110011,4,34,139,177,
Cherokee,Lieutenant Governor,Anastasia Pittman,DEM,110011,8,19,88,115,
Cherokee,Lieutenant Governor,Ivan Holmes,IND,110011,0,4,14,18,
Cherokee,State Auditor,John Yeutter,LIB,110011,6,21,69,96,
Cherokee,State Auditor,Cindy Byrd,REP,110011,4,34,145,183,
Cherokee,Attorney General,Mike Hunter,REP,110011,3,32,136,171,
Cherokee,Attorney General,Mark Myles,DEM,110011,9,25,99,133,
Cherokee,State Treasurer,Randy Mcdaniel,REP,110011,4,37,155,196,
Cherokee,State Treasurer,Charles De Coune,IND,110011,6,19,63,88,
Cherokee,Superintendent of Public Instruction,Joy Hofmeister,REP,110011,3,17,83,103,
Cherokee,Superintendent of Public Instruction,John Cox,DEM,110011,7,36,136,179,
Cherokee,Superintendent of Public Instruction,Larry Huff,IND,110011,2,5,21,28,
Cherokee,Commissioner of Labor,Leslie Osborn,REP,110011,3,34,116,153,
Cherokee,Commissioner of Labor,Fred Dorrell,DEM,110011,8,18,112,138,
Cherokee,Commissioner of Labor,Brandt Dismukes,IND,110011,0,3,9,12,
Cherokee,Insurance Commissioner,Glen Mulready,REP,110011,4,32,132,168,
Cherokee,Insurance Commissioner,Kimberly Fobbs,DEM,110011,8,22,105,135,
Cherokee,Corporation Commissioner,Bob Anthony,REP,110011,4,29,139,172,
Cherokee,Corporation Commissioner,Ashley Nicole Mccray,DEM,110011,8,22,89,119,
Cherokee,Corporation Commissioner,Jackie Short,IND,110011,0,5,10,15,
Cherokee,U.S. House,Richard Castaldo,LIB,110011,0,1,5,6,2
Cherokee,U.S. House,Markwayne Mullin,REP,110011,3,31,126,160,2
Cherokee,U.S. House,Jason Nichols,DEM,110011,9,23,97,129,2
Cherokee,U.S. House,John Foreman,IND,110011,0,2,12,14,2
Cherokee,State Senate,Kim David,REP,110011,2,28,112,142,18
Cherokee,State Senate,Charles Arnall,DEM,110011,10,28,126,164,18
Cherokee,Governor,Chris Powell,LIB,110012,1,11,43,55,
Cherokee,Governor,Kevin Stitt,REP,110012,8,83,332,423,
Cherokee,Governor,Drew Edmondson,DEM,110012,10,76,252,338,
Cherokee,Lieutenant Governor,Matt Pinnell,REP,110012,10,102,362,474,
Cherokee,Lieutenant Governor,Anastasia Pittman,DEM,110012,9,59,224,292,
Cherokee,Lieutenant Governor,Ivan Holmes,IND,110012,0,8,35,43,
Cherokee,State Auditor,John Yeutter,LIB,110012,6,66,215,287,
Cherokee,State Auditor,Cindy Byrd,REP,110012,11,91,366,468,
Cherokee,Attorney General,Mike Hunter,REP,110012,11,94,392,497,
Cherokee,Attorney General,Mark Myles,DEM,110012,8,72,227,307,
Cherokee,State Treasurer,Randy Mcdaniel,REP,110012,11,103,391,505,
Cherokee,State Treasurer,Charles De Coune,IND,110012,6,53,178,237,
Cherokee,Superintendent of Public Instruction,Joy Hofmeister,REP,110012,10,63,296,369,
Cherokee,Superintendent of Public Instruction,John Cox,DEM,110012,9,85,270,364,
Cherokee,Superintendent of Public Instruction,Larry Huff,IND,110012,0,22,56,78,
Cherokee,Commissioner of Labor,Leslie Osborn,REP,110012,9,81,347,437,
Cherokee,Commissioner of Labor,Fred Dorrell,DEM,110012,8,70,232,310,
Cherokee,Commissioner of Labor,Brandt Dismukes,IND,110012,1,16,34,51,
Cherokee,Insurance Commissioner,Glen Mulready,REP,110012,9,91,370,470,
Cherokee,Insurance Commissioner,Kimberly Fobbs,DEM,110012,9,75,245,329,
Cherokee,Corporation Commissioner,Bob Anthony,REP,110012,10,90,341,441,
Cherokee,Corporation Commissioner,Ashley Nicole Mccray,DEM,110012,9,68,233,310,
Cherokee,Corporation Commissioner,Jackie Short,IND,110012,0,10,44,54,
Cherokee,U.S. House,Richard Castaldo,LIB,110012,0,4,25,29,2
Cherokee,U.S. House,Markwayne Mullin,REP,110012,11,86,330,427,2
Cherokee,U.S. House,Jason Nichols,DEM,110012,8,63,242,313,2
Cherokee,U.S. House,John Foreman,IND,110012,0,16,27,43,2
Cherokee,State House,David Hardin,REP,110012,8,77,338,423,86
Cherokee,State House,Rhonda Cox,DEM,110012,10,90,277,377,86
Cherokee,Governor,Chris Powell,LIB,110013,0,1,22,23,
Cherokee,Governor,Kevin Stitt,REP,110013,5,41,173,219,
Cherokee,Governor,Drew Edmondson,DEM,110013,10,42,183,235,
Cherokee,Lieutenant Governor,Matt Pinnell,REP,110013,7,41,198,246,
Cherokee,Lieutenant Governor,Anastasia Pittman,DEM,110013,7,38,160,205,
Cherokee,Lieutenant Governor,Ivan Holmes,IND,110013,1,4,17,22,
Cherokee,State Auditor,John Yeutter,LIB,110013,4,34,157,195,
Cherokee,State Auditor,Cindy Byrd,REP,110013,8,41,199,248,
Cherokee,Attorney General,Mike Hunter,REP,110013,7,41,203,251,
Cherokee,Attorney General,Mark Myles,DEM,110013,8,42,172,222,
Cherokee,State Treasurer,Randy Mcdaniel,REP,110013,8,47,208,263,
Cherokee,State Treasurer,Charles De Coune,IND,110013,3,25,142,170,
Cherokee,Superintendent of Public Instruction,Joy Hofmeister,REP,110013,5,32,153,190,
Cherokee,Superintendent of Public Instruction,John Cox,DEM,110013,10,48,202,260,
Cherokee,Superintendent of Public Instruction,Larry Huff,IND,110013,0,4,21,25,
Cherokee,Commissioner of Labor,Leslie Osborn,REP,110013,6,36,173,215,
Cherokee,Commissioner of Labor,Fred Dorrell,DEM,110013,9,40,183,232,
Cherokee,Commissioner of Labor,Brandt Dismukes,IND,110013,0,6,16,22,
Cherokee,Insurance Commissioner,Glen Mulready,REP,110013,6,38,186,230,
Cherokee,Insurance Commissioner,Kimberly Fobbs,DEM,110013,9,44,188,241,
Cherokee,Corporation Commissioner,Bob Anthony,REP,110013,8,39,181,228,
Cherokee,Corporation Commissioner,Ashley Nicole Mccray,DEM,110013,7,40,176,223,
Cherokee,Corporation Commissioner,Jackie Short,IND,110013,0,4,16,20,
Cherokee,U.S. House,Richard Castaldo,LIB,110013,0,1,10,11,2
Cherokee,U.S. House,Markwayne Mullin,REP,110013,7,42,174,223,2
Cherokee,U.S. House,Jason Nichols,DEM,110013,8,39,175,222,2
Cherokee,U.S. House,John Foreman,IND,110013,0,2,20,22,2
Cherokee,Governor,Chris Powell,LIB,110014,1,3,25,29,
Cherokee,Governor,Kevin Stitt,REP,110014,34,25,310,369,
Cherokee,Governor,Drew Edmondson,DEM,110014,8,23,272,303,
Cherokee,Lieutenant Governor,Matt Pinnell,REP,110014,36,26,336,398,
Cherokee,Lieutenant Governor,Anastasia Pittman,DEM,110014,6,24,255,285,
Cherokee,Lieutenant Governor,Ivan Holmes,IND,110014,1,1,13,15,
Cherokee,State Auditor,John Yeutter,LIB,110014,8,16,193,217,
Cherokee,State Auditor,Cindy Byrd,REP,110014,32,29,352,413,
Cherokee,Attorney General,Mike Hunter,REP,110014,33,26,362,421,
Cherokee,Attorney General,Mark Myles,DEM,110014,9,25,242,276,
Cherokee,State Treasurer,Randy Mcdaniel,REP,110014,34,27,359,420,
Cherokee,State Treasurer,Charles De Coune,IND,110014,6,16,184,206,
Cherokee,Superintendent of Public Instruction,Joy Hofmeister,REP,110014,31,21,283,335,
Cherokee,Superintendent of Public Instruction,John Cox,DEM,110014,8,24,276,308,
Cherokee,Superintendent of Public Instruction,Larry Huff,IND,110014,2,6,48,56,
Cherokee,Commissioner of Labor,Leslie Osborn,REP,110014,22,24,316,362,
Cherokee,Commissioner of Labor,Fred Dorrell,DEM,110014,9,23,255,287,
Cherokee,Commissioner of Labor,Brandt Dismukes,IND,110014,8,4,30,42,
Cherokee,Insurance Commissioner,Glen Mulready,REP,110014,33,25,326,384,
Cherokee,Insurance Commissioner,Kimberly Fobbs,DEM,110014,7,25,274,306,
Cherokee,Corporation Commissioner,Bob Anthony,REP,110014,29,24,328,381,
Cherokee,Corporation Commissioner,Ashley Nicole Mccray,DEM,110014,8,24,247,279,
Cherokee,Corporation Commissioner,Jackie Short,IND,110014,2,2,30,34,
Cherokee,U.S. House,Richard Castaldo,LIB,110014,1,1,10,12,2
Cherokee,U.S. House,Markwayne Mullin,REP,110014,35,22,323,380,2
Cherokee,U.S. House,Jason Nichols,DEM,110014,6,25,263,294,2
Cherokee,U.S. House,John Foreman,IND,110014,1,3,12,16,2
Cherokee,State Senate,Kim David,REP,110014,35,23,299,357,18
Cherokee,State Senate,Charles Arnall,DEM,110014,8,27,305,340,18
Cherokee,State House,Chris Sneed,REP,110014,33,29,341,403,14
Cherokee,State House,Jack Reavis,DEM,110014,8,22,264,294,14
Cherokee,Governor,Chris Powell,LIB,110015,1,0,31,32,
Cherokee,Governor,Kevin Stitt,REP,110015,18,42,430,490,
Cherokee,Governor,Drew Edmondson,DEM,110015,13,21,270,304,
Cherokee,Lieutenant Governor,Matt Pinnell,REP,110015,19,42,490,551,
Cherokee,Lieutenant Governor,Anastasia Pittman,DEM,110015,13,21,208,242,
Cherokee,Lieutenant Governor,Ivan Holmes,IND,110015,0,0,31,31,
Cherokee,State Auditor,John Yeutter,LIB,110015,7,21,172,200,
Cherokee,State Auditor,Cindy Byrd,REP,110015,22,37,521,580,
Cherokee,Attorney General,Mike Hunter,REP,110015,17,40,501,558,
Cherokee,Attorney General,Mark Myles,DEM,110015,15,23,222,260,
Cherokee,State Treasurer,Randy Mcdaniel,REP,110015,20,43,518,581,
Cherokee,State Treasurer,Charles De Coune,IND,110015,9,16,171,196,
Cherokee,Superintendent of Public Instruction,Joy Hofmeister,REP,110015,18,35,402,455,
Cherokee,Superintendent of Public Instruction,John Cox,DEM,110015,11,24,263,298,
Cherokee,Superintendent of Public Instruction,Larry Huff,IND,110015,2,4,64,70,
Cherokee,Commissioner of Labor,Leslie Osborn,REP,110015,21,41,458,520,
Cherokee,Commissioner of Labor,Fred Dorrell,DEM,110015,10,21,225,256,
Cherokee,Commissioner of Labor,Brandt Dismukes,IND,110015,0,1,41,42,
Cherokee,Insurance Commissioner,Glen Mulready,REP,110015,20,41,475,536,
Cherokee,Insurance Commissioner,Kimberly Fobbs,DEM,110015,11,22,244,277,
Cherokee,Corporation Commissioner,Bob Anthony,REP,110015,18,40,476,534,
Cherokee,Corporation Commissioner,Ashley Nicole Mccray,DEM,110015,13,22,213,248,
Cherokee,Corporation Commissioner,Jackie Short,IND,110015,1,1,34,36,
Cherokee,U.S. House,Richard Castaldo,LIB,110015,2,0,13,15,2
Cherokee,U.S. House,Markwayne Mullin,REP,110015,17,41,456,514,2
Cherokee,U.S. House,Jason Nichols,DEM,110015,13,21,235,269,2
Cherokee,U.S. House,John Foreman,IND,110015,0,1,28,29,2
Cherokee,State Senate,Kim David,REP,110015,22,41,472,535,18
Cherokee,State Senate,Charles Arnall,DEM,110015,10,22,256,288,18
Cherokee,State House,Chris Sneed,REP,110015,19,42,448,509,14
Cherokee,State House,Jack Reavis,DEM,110015,13,21,278,312,14
Cherokee,Governor,Chris Powell,LIB,110016,1,2,10,13,
Cherokee,Governor,Kevin Stitt,REP,110016,3,14,130,147,
Cherokee,Governor,Drew Edmondson,DEM,110016,2,8,106,116,
Cherokee,Lieutenant Governor,Matt Pinnell,REP,110016,4,13,140,157,
Cherokee,Lieutenant Governor,Anastasia Pittman,DEM,110016,2,6,89,97,
Cherokee,Lieutenant Governor,Ivan Holmes,IND,110016,0,5,16,21,
Cherokee,State Auditor,John Yeutter,LIB,110016,3,6,75,84,
Cherokee,State Auditor,Cindy Byrd,REP,110016,3,16,148,167,
Cherokee,Attorney General,Mike Hunter,REP,110016,3,14,138,155,
Cherokee,Attorney General,Mark Myles,DEM,110016,3,9,102,114,
Cherokee,State Treasurer,Randy Mcdaniel,REP,110016,3,16,153,172,
Cherokee,State Treasurer,Charles De Coune,IND,110016,3,6,70,79,
Cherokee,Superintendent of Public Instruction,Joy Hofmeister,REP,110016,3,7,101,111,
Cherokee,Superintendent of Public Instruction,John Cox,DEM,110016,3,15,128,146,
Cherokee,Superintendent of Public Instruction,Larry Huff,IND,110016,0,2,19,21,
Cherokee,Commissioner of Labor,Leslie Osborn,REP,110016,3,12,123,138,
Cherokee,Commissioner of Labor,Fred Dorrell,DEM,110016,1,10,101,112,
Cherokee,Commissioner of Labor,Brandt Dismukes,IND,110016,2,1,14,17,
Cherokee,Insurance Commissioner,Glen Mulready,REP,110016,3,14,130,147,
Cherokee,Insurance Commissioner,Kimberly Fobbs,DEM,110016,3,9,111,123,
Cherokee,Corporation Commissioner,Bob Anthony,REP,110016,3,13,122,138,
Cherokee,Corporation Commissioner,Ashley Nicole Mccray,DEM,110016,3,9,105,117,
Cherokee,Corporation Commissioner,Jackie Short,IND,110016,0,1,13,14,
Cherokee,U.S. House,Richard Castaldo,LIB,110016,0,1,11,12,2
Cherokee,U.S. House,Markwayne Mullin,REP,110016,3,13,125,141,2
Cherokee,U.S. House,Jason Nichols,DEM,110016,2,9,98,109,2
Cherokee,U.S. House,John Foreman,IND,110016,1,1,10,12,2
Cherokee,State House,David Hardin,REP,110016,3,8,114,125,86
Cherokee,State House,Rhonda Cox,DEM,110016,3,16,132,151,86
Cherokee,Governor,Chris Powell,LIB,110017,0,2,6,8,
Cherokee,Governor,Kevin Stitt,REP,110017,1,14,101,116,
Cherokee,Governor,Drew Edmondson,DEM,110017,5,18,100,123,
Cherokee,Lieutenant Governor,Matt Pinnell,REP,110017,1,15,110,126,
Cherokee,Lieutenant Governor,Anastasia Pittman,DEM,110017,5,17,88,110,
Cherokee,Lieutenant Governor,Ivan Holmes,IND,110017,0,2,7,9,
Cherokee,State Auditor,John Yeutter,LIB,110017,2,18,83,103,
Cherokee,State Auditor,Cindy Byrd,REP,110017,3,14,116,133,
Cherokee,Attorney General,Mike Hunter,REP,110017,3,16,119,138,
Cherokee,Attorney General,Mark Myles,DEM,110017,3,18,87,108,
Cherokee,State Treasurer,Randy Mcdaniel,REP,110017,3,15,126,144,
Cherokee,State Treasurer,Charles De Coune,IND,110017,2,17,70,89,
Cherokee,Superintendent of Public Instruction,Joy Hofmeister,REP,110017,1,10,85,96,
Cherokee,Superintendent of Public Instruction,John Cox,DEM,110017,5,20,100,125,
Cherokee,Superintendent of Public Instruction,Larry Huff,IND,110017,0,4,22,26,
Cherokee,Commissioner of Labor,Leslie Osborn,REP,110017,1,13,109,123,
Cherokee,Commissioner of Labor,Fred Dorrell,DEM,110017,5,17,85,107,
Cherokee,Commissioner of Labor,Brandt Dismukes,IND,110017,0,4,12,16,
Cherokee,Insurance Commissioner,Glen Mulready,REP,110017,1,14,112,127,
Cherokee,Insurance Commissioner,Kimberly Fobbs,DEM,110017,5,20,93,118,
Cherokee,Corporation Commissioner,Bob Anthony,REP,110017,0,12,93,105,
Cherokee,Corporation Commissioner,Ashley Nicole Mccray,DEM,110017,6,19,101,126,
Cherokee,Corporation Commissioner,Jackie Short,IND,110017,0,3,11,14,
Cherokee,U.S. House,Richard Castaldo,LIB,110017,0,0,8,8,2
Cherokee,U.S. House,Markwayne Mullin,REP,110017,3,14,107,124,2
Cherokee,U.S. House,Jason Nichols,DEM,110017,3,20,89,112,2
Cherokee,U.S. House,John Foreman,IND,110017,0,0,4,4,2
Cherokee,Governor,Chris Powell,LIB,110018,0,2,6,8,
Cherokee,Governor,Kevin Stitt,REP,110018,5,15,96,116,
Cherokee,Governor,Drew Edmondson,DEM,110018,3,6,72,81,
Cherokee,Lieutenant Governor,Matt Pinnell,REP,110018,7,17,109,133,
Cherokee,Lieutenant Governor,Anastasia Pittman,DEM,110018,1,5,56,62,
Cherokee,Lieutenant Governor,Ivan Holmes,IND,110018,0,1,9,10,
Cherokee,State Auditor,John Yeutter,LIB,110018,0,6,57,63,
Cherokee,State Auditor,Cindy Byrd,REP,110018,7,16,104,127,
Cherokee,Attorney General,Mike Hunter,REP,110018,7,13,119,139,
Cherokee,Attorney General,Mark Myles,DEM,110018,1,8,54,63,
Cherokee,State Treasurer,Randy Mcdaniel,REP,110018,7,13,121,141,
Cherokee,State Treasurer,Charles De Coune,IND,110018,0,8,41,49,
Cherokee,Superintendent of Public Instruction,Joy Hofmeister,REP,110018,4,12,84,100,
Cherokee,Superintendent of Public Instruction,John Cox,DEM,110018,3,9,76,88,
Cherokee,Superintendent of Public Instruction,Larry Huff,IND,110018,1,1,14,16,
Cherokee,Commissioner of Labor,Leslie Osborn,REP,110018,7,13,105,125,
Cherokee,Commissioner of Labor,Fred Dorrell,DEM,110018,1,5,61,67,
Cherokee,Commissioner of Labor,Brandt Dismukes,IND,110018,0,3,7,10,
Cherokee,Insurance Commissioner,Glen Mulready,REP,110018,7,14,107,128,
Cherokee,Insurance Commissioner,Kimberly Fobbs,DEM,110018,1,7,65,73,
Cherokee,Corporation Commissioner,Bob Anthony,REP,110018,6,13,108,127,
Cherokee,Corporation Commissioner,Ashley Nicole Mccray,DEM,110018,1,7,55,63,
Cherokee,Corporation Commissioner,Jackie Short,IND,110018,1,1,10,12,
Cherokee,U.S. House,Richard Castaldo,LIB,110018,0,0,4,4,2
Cherokee,U.S. House,Markwayne Mullin,REP,110018,7,17,99,123,2
Cherokee,U.S. House,Jason Nichols,DEM,110018,1,6,66,73,2
Cherokee,U.S. House,John Foreman,IND,110018,0,0,4,4,2
Cherokee,State House,David Hardin,REP,110018,6,14,95,115,86
Cherokee,State House,Rhonda Cox,DEM,110018,2,9,77,88,86
Cherokee,Governor,Chris Powell,LIB,110019,0,3,22,25,
Cherokee,Governor,Kevin Stitt,REP,110019,10,41,189,240,
Cherokee,Governor,Drew Edmondson,DEM,110019,8,40,204,252,
Cherokee,Lieutenant Governor,Matt Pinnell,REP,110019,13,45,227,285,
Cherokee,Lieutenant Governor,Anastasia Pittman,DEM,110019,5,37,168,210,
Cherokee,Lieutenant Governor,Ivan Holmes,IND,110019,0,2,21,23,
Cherokee,State Auditor,John Yeutter,LIB,110019,4,27,161,192,
Cherokee,State Auditor,Cindy Byrd,REP,110019,14,50,235,299,
Cherokee,Attorney General,Mike Hunter,REP,110019,14,49,239,302,
Cherokee,Attorney General,Mark Myles,DEM,110019,4,34,176,214,
Cherokee,State Treasurer,Randy Mcdaniel,REP,110019,14,51,251,316,
Cherokee,State Treasurer,Charles De Coune,IND,110019,3,23,142,168,
Cherokee,Superintendent of Public Instruction,Joy Hofmeister,REP,110019,7,34,186,227,
Cherokee,Superintendent of Public Instruction,John Cox,DEM,110019,10,42,199,251,
Cherokee,Superintendent of Public Instruction,Larry Huff,IND,110019,1,5,32,38,
Cherokee,Commissioner of Labor,Leslie Osborn,REP,110019,12,43,221,276,
Cherokee,Commissioner of Labor,Fred Dorrell,DEM,110019,5,38,176,219,
Cherokee,Commissioner of Labor,Brandt Dismukes,IND,110019,0,1,17,18,
Cherokee,Insurance Commissioner,Glen Mulready,REP,110019,11,44,233,288,
Cherokee,Insurance Commissioner,Kimberly Fobbs,DEM,110019,5,39,178,222,
Cherokee,Corporation Commissioner,Bob Anthony,REP,110019,8,41,216,265,
Cherokee,Corporation Commissioner,Ashley Nicole Mccray,DEM,110019,6,40,165,211,
Cherokee,Corporation Commissioner,Jackie Short,IND,110019,2,2,33,37,
Cherokee,U.S. House,Richard Castaldo,LIB,110019,0,1,12,13,2
Cherokee,U.S. House,Markwayne Mullin,REP,110019,13,39,218,270,2
Cherokee,U.S. House,Jason Nichols,DEM,110019,5,41,176,222,2
Cherokee,U.S. House,John Foreman,IND,110019,0,2,11,13,2
Cherokee,State Senate,Kim David,REP,110019,9,40,205,254,18
Cherokee,State Senate,Charles Arnall,DEM,110019,9,43,210,262,18
Cherokee,Governor,Chris Powell,LIB,110020,2,4,26,32,
Cherokee,Governor,Kevin Stitt,REP,110020,24,81,231,336,
Cherokee,Governor,Drew Edmondson,DEM,110020,14,122,291,427,
Cherokee,Lieutenant Governor,Matt Pinnell,REP,110020,26,92,279,397,
Cherokee,Lieutenant Governor,Anastasia Pittman,DEM,110020,11,108,239,358,
Cherokee,Lieutenant Governor,Ivan Holmes,IND,110020,3,5,27,35,
Cherokee,State Auditor,John Yeutter,LIB,110020,13,87,211,311,
Cherokee,State Auditor,Cindy Byrd,REP,110020,24,102,296,422,
Cherokee,Attorney General,Mike Hunter,REP,110020,25,93,279,397,
Cherokee,Attorney General,Mark Myles,DEM,110020,15,109,262,386,
Cherokee,State Treasurer,Randy Mcdaniel,REP,110020,25,113,289,427,
Cherokee,State Treasurer,Charles De Coune,IND,110020,12,76,220,308,
Cherokee,Superintendent of Public Instruction,Joy Hofmeister,REP,110020,26,88,242,356,
Cherokee,Superintendent of Public Instruction,John Cox,DEM,110020,12,106,265,383,
Cherokee,Superintendent of Public Instruction,Larry Huff,IND,110020,2,9,37,48,
Cherokee,Commissioner of Labor,Leslie Osborn,REP,110020,25,87,256,368,
Cherokee,Commissioner of Labor,Fred Dorrell,DEM,110020,13,107,245,365,
Cherokee,Commissioner of Labor,Brandt Dismukes,IND,110020,2,7,34,43,
Cherokee,Insurance Commissioner,Glen Mulready,REP,110020,26,85,272,383,
Cherokee,Insurance Commissioner,Kimberly Fobbs,DEM,110020,13,116,261,390,
Cherokee,Corporation Commissioner,Bob Anthony,REP,110020,24,86,263,373,
Cherokee,Corporation Commissioner,Ashley Nicole Mccray,DEM,110020,14,103,242,359,
Cherokee,Corporation Commissioner,Jackie Short,IND,110020,1,14,31,46,
Cherokee,U.S. House,Richard Castaldo,LIB,110020,1,6,10,17,2
Cherokee,U.S. House,Markwayne Mullin,REP,110020,22,79,239,340,2
Cherokee,U.S. House,Jason Nichols,DEM,110020,17,118,272,407,2
Cherokee,U.S. House,John Foreman,IND,110020,0,4,23,27,2
Cherokee,Governor,Chris Powell,LIB,110021,0,0,9,9,
Cherokee,Governor,Kevin Stitt,REP,110021,10,12,156,178,
Cherokee,Governor,Drew Edmondson,DEM,110021,5,14,113,132,
Cherokee,Lieutenant Governor,Matt Pinnell,REP,110021,11,14,173,198,
Cherokee,Lieutenant Governor,Anastasia Pittman,DEM,110021,4,10,81,95,
Cherokee,Lieutenant Governor,Ivan Holmes,IND,110021,0,2,14,16,
Cherokee,State Auditor,John Yeutter,LIB,110021,4,16,93,113,
Cherokee,State Auditor,Cindy Byrd,REP,110021,10,10,173,193,
Cherokee,Attorney General,Mike Hunter,REP,110021,10,14,187,211,
Cherokee,Attorney General,Mark Myles,DEM,110021,5,12,84,101,
Cherokee,State Treasurer,Randy Mcdaniel,REP,110021,11,13,191,215,
Cherokee,State Treasurer,Charles De Coune,IND,110021,3,13,70,86,
Cherokee,Superintendent of Public Instruction,Joy Hofmeister,REP,110021,11,13,129,153,
Cherokee,Superintendent of Public Instruction,John Cox,DEM,110021,4,10,124,138,
Cherokee,Superintendent of Public Instruction,Larry Huff,IND,110021,0,3,20,23,
Cherokee,Commissioner of Labor,Leslie Osborn,REP,110021,10,12,146,168,
Cherokee,Commissioner of Labor,Fred Dorrell,DEM,110021,5,12,105,122,
Cherokee,Commissioner of Labor,Brandt Dismukes,IND,110021,0,2,15,17,
Cherokee,Insurance Commissioner,Glen Mulready,REP,110021,10,15,161,186,
Cherokee,Insurance Commissioner,Kimberly Fobbs,DEM,110021,4,11,107,122,
Cherokee,Corporation Commissioner,Bob Anthony,REP,110021,10,13,158,181,
Cherokee,Corporation Commissioner,Ashley Nicole Mccray,DEM,110021,5,12,92,109,
Cherokee,Corporation Commissioner,Jackie Short,IND,110021,0,1,18,19,
Cherokee,U.S. House,Richard Castaldo,LIB,110021,0,0,5,5,2
Cherokee,U.S. House,Markwayne Mullin,REP,110021,10,13,168,191,2
Cherokee,U.S. House,Jason Nichols,DEM,110021,5,11,90,106,2
Cherokee,U.S. House,John Foreman,IND,110021,0,2,14,16,2
Cherokee,Governor,Chris Powell,LIB,110022,0,4,7,11,
Cherokee,Governor,Kevin Stitt,REP,110022,0,11,94,105,
Cherokee,Governor,Drew Edmondson,DEM,110022,5,10,58,73,
Cherokee,Lieutenant Governor,Matt Pinnell,REP,110022,0,14,96,110,
Cherokee,Lieutenant Governor,Anastasia Pittman,DEM,110022,5,9,54,68,
Cherokee,Lieutenant Governor,Ivan Holmes,IND,110022,0,2,8,10,
Cherokee,State Auditor,John Yeutter,LIB,110022,5,7,45,57,
Cherokee,State Auditor,Cindy Byrd,REP,110022,0,14,105,119,
Cherokee,Attorney General,Mike Hunter,REP,110022,0,15,100,115,
Cherokee,Attorney General,Mark Myles,DEM,110022,5,10,58,73,
Cherokee,State Treasurer,Randy Mcdaniel,REP,110022,0,11,107,118,
Cherokee,State Treasurer,Charles De Coune,IND,110022,5,8,42,55,
Cherokee,Superintendent of Public Instruction,Joy Hofmeister,REP,110022,0,8,60,68,
Cherokee,Superintendent of Public Instruction,John Cox,DEM,110022,4,15,81,100,
Cherokee,Superintendent of Public Instruction,Larry Huff,IND,110022,1,2,17,20,
Cherokee,Commissioner of Labor,Leslie Osborn,REP,110022,1,11,88,100,
Cherokee,Commissioner of Labor,Fred Dorrell,DEM,110022,4,13,60,77,
Cherokee,Commissioner of Labor,Brandt Dismukes,IND,110022,0,1,10,11,
Cherokee,Insurance Commissioner,Glen Mulready,REP,110022,0,13,91,104,
Cherokee,Insurance Commissioner,Kimberly Fobbs,DEM,110022,5,12,67,84,
Cherokee,Corporation Commissioner,Bob Anthony,REP,110022,0,14,90,104,
Cherokee,Corporation Commissioner,Ashley Nicole Mccray,DEM,110022,5,11,54,70,
Cherokee,Corporation Commissioner,Jackie Short,IND,110022,0,0,13,13,
Cherokee,U.S. House,Richard Castaldo,LIB,110022,0,0,0,0,2
Cherokee,U.S. House,Markwayne Mullin,REP,110022,0,13,100,113,2
Cherokee,U.S. House,Jason Nichols,DEM,110022,5,11,55,71,2
Cherokee,U.S. House,John Foreman,IND,110022,0,1,4,5,2
Cherokee,Governor,Chris Powell,LIB,110023,0,3,6,9,
Cherokee,Governor,Kevin Stitt,REP,110023,4,31,80,115,
Cherokee,Governor,Drew Edmondson,DEM,110023,1,23,69,93,
Cherokee,Lieutenant Governor,Matt Pinnell,REP,110023,5,30,88,123,
Cherokee,Lieutenant Governor,Anastasia Pittman,DEM,110023,1,21,57,79,
Cherokee,Lieutenant Governor,Ivan Holmes,IND,110023,0,4,10,14,
Cherokee,State Auditor,John Yeutter,LIB,110023,2,20,42,64,
Cherokee,State Auditor,Cindy Byrd,REP,110023,4,33,101,138,
Cherokee,Attorney General,Mike Hunter,REP,110023,5,32,99,136,
Cherokee,Attorney General,Mark Myles,DEM,110023,1,23,55,79,
Cherokee,State Treasurer,Randy Mcdaniel,REP,110023,4,35,106,145,
Cherokee,State Treasurer,Charles De Coune,IND,110023,2,19,36,57,
Cherokee,Superintendent of Public Instruction,Joy Hofmeister,REP,110023,3,26,56,85,
Cherokee,Superintendent of Public Instruction,John Cox,DEM,110023,3,27,87,117,
Cherokee,Superintendent of Public Instruction,Larry Huff,IND,110023,0,4,13,17,
Cherokee,Commissioner of Labor,Leslie Osborn,REP,110023,5,32,87,124,
Cherokee,Commissioner of Labor,Fred Dorrell,DEM,110023,1,20,61,82,
Cherokee,Commissioner of Labor,Brandt Dismukes,IND,110023,0,2,6,8,
Cherokee,Insurance Commissioner,Glen Mulready,REP,110023,5,29,90,124,
Cherokee,Insurance Commissioner,Kimberly Fobbs,DEM,110023,1,26,63,90,
Cherokee,Corporation Commissioner,Bob Anthony,REP,110023,4,27,85,116,
Cherokee,Corporation Commissioner,Ashley Nicole Mccray,DEM,110023,2,23,56,81,
Cherokee,Corporation Commissioner,Jackie Short,IND,110023,0,5,12,17,
Cherokee,U.S. House,Richard Castaldo,LIB,110023,0,1,3,4,2
Cherokee,U.S. House,Markwayne Mullin,REP,110023,5,29,84,118,2
Cherokee,U.S. House,Jason Nichols,DEM,110023,1,24,60,85,2
Cherokee,U.S. House,John Foreman,IND,110023,0,2,8,10,2
Cherokee,Governor,Chris Powell,LIB,110025,0,5,23,28,
Cherokee,Governor,Kevin Stitt,REP,110025,4,41,156,201,
Cherokee,Governor,Drew Edmondson,DEM,110025,8,82,199,289,
Cherokee,Lieutenant Governor,Matt Pinnell,REP,110025,8,55,177,240,
Cherokee,Lieutenant Governor,Anastasia Pittman,DEM,110025,4,62,177,243,
Cherokee,Lieutenant Governor,Ivan Holmes,IND,110025,0,5,21,26,
Cherokee,State Auditor,John Yeutter,LIB,110025,5,54,131,190,
Cherokee,State Auditor,Cindy Byrd,REP,110025,7,65,218,290,
Cherokee,Attorney General,Mike Hunter,REP,110025,8,54,197,259,
Cherokee,Attorney General,Mark Myles,DEM,110025,4,70,177,251,
Cherokee,State Treasurer,Randy Mcdaniel,REP,110025,7,68,220,295,
Cherokee,State Treasurer,Charles De Coune,IND,110025,4,52,126,182,
Cherokee,Superintendent of Public Instruction,Joy Hofmeister,REP,110025,4,41,139,184,
Cherokee,Superintendent of Public Instruction,John Cox,DEM,110025,8,77,208,293,
Cherokee,Superintendent of Public Instruction,Larry Huff,IND,110025,0,6,31,37,
Cherokee,Commissioner of Labor,Leslie Osborn,REP,110025,7,50,165,222,
Cherokee,Commissioner of Labor,Fred Dorrell,DEM,110025,5,67,191,263,
Cherokee,Commissioner of Labor,Brandt Dismukes,IND,110025,0,7,17,24,
Cherokee,Insurance Commissioner,Glen Mulready,REP,110025,7,53,175,235,
Cherokee,Insurance Commissioner,Kimberly Fobbs,DEM,110025,5,72,193,270,
Cherokee,Corporation Commissioner,Bob Anthony,REP,110025,7,52,164,223,
Cherokee,Corporation Commissioner,Ashley Nicole Mccray,DEM,110025,5,67,186,258,
Cherokee,Corporation Commissioner,Jackie Short,IND,110025,0,6,23,29,
Cherokee,U.S. House,Richard Castaldo,LIB,110025,1,2,9,12,2
Cherokee,U.S. House,Markwayne Mullin,REP,110025,5,56,169,230,2
Cherokee,U.S. House,Jason Nichols,DEM,110025,6,62,178,246,2
Cherokee,U.S. House,John Foreman,IND,110025,0,2,20,22,2
Cherokee,State Senate,Kim David,REP,110025,3,37,130,170,18
Cherokee,State Senate,Charles Arnall,DEM,110025,9,89,246,344,18
Choctaw,Governor,Chris Powell,LIB,120101,0,0,13,13,
Choctaw,Governor,Kevin Stitt,REP,120101,4,20,284,308,
Choctaw,Governor,Drew Edmondson,DEM,120101,1,3,132,136,
Choctaw,Lieutenant Governor,Matt Pinnell,REP,120101,4,20,298,322,
Choctaw,Lieutenant Governor,Anastasia Pittman,DEM,120101,1,3,112,116,
Choctaw,Lieutenant Governor,Ivan Holmes,IND,120101,0,0,11,11,
Choctaw,State Auditor,John Yeutter,LIB,120101,1,1,76,78,
Choctaw,State Auditor,Cindy Byrd,REP,120101,4,20,321,345,
Choctaw,Attorney General,Mike Hunter,REP,120101,4,20,309,333,
Choctaw,Attorney General,Mark Myles,DEM,120101,1,3,115,119,
Choctaw,State Treasurer,Randy Mcdaniel,REP,120101,3,20,322,345,
Choctaw,State Treasurer,Charles De Coune,IND,120101,2,1,70,73,
Choctaw,Superintendent of Public Instruction,Joy Hofmeister,REP,120101,3,16,250,269,
Choctaw,Superintendent of Public Instruction,John Cox,DEM,120101,1,5,139,145,
Choctaw,Superintendent of Public Instruction,Larry Huff,IND,120101,1,1,31,33,
Choctaw,Commissioner of Labor,Leslie Osborn,REP,120101,3,19,287,309,
Choctaw,Commissioner of Labor,Fred Dorrell,DEM,120101,1,3,112,116,
Choctaw,Commissioner of Labor,Brandt Dismukes,IND,120101,1,1,19,21,
Choctaw,Insurance Commissioner,Glen Mulready,REP,120101,2,19,295,316,
Choctaw,Insurance Commissioner,Kimberly Fobbs,DEM,120101,2,4,123,129,
Choctaw,Corporation Commissioner,Bob Anthony,REP,120101,3,20,293,316,
Choctaw,Corporation Commissioner,Ashley Nicole Mccray,DEM,120101,2,2,105,109,
Choctaw,Corporation Commissioner,Jackie Short,IND,120101,0,1,23,24,
Choctaw,U.S. House,Richard Castaldo,LIB,120101,0,0,9,9,2
Choctaw,U.S. House,Markwayne Mullin,REP,120101,3,20,307,330,2
Choctaw,U.S. House,Jason Nichols,DEM,120101,1,3,103,107,2
Choctaw,U.S. House,John Foreman,IND,120101,1,0,10,11,2
Choctaw,State House,Justin Humphrey,REP,120101,3,19,284,306,19
Choctaw,State House,Lewis Collins,DEM,120101,2,4,142,148,19
Choctaw,Governor,Chris Powell,LIB,120104,0,3,19,22,
Choctaw,Governor,Kevin Stitt,REP,120104,9,28,263,300,
Choctaw,Governor,Drew Edmondson,DEM,120104,0,17,102,119,
Choctaw,Lieutenant Governor,Matt Pinnell,REP,120104,9,31,284,324,
Choctaw,Lieutenant Governor,Anastasia Pittman,DEM,120104,0,15,78,93,
Choctaw,Lieutenant Governor,Ivan Holmes,IND,120104,0,1,19,20,
Choctaw,State Auditor,John Yeutter,LIB,120104,0,10,52,62,
Choctaw,State Auditor,Cindy Byrd,REP,120104,9,32,310,351,
Choctaw,Attorney General,Mike Hunter,REP,120104,9,30,283,322,
Choctaw,Attorney General,Mark Myles,DEM,120104,0,17,96,113,
Choctaw,State Treasurer,Randy Mcdaniel,REP,120104,9,30,297,336,
Choctaw,State Treasurer,Charles De Coune,IND,120104,0,12,65,77,
Choctaw,Superintendent of Public Instruction,Joy Hofmeister,REP,120104,9,28,247,284,
Choctaw,Superintendent of Public Instruction,John Cox,DEM,120104,0,15,95,110,
Choctaw,Superintendent of Public Instruction,Larry Huff,IND,120104,0,5,37,42,
Choctaw,Commissioner of Labor,Leslie Osborn,REP,120104,9,28,266,303,
Choctaw,Commissioner of Labor,Fred Dorrell,DEM,120104,0,15,90,105,
Choctaw,Commissioner of Labor,Brandt Dismukes,IND,120104,0,4,24,28,
Choctaw,Insurance Commissioner,Glen Mulready,REP,120104,9,31,276,316,
Choctaw,Insurance Commissioner,Kimberly Fobbs,DEM,120104,0,15,104,119,
Choctaw,Corporation Commissioner,Bob Anthony,REP,120104,9,29,263,301,
Choctaw,Corporation Commissioner,Ashley Nicole Mccray,DEM,120104,0,15,85,100,
Choctaw,Corporation Commissioner,Jackie Short,IND,120104,0,3,31,34,
Choctaw,U.S. House,Richard Castaldo,LIB,120104,0,3,8,11,2
Choctaw,U.S. House,Markwayne Mullin,REP,120104,9,30,285,324,2
Choctaw,U.S. House,Jason Nichols,DEM,120104,0,14,74,88,2
Choctaw,U.S. House,John Foreman,IND,120104,0,1,17,18,2
Choctaw,State House,Justin Humphrey,REP,120104,9,32,265,306,19
Choctaw,State House,Lewis Collins,DEM,120104,0,16,121,137,19
Choctaw,Governor,Chris Powell,LIB,120105,0,1,2,3,
Choctaw,Governor,Kevin Stitt,REP,120105,0,4,29,33,
Choctaw,Governor,Drew Edmondson,DEM,120105,0,12,85,97,
Choctaw,Lieutenant Governor,Matt Pinnell,REP,120105,0,8,27,35,
Choctaw,Lieutenant Governor,Anastasia Pittman,DEM,120105,0,10,83,93,
Choctaw,Lieutenant Governor,Ivan Holmes,IND,120105,0,0,5,5,
Choctaw,State Auditor,John Yeutter,LIB,120105,0,5,49,54,
Choctaw,State Auditor,Cindy Byrd,REP,120105,0,9,42,51,
Choctaw,Attorney General,Mike Hunter,REP,120105,0,7,33,40,
Choctaw,Attorney General,Mark Myles,DEM,120105,0,11,83,94,
Choctaw,State Treasurer,Randy Mcdaniel,REP,120105,0,8,41,49,
Choctaw,State Treasurer,Charles De Coune,IND,120105,0,6,51,57,
Choctaw,Superintendent of Public Instruction,Joy Hofmeister,REP,120105,0,6,27,33,
Choctaw,Superintendent of Public Instruction,John Cox,DEM,120105,0,12,80,92,
Choctaw,Superintendent of Public Instruction,Larry Huff,IND,120105,0,0,9,9,
Choctaw,Commissioner of Labor,Leslie Osborn,REP,120105,0,7,30,37,
Choctaw,Commissioner of Labor,Fred Dorrell,DEM,120105,0,11,82,93,
Choctaw,Commissioner of Labor,Brandt Dismukes,IND,120105,0,0,4,4,
Choctaw,Insurance Commissioner,Glen Mulready,REP,120105,0,7,29,36,
Choctaw,Insurance Commissioner,Kimberly Fobbs,DEM,120105,0,11,87,98,
Choctaw,Corporation Commissioner,Bob Anthony,REP,120105,0,7,28,35,
Choctaw,Corporation Commissioner,Ashley Nicole Mccray,DEM,120105,0,10,77,87,
Choctaw,Corporation Commissioner,Jackie Short,IND,120105,0,1,10,11,
Choctaw,U.S. House,Richard Castaldo,LIB,120105,0,0,1,1,2
Choctaw,U.S. House,Markwayne Mullin,REP,120105,0,8,35,43,2
Choctaw,U.S. House,Jason Nichols,DEM,120105,0,10,74,84,2
Choctaw,U.S. House,John Foreman,IND,120105,0,0,6,6,2
Choctaw,State House,Justin Humphrey,REP,120105,0,6,31,37,19
Choctaw,State House,Lewis Collins,DEM,120105,0,12,85,97,19
Choctaw,Governor,Chris Powell,LIB,120106,0,0,6,6,
Choctaw,Governor,Kevin Stitt,REP,120106,3,8,121,132,
Choctaw,Governor,Drew Edmondson,DEM,120106,3,7,66,76,
Choctaw,Lieutenant Governor,Matt Pinnell,REP,120106,2,10,123,135,
Choctaw,Lieutenant Governor,Anastasia Pittman,DEM,120106,3,6,57,66,
Choctaw,Lieutenant Governor,Ivan Holmes,IND,120106,1,0,9,10,
Choctaw,State Auditor,John Yeutter,LIB,120106,2,5,33,40,
Choctaw,State Auditor,Cindy Byrd,REP,120106,2,8,139,149,
Choctaw,Attorney General,Mike Hunter,REP,120106,3,10,131,144,
Choctaw,Attorney General,Mark Myles,DEM,120106,3,6,58,67,
Choctaw,State Treasurer,Randy Mcdaniel,REP,120106,4,8,140,152,
Choctaw,State Treasurer,Charles De Coune,IND,120106,0,5,32,37,
Choctaw,Superintendent of Public Instruction,Joy Hofmeister,REP,120106,2,8,119,129,
Choctaw,Superintendent of Public Instruction,John Cox,DEM,120106,3,7,53,63,
Choctaw,Superintendent of Public Instruction,Larry Huff,IND,120106,1,1,16,18,
Choctaw,Commissioner of Labor,Leslie Osborn,REP,120106,2,9,124,135,
Choctaw,Commissioner of Labor,Fred Dorrell,DEM,120106,3,7,54,64,
Choctaw,Commissioner of Labor,Brandt Dismukes,IND,120106,1,0,9,10,
Choctaw,Insurance Commissioner,Glen Mulready,REP,120106,3,9,123,135,
Choctaw,Insurance Commissioner,Kimberly Fobbs,DEM,120106,3,6,64,73,
Choctaw,Corporation Commissioner,Bob Anthony,REP,120106,3,9,118,130,
Choctaw,Corporation Commissioner,Ashley Nicole Mccray,DEM,120106,3,7,60,70,
Choctaw,Corporation Commissioner,Jackie Short,IND,120106,0,0,10,10,
Choctaw,U.S. House,Richard Castaldo,LIB,120106,1,0,4,5,2
Choctaw,U.S. House,Markwayne Mullin,REP,120106,3,8,132,143,2
Choctaw,U.S. House,Jason Nichols,DEM,120106,1,8,47,56,2
Choctaw,U.S. House,John Foreman,IND,120106,1,0,10,11,2
Choctaw,State House,Justin Humphrey,REP,120106,1,9,103,113,19
Choctaw,State House,Lewis Collins,DEM,120106,5,7,88,100,19
Choctaw,Governor,Chris Powell,LIB,120207,0,0,6,6,
Choctaw,Governor,Kevin Stitt,REP,120207,1,1,53,55,
Choctaw,Governor,Drew Edmondson,DEM,120207,0,0,22,22,
Choctaw,Lieutenant Governor,Matt Pinnell,REP,120207,1,1,54,56,
Choctaw,Lieutenant Governor,Anastasia Pittman,DEM,120207,0,0,24,24,
Choctaw,Lieutenant Governor,Ivan Holmes,IND,120207,0,0,3,3,
Choctaw,State Auditor,John Yeutter,LIB,120207,0,0,22,22,
Choctaw,State Auditor,Cindy Byrd,REP,120207,1,1,53,55,
Choctaw,Attorney General,Mike Hunter,REP,120207,1,1,60,62,
Choctaw,Attorney General,Mark Myles,DEM,120207,0,0,22,22,
Choctaw,State Treasurer,Randy Mcdaniel,REP,120207,1,1,59,61,
Choctaw,State Treasurer,Charles De Coune,IND,120207,0,0,16,16,
Choctaw,Superintendent of Public Instruction,Joy Hofmeister,REP,120207,1,1,46,48,
Choctaw,Superintendent of Public Instruction,John Cox,DEM,120207,0,0,29,29,
Choctaw,Superintendent of Public Instruction,Larry Huff,IND,120207,0,0,6,6,
Choctaw,Commissioner of Labor,Leslie Osborn,REP,120207,1,1,54,56,
Choctaw,Commissioner of Labor,Fred Dorrell,DEM,120207,0,0,22,22,
Choctaw,Commissioner of Labor,Brandt Dismukes,IND,120207,0,0,5,5,
Choctaw,Insurance Commissioner,Glen Mulready,REP,120207,1,1,54,56,
Choctaw,Insurance Commissioner,Kimberly Fobbs,DEM,120207,0,0,26,26,
Choctaw,Corporation Commissioner,Bob Anthony,REP,120207,1,1,54,56,
Choctaw,Corporation Commissioner,Ashley Nicole Mccray,DEM,120207,0,0,21,21,
Choctaw,Corporation Commissioner,Jackie Short,IND,120207,0,0,6,6,
Choctaw,U.S. House,Richard Castaldo,LIB,120207,0,0,2,2,2
Choctaw,U.S. House,Markwayne Mullin,REP,120207,1,1,56,58,2
Choctaw,U.S. House,Jason Nichols,DEM,120207,0,0,20,20,2
Choctaw,U.S. House,John Foreman,IND,120207,0,0,2,2,2
Choctaw,State House,Justin Humphrey,REP,120207,1,1,56,58,19
Choctaw,State House,Lewis Collins,DEM,120207,0,0,25,25,19
Choctaw,Governor,Chris Powell,LIB,120208,1,1,5,7,
Choctaw,Governor,Kevin Stitt,REP,120208,2,52,157,211,
Choctaw,Governor,Drew Edmondson,DEM,120208,3,23,69,95,
Choctaw,Lieutenant Governor,Matt Pinnell,REP,120208,2,57,164,223,
Choctaw,Lieutenant Governor,Anastasia Pittman,DEM,120208,3,18,60,81,
Choctaw,Lieutenant Governor,Ivan Holmes,IND,120208,1,0,8,9,
Choctaw,State Auditor,John Yeutter,LIB,120208,1,11,38,50,
Choctaw,State Auditor,Cindy Byrd,REP,120208,4,62,173,239,
Choctaw,Attorney General,Mike Hunter,REP,120208,2,59,172,233,
Choctaw,Attorney General,Mark Myles,DEM,120208,4,16,60,80,
Choctaw,State Treasurer,Randy Mcdaniel,REP,120208,4,63,170,237,
Choctaw,State Treasurer,Charles De Coune,IND,120208,1,10,46,57,
Choctaw,Superintendent of Public Instruction,Joy Hofmeister,REP,120208,4,52,151,207,
Choctaw,Superintendent of Public Instruction,John Cox,DEM,120208,1,20,59,80,
Choctaw,Superintendent of Public Instruction,Larry Huff,IND,120208,1,3,19,23,
Choctaw,Commissioner of Labor,Leslie Osborn,REP,120208,2,56,163,221,
Choctaw,Commissioner of Labor,Fred Dorrell,DEM,120208,4,19,55,78,
Choctaw,Commissioner of Labor,Brandt Dismukes,IND,120208,0,0,7,7,
Choctaw,Insurance Commissioner,Glen Mulready,REP,120208,2,53,165,220,
Choctaw,Insurance Commissioner,Kimberly Fobbs,DEM,120208,4,22,61,87,
Choctaw,Corporation Commissioner,Bob Anthony,REP,120208,2,54,161,217,
Choctaw,Corporation Commissioner,Ashley Nicole Mccray,DEM,120208,3,20,60,83,
Choctaw,Corporation Commissioner,Jackie Short,IND,120208,1,0,5,6,
Choctaw,U.S. House,Richard Castaldo,LIB,120208,0,1,2,3,2
Choctaw,U.S. House,Markwayne Mullin,REP,120208,2,56,171,229,2
Choctaw,U.S. House,Jason Nichols,DEM,120208,3,17,55,75,2
Choctaw,U.S. House,John Foreman,IND,120208,1,1,5,7,2
Choctaw,State House,Justin Humphrey,REP,120208,2,41,149,192,19
Choctaw,State House,Lewis Collins,DEM,120208,4,35,82,121,19
Choctaw,Governor,Chris Powell,LIB,120209,0,0,2,2,
Choctaw,Governor,Kevin Stitt,REP,120209,1,5,53,59,
Choctaw,Governor,Drew Edmondson,DEM,120209,2,1,45,48,
Choctaw,Lieutenant Governor,Matt Pinnell,REP,120209,0,5,57,62,
Choctaw,Lieutenant Governor,Anastasia Pittman,DEM,120209,2,1,41,44,
Choctaw,Lieutenant Governor,Ivan Holmes,IND,120209,1,0,2,3,
Choctaw,State Auditor,John Yeutter,LIB,120209,0,0,24,24,
Choctaw,State Auditor,Cindy Byrd,REP,120209,1,6,66,73,
Choctaw,Attorney General,Mike Hunter,REP,120209,1,5,62,68,
Choctaw,Attorney General,Mark Myles,DEM,120209,2,1,38,41,
Choctaw,State Treasurer,Randy Mcdaniel,REP,120209,0,5,69,74,
Choctaw,State Treasurer,Charles De Coune,IND,120209,1,1,22,24,
Choctaw,Superintendent of Public Instruction,Joy Hofmeister,REP,120209,1,4,55,60,
Choctaw,Superintendent of Public Instruction,John Cox,DEM,120209,2,2,37,41,
Choctaw,Superintendent of Public Instruction,Larry Huff,IND,120209,0,0,7,7,
Choctaw,Commissioner of Labor,Leslie Osborn,REP,120209,0,5,64,69,
Choctaw,Commissioner of Labor,Fred Dorrell,DEM,120209,2,1,36,39,
Choctaw,Commissioner of Labor,Brandt Dismukes,IND,120209,1,0,0,1,
Choctaw,Insurance Commissioner,Glen Mulready,REP,120209,1,5,60,66,
Choctaw,Insurance Commissioner,Kimberly Fobbs,DEM,120209,2,1,40,43,
Choctaw,Corporation Commissioner,Bob Anthony,REP,120209,0,5,57,62,
Choctaw,Corporation Commissioner,Ashley Nicole Mccray,DEM,120209,2,1,37,40,
Choctaw,Corporation Commissioner,Jackie Short,IND,120209,1,0,5,6,
Choctaw,U.S. House,Richard Castaldo,LIB,120209,0,0,1,1,2
Choctaw,U.S. House,Markwayne Mullin,REP,120209,0,5,59,64,2
Choctaw,U.S. House,Jason Nichols,DEM,120209,2,1,37,40,2
Choctaw,U.S. House,John Foreman,IND,120209,1,0,3,4,2
Choctaw,State House,Justin Humphrey,REP,120209,0,3,58,61,19
Choctaw,State House,Lewis Collins,DEM,120209,3,3,42,48,19
Choctaw,Governor,Chris Powell,LIB,120210,0,1,3,4,
Choctaw,Governor,Kevin Stitt,REP,120210,16,60,235,311,
Choctaw,Governor,Drew Edmondson,DEM,120210,7,15,68,90,
Choctaw,Lieutenant Governor,Matt Pinnell,REP,120210,16,65,247,328,
Choctaw,Lieutenant Governor,Anastasia Pittman,DEM,120210,7,10,48,65,
Choctaw,Lieutenant Governor,Ivan Holmes,IND,120210,0,0,1,1,
Choctaw,State Auditor,John Yeutter,LIB,120210,2,4,29,35,
Choctaw,State Auditor,Cindy Byrd,REP,120210,19,68,264,351,
Choctaw,Attorney General,Mike Hunter,REP,120210,16,66,247,329,
Choctaw,Attorney General,Mark Myles,DEM,120210,7,10,53,70,
Choctaw,State Treasurer,Randy Mcdaniel,REP,120210,17,68,262,347,
Choctaw,State Treasurer,Charles De Coune,IND,120210,4,6,29,39,
Choctaw,Superintendent of Public Instruction,Joy Hofmeister,REP,120210,17,59,228,304,
Choctaw,Superintendent of Public Instruction,John Cox,DEM,120210,6,13,60,79,
Choctaw,Superintendent of Public Instruction,Larry Huff,IND,120210,0,4,11,15,
Choctaw,Commissioner of Labor,Leslie Osborn,REP,120210,17,63,243,323,
Choctaw,Commissioner of Labor,Fred Dorrell,DEM,120210,6,11,51,68,
Choctaw,Commissioner of Labor,Brandt Dismukes,IND,120210,0,0,3,3,
Choctaw,Insurance Commissioner,Glen Mulready,REP,120210,16,62,240,318,
Choctaw,Insurance Commissioner,Kimberly Fobbs,DEM,120210,7,12,55,74,
Choctaw,Corporation Commissioner,Bob Anthony,REP,120210,15,59,232,306,
Choctaw,Corporation Commissioner,Ashley Nicole Mccray,DEM,120210,7,13,55,75,
Choctaw,Corporation Commissioner,Jackie Short,IND,120210,0,3,7,10,
Choctaw,U.S. House,Richard Castaldo,LIB,120210,0,1,2,3,2
Choctaw,U.S. House,Markwayne Mullin,REP,120210,17,67,251,335,2
Choctaw,U.S. House,Jason Nichols,DEM,120210,6,9,47,62,2
Choctaw,U.S. House,John Foreman,IND,120210,0,0,5,5,2
Choctaw,State House,Justin Humphrey,REP,120210,14,56,219,289,19
Choctaw,State House,Lewis Collins,DEM,120210,8,20,85,113,19
Choctaw,Governor,Chris Powell,LIB,120211,0,0,0,0,
Choctaw,Governor,Kevin Stitt,REP,120211,0,8,32,40,
Choctaw,Governor,Drew Edmondson,DEM,120211,3,1,28,32,
Choctaw,Lieutenant Governor,Matt Pinnell,REP,120211,0,7,33,40,
Choctaw,Lieutenant Governor,Anastasia Pittman,DEM,120211,3,2,26,31,
Choctaw,Lieutenant Governor,Ivan Holmes,IND,120211,0,0,0,0,
Choctaw,State Auditor,John Yeutter,LIB,120211,3,0,17,20,
Choctaw,State Auditor,Cindy Byrd,REP,120211,0,9,33,42,
Choctaw,Attorney General,Mike Hunter,REP,120211,0,8,32,40,
Choctaw,Attorney General,Mark Myles,DEM,120211,3,1,28,32,
Choctaw,State Treasurer,Randy Mcdaniel,REP,120211,0,9,36,45,
Choctaw,State Treasurer,Charles De Coune,IND,120211,3,0,11,14,
Choctaw,Superintendent of Public Instruction,Joy Hofmeister,REP,120211,0,8,24,32,
Choctaw,Superintendent of Public Instruction,John Cox,DEM,120211,3,0,34,37,
Choctaw,Superintendent of Public Instruction,Larry Huff,IND,120211,0,0,2,2,
Choctaw,Commissioner of Labor,Leslie Osborn,REP,120211,0,8,30,38,
Choctaw,Commissioner of Labor,Fred Dorrell,DEM,120211,3,1,30,34,
Choctaw,Commissioner of Labor,Brandt Dismukes,IND,120211,0,0,0,0,
Choctaw,Insurance Commissioner,Glen Mulready,REP,120211,0,7,30,37,
Choctaw,Insurance Commissioner,Kimberly Fobbs,DEM,120211,3,2,29,34,
Choctaw,Corporation Commissioner,Bob Anthony,REP,120211,0,8,31,39,
Choctaw,Corporation Commissioner,Ashley Nicole Mccray,DEM,120211,3,1,28,32,
Choctaw,Corporation Commissioner,Jackie Short,IND,120211,0,0,0,0,
Choctaw,U.S. House,Richard Castaldo,LIB,120211,0,0,1,1,2
Choctaw,U.S. House,Markwayne Mullin,REP,120211,0,7,28,35,2
Choctaw,U.S. House,Jason Nichols,DEM,120211,3,1,30,34,2
Choctaw,U.S. House,John Foreman,IND,120211,0,1,1,2,2
Choctaw,State House,Justin Humphrey,REP,120211,1,5,23,29,19
Choctaw,State House,Lewis Collins,DEM,120211,2,4,37,43,19
Choctaw,Governor,Chris Powell,LIB,120214,0,0,3,3,
Choctaw,Governor,Kevin Stitt,REP,120214,4,19,74,97,
Choctaw,Governor,Drew Edmondson,DEM,120214,3,18,82,103,
Choctaw,Lieutenant Governor,Matt Pinnell,REP,120214,5,23,82,110,
Choctaw,Lieutenant Governor,Anastasia Pittman,DEM,120214,2,13,76,91,
Choctaw,Lieutenant Governor,Ivan Holmes,IND,120214,0,0,1,1,
Choctaw,State Auditor,John Yeutter,LIB,120214,1,8,46,55,
Choctaw,State Auditor,Cindy Byrd,REP,120214,5,24,99,128,
Choctaw,Attorney General,Mike Hunter,REP,120214,4,23,86,113,
Choctaw,Attorney General,Mark Myles,DEM,120214,3,13,73,89,
Choctaw,State Treasurer,Randy Mcdaniel,REP,120214,5,23,91,119,
Choctaw,State Treasurer,Charles De Coune,IND,120214,1,9,55,65,
Choctaw,Superintendent of Public Instruction,Joy Hofmeister,REP,120214,4,19,78,101,
Choctaw,Superintendent of Public Instruction,John Cox,DEM,120214,3,18,73,94,
Choctaw,Superintendent of Public Instruction,Larry Huff,IND,120214,0,0,8,8,
Choctaw,Commissioner of Labor,Leslie Osborn,REP,120214,5,22,83,110,
Choctaw,Commissioner of Labor,Fred Dorrell,DEM,120214,2,13,69,84,
Choctaw,Commissioner of Labor,Brandt Dismukes,IND,120214,0,1,3,4,
Choctaw,Insurance Commissioner,Glen Mulready,REP,120214,4,23,82,109,
Choctaw,Insurance Commissioner,Kimberly Fobbs,DEM,120214,3,13,75,91,
Choctaw,Corporation Commissioner,Bob Anthony,REP,120214,4,21,80,105,
Choctaw,Corporation Commissioner,Ashley Nicole Mccray,DEM,120214,3,14,71,88,
Choctaw,Corporation Commissioner,Jackie Short,IND,120214,0,1,6,7,
Choctaw,U.S. House,Richard Castaldo,LIB,120214,0,1,1,2,2
Choctaw,U.S. House,Markwayne Mullin,REP,120214,3,22,79,104,2
Choctaw,U.S. House,Jason Nichols,DEM,120214,3,13,72,88,2
Choctaw,U.S. House,John Foreman,IND,120214,1,1,8,10,2
Choctaw,State House,Justin Humphrey,REP,120214,3,16,64,83,19
Choctaw,State House,Lewis Collins,DEM,120214,4,21,94,119,19
Choctaw,Governor,Chris Powell,LIB,120215,0,0,1,1,
Choctaw,Governor,Kevin Stitt,REP,120215,4,26,62,92,
Choctaw,Governor,Drew Edmondson,DEM,120215,2,14,38,54,
Choctaw,Lieutenant Governor,Matt Pinnell,REP,120215,4,26,65,95,
Choctaw,Lieutenant Governor,Anastasia Pittman,DEM,120215,2,12,35,49,
Choctaw,Lieutenant Governor,Ivan Holmes,IND,120215,0,1,0,1,
Choctaw,State Auditor,John Yeutter,LIB,120215,1,5,22,28,
Choctaw,State Auditor,Cindy Byrd,REP,120215,4,28,68,100,
Choctaw,Attorney General,Mike Hunter,REP,120215,4,26,66,96,
Choctaw,Attorney General,Mark Myles,DEM,120215,2,13,32,47,
Choctaw,State Treasurer,Randy Mcdaniel,REP,120215,4,27,64,95,
Choctaw,State Treasurer,Charles De Coune,IND,120215,1,7,27,35,
Choctaw,Superintendent of Public Instruction,Joy Hofmeister,REP,120215,4,23,58,85,
Choctaw,Superintendent of Public Instruction,John Cox,DEM,120215,2,16,37,55,
Choctaw,Superintendent of Public Instruction,Larry Huff,IND,120215,0,1,4,5,
Choctaw,Commissioner of Labor,Leslie Osborn,REP,120215,4,27,60,91,
Choctaw,Commissioner of Labor,Fred Dorrell,DEM,120215,2,11,34,47,
Choctaw,Commissioner of Labor,Brandt Dismukes,IND,120215,0,2,3,5,
Choctaw,Insurance Commissioner,Glen Mulready,REP,120215,4,25,63,92,
Choctaw,Insurance Commissioner,Kimberly Fobbs,DEM,120215,2,16,35,53,
Choctaw,Corporation Commissioner,Bob Anthony,REP,120215,4,26,64,94,
Choctaw,Corporation Commissioner,Ashley Nicole Mccray,DEM,120215,2,13,32,47,
Choctaw,Corporation Commissioner,Jackie Short,IND,120215,0,0,2,2,
Choctaw,U.S. House,Richard Castaldo,LIB,120215,0,0,0,0,2
Choctaw,U.S. House,Markwayne Mullin,REP,120215,4,25,65,94,2
Choctaw,U.S. House,Jason Nichols,DEM,120215,2,15,34,51,2
Choctaw,U.S. House,John Foreman,IND,120215,0,0,2,2,2
Choctaw,State House,Justin Humphrey,REP,120215,4,20,58,82,19
Choctaw,State House,Lewis Collins,DEM,120215,2,21,41,64,19
Choctaw,Governor,Chris Powell,LIB,120316,0,0,7,7,
Choctaw,Governor,Kevin Stitt,REP,120316,11,60,181,252,
Choctaw,Governor,Drew Edmondson,DEM,120316,7,29,107,143,
Choctaw,Lieutenant Governor,Matt Pinnell,REP,120316,10,66,193,269,
Choctaw,Lieutenant Governor,Anastasia Pittman,DEM,120316,7,22,93,122,
Choctaw,Lieutenant Governor,Ivan Holmes,IND,120316,1,0,8,9,
Choctaw,State Auditor,John Yeutter,LIB,120316,2,8,61,71,
Choctaw,State Auditor,Cindy Byrd,REP,120316,13,72,217,302,
Choctaw,Attorney General,Mike Hunter,REP,120316,10,64,194,268,
Choctaw,Attorney General,Mark Myles,DEM,120316,8,24,98,130,
Choctaw,State Treasurer,Randy Mcdaniel,REP,120316,12,70,205,287,
Choctaw,State Treasurer,Charles De Coune,IND,120316,3,11,74,88,
Choctaw,Superintendent of Public Instruction,Joy Hofmeister,REP,120316,8,60,178,246,
Choctaw,Superintendent of Public Instruction,John Cox,DEM,120316,6,24,89,119,
Choctaw,Superintendent of Public Instruction,Larry Huff,IND,120316,4,4,25,33,
Choctaw,Commissioner of Labor,Leslie Osborn,REP,120316,10,62,190,262,
Choctaw,Commissioner of Labor,Fred Dorrell,DEM,120316,8,26,88,122,
Choctaw,Commissioner of Labor,Brandt Dismukes,IND,120316,0,0,13,13,
Choctaw,Insurance Commissioner,Glen Mulready,REP,120316,12,61,183,256,
Choctaw,Insurance Commissioner,Kimberly Fobbs,DEM,120316,6,26,106,138,
Choctaw,Corporation Commissioner,Bob Anthony,REP,120316,10,63,185,258,
Choctaw,Corporation Commissioner,Ashley Nicole Mccray,DEM,120316,7,23,93,123,
Choctaw,Corporation Commissioner,Jackie Short,IND,120316,1,2,11,14,
Choctaw,U.S. House,Richard Castaldo,LIB,120316,0,2,5,7,2
Choctaw,U.S. House,Markwayne Mullin,REP,120316,7,60,190,257,2
Choctaw,U.S. House,Jason Nichols,DEM,120316,8,24,92,124,2
Choctaw,U.S. House,John Foreman,IND,120316,3,2,7,12,2
Choctaw,State House,Justin Humphrey,REP,120316,8,50,170,228,19
Choctaw,State House,Lewis Collins,DEM,120316,10,39,121,170,19
Choctaw,Governor,Chris Powell,LIB,120318,0,1,4,5,
Choctaw,Governor,Kevin Stitt,REP,120318,2,29,148,179,
Choctaw,Governor,Drew Edmondson,DEM,120318,1,19,62,82,
Choctaw,Lieutenant Governor,Matt Pinnell,REP,120318,2,32,165,199,
Choctaw,Lieutenant Governor,Anastasia Pittman,DEM,120318,1,17,38,56,
Choctaw,Lieutenant Governor,Ivan Holmes,IND,120318,0,0,10,10,
Choctaw,State Auditor,John Yeutter,LIB,120318,0,3,24,27,
Choctaw,State Auditor,Cindy Byrd,REP,120318,2,42,178,222,
Choctaw,Attorney General,Mike Hunter,REP,120318,2,34,166,202,
Choctaw,Attorney General,Mark Myles,DEM,120318,1,15,46,62,
Choctaw,State Treasurer,Randy Mcdaniel,REP,120318,2,42,180,224,
Choctaw,State Treasurer,Charles De Coune,IND,120318,0,5,26,31,
Choctaw,Superintendent of Public Instruction,Joy Hofmeister,REP,120318,2,34,141,177,
Choctaw,Superintendent of Public Instruction,John Cox,DEM,120318,1,15,49,65,
Choctaw,Superintendent of Public Instruction,Larry Huff,IND,120318,0,1,19,20,
Choctaw,Commissioner of Labor,Leslie Osborn,REP,120318,2,38,168,208,
Choctaw,Commissioner of Labor,Fred Dorrell,DEM,120318,1,12,36,49,
Choctaw,Commissioner of Labor,Brandt Dismukes,IND,120318,0,0,3,3,
Choctaw,Insurance Commissioner,Glen Mulready,REP,120318,2,34,166,202,
Choctaw,Insurance Commissioner,Kimberly Fobbs,DEM,120318,1,16,41,58,
Choctaw,Corporation Commissioner,Bob Anthony,REP,120318,2,39,159,200,
Choctaw,Corporation Commissioner,Ashley Nicole Mccray,DEM,120318,1,11,42,54,
Choctaw,Corporation Commissioner,Jackie Short,IND,120318,0,0,7,7,
Choctaw,U.S. House,Richard Castaldo,LIB,120318,0,0,1,1,2
Choctaw,U.S. House,Markwayne Mullin,REP,120318,2,33,172,207,2
Choctaw,U.S. House,Jason Nichols,DEM,120318,1,16,38,55,2
Choctaw,U.S. House,John Foreman,IND,120318,0,1,4,5,2
Choctaw,State House,Justin Humphrey,REP,120318,2,22,135,159,19
Choctaw,State House,Lewis Collins,DEM,120318,1,28,78,107,19
Choctaw,Governor,Chris Powell,LIB,120319,5,0,7,12,
Choctaw,Governor,Kevin Stitt,REP,120319,7,26,129,162,
Choctaw,Governor,Drew Edmondson,DEM,120319,5,7,50,62,
Choctaw,Lieutenant Governor,Matt Pinnell,REP,120319,7,27,139,173,
Choctaw,Lieutenant Governor,Anastasia Pittman,DEM,120319,5,5,36,46,
Choctaw,Lieutenant Governor,Ivan Holmes,IND,120319,5,0,7,12,
Choctaw,State Auditor,John Yeutter,LIB,120319,4,3,27,34,
Choctaw,State Auditor,Cindy Byrd,REP,120319,13,29,151,193,
Choctaw,Attorney General,Mike Hunter,REP,120319,10,27,138,175,
Choctaw,Attorney General,Mark Myles,DEM,120319,7,5,44,56,
Choctaw,State Treasurer,Randy Mcdaniel,REP,120319,11,28,148,187,
Choctaw,State Treasurer,Charles De Coune,IND,120319,6,3,29,38,
Choctaw,Superintendent of Public Instruction,Joy Hofmeister,REP,120319,8,23,122,153,
Choctaw,Superintendent of Public Instruction,John Cox,DEM,120319,3,5,45,53,
Choctaw,Superintendent of Public Instruction,Larry Huff,IND,120319,6,3,16,25,
Choctaw,Commissioner of Labor,Leslie Osborn,REP,120319,7,26,139,172,
Choctaw,Commissioner of Labor,Fred Dorrell,DEM,120319,5,5,37,47,
Choctaw,Commissioner of Labor,Brandt Dismukes,IND,120319,5,0,6,11,
Choctaw,Insurance Commissioner,Glen Mulready,REP,120319,10,25,137,172,
Choctaw,Insurance Commissioner,Kimberly Fobbs,DEM,120319,7,6,45,58,
Choctaw,Corporation Commissioner,Bob Anthony,REP,120319,9,24,126,159,
Choctaw,Corporation Commissioner,Ashley Nicole Mccray,DEM,120319,5,5,44,54,
Choctaw,Corporation Commissioner,Jackie Short,IND,120319,3,2,12,17,
Choctaw,U.S. House,Richard Castaldo,LIB,120319,1,0,3,4,2
Choctaw,U.S. House,Markwayne Mullin,REP,120319,8,28,138,174,2
Choctaw,U.S. House,Jason Nichols,DEM,120319,4,5,38,47,2
Choctaw,U.S. House,John Foreman,IND,120319,4,0,5,9,2
Choctaw,State House,Justin Humphrey,REP,120319,8,23,129,160,19
Choctaw,State House,Lewis Collins,DEM,120319,9,9,57,75,19
Choctaw,Governor,Chris Powell,LIB,120320,0,0,4,4,
Choctaw,Governor,Kevin Stitt,REP,120320,0,8,95,103,
Choctaw,Governor,Drew Edmondson,DEM,120320,0,1,28,29,
Choctaw,Lieutenant Governor,Matt Pinnell,REP,120320,0,6,103,109,
Choctaw,Lieutenant Governor,Anastasia Pittman,DEM,120320,0,3,19,22,
Choctaw,Lieutenant Governor,Ivan Holmes,IND,120320,0,0,3,3,
Choctaw,State Auditor,John Yeutter,LIB,120320,0,0,14,14,
Choctaw,State Auditor,Cindy Byrd,REP,120320,0,8,108,116,
Choctaw,Attorney General,Mike Hunter,REP,120320,0,7,100,107,
Choctaw,Attorney General,Mark Myles,DEM,120320,0,0,24,24,
Choctaw,State Treasurer,Randy Mcdaniel,REP,120320,0,7,108,115,
Choctaw,State Treasurer,Charles De Coune,IND,120320,0,0,13,13,
Choctaw,Superintendent of Public Instruction,Joy Hofmeister,REP,120320,0,7,94,101,
Choctaw,Superintendent of Public Instruction,John Cox,DEM,120320,0,1,25,26,
Choctaw,Superintendent of Public Instruction,Larry Huff,IND,120320,0,0,5,5,
Choctaw,Commissioner of Labor,Leslie Osborn,REP,120320,0,7,97,104,
Choctaw,Commissioner of Labor,Fred Dorrell,DEM,120320,0,0,20,20,
Choctaw,Commissioner of Labor,Brandt Dismukes,IND,120320,0,0,5,5,
Choctaw,Insurance Commissioner,Glen Mulready,REP,120320,0,7,104,111,
Choctaw,Insurance Commissioner,Kimberly Fobbs,DEM,120320,0,0,21,21,
Choctaw,Corporation Commissioner,Bob Anthony,REP,120320,0,7,100,107,
Choctaw,Corporation Commissioner,Ashley Nicole Mccray,DEM,120320,0,0,19,19,
Choctaw,Corporation Commissioner,Jackie Short,IND,120320,0,0,6,6,
Choctaw,U.S. House,Richard Castaldo,LIB,120320,0,0,5,5,2
Choctaw,U.S. House,Markwayne Mullin,REP,120320,0,8,100,108,2
Choctaw,U.S. House,Jason Nichols,DEM,120320,0,0,20,20,2
Choctaw,U.S. House,John Foreman,IND,120320,0,0,0,0,2
Choctaw,State House,Justin Humphrey,REP,120320,0,8,89,97,19
Choctaw,State House,Lewis Collins,DEM,120320,0,1,38,39,19
Choctaw,Governor,Chris Powell,LIB,120321,1,0,12,13,
Choctaw,Governor,Kevin Stitt,REP,120321,5,23,169,197,
Choctaw,Governor,Drew Edmondson,DEM,120321,8,5,62,75,
Choctaw,Lieutenant Governor,Matt Pinnell,REP,120321,8,25,178,211,
Choctaw,Lieutenant Governor,Anastasia Pittman,DEM,120321,5,2,55,62,
Choctaw,Lieutenant Governor,Ivan Holmes,IND,120321,1,0,7,8,
Choctaw,State Auditor,John Yeutter,LIB,120321,2,2,28,32,
Choctaw,State Auditor,Cindy Byrd,REP,120321,12,24,194,230,
Choctaw,Attorney General,Mike Hunter,REP,120321,10,23,181,214,
Choctaw,Attorney General,Mark Myles,DEM,120321,4,4,57,65,
Choctaw,State Treasurer,Randy Mcdaniel,REP,120321,10,26,198,234,
Choctaw,State Treasurer,Charles De Coune,IND,120321,4,1,26,31,
Choctaw,Superintendent of Public Instruction,Joy Hofmeister,REP,120321,6,22,160,188,
Choctaw,Superintendent of Public Instruction,John Cox,DEM,120321,6,4,60,70,
Choctaw,Superintendent of Public Instruction,Larry Huff,IND,120321,2,1,20,23,
Choctaw,Commissioner of Labor,Leslie Osborn,REP,120321,8,24,173,205,
Choctaw,Commissioner of Labor,Fred Dorrell,DEM,120321,5,1,57,63,
Choctaw,Commissioner of Labor,Brandt Dismukes,IND,120321,1,1,7,9,
Choctaw,Insurance Commissioner,Glen Mulready,REP,120321,9,24,177,210,
Choctaw,Insurance Commissioner,Kimberly Fobbs,DEM,120321,5,2,61,68,
Choctaw,Corporation Commissioner,Bob Anthony,REP,120321,9,24,169,202,
Choctaw,Corporation Commissioner,Ashley Nicole Mccray,DEM,120321,5,0,56,61,
Choctaw,Corporation Commissioner,Jackie Short,IND,120321,0,2,11,13,
Choctaw,U.S. House,Richard Castaldo,LIB,120321,0,0,5,5,2
Choctaw,U.S. House,Markwayne Mullin,REP,120321,7,27,177,211,2
Choctaw,U.S. House,Jason Nichols,DEM,120321,5,1,52,58,2
Choctaw,U.S. House,John Foreman,IND,120321,2,0,5,7,2
Choctaw,State House,Justin Humphrey,REP,120321,7,22,161,190,19
Choctaw,State House,Lewis Collins,DEM,120321,7,6,82,95,19
Choctaw,Governor,Chris Powell,LIB,120322,0,0,7,7,
Choctaw,Governor,Kevin Stitt,REP,120322,3,3,97,103,
Choctaw,Governor,Drew Edmondson,DEM,120322,1,1,21,23,
Choctaw,Lieutenant Governor,Matt Pinnell,REP,120322,3,3,98,104,
Choctaw,Lieutenant Governor,Anastasia Pittman,DEM,120322,1,1,23,25,
Choctaw,Lieutenant Governor,Ivan Holmes,IND,120322,0,0,4,4,
Choctaw,State Auditor,John Yeutter,LIB,120322,0,0,10,10,
Choctaw,State Auditor,Cindy Byrd,REP,120322,3,3,112,118,
Choctaw,Attorney General,Mike Hunter,REP,120322,3,3,99,105,
Choctaw,Attorney General,Mark Myles,DEM,120322,1,1,23,25,
Choctaw,State Treasurer,Randy Mcdaniel,REP,120322,3,3,107,113,
Choctaw,State Treasurer,Charles De Coune,IND,120322,0,0,14,14,
Choctaw,Superintendent of Public Instruction,Joy Hofmeister,REP,120322,3,3,91,97,
Choctaw,Superintendent of Public Instruction,John Cox,DEM,120322,1,1,23,25,
Choctaw,Superintendent of Public Instruction,Larry Huff,IND,120322,0,0,8,8,
Choctaw,Commissioner of Labor,Leslie Osborn,REP,120322,3,3,99,105,
Choctaw,Commissioner of Labor,Fred Dorrell,DEM,120322,1,1,21,23,
Choctaw,Commissioner of Labor,Brandt Dismukes,IND,120322,0,0,2,2,
Choctaw,Insurance Commissioner,Glen Mulready,REP,120322,3,3,101,107,
Choctaw,Insurance Commissioner,Kimberly Fobbs,DEM,120322,1,1,21,23,
Choctaw,Corporation Commissioner,Bob Anthony,REP,120322,3,3,96,102,
Choctaw,Corporation Commissioner,Ashley Nicole Mccray,DEM,120322,1,1,23,25,
Choctaw,Corporation Commissioner,Jackie Short,IND,120322,0,0,3,3,
Choctaw,U.S. House,Richard Castaldo,LIB,120322,0,0,1,1,2
Choctaw,U.S. House,Markwayne Mullin,REP,120322,3,3,105,111,2
Choctaw,U.S. House,Jason Nichols,DEM,120322,1,1,18,20,2
Choctaw,U.S. House,John Foreman,IND,120322,0,0,2,2,2
Choctaw,State House,Justin Humphrey,REP,120322,3,3,86,92,19
Choctaw,State House,Lewis Collins,DEM,120322,1,1,40,42,19
Cimarron,Governor,Chris Powell,LIB,130002,0,0,3,3,
Cimarron,Governor,Kevin Stitt,REP,130002,14,20,72,106,
Cimarron,Governor,Drew Edmondson,DEM,130002,0,3,13,16,
Cimarron,Lieutenant Governor,Matt Pinnell,REP,130002,14,21,75,110,
Cimarron,Lieutenant Governor,Anastasia Pittman,DEM,130002,0,2,11,13,
Cimarron,Lieutenant Governor,Ivan Holmes,IND,130002,0,0,2,2,
Cimarron,State Auditor,John Yeutter,LIB,130002,0,2,5,7,
Cimarron,State Auditor,Cindy Byrd,REP,130002,14,21,74,109,
Cimarron,Attorney General,Mike Hunter,REP,130002,13,21,73,107,
Cimarron,Attorney General,Mark Myles,DEM,130002,0,2,11,13,
Cimarron,State Treasurer,Randy Mcdaniel,REP,130002,13,21,70,104,
Cimarron,State Treasurer,Charles De Coune,IND,130002,0,2,10,12,
Cimarron,Superintendent of Public Instruction,Joy Hofmeister,REP,130002,13,16,63,92,
Cimarron,Superintendent of Public Instruction,John Cox,DEM,130002,0,4,20,24,
Cimarron,Superintendent of Public Instruction,Larry Huff,IND,130002,1,2,4,7,
Cimarron,Commissioner of Labor,Leslie Osborn,REP,130002,14,20,68,102,
Cimarron,Commissioner of Labor,Fred Dorrell,DEM,130002,0,2,12,14,
Cimarron,Commissioner of Labor,Brandt Dismukes,IND,130002,0,1,2,3,
Cimarron,Insurance Commissioner,Glen Mulready,REP,130002,14,21,68,103,
Cimarron,Insurance Commissioner,Kimberly Fobbs,DEM,130002,0,2,14,16,
Cimarron,Corporation Commissioner,Bob Anthony,REP,130002,12,17,67,96,
Cimarron,Corporation Commissioner,Ashley Nicole Mccray,DEM,130002,1,3,12,16,
Cimarron,Corporation Commissioner,Jackie Short,IND,130002,1,3,7,11,
Cimarron,U.S. House,Frank Lucas,REP,130002,14,21,78,113,3
Cimarron,U.S. House,Frankie Robbins,DEM,130002,0,2,9,11,3
Cimarron,State House,Kenton Patzkowsky,REP,130002,13,20,70,103,61
Cimarron,State House,Ashley Lehnert,DEM,130002,1,3,16,20,61
Cimarron,Governor,Chris Powell,LIB,130003,0,0,1,1,
Cimarron,Governor,Kevin Stitt,REP,130003,3,18,95,116,
Cimarron,Governor,Drew Edmondson,DEM,130003,1,2,10,13,
Cimarron,Lieutenant Governor,Matt Pinnell,REP,130003,3,18,94,115,
Cimarron,Lieutenant Governor,Anastasia Pittman,DEM,130003,1,2,7,10,
Cimarron,Lieutenant Governor,Ivan Holmes,IND,130003,0,0,3,3,
Cimarron,State Auditor,John Yeutter,LIB,130003,0,4,12,16,
Cimarron,State Auditor,Cindy Byrd,REP,130003,3,17,96,116,
Cimarron,Attorney General,Mike Hunter,REP,130003,3,18,99,120,
Cimarron,Attorney General,Mark Myles,DEM,130003,1,2,5,8,
Cimarron,State Treasurer,Randy Mcdaniel,REP,130003,3,19,99,121,
Cimarron,State Treasurer,Charles De Coune,IND,130003,0,1,4,5,
Cimarron,Superintendent of Public Instruction,Joy Hofmeister,REP,130003,3,14,88,105,
Cimarron,Superintendent of Public Instruction,John Cox,DEM,130003,1,4,13,18,
Cimarron,Superintendent of Public Instruction,Larry Huff,IND,130003,0,2,5,7,
Cimarron,Commissioner of Labor,Leslie Osborn,REP,130003,3,18,95,116,
Cimarron,Commissioner of Labor,Fred Dorrell,DEM,130003,1,1,6,8,
Cimarron,Commissioner of Labor,Brandt Dismukes,IND,130003,0,1,5,6,
Cimarron,Insurance Commissioner,Glen Mulready,REP,130003,3,18,96,117,
Cimarron,Insurance Commissioner,Kimberly Fobbs,DEM,130003,1,3,6,10,
Cimarron,Corporation Commissioner,Bob Anthony,REP,130003,3,17,92,112,
Cimarron,Corporation Commissioner,Ashley Nicole Mccray,DEM,130003,1,2,8,11,
Cimarron,Corporation Commissioner,Jackie Short,IND,130003,0,1,3,4,
Cimarron,U.S. House,Frank Lucas,REP,130003,3,18,96,117,3
Cimarron,U.S. House,Frankie Robbins,DEM,130003,1,2,8,11,3
Cimarron,State House,Kenton Patzkowsky,REP,130003,3,18,93,114,61
Cimarron,State House,Ashley Lehnert,DEM,130003,1,2,11,14,61
Cimarron,Governor,Chris Powell,LIB,130004,0,0,0,0,
Cimarron,Governor,Kevin Stitt,REP,130004,1,21,110,132,
Cimarron,Governor,Drew Edmondson,DEM,130004,3,8,15,26,
Cimarron,Lieutenant Governor,Matt Pinnell,REP,130004,3,24,107,134,
Cimarron,Lieutenant Governor,Anastasia Pittman,DEM,130004,1,3,12,16,
Cimarron,Lieutenant Governor,Ivan Holmes,IND,130004,0,1,6,7,
Cimarron,State Auditor,John Yeutter,LIB,130004,1,3,16,20,
Cimarron,State Auditor,Cindy Byrd,REP,130004,3,26,106,135,
Cimarron,Attorney General,Mike Hunter,REP,130004,3,25,113,141,
Cimarron,Attorney General,Mark Myles,DEM,130004,1,3,12,16,
Cimarron,State Treasurer,Randy Mcdaniel,REP,130004,3,25,110,138,
Cimarron,State Treasurer,Charles De Coune,IND,130004,1,3,11,15,
Cimarron,Superintendent of Public Instruction,Joy Hofmeister,REP,130004,3,18,88,109,
Cimarron,Superintendent of Public Instruction,John Cox,DEM,130004,1,8,18,27,
Cimarron,Superintendent of Public Instruction,Larry Huff,IND,130004,0,3,18,21,
Cimarron,Commissioner of Labor,Leslie Osborn,REP,130004,3,25,108,136,
Cimarron,Commissioner of Labor,Fred Dorrell,DEM,130004,1,2,10,13,
Cimarron,Commissioner of Labor,Brandt Dismukes,IND,130004,0,2,7,9,
Cimarron,Insurance Commissioner,Glen Mulready,REP,130004,3,25,108,136,
Cimarron,Insurance Commissioner,Kimberly Fobbs,DEM,130004,1,3,15,19,
Cimarron,Corporation Commissioner,Bob Anthony,REP,130004,3,24,106,133,
Cimarron,Corporation Commissioner,Ashley Nicole Mccray,DEM,130004,1,4,13,18,
Cimarron,Corporation Commissioner,Jackie Short,IND,130004,0,0,6,6,
Cimarron,U.S. House,Frank Lucas,REP,130004,3,26,115,144,3
Cimarron,U.S. House,Frankie Robbins,DEM,130004,1,2,10,13,3
Cimarron,State House,Kenton Patzkowsky,REP,130004,1,22,107,130,61
Cimarron,State House,Ashley Lehnert,DEM,130004,3,6,17,26,61
Cimarron,Governor,Chris Powell,LIB,130005,0,0,8,8,
Cimarron,Governor,Kevin Stitt,REP,130005,3,21,84,108,
Cimarron,Governor,Drew Edmondson,DEM,130005,0,3,13,16,
Cimarron,Lieutenant Governor,Matt Pinnell,REP,130005,3,22,90,115,
Cimarron,Lieutenant Governor,Anastasia Pittman,DEM,130005,0,2,12,14,
Cimarron,Lieutenant Governor,Ivan Holmes,IND,130005,0,0,3,3,
Cimarron,State Auditor,John Yeutter,LIB,130005,0,1,9,10,
Cimarron,State Auditor,Cindy Byrd,REP,130005,3,23,88,114,
Cimarron,Attorney General,Mike Hunter,REP,130005,3,21,93,117,
Cimarron,Attorney General,Mark Myles,DEM,130005,0,3,12,15,
Cimarron,State Treasurer,Randy Mcdaniel,REP,130005,3,23,90,116,
Cimarron,State Treasurer,Charles De Coune,IND,130005,0,1,7,8,
Cimarron,Superintendent of Public Instruction,Joy Hofmeister,REP,130005,3,22,80,105,
Cimarron,Superintendent of Public Instruction,John Cox,DEM,130005,0,2,18,20,
Cimarron,Superintendent of Public Instruction,Larry Huff,IND,130005,0,0,6,6,
Cimarron,Commissioner of Labor,Leslie Osborn,REP,130005,3,22,85,110,
Cimarron,Commissioner of Labor,Fred Dorrell,DEM,130005,0,2,14,16,
Cimarron,Commissioner of Labor,Brandt Dismukes,IND,130005,0,0,4,4,
Cimarron,Insurance Commissioner,Glen Mulready,REP,130005,3,22,88,113,
Cimarron,Insurance Commissioner,Kimberly Fobbs,DEM,130005,0,2,14,16,
Cimarron,Corporation Commissioner,Bob Anthony,REP,130005,3,21,81,105,
Cimarron,Corporation Commissioner,Ashley Nicole Mccray,DEM,130005,0,3,13,16,
Cimarron,Corporation Commissioner,Jackie Short,IND,130005,0,0,8,8,
Cimarron,U.S. House,Frank Lucas,REP,130005,3,22,93,118,3
Cimarron,U.S. House,Frankie Robbins,DEM,130005,0,2,12,14,3
Cimarron,State House,Kenton Patzkowsky,REP,130005,3,20,80,103,61
Cimarron,State House,Ashley Lehnert,DEM,130005,0,4,25,29,61
Cimarron,Governor,Chris Powell,LIB,130006,0,1,5,6,
Cimarron,Governor,Kevin Stitt,REP,130006,12,48,118,178,
Cimarron,Governor,Drew Edmondson,DEM,130006,1,4,18,23,
Cimarron,Lieutenant Governor,Matt Pinnell,REP,130006,13,49,118,180,
Cimarron,Lieutenant Governor,Anastasia Pittman,DEM,130006,0,1,17,18,
Cimarron,Lieutenant Governor,Ivan Holmes,IND,130006,0,3,5,8,
Cimarron,State Auditor,John Yeutter,LIB,130006,0,1,12,13,
Cimarron,State Auditor,Cindy Byrd,REP,130006,13,51,125,189,
Cimarron,Attorney General,Mike Hunter,REP,130006,12,49,120,181,
Cimarron,Attorney General,Mark Myles,DEM,130006,1,4,18,23,
Cimarron,State Treasurer,Randy Mcdaniel,REP,130006,13,50,127,190,
Cimarron,State Treasurer,Charles De Coune,IND,130006,0,3,9,12,
Cimarron,Superintendent of Public Instruction,Joy Hofmeister,REP,130006,9,44,110,163,
Cimarron,Superintendent of Public Instruction,John Cox,DEM,130006,1,4,20,25,
Cimarron,Superintendent of Public Instruction,Larry Huff,IND,130006,1,5,9,15,
Cimarron,Commissioner of Labor,Leslie Osborn,REP,130006,13,48,117,178,
Cimarron,Commissioner of Labor,Fred Dorrell,DEM,130006,0,3,16,19,
Cimarron,Commissioner of Labor,Brandt Dismukes,IND,130006,0,2,4,6,
Cimarron,Insurance Commissioner,Glen Mulready,REP,130006,11,49,118,178,
Cimarron,Insurance Commissioner,Kimberly Fobbs,DEM,130006,2,4,19,25,
Cimarron,Corporation Commissioner,Bob Anthony,REP,130006,12,45,110,167,
Cimarron,Corporation Commissioner,Ashley Nicole Mccray,DEM,130006,1,4,16,21,
Cimarron,Corporation Commissioner,Jackie Short,IND,130006,0,4,10,14,
Cimarron,U.S. House,Frank Lucas,REP,130006,13,51,129,193,3
Cimarron,U.S. House,Frankie Robbins,DEM,130006,0,2,13,15,3
Cimarron,State House,Kenton Patzkowsky,REP,130006,12,47,118,177,61
Cimarron,State House,Ashley Lehnert,DEM,130006,1,6,23,30,61
Cimarron,Governor,Chris Powell,LIB,130007,1,0,0,1,
Cimarron,Governor,Kevin Stitt,REP,130007,5,6,31,42,
Cimarron,Governor,Drew Edmondson,DEM,130007,0,1,3,4,
Cimarron,Lieutenant Governor,Matt Pinnell,REP,130007,6,4,31,41,
Cimarron,Lieutenant Governor,Anastasia Pittman,DEM,130007,0,2,3,5,
Cimarron,Lieutenant Governor,Ivan Holmes,IND,130007,0,1,0,1,
Cimarron,State Auditor,John Yeutter,LIB,130007,0,1,1,2,
Cimarron,State Auditor,Cindy Byrd,REP,130007,6,6,32,44,
Cimarron,Attorney General,Mike Hunter,REP,130007,6,5,31,42,
Cimarron,Attorney General,Mark Myles,DEM,130007,0,2,3,5,
Cimarron,State Treasurer,Randy Mcdaniel,REP,130007,6,5,31,42,
Cimarron,State Treasurer,Charles De Coune,IND,130007,0,2,2,4,
Cimarron,Superintendent of Public Instruction,Joy Hofmeister,REP,130007,5,6,28,39,
Cimarron,Superintendent of Public Instruction,John Cox,DEM,130007,0,1,4,5,
Cimarron,Superintendent of Public Instruction,Larry Huff,IND,130007,1,0,2,3,
Cimarron,Commissioner of Labor,Leslie Osborn,REP,130007,6,5,29,40,
Cimarron,Commissioner of Labor,Fred Dorrell,DEM,130007,0,1,3,4,
Cimarron,Commissioner of Labor,Brandt Dismukes,IND,130007,0,1,2,3,
Cimarron,Insurance Commissioner,Glen Mulready,REP,130007,5,5,29,39,
Cimarron,Insurance Commissioner,Kimberly Fobbs,DEM,130007,1,2,4,7,
Cimarron,Corporation Commissioner,Bob Anthony,REP,130007,4,4,27,35,
Cimarron,Corporation Commissioner,Ashley Nicole Mccray,DEM,130007,2,3,5,10,
Cimarron,Corporation Commissioner,Jackie Short,IND,130007,0,0,2,2,
Cimarron,U.S. House,Frank Lucas,REP,130007,6,7,32,45,3
Cimarron,U.S. House,Frankie Robbins,DEM,130007,0,1,2,3,3
Cimarron,State House,Kenton Patzkowsky,REP,130007,5,6,31,42,61
Cimarron,State House,Ashley Lehnert,DEM,130007,1,2,3,6,61
Cleveland,Governor,Chris Powell,LIB,140001,9,8,30,47,
Cleveland,Governor,Kevin Stitt,REP,140001,85,135,421,641,
Cleveland,Governor,Drew Edmondson,DEM,140001,133,225,593,951,
Cleveland,Lieutenant Governor,Matt Pinnell,REP,140001,110,151,530,791,
Cleveland,Lieutenant Governor,Anastasia Pittman,DEM,140001,109,199,463,771,
Cleveland,Lieutenant Governor,Ivan Holmes,IND,140001,8,15,39,62,
Cleveland,State Auditor,John Yeutter,LIB,140001,51,105,277,433,
Cleveland,State Auditor,Cindy Byrd,REP,140001,158,219,676,1053,
Cleveland,Attorney General,Mike Hunter,REP,140001,116,170,550,836,
Cleveland,Attorney General,Mark Myles,DEM,140001,110,194,477,781,
Cleveland,State Treasurer,Randy Mcdaniel,REP,140001,128,182,586,896,
Cleveland,State Treasurer,Charles De Coune,IND,140001,80,146,367,593,
Cleveland,Superintendent of Public Instruction,Joy Hofmeister,REP,140001,131,185,576,892,
Cleveland,Superintendent of Public Instruction,John Cox,DEM,140001,90,161,401,652,
Cleveland,Superintendent of Public Instruction,Larry Huff,IND,140001,4,19,57,80,
Cleveland,Commissioner of Labor,Leslie Osborn,REP,140001,120,169,557,846,
Cleveland,Commissioner of Labor,Fred Dorrell,DEM,140001,101,177,415,693,
Cleveland,Commissioner of Labor,Brandt Dismukes,IND,140001,6,16,46,68,
Cleveland,Insurance Commissioner,Glen Mulready,REP,140001,115,159,522,796,
Cleveland,Insurance Commissioner,Kimberly Fobbs,DEM,140001,110,200,493,803,
Cleveland,Corporation Commissioner,Bob Anthony,REP,140001,122,160,519,801,
Cleveland,Corporation Commissioner,Ashley Nicole Mccray,DEM,140001,97,187,449,733,
Cleveland,Corporation Commissioner,Jackie Short,IND,140001,7,18,55,80,
Cleveland,U.S. House,Tom Cole,REP,140001,110,164,547,821,4
Cleveland,U.S. House,Mary Brannon,DEM,140001,111,192,445,748,4
Cleveland,U.S. House,Ruby Peters,IND,140001,6,11,41,58,4
Cleveland,State House,Marc Etters,REP,140001,101,138,473,712,45
Cleveland,State House,Merleyn Bell,DEM,140001,117,203,487,807,45
Cleveland,State House,Tom Hackelman,IND,140001,9,23,55,87,45
Cleveland,Governor,Chris Powell,LIB,140002,0,2,28,30,
Cleveland,Governor,Kevin Stitt,REP,140002,6,9,99,114,
Cleveland,Governor,Drew Edmondson,DEM,140002,20,40,327,387,
Cleveland,Lieutenant Governor,Matt Pinnell,REP,140002,7,11,114,132,
Cleveland,Lieutenant Governor,Anastasia Pittman,DEM,140002,16,34,303,353,
Cleveland,Lieutenant Governor,Ivan Holmes,IND,140002,2,5,34,41,
Cleveland,State Auditor,John Yeutter,LIB,140002,15,16,213,244,
Cleveland,State Auditor,Cindy Byrd,REP,140002,7,25,182,214,
Cleveland,Attorney General,Mike Hunter,REP,140002,7,13,133,153,
Cleveland,Attorney General,Mark Myles,DEM,140002,19,37,318,374,
Cleveland,State Treasurer,Randy Mcdaniel,REP,140002,8,15,147,170,
Cleveland,State Treasurer,Charles De Coune,IND,140002,14,28,245,287,
Cleveland,Superintendent of Public Instruction,Joy Hofmeister,REP,140002,6,18,144,168,
Cleveland,Superintendent of Public Instruction,John Cox,DEM,140002,18,29,275,322,
Cleveland,Superintendent of Public Instruction,Larry Huff,IND,140002,2,3,30,35,
Cleveland,Commissioner of Labor,Leslie Osborn,REP,140002,8,16,135,159,
Cleveland,Commissioner of Labor,Fred Dorrell,DEM,140002,17,30,284,331,
Cleveland,Commissioner of Labor,Brandt Dismukes,IND,140002,1,4,27,32,
Cleveland,Insurance Commissioner,Glen Mulready,REP,140002,6,14,121,141,
Cleveland,Insurance Commissioner,Kimberly Fobbs,DEM,140002,20,36,326,382,
Cleveland,Corporation Commissioner,Bob Anthony,REP,140002,7,14,124,145,
Cleveland,Corporation Commissioner,Ashley Nicole Mccray,DEM,140002,18,33,291,342,
Cleveland,Corporation Commissioner,Jackie Short,IND,140002,1,3,36,40,
Cleveland,U.S. House,Tom Cole,REP,140002,6,14,124,144,4
Cleveland,U.S. House,Mary Brannon,DEM,140002,19,34,307,360,4
Cleveland,U.S. House,Ruby Peters,IND,140002,1,3,22,26,4
Cleveland,State Senate,Becki Maldonado,REP,140002,7,13,117,137,16
Cleveland,State Senate,Mary Boren,DEM,140002,19,37,335,391,16
Cleveland,Governor,Chris Powell,LIB,140003,0,0,30,30,
Cleveland,Governor,Kevin Stitt,REP,140003,4,15,192,211,
Cleveland,Governor,Drew Edmondson,DEM,140003,32,52,413,497,
Cleveland,Lieutenant Governor,Matt Pinnell,REP,140003,8,21,244,273,
Cleveland,Lieutenant Governor,Anastasia Pittman,DEM,140003,26,45,339,410,
Cleveland,Lieutenant Governor,Ivan Holmes,IND,140003,3,1,45,49,
Cleveland,State Auditor,John Yeutter,LIB,140003,17,21,218,256,
Cleveland,State Auditor,Cindy Byrd,REP,140003,14,34,341,389,
Cleveland,Attorney General,Mike Hunter,REP,140003,8,25,266,299,
Cleveland,Attorney General,Mark Myles,DEM,140003,29,42,359,430,
Cleveland,State Treasurer,Randy Mcdaniel,REP,140003,11,25,289,325,
Cleveland,State Treasurer,Charles De Coune,IND,140003,23,29,268,320,
Cleveland,Superintendent of Public Instruction,Joy Hofmeister,REP,140003,9,26,277,312,
Cleveland,Superintendent of Public Instruction,John Cox,DEM,140003,27,37,299,363,
Cleveland,Superintendent of Public Instruction,Larry Huff,IND,140003,1,4,54,59,
Cleveland,Commissioner of Labor,Leslie Osborn,REP,140003,9,21,274,304,
Cleveland,Commissioner of Labor,Fred Dorrell,DEM,140003,28,43,310,381,
Cleveland,Commissioner of Labor,Brandt Dismukes,IND,140003,0,3,38,41,
Cleveland,Insurance Commissioner,Glen Mulready,REP,140003,6,27,243,276,
Cleveland,Insurance Commissioner,Kimberly Fobbs,DEM,140003,31,40,375,446,
Cleveland,Corporation Commissioner,Bob Anthony,REP,140003,9,29,274,312,
Cleveland,Corporation Commissioner,Ashley Nicole Mccray,DEM,140003,27,37,307,371,
Cleveland,Corporation Commissioner,Jackie Short,IND,140003,1,1,43,45,
Cleveland,U.S. House,Tom Cole,REP,140003,12,27,270,309,4
Cleveland,U.S. House,Mary Brannon,DEM,140003,25,40,330,395,4
Cleveland,U.S. House,Ruby Peters,IND,140003,0,0,31,31,4
Cleveland,State House,Marc Etters,REP,140003,5,19,219,243,45
Cleveland,State House,Merleyn Bell,DEM,140003,31,48,360,439,45
Cleveland,State House,Tom Hackelman,IND,140003,1,0,46,47,45
Cleveland,Governor,Chris Powell,LIB,140004,5,6,28,39,
Cleveland,Governor,Kevin Stitt,REP,140004,111,198,746,1055,
Cleveland,Governor,Drew Edmondson,DEM,140004,56,135,402,593,
Cleveland,Lieutenant Governor,Matt Pinnell,REP,140004,119,232,841,1192,
Cleveland,Lieutenant Governor,Anastasia Pittman,DEM,140004,47,103,296,446,
Cleveland,Lieutenant Governor,Ivan Holmes,IND,140004,5,4,23,32,
Cleveland,State Auditor,John Yeutter,LIB,140004,26,53,183,262,
Cleveland,State Auditor,Cindy Byrd,REP,140004,130,247,893,1270,
Cleveland,Attorney General,Mike Hunter,REP,140004,125,230,856,1211,
Cleveland,Attorney General,Mark Myles,DEM,140004,46,106,306,458,
Cleveland,State Treasurer,Randy Mcdaniel,REP,140004,127,229,873,1229,
Cleveland,State Treasurer,Charles De Coune,IND,140004,31,72,203,306,
Cleveland,Superintendent of Public Instruction,Joy Hofmeister,REP,140004,117,218,804,1139,
Cleveland,Superintendent of Public Instruction,John Cox,DEM,140004,39,92,282,413,
Cleveland,Superintendent of Public Instruction,Larry Huff,IND,140004,15,27,79,121,
Cleveland,Commissioner of Labor,Leslie Osborn,REP,140004,122,222,817,1161,
Cleveland,Commissioner of Labor,Fred Dorrell,DEM,140004,42,95,291,428,
Cleveland,Commissioner of Labor,Brandt Dismukes,IND,140004,7,15,38,60,
Cleveland,Insurance Commissioner,Glen Mulready,REP,140004,124,224,817,1165,
Cleveland,Insurance Commissioner,Kimberly Fobbs,DEM,140004,48,106,330,484,
Cleveland,Corporation Commissioner,Bob Anthony,REP,140004,118,212,798,1128,
Cleveland,Corporation Commissioner,Ashley Nicole Mccray,DEM,140004,43,107,311,461,
Cleveland,Corporation Commissioner,Jackie Short,IND,140004,11,17,47,75,
Cleveland,U.S. House,Tom Cole,REP,140004,121,225,851,1197,4
Cleveland,U.S. House,Mary Brannon,DEM,140004,47,101,289,437,4
Cleveland,U.S. House,Ruby Peters,IND,140004,4,11,29,44,4
Cleveland,State House,Chris Kannady,REP,140004,122,214,795,1131,91
Cleveland,State House,Amanda Jeffers,DEM,140004,51,121,365,537,91
Cleveland,Governor,Chris Powell,LIB,140005,7,11,61,79,
Cleveland,Governor,Kevin Stitt,REP,140005,128,144,761,1033,
Cleveland,Governor,Drew Edmondson,DEM,140005,86,113,566,765,
Cleveland,Lieutenant Governor,Matt Pinnell,REP,140005,144,161,875,1180,
Cleveland,Lieutenant Governor,Anastasia Pittman,DEM,140005,69,98,453,620,
Cleveland,Lieutenant Governor,Ivan Holmes,IND,140005,6,7,53,66,
Cleveland,State Auditor,John Yeutter,LIB,140005,41,61,296,398,
Cleveland,State Auditor,Cindy Byrd,REP,140005,160,186,993,1339,
Cleveland,Attorney General,Mike Hunter,REP,140005,155,167,914,1236,
Cleveland,Attorney General,Mark Myles,DEM,140005,65,100,456,621,
Cleveland,State Treasurer,Randy Mcdaniel,REP,140005,150,177,933,1260,
Cleveland,State Treasurer,Charles De Coune,IND,140005,51,69,355,475,
Cleveland,Superintendent of Public Instruction,Joy Hofmeister,REP,140005,151,166,857,1174,
Cleveland,Superintendent of Public Instruction,John Cox,DEM,140005,60,84,395,539,
Cleveland,Superintendent of Public Instruction,Larry Huff,IND,140005,10,18,121,149,
Cleveland,Commissioner of Labor,Leslie Osborn,REP,140005,152,165,883,1200,
Cleveland,Commissioner of Labor,Fred Dorrell,DEM,140005,60,87,399,546,
Cleveland,Commissioner of Labor,Brandt Dismukes,IND,140005,6,12,79,97,
Cleveland,Insurance Commissioner,Glen Mulready,REP,140005,143,162,875,1180,
Cleveland,Insurance Commissioner,Kimberly Fobbs,DEM,140005,76,104,483,663,
Cleveland,Corporation Commissioner,Bob Anthony,REP,140005,145,162,827,1134,
Cleveland,Corporation Commissioner,Ashley Nicole Mccray,DEM,140005,69,86,446,601,
Cleveland,Corporation Commissioner,Jackie Short,IND,140005,9,19,95,123,
Cleveland,U.S. House,Tom Cole,REP,140005,143,165,911,1219,4
Cleveland,U.S. House,Mary Brannon,DEM,140005,72,91,409,572,4
Cleveland,U.S. House,Ruby Peters,IND,140005,6,10,62,78,4
Cleveland,State Senate,Darrell Weaver,REP,140005,148,164,910,1222,24
Cleveland,State Senate,RenÉE Jerden,DEM,140005,68,99,456,623,24
Cleveland,State House,Kevin West,REP,140005,143,159,857,1159,54
Cleveland,State House,Katelyn Dockery,DEM,140005,78,107,511,696,54
Cleveland,Governor,Chris Powell,LIB,140006,2,0,11,13,
Cleveland,Governor,Kevin Stitt,REP,140006,9,3,119,131,
Cleveland,Governor,Drew Edmondson,DEM,140006,72,102,545,719,
Cleveland,Lieutenant Governor,Matt Pinnell,REP,140006,14,6,150,170,
Cleveland,Lieutenant Governor,Anastasia Pittman,DEM,140006,65,93,478,636,
Cleveland,Lieutenant Governor,Ivan Holmes,IND,140006,3,7,41,51,
Cleveland,State Auditor,John Yeutter,LIB,140006,30,55,297,382,
Cleveland,State Auditor,Cindy Byrd,REP,140006,28,31,253,312,
Cleveland,Attorney General,Mike Hunter,REP,140006,14,8,156,178,
Cleveland,Attorney General,Mark Myles,DEM,140006,68,97,509,674,
Cleveland,State Treasurer,Randy Mcdaniel,REP,140006,22,17,198,237,
Cleveland,State Treasurer,Charles De Coune,IND,140006,40,70,360,470,
Cleveland,Superintendent of Public Instruction,Joy Hofmeister,REP,140006,30,24,204,258,
Cleveland,Superintendent of Public Instruction,John Cox,DEM,140006,51,80,433,564,
Cleveland,Superintendent of Public Instruction,Larry Huff,IND,140006,2,2,30,34,
Cleveland,Commissioner of Labor,Leslie Osborn,REP,140006,21,16,175,212,
Cleveland,Commissioner of Labor,Fred Dorrell,DEM,140006,55,88,465,608,
Cleveland,Commissioner of Labor,Brandt Dismukes,IND,140006,6,1,19,26,
Cleveland,Insurance Commissioner,Glen Mulready,REP,140006,16,7,149,172,
Cleveland,Insurance Commissioner,Kimberly Fobbs,DEM,140006,66,99,515,680,
Cleveland,Corporation Commissioner,Bob Anthony,REP,140006,20,10,165,195,
Cleveland,Corporation Commissioner,Ashley Nicole Mccray,DEM,140006,62,93,475,630,
Cleveland,Corporation Commissioner,Jackie Short,IND,140006,0,3,25,28,
Cleveland,U.S. House,Tom Cole,REP,140006,15,8,154,177,4
Cleveland,U.S. House,Mary Brannon,DEM,140006,67,95,491,653,4
Cleveland,U.S. House,Ruby Peters,IND,140006,0,2,27,29,4
Cleveland,State Senate,Becki Maldonado,REP,140006,12,6,130,148,16
Cleveland,State Senate,Mary Boren,DEM,140006,68,100,540,708,16
Cleveland,Governor,Chris Powell,LIB,140007,5,2,24,31,
Cleveland,Governor,Kevin Stitt,REP,140007,64,108,721,893,
Cleveland,Governor,Drew Edmondson,DEM,140007,44,96,414,554,
Cleveland,Lieutenant Governor,Matt Pinnell,REP,140007,75,129,821,1025,
Cleveland,Lieutenant Governor,Anastasia Pittman,DEM,140007,35,73,294,402,
Cleveland,Lieutenant Governor,Ivan Holmes,IND,140007,4,3,32,39,
Cleveland,State Auditor,John Yeutter,LIB,140007,22,41,187,250,
Cleveland,State Auditor,Cindy Byrd,REP,140007,82,146,876,1104,
Cleveland,Attorney General,Mike Hunter,REP,140007,76,134,845,1055,
Cleveland,Attorney General,Mark Myles,DEM,140007,37,73,294,404,
Cleveland,State Treasurer,Randy Mcdaniel,REP,140007,80,135,834,1049,
Cleveland,State Treasurer,Charles De Coune,IND,140007,24,55,224,303,
Cleveland,Superintendent of Public Instruction,Joy Hofmeister,REP,140007,71,135,798,1004,
Cleveland,Superintendent of Public Instruction,John Cox,DEM,140007,35,58,295,388,
Cleveland,Superintendent of Public Instruction,Larry Huff,IND,140007,5,12,55,72,
Cleveland,Commissioner of Labor,Leslie Osborn,REP,140007,76,139,846,1061,
Cleveland,Commissioner of Labor,Fred Dorrell,DEM,140007,34,62,241,337,
Cleveland,Commissioner of Labor,Brandt Dismukes,IND,140007,4,3,39,46,
Cleveland,Insurance Commissioner,Glen Mulready,REP,140007,69,121,818,1008,
Cleveland,Insurance Commissioner,Kimberly Fobbs,DEM,140007,43,82,308,433,
Cleveland,Corporation Commissioner,Bob Anthony,REP,140007,69,120,793,982,
Cleveland,Corporation Commissioner,Ashley Nicole Mccray,DEM,140007,37,75,293,405,
Cleveland,Corporation Commissioner,Jackie Short,IND,140007,7,11,41,59,
Cleveland,U.S. House,Tom Cole,REP,140007,75,131,836,1042,4
Cleveland,U.S. House,Mary Brannon,DEM,140007,35,72,270,377,4
Cleveland,U.S. House,Ruby Peters,IND,140007,3,3,34,40,4
Cleveland,State House,Jon Echols,REP,140007,78,139,871,1088,90
Cleveland,State House,Lavelle Compton,DEM,140007,36,69,273,378,90
Cleveland,Governor,Chris Powell,LIB,140008,1,0,20,21,
Cleveland,Governor,Kevin Stitt,REP,140008,11,13,80,104,
Cleveland,Governor,Drew Edmondson,DEM,140008,42,55,547,644,
Cleveland,Lieutenant Governor,Matt Pinnell,REP,140008,12,16,113,141,
Cleveland,Lieutenant Governor,Anastasia Pittman,DEM,140008,42,47,482,571,
Cleveland,Lieutenant Governor,Ivan Holmes,IND,140008,0,4,42,46,
Cleveland,State Auditor,John Yeutter,LIB,140008,19,26,306,351,
Cleveland,State Auditor,Cindy Byrd,REP,140008,20,32,199,251,
Cleveland,Attorney General,Mike Hunter,REP,140008,12,16,121,149,
Cleveland,Attorney General,Mark Myles,DEM,140008,41,51,511,603,
Cleveland,State Treasurer,Randy Mcdaniel,REP,140008,10,20,144,174,
Cleveland,State Treasurer,Charles De Coune,IND,140008,30,40,376,446,
Cleveland,Superintendent of Public Instruction,Joy Hofmeister,REP,140008,17,25,154,196,
Cleveland,Superintendent of Public Instruction,John Cox,DEM,140008,34,39,448,521,
Cleveland,Superintendent of Public Instruction,Larry Huff,IND,140008,2,3,34,39,
Cleveland,Commissioner of Labor,Leslie Osborn,REP,140008,12,24,139,175,
Cleveland,Commissioner of Labor,Fred Dorrell,DEM,140008,40,40,449,529,
Cleveland,Commissioner of Labor,Brandt Dismukes,IND,140008,0,2,40,42,
Cleveland,Insurance Commissioner,Glen Mulready,REP,140008,11,15,109,135,
Cleveland,Insurance Commissioner,Kimberly Fobbs,DEM,140008,40,52,518,610,
Cleveland,Corporation Commissioner,Bob Anthony,REP,140008,11,14,124,149,
Cleveland,Corporation Commissioner,Ashley Nicole Mccray,DEM,140008,39,50,474,563,
Cleveland,Corporation Commissioner,Jackie Short,IND,140008,1,2,34,37,
Cleveland,U.S. House,Tom Cole,REP,140008,12,19,128,159,4
Cleveland,U.S. House,Mary Brannon,DEM,140008,41,48,483,572,4
Cleveland,U.S. House,Ruby Peters,IND,140008,1,1,26,28,4
Cleveland,State Senate,Becki Maldonado,REP,140008,12,14,94,120,16
Cleveland,State Senate,Mary Boren,DEM,140008,42,53,541,636,16
Cleveland,Governor,Chris Powell,LIB,140009,2,5,41,48,
Cleveland,Governor,Kevin Stitt,REP,140009,58,145,641,844,
Cleveland,Governor,Drew Edmondson,DEM,140009,64,118,492,674,
Cleveland,Lieutenant Governor,Matt Pinnell,REP,140009,72,165,749,986,
Cleveland,Lieutenant Governor,Anastasia Pittman,DEM,140009,44,94,376,514,
Cleveland,Lieutenant Governor,Ivan Holmes,IND,140009,2,8,41,51,
Cleveland,State Auditor,John Yeutter,LIB,140009,25,63,250,338,
Cleveland,State Auditor,Cindy Byrd,REP,140009,82,189,832,1103,
Cleveland,Attorney General,Mike Hunter,REP,140009,79,176,788,1043,
Cleveland,Attorney General,Mark Myles,DEM,140009,43,91,369,503,
Cleveland,State Treasurer,Randy Mcdaniel,REP,140009,74,173,771,1018,
Cleveland,State Treasurer,Charles De Coune,IND,140009,33,78,308,419,
Cleveland,Superintendent of Public Instruction,Joy Hofmeister,REP,140009,68,170,718,956,
Cleveland,Superintendent of Public Instruction,John Cox,DEM,140009,48,78,338,464,
Cleveland,Superintendent of Public Instruction,Larry Huff,IND,140009,5,19,101,125,
Cleveland,Commissioner of Labor,Leslie Osborn,REP,140009,75,174,744,993,
Cleveland,Commissioner of Labor,Fred Dorrell,DEM,140009,40,83,331,454,
Cleveland,Commissioner of Labor,Brandt Dismukes,IND,140009,5,8,65,78,
Cleveland,Insurance Commissioner,Glen Mulready,REP,140009,68,164,745,977,
Cleveland,Insurance Commissioner,Kimberly Fobbs,DEM,140009,52,100,393,545,
Cleveland,Corporation Commissioner,Bob Anthony,REP,140009,67,162,703,932,
Cleveland,Corporation Commissioner,Ashley Nicole Mccray,DEM,140009,47,91,373,511,
Cleveland,Corporation Commissioner,Jackie Short,IND,140009,6,13,68,87,
Cleveland,U.S. House,Tom Cole,REP,140009,74,160,770,1004,4
Cleveland,U.S. House,Mary Brannon,DEM,140009,45,99,350,494,4
Cleveland,U.S. House,Ruby Peters,IND,140009,4,8,41,53,4
Cleveland,State Senate,Darrell Weaver,REP,140009,75,167,763,1005,24
Cleveland,State Senate,RenÉE Jerden,DEM,140009,46,97,380,523,24
Cleveland,State House,Chris Kannady,REP,140009,70,163,743,976,91
Cleveland,State House,Amanda Jeffers,DEM,140009,51,101,409,561,91
Cleveland,Governor,Chris Powell,LIB,140010,0,1,25,26,
Cleveland,Governor,Kevin Stitt,REP,140010,27,36,361,424,
Cleveland,Governor,Drew Edmondson,DEM,140010,30,23,290,343,
Cleveland,Lieutenant Governor,Matt Pinnell,REP,140010,30,43,404,477,
Cleveland,Lieutenant Governor,Anastasia Pittman,DEM,140010,27,15,237,279,
Cleveland,Lieutenant Governor,Ivan Holmes,IND,140010,0,2,29,31,
Cleveland,State Auditor,John Yeutter,LIB,140010,16,8,165,189,
Cleveland,State Auditor,Cindy Byrd,REP,140010,35,47,453,535,
Cleveland,Attorney General,Mike Hunter,REP,140010,30,39,414,483,
Cleveland,Attorney General,Mark Myles,DEM,140010,26,21,251,298,
Cleveland,State Treasurer,Randy Mcdaniel,REP,140010,33,41,417,491,
Cleveland,State Treasurer,Charles De Coune,IND,140010,19,15,194,228,
Cleveland,Superintendent of Public Instruction,Joy Hofmeister,REP,140010,33,43,363,439,
Cleveland,Superintendent of Public Instruction,John Cox,DEM,140010,20,15,229,264,
Cleveland,Superintendent of Public Instruction,Larry Huff,IND,140010,4,1,73,78,
Cleveland,Commissioner of Labor,Leslie Osborn,REP,140010,34,42,391,467,
Cleveland,Commissioner of Labor,Fred Dorrell,DEM,140010,22,16,231,269,
Cleveland,Commissioner of Labor,Brandt Dismukes,IND,140010,1,2,34,37,
Cleveland,Insurance Commissioner,Glen Mulready,REP,140010,32,42,407,481,
Cleveland,Insurance Commissioner,Kimberly Fobbs,DEM,140010,25,18,253,296,
Cleveland,Corporation Commissioner,Bob Anthony,REP,140010,30,39,396,465,
Cleveland,Corporation Commissioner,Ashley Nicole Mccray,DEM,140010,24,18,224,266,
Cleveland,Corporation Commissioner,Jackie Short,IND,140010,3,3,45,51,
Cleveland,U.S. House,Tom Cole,REP,140010,33,40,401,474,4
Cleveland,U.S. House,Mary Brannon,DEM,140010,24,18,245,287,4
Cleveland,U.S. House,Ruby Peters,IND,140010,0,2,23,25,4
Cleveland,State House,Kevin West,REP,140010,32,41,375,448,54
Cleveland,State House,Katelyn Dockery,DEM,140010,24,19,284,327,54
Cleveland,Governor,Chris Powell,LIB,140011,0,2,25,27,
Cleveland,Governor,Kevin Stitt,REP,140011,6,15,182,203,
Cleveland,Governor,Drew Edmondson,DEM,140011,50,67,605,722,
Cleveland,Lieutenant Governor,Matt Pinnell,REP,140011,7,18,237,262,
Cleveland,Lieutenant Governor,Anastasia Pittman,DEM,140011,47,63,511,621,
Cleveland,Lieutenant Governor,Ivan Holmes,IND,140011,4,2,54,60,
Cleveland,State Auditor,John Yeutter,LIB,140011,30,26,311,367,
Cleveland,State Auditor,Cindy Byrd,REP,140011,14,38,363,415,
Cleveland,Attorney General,Mike Hunter,REP,140011,7,22,264,293,
Cleveland,Attorney General,Mark Myles,DEM,140011,51,61,538,650,
Cleveland,State Treasurer,Randy Mcdaniel,REP,140011,10,32,284,326,
Cleveland,State Treasurer,Charles De Coune,IND,140011,36,34,398,468,
Cleveland,Superintendent of Public Instruction,Joy Hofmeister,REP,140011,13,29,291,333,
Cleveland,Superintendent of Public Instruction,John Cox,DEM,140011,39,50,446,535,
Cleveland,Superintendent of Public Instruction,Larry Huff,IND,140011,5,4,63,72,
Cleveland,Commissioner of Labor,Leslie Osborn,REP,140011,12,29,264,305,
Cleveland,Commissioner of Labor,Fred Dorrell,DEM,140011,41,52,477,570,
Cleveland,Commissioner of Labor,Brandt Dismukes,IND,140011,4,1,53,58,
Cleveland,Insurance Commissioner,Glen Mulready,REP,140011,9,20,231,260,
Cleveland,Insurance Commissioner,Kimberly Fobbs,DEM,140011,48,62,557,667,
Cleveland,Corporation Commissioner,Bob Anthony,REP,140011,12,18,235,265,
Cleveland,Corporation Commissioner,Ashley Nicole Mccray,DEM,140011,43,62,515,620,
Cleveland,Corporation Commissioner,Jackie Short,IND,140011,4,2,49,55,
Cleveland,U.S. House,Tom Cole,REP,140011,9,19,244,272,4
Cleveland,U.S. House,Mary Brannon,DEM,140011,46,64,529,639,4
Cleveland,U.S. House,Ruby Peters,IND,140011,3,0,33,36,4
Cleveland,State Senate,Becki Maldonado,REP,140011,7,16,217,240,16
Cleveland,State Senate,Mary Boren,DEM,140011,52,68,588,708,16
Cleveland,Governor,Chris Powell,LIB,140012,3,8,37,48,
Cleveland,Governor,Kevin Stitt,REP,140012,45,77,473,595,
Cleveland,Governor,Drew Edmondson,DEM,140012,73,127,513,713,
Cleveland,Lieutenant Governor,Matt Pinnell,REP,140012,48,88,556,692,
Cleveland,Lieutenant Governor,Anastasia Pittman,DEM,140012,68,117,433,618,
Cleveland,Lieutenant Governor,Ivan Holmes,IND,140012,4,7,33,44,
Cleveland,State Auditor,John Yeutter,LIB,140012,34,55,263,352,
Cleveland,State Auditor,Cindy Byrd,REP,140012,64,126,652,842,
Cleveland,Attorney General,Mike Hunter,REP,140012,55,94,592,741,
Cleveland,Attorney General,Mark Myles,DEM,140012,64,118,421,603,
Cleveland,State Treasurer,Randy Mcdaniel,REP,140012,51,99,609,759,
Cleveland,State Treasurer,Charles De Coune,IND,140012,47,85,302,434,
Cleveland,Superintendent of Public Instruction,Joy Hofmeister,REP,140012,50,86,569,705,
Cleveland,Superintendent of Public Instruction,John Cox,DEM,140012,57,106,364,527,
Cleveland,Superintendent of Public Instruction,Larry Huff,IND,140012,12,18,82,112,
Cleveland,Commissioner of Labor,Leslie Osborn,REP,140012,58,89,562,709,
Cleveland,Commissioner of Labor,Fred Dorrell,DEM,140012,57,115,384,556,
Cleveland,Commissioner of Labor,Brandt Dismukes,IND,140012,3,8,58,69,
Cleveland,Insurance Commissioner,Glen Mulready,REP,140012,53,85,552,690,
Cleveland,Insurance Commissioner,Kimberly Fobbs,DEM,140012,63,125,454,642,
Cleveland,Corporation Commissioner,Bob Anthony,REP,140012,48,85,538,671,
Cleveland,Corporation Commissioner,Ashley Nicole Mccray,DEM,140012,64,117,410,591,
Cleveland,Corporation Commissioner,Jackie Short,IND,140012,4,9,65,78,
Cleveland,U.S. House,Tom Cole,REP,140012,53,93,579,725,4
Cleveland,U.S. House,Mary Brannon,DEM,140012,61,115,405,581,4
Cleveland,U.S. House,Ruby Peters,IND,140012,5,5,40,50,4
Cleveland,State House,Marc Etters,REP,140012,45,82,523,650,45
Cleveland,State House,Merleyn Bell,DEM,140012,68,123,437,628,45
Cleveland,State House,Tom Hackelman,IND,140012,5,8,54,67,45
Cleveland,Governor,Chris Powell,LIB,140013,0,0,4,4,
Cleveland,Governor,Kevin Stitt,REP,140013,2,0,57,59,
Cleveland,Governor,Drew Edmondson,DEM,140013,15,21,245,281,
Cleveland,Lieutenant Governor,Matt Pinnell,REP,140013,2,0,73,75,
Cleveland,Lieutenant Governor,Anastasia Pittman,DEM,140013,14,20,210,244,
Cleveland,Lieutenant Governor,Ivan Holmes,IND,140013,1,1,13,15,
Cleveland,State Auditor,John Yeutter,LIB,140013,6,15,145,166,
Cleveland,State Auditor,Cindy Byrd,REP,140013,7,5,131,143,
Cleveland,Attorney General,Mike Hunter,REP,140013,3,1,73,77,
Cleveland,Attorney General,Mark Myles,DEM,140013,13,20,220,253,
Cleveland,State Treasurer,Randy Mcdaniel,REP,140013,5,4,96,105,
Cleveland,State Treasurer,Charles De Coune,IND,140013,8,15,178,201,
Cleveland,Superintendent of Public Instruction,Joy Hofmeister,REP,140013,2,3,76,81,
Cleveland,Superintendent of Public Instruction,John Cox,DEM,140013,13,17,205,235,
Cleveland,Superintendent of Public Instruction,Larry Huff,IND,140013,1,1,16,18,
Cleveland,Commissioner of Labor,Leslie Osborn,REP,140013,4,3,90,97,
Cleveland,Commissioner of Labor,Fred Dorrell,DEM,140013,12,16,192,220,
Cleveland,Commissioner of Labor,Brandt Dismukes,IND,140013,0,2,11,13,
Cleveland,Insurance Commissioner,Glen Mulready,REP,140013,1,1,82,84,
Cleveland,Insurance Commissioner,Kimberly Fobbs,DEM,140013,15,20,208,243,
Cleveland,Corporation Commissioner,Bob Anthony,REP,140013,4,0,63,67,
Cleveland,Corporation Commissioner,Ashley Nicole Mccray,DEM,140013,11,20,208,239,
Cleveland,Corporation Commissioner,Jackie Short,IND,140013,0,1,21,22,
Cleveland,U.S. House,Tom Cole,REP,140013,1,0,76,77,4
Cleveland,U.S. House,Mary Brannon,DEM,140013,15,20,210,245,4
Cleveland,U.S. House,Ruby Peters,IND,140013,0,1,10,11,4
Cleveland,Governor,Chris Powell,LIB,140014,0,2,36,38,
Cleveland,Governor,Kevin Stitt,REP,140014,7,7,128,142,
Cleveland,Governor,Drew Edmondson,DEM,140014,53,55,526,634,
Cleveland,Lieutenant Governor,Matt Pinnell,REP,140014,12,13,159,184,
Cleveland,Lieutenant Governor,Anastasia Pittman,DEM,140014,45,49,477,571,
Cleveland,Lieutenant Governor,Ivan Holmes,IND,140014,3,2,48,53,
Cleveland,State Auditor,John Yeutter,LIB,140014,28,27,323,378,
Cleveland,State Auditor,Cindy Byrd,REP,140014,19,18,256,293,
Cleveland,Attorney General,Mike Hunter,REP,140014,13,11,185,209,
Cleveland,Attorney General,Mark Myles,DEM,140014,46,53,498,597,
Cleveland,State Treasurer,Randy Mcdaniel,REP,140014,13,16,202,231,
Cleveland,State Treasurer,Charles De Coune,IND,140014,35,35,384,454,
Cleveland,Superintendent of Public Instruction,Joy Hofmeister,REP,140014,13,16,181,210,
Cleveland,Superintendent of Public Instruction,John Cox,DEM,140014,42,45,439,526,
Cleveland,Superintendent of Public Instruction,Larry Huff,IND,140014,4,2,60,66,
Cleveland,Commissioner of Labor,Leslie Osborn,REP,140014,14,15,193,222,
Cleveland,Commissioner of Labor,Fred Dorrell,DEM,140014,40,48,441,529,
Cleveland,Commissioner of Labor,Brandt Dismukes,IND,140014,5,0,44,49,
Cleveland,Insurance Commissioner,Glen Mulready,REP,140014,10,12,179,201,
Cleveland,Insurance Commissioner,Kimberly Fobbs,DEM,140014,49,50,493,592,
Cleveland,Corporation Commissioner,Bob Anthony,REP,140014,12,9,160,181,
Cleveland,Corporation Commissioner,Ashley Nicole Mccray,DEM,140014,43,52,457,552,
Cleveland,Corporation Commissioner,Jackie Short,IND,140014,4,1,61,66,
Cleveland,U.S. House,Tom Cole,REP,140014,11,8,177,196,4
Cleveland,U.S. House,Mary Brannon,DEM,140014,43,53,470,566,4
Cleveland,U.S. House,Ruby Peters,IND,140014,5,3,38,46,4
Cleveland,State Senate,Becki Maldonado,REP,140014,12,11,166,189,16
Cleveland,State Senate,Mary Boren,DEM,140014,46,51,515,612,16
Cleveland,Governor,Chris Powell,LIB,140015,1,0,19,20,
Cleveland,Governor,Kevin Stitt,REP,140015,9,22,203,234,
Cleveland,Governor,Drew Edmondson,DEM,140015,44,97,609,750,
Cleveland,Lieutenant Governor,Matt Pinnell,REP,140015,10,27,242,279,
Cleveland,Lieutenant Governor,Anastasia Pittman,DEM,140015,40,84,532,656,
Cleveland,Lieutenant Governor,Ivan Holmes,IND,140015,3,6,50,59,
Cleveland,State Auditor,John Yeutter,LIB,140015,19,55,320,394,
Cleveland,State Auditor,Cindy Byrd,REP,140015,21,47,367,435,
Cleveland,Attorney General,Mike Hunter,REP,140015,17,32,281,330,
Cleveland,Attorney General,Mark Myles,DEM,140015,36,86,535,657,
Cleveland,State Treasurer,Randy Mcdaniel,REP,140015,15,35,285,335,
Cleveland,State Treasurer,Charles De Coune,IND,140015,28,70,410,508,
Cleveland,Superintendent of Public Instruction,Joy Hofmeister,REP,140015,15,41,291,347,
Cleveland,Superintendent of Public Instruction,John Cox,DEM,140015,33,77,467,577,
Cleveland,Superintendent of Public Instruction,Larry Huff,IND,140015,4,0,61,65,
Cleveland,Commissioner of Labor,Leslie Osborn,REP,140015,9,35,260,304,
Cleveland,Commissioner of Labor,Fred Dorrell,DEM,140015,40,80,505,625,
Cleveland,Commissioner of Labor,Brandt Dismukes,IND,140015,3,2,46,51,
Cleveland,Insurance Commissioner,Glen Mulready,REP,140015,11,26,254,291,
Cleveland,Insurance Commissioner,Kimberly Fobbs,DEM,140015,42,91,555,688,
Cleveland,Corporation Commissioner,Bob Anthony,REP,140015,10,33,263,306,
Cleveland,Corporation Commissioner,Ashley Nicole Mccray,DEM,140015,36,85,504,625,
Cleveland,Corporation Commissioner,Jackie Short,IND,140015,6,0,54,60,
Cleveland,U.S. House,Tom Cole,REP,140015,14,30,257,301,4
Cleveland,U.S. House,Mary Brannon,DEM,140015,36,88,527,651,4
Cleveland,U.S. House,Ruby Peters,IND,140015,3,1,43,47,4
Cleveland,State Senate,Becki Maldonado,REP,140015,12,26,237,275,16
Cleveland,State Senate,Mary Boren,DEM,140015,41,93,586,720,16
Cleveland,Governor,Chris Powell,LIB,140016,1,1,44,46,
Cleveland,Governor,Kevin Stitt,REP,140016,29,30,467,526,
Cleveland,Governor,Drew Edmondson,DEM,140016,61,35,411,507,
Cleveland,Lieutenant Governor,Matt Pinnell,REP,140016,44,31,543,618,
Cleveland,Lieutenant Governor,Anastasia Pittman,DEM,140016,42,31,333,406,
Cleveland,Lieutenant Governor,Ivan Holmes,IND,140016,3,2,42,47,
Cleveland,State Auditor,John Yeutter,LIB,140016,26,18,205,249,
Cleveland,State Auditor,Cindy Byrd,REP,140016,57,42,626,725,
Cleveland,Attorney General,Mike Hunter,REP,140016,42,37,587,666,
Cleveland,Attorney General,Mark Myles,DEM,140016,47,29,330,406,
Cleveland,State Treasurer,Randy Mcdaniel,REP,140016,51,38,593,682,
Cleveland,State Treasurer,Charles De Coune,IND,140016,30,22,239,291,
Cleveland,Superintendent of Public Instruction,Joy Hofmeister,REP,140016,46,35,529,610,
Cleveland,Superintendent of Public Instruction,John Cox,DEM,140016,42,26,298,366,
Cleveland,Superintendent of Public Instruction,Larry Huff,IND,140016,2,4,90,96,
Cleveland,Commissioner of Labor,Leslie Osborn,REP,140016,45,39,563,647,
Cleveland,Commissioner of Labor,Fred Dorrell,DEM,140016,43,22,305,370,
Cleveland,Commissioner of Labor,Brandt Dismukes,IND,140016,2,4,47,53,
Cleveland,Insurance Commissioner,Glen Mulready,REP,140016,42,34,548,624,
Cleveland,Insurance Commissioner,Kimberly Fobbs,DEM,140016,46,31,361,438,
Cleveland,Corporation Commissioner,Bob Anthony,REP,140016,46,36,532,614,
Cleveland,Corporation Commissioner,Ashley Nicole Mccray,DEM,140016,38,28,319,385,
Cleveland,Corporation Commissioner,Jackie Short,IND,140016,4,2,61,67,
Cleveland,U.S. House,Tom Cole,REP,140016,48,37,573,658,4
Cleveland,U.S. House,Mary Brannon,DEM,140016,43,28,305,376,4
Cleveland,U.S. House,Ruby Peters,IND,140016,0,1,41,42,4
Cleveland,State Senate,Darrell Weaver,REP,140016,46,34,575,655,24
Cleveland,State Senate,RenÉE Jerden,DEM,140016,45,31,341,417,24
Cleveland,State House,Kevin West,REP,140016,37,33,547,617,54
Cleveland,State House,Katelyn Dockery,DEM,140016,50,32,365,447,54
Cleveland,Governor,Chris Powell,LIB,140017,1,0,9,10,
Cleveland,Governor,Kevin Stitt,REP,140017,18,14,242,274,
Cleveland,Governor,Drew Edmondson,DEM,140017,14,8,111,133,
Cleveland,Lieutenant Governor,Matt Pinnell,REP,140017,19,15,244,278,
Cleveland,Lieutenant Governor,Anastasia Pittman,DEM,140017,14,7,96,117,
Cleveland,Lieutenant Governor,Ivan Holmes,IND,140017,0,0,20,20,
Cleveland,State Auditor,John Yeutter,LIB,140017,7,4,81,92,
Cleveland,State Auditor,Cindy Byrd,REP,140017,22,15,259,296,
Cleveland,Attorney General,Mike Hunter,REP,140017,21,16,265,302,
Cleveland,Attorney General,Mark Myles,DEM,140017,12,6,93,111,
Cleveland,State Treasurer,Randy Mcdaniel,REP,140017,22,15,264,301,
Cleveland,State Treasurer,Charles De Coune,IND,140017,7,5,79,91,
Cleveland,Superintendent of Public Instruction,Joy Hofmeister,REP,140017,22,16,245,283,
Cleveland,Superintendent of Public Instruction,John Cox,DEM,140017,10,5,90,105,
Cleveland,Superintendent of Public Instruction,Larry Huff,IND,140017,1,1,26,28,
Cleveland,Commissioner of Labor,Leslie Osborn,REP,140017,22,14,257,293,
Cleveland,Commissioner of Labor,Fred Dorrell,DEM,140017,11,8,86,105,
Cleveland,Commissioner of Labor,Brandt Dismukes,IND,140017,0,0,14,14,
Cleveland,Insurance Commissioner,Glen Mulready,REP,140017,22,16,250,288,
Cleveland,Insurance Commissioner,Kimberly Fobbs,DEM,140017,11,6,107,124,
Cleveland,Corporation Commissioner,Bob Anthony,REP,140017,21,13,249,283,
Cleveland,Corporation Commissioner,Ashley Nicole Mccray,DEM,140017,12,7,92,111,
Cleveland,Corporation Commissioner,Jackie Short,IND,140017,0,2,15,17,
Cleveland,U.S. House,Tom Cole,REP,140017,20,16,264,300,4
Cleveland,U.S. House,Mary Brannon,DEM,140017,12,6,83,101,4
Cleveland,U.S. House,Ruby Peters,IND,140017,1,0,15,16,4
Cleveland,State Senate,Darrell Weaver,REP,140017,20,15,267,302,24
Cleveland,State Senate,RenÉE Jerden,DEM,140017,13,7,90,110,24
Cleveland,Governor,Chris Powell,LIB,140018,0,2,45,47,
Cleveland,Governor,Kevin Stitt,REP,140018,12,15,185,212,
Cleveland,Governor,Drew Edmondson,DEM,140018,36,80,618,734,
Cleveland,Lieutenant Governor,Matt Pinnell,REP,140018,15,21,237,273,
Cleveland,Lieutenant Governor,Anastasia Pittman,DEM,140018,31,74,537,642,
Cleveland,Lieutenant Governor,Ivan Holmes,IND,140018,2,2,61,65,
Cleveland,State Auditor,John Yeutter,LIB,140018,23,52,389,464,
Cleveland,State Auditor,Cindy Byrd,REP,140018,18,27,343,388,
Cleveland,Attorney General,Mike Hunter,REP,140018,12,22,255,289,
Cleveland,Attorney General,Mark Myles,DEM,140018,35,74,573,682,
Cleveland,State Treasurer,Randy Mcdaniel,REP,140018,17,23,266,306,
Cleveland,State Treasurer,Charles De Coune,IND,140018,23,59,467,549,
Cleveland,Superintendent of Public Instruction,Joy Hofmeister,REP,140018,14,30,250,294,
Cleveland,Superintendent of Public Instruction,John Cox,DEM,140018,26,61,495,582,
Cleveland,Superintendent of Public Instruction,Larry Huff,IND,140018,6,5,86,97,
Cleveland,Commissioner of Labor,Leslie Osborn,REP,140018,15,27,252,294,
Cleveland,Commissioner of Labor,Fred Dorrell,DEM,140018,26,62,490,578,
Cleveland,Commissioner of Labor,Brandt Dismukes,IND,140018,6,6,79,91,
Cleveland,Insurance Commissioner,Glen Mulready,REP,140018,13,22,242,277,
Cleveland,Insurance Commissioner,Kimberly Fobbs,DEM,140018,33,74,579,686,
Cleveland,Corporation Commissioner,Bob Anthony,REP,140018,13,23,224,260,
Cleveland,Corporation Commissioner,Ashley Nicole Mccray,DEM,140018,35,71,530,636,
Cleveland,Corporation Commissioner,Jackie Short,IND,140018,0,2,73,75,
Cleveland,U.S. House,Tom Cole,REP,140018,16,23,258,297,4
Cleveland,U.S. House,Mary Brannon,DEM,140018,32,72,531,635,4
Cleveland,U.S. House,Ruby Peters,IND,140018,1,2,50,53,4
Cleveland,State Senate,Becki Maldonado,REP,140018,11,19,228,258,16
Cleveland,State Senate,Mary Boren,DEM,140018,37,77,601,715,16
Cleveland,Governor,Chris Powell,LIB,140019,1,1,50,52,
Cleveland,Governor,Kevin Stitt,REP,140019,34,65,379,478,
Cleveland,Governor,Drew Edmondson,DEM,140019,82,192,848,1122,
Cleveland,Lieutenant Governor,Matt Pinnell,REP,140019,39,77,493,609,
Cleveland,Lieutenant Governor,Anastasia Pittman,DEM,140019,73,168,701,942,
Cleveland,Lieutenant Governor,Ivan Holmes,IND,140019,4,13,70,87,
Cleveland,State Auditor,John Yeutter,LIB,140019,32,83,396,511,
Cleveland,State Auditor,Cindy Byrd,REP,140019,62,126,651,839,
Cleveland,Attorney General,Mike Hunter,REP,140019,40,81,511,632,
Cleveland,Attorney General,Mark Myles,DEM,140019,75,177,748,1000,
Cleveland,State Treasurer,Randy Mcdaniel,REP,140019,51,107,551,709,
Cleveland,State Treasurer,Charles De Coune,IND,140019,49,113,492,654,
Cleveland,Superintendent of Public Instruction,Joy Hofmeister,REP,140019,58,103,573,734,
Cleveland,Superintendent of Public Instruction,John Cox,DEM,140019,55,146,612,813,
Cleveland,Superintendent of Public Instruction,Larry Huff,IND,140019,3,11,83,97,
Cleveland,Commissioner of Labor,Leslie Osborn,REP,140019,54,102,536,692,
Cleveland,Commissioner of Labor,Fred Dorrell,DEM,140019,59,150,659,868,
Cleveland,Commissioner of Labor,Brandt Dismukes,IND,140019,1,7,57,65,
Cleveland,Insurance Commissioner,Glen Mulready,REP,140019,41,75,476,592,
Cleveland,Insurance Commissioner,Kimberly Fobbs,DEM,140019,73,183,765,1021,
Cleveland,Corporation Commissioner,Bob Anthony,REP,140019,37,89,494,620,
Cleveland,Corporation Commissioner,Ashley Nicole Mccray,DEM,140019,73,165,690,928,
Cleveland,Corporation Commissioner,Jackie Short,IND,140019,5,5,69,79,
Cleveland,U.S. House,Tom Cole,REP,140019,42,81,512,635,4
Cleveland,U.S. House,Mary Brannon,DEM,140019,72,176,702,950,4
Cleveland,U.S. House,Ruby Peters,IND,140019,2,1,54,57,4
Cleveland,State Senate,Becki Maldonado,REP,140019,36,66,425,527,16
Cleveland,State Senate,Mary Boren,DEM,140019,79,193,833,1105,16
Cleveland,Governor,Chris Powell,LIB,140020,5,10,23,38,
Cleveland,Governor,Kevin Stitt,REP,140020,95,351,711,1157,
Cleveland,Governor,Drew Edmondson,DEM,140020,103,211,472,786,
Cleveland,Lieutenant Governor,Matt Pinnell,REP,140020,107,393,803,1303,
Cleveland,Lieutenant Governor,Anastasia Pittman,DEM,140020,85,167,372,624,
Cleveland,Lieutenant Governor,Ivan Holmes,IND,140020,10,13,17,40,
Cleveland,State Auditor,John Yeutter,LIB,140020,35,93,226,354,
Cleveland,State Auditor,Cindy Byrd,REP,140020,136,443,899,1478,
Cleveland,Attorney General,Mike Hunter,REP,140020,116,396,829,1341,
Cleveland,Attorney General,Mark Myles,DEM,140020,84,176,365,625,
Cleveland,State Treasurer,Randy Mcdaniel,REP,140020,122,411,843,1376,
Cleveland,State Treasurer,Charles De Coune,IND,140020,47,121,281,449,
Cleveland,Superintendent of Public Instruction,Joy Hofmeister,REP,140020,121,373,757,1251,
Cleveland,Superintendent of Public Instruction,John Cox,DEM,140020,68,158,363,589,
Cleveland,Superintendent of Public Instruction,Larry Huff,IND,140020,10,40,76,126,
Cleveland,Commissioner of Labor,Leslie Osborn,REP,140020,122,401,810,1333,
Cleveland,Commissioner of Labor,Fred Dorrell,DEM,140020,68,158,326,552,
Cleveland,Commissioner of Labor,Brandt Dismukes,IND,140020,8,11,46,65,
Cleveland,Insurance Commissioner,Glen Mulready,REP,140020,111,398,779,1288,
Cleveland,Insurance Commissioner,Kimberly Fobbs,DEM,140020,82,172,400,654,
Cleveland,Corporation Commissioner,Bob Anthony,REP,140020,110,383,781,1274,
Cleveland,Corporation Commissioner,Ashley Nicole Mccray,DEM,140020,77,157,345,579,
Cleveland,Corporation Commissioner,Jackie Short,IND,140020,11,29,56,96,
Cleveland,U.S. House,Tom Cole,REP,140020,117,400,822,1339,4
Cleveland,U.S. House,Mary Brannon,DEM,140020,75,155,352,582,4
Cleveland,U.S. House,Ruby Peters,IND,140020,8,17,22,47,4
Cleveland,State Senate,Darrell Weaver,REP,140020,114,410,817,1341,24
Cleveland,State Senate,RenÉE Jerden,DEM,140020,83,163,373,619,24
Cleveland,State House,Chris Kannady,REP,140020,109,388,786,1283,91
Cleveland,State House,Amanda Jeffers,DEM,140020,91,183,409,683,91
Cleveland,Governor,Chris Powell,LIB,140021,3,5,48,56,
Cleveland,Governor,Kevin Stitt,REP,140021,23,26,311,360,
Cleveland,Governor,Drew Edmondson,DEM,140021,26,18,261,305,
Cleveland,Lieutenant Governor,Matt Pinnell,REP,140021,25,28,354,407,
Cleveland,Lieutenant Governor,Anastasia Pittman,DEM,140021,23,17,222,262,
Cleveland,Lieutenant Governor,Ivan Holmes,IND,140021,3,3,41,47,
Cleveland,State Auditor,John Yeutter,LIB,140021,17,15,165,197,
Cleveland,State Auditor,Cindy Byrd,REP,140021,33,32,412,477,
Cleveland,Attorney General,Mike Hunter,REP,140021,31,33,367,431,
Cleveland,Attorney General,Mark Myles,DEM,140021,21,14,248,283,
Cleveland,State Treasurer,Randy Mcdaniel,REP,140021,30,34,379,443,
Cleveland,State Treasurer,Charles De Coune,IND,140021,19,11,201,231,
Cleveland,Superintendent of Public Instruction,Joy Hofmeister,REP,140021,24,25,344,393,
Cleveland,Superintendent of Public Instruction,John Cox,DEM,140021,20,16,198,234,
Cleveland,Superintendent of Public Instruction,Larry Huff,IND,140021,8,6,76,90,
Cleveland,Commissioner of Labor,Leslie Osborn,REP,140021,28,33,359,420,
Cleveland,Commissioner of Labor,Fred Dorrell,DEM,140021,20,11,195,226,
Cleveland,Commissioner of Labor,Brandt Dismukes,IND,140021,4,3,55,62,
Cleveland,Insurance Commissioner,Glen Mulready,REP,140021,28,33,357,418,
Cleveland,Insurance Commissioner,Kimberly Fobbs,DEM,140021,23,15,255,293,
Cleveland,Corporation Commissioner,Bob Anthony,REP,140021,25,29,332,386,
Cleveland,Corporation Commissioner,Ashley Nicole Mccray,DEM,140021,18,16,226,260,
Cleveland,Corporation Commissioner,Jackie Short,IND,140021,9,2,53,64,
Cleveland,U.S. House,Tom Cole,REP,140021,29,29,372,430,4
Cleveland,U.S. House,Mary Brannon,DEM,140021,19,15,209,243,4
Cleveland,U.S. House,Ruby Peters,IND,140021,4,4,36,44,4
Cleveland,State Senate,Darrell Weaver,REP,140021,28,32,379,439,24
Cleveland,State Senate,RenÉE Jerden,DEM,140021,24,15,235,274,24
Cleveland,State House,Mark Mcbride,REP,140021,29,30,359,418,53
Cleveland,State House,Leslie Bonebreak,DEM,140021,23,19,255,297,53
Cleveland,Governor,Chris Powell,LIB,140022,9,4,72,85,
Cleveland,Governor,Kevin Stitt,REP,140022,96,90,702,888,
Cleveland,Governor,Drew Edmondson,DEM,140022,64,63,562,689,
Cleveland,Lieutenant Governor,Matt Pinnell,REP,140022,105,98,814,1017,
Cleveland,Lieutenant Governor,Anastasia Pittman,DEM,140022,58,52,447,557,
Cleveland,Lieutenant Governor,Ivan Holmes,IND,140022,7,5,68,80,
Cleveland,State Auditor,John Yeutter,LIB,140022,28,31,335,394,
Cleveland,State Auditor,Cindy Byrd,REP,140022,128,115,898,1141,
Cleveland,Attorney General,Mike Hunter,REP,140022,109,102,826,1037,
Cleveland,Attorney General,Mark Myles,DEM,140022,60,54,491,605,
Cleveland,State Treasurer,Randy Mcdaniel,REP,140022,115,97,829,1041,
Cleveland,State Treasurer,Charles De Coune,IND,140022,42,49,402,493,
Cleveland,Superintendent of Public Instruction,Joy Hofmeister,REP,140022,107,103,723,933,
Cleveland,Superintendent of Public Instruction,John Cox,DEM,140022,49,44,429,522,
Cleveland,Superintendent of Public Instruction,Larry Huff,IND,140022,14,9,166,189,
Cleveland,Commissioner of Labor,Leslie Osborn,REP,140022,111,99,807,1017,
Cleveland,Commissioner of Labor,Fred Dorrell,DEM,140022,51,49,406,506,
Cleveland,Commissioner of Labor,Brandt Dismukes,IND,140022,7,6,99,112,
Cleveland,Insurance Commissioner,Glen Mulready,REP,140022,105,97,798,1000,
Cleveland,Insurance Commissioner,Kimberly Fobbs,DEM,140022,63,56,505,624,
Cleveland,Corporation Commissioner,Bob Anthony,REP,140022,108,96,769,973,
Cleveland,Corporation Commissioner,Ashley Nicole Mccray,DEM,140022,52,49,441,542,
Cleveland,Corporation Commissioner,Jackie Short,IND,140022,10,9,106,125,
Cleveland,U.S. House,Tom Cole,REP,140022,111,100,807,1018,4
Cleveland,U.S. House,Mary Brannon,DEM,140022,51,52,440,543,4
Cleveland,U.S. House,Ruby Peters,IND,140022,8,4,83,95,4
Cleveland,State Senate,Darrell Weaver,REP,140022,110,101,823,1034,24
Cleveland,State Senate,RenÉE Jerden,DEM,140022,57,54,478,589,24
Cleveland,State House,Mark Mcbride,REP,140022,107,100,770,977,53
Cleveland,State House,Leslie Bonebreak,DEM,140022,60,56,549,665,53
Cleveland,Governor,Chris Powell,LIB,140024,8,7,70,85,
Cleveland,Governor,Kevin Stitt,REP,140024,146,180,875,1201,
Cleveland,Governor,Drew Edmondson,DEM,140024,191,180,641,1012,
Cleveland,Lieutenant Governor,Matt Pinnell,REP,140024,171,199,993,1363,
Cleveland,Lieutenant Governor,Anastasia Pittman,DEM,140024,152,162,514,828,
Cleveland,Lieutenant Governor,Ivan Holmes,IND,140024,18,6,66,90,
Cleveland,State Auditor,John Yeutter,LIB,140024,100,78,352,530,
Cleveland,State Auditor,Cindy Byrd,REP,140024,206,237,1103,1546,
Cleveland,Attorney General,Mike Hunter,REP,140024,182,201,1023,1406,
Cleveland,Attorney General,Mark Myles,DEM,140024,161,163,544,868,
Cleveland,State Treasurer,Randy Mcdaniel,REP,140024,181,214,1034,1429,
Cleveland,State Treasurer,Charles De Coune,IND,140024,124,108,421,653,
Cleveland,Superintendent of Public Instruction,Joy Hofmeister,REP,140024,177,206,966,1349,
Cleveland,Superintendent of Public Instruction,John Cox,DEM,140024,144,136,470,750,
Cleveland,Superintendent of Public Instruction,Larry Huff,IND,140024,21,23,132,176,
Cleveland,Commissioner of Labor,Leslie Osborn,REP,140024,187,211,1017,1415,
Cleveland,Commissioner of Labor,Fred Dorrell,DEM,140024,143,137,458,738,
Cleveland,Commissioner of Labor,Brandt Dismukes,IND,140024,8,12,80,100,
Cleveland,Insurance Commissioner,Glen Mulready,REP,140024,177,203,999,1379,
Cleveland,Insurance Commissioner,Kimberly Fobbs,DEM,140024,162,158,555,875,
Cleveland,Corporation Commissioner,Bob Anthony,REP,140024,172,192,947,1311,
Cleveland,Corporation Commissioner,Ashley Nicole Mccray,DEM,140024,154,153,515,822,
Cleveland,Corporation Commissioner,Jackie Short,IND,140024,16,17,100,133,
Cleveland,U.S. House,Tom Cole,REP,140024,180,201,1017,1398,4
Cleveland,U.S. House,Mary Brannon,DEM,140024,153,158,498,809,4
Cleveland,U.S. House,Ruby Peters,IND,140024,11,6,62,79,4
Cleveland,State Senate,Darrell Weaver,REP,140024,177,205,1039,1421,24
Cleveland,State Senate,RenÉE Jerden,DEM,140024,161,157,526,844,24
Cleveland,State House,Mark Mcbride,REP,140024,171,188,953,1312,53
Cleveland,State House,Leslie Bonebreak,DEM,140024,170,175,612,957,53
Cleveland,Governor,Chris Powell,LIB,140025,2,0,36,38,
Cleveland,Governor,Kevin Stitt,REP,140025,12,18,353,383,
Cleveland,Governor,Drew Edmondson,DEM,140025,16,16,256,288,
Cleveland,Lieutenant Governor,Matt Pinnell,REP,140025,18,17,388,423,
Cleveland,Lieutenant Governor,Anastasia Pittman,DEM,140025,11,15,226,252,
Cleveland,Lieutenant Governor,Ivan Holmes,IND,140025,1,1,26,28,
Cleveland,State Auditor,John Yeutter,LIB,140025,5,10,172,187,
Cleveland,State Auditor,Cindy Byrd,REP,140025,20,22,428,470,
Cleveland,Attorney General,Mike Hunter,REP,140025,16,21,408,445,
Cleveland,Attorney General,Mark Myles,DEM,140025,13,13,228,254,
Cleveland,State Treasurer,Randy Mcdaniel,REP,140025,17,22,406,445,
Cleveland,State Treasurer,Charles De Coune,IND,140025,9,11,195,215,
Cleveland,Superintendent of Public Instruction,Joy Hofmeister,REP,140025,15,20,369,404,
Cleveland,Superintendent of Public Instruction,John Cox,DEM,140025,13,12,199,224,
Cleveland,Superintendent of Public Instruction,Larry Huff,IND,140025,1,2,70,73,
Cleveland,Commissioner of Labor,Leslie Osborn,REP,140025,16,17,387,420,
Cleveland,Commissioner of Labor,Fred Dorrell,DEM,140025,13,14,202,229,
Cleveland,Commissioner of Labor,Brandt Dismukes,IND,140025,0,2,47,49,
Cleveland,Insurance Commissioner,Glen Mulready,REP,140025,18,19,391,428,
Cleveland,Insurance Commissioner,Kimberly Fobbs,DEM,140025,10,15,243,268,
Cleveland,Corporation Commissioner,Bob Anthony,REP,140025,18,20,369,407,
Cleveland,Corporation Commissioner,Ashley Nicole Mccray,DEM,140025,10,13,218,241,
Cleveland,Corporation Commissioner,Jackie Short,IND,140025,1,1,49,51,
Cleveland,U.S. House,Tom Cole,REP,140025,18,20,381,419,4
Cleveland,U.S. House,Mary Brannon,DEM,140025,12,13,216,241,4
Cleveland,U.S. House,Ruby Peters,IND,140025,0,1,44,45,4
Cleveland,State House,Marc Etters,REP,140025,15,18,359,392,45
Cleveland,State House,Merleyn Bell,DEM,140025,13,15,219,247,45
Cleveland,State House,Tom Hackelman,IND,140025,1,1,61,63,45
Cleveland,Governor,Chris Powell,LIB,140026,4,5,37,46,
Cleveland,Governor,Kevin Stitt,REP,140026,43,73,410,526,
Cleveland,Governor,Drew Edmondson,DEM,140026,104,151,670,925,
Cleveland,Lieutenant Governor,Matt Pinnell,REP,140026,54,86,487,627,
Cleveland,Lieutenant Governor,Anastasia Pittman,DEM,140026,86,136,571,793,
Cleveland,Lieutenant Governor,Ivan Holmes,IND,140026,10,9,55,74,
Cleveland,State Auditor,John Yeutter,LIB,140026,63,73,393,529,
Cleveland,State Auditor,Cindy Byrd,REP,140026,71,122,605,798,
Cleveland,Attorney General,Mike Hunter,REP,140026,61,102,538,701,
Cleveland,Attorney General,Mark Myles,DEM,140026,91,128,572,791,
Cleveland,State Treasurer,Randy Mcdaniel,REP,140026,63,107,556,726,
Cleveland,State Treasurer,Charles De Coune,IND,140026,73,92,448,613,
Cleveland,Superintendent of Public Instruction,Joy Hofmeister,REP,140026,65,111,540,716,
Cleveland,Superintendent of Public Instruction,John Cox,DEM,140026,78,107,493,678,
Cleveland,Superintendent of Public Instruction,Larry Huff,IND,140026,8,13,73,94,
Cleveland,Commissioner of Labor,Leslie Osborn,REP,140026,59,101,523,683,
Cleveland,Commissioner of Labor,Fred Dorrell,DEM,140026,86,115,508,709,
Cleveland,Commissioner of Labor,Brandt Dismukes,IND,140026,6,12,66,84,
Cleveland,Insurance Commissioner,Glen Mulready,REP,140026,60,90,491,641,
Cleveland,Insurance Commissioner,Kimberly Fobbs,DEM,140026,90,135,606,831,
Cleveland,Corporation Commissioner,Bob Anthony,REP,140026,60,95,488,643,
Cleveland,Corporation Commissioner,Ashley Nicole Mccray,DEM,140026,85,122,550,757,
Cleveland,Corporation Commissioner,Jackie Short,IND,140026,5,11,64,80,
Cleveland,U.S. House,Tom Cole,REP,140026,63,96,503,662,4
Cleveland,U.S. House,Mary Brannon,DEM,140026,86,129,563,778,4
Cleveland,U.S. House,Ruby Peters,IND,140026,2,6,50,58,4
Cleveland,State House,Marc Etters,REP,140026,53,76,460,589,45
Cleveland,State House,Merleyn Bell,DEM,140026,92,142,577,811,45
Cleveland,State House,Tom Hackelman,IND,140026,6,12,65,83,45
Cleveland,Governor,Chris Powell,LIB,140027,2,2,31,35,
Cleveland,Governor,Kevin Stitt,REP,140027,117,115,633,865,
Cleveland,Governor,Drew Edmondson,DEM,140027,162,172,723,1057,
Cleveland,Lieutenant Governor,Matt Pinnell,REP,140027,138,145,801,1084,
Cleveland,Lieutenant Governor,Anastasia Pittman,DEM,140027,134,140,522,796,
Cleveland,Lieutenant Governor,Ivan Holmes,IND,140027,8,6,53,67,
Cleveland,State Auditor,John Yeutter,LIB,140027,58,84,303,445,
Cleveland,State Auditor,Cindy Byrd,REP,140027,183,175,942,1300,
Cleveland,Attorney General,Mike Hunter,REP,140027,151,156,840,1147,
Cleveland,Attorney General,Mark Myles,DEM,140027,130,133,531,794,
Cleveland,State Treasurer,Randy Mcdaniel,REP,140027,164,157,878,1199,
Cleveland,State Treasurer,Charles De Coune,IND,140027,89,104,372,565,
Cleveland,Superintendent of Public Instruction,Joy Hofmeister,REP,140027,169,172,846,1187,
Cleveland,Superintendent of Public Instruction,John Cox,DEM,140027,94,110,430,634,
Cleveland,Superintendent of Public Instruction,Larry Huff,IND,140027,14,9,91,114,
Cleveland,Commissioner of Labor,Leslie Osborn,REP,140027,155,156,832,1143,
Cleveland,Commissioner of Labor,Fred Dorrell,DEM,140027,114,127,464,705,
Cleveland,Commissioner of Labor,Brandt Dismukes,IND,140027,9,4,56,69,
Cleveland,Insurance Commissioner,Glen Mulready,REP,140027,143,132,795,1070,
Cleveland,Insurance Commissioner,Kimberly Fobbs,DEM,140027,135,155,546,836,
Cleveland,Corporation Commissioner,Bob Anthony,REP,140027,156,155,834,1145,
Cleveland,Corporation Commissioner,Ashley Nicole Mccray,DEM,140027,117,126,467,710,
Cleveland,Corporation Commissioner,Jackie Short,IND,140027,7,10,68,85,
Cleveland,U.S. House,Tom Cole,REP,140027,150,150,834,1134,4
Cleveland,U.S. House,Mary Brannon,DEM,140027,123,137,514,774,4
Cleveland,U.S. House,Ruby Peters,IND,140027,7,6,31,44,4
Cleveland,State House,Bryan Vinyard,REP,140027,137,141,771,1049,46
Cleveland,State House,Jacob Rosecrants,DEM,140027,145,152,608,905,46
Cleveland,Governor,Chris Powell,LIB,140028,3,2,54,59,
Cleveland,Governor,Kevin Stitt,REP,140028,13,34,321,368,
Cleveland,Governor,Drew Edmondson,DEM,140028,65,121,900,1086,
Cleveland,Lieutenant Governor,Matt Pinnell,REP,140028,12,41,405,458,
Cleveland,Lieutenant Governor,Anastasia Pittman,DEM,140028,66,110,786,962,
Cleveland,Lieutenant Governor,Ivan Holmes,IND,140028,2,6,73,81,
Cleveland,State Auditor,John Yeutter,LIB,140028,30,70,551,651,
Cleveland,State Auditor,Cindy Byrd,REP,140028,31,64,573,668,
Cleveland,Attorney General,Mike Hunter,REP,140028,19,42,441,502,
Cleveland,Attorney General,Mark Myles,DEM,140028,59,115,817,991,
Cleveland,State Treasurer,Randy Mcdaniel,REP,140028,18,42,460,520,
Cleveland,State Treasurer,Charles De Coune,IND,140028,49,93,673,815,
Cleveland,Superintendent of Public Instruction,Joy Hofmeister,REP,140028,24,46,450,520,
Cleveland,Superintendent of Public Instruction,John Cox,DEM,140028,51,106,694,851,
Cleveland,Superintendent of Public Instruction,Larry Huff,IND,140028,4,4,116,124,
Cleveland,Commissioner of Labor,Leslie Osborn,REP,140028,17,40,443,500,
Cleveland,Commissioner of Labor,Fred Dorrell,DEM,140028,58,111,734,903,
Cleveland,Commissioner of Labor,Brandt Dismukes,IND,140028,3,6,69,78,
Cleveland,Insurance Commissioner,Glen Mulready,REP,140028,14,37,403,454,
Cleveland,Insurance Commissioner,Kimberly Fobbs,DEM,140028,62,119,843,1024,
Cleveland,Corporation Commissioner,Bob Anthony,REP,140028,17,42,409,468,
Cleveland,Corporation Commissioner,Ashley Nicole Mccray,DEM,140028,56,108,764,928,
Cleveland,Corporation Commissioner,Jackie Short,IND,140028,5,7,84,96,
Cleveland,U.S. House,Tom Cole,REP,140028,17,38,415,470,4
Cleveland,U.S. House,Mary Brannon,DEM,140028,59,113,782,954,4
Cleveland,U.S. House,Ruby Peters,IND,140028,3,6,67,76,4
Cleveland,State Senate,Becki Maldonado,REP,140028,16,38,390,444,16
Cleveland,State Senate,Mary Boren,DEM,140028,61,119,866,1046,16
Cleveland,State House,Marc Etters,REP,140028,11,34,360,405,45
Cleveland,State House,Merleyn Bell,DEM,140028,65,115,804,984,45
Cleveland,State House,Tom Hackelman,IND,140028,2,8,92,102,45
Cleveland,Governor,Chris Powell,LIB,140029,0,6,45,51,
Cleveland,Governor,Kevin Stitt,REP,140029,48,58,680,786,
Cleveland,Governor,Drew Edmondson,DEM,140029,32,28,402,462,
Cleveland,Lieutenant Governor,Matt Pinnell,REP,140029,57,69,787,913,
Cleveland,Lieutenant Governor,Anastasia Pittman,DEM,140029,18,21,283,322,
Cleveland,Lieutenant Governor,Ivan Holmes,IND,140029,3,2,45,50,
Cleveland,State Auditor,John Yeutter,LIB,140029,14,12,168,194,
Cleveland,State Auditor,Cindy Byrd,REP,140029,64,76,890,1030,
Cleveland,Attorney General,Mike Hunter,REP,140029,58,69,793,920,
Cleveland,Attorney General,Mark Myles,DEM,140029,20,23,315,358,
Cleveland,State Treasurer,Randy Mcdaniel,REP,140029,60,66,813,939,
Cleveland,State Treasurer,Charles De Coune,IND,140029,17,24,236,277,
Cleveland,Superintendent of Public Instruction,Joy Hofmeister,REP,140029,51,60,725,836,
Cleveland,Superintendent of Public Instruction,John Cox,DEM,140029,20,23,284,327,
Cleveland,Superintendent of Public Instruction,Larry Huff,IND,140029,8,9,103,120,
Cleveland,Commissioner of Labor,Leslie Osborn,REP,140029,54,67,753,874,
Cleveland,Commissioner of Labor,Fred Dorrell,DEM,140029,21,20,279,320,
Cleveland,Commissioner of Labor,Brandt Dismukes,IND,140029,4,5,69,78,
Cleveland,Insurance Commissioner,Glen Mulready,REP,140029,52,69,750,871,
Cleveland,Insurance Commissioner,Kimberly Fobbs,DEM,140029,26,23,350,399,
Cleveland,Corporation Commissioner,Bob Anthony,REP,140029,49,59,708,816,
Cleveland,Corporation Commissioner,Ashley Nicole Mccray,DEM,140029,24,26,316,366,
Cleveland,Corporation Commissioner,Jackie Short,IND,140029,5,7,77,89,
Cleveland,U.S. House,Tom Cole,REP,140029,57,61,747,865,4
Cleveland,U.S. House,Mary Brannon,DEM,140029,19,26,312,357,4
Cleveland,U.S. House,Ruby Peters,IND,140029,4,5,53,62,4
Cleveland,State Senate,Becki Maldonado,REP,140029,47,59,704,810,16
Cleveland,State Senate,Mary Boren,DEM,140029,32,32,402,466,16
Cleveland,State House,Sherrie Conley,REP,140029,54,68,851,973,20
Cleveland,State House,Steve Jarman,DEM,140029,23,22,254,299,20
Cleveland,Governor,Chris Powell,LIB,140030,1,1,30,32,
Cleveland,Governor,Kevin Stitt,REP,140030,22,32,314,368,
Cleveland,Governor,Drew Edmondson,DEM,140030,38,61,327,426,
Cleveland,Lieutenant Governor,Matt Pinnell,REP,140030,24,30,377,431,
Cleveland,Lieutenant Governor,Anastasia Pittman,DEM,140030,35,60,250,345,
Cleveland,Lieutenant Governor,Ivan Holmes,IND,140030,2,4,36,42,
Cleveland,State Auditor,John Yeutter,LIB,140030,21,24,154,199,
Cleveland,State Auditor,Cindy Byrd,REP,140030,34,57,442,533,
Cleveland,Attorney General,Mike Hunter,REP,140030,21,41,400,462,
Cleveland,Attorney General,Mark Myles,DEM,140030,38,52,262,352,
Cleveland,State Treasurer,Randy Mcdaniel,REP,140030,23,34,393,450,
Cleveland,State Treasurer,Charles De Coune,IND,140030,31,47,203,281,
Cleveland,Superintendent of Public Instruction,Joy Hofmeister,REP,140030,29,42,368,439,
Cleveland,Superintendent of Public Instruction,John Cox,DEM,140030,30,44,227,301,
Cleveland,Superintendent of Public Instruction,Larry Huff,IND,140030,2,7,69,78,
Cleveland,Commissioner of Labor,Leslie Osborn,REP,140030,24,37,386,447,
Cleveland,Commissioner of Labor,Fred Dorrell,DEM,140030,35,53,235,323,
Cleveland,Commissioner of Labor,Brandt Dismukes,IND,140030,2,3,36,41,
Cleveland,Insurance Commissioner,Glen Mulready,REP,140030,22,33,380,435,
Cleveland,Insurance Commissioner,Kimberly Fobbs,DEM,140030,39,59,275,373,
Cleveland,Corporation Commissioner,Bob Anthony,REP,140030,24,35,371,430,
Cleveland,Corporation Commissioner,Ashley Nicole Mccray,DEM,140030,35,52,241,328,
Cleveland,Corporation Commissioner,Jackie Short,IND,140030,2,5,50,57,
Cleveland,U.S. House,Tom Cole,REP,140030,24,36,386,446,4
Cleveland,U.S. House,Mary Brannon,DEM,140030,36,56,256,348,4
Cleveland,U.S. House,Ruby Peters,IND,140030,1,2,25,28,4
Cleveland,State Senate,Becki Maldonado,REP,140030,21,33,360,414,16
Cleveland,State Senate,Mary Boren,DEM,140030,40,60,299,399,16
Cleveland,State House,Marc Etters,REP,140030,19,30,342,391,45
Cleveland,State House,Merleyn Bell,DEM,140030,34,53,243,330,45
Cleveland,State House,Tom Hackelman,IND,140030,8,11,79,98,45
Cleveland,Governor,Chris Powell,LIB,140032,4,4,50,58,
Cleveland,Governor,Kevin Stitt,REP,140032,11,28,292,331,
Cleveland,Governor,Drew Edmondson,DEM,140032,55,116,833,1004,
Cleveland,Lieutenant Governor,Matt Pinnell,REP,140032,14,31,352,397,
Cleveland,Lieutenant Governor,Anastasia Pittman,DEM,140032,53,108,763,924,
Cleveland,Lieutenant Governor,Ivan Holmes,IND,140032,2,8,50,60,
Cleveland,State Auditor,John Yeutter,LIB,140032,26,68,533,627,
Cleveland,State Auditor,Cindy Byrd,REP,140032,28,51,495,574,
Cleveland,Attorney General,Mike Hunter,REP,140032,14,34,376,424,
Cleveland,Attorney General,Mark Myles,DEM,140032,55,110,783,948,
Cleveland,State Treasurer,Randy Mcdaniel,REP,140032,25,40,410,475,
Cleveland,State Treasurer,Charles De Coune,IND,140032,31,80,624,735,
Cleveland,Superintendent of Public Instruction,Joy Hofmeister,REP,140032,17,43,375,435,
Cleveland,Superintendent of Public Instruction,John Cox,DEM,140032,46,94,681,821,
Cleveland,Superintendent of Public Instruction,Larry Huff,IND,140032,6,9,101,116,
Cleveland,Commissioner of Labor,Leslie Osborn,REP,140032,19,39,379,437,
Cleveland,Commissioner of Labor,Fred Dorrell,DEM,140032,45,100,692,837,
Cleveland,Commissioner of Labor,Brandt Dismukes,IND,140032,5,5,82,92,
Cleveland,Insurance Commissioner,Glen Mulready,REP,140032,19,37,361,417,
Cleveland,Insurance Commissioner,Kimberly Fobbs,DEM,140032,49,106,788,943,
Cleveland,Corporation Commissioner,Bob Anthony,REP,140032,17,33,336,386,
Cleveland,Corporation Commissioner,Ashley Nicole Mccray,DEM,140032,46,105,743,894,
Cleveland,Corporation Commissioner,Jackie Short,IND,140032,5,5,74,84,
Cleveland,U.S. House,Tom Cole,REP,140032,16,40,362,418,4
Cleveland,U.S. House,Mary Brannon,DEM,140032,50,103,744,897,4
Cleveland,U.S. House,Ruby Peters,IND,140032,4,3,60,67,4
Cleveland,State Senate,Becki Maldonado,REP,140032,14,36,327,377,16
Cleveland,State Senate,Mary Boren,DEM,140032,53,107,832,992,16
Cleveland,State House,Marc Etters,REP,140032,11,31,317,359,45
Cleveland,State House,Merleyn Bell,DEM,140032,47,107,753,907,45
Cleveland,State House,Tom Hackelman,IND,140032,8,7,90,105,45
Cleveland,Governor,Chris Powell,LIB,140034,3,0,56,59,
Cleveland,Governor,Kevin Stitt,REP,140034,35,31,780,846,
Cleveland,Governor,Drew Edmondson,DEM,140034,23,13,417,453,
Cleveland,Lieutenant Governor,Matt Pinnell,REP,140034,39,32,873,944,
Cleveland,Lieutenant Governor,Anastasia Pittman,DEM,140034,17,11,334,362,
Cleveland,Lieutenant Governor,Ivan Holmes,IND,140034,5,1,42,48,
Cleveland,State Auditor,John Yeutter,LIB,140034,12,1,234,247,
Cleveland,State Auditor,Cindy Byrd,REP,140034,48,41,947,1036,
Cleveland,Attorney General,Mike Hunter,REP,140034,39,36,867,942,
Cleveland,Attorney General,Mark Myles,DEM,140034,22,8,376,406,
Cleveland,State Treasurer,Randy Mcdaniel,REP,140034,38,36,921,995,
Cleveland,State Treasurer,Charles De Coune,IND,140034,20,6,261,287,
Cleveland,Superintendent of Public Instruction,Joy Hofmeister,REP,140034,36,34,816,886,
Cleveland,Superintendent of Public Instruction,John Cox,DEM,140034,19,8,305,332,
Cleveland,Superintendent of Public Instruction,Larry Huff,IND,140034,4,2,128,134,
Cleveland,Commissioner of Labor,Leslie Osborn,REP,140034,44,32,865,941,
Cleveland,Commissioner of Labor,Fred Dorrell,DEM,140034,10,9,307,326,
Cleveland,Commissioner of Labor,Brandt Dismukes,IND,140034,5,1,64,70,
Cleveland,Insurance Commissioner,Glen Mulready,REP,140034,40,31,851,922,
Cleveland,Insurance Commissioner,Kimberly Fobbs,DEM,140034,21,12,384,417,
Cleveland,Corporation Commissioner,Bob Anthony,REP,140034,42,33,825,900,
Cleveland,Corporation Commissioner,Ashley Nicole Mccray,DEM,140034,12,8,340,360,
Cleveland,Corporation Commissioner,Jackie Short,IND,140034,7,2,76,85,
Cleveland,U.S. House,Tom Cole,REP,140034,44,35,861,940,4
Cleveland,U.S. House,Mary Brannon,DEM,140034,17,7,341,365,4
Cleveland,U.S. House,Ruby Peters,IND,140034,0,2,47,49,4
Cleveland,State Senate,Becki Maldonado,REP,140034,35,33,795,863,16
Cleveland,State Senate,Mary Boren,DEM,140034,24,10,439,473,16
Cleveland,State House,Sherrie Conley,REP,140034,37,35,886,958,20
Cleveland,State House,Steve Jarman,DEM,140034,22,7,358,387,20
Cleveland,Governor,Chris Powell,LIB,140035,2,0,19,21,
Cleveland,Governor,Kevin Stitt,REP,140035,19,24,319,362,
Cleveland,Governor,Drew Edmondson,DEM,140035,45,46,389,480,
Cleveland,Lieutenant Governor,Matt Pinnell,REP,140035,24,28,391,443,
Cleveland,Lieutenant Governor,Anastasia Pittman,DEM,140035,40,40,317,397,
Cleveland,Lieutenant Governor,Ivan Holmes,IND,140035,1,2,19,22,
Cleveland,State Auditor,John Yeutter,LIB,140035,9,18,178,205,
Cleveland,State Auditor,Cindy Byrd,REP,140035,40,37,469,546,
Cleveland,Attorney General,Mike Hunter,REP,140035,28,31,408,467,
Cleveland,Attorney General,Mark Myles,DEM,140035,36,39,317,392,
Cleveland,State Treasurer,Randy Mcdaniel,REP,140035,31,33,424,488,
Cleveland,State Treasurer,Charles De Coune,IND,140035,20,22,225,267,
Cleveland,Superintendent of Public Instruction,Joy Hofmeister,REP,140035,32,35,432,499,
Cleveland,Superintendent of Public Instruction,John Cox,DEM,140035,28,34,251,313,
Cleveland,Superintendent of Public Instruction,Larry Huff,IND,140035,4,1,42,47,
Cleveland,Commissioner of Labor,Leslie Osborn,REP,140035,29,31,403,463,
Cleveland,Commissioner of Labor,Fred Dorrell,DEM,140035,30,38,283,351,
Cleveland,Commissioner of Labor,Brandt Dismukes,IND,140035,4,1,31,36,
Cleveland,Insurance Commissioner,Glen Mulready,REP,140035,28,28,372,428,
Cleveland,Insurance Commissioner,Kimberly Fobbs,DEM,140035,35,41,338,414,
Cleveland,Corporation Commissioner,Bob Anthony,REP,140035,26,31,386,443,
Cleveland,Corporation Commissioner,Ashley Nicole Mccray,DEM,140035,38,38,310,386,
Cleveland,Corporation Commissioner,Jackie Short,IND,140035,0,0,23,23,
Cleveland,U.S. House,Tom Cole,REP,140035,23,29,401,453,4
Cleveland,U.S. House,Mary Brannon,DEM,140035,39,40,302,381,4
Cleveland,U.S. House,Ruby Peters,IND,140035,1,1,24,26,4
Cleveland,State House,Bryan Vinyard,REP,140035,22,26,372,420,46
Cleveland,State House,Jacob Rosecrants,DEM,140035,43,44,353,440,46
Cleveland,Governor,Chris Powell,LIB,140036,0,2,43,45,
Cleveland,Governor,Kevin Stitt,REP,140036,32,55,553,640,
Cleveland,Governor,Drew Edmondson,DEM,140036,34,27,246,307,
Cleveland,Lieutenant Governor,Matt Pinnell,REP,140036,36,61,591,688,
Cleveland,Lieutenant Governor,Anastasia Pittman,DEM,140036,28,20,215,263,
Cleveland,Lieutenant Governor,Ivan Holmes,IND,140036,1,3,35,39,
Cleveland,State Auditor,John Yeutter,LIB,140036,15,10,162,187,
Cleveland,State Auditor,Cindy Byrd,REP,140036,42,67,635,744,
Cleveland,Attorney General,Mike Hunter,REP,140036,41,60,621,722,
Cleveland,Attorney General,Mark Myles,DEM,140036,25,24,218,267,
Cleveland,State Treasurer,Randy Mcdaniel,REP,140036,36,63,615,714,
Cleveland,State Treasurer,Charles De Coune,IND,140036,22,14,182,218,
Cleveland,Superintendent of Public Instruction,Joy Hofmeister,REP,140036,41,56,548,645,
Cleveland,Superintendent of Public Instruction,John Cox,DEM,140036,20,19,202,241,
Cleveland,Superintendent of Public Instruction,Larry Huff,IND,140036,5,9,88,102,
Cleveland,Commissioner of Labor,Leslie Osborn,REP,140036,42,61,583,686,
Cleveland,Commissioner of Labor,Fred Dorrell,DEM,140036,22,21,195,238,
Cleveland,Commissioner of Labor,Brandt Dismukes,IND,140036,1,2,60,63,
Cleveland,Insurance Commissioner,Glen Mulready,REP,140036,36,60,593,689,
Cleveland,Insurance Commissioner,Kimberly Fobbs,DEM,140036,27,24,244,295,
Cleveland,Corporation Commissioner,Bob Anthony,REP,140036,39,57,550,646,
Cleveland,Corporation Commissioner,Ashley Nicole Mccray,DEM,140036,25,20,221,266,
Cleveland,Corporation Commissioner,Jackie Short,IND,140036,1,7,67,75,
Cleveland,U.S. House,Tom Cole,REP,140036,36,58,594,688,4
Cleveland,U.S. House,Mary Brannon,DEM,140036,26,23,200,249,4
Cleveland,U.S. House,Ruby Peters,IND,140036,3,2,47,52,4
Cleveland,Governor,Chris Powell,LIB,140037,2,2,53,57,
Cleveland,Governor,Kevin Stitt,REP,140037,23,30,414,467,
Cleveland,Governor,Drew Edmondson,DEM,140037,28,46,405,479,
Cleveland,Lieutenant Governor,Matt Pinnell,REP,140037,27,31,474,532,
Cleveland,Lieutenant Governor,Anastasia Pittman,DEM,140037,25,41,348,414,
Cleveland,Lieutenant Governor,Ivan Holmes,IND,140037,1,6,44,51,
Cleveland,State Auditor,John Yeutter,LIB,140037,17,28,261,306,
Cleveland,State Auditor,Cindy Byrd,REP,140037,29,37,559,625,
Cleveland,Attorney General,Mike Hunter,REP,140037,26,34,512,572,
Cleveland,Attorney General,Mark Myles,DEM,140037,26,45,350,421,
Cleveland,State Treasurer,Randy Mcdaniel,REP,140037,29,34,505,568,
Cleveland,State Treasurer,Charles De Coune,IND,140037,19,34,312,365,
Cleveland,Superintendent of Public Instruction,Joy Hofmeister,REP,140037,27,38,452,517,
Cleveland,Superintendent of Public Instruction,John Cox,DEM,140037,22,38,324,384,
Cleveland,Superintendent of Public Instruction,Larry Huff,IND,140037,4,3,85,92,
Cleveland,Commissioner of Labor,Leslie Osborn,REP,140037,26,34,485,545,
Cleveland,Commissioner of Labor,Fred Dorrell,DEM,140037,26,42,306,374,
Cleveland,Commissioner of Labor,Brandt Dismukes,IND,140037,1,3,63,67,
Cleveland,Insurance Commissioner,Glen Mulready,REP,140037,25,33,487,545,
Cleveland,Insurance Commissioner,Kimberly Fobbs,DEM,140037,28,45,368,441,
Cleveland,Corporation Commissioner,Bob Anthony,REP,140037,25,30,458,513,
Cleveland,Corporation Commissioner,Ashley Nicole Mccray,DEM,140037,26,42,341,409,
Cleveland,Corporation Commissioner,Jackie Short,IND,140037,2,7,58,67,
Cleveland,U.S. House,Tom Cole,REP,140037,25,35,496,556,4
Cleveland,U.S. House,Mary Brannon,DEM,140037,26,41,321,388,4
Cleveland,U.S. House,Ruby Peters,IND,140037,1,3,50,54,4
Cleveland,State House,Kevin West,REP,140037,24,32,472,528,54
Cleveland,State House,Katelyn Dockery,DEM,140037,28,46,387,461,54
Cleveland,Governor,Chris Powell,LIB,140038,0,0,47,47,
Cleveland,Governor,Kevin Stitt,REP,140038,20,15,469,504,
Cleveland,Governor,Drew Edmondson,DEM,140038,25,20,299,344,
Cleveland,Lieutenant Governor,Matt Pinnell,REP,140038,20,18,526,564,
Cleveland,Lieutenant Governor,Anastasia Pittman,DEM,140038,23,16,238,277,
Cleveland,Lieutenant Governor,Ivan Holmes,IND,140038,1,1,46,48,
Cleveland,State Auditor,John Yeutter,LIB,140038,18,11,217,246,
Cleveland,State Auditor,Cindy Byrd,REP,140038,22,20,561,603,
Cleveland,Attorney General,Mike Hunter,REP,140038,18,20,544,582,
Cleveland,Attorney General,Mark Myles,DEM,140038,27,15,258,300,
Cleveland,State Treasurer,Randy Mcdaniel,REP,140038,21,21,544,586,
Cleveland,State Treasurer,Charles De Coune,IND,140038,19,10,227,256,
Cleveland,Superintendent of Public Instruction,Joy Hofmeister,REP,140038,17,19,485,521,
Cleveland,Superintendent of Public Instruction,John Cox,DEM,140038,24,14,215,253,
Cleveland,Superintendent of Public Instruction,Larry Huff,IND,140038,4,2,106,112,
Cleveland,Commissioner of Labor,Leslie Osborn,REP,140038,22,19,518,559,
Cleveland,Commissioner of Labor,Fred Dorrell,DEM,140038,22,12,223,257,
Cleveland,Commissioner of Labor,Brandt Dismukes,IND,140038,1,4,62,67,
Cleveland,Insurance Commissioner,Glen Mulready,REP,140038,20,18,519,557,
Cleveland,Insurance Commissioner,Kimberly Fobbs,DEM,140038,25,17,283,325,
Cleveland,Corporation Commissioner,Bob Anthony,REP,140038,18,21,498,537,
Cleveland,Corporation Commissioner,Ashley Nicole Mccray,DEM,140038,23,13,252,288,
Cleveland,Corporation Commissioner,Jackie Short,IND,140038,4,1,56,61,
Cleveland,U.S. House,Tom Cole,REP,140038,21,21,520,562,4
Cleveland,U.S. House,Mary Brannon,DEM,140038,24,14,236,274,4
Cleveland,U.S. House,Ruby Peters,IND,140038,1,0,52,53,4
Cleveland,State House,Sherrie Conley,REP,140038,21,16,547,584,20
Cleveland,State House,Steve Jarman,DEM,140038,24,19,251,294,20
Cleveland,Governor,Chris Powell,LIB,140039,1,1,22,24,
Cleveland,Governor,Kevin Stitt,REP,140039,33,21,329,383,
Cleveland,Governor,Drew Edmondson,DEM,140039,81,66,536,683,
Cleveland,Lieutenant Governor,Matt Pinnell,REP,140039,38,32,389,459,
Cleveland,Lieutenant Governor,Anastasia Pittman,DEM,140039,77,54,446,577,
Cleveland,Lieutenant Governor,Ivan Holmes,IND,140039,0,2,46,48,
Cleveland,State Auditor,John Yeutter,LIB,140039,30,20,285,335,
Cleveland,State Auditor,Cindy Byrd,REP,140039,59,50,485,594,
Cleveland,Attorney General,Mike Hunter,REP,140039,38,31,408,477,
Cleveland,Attorney General,Mark Myles,DEM,140039,74,57,472,603,
Cleveland,State Treasurer,Randy Mcdaniel,REP,140039,44,35,426,505,
Cleveland,State Treasurer,Charles De Coune,IND,140039,50,36,343,429,
Cleveland,Superintendent of Public Instruction,Joy Hofmeister,REP,140039,50,37,407,494,
Cleveland,Superintendent of Public Instruction,John Cox,DEM,140039,62,48,404,514,
Cleveland,Superintendent of Public Instruction,Larry Huff,IND,140039,4,2,66,72,
Cleveland,Commissioner of Labor,Leslie Osborn,REP,140039,42,31,412,485,
Cleveland,Commissioner of Labor,Fred Dorrell,DEM,140039,69,54,422,545,
Cleveland,Commissioner of Labor,Brandt Dismukes,IND,140039,2,2,38,42,
Cleveland,Insurance Commissioner,Glen Mulready,REP,140039,34,30,389,453,
Cleveland,Insurance Commissioner,Kimberly Fobbs,DEM,140039,79,58,476,613,
Cleveland,Corporation Commissioner,Bob Anthony,REP,140039,44,33,371,448,
Cleveland,Corporation Commissioner,Ashley Nicole Mccray,DEM,140039,69,53,449,571,
Cleveland,Corporation Commissioner,Jackie Short,IND,140039,3,1,48,52,
Cleveland,U.S. House,Tom Cole,REP,140039,40,30,398,468,4
Cleveland,U.S. House,Mary Brannon,DEM,140039,74,56,454,584,4
Cleveland,U.S. House,Ruby Peters,IND,140039,1,1,29,31,4
Cleveland,State House,Bryan Vinyard,REP,140039,33,27,362,422,46
Cleveland,State House,Jacob Rosecrants,DEM,140039,83,61,517,661,46
Cleveland,Governor,Chris Powell,LIB,140040,1,0,28,29,
Cleveland,Governor,Kevin Stitt,REP,140040,41,73,508,622,
Cleveland,Governor,Drew Edmondson,DEM,140040,44,60,485,589,
Cleveland,Lieutenant Governor,Matt Pinnell,REP,140040,42,79,571,692,
Cleveland,Lieutenant Governor,Anastasia Pittman,DEM,140040,41,51,416,508,
Cleveland,Lieutenant Governor,Ivan Holmes,IND,140040,2,3,30,35,
Cleveland,State Auditor,John Yeutter,LIB,140040,20,28,247,295,
Cleveland,State Auditor,Cindy Byrd,REP,140040,56,92,657,805,
Cleveland,Attorney General,Mike Hunter,REP,140040,54,76,593,723,
Cleveland,Attorney General,Mark Myles,DEM,140040,30,55,419,504,
Cleveland,State Treasurer,Randy Mcdaniel,REP,140040,49,82,609,740,
Cleveland,State Treasurer,Charles De Coune,IND,140040,26,41,294,361,
Cleveland,Superintendent of Public Instruction,Joy Hofmeister,REP,140040,46,78,554,678,
Cleveland,Superintendent of Public Instruction,John Cox,DEM,140040,31,47,389,467,
Cleveland,Superintendent of Public Instruction,Larry Huff,IND,140040,7,7,68,82,
Cleveland,Commissioner of Labor,Leslie Osborn,REP,140040,48,78,581,707,
Cleveland,Commissioner of Labor,Fred Dorrell,DEM,140040,33,47,375,455,
Cleveland,Commissioner of Labor,Brandt Dismukes,IND,140040,0,4,44,48,
Cleveland,Insurance Commissioner,Glen Mulready,REP,140040,46,80,563,689,
Cleveland,Insurance Commissioner,Kimberly Fobbs,DEM,140040,37,51,440,528,
Cleveland,Corporation Commissioner,Bob Anthony,REP,140040,47,81,548,676,
Cleveland,Corporation Commissioner,Ashley Nicole Mccray,DEM,140040,32,46,406,484,
Cleveland,Corporation Commissioner,Jackie Short,IND,140040,3,5,58,66,
Cleveland,U.S. House,Tom Cole,REP,140040,44,79,580,703,4
Cleveland,U.S. House,Mary Brannon,DEM,140040,36,49,401,486,4
Cleveland,U.S. House,Ruby Peters,IND,140040,2,5,33,40,4
Cleveland,State House,Chris Kannady,REP,140040,48,74,550,672,91
Cleveland,State House,Amanda Jeffers,DEM,140040,36,57,467,560,91
Cleveland,Governor,Chris Powell,LIB,140041,0,1,14,15,
Cleveland,Governor,Kevin Stitt,REP,140041,9,22,212,243,
Cleveland,Governor,Drew Edmondson,DEM,140041,9,7,210,226,
Cleveland,Lieutenant Governor,Matt Pinnell,REP,140041,11,22,234,267,
Cleveland,Lieutenant Governor,Anastasia Pittman,DEM,140041,7,6,181,194,
Cleveland,Lieutenant Governor,Ivan Holmes,IND,140041,0,2,18,20,
Cleveland,State Auditor,John Yeutter,LIB,140041,5,6,117,128,
Cleveland,State Auditor,Cindy Byrd,REP,140041,12,23,269,304,
Cleveland,Attorney General,Mike Hunter,REP,140041,9,23,242,274,
Cleveland,Attorney General,Mark Myles,DEM,140041,8,7,189,204,
Cleveland,State Treasurer,Randy Mcdaniel,REP,140041,11,20,256,287,
Cleveland,State Treasurer,Charles De Coune,IND,140041,6,10,136,152,
Cleveland,Superintendent of Public Instruction,Joy Hofmeister,REP,140041,11,19,234,264,
Cleveland,Superintendent of Public Instruction,John Cox,DEM,140041,6,9,168,183,
Cleveland,Superintendent of Public Instruction,Larry Huff,IND,140041,1,2,30,33,
Cleveland,Commissioner of Labor,Leslie Osborn,REP,140041,9,20,238,267,
Cleveland,Commissioner of Labor,Fred Dorrell,DEM,140041,7,9,157,173,
Cleveland,Commissioner of Labor,Brandt Dismukes,IND,140041,0,1,31,32,
Cleveland,Insurance Commissioner,Glen Mulready,REP,140041,9,22,235,266,
Cleveland,Insurance Commissioner,Kimberly Fobbs,DEM,140041,6,8,190,204,
Cleveland,Corporation Commissioner,Bob Anthony,REP,140041,10,18,232,260,
Cleveland,Corporation Commissioner,Ashley Nicole Mccray,DEM,140041,6,8,171,185,
Cleveland,Corporation Commissioner,Jackie Short,IND,140041,0,4,27,31,
Cleveland,U.S. House,Tom Cole,REP,140041,11,23,251,285,4
Cleveland,U.S. House,Mary Brannon,DEM,140041,6,6,165,177,4
Cleveland,U.S. House,Ruby Peters,IND,140041,0,1,19,20,4
Cleveland,State House,Chris Kannady,REP,140041,10,22,231,263,91
Cleveland,State House,Amanda Jeffers,DEM,140041,6,8,192,206,91
Cleveland,Governor,Chris Powell,LIB,140042,0,0,8,8,
Cleveland,Governor,Kevin Stitt,REP,140042,14,23,161,198,
Cleveland,Governor,Drew Edmondson,DEM,140042,51,49,420,520,
Cleveland,Lieutenant Governor,Matt Pinnell,REP,140042,17,26,209,252,
Cleveland,Lieutenant Governor,Anastasia Pittman,DEM,140042,45,45,354,444,
Cleveland,Lieutenant Governor,Ivan Holmes,IND,140042,2,1,22,25,
Cleveland,State Auditor,John Yeutter,LIB,140042,21,26,189,236,
Cleveland,State Auditor,Cindy Byrd,REP,140042,30,34,308,372,
Cleveland,Attorney General,Mike Hunter,REP,140042,19,34,240,293,
Cleveland,Attorney General,Mark Myles,DEM,140042,46,39,338,423,
Cleveland,State Treasurer,Randy Mcdaniel,REP,140042,22,33,256,311,
Cleveland,State Treasurer,Charles De Coune,IND,140042,32,28,245,305,
Cleveland,Superintendent of Public Instruction,Joy Hofmeister,REP,140042,23,35,248,306,
Cleveland,Superintendent of Public Instruction,John Cox,DEM,140042,38,35,299,372,
Cleveland,Superintendent of Public Instruction,Larry Huff,IND,140042,1,2,37,40,
Cleveland,Commissioner of Labor,Leslie Osborn,REP,140042,21,33,250,304,
Cleveland,Commissioner of Labor,Fred Dorrell,DEM,140042,41,38,299,378,
Cleveland,Commissioner of Labor,Brandt Dismukes,IND,140042,1,1,23,25,
Cleveland,Insurance Commissioner,Glen Mulready,REP,140042,20,28,212,260,
Cleveland,Insurance Commissioner,Kimberly Fobbs,DEM,140042,44,42,362,448,
Cleveland,Corporation Commissioner,Bob Anthony,REP,140042,20,28,230,278,
Cleveland,Corporation Commissioner,Ashley Nicole Mccray,DEM,140042,41,42,318,401,
Cleveland,Corporation Commissioner,Jackie Short,IND,140042,2,1,31,34,
Cleveland,U.S. House,Tom Cole,REP,140042,22,27,226,275,4
Cleveland,U.S. House,Mary Brannon,DEM,140042,43,46,347,436,4
Cleveland,U.S. House,Ruby Peters,IND,140042,0,0,11,11,4
Cleveland,State Senate,Becki Maldonado,REP,140042,15,25,184,224,16
Cleveland,State Senate,Mary Boren,DEM,140042,49,46,396,491,16
Cleveland,Governor,Chris Powell,LIB,140043,3,1,43,47,
Cleveland,Governor,Kevin Stitt,REP,140043,53,108,646,807,
Cleveland,Governor,Drew Edmondson,DEM,140043,69,91,656,816,
Cleveland,Lieutenant Governor,Matt Pinnell,REP,140043,65,121,762,948,
Cleveland,Lieutenant Governor,Anastasia Pittman,DEM,140043,58,75,521,654,
Cleveland,Lieutenant Governor,Ivan Holmes,IND,140043,3,5,52,60,
Cleveland,State Auditor,John Yeutter,LIB,140043,38,49,349,436,
Cleveland,State Auditor,Cindy Byrd,REP,140043,78,136,896,1110,
Cleveland,Attorney General,Mike Hunter,REP,140043,69,123,808,1000,
Cleveland,Attorney General,Mark Myles,DEM,140043,57,74,517,648,
Cleveland,State Treasurer,Randy Mcdaniel,REP,140043,66,122,831,1019,
Cleveland,State Treasurer,Charles De Coune,IND,140043,55,61,401,517,
Cleveland,Superintendent of Public Instruction,Joy Hofmeister,REP,140043,62,110,737,909,
Cleveland,Superintendent of Public Instruction,John Cox,DEM,140043,52,76,465,593,
Cleveland,Superintendent of Public Instruction,Larry Huff,IND,140043,11,11,130,152,
Cleveland,Commissioner of Labor,Leslie Osborn,REP,140043,69,122,792,983,
Cleveland,Commissioner of Labor,Fred Dorrell,DEM,140043,54,66,432,552,
Cleveland,Commissioner of Labor,Brandt Dismukes,IND,140043,3,7,90,100,
Cleveland,Insurance Commissioner,Glen Mulready,REP,140043,62,113,780,955,
Cleveland,Insurance Commissioner,Kimberly Fobbs,DEM,140043,63,82,532,677,
Cleveland,Corporation Commissioner,Bob Anthony,REP,140043,59,110,729,898,
Cleveland,Corporation Commissioner,Ashley Nicole Mccray,DEM,140043,58,78,498,634,
Cleveland,Corporation Commissioner,Jackie Short,IND,140043,9,7,87,103,
Cleveland,U.S. House,Tom Cole,REP,140043,67,121,800,988,4
Cleveland,U.S. House,Mary Brannon,DEM,140043,52,77,475,604,4
Cleveland,U.S. House,Ruby Peters,IND,140043,7,3,58,68,4
Cleveland,State Senate,Darrell Weaver,REP,140043,68,115,792,975,24
Cleveland,State Senate,RenÉE Jerden,DEM,140043,58,83,525,666,24
Cleveland,State House,Mark Mcbride,REP,140043,58,111,732,901,53
Cleveland,State House,Leslie Bonebreak,DEM,140043,67,89,590,746,53
Cleveland,Governor,Chris Powell,LIB,140044,4,1,61,66,
Cleveland,Governor,Kevin Stitt,REP,140044,55,72,646,773,
Cleveland,Governor,Drew Edmondson,DEM,140044,57,67,571,695,
Cleveland,Lieutenant Governor,Matt Pinnell,REP,140044,61,89,717,867,
Cleveland,Lieutenant Governor,Anastasia Pittman,DEM,140044,49,51,486,586,
Cleveland,Lieutenant Governor,Ivan Holmes,IND,140044,6,1,70,77,
Cleveland,State Auditor,John Yeutter,LIB,140044,26,28,301,355,
Cleveland,State Auditor,Cindy Byrd,REP,140044,82,97,859,1038,
Cleveland,Attorney General,Mike Hunter,REP,140044,66,88,761,915,
Cleveland,Attorney General,Mark Myles,DEM,140044,49,53,501,603,
Cleveland,State Treasurer,Randy Mcdaniel,REP,140044,66,92,795,953,
Cleveland,State Treasurer,Charles De Coune,IND,140044,42,35,371,448,
Cleveland,Superintendent of Public Instruction,Joy Hofmeister,REP,140044,58,84,712,854,
Cleveland,Superintendent of Public Instruction,John Cox,DEM,140044,46,52,435,533,
Cleveland,Superintendent of Public Instruction,Larry Huff,IND,140044,11,5,117,133,
Cleveland,Commissioner of Labor,Leslie Osborn,REP,140044,70,81,760,911,
Cleveland,Commissioner of Labor,Fred Dorrell,DEM,140044,44,57,418,519,
Cleveland,Commissioner of Labor,Brandt Dismukes,IND,140044,2,2,80,84,
Cleveland,Insurance Commissioner,Glen Mulready,REP,140044,59,81,729,869,
Cleveland,Insurance Commissioner,Kimberly Fobbs,DEM,140044,54,59,522,635,
Cleveland,Corporation Commissioner,Bob Anthony,REP,140044,58,85,694,837,
Cleveland,Corporation Commissioner,Ashley Nicole Mccray,DEM,140044,51,53,467,571,
Cleveland,Corporation Commissioner,Jackie Short,IND,140044,5,2,95,102,
Cleveland,U.S. House,Tom Cole,REP,140044,61,87,770,918,4
Cleveland,U.S. House,Mary Brannon,DEM,140044,49,53,444,546,4
Cleveland,U.S. House,Ruby Peters,IND,140044,4,1,57,62,4
Cleveland,State Senate,Darrell Weaver,REP,140044,63,83,751,897,24
Cleveland,State Senate,RenÉE Jerden,DEM,140044,51,58,516,625,24
Cleveland,State House,Mark Mcbride,REP,140044,56,80,707,843,53
Cleveland,State House,Leslie Bonebreak,DEM,140044,57,61,563,681,53
Cleveland,Governor,Chris Powell,LIB,140045,1,0,22,23,
Cleveland,Governor,Kevin Stitt,REP,140045,12,5,252,269,
Cleveland,Governor,Drew Edmondson,DEM,140045,12,14,172,198,
Cleveland,Lieutenant Governor,Matt Pinnell,REP,140045,13,5,268,286,
Cleveland,Lieutenant Governor,Anastasia Pittman,DEM,140045,10,14,146,170,
Cleveland,Lieutenant Governor,Ivan Holmes,IND,140045,2,0,27,29,
Cleveland,State Auditor,John Yeutter,LIB,140045,7,11,96,114,
Cleveland,State Auditor,Cindy Byrd,REP,140045,15,5,313,333,
Cleveland,Attorney General,Mike Hunter,REP,140045,14,5,278,297,
Cleveland,Attorney General,Mark Myles,DEM,140045,11,14,161,186,
Cleveland,State Treasurer,Randy Mcdaniel,REP,140045,12,6,294,312,
Cleveland,State Treasurer,Charles De Coune,IND,140045,12,10,113,135,
Cleveland,Superintendent of Public Instruction,Joy Hofmeister,REP,140045,12,4,272,288,
Cleveland,Superintendent of Public Instruction,John Cox,DEM,140045,12,12,119,143,
Cleveland,Superintendent of Public Instruction,Larry Huff,IND,140045,1,3,49,53,
Cleveland,Commissioner of Labor,Leslie Osborn,REP,140045,12,5,278,295,
Cleveland,Commissioner of Labor,Fred Dorrell,DEM,140045,12,14,116,142,
Cleveland,Commissioner of Labor,Brandt Dismukes,IND,140045,1,0,41,42,
Cleveland,Insurance Commissioner,Glen Mulready,REP,140045,14,5,274,293,
Cleveland,Insurance Commissioner,Kimberly Fobbs,DEM,140045,11,14,162,187,
Cleveland,Corporation Commissioner,Bob Anthony,REP,140045,12,5,260,277,
Cleveland,Corporation Commissioner,Ashley Nicole Mccray,DEM,140045,12,13,131,156,
Cleveland,Corporation Commissioner,Jackie Short,IND,140045,1,1,45,47,
Cleveland,U.S. House,Tom Cole,REP,140045,12,5,275,292,4
Cleveland,U.S. House,Mary Brannon,DEM,140045,12,14,148,174,4
Cleveland,U.S. House,Ruby Peters,IND,140045,1,0,19,20,4
Cleveland,State House,Sherrie Conley,REP,140045,15,5,289,309,20
Cleveland,State House,Steve Jarman,DEM,140045,10,14,149,173,20
Cleveland,Governor,Chris Powell,LIB,140047,4,4,62,70,
Cleveland,Governor,Kevin Stitt,REP,140047,20,27,415,462,
Cleveland,Governor,Drew Edmondson,DEM,140047,24,35,423,482,
Cleveland,Lieutenant Governor,Matt Pinnell,REP,140047,19,31,505,555,
Cleveland,Lieutenant Governor,Anastasia Pittman,DEM,140047,25,31,338,394,
Cleveland,Lieutenant Governor,Ivan Holmes,IND,140047,2,2,54,58,
Cleveland,State Auditor,John Yeutter,LIB,140047,17,22,267,306,
Cleveland,State Auditor,Cindy Byrd,REP,140047,20,37,573,630,
Cleveland,Attorney General,Mike Hunter,REP,140047,21,31,514,566,
Cleveland,Attorney General,Mark Myles,DEM,140047,26,33,374,433,
Cleveland,State Treasurer,Randy Mcdaniel,REP,140047,18,35,542,595,
Cleveland,State Treasurer,Charles De Coune,IND,140047,16,24,295,335,
Cleveland,Superintendent of Public Instruction,Joy Hofmeister,REP,140047,17,38,470,525,
Cleveland,Superintendent of Public Instruction,John Cox,DEM,140047,24,21,306,351,
Cleveland,Superintendent of Public Instruction,Larry Huff,IND,140047,5,5,114,124,
Cleveland,Commissioner of Labor,Leslie Osborn,REP,140047,22,35,505,562,
Cleveland,Commissioner of Labor,Fred Dorrell,DEM,140047,23,27,301,351,
Cleveland,Commissioner of Labor,Brandt Dismukes,IND,140047,0,3,78,81,
Cleveland,Insurance Commissioner,Glen Mulready,REP,140047,19,32,484,535,
Cleveland,Insurance Commissioner,Kimberly Fobbs,DEM,140047,27,32,399,458,
Cleveland,Corporation Commissioner,Bob Anthony,REP,140047,15,28,477,520,
Cleveland,Corporation Commissioner,Ashley Nicole Mccray,DEM,140047,26,33,319,378,
Cleveland,Corporation Commissioner,Jackie Short,IND,140047,4,4,91,99,
Cleveland,U.S. House,Tom Cole,REP,140047,20,32,520,572,4
Cleveland,U.S. House,Mary Brannon,DEM,140047,25,33,316,374,4
Cleveland,U.S. House,Ruby Peters,IND,140047,2,1,56,59,4
Cleveland,State Senate,Darrell Weaver,REP,140047,20,33,512,565,24
Cleveland,State Senate,RenÉE Jerden,DEM,140047,27,32,371,430,24
Cleveland,State House,Kevin West,REP,140047,19,31,476,526,54
Cleveland,State House,Katelyn Dockery,DEM,140047,28,34,413,475,54
Cleveland,Governor,Chris Powell,LIB,140048,3,6,42,51,
Cleveland,Governor,Kevin Stitt,REP,140048,24,28,364,416,
Cleveland,Governor,Drew Edmondson,DEM,140048,25,38,320,383,
Cleveland,Lieutenant Governor,Matt Pinnell,REP,140048,24,35,408,467,
Cleveland,Lieutenant Governor,Anastasia Pittman,DEM,140048,26,29,281,336,
Cleveland,Lieutenant Governor,Ivan Holmes,IND,140048,2,6,34,42,
Cleveland,State Auditor,John Yeutter,LIB,140048,18,27,219,264,
Cleveland,State Auditor,Cindy Byrd,REP,140048,29,39,459,527,
Cleveland,Attorney General,Mike Hunter,REP,140048,29,33,423,485,
Cleveland,Attorney General,Mark Myles,DEM,140048,23,38,292,353,
Cleveland,State Treasurer,Randy Mcdaniel,REP,140048,25,36,440,501,
Cleveland,State Treasurer,Charles De Coune,IND,140048,23,29,228,280,
Cleveland,Superintendent of Public Instruction,Joy Hofmeister,REP,140048,29,34,400,463,
Cleveland,Superintendent of Public Instruction,John Cox,DEM,140048,19,32,249,300,
Cleveland,Superintendent of Public Instruction,Larry Huff,IND,140048,4,5,73,82,
Cleveland,Commissioner of Labor,Leslie Osborn,REP,140048,28,38,424,490,
Cleveland,Commissioner of Labor,Fred Dorrell,DEM,140048,21,30,242,293,
Cleveland,Commissioner of Labor,Brandt Dismukes,IND,140048,3,2,46,51,
Cleveland,Insurance Commissioner,Glen Mulready,REP,140048,28,32,410,470,
Cleveland,Insurance Commissioner,Kimberly Fobbs,DEM,140048,23,38,294,355,
Cleveland,Corporation Commissioner,Bob Anthony,REP,140048,23,34,378,435,
Cleveland,Corporation Commissioner,Ashley Nicole Mccray,DEM,140048,20,31,270,321,
Cleveland,Corporation Commissioner,Jackie Short,IND,140048,7,5,66,78,
Cleveland,U.S. House,Tom Cole,REP,140048,28,32,414,474,4
Cleveland,U.S. House,Mary Brannon,DEM,140048,21,34,258,313,4
Cleveland,U.S. House,Ruby Peters,IND,140048,3,4,45,52,4
Cleveland,State Senate,Darrell Weaver,REP,140048,26,37,425,488,24
Cleveland,State Senate,RenÉE Jerden,DEM,140048,25,33,289,347,24
Cleveland,State House,Mark Mcbride,REP,140048,27,35,407,469,53
Cleveland,State House,Leslie Bonebreak,DEM,140048,24,35,312,371,53
Cleveland,Governor,Chris Powell,LIB,140049,1,1,38,40,
Cleveland,Governor,Kevin Stitt,REP,140049,13,11,315,339,
Cleveland,Governor,Drew Edmondson,DEM,140049,8,9,224,241,
Cleveland,Lieutenant Governor,Matt Pinnell,REP,140049,16,10,359,385,
Cleveland,Lieutenant Governor,Anastasia Pittman,DEM,140049,6,10,183,199,
Cleveland,Lieutenant Governor,Ivan Holmes,IND,140049,0,0,31,31,
Cleveland,State Auditor,John Yeutter,LIB,140049,4,5,135,144,
Cleveland,State Auditor,Cindy Byrd,REP,140049,17,14,385,416,
Cleveland,Attorney General,Mike Hunter,REP,140049,17,11,371,399,
Cleveland,Attorney General,Mark Myles,DEM,140049,4,10,196,210,
Cleveland,State Treasurer,Randy Mcdaniel,REP,140049,14,11,364,389,
Cleveland,State Treasurer,Charles De Coune,IND,140049,4,8,153,165,
Cleveland,Superintendent of Public Instruction,Joy Hofmeister,REP,140049,16,11,333,360,
Cleveland,Superintendent of Public Instruction,John Cox,DEM,140049,6,7,158,171,
Cleveland,Superintendent of Public Instruction,Larry Huff,IND,140049,0,3,79,82,
Cleveland,Commissioner of Labor,Leslie Osborn,REP,140049,13,10,358,381,
Cleveland,Commissioner of Labor,Fred Dorrell,DEM,140049,7,8,164,179,
Cleveland,Commissioner of Labor,Brandt Dismukes,IND,140049,1,1,42,44,
Cleveland,Insurance Commissioner,Glen Mulready,REP,140049,14,10,351,375,
Cleveland,Insurance Commissioner,Kimberly Fobbs,DEM,140049,6,10,211,227,
Cleveland,Corporation Commissioner,Bob Anthony,REP,140049,12,11,319,342,
Cleveland,Corporation Commissioner,Ashley Nicole Mccray,DEM,140049,6,9,198,213,
Cleveland,Corporation Commissioner,Jackie Short,IND,140049,2,1,49,52,
Cleveland,U.S. House,Tom Cole,REP,140049,16,12,367,395,4
Cleveland,U.S. House,Mary Brannon,DEM,140049,5,9,165,179,4
Cleveland,U.S. House,Ruby Peters,IND,140049,1,0,38,39,4
Cleveland,Governor,Chris Powell,LIB,140050,4,3,51,58,
Cleveland,Governor,Kevin Stitt,REP,140050,52,50,628,730,
Cleveland,Governor,Drew Edmondson,DEM,140050,39,68,558,665,
Cleveland,Lieutenant Governor,Matt Pinnell,REP,140050,61,60,688,809,
Cleveland,Lieutenant Governor,Anastasia Pittman,DEM,140050,31,60,486,577,
Cleveland,Lieutenant Governor,Ivan Holmes,IND,140050,3,0,59,62,
Cleveland,State Auditor,John Yeutter,LIB,140050,16,24,306,346,
Cleveland,State Auditor,Cindy Byrd,REP,140050,64,78,817,959,
Cleveland,Attorney General,Mike Hunter,REP,140050,55,60,748,863,
Cleveland,Attorney General,Mark Myles,DEM,140050,39,59,480,578,
Cleveland,State Treasurer,Randy Mcdaniel,REP,140050,61,68,764,893,
Cleveland,State Treasurer,Charles De Coune,IND,140050,18,34,365,417,
Cleveland,Superintendent of Public Instruction,Joy Hofmeister,REP,140050,49,60,656,765,
Cleveland,Superintendent of Public Instruction,John Cox,DEM,140050,38,55,456,549,
Cleveland,Superintendent of Public Instruction,Larry Huff,IND,140050,7,5,110,122,
Cleveland,Commissioner of Labor,Leslie Osborn,REP,140050,57,62,712,831,
Cleveland,Commissioner of Labor,Fred Dorrell,DEM,140050,37,55,447,539,
Cleveland,Commissioner of Labor,Brandt Dismukes,IND,140050,1,1,63,65,
Cleveland,Insurance Commissioner,Glen Mulready,REP,140050,59,63,703,825,
Cleveland,Insurance Commissioner,Kimberly Fobbs,DEM,140050,36,57,517,610,
Cleveland,Corporation Commissioner,Bob Anthony,REP,140050,58,63,679,800,
Cleveland,Corporation Commissioner,Ashley Nicole Mccray,DEM,140050,31,51,453,535,
Cleveland,Corporation Commissioner,Jackie Short,IND,140050,6,6,89,101,
Cleveland,U.S. House,Tom Cole,REP,140050,58,68,712,838,4
Cleveland,U.S. House,Mary Brannon,DEM,140050,33,54,471,558,4
Cleveland,U.S. House,Ruby Peters,IND,140050,4,0,50,54,4
Cleveland,State House,Chris Kannady,REP,140050,58,57,696,811,91
Cleveland,State House,Amanda Jeffers,DEM,140050,37,64,526,627,91
Cleveland,Governor,Chris Powell,LIB,140051,0,1,18,19,
Cleveland,Governor,Kevin Stitt,REP,140051,19,14,167,200,
Cleveland,Governor,Drew Edmondson,DEM,140051,28,29,377,434,
Cleveland,Lieutenant Governor,Matt Pinnell,REP,140051,19,16,217,252,
Cleveland,Lieutenant Governor,Anastasia Pittman,DEM,140051,27,28,300,355,
Cleveland,Lieutenant Governor,Ivan Holmes,IND,140051,1,0,34,35,
Cleveland,State Auditor,John Yeutter,LIB,140051,8,13,209,230,
Cleveland,State Auditor,Cindy Byrd,REP,140051,31,24,275,330,
Cleveland,Attorney General,Mike Hunter,REP,140051,22,18,229,269,
Cleveland,Attorney General,Mark Myles,DEM,140051,25,26,321,372,
Cleveland,State Treasurer,Randy Mcdaniel,REP,140051,23,23,231,277,
Cleveland,State Treasurer,Charles De Coune,IND,140051,15,16,256,287,
Cleveland,Superintendent of Public Instruction,Joy Hofmeister,REP,140051,23,18,239,280,
Cleveland,Superintendent of Public Instruction,John Cox,DEM,140051,21,23,267,311,
Cleveland,Superintendent of Public Instruction,Larry Huff,IND,140051,1,3,47,51,
Cleveland,Commissioner of Labor,Leslie Osborn,REP,140051,23,16,219,258,
Cleveland,Commissioner of Labor,Fred Dorrell,DEM,140051,22,26,283,331,
Cleveland,Commissioner of Labor,Brandt Dismukes,IND,140051,1,2,43,46,
Cleveland,Insurance Commissioner,Glen Mulready,REP,140051,20,14,213,247,
Cleveland,Insurance Commissioner,Kimberly Fobbs,DEM,140051,25,30,332,387,
Cleveland,Corporation Commissioner,Bob Anthony,REP,140051,22,17,218,257,
Cleveland,Corporation Commissioner,Ashley Nicole Mccray,DEM,140051,20,26,291,337,
Cleveland,Corporation Commissioner,Jackie Short,IND,140051,3,1,37,41,
Cleveland,U.S. House,Tom Cole,REP,140051,23,13,221,257,4
Cleveland,U.S. House,Mary Brannon,DEM,140051,24,29,307,360,4
Cleveland,U.S. House,Ruby Peters,IND,140051,0,2,25,27,4
Cleveland,State Senate,Becki Maldonado,REP,140051,17,14,196,227,16
Cleveland,State Senate,Mary Boren,DEM,140051,29,30,356,415,16
Cleveland,Governor,Chris Powell,LIB,140053,5,3,46,54,
Cleveland,Governor,Kevin Stitt,REP,140053,91,98,686,875,
Cleveland,Governor,Drew Edmondson,DEM,140053,138,201,951,1290,
Cleveland,Lieutenant Governor,Matt Pinnell,REP,140053,108,114,829,1051,
Cleveland,Lieutenant Governor,Anastasia Pittman,DEM,140053,119,178,777,1074,
Cleveland,Lieutenant Governor,Ivan Holmes,IND,140053,6,8,62,76,
Cleveland,State Auditor,John Yeutter,LIB,140053,57,87,462,606,
Cleveland,State Auditor,Cindy Byrd,REP,140053,139,155,1027,1321,
Cleveland,Attorney General,Mike Hunter,REP,140053,115,132,873,1120,
Cleveland,Attorney General,Mark Myles,DEM,140053,116,169,792,1077,
Cleveland,State Treasurer,Randy Mcdaniel,REP,140053,130,135,910,1175,
Cleveland,State Treasurer,Charles De Coune,IND,140053,74,115,587,776,
Cleveland,Superintendent of Public Instruction,Joy Hofmeister,REP,140053,135,135,891,1161,
Cleveland,Superintendent of Public Instruction,John Cox,DEM,140053,82,152,663,897,
Cleveland,Superintendent of Public Instruction,Larry Huff,IND,140053,15,12,110,137,
Cleveland,Commissioner of Labor,Leslie Osborn,REP,140053,125,121,861,1107,
Cleveland,Commissioner of Labor,Fred Dorrell,DEM,140053,97,168,695,960,
Cleveland,Commissioner of Labor,Brandt Dismukes,IND,140053,6,9,81,96,
Cleveland,Insurance Commissioner,Glen Mulready,REP,140053,107,115,825,1047,
Cleveland,Insurance Commissioner,Kimberly Fobbs,DEM,140053,122,186,813,1121,
Cleveland,Corporation Commissioner,Bob Anthony,REP,140053,119,131,802,1052,
Cleveland,Corporation Commissioner,Ashley Nicole Mccray,DEM,140053,103,164,757,1024,
Cleveland,Corporation Commissioner,Jackie Short,IND,140053,9,7,97,113,
Cleveland,U.S. House,Tom Cole,REP,140053,119,119,863,1101,4
Cleveland,U.S. House,Mary Brannon,DEM,140053,111,177,759,1047,4
Cleveland,U.S. House,Ruby Peters,IND,140053,3,6,52,61,4
Cleveland,State House,Bryan Vinyard,REP,140053,96,107,782,985,46
Cleveland,State House,Jacob Rosecrants,DEM,140053,137,194,895,1226,46
Cleveland,Governor,Chris Powell,LIB,140054,0,3,49,52,
Cleveland,Governor,Kevin Stitt,REP,140054,15,18,320,353,
Cleveland,Governor,Drew Edmondson,DEM,140054,11,19,264,294,
Cleveland,Lieutenant Governor,Matt Pinnell,REP,140054,16,23,346,385,
Cleveland,Lieutenant Governor,Anastasia Pittman,DEM,140054,10,15,238,263,
Cleveland,Lieutenant Governor,Ivan Holmes,IND,140054,0,2,43,45,
Cleveland,State Auditor,John Yeutter,LIB,140054,7,12,186,205,
Cleveland,State Auditor,Cindy Byrd,REP,140054,18,25,400,443,
Cleveland,Attorney General,Mike Hunter,REP,140054,16,22,369,407,
Cleveland,Attorney General,Mark Myles,DEM,140054,10,18,256,284,
Cleveland,State Treasurer,Randy Mcdaniel,REP,140054,19,22,370,411,
Cleveland,State Treasurer,Charles De Coune,IND,140054,7,15,212,234,
Cleveland,Superintendent of Public Instruction,Joy Hofmeister,REP,140054,19,24,319,362,
Cleveland,Superintendent of Public Instruction,John Cox,DEM,140054,3,12,228,243,
Cleveland,Superintendent of Public Instruction,Larry Huff,IND,140054,4,4,74,82,
Cleveland,Commissioner of Labor,Leslie Osborn,REP,140054,18,23,340,381,
Cleveland,Commissioner of Labor,Fred Dorrell,DEM,140054,8,12,231,251,
Cleveland,Commissioner of Labor,Brandt Dismukes,IND,140054,0,5,50,55,
Cleveland,Insurance Commissioner,Glen Mulready,REP,140054,14,22,348,384,
Cleveland,Insurance Commissioner,Kimberly Fobbs,DEM,140054,12,18,270,300,
Cleveland,Corporation Commissioner,Bob Anthony,REP,140054,16,20,315,351,
Cleveland,Corporation Commissioner,Ashley Nicole Mccray,DEM,140054,10,16,245,271,
Cleveland,Corporation Commissioner,Jackie Short,IND,140054,0,4,60,64,
Cleveland,U.S. House,Tom Cole,REP,140054,18,20,354,392,4
Cleveland,U.S. House,Mary Brannon,DEM,140054,6,15,238,259,4
Cleveland,U.S. House,Ruby Peters,IND,140054,2,5,36,43,4
Cleveland,State Senate,Darrell Weaver,REP,140054,14,22,371,407,24
Cleveland,State Senate,RenÉE Jerden,DEM,140054,11,18,251,280,24
Cleveland,State House,Kevin West,REP,140054,15,22,366,403,54
Cleveland,State House,Katelyn Dockery,DEM,140054,11,18,258,287,54
Cleveland,Governor,Chris Powell,LIB,140055,2,4,51,57,
Cleveland,Governor,Kevin Stitt,REP,140055,40,84,444,568,
Cleveland,Governor,Drew Edmondson,DEM,140055,81,174,659,914,
Cleveland,Lieutenant Governor,Matt Pinnell,REP,140055,45,97,542,684,
Cleveland,Lieutenant Governor,Anastasia Pittman,DEM,140055,73,159,542,774,
Cleveland,Lieutenant Governor,Ivan Holmes,IND,140055,5,7,64,76,
Cleveland,State Auditor,John Yeutter,LIB,140055,29,84,379,492,
Cleveland,State Auditor,Cindy Byrd,REP,140055,74,136,666,876,
Cleveland,Attorney General,Mike Hunter,REP,140055,52,105,574,731,
Cleveland,Attorney General,Mark Myles,DEM,140055,70,157,570,797,
Cleveland,State Treasurer,Randy Mcdaniel,REP,140055,61,110,591,762,
Cleveland,State Treasurer,Charles De Coune,IND,140055,46,117,449,612,
Cleveland,Superintendent of Public Instruction,Joy Hofmeister,REP,140055,59,127,551,737,
Cleveland,Superintendent of Public Instruction,John Cox,DEM,140055,60,119,474,653,
Cleveland,Superintendent of Public Instruction,Larry Huff,IND,140055,4,15,114,133,
Cleveland,Commissioner of Labor,Leslie Osborn,REP,140055,57,106,557,720,
Cleveland,Commissioner of Labor,Fred Dorrell,DEM,140055,62,141,506,709,
Cleveland,Commissioner of Labor,Brandt Dismukes,IND,140055,2,12,68,82,
Cleveland,Insurance Commissioner,Glen Mulready,REP,140055,50,101,542,693,
Cleveland,Insurance Commissioner,Kimberly Fobbs,DEM,140055,69,158,582,809,
Cleveland,Corporation Commissioner,Bob Anthony,REP,140055,60,99,515,674,
Cleveland,Corporation Commissioner,Ashley Nicole Mccray,DEM,140055,59,154,532,745,
Cleveland,Corporation Commissioner,Jackie Short,IND,140055,2,7,84,93,
Cleveland,U.S. House,Tom Cole,REP,140055,49,103,557,709,4
Cleveland,U.S. House,Mary Brannon,DEM,140055,71,154,531,756,4
Cleveland,U.S. House,Ruby Peters,IND,140055,3,5,59,67,4
Cleveland,State House,Marc Etters,REP,140055,46,85,492,623,45
Cleveland,State House,Merleyn Bell,DEM,140055,73,162,572,807,45
Cleveland,State House,Tom Hackelman,IND,140055,2,13,75,90,45
Cleveland,Governor,Chris Powell,LIB,140056,2,3,29,34,
Cleveland,Governor,Kevin Stitt,REP,140056,22,56,290,368,
Cleveland,Governor,Drew Edmondson,DEM,140056,88,115,662,865,
Cleveland,Lieutenant Governor,Matt Pinnell,REP,140056,25,68,373,466,
Cleveland,Lieutenant Governor,Anastasia Pittman,DEM,140056,81,100,552,733,
Cleveland,Lieutenant Governor,Ivan Holmes,IND,140056,5,5,53,63,
Cleveland,State Auditor,John Yeutter,LIB,140056,37,48,330,415,
Cleveland,State Auditor,Cindy Byrd,REP,140056,45,97,487,629,
Cleveland,Attorney General,Mike Hunter,REP,140056,26,68,388,482,
Cleveland,Attorney General,Mark Myles,DEM,140056,83,104,579,766,
Cleveland,State Treasurer,Randy Mcdaniel,REP,140056,41,77,422,540,
Cleveland,State Treasurer,Charles De Coune,IND,140056,41,70,407,518,
Cleveland,Superintendent of Public Instruction,Joy Hofmeister,REP,140056,40,89,413,542,
Cleveland,Superintendent of Public Instruction,John Cox,DEM,140056,69,82,491,642,
Cleveland,Superintendent of Public Instruction,Larry Huff,IND,140056,2,2,70,74,
Cleveland,Commissioner of Labor,Leslie Osborn,REP,140056,30,77,383,490,
Cleveland,Commissioner of Labor,Fred Dorrell,DEM,140056,76,92,521,689,
Cleveland,Commissioner of Labor,Brandt Dismukes,IND,140056,2,3,52,57,
Cleveland,Insurance Commissioner,Glen Mulready,REP,140056,24,64,361,449,
Cleveland,Insurance Commissioner,Kimberly Fobbs,DEM,140056,84,109,590,783,
Cleveland,Corporation Commissioner,Bob Anthony,REP,140056,30,77,364,471,
Cleveland,Corporation Commissioner,Ashley Nicole Mccray,DEM,140056,77,90,533,700,
Cleveland,Corporation Commissioner,Jackie Short,IND,140056,2,6,67,75,
Cleveland,U.S. House,Tom Cole,REP,140056,29,66,381,476,4
Cleveland,U.S. House,Mary Brannon,DEM,140056,81,105,556,742,4
Cleveland,U.S. House,Ruby Peters,IND,140056,2,2,36,40,4
Cleveland,State Senate,Becki Maldonado,REP,140056,22,59,319,400,16
Cleveland,State Senate,Mary Boren,DEM,140056,89,113,646,848,16
Cleveland,Governor,Chris Powell,LIB,140057,6,2,61,69,
Cleveland,Governor,Kevin Stitt,REP,140057,44,40,690,774,
Cleveland,Governor,Drew Edmondson,DEM,140057,39,67,634,740,
Cleveland,Lieutenant Governor,Matt Pinnell,REP,140057,55,48,816,919,
Cleveland,Lieutenant Governor,Anastasia Pittman,DEM,140057,31,56,488,575,
Cleveland,Lieutenant Governor,Ivan Holmes,IND,140057,3,5,71,79,
Cleveland,State Auditor,John Yeutter,LIB,140057,7,35,312,354,
Cleveland,State Auditor,Cindy Byrd,REP,140057,73,63,984,1120,
Cleveland,Attorney General,Mike Hunter,REP,140057,61,46,877,984,
Cleveland,Attorney General,Mark Myles,DEM,140057,28,62,496,586,
Cleveland,State Treasurer,Randy Mcdaniel,REP,140057,61,49,888,998,
Cleveland,State Treasurer,Charles De Coune,IND,140057,20,50,402,472,
Cleveland,Superintendent of Public Instruction,Joy Hofmeister,REP,140057,50,51,805,906,
Cleveland,Superintendent of Public Instruction,John Cox,DEM,140057,36,52,435,523,
Cleveland,Superintendent of Public Instruction,Larry Huff,IND,140057,2,5,134,141,
Cleveland,Commissioner of Labor,Leslie Osborn,REP,140057,58,47,815,920,
Cleveland,Commissioner of Labor,Fred Dorrell,DEM,140057,27,55,445,527,
Cleveland,Commissioner of Labor,Brandt Dismukes,IND,140057,3,7,91,101,
Cleveland,Insurance Commissioner,Glen Mulready,REP,140057,58,47,813,918,
Cleveland,Insurance Commissioner,Kimberly Fobbs,DEM,140057,30,60,543,633,
Cleveland,Corporation Commissioner,Bob Anthony,REP,140057,60,46,759,865,
Cleveland,Corporation Commissioner,Ashley Nicole Mccray,DEM,140057,25,60,499,584,
Cleveland,Corporation Commissioner,Jackie Short,IND,140057,2,3,107,112,
Cleveland,U.S. House,Tom Cole,REP,140057,57,47,836,940,4
Cleveland,U.S. House,Mary Brannon,DEM,140057,30,58,479,567,4
Cleveland,U.S. House,Ruby Peters,IND,140057,2,3,59,64,4
Cleveland,State Senate,Becki Maldonado,REP,140057,53,43,729,825,16
Cleveland,State Senate,Mary Boren,DEM,140057,35,65,640,740,16
Cleveland,State House,Bryan Vinyard,REP,140057,50,40,740,830,46
Cleveland,State House,Jacob Rosecrants,DEM,140057,37,68,637,742,46
Cleveland,Governor,Chris Powell,LIB,140058,2,5,43,50,
Cleveland,Governor,Kevin Stitt,REP,140058,38,38,481,557,
Cleveland,Governor,Drew Edmondson,DEM,140058,39,41,393,473,
Cleveland,Lieutenant Governor,Matt Pinnell,REP,140058,40,47,576,663,
Cleveland,Lieutenant Governor,Anastasia Pittman,DEM,140058,33,37,301,371,
Cleveland,Lieutenant Governor,Ivan Holmes,IND,140058,4,1,36,41,
Cleveland,State Auditor,John Yeutter,LIB,140058,13,25,217,255,
Cleveland,State Auditor,Cindy Byrd,REP,140058,53,52,640,745,
Cleveland,Attorney General,Mike Hunter,REP,140058,44,47,606,697,
Cleveland,Attorney General,Mark Myles,DEM,140058,33,37,299,369,
Cleveland,State Treasurer,Randy Mcdaniel,REP,140058,47,49,598,694,
Cleveland,State Treasurer,Charles De Coune,IND,140058,21,28,260,309,
Cleveland,Superintendent of Public Instruction,Joy Hofmeister,REP,140058,45,40,546,631,
Cleveland,Superintendent of Public Instruction,John Cox,DEM,140058,29,33,282,344,
Cleveland,Superintendent of Public Instruction,Larry Huff,IND,140058,4,10,84,98,
Cleveland,Commissioner of Labor,Leslie Osborn,REP,140058,44,35,586,665,
Cleveland,Commissioner of Labor,Fred Dorrell,DEM,140058,29,41,263,333,
Cleveland,Commissioner of Labor,Brandt Dismukes,IND,140058,4,7,50,61,
Cleveland,Insurance Commissioner,Glen Mulready,REP,140058,44,47,578,669,
Cleveland,Insurance Commissioner,Kimberly Fobbs,DEM,140058,34,37,324,395,
Cleveland,Corporation Commissioner,Bob Anthony,REP,140058,41,41,548,630,
Cleveland,Corporation Commissioner,Ashley Nicole Mccray,DEM,140058,32,36,297,365,
Cleveland,Corporation Commissioner,Jackie Short,IND,140058,5,6,61,72,
Cleveland,U.S. House,Tom Cole,REP,140058,47,42,600,689,4
Cleveland,U.S. House,Mary Brannon,DEM,140058,30,36,266,332,4
Cleveland,U.S. House,Ruby Peters,IND,140058,2,6,47,55,4
Cleveland,State Senate,Darrell Weaver,REP,140058,45,46,601,692,24
Cleveland,State Senate,RenÉE Jerden,DEM,140058,33,38,304,375,24
Cleveland,State House,Kevin West,REP,140058,45,42,569,656,54
Cleveland,State House,Katelyn Dockery,DEM,140058,34,40,339,413,54
Cleveland,Governor,Chris Powell,LIB,140059,0,0,16,16,
Cleveland,Governor,Kevin Stitt,REP,140059,17,10,153,180,
Cleveland,Governor,Drew Edmondson,DEM,140059,27,25,236,288,
Cleveland,Lieutenant Governor,Matt Pinnell,REP,140059,18,15,178,211,
Cleveland,Lieutenant Governor,Anastasia Pittman,DEM,140059,25,20,201,246,
Cleveland,Lieutenant Governor,Ivan Holmes,IND,140059,1,0,24,25,
Cleveland,State Auditor,John Yeutter,LIB,140059,11,10,130,151,
Cleveland,State Auditor,Cindy Byrd,REP,140059,22,19,226,267,
Cleveland,Attorney General,Mike Hunter,REP,140059,21,15,185,221,
Cleveland,Attorney General,Mark Myles,DEM,140059,23,20,217,260,
Cleveland,State Treasurer,Randy Mcdaniel,REP,140059,17,14,191,222,
Cleveland,State Treasurer,Charles De Coune,IND,140059,15,16,178,209,
Cleveland,Superintendent of Public Instruction,Joy Hofmeister,REP,140059,16,16,202,234,
Cleveland,Superintendent of Public Instruction,John Cox,DEM,140059,24,19,176,219,
Cleveland,Superintendent of Public Instruction,Larry Huff,IND,140059,4,0,26,30,
Cleveland,Commissioner of Labor,Leslie Osborn,REP,140059,18,14,195,227,
Cleveland,Commissioner of Labor,Fred Dorrell,DEM,140059,25,18,179,222,
Cleveland,Commissioner of Labor,Brandt Dismukes,IND,140059,1,3,27,31,
Cleveland,Insurance Commissioner,Glen Mulready,REP,140059,16,14,188,218,
Cleveland,Insurance Commissioner,Kimberly Fobbs,DEM,140059,26,21,214,261,
Cleveland,Corporation Commissioner,Bob Anthony,REP,140059,16,13,185,214,
Cleveland,Corporation Commissioner,Ashley Nicole Mccray,DEM,140059,24,22,187,233,
Cleveland,Corporation Commissioner,Jackie Short,IND,140059,4,0,30,34,
Cleveland,U.S. House,Tom Cole,REP,140059,20,14,190,224,4
Cleveland,U.S. House,Mary Brannon,DEM,140059,24,20,196,240,4
Cleveland,U.S. House,Ruby Peters,IND,140059,0,1,17,18,4
Cleveland,State Senate,Becki Maldonado,REP,140059,17,14,168,199,16
Cleveland,State Senate,Mary Boren,DEM,140059,27,21,235,283,16
Cleveland,State House,Bryan Vinyard,REP,140059,17,12,176,205,46
Cleveland,State House,Jacob Rosecrants,DEM,140059,27,23,227,277,46
Cleveland,Governor,Chris Powell,LIB,140060,1,5,67,73,
Cleveland,Governor,Kevin Stitt,REP,140060,87,117,867,1071,
Cleveland,Governor,Drew Edmondson,DEM,140060,66,74,589,729,
Cleveland,Lieutenant Governor,Matt Pinnell,REP,140060,92,124,953,1169,
Cleveland,Lieutenant Governor,Anastasia Pittman,DEM,140060,59,66,472,597,
Cleveland,Lieutenant Governor,Ivan Holmes,IND,140060,2,6,85,93,
Cleveland,State Auditor,John Yeutter,LIB,140060,30,37,347,414,
Cleveland,State Auditor,Cindy Byrd,REP,140060,104,144,1061,1309,
Cleveland,Attorney General,Mike Hunter,REP,140060,94,127,1004,1225,
Cleveland,Attorney General,Mark Myles,DEM,140060,60,69,494,623,
Cleveland,State Treasurer,Randy Mcdaniel,REP,140060,92,132,1013,1237,
Cleveland,State Treasurer,Charles De Coune,IND,140060,42,52,394,488,
Cleveland,Superintendent of Public Instruction,Joy Hofmeister,REP,140060,89,125,925,1139,
Cleveland,Superintendent of Public Instruction,John Cox,DEM,140060,56,54,437,547,
Cleveland,Superintendent of Public Instruction,Larry Huff,IND,140060,8,17,142,167,
Cleveland,Commissioner of Labor,Leslie Osborn,REP,140060,87,125,941,1153,
Cleveland,Commissioner of Labor,Fred Dorrell,DEM,140060,57,63,438,558,
Cleveland,Commissioner of Labor,Brandt Dismukes,IND,140060,8,8,100,116,
Cleveland,Insurance Commissioner,Glen Mulready,REP,140060,90,120,988,1198,
Cleveland,Insurance Commissioner,Kimberly Fobbs,DEM,140060,62,73,507,642,
Cleveland,Corporation Commissioner,Bob Anthony,REP,140060,84,121,903,1108,
Cleveland,Corporation Commissioner,Ashley Nicole Mccray,DEM,140060,63,65,460,588,
Cleveland,Corporation Commissioner,Jackie Short,IND,140060,6,10,129,145,
Cleveland,U.S. House,Tom Cole,REP,140060,89,129,1006,1224,4
Cleveland,U.S. House,Mary Brannon,DEM,140060,60,58,433,551,4
Cleveland,U.S. House,Ruby Peters,IND,140060,4,9,74,87,4
Cleveland,State Senate,Darrell Weaver,REP,140060,87,125,998,1210,24
Cleveland,State Senate,RenÉE Jerden,DEM,140060,63,70,497,630,24
Cleveland,State House,Kevin West,REP,140060,86,120,975,1181,54
Cleveland,State House,Katelyn Dockery,DEM,140060,67,76,522,665,54
Cleveland,Governor,Chris Powell,LIB,140061,3,6,32,41,
Cleveland,Governor,Kevin Stitt,REP,140061,139,128,637,904,
Cleveland,Governor,Drew Edmondson,DEM,140061,79,77,376,532,
Cleveland,Lieutenant Governor,Matt Pinnell,REP,140061,146,135,702,983,
Cleveland,Lieutenant Governor,Anastasia Pittman,DEM,140061,66,69,303,438,
Cleveland,Lieutenant Governor,Ivan Holmes,IND,140061,6,5,34,45,
Cleveland,State Auditor,John Yeutter,LIB,140061,33,45,179,257,
Cleveland,State Auditor,Cindy Byrd,REP,140061,161,148,778,1087,
Cleveland,Attorney General,Mike Hunter,REP,140061,156,142,721,1019,
Cleveland,Attorney General,Mark Myles,DEM,140061,63,69,312,444,
Cleveland,State Treasurer,Randy Mcdaniel,REP,140061,156,140,736,1032,
Cleveland,State Treasurer,Charles De Coune,IND,140061,38,52,223,313,
Cleveland,Superintendent of Public Instruction,Joy Hofmeister,REP,140061,142,133,700,975,
Cleveland,Superintendent of Public Instruction,John Cox,DEM,140061,68,60,254,382,
Cleveland,Superintendent of Public Instruction,Larry Huff,IND,140061,8,17,76,101,
Cleveland,Commissioner of Labor,Leslie Osborn,REP,140061,149,136,708,993,
Cleveland,Commissioner of Labor,Fred Dorrell,DEM,140061,63,59,268,390,
Cleveland,Commissioner of Labor,Brandt Dismukes,IND,140061,4,9,45,58,
Cleveland,Insurance Commissioner,Glen Mulready,REP,140061,152,138,702,992,
Cleveland,Insurance Commissioner,Kimberly Fobbs,DEM,140061,63,68,319,450,
Cleveland,Corporation Commissioner,Bob Anthony,REP,140061,149,127,686,962,
Cleveland,Corporation Commissioner,Ashley Nicole Mccray,DEM,140061,60,69,283,412,
Cleveland,Corporation Commissioner,Jackie Short,IND,140061,10,11,52,73,
Cleveland,U.S. House,Tom Cole,REP,140061,159,141,714,1014,4
Cleveland,U.S. House,Mary Brannon,DEM,140061,58,63,275,396,4
Cleveland,U.S. House,Ruby Peters,IND,140061,1,5,45,51,4
Cleveland,State House,Chris Kannady,REP,140061,154,135,695,984,91
Cleveland,State House,Amanda Jeffers,DEM,140061,64,72,332,468,91
Cleveland,Governor,Chris Powell,LIB,140063,0,0,19,19,
Cleveland,Governor,Kevin Stitt,REP,140063,27,42,299,368,
Cleveland,Governor,Drew Edmondson,DEM,140063,16,34,182,232,
Cleveland,Lieutenant Governor,Matt Pinnell,REP,140063,31,42,346,419,
Cleveland,Lieutenant Governor,Anastasia Pittman,DEM,140063,13,33,133,179,
Cleveland,Lieutenant Governor,Ivan Holmes,IND,140063,0,0,17,17,
Cleveland,State Auditor,John Yeutter,LIB,140063,11,12,85,108,
Cleveland,State Auditor,Cindy Byrd,REP,140063,30,51,387,468,
Cleveland,Attorney General,Mike Hunter,REP,140063,30,42,353,425,
Cleveland,Attorney General,Mark Myles,DEM,140063,14,33,144,191,
Cleveland,State Treasurer,Randy Mcdaniel,REP,140063,33,44,364,441,
Cleveland,State Treasurer,Charles De Coune,IND,140063,9,20,107,136,
Cleveland,Superintendent of Public Instruction,Joy Hofmeister,REP,140063,27,44,313,384,
Cleveland,Superintendent of Public Instruction,John Cox,DEM,140063,14,30,137,181,
Cleveland,Superintendent of Public Instruction,Larry Huff,IND,140063,3,1,45,49,
Cleveland,Commissioner of Labor,Leslie Osborn,REP,140063,30,45,350,425,
Cleveland,Commissioner of Labor,Fred Dorrell,DEM,140063,14,29,109,152,
Cleveland,Commissioner of Labor,Brandt Dismukes,IND,140063,0,1,32,33,
Cleveland,Insurance Commissioner,Glen Mulready,REP,140063,29,41,347,417,
Cleveland,Insurance Commissioner,Kimberly Fobbs,DEM,140063,15,34,141,190,
Cleveland,Corporation Commissioner,Bob Anthony,REP,140063,28,41,327,396,
Cleveland,Corporation Commissioner,Ashley Nicole Mccray,DEM,140063,15,32,141,188,
Cleveland,Corporation Commissioner,Jackie Short,IND,140063,1,2,27,30,
Cleveland,U.S. House,Tom Cole,REP,140063,30,45,344,419,4
Cleveland,U.S. House,Mary Brannon,DEM,140063,13,30,136,179,4
Cleveland,U.S. House,Ruby Peters,IND,140063,1,1,17,19,4
Cleveland,Governor,Chris Powell,LIB,140064,3,1,43,47,
Cleveland,Governor,Kevin Stitt,REP,140064,76,36,650,762,
Cleveland,Governor,Drew Edmondson,DEM,140064,60,24,278,362,
Cleveland,Lieutenant Governor,Matt Pinnell,REP,140064,82,38,686,806,
Cleveland,Lieutenant Governor,Anastasia Pittman,DEM,140064,49,21,237,307,
Cleveland,Lieutenant Governor,Ivan Holmes,IND,140064,4,2,38,44,
Cleveland,State Auditor,John Yeutter,LIB,140064,27,11,172,210,
Cleveland,State Auditor,Cindy Byrd,REP,140064,104,41,726,871,
Cleveland,Attorney General,Mike Hunter,REP,140064,92,35,698,825,
Cleveland,Attorney General,Mark Myles,DEM,140064,45,26,261,332,
Cleveland,State Treasurer,Randy Mcdaniel,REP,140064,91,39,694,824,
Cleveland,State Treasurer,Charles De Coune,IND,140064,35,15,210,260,
Cleveland,Superintendent of Public Instruction,Joy Hofmeister,REP,140064,86,39,643,768,
Cleveland,Superintendent of Public Instruction,John Cox,DEM,140064,39,16,207,262,
Cleveland,Superintendent of Public Instruction,Larry Huff,IND,140064,11,5,111,127,
Cleveland,Commissioner of Labor,Leslie Osborn,REP,140064,86,42,657,785,
Cleveland,Commissioner of Labor,Fred Dorrell,DEM,140064,43,16,230,289,
Cleveland,Commissioner of Labor,Brandt Dismukes,IND,140064,7,3,65,75,
Cleveland,Insurance Commissioner,Glen Mulready,REP,140064,88,37,681,806,
Cleveland,Insurance Commissioner,Kimberly Fobbs,DEM,140064,50,23,274,347,
Cleveland,Corporation Commissioner,Bob Anthony,REP,140064,83,34,636,753,
Cleveland,Corporation Commissioner,Ashley Nicole Mccray,DEM,140064,42,22,244,308,
Cleveland,Corporation Commissioner,Jackie Short,IND,140064,11,4,78,93,
Cleveland,U.S. House,Tom Cole,REP,140064,89,42,699,830,4
Cleveland,U.S. House,Mary Brannon,DEM,140064,43,18,223,284,4
Cleveland,U.S. House,Ruby Peters,IND,140064,6,1,43,50,4
Cleveland,Governor,Chris Powell,LIB,140065,1,0,24,25,
Cleveland,Governor,Kevin Stitt,REP,140065,21,12,356,389,
Cleveland,Governor,Drew Edmondson,DEM,140065,9,10,218,237,
Cleveland,Lieutenant Governor,Matt Pinnell,REP,140065,21,13,380,414,
Cleveland,Lieutenant Governor,Anastasia Pittman,DEM,140065,6,7,186,199,
Cleveland,Lieutenant Governor,Ivan Holmes,IND,140065,1,2,29,32,
Cleveland,State Auditor,John Yeutter,LIB,140065,5,6,137,148,
Cleveland,State Auditor,Cindy Byrd,REP,140065,23,16,409,448,
Cleveland,Attorney General,Mike Hunter,REP,140065,21,12,398,431,
Cleveland,Attorney General,Mark Myles,DEM,140065,8,10,192,210,
Cleveland,State Treasurer,Randy Mcdaniel,REP,140065,23,17,394,434,
Cleveland,State Treasurer,Charles De Coune,IND,140065,4,5,146,155,
Cleveland,Superintendent of Public Instruction,Joy Hofmeister,REP,140065,17,12,362,391,
Cleveland,Superintendent of Public Instruction,John Cox,DEM,140065,7,8,164,179,
Cleveland,Superintendent of Public Instruction,Larry Huff,IND,140065,5,2,64,71,
Cleveland,Commissioner of Labor,Leslie Osborn,REP,140065,19,12,379,410,
Cleveland,Commissioner of Labor,Fred Dorrell,DEM,140065,6,10,180,196,
Cleveland,Commissioner of Labor,Brandt Dismukes,IND,140065,3,0,27,30,
Cleveland,Insurance Commissioner,Glen Mulready,REP,140065,22,12,376,410,
Cleveland,Insurance Commissioner,Kimberly Fobbs,DEM,140065,5,10,209,224,
Cleveland,Corporation Commissioner,Bob Anthony,REP,140065,21,12,353,386,
Cleveland,Corporation Commissioner,Ashley Nicole Mccray,DEM,140065,4,8,187,199,
Cleveland,Corporation Commissioner,Jackie Short,IND,140065,3,2,48,53,
Cleveland,U.S. House,Tom Cole,REP,140065,23,13,386,422,4
Cleveland,U.S. House,Mary Brannon,DEM,140065,5,9,183,197,4
Cleveland,U.S. House,Ruby Peters,IND,140065,2,0,25,27,4
Cleveland,Governor,Chris Powell,LIB,140067,2,0,28,30,
Cleveland,Governor,Kevin Stitt,REP,140067,22,23,313,358,
Cleveland,Governor,Drew Edmondson,DEM,140067,37,77,413,527,
Cleveland,Lieutenant Governor,Matt Pinnell,REP,140067,23,34,368,425,
Cleveland,Lieutenant Governor,Anastasia Pittman,DEM,140067,36,64,353,453,
Cleveland,Lieutenant Governor,Ivan Holmes,IND,140067,2,2,27,31,
Cleveland,State Auditor,John Yeutter,LIB,140067,22,40,214,276,
Cleveland,State Auditor,Cindy Byrd,REP,140067,30,48,446,524,
Cleveland,Attorney General,Mike Hunter,REP,140067,27,37,397,461,
Cleveland,Attorney General,Mark Myles,DEM,140067,34,62,346,442,
Cleveland,State Treasurer,Randy Mcdaniel,REP,140067,27,36,408,471,
Cleveland,State Treasurer,Charles De Coune,IND,140067,27,54,261,342,
Cleveland,Superintendent of Public Instruction,Joy Hofmeister,REP,140067,31,40,382,453,
Cleveland,Superintendent of Public Instruction,John Cox,DEM,140067,27,59,314,400,
Cleveland,Superintendent of Public Instruction,Larry Huff,IND,140067,3,1,44,48,
Cleveland,Commissioner of Labor,Leslie Osborn,REP,140067,28,39,391,458,
Cleveland,Commissioner of Labor,Fred Dorrell,DEM,140067,29,55,305,389,
Cleveland,Commissioner of Labor,Brandt Dismukes,IND,140067,3,3,35,41,
Cleveland,Insurance Commissioner,Glen Mulready,REP,140067,23,29,360,412,
Cleveland,Insurance Commissioner,Kimberly Fobbs,DEM,140067,37,69,370,476,
Cleveland,Corporation Commissioner,Bob Anthony,REP,140067,26,30,345,401,
Cleveland,Corporation Commissioner,Ashley Nicole Mccray,DEM,140067,31,64,351,446,
Cleveland,Corporation Commissioner,Jackie Short,IND,140067,3,5,38,46,
Cleveland,U.S. House,Tom Cole,REP,140067,25,32,366,423,4
Cleveland,U.S. House,Mary Brannon,DEM,140067,32,68,352,452,4
Cleveland,U.S. House,Ruby Peters,IND,140067,4,0,27,31,4
Cleveland,State Senate,Becki Maldonado,REP,140067,25,26,334,385,16
Cleveland,State Senate,Mary Boren,DEM,140067,36,73,411,520,16
Cleveland,State House,Bryan Vinyard,REP,140067,23,27,357,407,46
Cleveland,State House,Jacob Rosecrants,DEM,140067,38,73,382,493,46
Cleveland,Governor,Chris Powell,LIB,140068,0,0,37,37,
Cleveland,Governor,Kevin Stitt,REP,140068,23,15,340,378,
Cleveland,Governor,Drew Edmondson,DEM,140068,41,61,605,707,
Cleveland,Lieutenant Governor,Matt Pinnell,REP,140068,28,24,404,456,
Cleveland,Lieutenant Governor,Anastasia Pittman,DEM,140068,35,52,511,598,
Cleveland,Lieutenant Governor,Ivan Holmes,IND,140068,1,1,58,60,
Cleveland,State Auditor,John Yeutter,LIB,140068,18,27,332,377,
Cleveland,State Auditor,Cindy Byrd,REP,140068,35,35,545,615,
Cleveland,Attorney General,Mike Hunter,REP,140068,27,24,448,499,
Cleveland,Attorney General,Mark Myles,DEM,140068,37,53,519,609,
Cleveland,State Treasurer,Randy Mcdaniel,REP,140068,29,21,457,507,
Cleveland,State Treasurer,Charles De Coune,IND,140068,22,42,425,489,
Cleveland,Superintendent of Public Instruction,Joy Hofmeister,REP,140068,26,23,442,491,
Cleveland,Superintendent of Public Instruction,John Cox,DEM,140068,31,51,462,544,
Cleveland,Superintendent of Public Instruction,Larry Huff,IND,140068,5,2,69,76,
Cleveland,Commissioner of Labor,Leslie Osborn,REP,140068,29,22,417,468,
Cleveland,Commissioner of Labor,Fred Dorrell,DEM,140068,33,52,492,577,
Cleveland,Commissioner of Labor,Brandt Dismukes,IND,140068,1,2,48,51,
Cleveland,Insurance Commissioner,Glen Mulready,REP,140068,29,20,413,462,
Cleveland,Insurance Commissioner,Kimberly Fobbs,DEM,140068,34,55,546,635,
Cleveland,Corporation Commissioner,Bob Anthony,REP,140068,26,21,397,444,
Cleveland,Corporation Commissioner,Ashley Nicole Mccray,DEM,140068,35,53,505,593,
Cleveland,Corporation Commissioner,Jackie Short,IND,140068,2,2,65,69,
Cleveland,U.S. House,Tom Cole,REP,140068,27,17,428,472,4
Cleveland,U.S. House,Mary Brannon,DEM,140068,37,59,515,611,4
Cleveland,U.S. House,Ruby Peters,IND,140068,0,1,40,41,4
Cleveland,State Senate,Becki Maldonado,REP,140068,27,17,372,416,16
Cleveland,State Senate,Mary Boren,DEM,140068,36,60,607,703,16
Cleveland,State House,Bryan Vinyard,REP,140068,25,19,389,433,46
Cleveland,State House,Jacob Rosecrants,DEM,140068,38,58,584,680,46
Cleveland,Governor,Chris Powell,LIB,140069,3,4,48,55,
Cleveland,Governor,Kevin Stitt,REP,140069,39,61,718,818,
Cleveland,Governor,Drew Edmondson,DEM,140069,45,74,624,743,
Cleveland,Lieutenant Governor,Matt Pinnell,REP,140069,41,79,811,931,
Cleveland,Lieutenant Governor,Anastasia Pittman,DEM,140069,42,57,507,606,
Cleveland,Lieutenant Governor,Ivan Holmes,IND,140069,3,5,54,62,
Cleveland,State Auditor,John Yeutter,LIB,140069,23,35,338,396,
Cleveland,State Auditor,Cindy Byrd,REP,140069,52,90,916,1058,
Cleveland,Attorney General,Mike Hunter,REP,140069,46,76,853,975,
Cleveland,Attorney General,Mark Myles,DEM,140069,38,65,512,615,
Cleveland,State Treasurer,Randy Mcdaniel,REP,140069,41,85,864,990,
Cleveland,State Treasurer,Charles De Coune,IND,140069,34,40,394,468,
Cleveland,Superintendent of Public Instruction,Joy Hofmeister,REP,140069,42,84,760,886,
Cleveland,Superintendent of Public Instruction,John Cox,DEM,140069,40,55,482,577,
Cleveland,Superintendent of Public Instruction,Larry Huff,IND,140069,4,2,132,138,
Cleveland,Commissioner of Labor,Leslie Osborn,REP,140069,43,75,816,934,
Cleveland,Commissioner of Labor,Fred Dorrell,DEM,140069,38,60,466,564,
Cleveland,Commissioner of Labor,Brandt Dismukes,IND,140069,3,5,78,86,
Cleveland,Insurance Commissioner,Glen Mulready,REP,140069,42,79,826,947,
Cleveland,Insurance Commissioner,Kimberly Fobbs,DEM,140069,40,62,532,634,
Cleveland,Corporation Commissioner,Bob Anthony,REP,140069,43,76,783,902,
Cleveland,Corporation Commissioner,Ashley Nicole Mccray,DEM,140069,36,58,497,591,
Cleveland,Corporation Commissioner,Jackie Short,IND,140069,7,7,85,99,
Cleveland,U.S. House,Tom Cole,REP,140069,42,78,839,959,4
Cleveland,U.S. House,Mary Brannon,DEM,140069,41,61,485,587,4
Cleveland,U.S. House,Ruby Peters,IND,140069,4,2,56,62,4
Cleveland,State House,Chris Kannady,REP,140069,41,75,822,938,91
Cleveland,State House,Amanda Jeffers,DEM,140069,44,66,543,653,91
Cleveland,Governor,Chris Powell,LIB,140070,5,4,42,51,
Cleveland,Governor,Kevin Stitt,REP,140070,37,55,507,599,
Cleveland,Governor,Drew Edmondson,DEM,140070,37,41,462,540,
Cleveland,Lieutenant Governor,Matt Pinnell,REP,140070,47,58,582,687,
Cleveland,Lieutenant Governor,Anastasia Pittman,DEM,140070,31,38,377,446,
Cleveland,Lieutenant Governor,Ivan Holmes,IND,140070,1,4,40,45,
Cleveland,State Auditor,John Yeutter,LIB,140070,20,30,269,319,
Cleveland,State Auditor,Cindy Byrd,REP,140070,54,63,661,778,
Cleveland,Attorney General,Mike Hunter,REP,140070,51,58,612,721,
Cleveland,Attorney General,Mark Myles,DEM,140070,28,41,384,453,
Cleveland,State Treasurer,Randy Mcdaniel,REP,140070,52,57,615,724,
Cleveland,State Treasurer,Charles De Coune,IND,140070,22,37,312,371,
Cleveland,Superintendent of Public Instruction,Joy Hofmeister,REP,140070,48,56,543,647,
Cleveland,Superintendent of Public Instruction,John Cox,DEM,140070,24,37,347,408,
Cleveland,Superintendent of Public Instruction,Larry Huff,IND,140070,7,6,108,121,
Cleveland,Commissioner of Labor,Leslie Osborn,REP,140070,51,62,602,715,
Cleveland,Commissioner of Labor,Fred Dorrell,DEM,140070,24,34,322,380,
Cleveland,Commissioner of Labor,Brandt Dismukes,IND,140070,4,3,67,74,
Cleveland,Insurance Commissioner,Glen Mulready,REP,140070,42,57,585,684,
Cleveland,Insurance Commissioner,Kimberly Fobbs,DEM,140070,36,42,405,483,
Cleveland,Corporation Commissioner,Bob Anthony,REP,140070,46,57,536,639,
Cleveland,Corporation Commissioner,Ashley Nicole Mccray,DEM,140070,26,40,368,434,
Cleveland,Corporation Commissioner,Jackie Short,IND,140070,7,3,85,95,
Cleveland,U.S. House,Tom Cole,REP,140070,46,59,596,701,4
Cleveland,U.S. House,Mary Brannon,DEM,140070,24,39,345,408,4
Cleveland,U.S. House,Ruby Peters,IND,140070,8,2,62,72,4
Cleveland,State Senate,Darrell Weaver,REP,140070,47,58,602,707,24
Cleveland,State Senate,RenÉE Jerden,DEM,140070,31,41,392,464,24
Cleveland,State House,Mark Mcbride,REP,140070,47,58,572,677,53
Cleveland,State House,Leslie Bonebreak,DEM,140070,32,42,428,502,53
Cleveland,Governor,Chris Powell,LIB,140071,2,0,18,20,
Cleveland,Governor,Kevin Stitt,REP,140071,19,13,214,246,
Cleveland,Governor,Drew Edmondson,DEM,140071,38,48,300,386,
Cleveland,Lieutenant Governor,Matt Pinnell,REP,140071,25,16,248,289,
Cleveland,Lieutenant Governor,Anastasia Pittman,DEM,140071,33,44,255,332,
Cleveland,Lieutenant Governor,Ivan Holmes,IND,140071,0,1,23,24,
Cleveland,State Auditor,John Yeutter,LIB,140071,19,19,142,180,
Cleveland,State Auditor,Cindy Byrd,REP,140071,31,32,327,390,
Cleveland,Attorney General,Mike Hunter,REP,140071,23,19,254,296,
Cleveland,Attorney General,Mark Myles,DEM,140071,35,42,270,347,
Cleveland,State Treasurer,Randy Mcdaniel,REP,140071,28,21,282,331,
Cleveland,State Treasurer,Charles De Coune,IND,140071,21,30,187,238,
Cleveland,Superintendent of Public Instruction,Joy Hofmeister,REP,140071,31,24,268,323,
Cleveland,Superintendent of Public Instruction,John Cox,DEM,140071,25,37,219,281,
Cleveland,Superintendent of Public Instruction,Larry Huff,IND,140071,2,1,36,39,
Cleveland,Commissioner of Labor,Leslie Osborn,REP,140071,28,25,253,306,
Cleveland,Commissioner of Labor,Fred Dorrell,DEM,140071,30,37,240,307,
Cleveland,Commissioner of Labor,Brandt Dismukes,IND,140071,0,0,24,24,
Cleveland,Insurance Commissioner,Glen Mulready,REP,140071,25,19,249,293,
Cleveland,Insurance Commissioner,Kimberly Fobbs,DEM,140071,33,42,266,341,
Cleveland,Corporation Commissioner,Bob Anthony,REP,140071,22,24,254,300,
Cleveland,Corporation Commissioner,Ashley Nicole Mccray,DEM,140071,35,38,243,316,
Cleveland,Corporation Commissioner,Jackie Short,IND,140071,1,0,23,24,
Cleveland,U.S. House,Tom Cole,REP,140071,26,18,252,296,4
Cleveland,U.S. House,Mary Brannon,DEM,140071,32,44,252,328,4
Cleveland,U.S. House,Ruby Peters,IND,140071,0,0,18,18,4
Cleveland,State House,Bryan Vinyard,REP,140071,21,15,250,286,46
Cleveland,State House,Jacob Rosecrants,DEM,140071,37,47,274,358,46
Cleveland,Governor,Chris Powell,LIB,140072,1,4,45,50,
Cleveland,Governor,Kevin Stitt,REP,140072,66,70,732,868,
Cleveland,Governor,Drew Edmondson,DEM,140072,66,73,539,678,
Cleveland,Lieutenant Governor,Matt Pinnell,REP,140072,71,81,800,952,
Cleveland,Lieutenant Governor,Anastasia Pittman,DEM,140072,58,62,452,572,
Cleveland,Lieutenant Governor,Ivan Holmes,IND,140072,4,4,56,64,
Cleveland,State Auditor,John Yeutter,LIB,140072,39,34,270,343,
Cleveland,State Auditor,Cindy Byrd,REP,140072,86,96,918,1100,
Cleveland,Attorney General,Mike Hunter,REP,140072,75,82,860,1017,
Cleveland,Attorney General,Mark Myles,DEM,140072,60,63,443,566,
Cleveland,State Treasurer,Randy Mcdaniel,REP,140072,77,88,847,1012,
Cleveland,State Treasurer,Charles De Coune,IND,140072,48,43,335,426,
Cleveland,Superintendent of Public Instruction,Joy Hofmeister,REP,140072,70,79,801,950,
Cleveland,Superintendent of Public Instruction,John Cox,DEM,140072,53,55,395,503,
Cleveland,Superintendent of Public Instruction,Larry Huff,IND,140072,12,11,109,132,
Cleveland,Commissioner of Labor,Leslie Osborn,REP,140072,73,85,834,992,
Cleveland,Commissioner of Labor,Fred Dorrell,DEM,140072,55,54,383,492,
Cleveland,Commissioner of Labor,Brandt Dismukes,IND,140072,7,7,72,86,
Cleveland,Insurance Commissioner,Glen Mulready,REP,140072,77,84,830,991,
Cleveland,Insurance Commissioner,Kimberly Fobbs,DEM,140072,58,60,463,581,
Cleveland,Corporation Commissioner,Bob Anthony,REP,140072,74,78,776,928,
Cleveland,Corporation Commissioner,Ashley Nicole Mccray,DEM,140072,54,58,433,545,
Cleveland,Corporation Commissioner,Jackie Short,IND,140072,7,9,85,101,
Cleveland,U.S. House,Tom Cole,REP,140072,70,78,853,1001,4
Cleveland,U.S. House,Mary Brannon,DEM,140072,59,64,408,531,4
Cleveland,U.S. House,Ruby Peters,IND,140072,6,3,48,57,4
Cleveland,State Senate,Darrell Weaver,REP,140072,74,85,856,1015,24
Cleveland,State Senate,RenÉE Jerden,DEM,140072,61,59,444,564,24
Cleveland,State House,Mark Mcbride,REP,140072,69,81,799,949,53
Cleveland,State House,Leslie Bonebreak,DEM,140072,66,64,508,638,53
Cleveland,Governor,Chris Powell,LIB,140073,5,4,33,42,
Cleveland,Governor,Kevin Stitt,REP,140073,111,149,923,1183,
Cleveland,Governor,Drew Edmondson,DEM,140073,192,194,1017,1403,
Cleveland,Lieutenant Governor,Matt Pinnell,REP,140073,135,173,1109,1417,
Cleveland,Lieutenant Governor,Anastasia Pittman,DEM,140073,166,164,788,1118,
Cleveland,Lieutenant Governor,Ivan Holmes,IND,140073,3,6,51,60,
Cleveland,State Auditor,John Yeutter,LIB,140073,97,87,455,639,
Cleveland,State Auditor,Cindy Byrd,REP,140073,174,217,1324,1715,
Cleveland,Attorney General,Mike Hunter,REP,140073,144,172,1174,1490,
Cleveland,Attorney General,Mark Myles,DEM,140073,156,173,770,1099,
Cleveland,State Treasurer,Randy Mcdaniel,REP,140073,155,186,1216,1557,
Cleveland,State Treasurer,Charles De Coune,IND,140073,123,126,563,812,
Cleveland,Superintendent of Public Instruction,Joy Hofmeister,REP,140073,153,197,1153,1503,
Cleveland,Superintendent of Public Instruction,John Cox,DEM,140073,137,139,687,963,
Cleveland,Superintendent of Public Instruction,Larry Huff,IND,140073,11,9,101,121,
Cleveland,Commissioner of Labor,Leslie Osborn,REP,140073,157,184,1194,1535,
Cleveland,Commissioner of Labor,Fred Dorrell,DEM,140073,133,156,650,939,
Cleveland,Commissioner of Labor,Brandt Dismukes,IND,140073,9,5,69,83,
Cleveland,Insurance Commissioner,Glen Mulready,REP,140073,132,166,1105,1403,
Cleveland,Insurance Commissioner,Kimberly Fobbs,DEM,140073,163,175,797,1135,
Cleveland,Corporation Commissioner,Bob Anthony,REP,140073,135,175,1110,1420,
Cleveland,Corporation Commissioner,Ashley Nicole Mccray,DEM,140073,157,159,738,1054,
Cleveland,Corporation Commissioner,Jackie Short,IND,140073,8,9,77,94,
Cleveland,U.S. House,Tom Cole,REP,140073,142,173,1142,1457,4
Cleveland,U.S. House,Mary Brannon,DEM,140073,159,167,759,1085,4
Cleveland,U.S. House,Ruby Peters,IND,140073,4,6,50,60,4
Cleveland,State House,Bryan Vinyard,REP,140073,126,158,1072,1356,46
Cleveland,State House,Jacob Rosecrants,DEM,140073,179,189,884,1252,46
Cleveland,Governor,Chris Powell,LIB,140074,1,1,19,21,
Cleveland,Governor,Kevin Stitt,REP,140074,25,36,378,439,
Cleveland,Governor,Drew Edmondson,DEM,140074,48,63,360,471,
Cleveland,Lieutenant Governor,Matt Pinnell,REP,140074,32,46,442,520,
Cleveland,Lieutenant Governor,Anastasia Pittman,DEM,140074,42,51,273,366,
Cleveland,Lieutenant Governor,Ivan Holmes,IND,140074,1,3,38,42,
Cleveland,State Auditor,John Yeutter,LIB,140074,21,28,181,230,
Cleveland,State Auditor,Cindy Byrd,REP,140074,41,60,506,607,
Cleveland,Attorney General,Mike Hunter,REP,140074,32,51,479,562,
Cleveland,Attorney General,Mark Myles,DEM,140074,41,47,273,361,
Cleveland,State Treasurer,Randy Mcdaniel,REP,140074,34,49,486,569,
Cleveland,State Treasurer,Charles De Coune,IND,140074,30,40,208,278,
Cleveland,Superintendent of Public Instruction,Joy Hofmeister,REP,140074,37,50,460,547,
Cleveland,Superintendent of Public Instruction,John Cox,DEM,140074,34,45,238,317,
Cleveland,Superintendent of Public Instruction,Larry Huff,IND,140074,2,5,52,59,
Cleveland,Commissioner of Labor,Leslie Osborn,REP,140074,36,54,451,541,
Cleveland,Commissioner of Labor,Fred Dorrell,DEM,140074,36,43,245,324,
Cleveland,Commissioner of Labor,Brandt Dismukes,IND,140074,1,2,46,49,
Cleveland,Insurance Commissioner,Glen Mulready,REP,140074,32,46,441,519,
Cleveland,Insurance Commissioner,Kimberly Fobbs,DEM,140074,39,52,300,391,
Cleveland,Corporation Commissioner,Bob Anthony,REP,140074,32,51,447,530,
Cleveland,Corporation Commissioner,Ashley Nicole Mccray,DEM,140074,40,47,257,344,
Cleveland,Corporation Commissioner,Jackie Short,IND,140074,2,2,44,48,
Cleveland,U.S. House,Tom Cole,REP,140074,37,49,468,554,4
Cleveland,U.S. House,Mary Brannon,DEM,140074,38,50,256,344,4
Cleveland,U.S. House,Ruby Peters,IND,140074,0,1,28,29,4
Cleveland,State House,Bryan Vinyard,REP,140074,27,45,435,507,46
Cleveland,State House,Jacob Rosecrants,DEM,140074,48,54,315,417,46
Cleveland,Governor,Chris Powell,LIB,140076,0,4,27,31,
Cleveland,Governor,Kevin Stitt,REP,140076,19,29,265,313,
Cleveland,Governor,Drew Edmondson,DEM,140076,29,68,458,555,
Cleveland,Lieutenant Governor,Matt Pinnell,REP,140076,22,34,344,400,
Cleveland,Lieutenant Governor,Anastasia Pittman,DEM,140076,25,59,363,447,
Cleveland,Lieutenant Governor,Ivan Holmes,IND,140076,0,6,40,46,
Cleveland,State Auditor,John Yeutter,LIB,140076,14,41,247,302,
Cleveland,State Auditor,Cindy Byrd,REP,140076,27,52,426,505,
Cleveland,Attorney General,Mike Hunter,REP,140076,21,39,364,424,
Cleveland,Attorney General,Mark Myles,DEM,140076,26,61,382,469,
Cleveland,State Treasurer,Randy Mcdaniel,REP,140076,23,39,391,453,
Cleveland,State Treasurer,Charles De Coune,IND,140076,20,55,284,359,
Cleveland,Superintendent of Public Instruction,Joy Hofmeister,REP,140076,26,44,357,427,
Cleveland,Superintendent of Public Instruction,John Cox,DEM,140076,21,53,321,395,
Cleveland,Superintendent of Public Instruction,Larry Huff,IND,140076,0,3,66,69,
Cleveland,Commissioner of Labor,Leslie Osborn,REP,140076,24,40,362,426,
Cleveland,Commissioner of Labor,Fred Dorrell,DEM,140076,23,55,336,414,
Cleveland,Commissioner of Labor,Brandt Dismukes,IND,140076,0,5,40,45,
Cleveland,Insurance Commissioner,Glen Mulready,REP,140076,19,35,354,408,
Cleveland,Insurance Commissioner,Kimberly Fobbs,DEM,140076,28,64,388,480,
Cleveland,Corporation Commissioner,Bob Anthony,REP,140076,23,35,336,394,
Cleveland,Corporation Commissioner,Ashley Nicole Mccray,DEM,140076,22,63,353,438,
Cleveland,Corporation Commissioner,Jackie Short,IND,140076,2,2,51,55,
Cleveland,U.S. House,Tom Cole,REP,140076,22,37,345,404,4
Cleveland,U.S. House,Mary Brannon,DEM,140076,24,60,361,445,4
Cleveland,U.S. House,Ruby Peters,IND,140076,2,3,41,46,4
Cleveland,State House,Bryan Vinyard,REP,140076,20,34,305,359,46
Cleveland,State House,Jacob Rosecrants,DEM,140076,27,66,439,532,46
Cleveland,Governor,Chris Powell,LIB,140077,0,0,11,11,
Cleveland,Governor,Kevin Stitt,REP,140077,4,3,67,74,
Cleveland,Governor,Drew Edmondson,DEM,140077,6,10,172,188,
Cleveland,Lieutenant Governor,Matt Pinnell,REP,140077,5,3,73,81,
Cleveland,Lieutenant Governor,Anastasia Pittman,DEM,140077,5,9,153,167,
Cleveland,Lieutenant Governor,Ivan Holmes,IND,140077,0,1,21,22,
Cleveland,State Auditor,John Yeutter,LIB,140077,2,7,123,132,
Cleveland,State Auditor,Cindy Byrd,REP,140077,6,5,101,112,
Cleveland,Attorney General,Mike Hunter,REP,140077,4,5,86,95,
Cleveland,Attorney General,Mark Myles,DEM,140077,6,8,161,175,
Cleveland,State Treasurer,Randy Mcdaniel,REP,140077,5,6,92,103,
Cleveland,State Treasurer,Charles De Coune,IND,140077,3,6,136,145,
Cleveland,Superintendent of Public Instruction,Joy Hofmeister,REP,140077,5,6,80,91,
Cleveland,Superintendent of Public Instruction,John Cox,DEM,140077,4,6,149,159,
Cleveland,Superintendent of Public Instruction,Larry Huff,IND,140077,1,1,18,20,
Cleveland,Commissioner of Labor,Leslie Osborn,REP,140077,5,5,77,87,
Cleveland,Commissioner of Labor,Fred Dorrell,DEM,140077,5,6,150,161,
Cleveland,Commissioner of Labor,Brandt Dismukes,IND,140077,0,2,20,22,
Cleveland,Insurance Commissioner,Glen Mulready,REP,140077,4,5,78,87,
Cleveland,Insurance Commissioner,Kimberly Fobbs,DEM,140077,6,8,168,182,
Cleveland,Corporation Commissioner,Bob Anthony,REP,140077,4,4,81,89,
Cleveland,Corporation Commissioner,Ashley Nicole Mccray,DEM,140077,6,9,152,167,
Cleveland,Corporation Commissioner,Jackie Short,IND,140077,0,0,13,13,
Cleveland,U.S. House,Tom Cole,REP,140077,4,4,78,86,4
Cleveland,U.S. House,Mary Brannon,DEM,140077,6,8,159,173,4
Cleveland,U.S. House,Ruby Peters,IND,140077,0,1,10,11,4
Cleveland,State House,Bryan Vinyard,REP,140077,4,4,81,89,46
Cleveland,State House,Jacob Rosecrants,DEM,140077,5,9,167,181,46
Cleveland,Governor,Chris Powell,LIB,140078,2,1,52,55,
Cleveland,Governor,Kevin Stitt,REP,140078,71,36,804,911,
Cleveland,Governor,Drew Edmondson,DEM,140078,41,8,270,319,
Cleveland,Lieutenant Governor,Matt Pinnell,REP,140078,77,37,862,976,
Cleveland,Lieutenant Governor,Anastasia Pittman,DEM,140078,36,8,201,245,
Cleveland,Lieutenant Governor,Ivan Holmes,IND,140078,1,0,54,55,
Cleveland,State Auditor,John Yeutter,LIB,140078,23,7,207,237,
Cleveland,State Auditor,Cindy Byrd,REP,140078,80,35,874,989,
Cleveland,Attorney General,Mike Hunter,REP,140078,71,36,885,992,
Cleveland,Attorney General,Mark Myles,DEM,140078,41,9,225,275,
Cleveland,State Treasurer,Randy Mcdaniel,REP,140078,77,35,864,976,
Cleveland,State Treasurer,Charles De Coune,IND,140078,27,8,209,244,
Cleveland,Superintendent of Public Instruction,Joy Hofmeister,REP,140078,76,33,796,905,
Cleveland,Superintendent of Public Instruction,John Cox,DEM,140078,33,7,211,251,
Cleveland,Superintendent of Public Instruction,Larry Huff,IND,140078,4,5,101,110,
Cleveland,Commissioner of Labor,Leslie Osborn,REP,140078,76,35,843,954,
Cleveland,Commissioner of Labor,Fred Dorrell,DEM,140078,31,8,199,238,
Cleveland,Commissioner of Labor,Brandt Dismukes,IND,140078,3,2,60,65,
Cleveland,Insurance Commissioner,Glen Mulready,REP,140078,75,35,857,967,
Cleveland,Insurance Commissioner,Kimberly Fobbs,DEM,140078,36,10,245,291,
Cleveland,Corporation Commissioner,Bob Anthony,REP,140078,71,33,809,913,
Cleveland,Corporation Commissioner,Ashley Nicole Mccray,DEM,140078,35,9,224,268,
Cleveland,Corporation Commissioner,Jackie Short,IND,140078,4,3,75,82,
Cleveland,U.S. House,Tom Cole,REP,140078,77,36,872,985,4
Cleveland,U.S. House,Mary Brannon,DEM,140078,34,8,189,231,4
Cleveland,U.S. House,Ruby Peters,IND,140078,2,1,48,51,4
Cleveland,Governor,Chris Powell,LIB,140080,0,1,13,14,
Cleveland,Governor,Kevin Stitt,REP,140080,16,5,163,184,
Cleveland,Governor,Drew Edmondson,DEM,140080,5,8,86,99,
Cleveland,Lieutenant Governor,Matt Pinnell,REP,140080,17,5,173,195,
Cleveland,Lieutenant Governor,Anastasia Pittman,DEM,140080,4,9,77,90,
Cleveland,Lieutenant Governor,Ivan Holmes,IND,140080,0,0,10,10,
Cleveland,State Auditor,John Yeutter,LIB,140080,3,7,56,66,
Cleveland,State Auditor,Cindy Byrd,REP,140080,17,5,192,214,
Cleveland,Attorney General,Mike Hunter,REP,140080,18,5,189,212,
Cleveland,Attorney General,Mark Myles,DEM,140080,3,9,71,83,
Cleveland,State Treasurer,Randy Mcdaniel,REP,140080,16,6,191,213,
Cleveland,State Treasurer,Charles De Coune,IND,140080,5,7,56,68,
Cleveland,Superintendent of Public Instruction,Joy Hofmeister,REP,140080,15,8,165,188,
Cleveland,Superintendent of Public Instruction,John Cox,DEM,140080,5,5,69,79,
Cleveland,Superintendent of Public Instruction,Larry Huff,IND,140080,1,1,24,26,
Cleveland,Commissioner of Labor,Leslie Osborn,REP,140080,17,6,179,202,
Cleveland,Commissioner of Labor,Fred Dorrell,DEM,140080,4,8,66,78,
Cleveland,Commissioner of Labor,Brandt Dismukes,IND,140080,0,0,12,12,
Cleveland,Insurance Commissioner,Glen Mulready,REP,140080,15,6,180,201,
Cleveland,Insurance Commissioner,Kimberly Fobbs,DEM,140080,6,8,77,91,
Cleveland,Corporation Commissioner,Bob Anthony,REP,140080,13,8,173,194,
Cleveland,Corporation Commissioner,Ashley Nicole Mccray,DEM,140080,7,5,69,81,
Cleveland,Corporation Commissioner,Jackie Short,IND,140080,1,1,17,19,
Cleveland,U.S. House,Tom Cole,REP,140080,16,5,185,206,4
Cleveland,U.S. House,Mary Brannon,DEM,140080,3,9,65,77,4
Cleveland,U.S. House,Ruby Peters,IND,140080,2,0,10,12,4
Cleveland,State House,Kevin West,REP,140080,17,5,174,196,54
Cleveland,State House,Katelyn Dockery,DEM,140080,4,9,85,98,54
Cleveland,Governor,Chris Powell,LIB,140081,2,6,59,67,
Cleveland,Governor,Kevin Stitt,REP,140081,45,55,423,523,
Cleveland,Governor,Drew Edmondson,DEM,140081,89,153,750,992,
Cleveland,Lieutenant Governor,Matt Pinnell,REP,140081,48,73,516,637,
Cleveland,Lieutenant Governor,Anastasia Pittman,DEM,140081,84,131,655,870,
Cleveland,Lieutenant Governor,Ivan Holmes,IND,140081,3,11,50,64,
Cleveland,State Auditor,John Yeutter,LIB,140081,35,72,433,540,
Cleveland,State Auditor,Cindy Byrd,REP,140081,73,109,668,850,
Cleveland,Attorney General,Mike Hunter,REP,140081,57,76,548,681,
Cleveland,Attorney General,Mark Myles,DEM,140081,78,138,668,884,
Cleveland,State Treasurer,Randy Mcdaniel,REP,140081,57,77,561,695,
Cleveland,State Treasurer,Charles De Coune,IND,140081,52,106,544,702,
Cleveland,Superintendent of Public Instruction,Joy Hofmeister,REP,140081,60,83,558,701,
Cleveland,Superintendent of Public Instruction,John Cox,DEM,140081,69,116,562,747,
Cleveland,Superintendent of Public Instruction,Larry Huff,IND,140081,7,16,94,117,
Cleveland,Commissioner of Labor,Leslie Osborn,REP,140081,56,76,532,664,
Cleveland,Commissioner of Labor,Fred Dorrell,DEM,140081,72,128,598,798,
Cleveland,Commissioner of Labor,Brandt Dismukes,IND,140081,8,11,69,88,
Cleveland,Insurance Commissioner,Glen Mulready,REP,140081,47,67,500,614,
Cleveland,Insurance Commissioner,Kimberly Fobbs,DEM,140081,89,147,687,923,
Cleveland,Corporation Commissioner,Bob Anthony,REP,140081,54,71,489,614,
Cleveland,Corporation Commissioner,Ashley Nicole Mccray,DEM,140081,79,133,637,849,
Cleveland,Corporation Commissioner,Jackie Short,IND,140081,4,11,76,91,
Cleveland,U.S. House,Tom Cole,REP,140081,61,70,521,652,4
Cleveland,U.S. House,Mary Brannon,DEM,140081,74,135,656,865,4
Cleveland,U.S. House,Ruby Peters,IND,140081,2,10,48,60,4
Cleveland,State Senate,Becki Maldonado,REP,140081,48,66,481,595,16
Cleveland,State Senate,Mary Boren,DEM,140081,88,148,732,968,16
Cleveland,State House,Marc Etters,REP,140081,50,62,469,581,45
Cleveland,State House,Merleyn Bell,DEM,140081,79,146,639,864,45
Cleveland,State House,Tom Hackelman,IND,140081,4,7,103,114,45
Cleveland,Governor,Chris Powell,LIB,140082,3,9,44,56,
Cleveland,Governor,Kevin Stitt,REP,140082,58,92,503,653,
Cleveland,Governor,Drew Edmondson,DEM,140082,97,210,766,1073,
Cleveland,Lieutenant Governor,Matt Pinnell,REP,140082,63,119,597,779,
Cleveland,Lieutenant Governor,Anastasia Pittman,DEM,140082,90,185,658,933,
Cleveland,Lieutenant Governor,Ivan Holmes,IND,140082,5,7,46,58,
Cleveland,State Auditor,John Yeutter,LIB,140082,43,96,399,538,
Cleveland,State Auditor,Cindy Byrd,REP,140082,92,171,765,1028,
Cleveland,Attorney General,Mike Hunter,REP,140082,69,126,623,818,
Cleveland,Attorney General,Mark Myles,DEM,140082,85,180,661,926,
Cleveland,State Treasurer,Randy Mcdaniel,REP,140082,79,142,642,863,
Cleveland,State Treasurer,Charles De Coune,IND,140082,58,127,516,701,
Cleveland,Superintendent of Public Instruction,Joy Hofmeister,REP,140082,79,134,680,893,
Cleveland,Superintendent of Public Instruction,John Cox,DEM,140082,69,163,513,745,
Cleveland,Superintendent of Public Instruction,Larry Huff,IND,140082,7,13,107,127,
Cleveland,Commissioner of Labor,Leslie Osborn,REP,140082,72,131,649,852,
Cleveland,Commissioner of Labor,Fred Dorrell,DEM,140082,73,168,562,803,
Cleveland,Commissioner of Labor,Brandt Dismukes,IND,140082,7,9,66,82,
Cleveland,Insurance Commissioner,Glen Mulready,REP,140082,67,118,613,798,
Cleveland,Insurance Commissioner,Kimberly Fobbs,DEM,140082,86,189,658,933,
Cleveland,Corporation Commissioner,Bob Anthony,REP,140082,62,127,578,767,
Cleveland,Corporation Commissioner,Ashley Nicole Mccray,DEM,140082,83,166,618,867,
Cleveland,Corporation Commissioner,Jackie Short,IND,140082,9,15,84,108,
Cleveland,U.S. House,Tom Cole,REP,140082,67,122,612,801,4
Cleveland,U.S. House,Mary Brannon,DEM,140082,85,176,624,885,4
Cleveland,U.S. House,Ruby Peters,IND,140082,5,12,61,78,4
Cleveland,State Senate,Becki Maldonado,REP,140082,62,106,561,729,16
Cleveland,State Senate,Mary Boren,DEM,140082,94,204,739,1037,16
Cleveland,State House,Marc Etters,REP,140082,65,102,575,742,45
Cleveland,State House,Merleyn Bell,DEM,140082,85,189,626,900,45
Cleveland,State House,Tom Hackelman,IND,140082,5,17,93,115,45
Cleveland,Governor,Chris Powell,LIB,140083,0,0,4,4,
Cleveland,Governor,Kevin Stitt,REP,140083,11,13,163,187,
Cleveland,Governor,Drew Edmondson,DEM,140083,10,8,177,195,
Cleveland,Lieutenant Governor,Matt Pinnell,REP,140083,11,15,196,222,
Cleveland,Lieutenant Governor,Anastasia Pittman,DEM,140083,9,6,129,144,
Cleveland,Lieutenant Governor,Ivan Holmes,IND,140083,0,0,14,14,
Cleveland,State Auditor,John Yeutter,LIB,140083,2,3,78,83,
Cleveland,State Auditor,Cindy Byrd,REP,140083,17,17,226,260,
Cleveland,Attorney General,Mike Hunter,REP,140083,11,16,210,237,
Cleveland,Attorney General,Mark Myles,DEM,140083,9,5,128,142,
Cleveland,State Treasurer,Randy Mcdaniel,REP,140083,13,14,207,234,
Cleveland,State Treasurer,Charles De Coune,IND,140083,5,6,94,105,
Cleveland,Superintendent of Public Instruction,Joy Hofmeister,REP,140083,14,15,207,236,
Cleveland,Superintendent of Public Instruction,John Cox,DEM,140083,6,6,114,126,
Cleveland,Superintendent of Public Instruction,Larry Huff,IND,140083,0,0,22,22,
Cleveland,Commissioner of Labor,Leslie Osborn,REP,140083,12,15,207,234,
Cleveland,Commissioner of Labor,Fred Dorrell,DEM,140083,8,6,115,129,
Cleveland,Commissioner of Labor,Brandt Dismukes,IND,140083,0,0,12,12,
Cleveland,Insurance Commissioner,Glen Mulready,REP,140083,10,14,204,228,
Cleveland,Insurance Commissioner,Kimberly Fobbs,DEM,140083,10,7,133,150,
Cleveland,Corporation Commissioner,Bob Anthony,REP,140083,15,14,201,230,
Cleveland,Corporation Commissioner,Ashley Nicole Mccray,DEM,140083,5,5,121,131,
Cleveland,Corporation Commissioner,Jackie Short,IND,140083,1,2,16,19,
Cleveland,U.S. House,Tom Cole,REP,140083,12,13,201,226,4
Cleveland,U.S. House,Mary Brannon,DEM,140083,8,7,129,144,4
Cleveland,U.S. House,Ruby Peters,IND,140083,1,1,8,10,4
Cleveland,State Senate,Becki Maldonado,REP,140083,10,13,183,206,16
Cleveland,State Senate,Mary Boren,DEM,140083,10,8,157,175,16
Cleveland,State House,Sherrie Conley,REP,140083,13,15,217,245,20
Cleveland,State House,Steve Jarman,DEM,140083,6,6,120,132,20
Cleveland,Governor,Chris Powell,LIB,140086,7,8,41,56,
Cleveland,Governor,Kevin Stitt,REP,140086,49,141,597,787,
Cleveland,Governor,Drew Edmondson,DEM,140086,50,96,419,565,
Cleveland,Lieutenant Governor,Matt Pinnell,REP,140086,65,162,681,908,
Cleveland,Lieutenant Governor,Anastasia Pittman,DEM,140086,36,77,331,444,
Cleveland,Lieutenant Governor,Ivan Holmes,IND,140086,5,6,38,49,
Cleveland,State Auditor,John Yeutter,LIB,140086,26,49,230,305,
Cleveland,State Auditor,Cindy Byrd,REP,140086,74,175,748,997,
Cleveland,Attorney General,Mike Hunter,REP,140086,63,168,703,934,
Cleveland,Attorney General,Mark Myles,DEM,140086,41,76,342,459,
Cleveland,State Treasurer,Randy Mcdaniel,REP,140086,67,168,712,947,
Cleveland,State Treasurer,Charles De Coune,IND,140086,29,58,264,351,
Cleveland,Superintendent of Public Instruction,Joy Hofmeister,REP,140086,62,159,652,873,
Cleveland,Superintendent of Public Instruction,John Cox,DEM,140086,30,68,322,420,
Cleveland,Superintendent of Public Instruction,Larry Huff,IND,140086,12,16,74,102,
Cleveland,Commissioner of Labor,Leslie Osborn,REP,140086,65,161,684,910,
Cleveland,Commissioner of Labor,Fred Dorrell,DEM,140086,30,72,303,405,
Cleveland,Commissioner of Labor,Brandt Dismukes,IND,140086,8,6,51,65,
Cleveland,Insurance Commissioner,Glen Mulready,REP,140086,58,161,666,885,
Cleveland,Insurance Commissioner,Kimberly Fobbs,DEM,140086,45,82,377,504,
Cleveland,Corporation Commissioner,Bob Anthony,REP,140086,64,160,634,858,
Cleveland,Corporation Commissioner,Ashley Nicole Mccray,DEM,140086,31,74,342,447,
Cleveland,Corporation Commissioner,Jackie Short,IND,140086,9,8,71,88,
Cleveland,U.S. House,Tom Cole,REP,140086,69,167,698,934,4
Cleveland,U.S. House,Mary Brannon,DEM,140086,34,72,315,421,4
Cleveland,U.S. House,Ruby Peters,IND,140086,3,6,41,50,4
Cleveland,State Senate,Darrell Weaver,REP,140086,65,163,685,913,24
Cleveland,State Senate,RenÉE Jerden,DEM,140086,40,78,357,475,24
Cleveland,State House,Chris Kannady,REP,140086,67,155,665,887,91
Cleveland,State House,Amanda Jeffers,DEM,140086,40,86,379,505,91
Cleveland,Governor,Chris Powell,LIB,140087,0,0,17,17,
Cleveland,Governor,Kevin Stitt,REP,140087,25,16,341,382,
Cleveland,Governor,Drew Edmondson,DEM,140087,17,6,187,210,
Cleveland,Lieutenant Governor,Matt Pinnell,REP,140087,25,17,375,417,
Cleveland,Lieutenant Governor,Anastasia Pittman,DEM,140087,15,5,154,174,
Cleveland,Lieutenant Governor,Ivan Holmes,IND,140087,2,0,17,19,
Cleveland,State Auditor,John Yeutter,LIB,140087,9,5,113,127,
Cleveland,State Auditor,Cindy Byrd,REP,140087,30,16,402,448,
Cleveland,Attorney General,Mike Hunter,REP,140087,26,16,382,424,
Cleveland,Attorney General,Mark Myles,DEM,140087,16,6,159,181,
Cleveland,State Treasurer,Randy Mcdaniel,REP,140087,25,17,388,430,
Cleveland,State Treasurer,Charles De Coune,IND,140087,15,4,126,145,
Cleveland,Superintendent of Public Instruction,Joy Hofmeister,REP,140087,26,16,355,397,
Cleveland,Superintendent of Public Instruction,John Cox,DEM,140087,9,5,150,164,
Cleveland,Superintendent of Public Instruction,Larry Huff,IND,140087,7,1,38,46,
Cleveland,Commissioner of Labor,Leslie Osborn,REP,140087,26,14,371,411,
Cleveland,Commissioner of Labor,Fred Dorrell,DEM,140087,12,6,144,162,
Cleveland,Commissioner of Labor,Brandt Dismukes,IND,140087,4,2,23,29,
Cleveland,Insurance Commissioner,Glen Mulready,REP,140087,26,16,371,413,
Cleveland,Insurance Commissioner,Kimberly Fobbs,DEM,140087,14,6,170,190,
Cleveland,Corporation Commissioner,Bob Anthony,REP,140087,26,14,349,389,
Cleveland,Corporation Commissioner,Ashley Nicole Mccray,DEM,140087,13,6,161,180,
Cleveland,Corporation Commissioner,Jackie Short,IND,140087,3,2,30,35,
Cleveland,U.S. House,Tom Cole,REP,140087,30,15,375,420,4
Cleveland,U.S. House,Mary Brannon,DEM,140087,12,6,145,163,4
Cleveland,U.S. House,Ruby Peters,IND,140087,0,1,23,24,4
Cleveland,Governor,Chris Powell,LIB,140088,5,5,34,44,
Cleveland,Governor,Kevin Stitt,REP,140088,77,171,786,1034,
Cleveland,Governor,Drew Edmondson,DEM,140088,77,125,490,692,
Cleveland,Lieutenant Governor,Matt Pinnell,REP,140088,89,198,886,1173,
Cleveland,Lieutenant Governor,Anastasia Pittman,DEM,140088,64,92,373,529,
Cleveland,Lieutenant Governor,Ivan Holmes,IND,140088,5,5,43,53,
Cleveland,State Auditor,John Yeutter,LIB,140088,28,56,239,323,
Cleveland,State Auditor,Cindy Byrd,REP,140088,106,216,976,1298,
Cleveland,Attorney General,Mike Hunter,REP,140088,92,197,930,1219,
Cleveland,Attorney General,Mark Myles,DEM,140088,64,103,367,534,
Cleveland,State Treasurer,Randy Mcdaniel,REP,140088,94,205,933,1232,
Cleveland,State Treasurer,Charles De Coune,IND,140088,41,68,281,390,
Cleveland,Superintendent of Public Instruction,Joy Hofmeister,REP,140088,87,176,845,1108,
Cleveland,Superintendent of Public Instruction,John Cox,DEM,140088,58,102,357,517,
Cleveland,Superintendent of Public Instruction,Larry Huff,IND,140088,12,21,96,129,
Cleveland,Commissioner of Labor,Leslie Osborn,REP,140088,93,200,893,1186,
Cleveland,Commissioner of Labor,Fred Dorrell,DEM,140088,55,87,328,470,
Cleveland,Commissioner of Labor,Brandt Dismukes,IND,140088,8,6,64,78,
Cleveland,Insurance Commissioner,Glen Mulready,REP,140088,91,192,877,1160,
Cleveland,Insurance Commissioner,Kimberly Fobbs,DEM,140088,63,102,403,568,
Cleveland,Corporation Commissioner,Bob Anthony,REP,140088,91,178,840,1109,
Cleveland,Corporation Commissioner,Ashley Nicole Mccray,DEM,140088,53,105,374,532,
Cleveland,Corporation Commissioner,Jackie Short,IND,140088,12,14,73,99,
Cleveland,U.S. House,Tom Cole,REP,140088,94,191,908,1193,4
Cleveland,U.S. House,Mary Brannon,DEM,140088,57,102,347,506,4
Cleveland,U.S. House,Ruby Peters,IND,140088,8,7,41,56,4
Cleveland,State Senate,Darrell Weaver,REP,140088,91,192,892,1175,24
Cleveland,State Senate,RenÉE Jerden,DEM,140088,65,105,395,565,24
Cleveland,State House,Chris Kannady,REP,140088,89,194,852,1135,91
Cleveland,State House,Amanda Jeffers,DEM,140088,69,105,447,621,91
Cleveland,Governor,Chris Powell,LIB,140089,6,5,54,65,
Cleveland,Governor,Kevin Stitt,REP,140089,81,139,683,903,
Cleveland,Governor,Drew Edmondson,DEM,140089,98,111,633,842,
Cleveland,Lieutenant Governor,Matt Pinnell,REP,140089,106,151,793,1050,
Cleveland,Lieutenant Governor,Anastasia Pittman,DEM,140089,74,101,527,702,
Cleveland,Lieutenant Governor,Ivan Holmes,IND,140089,5,2,44,51,
Cleveland,State Auditor,John Yeutter,LIB,140089,35,50,337,422,
Cleveland,State Auditor,Cindy Byrd,REP,140089,130,188,901,1219,
Cleveland,Attorney General,Mike Hunter,REP,140089,105,163,834,1102,
Cleveland,Attorney General,Mark Myles,DEM,140089,78,90,514,682,
Cleveland,State Treasurer,Randy Mcdaniel,REP,140089,116,172,849,1137,
Cleveland,State Treasurer,Charles De Coune,IND,140089,52,67,391,510,
Cleveland,Superintendent of Public Instruction,Joy Hofmeister,REP,140089,103,168,769,1040,
Cleveland,Superintendent of Public Instruction,John Cox,DEM,140089,63,74,489,626,
Cleveland,Superintendent of Public Instruction,Larry Huff,IND,140089,19,12,95,126,
Cleveland,Commissioner of Labor,Leslie Osborn,REP,140089,109,161,835,1105,
Cleveland,Commissioner of Labor,Fred Dorrell,DEM,140089,62,87,442,591,
Cleveland,Commissioner of Labor,Brandt Dismukes,IND,140089,12,5,67,84,
Cleveland,Insurance Commissioner,Glen Mulready,REP,140089,105,161,785,1051,
Cleveland,Insurance Commissioner,Kimberly Fobbs,DEM,140089,73,92,546,711,
Cleveland,Corporation Commissioner,Bob Anthony,REP,140089,98,156,731,985,
Cleveland,Corporation Commissioner,Ashley Nicole Mccray,DEM,140089,71,88,513,672,
Cleveland,Corporation Commissioner,Jackie Short,IND,140089,11,9,89,109,
Cleveland,U.S. House,Tom Cole,REP,140089,114,156,799,1069,4
Cleveland,U.S. House,Mary Brannon,DEM,140089,63,92,514,669,4
Cleveland,U.S. House,Ruby Peters,IND,140089,9,6,45,60,4
Cleveland,State Senate,Darrell Weaver,REP,140089,115,160,835,1110,24
Cleveland,State Senate,RenÉE Jerden,DEM,140089,69,92,516,677,24
Cleveland,State House,Mark Mcbride,REP,140089,97,150,773,1020,53
Cleveland,State House,Leslie Bonebreak,DEM,140089,87,102,584,773,53
Cleveland,Governor,Chris Powell,LIB,140090,0,0,0,0,
Cleveland,Governor,Kevin Stitt,REP,140090,0,1,0,1,
Cleveland,Governor,Drew Edmondson,DEM,140090,0,0,0,0,
Cleveland,Lieutenant Governor,Matt Pinnell,REP,140090,0,1,0,1,
Cleveland,Lieutenant Governor,Anastasia Pittman,DEM,140090,0,0,0,0,
Cleveland,Lieutenant Governor,Ivan Holmes,IND,140090,0,0,0,0,
Cleveland,State Auditor,John Yeutter,LIB,140090,0,0,0,0,
Cleveland,State Auditor,Cindy Byrd,REP,140090,0,1,0,1,
Cleveland,Attorney General,Mike Hunter,REP,140090,0,1,0,1,
Cleveland,Attorney General,Mark Myles,DEM,140090,0,0,0,0,
Cleveland,State Treasurer,Randy Mcdaniel,REP,140090,0,1,0,1,
Cleveland,State Treasurer,Charles De Coune,IND,140090,0,0,0,0,
Cleveland,Superintendent of Public Instruction,Joy Hofmeister,REP,140090,0,1,0,1,
Cleveland,Superintendent of Public Instruction,John Cox,DEM,140090,0,0,0,0,
Cleveland,Superintendent of Public Instruction,Larry Huff,IND,140090,0,0,0,0,
Cleveland,Commissioner of Labor,Leslie Osborn,REP,140090,0,1,0,1,
Cleveland,Commissioner of Labor,Fred Dorrell,DEM,140090,0,0,0,0,
Cleveland,Commissioner of Labor,Brandt Dismukes,IND,140090,0,0,0,0,
Cleveland,Insurance Commissioner,Glen Mulready,REP,140090,0,1,0,1,
Cleveland,Insurance Commissioner,Kimberly Fobbs,DEM,140090,0,0,0,0,
Cleveland,Corporation Commissioner,Bob Anthony,REP,140090,0,1,0,1,
Cleveland,Corporation Commissioner,Ashley Nicole Mccray,DEM,140090,0,0,0,0,
Cleveland,Corporation Commissioner,Jackie Short,IND,140090,0,0,0,0,
Cleveland,U.S. House,Tom Cole,REP,140090,0,1,0,1,4
Cleveland,U.S. House,Mary Brannon,DEM,140090,0,0,0,0,4
Cleveland,U.S. House,Ruby Peters,IND,140090,0,0,0,0,4
Cleveland,State House,Kevin West,REP,140090,0,1,0,1,54
Cleveland,State House,Katelyn Dockery,DEM,140090,0,0,0,0,54
Cleveland,Governor,Chris Powell,LIB,140091,1,1,1,3,
Cleveland,Governor,Kevin Stitt,REP,140091,17,16,55,88,
Cleveland,Governor,Drew Edmondson,DEM,140091,8,18,49,75,
Cleveland,Lieutenant Governor,Matt Pinnell,REP,140091,20,20,63,103,
Cleveland,Lieutenant Governor,Anastasia Pittman,DEM,140091,6,15,38,59,
Cleveland,Lieutenant Governor,Ivan Holmes,IND,140091,0,0,4,4,
Cleveland,State Auditor,John Yeutter,LIB,140091,2,10,22,34,
Cleveland,State Auditor,Cindy Byrd,REP,140091,21,19,73,113,
Cleveland,Attorney General,Mike Hunter,REP,140091,16,20,70,106,
Cleveland,Attorney General,Mark Myles,DEM,140091,10,15,35,60,
Cleveland,State Treasurer,Randy Mcdaniel,REP,140091,21,20,71,112,
Cleveland,State Treasurer,Charles De Coune,IND,140091,2,9,26,37,
Cleveland,Superintendent of Public Instruction,Joy Hofmeister,REP,140091,19,19,64,102,
Cleveland,Superintendent of Public Instruction,John Cox,DEM,140091,5,16,34,55,
Cleveland,Superintendent of Public Instruction,Larry Huff,IND,140091,1,0,7,8,
Cleveland,Commissioner of Labor,Leslie Osborn,REP,140091,21,18,69,108,
Cleveland,Commissioner of Labor,Fred Dorrell,DEM,140091,4,13,34,51,
Cleveland,Commissioner of Labor,Brandt Dismukes,IND,140091,1,2,1,4,
Cleveland,Insurance Commissioner,Glen Mulready,REP,140091,18,19,65,102,
Cleveland,Insurance Commissioner,Kimberly Fobbs,DEM,140091,8,15,39,62,
Cleveland,Corporation Commissioner,Bob Anthony,REP,140091,18,19,62,99,
Cleveland,Corporation Commissioner,Ashley Nicole Mccray,DEM,140091,8,14,37,59,
Cleveland,Corporation Commissioner,Jackie Short,IND,140091,0,1,4,5,
Cleveland,U.S. House,Tom Cole,REP,140091,16,19,67,102,4
Cleveland,U.S. House,Mary Brannon,DEM,140091,8,15,36,59,4
Cleveland,U.S. House,Ruby Peters,IND,140091,2,0,2,4,4
Cleveland,State House,Bryan Vinyard,REP,140091,20,19,68,107,46
Cleveland,State House,Jacob Rosecrants,DEM,140091,6,15,36,57,46
Cleveland,Governor,Chris Powell,LIB,140092,0,0,0,0,
Cleveland,Governor,Kevin Stitt,REP,140092,0,0,2,2,
Cleveland,Governor,Drew Edmondson,DEM,140092,0,0,4,4,
Cleveland,Lieutenant Governor,Matt Pinnell,REP,140092,0,0,2,2,
Cleveland,Lieutenant Governor,Anastasia Pittman,DEM,140092,0,0,3,3,
Cleveland,Lieutenant Governor,Ivan Holmes,IND,140092,0,0,1,1,
Cleveland,State Auditor,John Yeutter,LIB,140092,0,0,4,4,
Cleveland,State Auditor,Cindy Byrd,REP,140092,0,0,2,2,
Cleveland,Attorney General,Mike Hunter,REP,140092,0,0,2,2,
Cleveland,Attorney General,Mark Myles,DEM,140092,0,0,4,4,
Cleveland,State Treasurer,Randy Mcdaniel,REP,140092,0,0,2,2,
Cleveland,State Treasurer,Charles De Coune,IND,140092,0,0,4,4,
Cleveland,Superintendent of Public Instruction,Joy Hofmeister,REP,140092,0,0,2,2,
Cleveland,Superintendent of Public Instruction,John Cox,DEM,140092,0,0,4,4,
Cleveland,Superintendent of Public Instruction,Larry Huff,IND,140092,0,0,0,0,
Cleveland,Commissioner of Labor,Leslie Osborn,REP,140092,0,0,3,3,
Cleveland,Commissioner of Labor,Fred Dorrell,DEM,140092,0,0,3,3,
Cleveland,Commissioner of Labor,Brandt Dismukes,IND,140092,0,0,0,0,
Cleveland,Insurance Commissioner,Glen Mulready,REP,140092,0,0,2,2,
Cleveland,Insurance Commissioner,Kimberly Fobbs,DEM,140092,0,0,4,4,
Cleveland,Corporation Commissioner,Bob Anthony,REP,140092,0,0,3,3,
Cleveland,Corporation Commissioner,Ashley Nicole Mccray,DEM,140092,0,0,3,3,
Cleveland,Corporation Commissioner,Jackie Short,IND,140092,0,0,0,0,
Cleveland,U.S. House,Tom Cole,REP,140092,0,0,2,2,4
Cleveland,U.S. House,Mary Brannon,DEM,140092,0,0,4,4,4
Cleveland,U.S. House,Ruby Peters,IND,140092,0,0,0,0,4
Cleveland,State Senate,Becki Maldonado,REP,140092,0,0,2,2,16
Cleveland,State Senate,Mary Boren,DEM,140092,0,0,4,4,16
Cleveland,State House,Bryan Vinyard,REP,140092,0,0,2,2,46
Cleveland,State House,Jacob Rosecrants,DEM,140092,0,0,4,4,46
Cleveland,Governor,Chris Powell,LIB,140093,1,1,16,18,
Cleveland,Governor,Kevin Stitt,REP,140093,7,9,101,117,
Cleveland,Governor,Drew Edmondson,DEM,140093,31,53,311,395,
Cleveland,Lieutenant Governor,Matt Pinnell,REP,140093,8,10,148,166,
Cleveland,Lieutenant Governor,Anastasia Pittman,DEM,140093,28,50,262,340,
Cleveland,Lieutenant Governor,Ivan Holmes,IND,140093,3,2,13,18,
Cleveland,State Auditor,John Yeutter,LIB,140093,12,25,145,182,
Cleveland,State Auditor,Cindy Byrd,REP,140093,16,26,218,260,
Cleveland,Attorney General,Mike Hunter,REP,140093,10,11,159,180,
Cleveland,Attorney General,Mark Myles,DEM,140093,29,51,261,341,
Cleveland,State Treasurer,Randy Mcdaniel,REP,140093,13,15,174,202,
Cleveland,State Treasurer,Charles De Coune,IND,140093,16,35,195,246,
Cleveland,Superintendent of Public Instruction,Joy Hofmeister,REP,140093,14,17,161,192,
Cleveland,Superintendent of Public Instruction,John Cox,DEM,140093,23,44,231,298,
Cleveland,Superintendent of Public Instruction,Larry Huff,IND,140093,1,1,29,31,
Cleveland,Commissioner of Labor,Leslie Osborn,REP,140093,12,20,167,199,
Cleveland,Commissioner of Labor,Fred Dorrell,DEM,140093,25,42,229,296,
Cleveland,Commissioner of Labor,Brandt Dismukes,IND,140093,1,0,20,21,
Cleveland,Insurance Commissioner,Glen Mulready,REP,140093,9,12,147,168,
Cleveland,Insurance Commissioner,Kimberly Fobbs,DEM,140093,30,50,262,342,
Cleveland,Corporation Commissioner,Bob Anthony,REP,140093,12,14,143,169,
Cleveland,Corporation Commissioner,Ashley Nicole Mccray,DEM,140093,26,46,253,325,
Cleveland,Corporation Commissioner,Jackie Short,IND,140093,1,2,20,23,
Cleveland,U.S. House,Tom Cole,REP,140093,12,14,154,180,4
Cleveland,U.S. House,Mary Brannon,DEM,140093,27,49,258,334,4
Cleveland,U.S. House,Ruby Peters,IND,140093,0,0,12,12,4
Cleveland,State Senate,Becki Maldonado,REP,140093,9,10,128,147,16
Cleveland,State Senate,Mary Boren,DEM,140093,30,53,289,372,16
Cleveland,State House,Bryan Vinyard,REP,140093,8,9,137,154,46
Cleveland,State House,Jacob Rosecrants,DEM,140093,31,54,284,369,46
Cleveland,Governor,Chris Powell,LIB,140094,0,0,10,10,
Cleveland,Governor,Kevin Stitt,REP,140094,14,16,93,123,
Cleveland,Governor,Drew Edmondson,DEM,140094,17,11,116,144,
Cleveland,Lieutenant Governor,Matt Pinnell,REP,140094,13,16,119,148,
Cleveland,Lieutenant Governor,Anastasia Pittman,DEM,140094,16,10,85,111,
Cleveland,Lieutenant Governor,Ivan Holmes,IND,140094,1,1,14,16,
Cleveland,State Auditor,John Yeutter,LIB,140094,9,3,63,75,
Cleveland,State Auditor,Cindy Byrd,REP,140094,18,19,139,176,
Cleveland,Attorney General,Mike Hunter,REP,140094,14,15,125,154,
Cleveland,Attorney General,Mark Myles,DEM,140094,17,12,93,122,
Cleveland,State Treasurer,Randy Mcdaniel,REP,140094,17,15,122,154,
Cleveland,State Treasurer,Charles De Coune,IND,140094,10,8,83,101,
Cleveland,Superintendent of Public Instruction,Joy Hofmeister,REP,140094,13,16,115,144,
Cleveland,Superintendent of Public Instruction,John Cox,DEM,140094,14,9,84,107,
Cleveland,Superintendent of Public Instruction,Larry Huff,IND,140094,4,2,17,23,
Cleveland,Commissioner of Labor,Leslie Osborn,REP,140094,15,18,118,151,
Cleveland,Commissioner of Labor,Fred Dorrell,DEM,140094,16,9,86,111,
Cleveland,Commissioner of Labor,Brandt Dismukes,IND,140094,0,0,13,13,
Cleveland,Insurance Commissioner,Glen Mulready,REP,140094,13,16,117,146,
Cleveland,Insurance Commissioner,Kimberly Fobbs,DEM,140094,17,11,100,128,
Cleveland,Corporation Commissioner,Bob Anthony,REP,140094,13,14,115,142,
Cleveland,Corporation Commissioner,Ashley Nicole Mccray,DEM,140094,16,10,96,122,
Cleveland,Corporation Commissioner,Jackie Short,IND,140094,2,3,5,10,
Cleveland,U.S. House,Tom Cole,REP,140094,14,16,124,154,4
Cleveland,U.S. House,Mary Brannon,DEM,140094,16,10,89,115,4
Cleveland,U.S. House,Ruby Peters,IND,140094,1,1,6,8,4
Cleveland,State House,Marc Etters,REP,140094,12,15,108,135,45
Cleveland,State House,Merleyn Bell,DEM,140094,17,10,93,120,45
Cleveland,State House,Tom Hackelman,IND,140094,2,2,17,21,45
Cleveland,Governor,Chris Powell,LIB,140095,0,0,19,19,
Cleveland,Governor,Kevin Stitt,REP,140095,8,6,247,261,
Cleveland,Governor,Drew Edmondson,DEM,140095,10,6,115,131,
Cleveland,Lieutenant Governor,Matt Pinnell,REP,140095,11,7,262,280,
Cleveland,Lieutenant Governor,Anastasia Pittman,DEM,140095,7,5,103,115,
Cleveland,Lieutenant Governor,Ivan Holmes,IND,140095,1,0,16,17,
Cleveland,State Auditor,John Yeutter,LIB,140095,2,2,67,71,
Cleveland,State Auditor,Cindy Byrd,REP,140095,17,8,293,318,
Cleveland,Attorney General,Mike Hunter,REP,140095,11,7,272,290,
Cleveland,Attorney General,Mark Myles,DEM,140095,7,5,108,120,
Cleveland,State Treasurer,Randy Mcdaniel,REP,140095,13,8,277,298,
Cleveland,State Treasurer,Charles De Coune,IND,140095,6,2,80,88,
Cleveland,Superintendent of Public Instruction,Joy Hofmeister,REP,140095,14,8,250,272,
Cleveland,Superintendent of Public Instruction,John Cox,DEM,140095,4,4,96,104,
Cleveland,Superintendent of Public Instruction,Larry Huff,IND,140095,0,0,35,35,
Cleveland,Commissioner of Labor,Leslie Osborn,REP,140095,14,6,271,291,
Cleveland,Commissioner of Labor,Fred Dorrell,DEM,140095,5,5,90,100,
Cleveland,Commissioner of Labor,Brandt Dismukes,IND,140095,0,0,19,19,
Cleveland,Insurance Commissioner,Glen Mulready,REP,140095,10,8,260,278,
Cleveland,Insurance Commissioner,Kimberly Fobbs,DEM,140095,9,4,120,133,
Cleveland,Corporation Commissioner,Bob Anthony,REP,140095,13,8,259,280,
Cleveland,Corporation Commissioner,Ashley Nicole Mccray,DEM,140095,6,4,103,113,
Cleveland,Corporation Commissioner,Jackie Short,IND,140095,0,0,18,18,
Cleveland,U.S. House,Tom Cole,REP,140095,14,6,267,287,4
Cleveland,U.S. House,Mary Brannon,DEM,140095,4,5,100,109,4
Cleveland,U.S. House,Ruby Peters,IND,140095,1,1,14,16,4
Cleveland,State House,Sherrie Conley,REP,140095,10,6,284,300,20
Cleveland,State House,Steve Jarman,DEM,140095,8,5,98,111,20
Coal,Governor,Chris Powell,LIB,150002,0,1,4,5,
Coal,Governor,Kevin Stitt,REP,150002,1,13,159,173,
Coal,Governor,Drew Edmondson,DEM,150002,3,4,102,109,
Coal,Lieutenant Governor,Matt Pinnell,REP,150002,1,16,178,195,
Coal,Lieutenant Governor,Anastasia Pittman,DEM,150002,2,1,78,81,
Coal,Lieutenant Governor,Ivan Holmes,IND,150002,1,0,9,10,
Coal,State Auditor,John Yeutter,LIB,150002,1,2,41,44,
Coal,State Auditor,Cindy Byrd,REP,150002,1,15,213,229,
Coal,Attorney General,Mike Hunter,REP,150002,1,16,184,201,
Coal,Attorney General,Mark Myles,DEM,150002,3,1,78,82,
Coal,State Treasurer,Randy Mcdaniel,REP,150002,1,18,206,225,
Coal,State Treasurer,Charles De Coune,IND,150002,1,0,47,48,
Coal,Superintendent of Public Instruction,Joy Hofmeister,REP,150002,1,16,182,199,
Coal,Superintendent of Public Instruction,John Cox,DEM,150002,3,1,64,68,
Coal,Superintendent of Public Instruction,Larry Huff,IND,150002,0,1,19,20,
Coal,Commissioner of Labor,Leslie Osborn,REP,150002,1,16,169,186,
Coal,Commissioner of Labor,Fred Dorrell,DEM,150002,3,1,81,85,
Coal,Commissioner of Labor,Brandt Dismukes,IND,150002,0,0,12,12,
Coal,Insurance Commissioner,Glen Mulready,REP,150002,1,15,167,183,
Coal,Insurance Commissioner,Kimberly Fobbs,DEM,150002,3,2,92,97,
Coal,Corporation Commissioner,Bob Anthony,REP,150002,1,17,161,179,
Coal,Corporation Commissioner,Ashley Nicole Mccray,DEM,150002,3,0,81,84,
Coal,Corporation Commissioner,Jackie Short,IND,150002,0,0,20,20,
Coal,U.S. House,Richard Castaldo,LIB,150002,0,1,6,7,2
Coal,U.S. House,Markwayne Mullin,REP,150002,1,16,164,181,2
Coal,U.S. House,Jason Nichols,DEM,150002,3,0,79,82,2
Coal,U.S. House,John Foreman,IND,150002,0,0,15,15,2
Coal,State Senate,David Bullard,REP,150002,1,16,170,187,6
Coal,State Senate,Arnold Bourne,DEM,150002,3,1,92,96,6
Coal,State House,David Smith,REP,150002,1,15,151,167,18
Coal,State House,Donnie Condit,DEM,150002,3,3,110,116,18
Coal,Governor,Chris Powell,LIB,150003,0,0,1,1,
Coal,Governor,Kevin Stitt,REP,150003,0,9,87,96,
Coal,Governor,Drew Edmondson,DEM,150003,3,3,49,55,
Coal,Lieutenant Governor,Matt Pinnell,REP,150003,0,12,99,111,
Coal,Lieutenant Governor,Anastasia Pittman,DEM,150003,3,1,33,37,
Coal,Lieutenant Governor,Ivan Holmes,IND,150003,0,0,5,5,
Coal,State Auditor,John Yeutter,LIB,150003,0,0,10,10,
Coal,State Auditor,Cindy Byrd,REP,150003,2,13,124,139,
Coal,Attorney General,Mike Hunter,REP,150003,0,11,106,117,
Coal,Attorney General,Mark Myles,DEM,150003,3,2,31,36,
Coal,State Treasurer,Randy Mcdaniel,REP,150003,2,12,109,123,
Coal,State Treasurer,Charles De Coune,IND,150003,0,1,26,27,
Coal,Superintendent of Public Instruction,Joy Hofmeister,REP,150003,0,9,85,94,
Coal,Superintendent of Public Instruction,John Cox,DEM,150003,3,3,38,44,
Coal,Superintendent of Public Instruction,Larry Huff,IND,150003,0,0,11,11,
Coal,Commissioner of Labor,Leslie Osborn,REP,150003,0,11,100,111,
Coal,Commissioner of Labor,Fred Dorrell,DEM,150003,3,2,32,37,
Coal,Commissioner of Labor,Brandt Dismukes,IND,150003,0,0,2,2,
Coal,Insurance Commissioner,Glen Mulready,REP,150003,0,11,95,106,
Coal,Insurance Commissioner,Kimberly Fobbs,DEM,150003,3,1,40,44,
Coal,Corporation Commissioner,Bob Anthony,REP,150003,0,11,97,108,
Coal,Corporation Commissioner,Ashley Nicole Mccray,DEM,150003,3,1,36,40,
Coal,Corporation Commissioner,Jackie Short,IND,150003,0,0,4,4,
Coal,U.S. House,Richard Castaldo,LIB,150003,0,1,0,1,2
Coal,U.S. House,Markwayne Mullin,REP,150003,0,11,96,107,2
Coal,U.S. House,Jason Nichols,DEM,150003,3,1,38,42,2
Coal,U.S. House,John Foreman,IND,150003,0,0,2,2,2
Coal,State Senate,David Bullard,REP,150003,1,11,98,110,6
Coal,State Senate,Arnold Bourne,DEM,150003,2,2,37,41,6
Coal,State House,David Smith,REP,150003,2,8,81,91,18
Coal,State House,Donnie Condit,DEM,150003,1,5,55,61,18
Coal,Governor,Chris Powell,LIB,150004,0,0,5,5,
Coal,Governor,Kevin Stitt,REP,150004,9,43,137,189,
Coal,Governor,Drew Edmondson,DEM,150004,3,21,81,105,
Coal,Lieutenant Governor,Matt Pinnell,REP,150004,9,46,148,203,
Coal,Lieutenant Governor,Anastasia Pittman,DEM,150004,3,18,65,86,
Coal,Lieutenant Governor,Ivan Holmes,IND,150004,0,0,7,7,
Coal,State Auditor,John Yeutter,LIB,150004,0,6,14,20,
Coal,State Auditor,Cindy Byrd,REP,150004,10,56,199,265,
Coal,Attorney General,Mike Hunter,REP,150004,10,43,150,203,
Coal,Attorney General,Mark Myles,DEM,150004,2,21,72,95,
Coal,State Treasurer,Randy Mcdaniel,REP,150004,10,50,169,229,
Coal,State Treasurer,Charles De Coune,IND,150004,0,11,39,50,
Coal,Superintendent of Public Instruction,Joy Hofmeister,REP,150004,8,38,128,174,
Coal,Superintendent of Public Instruction,John Cox,DEM,150004,4,22,77,103,
Coal,Superintendent of Public Instruction,Larry Huff,IND,150004,0,4,17,21,
Coal,Commissioner of Labor,Leslie Osborn,REP,150004,7,47,146,200,
Coal,Commissioner of Labor,Fred Dorrell,DEM,150004,5,16,69,90,
Coal,Commissioner of Labor,Brandt Dismukes,IND,150004,0,1,6,7,
Coal,Insurance Commissioner,Glen Mulready,REP,150004,10,45,137,192,
Coal,Insurance Commissioner,Kimberly Fobbs,DEM,150004,2,19,82,103,
Coal,Corporation Commissioner,Bob Anthony,REP,150004,9,43,151,203,
Coal,Corporation Commissioner,Ashley Nicole Mccray,DEM,150004,3,18,60,81,
Coal,Corporation Commissioner,Jackie Short,IND,150004,0,3,11,14,
Coal,U.S. House,Richard Castaldo,LIB,150004,0,0,3,3,2
Coal,U.S. House,Markwayne Mullin,REP,150004,10,45,153,208,2
Coal,U.S. House,Jason Nichols,DEM,150004,2,19,61,82,2
Coal,U.S. House,John Foreman,IND,150004,0,0,7,7,2
Coal,State Senate,David Bullard,REP,150004,9,43,141,193,6
Coal,State Senate,Arnold Bourne,DEM,150004,3,21,81,105,6
Coal,State House,David Smith,REP,150004,7,33,99,139,18
Coal,State House,Donnie Condit,DEM,150004,5,32,121,158,18
Coal,Governor,Chris Powell,LIB,150005,0,3,10,13,
Coal,Governor,Kevin Stitt,REP,150005,6,37,135,178,
Coal,Governor,Drew Edmondson,DEM,150005,2,20,79,101,
Coal,Lieutenant Governor,Matt Pinnell,REP,150005,6,39,157,202,
Coal,Lieutenant Governor,Anastasia Pittman,DEM,150005,2,17,53,72,
Coal,Lieutenant Governor,Ivan Holmes,IND,150005,0,4,6,10,
Coal,State Auditor,John Yeutter,LIB,150005,0,3,11,14,
Coal,State Auditor,Cindy Byrd,REP,150005,6,54,203,263,
Coal,Attorney General,Mike Hunter,REP,150005,6,40,154,200,
Coal,Attorney General,Mark Myles,DEM,150005,2,19,63,84,
Coal,State Treasurer,Randy Mcdaniel,REP,150005,6,43,180,229,
Coal,State Treasurer,Charles De Coune,IND,150005,0,11,26,37,
Coal,Superintendent of Public Instruction,Joy Hofmeister,REP,150005,5,38,126,169,
Coal,Superintendent of Public Instruction,John Cox,DEM,150005,3,19,78,100,
Coal,Superintendent of Public Instruction,Larry Huff,IND,150005,0,2,15,17,
Coal,Commissioner of Labor,Leslie Osborn,REP,150005,6,41,141,188,
Coal,Commissioner of Labor,Fred Dorrell,DEM,150005,2,15,65,82,
Coal,Commissioner of Labor,Brandt Dismukes,IND,150005,0,3,9,12,
Coal,Insurance Commissioner,Glen Mulready,REP,150005,6,39,141,186,
Coal,Insurance Commissioner,Kimberly Fobbs,DEM,150005,2,18,76,96,
Coal,Corporation Commissioner,Bob Anthony,REP,150005,6,39,139,184,
Coal,Corporation Commissioner,Ashley Nicole Mccray,DEM,150005,2,17,68,87,
Coal,Corporation Commissioner,Jackie Short,IND,150005,0,2,8,10,
Coal,U.S. House,Richard Castaldo,LIB,150005,0,0,5,5,2
Coal,U.S. House,Markwayne Mullin,REP,150005,6,42,149,197,2
Coal,U.S. House,Jason Nichols,DEM,150005,2,17,61,80,2
Coal,U.S. House,John Foreman,IND,150005,0,1,7,8,2
Coal,State Senate,David Bullard,REP,150005,5,40,138,183,6
Coal,State Senate,Arnold Bourne,DEM,150005,3,20,81,104,6
Coal,State House,David Smith,REP,150005,4,32,128,164,18
Coal,State House,Donnie Condit,DEM,150005,4,28,95,127,18
Coal,Governor,Chris Powell,LIB,150006,0,0,6,6,
Coal,Governor,Kevin Stitt,REP,150006,2,14,43,59,
Coal,Governor,Drew Edmondson,DEM,150006,3,8,34,45,
Coal,Lieutenant Governor,Matt Pinnell,REP,150006,3,15,55,73,
Coal,Lieutenant Governor,Anastasia Pittman,DEM,150006,2,5,20,27,
Coal,Lieutenant Governor,Ivan Holmes,IND,150006,0,1,6,7,
Coal,State Auditor,John Yeutter,LIB,150006,0,0,0,0,
Coal,State Auditor,Cindy Byrd,REP,150006,5,22,82,109,
Coal,Attorney General,Mike Hunter,REP,150006,2,15,57,74,
Coal,Attorney General,Mark Myles,DEM,150006,3,5,24,32,
Coal,State Treasurer,Randy Mcdaniel,REP,150006,2,18,61,81,
Coal,State Treasurer,Charles De Coune,IND,150006,2,3,19,24,
Coal,Superintendent of Public Instruction,Joy Hofmeister,REP,150006,2,16,48,66,
Coal,Superintendent of Public Instruction,John Cox,DEM,150006,3,5,26,34,
Coal,Superintendent of Public Instruction,Larry Huff,IND,150006,0,0,7,7,
Coal,Commissioner of Labor,Leslie Osborn,REP,150006,2,15,54,71,
Coal,Commissioner of Labor,Fred Dorrell,DEM,150006,2,4,21,27,
Coal,Commissioner of Labor,Brandt Dismukes,IND,150006,0,1,4,5,
Coal,Insurance Commissioner,Glen Mulready,REP,150006,2,16,54,72,
Coal,Insurance Commissioner,Kimberly Fobbs,DEM,150006,2,3,25,30,
Coal,Corporation Commissioner,Bob Anthony,REP,150006,2,15,51,68,
Coal,Corporation Commissioner,Ashley Nicole Mccray,DEM,150006,2,3,20,25,
Coal,Corporation Commissioner,Jackie Short,IND,150006,0,1,9,10,
Coal,U.S. House,Richard Castaldo,LIB,150006,0,0,4,4,2
Coal,U.S. House,Markwayne Mullin,REP,150006,2,15,59,76,2
Coal,U.S. House,Jason Nichols,DEM,150006,2,3,18,23,2
Coal,U.S. House,John Foreman,IND,150006,0,3,1,4,2
Coal,State Senate,David Bullard,REP,150006,3,15,46,64,6
Coal,State Senate,Arnold Bourne,DEM,150006,2,5,35,42,6
Coal,State House,David Smith,REP,150006,2,11,38,51,18
Coal,State House,Donnie Condit,DEM,150006,3,9,44,56,18
Coal,Governor,Chris Powell,LIB,150007,0,2,5,7,
Coal,Governor,Kevin Stitt,REP,150007,1,24,121,146,
Coal,Governor,Drew Edmondson,DEM,150007,4,14,61,79,
Coal,Lieutenant Governor,Matt Pinnell,REP,150007,1,26,133,160,
Coal,Lieutenant Governor,Anastasia Pittman,DEM,150007,4,9,45,58,
Coal,Lieutenant Governor,Ivan Holmes,IND,150007,0,4,6,10,
Coal,State Auditor,John Yeutter,LIB,150007,1,6,8,15,
Coal,State Auditor,Cindy Byrd,REP,150007,2,33,173,208,
Coal,Attorney General,Mike Hunter,REP,150007,1,27,139,167,
Coal,Attorney General,Mark Myles,DEM,150007,4,12,42,58,
Coal,State Treasurer,Randy Mcdaniel,REP,150007,2,31,147,180,
Coal,State Treasurer,Charles De Coune,IND,150007,1,9,31,41,
Coal,Superintendent of Public Instruction,Joy Hofmeister,REP,150007,1,21,123,145,
Coal,Superintendent of Public Instruction,John Cox,DEM,150007,4,15,52,71,
Coal,Superintendent of Public Instruction,Larry Huff,IND,150007,0,3,9,12,
Coal,Commissioner of Labor,Leslie Osborn,REP,150007,2,22,131,155,
Coal,Commissioner of Labor,Fred Dorrell,DEM,150007,3,15,43,61,
Coal,Commissioner of Labor,Brandt Dismukes,IND,150007,0,2,7,9,
Coal,Insurance Commissioner,Glen Mulready,REP,150007,1,28,128,157,
Coal,Insurance Commissioner,Kimberly Fobbs,DEM,150007,4,11,54,69,
Coal,Corporation Commissioner,Bob Anthony,REP,150007,1,26,122,149,
Coal,Corporation Commissioner,Ashley Nicole Mccray,DEM,150007,4,11,55,70,
Coal,Corporation Commissioner,Jackie Short,IND,150007,0,2,5,7,
Coal,U.S. House,Richard Castaldo,LIB,150007,0,4,0,4,2
Coal,U.S. House,Markwayne Mullin,REP,150007,1,23,140,164,2
Coal,U.S. House,Jason Nichols,DEM,150007,4,9,42,55,2
Coal,U.S. House,John Foreman,IND,150007,0,2,3,5,2
Coal,State Senate,David Bullard,REP,150007,1,25,131,157,6
Coal,State Senate,Arnold Bourne,DEM,150007,4,15,54,73,6
Coal,State House,David Smith,REP,150007,1,21,99,121,18
Coal,State House,Donnie Condit,DEM,150007,4,19,85,108,18
Coal,Governor,Chris Powell,LIB,150009,0,1,4,5,
Coal,Governor,Kevin Stitt,REP,150009,0,2,48,50,
Coal,Governor,Drew Edmondson,DEM,150009,1,1,29,31,
Coal,Lieutenant Governor,Matt Pinnell,REP,150009,0,2,51,53,
Coal,Lieutenant Governor,Anastasia Pittman,DEM,150009,1,1,26,28,
Coal,Lieutenant Governor,Ivan Holmes,IND,150009,0,1,2,3,
Coal,State Auditor,John Yeutter,LIB,150009,0,0,9,9,
Coal,State Auditor,Cindy Byrd,REP,150009,1,4,64,69,
Coal,Attorney General,Mike Hunter,REP,150009,0,3,53,56,
Coal,Attorney General,Mark Myles,DEM,150009,1,1,26,28,
Coal,State Treasurer,Randy Mcdaniel,REP,150009,1,2,61,64,
Coal,State Treasurer,Charles De Coune,IND,150009,0,2,10,12,
Coal,Superintendent of Public Instruction,Joy Hofmeister,REP,150009,1,2,55,58,
Coal,Superintendent of Public Instruction,John Cox,DEM,150009,0,2,22,24,
Coal,Superintendent of Public Instruction,Larry Huff,IND,150009,0,0,3,3,
Coal,Commissioner of Labor,Leslie Osborn,REP,150009,1,2,49,52,
Coal,Commissioner of Labor,Fred Dorrell,DEM,150009,0,2,29,31,
Coal,Commissioner of Labor,Brandt Dismukes,IND,150009,0,0,1,1,
Coal,Insurance Commissioner,Glen Mulready,REP,150009,0,2,52,54,
Coal,Insurance Commissioner,Kimberly Fobbs,DEM,150009,1,2,25,28,
Coal,Corporation Commissioner,Bob Anthony,REP,150009,0,3,49,52,
Coal,Corporation Commissioner,Ashley Nicole Mccray,DEM,150009,1,1,24,26,
Coal,Corporation Commissioner,Jackie Short,IND,150009,0,0,3,3,
Coal,U.S. House,Richard Castaldo,LIB,150009,0,0,0,0,2
Coal,U.S. House,Markwayne Mullin,REP,150009,0,2,53,55,2
Coal,U.S. House,Jason Nichols,DEM,150009,1,2,24,27,2
Coal,U.S. House,John Foreman,IND,150009,0,0,3,3,2
Coal,State Senate,David Bullard,REP,150009,0,2,50,52,6
Coal,State Senate,Arnold Bourne,DEM,150009,1,2,28,31,6
Coal,State House,David Smith,REP,150009,0,2,43,45,18
Coal,State House,Donnie Condit,DEM,150009,1,2,37,40,18
Coal,Governor,Chris Powell,LIB,150010,0,0,5,5,
Coal,Governor,Kevin Stitt,REP,150010,1,13,73,87,
Coal,Governor,Drew Edmondson,DEM,150010,3,3,31,37,
Coal,Lieutenant Governor,Matt Pinnell,REP,150010,4,14,73,91,
Coal,Lieutenant Governor,Anastasia Pittman,DEM,150010,0,2,30,32,
Coal,Lieutenant Governor,Ivan Holmes,IND,150010,0,0,5,5,
Coal,State Auditor,John Yeutter,LIB,150010,0,1,13,14,
Coal,State Auditor,Cindy Byrd,REP,150010,4,15,93,112,
Coal,Attorney General,Mike Hunter,REP,150010,4,14,75,93,
Coal,Attorney General,Mark Myles,DEM,150010,0,2,32,34,
Coal,State Treasurer,Randy Mcdaniel,REP,150010,4,15,84,103,
Coal,State Treasurer,Charles De Coune,IND,150010,0,1,18,19,
Coal,Superintendent of Public Instruction,Joy Hofmeister,REP,150010,3,11,67,81,
Coal,Superintendent of Public Instruction,John Cox,DEM,150010,1,4,35,40,
Coal,Superintendent of Public Instruction,Larry Huff,IND,150010,0,1,5,6,
Coal,Commissioner of Labor,Leslie Osborn,REP,150010,4,13,72,89,
Coal,Commissioner of Labor,Fred Dorrell,DEM,150010,0,2,29,31,
Coal,Commissioner of Labor,Brandt Dismukes,IND,150010,0,1,6,7,
Coal,Insurance Commissioner,Glen Mulready,REP,150010,4,13,74,91,
Coal,Insurance Commissioner,Kimberly Fobbs,DEM,150010,0,2,33,35,
Coal,Corporation Commissioner,Bob Anthony,REP,150010,4,15,74,93,
Coal,Corporation Commissioner,Ashley Nicole Mccray,DEM,150010,0,0,28,28,
Coal,Corporation Commissioner,Jackie Short,IND,150010,0,1,6,7,
Coal,U.S. House,Richard Castaldo,LIB,150010,0,0,6,6,2
Coal,U.S. House,Markwayne Mullin,REP,150010,4,15,72,91,2
Coal,U.S. House,Jason Nichols,DEM,150010,0,0,27,27,2
Coal,U.S. House,John Foreman,IND,150010,0,1,4,5,2
Coal,State Senate,David Bullard,REP,150010,4,14,72,90,6
Coal,State Senate,Arnold Bourne,DEM,150010,0,2,33,35,6
Coal,State House,David Smith,REP,150010,4,13,69,86,18
Coal,State House,Donnie Condit,DEM,150010,0,3,38,41,18
Coal,Governor,Chris Powell,LIB,150011,0,0,13,13,
Coal,Governor,Kevin Stitt,REP,150011,1,17,131,149,
Coal,Governor,Drew Edmondson,DEM,150011,3,11,83,97,
Coal,Lieutenant Governor,Matt Pinnell,REP,150011,3,16,135,154,
Coal,Lieutenant Governor,Anastasia Pittman,DEM,150011,1,7,81,89,
Coal,Lieutenant Governor,Ivan Holmes,IND,150011,0,1,6,7,
Coal,State Auditor,John Yeutter,LIB,150011,0,1,26,27,
Coal,State Auditor,Cindy Byrd,REP,150011,3,25,185,213,
Coal,Attorney General,Mike Hunter,REP,150011,1,16,135,152,
Coal,Attorney General,Mark Myles,DEM,150011,3,10,87,100,
Coal,State Treasurer,Randy Mcdaniel,REP,150011,2,21,168,191,
Coal,State Treasurer,Charles De Coune,IND,150011,1,3,39,43,
Coal,Superintendent of Public Instruction,Joy Hofmeister,REP,150011,1,15,119,135,
Coal,Superintendent of Public Instruction,John Cox,DEM,150011,3,10,82,95,
Coal,Superintendent of Public Instruction,Larry Huff,IND,150011,0,1,19,20,
Coal,Commissioner of Labor,Leslie Osborn,REP,150011,2,17,132,151,
Coal,Commissioner of Labor,Fred Dorrell,DEM,150011,2,8,77,87,
Coal,Commissioner of Labor,Brandt Dismukes,IND,150011,0,0,13,13,
Coal,Insurance Commissioner,Glen Mulready,REP,150011,1,13,130,144,
Coal,Insurance Commissioner,Kimberly Fobbs,DEM,150011,3,10,88,101,
Coal,Corporation Commissioner,Bob Anthony,REP,150011,1,16,114,131,
Coal,Corporation Commissioner,Ashley Nicole Mccray,DEM,150011,3,8,83,94,
Coal,Corporation Commissioner,Jackie Short,IND,150011,0,0,21,21,
Coal,U.S. House,Richard Castaldo,LIB,150011,0,0,4,4,2
Coal,U.S. House,Markwayne Mullin,REP,150011,3,20,140,163,2
Coal,U.S. House,Jason Nichols,DEM,150011,1,7,68,76,2
Coal,U.S. House,John Foreman,IND,150011,0,0,11,11,2
Coal,State Senate,David Bullard,REP,150011,1,15,132,148,6
Coal,State Senate,Arnold Bourne,DEM,150011,3,9,89,101,6
Coal,State House,David Smith,REP,150011,1,13,111,125,18
Coal,State House,Donnie Condit,DEM,150011,3,13,111,127,18
Comanche,Governor,Chris Powell,LIB,160001,4,0,29,33,
Comanche,Governor,Kevin Stitt,REP,160001,23,38,383,444,
Comanche,Governor,Drew Edmondson,DEM,160001,53,70,445,568,
Comanche,Lieutenant Governor,Matt Pinnell,REP,160001,29,46,439,514,
Comanche,Lieutenant Governor,Anastasia Pittman,DEM,160001,43,58,372,473,
Comanche,Lieutenant Governor,Ivan Holmes,IND,160001,7,4,38,49,
Comanche,State Auditor,John Yeutter,LIB,160001,20,40,261,321,
Comanche,State Auditor,Cindy Byrd,REP,160001,47,58,524,629,
Comanche,Attorney General,Mike Hunter,REP,160001,29,46,469,544,
Comanche,Attorney General,Mark Myles,DEM,160001,50,61,376,487,
Comanche,State Treasurer,Randy Mcdaniel,REP,160001,40,55,500,595,
Comanche,State Treasurer,Charles De Coune,IND,160001,29,42,287,358,
Comanche,Superintendent of Public Instruction,Joy Hofmeister,REP,160001,31,45,412,488,
Comanche,Superintendent of Public Instruction,John Cox,DEM,160001,41,52,368,461,
Comanche,Superintendent of Public Instruction,Larry Huff,IND,160001,7,11,63,81,
Comanche,Commissioner of Labor,Leslie Osborn,REP,160001,29,39,427,495,
Comanche,Commissioner of Labor,Fred Dorrell,DEM,160001,42,60,356,458,
Comanche,Commissioner of Labor,Brandt Dismukes,IND,160001,8,8,59,75,
Comanche,Insurance Commissioner,Glen Mulready,REP,160001,25,45,427,497,
Comanche,Insurance Commissioner,Kimberly Fobbs,DEM,160001,54,61,415,530,
Comanche,Corporation Commissioner,Bob Anthony,REP,160001,36,43,431,510,
Comanche,Corporation Commissioner,Ashley Nicole Mccray,DEM,160001,41,61,361,463,
Comanche,Corporation Commissioner,Jackie Short,IND,160001,2,4,52,58,
Comanche,U.S. House,Tom Cole,REP,160001,38,50,472,560,4
Comanche,U.S. House,Mary Brannon,DEM,160001,32,47,304,383,4
Comanche,U.S. House,Ruby Peters,IND,160001,10,11,75,96,4
Comanche,State Senate,John Michael Montgomery,REP,160001,42,45,454,541,32
Comanche,State Senate,Jacobi Crowley,DEM,160001,38,63,397,498,32
Comanche,State House,Daniel Pae,REP,160001,41,47,462,550,62
Comanche,State House,Larry Bush,DEM,160001,39,61,386,486,62
Comanche,Governor,Chris Powell,LIB,160002,1,5,27,33,
Comanche,Governor,Kevin Stitt,REP,160002,22,37,299,358,
Comanche,Governor,Drew Edmondson,DEM,160002,23,66,387,476,
Comanche,Lieutenant Governor,Matt Pinnell,REP,160002,24,48,338,410,
Comanche,Lieutenant Governor,Anastasia Pittman,DEM,160002,20,55,338,413,
Comanche,Lieutenant Governor,Ivan Holmes,IND,160002,1,4,34,39,
Comanche,State Auditor,John Yeutter,LIB,160002,13,35,224,272,
Comanche,State Auditor,Cindy Byrd,REP,160002,27,55,423,505,
Comanche,Attorney General,Mike Hunter,REP,160002,25,51,357,433,
Comanche,Attorney General,Mark Myles,DEM,160002,21,57,351,429,
Comanche,State Treasurer,Randy Mcdaniel,REP,160002,26,51,387,464,
Comanche,State Treasurer,Charles De Coune,IND,160002,14,39,257,310,
Comanche,Superintendent of Public Instruction,Joy Hofmeister,REP,160002,24,41,313,378,
Comanche,Superintendent of Public Instruction,John Cox,DEM,160002,20,58,342,420,
Comanche,Superintendent of Public Instruction,Larry Huff,IND,160002,2,8,53,63,
Comanche,Commissioner of Labor,Leslie Osborn,REP,160002,24,45,340,409,
Comanche,Commissioner of Labor,Fred Dorrell,DEM,160002,19,55,319,393,
Comanche,Commissioner of Labor,Brandt Dismukes,IND,160002,3,3,49,55,
Comanche,Insurance Commissioner,Glen Mulready,REP,160002,25,47,339,411,
Comanche,Insurance Commissioner,Kimberly Fobbs,DEM,160002,21,60,371,452,
Comanche,Corporation Commissioner,Bob Anthony,REP,160002,23,52,334,409,
Comanche,Corporation Commissioner,Ashley Nicole Mccray,DEM,160002,20,53,337,410,
Comanche,Corporation Commissioner,Jackie Short,IND,160002,3,2,41,46,
Comanche,U.S. House,Tom Cole,REP,160002,24,51,371,446,4
Comanche,U.S. House,Mary Brannon,DEM,160002,21,53,310,384,4
Comanche,U.S. House,Ruby Peters,IND,160002,1,3,32,36,4
Comanche,State Senate,John Michael Montgomery,REP,160002,23,45,346,414,32
Comanche,State Senate,Jacobi Crowley,DEM,160002,22,62,365,449,32
Comanche,State House,Daniel Pae,REP,160002,24,44,365,433,62
Comanche,State House,Larry Bush,DEM,160002,21,64,348,433,62
Comanche,Governor,Chris Powell,LIB,160003,4,4,30,38,
Comanche,Governor,Kevin Stitt,REP,160003,16,20,218,254,
Comanche,Governor,Drew Edmondson,DEM,160003,24,45,324,393,
Comanche,Lieutenant Governor,Matt Pinnell,REP,160003,18,24,242,284,
Comanche,Lieutenant Governor,Anastasia Pittman,DEM,160003,23,44,294,361,
Comanche,Lieutenant Governor,Ivan Holmes,IND,160003,3,1,33,37,
Comanche,State Auditor,John Yeutter,LIB,160003,7,33,177,217,
Comanche,State Auditor,Cindy Byrd,REP,160003,29,27,329,385,
Comanche,Attorney General,Mike Hunter,REP,160003,20,25,265,310,
Comanche,Attorney General,Mark Myles,DEM,160003,24,43,296,363,
Comanche,State Treasurer,Randy Mcdaniel,REP,160003,25,26,285,336,
Comanche,State Treasurer,Charles De Coune,IND,160003,12,32,223,267,
Comanche,Superintendent of Public Instruction,Joy Hofmeister,REP,160003,18,18,254,290,
Comanche,Superintendent of Public Instruction,John Cox,DEM,160003,22,45,270,337,
Comanche,Superintendent of Public Instruction,Larry Huff,IND,160003,2,6,47,55,
Comanche,Commissioner of Labor,Leslie Osborn,REP,160003,19,23,241,283,
Comanche,Commissioner of Labor,Fred Dorrell,DEM,160003,19,41,283,343,
Comanche,Commissioner of Labor,Brandt Dismukes,IND,160003,3,4,42,49,
Comanche,Insurance Commissioner,Glen Mulready,REP,160003,16,23,257,296,
Comanche,Insurance Commissioner,Kimberly Fobbs,DEM,160003,25,46,310,381,
Comanche,Corporation Commissioner,Bob Anthony,REP,160003,17,21,247,285,
Comanche,Corporation Commissioner,Ashley Nicole Mccray,DEM,160003,18,44,283,345,
Comanche,Corporation Commissioner,Jackie Short,IND,160003,7,4,36,47,
Comanche,U.S. House,Tom Cole,REP,160003,25,24,275,324,4
Comanche,U.S. House,Mary Brannon,DEM,160003,18,42,259,319,4
Comanche,U.S. House,Ruby Peters,IND,160003,1,3,34,38,4
Comanche,State Senate,John Michael Montgomery,REP,160003,23,23,274,320,32
Comanche,State Senate,Jacobi Crowley,DEM,160003,21,46,294,361,32
Comanche,State House,Daniel Pae,REP,160003,25,27,272,324,62
Comanche,State House,Larry Bush,DEM,160003,17,42,298,357,62
Comanche,Governor,Chris Powell,LIB,160007,2,2,35,39,
Comanche,Governor,Kevin Stitt,REP,160007,19,39,290,348,
Comanche,Governor,Drew Edmondson,DEM,160007,26,65,322,413,
Comanche,Lieutenant Governor,Matt Pinnell,REP,160007,22,42,314,378,
Comanche,Lieutenant Governor,Anastasia Pittman,DEM,160007,22,57,301,380,
Comanche,Lieutenant Governor,Ivan Holmes,IND,160007,1,6,24,31,
Comanche,State Auditor,John Yeutter,LIB,160007,15,40,186,241,
Comanche,State Auditor,Cindy Byrd,REP,160007,25,55,374,454,
Comanche,Attorney General,Mike Hunter,REP,160007,22,46,330,398,
Comanche,Attorney General,Mark Myles,DEM,160007,23,59,309,391,
Comanche,State Treasurer,Randy Mcdaniel,REP,160007,23,50,351,424,
Comanche,State Treasurer,Charles De Coune,IND,160007,18,46,200,264,
Comanche,Superintendent of Public Instruction,Joy Hofmeister,REP,160007,20,46,293,359,
Comanche,Superintendent of Public Instruction,John Cox,DEM,160007,24,53,291,368,
Comanche,Superintendent of Public Instruction,Larry Huff,IND,160007,2,6,56,64,
Comanche,Commissioner of Labor,Leslie Osborn,REP,160007,21,44,309,374,
Comanche,Commissioner of Labor,Fred Dorrell,DEM,160007,21,54,289,364,
Comanche,Commissioner of Labor,Brandt Dismukes,IND,160007,4,6,38,48,
Comanche,Insurance Commissioner,Glen Mulready,REP,160007,22,45,317,384,
Comanche,Insurance Commissioner,Kimberly Fobbs,DEM,160007,23,60,320,403,
Comanche,Corporation Commissioner,Bob Anthony,REP,160007,21,44,314,379,
Comanche,Corporation Commissioner,Ashley Nicole Mccray,DEM,160007,20,56,280,356,
Comanche,Corporation Commissioner,Jackie Short,IND,160007,4,5,43,52,
Comanche,U.S. House,Tom Cole,REP,160007,24,47,355,426,4
Comanche,U.S. House,Mary Brannon,DEM,160007,21,52,245,318,4
Comanche,U.S. House,Ruby Peters,IND,160007,2,7,44,53,4
Comanche,State Senate,John Michael Montgomery,REP,160007,24,45,332,401,32
Comanche,State Senate,Jacobi Crowley,DEM,160007,23,61,312,396,32
Comanche,State House,Daniel Pae,REP,160007,25,49,337,411,62
Comanche,State House,Larry Bush,DEM,160007,21,57,308,386,62
Comanche,Governor,Chris Powell,LIB,160008,3,3,38,44,
Comanche,Governor,Kevin Stitt,REP,160008,31,67,447,545,
Comanche,Governor,Drew Edmondson,DEM,160008,47,84,487,618,
Comanche,Lieutenant Governor,Matt Pinnell,REP,160008,44,80,470,594,
Comanche,Lieutenant Governor,Anastasia Pittman,DEM,160008,35,66,449,550,
Comanche,Lieutenant Governor,Ivan Holmes,IND,160008,2,8,49,59,
Comanche,State Auditor,John Yeutter,LIB,160008,18,43,316,377,
Comanche,State Auditor,Cindy Byrd,REP,160008,50,96,584,730,
Comanche,Attorney General,Mike Hunter,REP,160008,45,81,507,633,
Comanche,Attorney General,Mark Myles,DEM,160008,35,71,455,561,
Comanche,State Treasurer,Randy Mcdaniel,REP,160008,49,91,555,695,
Comanche,State Treasurer,Charles De Coune,IND,160008,22,47,345,414,
Comanche,Superintendent of Public Instruction,Joy Hofmeister,REP,160008,40,79,465,584,
Comanche,Superintendent of Public Instruction,John Cox,DEM,160008,35,67,415,517,
Comanche,Superintendent of Public Instruction,Larry Huff,IND,160008,4,8,88,100,
Comanche,Commissioner of Labor,Leslie Osborn,REP,160008,42,74,466,582,
Comanche,Commissioner of Labor,Fred Dorrell,DEM,160008,31,70,426,527,
Comanche,Commissioner of Labor,Brandt Dismukes,IND,160008,4,8,65,77,
Comanche,Insurance Commissioner,Glen Mulready,REP,160008,39,78,483,600,
Comanche,Insurance Commissioner,Kimberly Fobbs,DEM,160008,39,73,475,587,
Comanche,Corporation Commissioner,Bob Anthony,REP,160008,42,73,471,586,
Comanche,Corporation Commissioner,Ashley Nicole Mccray,DEM,160008,35,69,442,546,
Comanche,Corporation Commissioner,Jackie Short,IND,160008,2,10,48,60,
Comanche,U.S. House,Tom Cole,REP,160008,45,88,535,668,4
Comanche,U.S. House,Mary Brannon,DEM,160008,32,63,365,460,4
Comanche,U.S. House,Ruby Peters,IND,160008,4,4,73,81,4
Comanche,State Senate,John Michael Montgomery,REP,160008,41,84,507,632,32
Comanche,State Senate,Jacobi Crowley,DEM,160008,38,71,465,574,32
Comanche,State House,Daniel Pae,REP,160008,41,82,516,639,62
Comanche,State House,Larry Bush,DEM,160008,39,72,454,565,62
Comanche,Governor,Chris Powell,LIB,160009,1,3,41,45,
Comanche,Governor,Kevin Stitt,REP,160009,18,64,351,433,
Comanche,Governor,Drew Edmondson,DEM,160009,21,84,500,605,
Comanche,Lieutenant Governor,Matt Pinnell,REP,160009,21,66,390,477,
Comanche,Lieutenant Governor,Anastasia Pittman,DEM,160009,18,76,462,556,
Comanche,Lieutenant Governor,Ivan Holmes,IND,160009,1,7,38,46,
Comanche,State Auditor,John Yeutter,LIB,160009,14,53,315,382,
Comanche,State Auditor,Cindy Byrd,REP,160009,25,79,498,602,
Comanche,Attorney General,Mike Hunter,REP,160009,21,69,409,499,
Comanche,Attorney General,Mark Myles,DEM,160009,19,80,478,577,
Comanche,State Treasurer,Randy Mcdaniel,REP,160009,25,74,464,563,
Comanche,State Treasurer,Charles De Coune,IND,160009,14,57,357,428,
Comanche,Superintendent of Public Instruction,Joy Hofmeister,REP,160009,21,70,368,459,
Comanche,Superintendent of Public Instruction,John Cox,DEM,160009,17,74,450,541,
Comanche,Superintendent of Public Instruction,Larry Huff,IND,160009,2,5,73,80,
Comanche,Commissioner of Labor,Leslie Osborn,REP,160009,20,68,395,483,
Comanche,Commissioner of Labor,Fred Dorrell,DEM,160009,19,78,443,540,
Comanche,Commissioner of Labor,Brandt Dismukes,IND,160009,1,3,50,54,
Comanche,Insurance Commissioner,Glen Mulready,REP,160009,23,66,396,485,
Comanche,Insurance Commissioner,Kimberly Fobbs,DEM,160009,17,83,490,590,
Comanche,Corporation Commissioner,Bob Anthony,REP,160009,20,68,376,464,
Comanche,Corporation Commissioner,Ashley Nicole Mccray,DEM,160009,18,76,461,555,
Comanche,Corporation Commissioner,Jackie Short,IND,160009,2,3,52,57,
Comanche,U.S. House,Tom Cole,REP,160009,25,71,424,520,4
Comanche,U.S. House,Mary Brannon,DEM,160009,10,72,390,472,4
Comanche,U.S. House,Ruby Peters,IND,160009,5,6,80,91,4
Comanche,State Senate,John Michael Montgomery,REP,160009,23,68,411,502,32
Comanche,State Senate,Jacobi Crowley,DEM,160009,17,83,482,582,32
Comanche,State House,Daniel Pae,REP,160009,23,70,418,511,62
Comanche,State House,Larry Bush,DEM,160009,17,81,477,575,62
Comanche,Governor,Chris Powell,LIB,160011,0,0,30,30,
Comanche,Governor,Kevin Stitt,REP,160011,6,38,224,268,
Comanche,Governor,Drew Edmondson,DEM,160011,19,73,420,512,
Comanche,Lieutenant Governor,Matt Pinnell,REP,160011,9,38,261,308,
Comanche,Lieutenant Governor,Anastasia Pittman,DEM,160011,15,70,380,465,
Comanche,Lieutenant Governor,Ivan Holmes,IND,160011,0,3,30,33,
Comanche,State Auditor,John Yeutter,LIB,160011,12,39,286,337,
Comanche,State Auditor,Cindy Byrd,REP,160011,12,56,323,391,
Comanche,Attorney General,Mike Hunter,REP,160011,10,39,269,318,
Comanche,Attorney General,Mark Myles,DEM,160011,15,72,400,487,
Comanche,State Treasurer,Randy Mcdaniel,REP,160011,13,46,305,364,
Comanche,State Treasurer,Charles De Coune,IND,160011,10,50,301,361,
Comanche,Superintendent of Public Instruction,Joy Hofmeister,REP,160011,9,43,253,305,
Comanche,Superintendent of Public Instruction,John Cox,DEM,160011,13,64,380,457,
Comanche,Superintendent of Public Instruction,Larry Huff,IND,160011,3,4,36,43,
Comanche,Commissioner of Labor,Leslie Osborn,REP,160011,11,37,260,308,
Comanche,Commissioner of Labor,Fred Dorrell,DEM,160011,13,68,371,452,
Comanche,Commissioner of Labor,Brandt Dismukes,IND,160011,1,5,34,40,
Comanche,Insurance Commissioner,Glen Mulready,REP,160011,11,39,255,305,
Comanche,Insurance Commissioner,Kimberly Fobbs,DEM,160011,14,72,413,499,
Comanche,Corporation Commissioner,Bob Anthony,REP,160011,12,36,245,293,
Comanche,Corporation Commissioner,Ashley Nicole Mccray,DEM,160011,14,71,384,469,
Comanche,Corporation Commissioner,Jackie Short,IND,160011,0,2,35,37,
Comanche,U.S. House,Tom Cole,REP,160011,12,42,280,334,4
Comanche,U.S. House,Mary Brannon,DEM,160011,13,59,344,416,4
Comanche,U.S. House,Ruby Peters,IND,160011,1,10,46,57,4
Comanche,State House,Daniel Pae,REP,160011,11,41,275,327,62
Comanche,State House,Larry Bush,DEM,160011,15,70,396,481,62
Comanche,Governor,Chris Powell,LIB,160013,1,4,32,37,
Comanche,Governor,Kevin Stitt,REP,160013,13,17,312,342,
Comanche,Governor,Drew Edmondson,DEM,160013,18,36,450,504,
Comanche,Lieutenant Governor,Matt Pinnell,REP,160013,10,21,339,370,
Comanche,Lieutenant Governor,Anastasia Pittman,DEM,160013,18,34,409,461,
Comanche,Lieutenant Governor,Ivan Holmes,IND,160013,3,3,43,49,
Comanche,State Auditor,John Yeutter,LIB,160013,12,24,282,318,
Comanche,State Auditor,Cindy Byrd,REP,160013,13,25,429,467,
Comanche,Attorney General,Mike Hunter,REP,160013,14,22,365,401,
Comanche,Attorney General,Mark Myles,DEM,160013,16,35,421,472,
Comanche,State Treasurer,Randy Mcdaniel,REP,160013,14,20,401,435,
Comanche,State Treasurer,Charles De Coune,IND,160013,13,29,312,354,
Comanche,Superintendent of Public Instruction,Joy Hofmeister,REP,160013,10,23,325,358,
Comanche,Superintendent of Public Instruction,John Cox,DEM,160013,18,28,383,429,
Comanche,Superintendent of Public Instruction,Larry Huff,IND,160013,2,7,85,94,
Comanche,Commissioner of Labor,Leslie Osborn,REP,160013,12,21,326,359,
Comanche,Commissioner of Labor,Fred Dorrell,DEM,160013,18,31,392,441,
Comanche,Commissioner of Labor,Brandt Dismukes,IND,160013,2,6,62,70,
Comanche,Insurance Commissioner,Glen Mulready,REP,160013,12,18,346,376,
Comanche,Insurance Commissioner,Kimberly Fobbs,DEM,160013,18,39,435,492,
Comanche,Corporation Commissioner,Bob Anthony,REP,160013,12,24,332,368,
Comanche,Corporation Commissioner,Ashley Nicole Mccray,DEM,160013,15,30,403,448,
Comanche,Corporation Commissioner,Jackie Short,IND,160013,3,4,53,60,
Comanche,U.S. House,Tom Cole,REP,160013,14,26,363,403,4
Comanche,U.S. House,Mary Brannon,DEM,160013,16,27,378,421,4
Comanche,U.S. House,Ruby Peters,IND,160013,1,5,54,60,4
Comanche,State Senate,John Michael Montgomery,REP,160013,11,21,363,395,32
Comanche,State Senate,Jacobi Crowley,DEM,160013,19,36,430,485,32
Comanche,State House,Rande Worthen,REP,160013,11,20,347,378,64
Comanche,State House,Ashley Mccarter,DEM,160013,18,33,392,443,64
Comanche,State House,David Pilon,IND,160013,3,5,50,58,64
Comanche,Governor,Chris Powell,LIB,160014,0,2,5,7,
Comanche,Governor,Kevin Stitt,REP,160014,4,2,38,44,
Comanche,Governor,Drew Edmondson,DEM,160014,6,4,41,51,
Comanche,Lieutenant Governor,Matt Pinnell,REP,160014,4,3,42,49,
Comanche,Lieutenant Governor,Anastasia Pittman,DEM,160014,6,4,37,47,
Comanche,Lieutenant Governor,Ivan Holmes,IND,160014,0,1,5,6,
Comanche,State Auditor,John Yeutter,LIB,160014,3,4,33,40,
Comanche,State Auditor,Cindy Byrd,REP,160014,6,3,45,54,
Comanche,Attorney General,Mike Hunter,REP,160014,4,4,39,47,
Comanche,Attorney General,Mark Myles,DEM,160014,6,4,44,54,
Comanche,State Treasurer,Randy Mcdaniel,REP,160014,4,3,50,57,
Comanche,State Treasurer,Charles De Coune,IND,160014,5,4,30,39,
Comanche,Superintendent of Public Instruction,Joy Hofmeister,REP,160014,4,3,34,41,
Comanche,Superintendent of Public Instruction,John Cox,DEM,160014,6,3,43,52,
Comanche,Superintendent of Public Instruction,Larry Huff,IND,160014,0,2,7,9,
Comanche,Commissioner of Labor,Leslie Osborn,REP,160014,4,3,37,44,
Comanche,Commissioner of Labor,Fred Dorrell,DEM,160014,5,4,40,49,
Comanche,Commissioner of Labor,Brandt Dismukes,IND,160014,1,1,6,8,
Comanche,Insurance Commissioner,Glen Mulready,REP,160014,3,4,38,45,
Comanche,Insurance Commissioner,Kimberly Fobbs,DEM,160014,7,4,42,53,
Comanche,Corporation Commissioner,Bob Anthony,REP,160014,4,3,34,41,
Comanche,Corporation Commissioner,Ashley Nicole Mccray,DEM,160014,5,4,43,52,
Comanche,Corporation Commissioner,Jackie Short,IND,160014,1,1,4,6,
Comanche,U.S. House,Tom Cole,REP,160014,4,4,40,48,4
Comanche,U.S. House,Mary Brannon,DEM,160014,6,3,35,44,4
Comanche,U.S. House,Ruby Peters,IND,160014,0,1,9,10,4
Comanche,State Senate,John Michael Montgomery,REP,160014,4,4,39,47,32
Comanche,State Senate,Jacobi Crowley,DEM,160014,6,4,43,53,32
Comanche,State House,Toni Hasenbeck,REP,160014,5,4,45,54,65
Comanche,State House,Brandon Thompson,DEM,160014,5,4,38,47,65
Comanche,Governor,Chris Powell,LIB,160015,1,3,29,33,
Comanche,Governor,Kevin Stitt,REP,160015,12,46,280,338,
Comanche,Governor,Drew Edmondson,DEM,160015,38,55,336,429,
Comanche,Lieutenant Governor,Matt Pinnell,REP,160015,19,52,319,390,
Comanche,Lieutenant Governor,Anastasia Pittman,DEM,160015,28,51,299,378,
Comanche,Lieutenant Governor,Ivan Holmes,IND,160015,4,2,28,34,
Comanche,State Auditor,John Yeutter,LIB,160015,18,30,199,247,
Comanche,State Auditor,Cindy Byrd,REP,160015,29,65,392,486,
Comanche,Attorney General,Mike Hunter,REP,160015,22,60,334,416,
Comanche,Attorney General,Mark Myles,DEM,160015,28,45,308,381,
Comanche,State Treasurer,Randy Mcdaniel,REP,160015,29,56,363,448,
Comanche,State Treasurer,Charles De Coune,IND,160015,18,39,224,281,
Comanche,Superintendent of Public Instruction,Joy Hofmeister,REP,160015,21,54,312,387,
Comanche,Superintendent of Public Instruction,John Cox,DEM,160015,27,41,285,353,
Comanche,Superintendent of Public Instruction,Larry Huff,IND,160015,3,10,51,64,
Comanche,Commissioner of Labor,Leslie Osborn,REP,160015,18,54,308,380,
Comanche,Commissioner of Labor,Fred Dorrell,DEM,160015,27,44,292,363,
Comanche,Commissioner of Labor,Brandt Dismukes,IND,160015,5,4,45,54,
Comanche,Insurance Commissioner,Glen Mulready,REP,160015,21,55,315,391,
Comanche,Insurance Commissioner,Kimberly Fobbs,DEM,160015,30,49,328,407,
Comanche,Corporation Commissioner,Bob Anthony,REP,160015,25,55,318,398,
Comanche,Corporation Commissioner,Ashley Nicole Mccray,DEM,160015,23,43,290,356,
Comanche,Corporation Commissioner,Jackie Short,IND,160015,3,7,37,47,
Comanche,U.S. House,Tom Cole,REP,160015,20,57,356,433,4
Comanche,U.S. House,Mary Brannon,DEM,160015,29,36,253,318,4
Comanche,U.S. House,Ruby Peters,IND,160015,1,12,41,54,4
Comanche,State Senate,John Michael Montgomery,REP,160015,24,54,319,397,32
Comanche,State Senate,Jacobi Crowley,DEM,160015,27,51,327,405,32
Comanche,State House,Rande Worthen,REP,160015,23,55,315,393,64
Comanche,State House,Ashley Mccarter,DEM,160015,25,47,302,374,64
Comanche,State House,David Pilon,IND,160015,2,3,29,34,64
Comanche,Governor,Chris Powell,LIB,160017,0,6,34,40,
Comanche,Governor,Kevin Stitt,REP,160017,17,38,326,381,
Comanche,Governor,Drew Edmondson,DEM,160017,40,55,301,396,
Comanche,Lieutenant Governor,Matt Pinnell,REP,160017,23,46,352,421,
Comanche,Lieutenant Governor,Anastasia Pittman,DEM,160017,33,50,266,349,
Comanche,Lieutenant Governor,Ivan Holmes,IND,160017,1,2,40,43,
Comanche,State Auditor,John Yeutter,LIB,160017,17,27,194,238,
Comanche,State Auditor,Cindy Byrd,REP,160017,33,59,434,526,
Comanche,Attorney General,Mike Hunter,REP,160017,19,47,383,449,
Comanche,Attorney General,Mark Myles,DEM,160017,36,52,277,365,
Comanche,State Treasurer,Randy Mcdaniel,REP,160017,26,57,403,486,
Comanche,State Treasurer,Charles De Coune,IND,160017,22,31,225,278,
Comanche,Superintendent of Public Instruction,Joy Hofmeister,REP,160017,20,47,334,401,
Comanche,Superintendent of Public Instruction,John Cox,DEM,160017,36,44,261,341,
Comanche,Superintendent of Public Instruction,Larry Huff,IND,160017,0,7,62,69,
Comanche,Commissioner of Labor,Leslie Osborn,REP,160017,22,52,346,420,
Comanche,Commissioner of Labor,Fred Dorrell,DEM,160017,33,40,256,329,
Comanche,Commissioner of Labor,Brandt Dismukes,IND,160017,1,4,47,52,
Comanche,Insurance Commissioner,Glen Mulready,REP,160017,20,47,337,404,
Comanche,Insurance Commissioner,Kimberly Fobbs,DEM,160017,35,48,313,396,
Comanche,Corporation Commissioner,Bob Anthony,REP,160017,24,51,351,426,
Comanche,Corporation Commissioner,Ashley Nicole Mccray,DEM,160017,30,42,266,338,
Comanche,Corporation Commissioner,Jackie Short,IND,160017,2,4,42,48,
Comanche,U.S. House,Tom Cole,REP,160017,25,51,389,465,4
Comanche,U.S. House,Mary Brannon,DEM,160017,31,43,227,301,4
Comanche,U.S. House,Ruby Peters,IND,160017,1,4,46,51,4
Comanche,State Senate,John Michael Montgomery,REP,160017,23,50,366,439,32
Comanche,State Senate,Jacobi Crowley,DEM,160017,34,47,294,375,32
Comanche,State House,Rande Worthen,REP,160017,25,55,352,432,64
Comanche,State House,Ashley Mccarter,DEM,160017,32,41,270,343,64
Comanche,State House,David Pilon,IND,160017,0,3,41,44,64
Comanche,Governor,Chris Powell,LIB,160019,2,1,28,31,
Comanche,Governor,Kevin Stitt,REP,160019,4,27,253,284,
Comanche,Governor,Drew Edmondson,DEM,160019,15,21,262,298,
Comanche,Lieutenant Governor,Matt Pinnell,REP,160019,6,29,287,322,
Comanche,Lieutenant Governor,Anastasia Pittman,DEM,160019,14,19,215,248,
Comanche,Lieutenant Governor,Ivan Holmes,IND,160019,0,1,36,37,
Comanche,State Auditor,John Yeutter,LIB,160019,12,12,169,193,
Comanche,State Auditor,Cindy Byrd,REP,160019,7,31,346,384,
Comanche,Attorney General,Mike Hunter,REP,160019,7,31,312,350,
Comanche,Attorney General,Mark Myles,DEM,160019,13,18,225,256,
Comanche,State Treasurer,Randy Mcdaniel,REP,160019,7,30,339,376,
Comanche,State Treasurer,Charles De Coune,IND,160019,12,13,172,197,
Comanche,Superintendent of Public Instruction,Joy Hofmeister,REP,160019,6,27,274,307,
Comanche,Superintendent of Public Instruction,John Cox,DEM,160019,13,20,215,248,
Comanche,Superintendent of Public Instruction,Larry Huff,IND,160019,1,2,49,52,
Comanche,Commissioner of Labor,Leslie Osborn,REP,160019,7,27,279,313,
Comanche,Commissioner of Labor,Fred Dorrell,DEM,160019,11,19,206,236,
Comanche,Commissioner of Labor,Brandt Dismukes,IND,160019,2,3,46,51,
Comanche,Insurance Commissioner,Glen Mulready,REP,160019,5,29,274,308,
Comanche,Insurance Commissioner,Kimberly Fobbs,DEM,160019,15,19,258,292,
Comanche,Corporation Commissioner,Bob Anthony,REP,160019,7,29,260,296,
Comanche,Corporation Commissioner,Ashley Nicole Mccray,DEM,160019,13,19,230,262,
Comanche,Corporation Commissioner,Jackie Short,IND,160019,0,0,43,43,
Comanche,U.S. House,Tom Cole,REP,160019,6,29,310,345,4
Comanche,U.S. House,Mary Brannon,DEM,160019,15,17,186,218,4
Comanche,U.S. House,Ruby Peters,IND,160019,1,2,44,47,4
Comanche,State Senate,John Michael Montgomery,REP,160019,6,26,282,314,32
Comanche,State Senate,Jacobi Crowley,DEM,160019,14,22,257,293,32
Comanche,State House,Rande Worthen,REP,160019,6,30,267,303,64
Comanche,State House,Ashley Mccarter,DEM,160019,15,18,244,277,64
Comanche,State House,David Pilon,IND,160019,0,0,27,27,64
Comanche,Governor,Chris Powell,LIB,160020,0,1,24,25,
Comanche,Governor,Kevin Stitt,REP,160020,10,29,243,282,
Comanche,Governor,Drew Edmondson,DEM,160020,21,24,275,320,
Comanche,Lieutenant Governor,Matt Pinnell,REP,160020,10,31,256,297,
Comanche,Lieutenant Governor,Anastasia Pittman,DEM,160020,20,21,256,297,
Comanche,Lieutenant Governor,Ivan Holmes,IND,160020,1,1,27,29,
Comanche,State Auditor,John Yeutter,LIB,160020,14,12,182,208,
Comanche,State Auditor,Cindy Byrd,REP,160020,13,34,309,356,
Comanche,Attorney General,Mike Hunter,REP,160020,10,29,283,322,
Comanche,Attorney General,Mark Myles,DEM,160020,21,24,255,300,
Comanche,State Treasurer,Randy Mcdaniel,REP,160020,11,33,285,329,
Comanche,State Treasurer,Charles De Coune,IND,160020,16,13,206,235,
Comanche,Superintendent of Public Instruction,Joy Hofmeister,REP,160020,11,30,249,290,
Comanche,Superintendent of Public Instruction,John Cox,DEM,160020,19,21,238,278,
Comanche,Superintendent of Public Instruction,Larry Huff,IND,160020,1,3,48,52,
Comanche,Commissioner of Labor,Leslie Osborn,REP,160020,12,27,247,286,
Comanche,Commissioner of Labor,Fred Dorrell,DEM,160020,18,24,231,273,
Comanche,Commissioner of Labor,Brandt Dismukes,IND,160020,1,1,52,54,
Comanche,Insurance Commissioner,Glen Mulready,REP,160020,9,29,259,297,
Comanche,Insurance Commissioner,Kimberly Fobbs,DEM,160020,21,24,274,319,
Comanche,Corporation Commissioner,Bob Anthony,REP,160020,11,30,248,289,
Comanche,Corporation Commissioner,Ashley Nicole Mccray,DEM,160020,17,22,246,285,
Comanche,Corporation Commissioner,Jackie Short,IND,160020,2,1,40,43,
Comanche,U.S. House,Tom Cole,REP,160020,13,32,293,338,4
Comanche,U.S. House,Mary Brannon,DEM,160020,16,21,215,252,4
Comanche,U.S. House,Ruby Peters,IND,160020,2,1,32,35,4
Comanche,State Senate,John Michael Montgomery,REP,160020,11,30,260,301,32
Comanche,State Senate,Jacobi Crowley,DEM,160020,20,23,278,321,32
Comanche,State House,Rande Worthen,REP,160020,11,32,261,304,64
Comanche,State House,Ashley Mccarter,DEM,160020,20,21,247,288,64
Comanche,State House,David Pilon,IND,160020,0,1,31,32,64
Comanche,Governor,Chris Powell,LIB,160021,3,1,21,25,
Comanche,Governor,Kevin Stitt,REP,160021,6,17,155,178,
Comanche,Governor,Drew Edmondson,DEM,160021,7,48,192,247,
Comanche,Lieutenant Governor,Matt Pinnell,REP,160021,7,16,175,198,
Comanche,Lieutenant Governor,Anastasia Pittman,DEM,160021,8,49,167,224,
Comanche,Lieutenant Governor,Ivan Holmes,IND,160021,0,1,22,23,
Comanche,State Auditor,John Yeutter,LIB,160021,5,26,125,156,
Comanche,State Auditor,Cindy Byrd,REP,160021,8,29,207,244,
Comanche,Attorney General,Mike Hunter,REP,160021,6,21,185,212,
Comanche,Attorney General,Mark Myles,DEM,160021,9,44,176,229,
Comanche,State Treasurer,Randy Mcdaniel,REP,160021,7,26,198,231,
Comanche,State Treasurer,Charles De Coune,IND,160021,6,32,135,173,
Comanche,Superintendent of Public Instruction,Joy Hofmeister,REP,160021,7,20,167,194,
Comanche,Superintendent of Public Instruction,John Cox,DEM,160021,8,42,163,213,
Comanche,Superintendent of Public Instruction,Larry Huff,IND,160021,0,4,34,38,
Comanche,Commissioner of Labor,Leslie Osborn,REP,160021,6,15,168,189,
Comanche,Commissioner of Labor,Fred Dorrell,DEM,160021,8,45,147,200,
Comanche,Commissioner of Labor,Brandt Dismukes,IND,160021,0,4,42,46,
Comanche,Insurance Commissioner,Glen Mulready,REP,160021,6,17,173,196,
Comanche,Insurance Commissioner,Kimberly Fobbs,DEM,160021,9,48,187,244,
Comanche,Corporation Commissioner,Bob Anthony,REP,160021,6,25,170,201,
Comanche,Corporation Commissioner,Ashley Nicole Mccray,DEM,160021,9,36,159,204,
Comanche,Corporation Commissioner,Jackie Short,IND,160021,0,4,32,36,
Comanche,U.S. House,Tom Cole,REP,160021,6,22,182,210,4
Comanche,U.S. House,Mary Brannon,DEM,160021,9,38,145,192,4
Comanche,U.S. House,Ruby Peters,IND,160021,0,6,38,44,4
Comanche,State Senate,John Michael Montgomery,REP,160021,7,21,183,211,32
Comanche,State Senate,Jacobi Crowley,DEM,160021,8,45,182,235,32
Comanche,State House,Rande Worthen,REP,160021,7,21,175,203,64
Comanche,State House,Ashley Mccarter,DEM,160021,7,44,167,218,64
Comanche,State House,David Pilon,IND,160021,1,1,21,23,64
Comanche,Governor,Chris Powell,LIB,160025,0,1,7,8,
Comanche,Governor,Kevin Stitt,REP,160025,3,1,33,37,
Comanche,Governor,Drew Edmondson,DEM,160025,8,25,240,273,
Comanche,Lieutenant Governor,Matt Pinnell,REP,160025,3,2,32,37,
Comanche,Lieutenant Governor,Anastasia Pittman,DEM,160025,8,25,242,275,
Comanche,Lieutenant Governor,Ivan Holmes,IND,160025,0,0,6,6,
Comanche,State Auditor,John Yeutter,LIB,160025,5,18,122,145,
Comanche,State Auditor,Cindy Byrd,REP,160025,4,2,77,83,
Comanche,Attorney General,Mike Hunter,REP,160025,3,1,40,44,
Comanche,Attorney General,Mark Myles,DEM,160025,8,26,239,273,
Comanche,State Treasurer,Randy Mcdaniel,REP,160025,4,2,60,66,
Comanche,State Treasurer,Charles De Coune,IND,160025,6,19,137,162,
Comanche,Superintendent of Public Instruction,Joy Hofmeister,REP,160025,4,2,46,52,
Comanche,Superintendent of Public Instruction,John Cox,DEM,160025,6,24,223,253,
Comanche,Superintendent of Public Instruction,Larry Huff,IND,160025,0,1,9,10,
Comanche,Commissioner of Labor,Leslie Osborn,REP,160025,2,1,35,38,
Comanche,Commissioner of Labor,Fred Dorrell,DEM,160025,7,24,227,258,
Comanche,Commissioner of Labor,Brandt Dismukes,IND,160025,1,2,17,20,
Comanche,Insurance Commissioner,Glen Mulready,REP,160025,2,2,33,37,
Comanche,Insurance Commissioner,Kimberly Fobbs,DEM,160025,9,25,246,280,
Comanche,Corporation Commissioner,Bob Anthony,REP,160025,3,1,32,36,
Comanche,Corporation Commissioner,Ashley Nicole Mccray,DEM,160025,7,25,234,266,
Comanche,Corporation Commissioner,Jackie Short,IND,160025,0,1,13,14,
Comanche,U.S. House,Tom Cole,REP,160025,3,1,45,49,4
Comanche,U.S. House,Mary Brannon,DEM,160025,6,22,202,230,4
Comanche,U.S. House,Ruby Peters,IND,160025,1,4,34,39,4
Comanche,State House,Daniel Pae,REP,160025,2,1,37,40,62
Comanche,State House,Larry Bush,DEM,160025,9,26,243,278,62
Comanche,Governor,Chris Powell,LIB,160026,0,2,25,27,
Comanche,Governor,Kevin Stitt,REP,160026,2,7,117,126,
Comanche,Governor,Drew Edmondson,DEM,160026,0,9,155,164,
Comanche,Lieutenant Governor,Matt Pinnell,REP,160026,2,8,132,142,
Comanche,Lieutenant Governor,Anastasia Pittman,DEM,160026,0,8,148,156,
Comanche,Lieutenant Governor,Ivan Holmes,IND,160026,0,2,17,19,
Comanche,State Auditor,John Yeutter,LIB,160026,0,6,119,125,
Comanche,State Auditor,Cindy Byrd,REP,160026,2,12,153,167,
Comanche,Attorney General,Mike Hunter,REP,160026,2,7,142,151,
Comanche,Attorney General,Mark Myles,DEM,160026,0,11,151,162,
Comanche,State Treasurer,Randy Mcdaniel,REP,160026,2,10,153,165,
Comanche,State Treasurer,Charles De Coune,IND,160026,0,8,120,128,
Comanche,Superintendent of Public Instruction,Joy Hofmeister,REP,160026,2,8,122,132,
Comanche,Superintendent of Public Instruction,John Cox,DEM,160026,0,8,141,149,
Comanche,Superintendent of Public Instruction,Larry Huff,IND,160026,0,2,33,35,
Comanche,Commissioner of Labor,Leslie Osborn,REP,160026,2,7,126,135,
Comanche,Commissioner of Labor,Fred Dorrell,DEM,160026,0,9,135,144,
Comanche,Commissioner of Labor,Brandt Dismukes,IND,160026,0,1,35,36,
Comanche,Insurance Commissioner,Glen Mulready,REP,160026,2,8,130,140,
Comanche,Insurance Commissioner,Kimberly Fobbs,DEM,160026,0,10,166,176,
Comanche,Corporation Commissioner,Bob Anthony,REP,160026,2,5,125,132,
Comanche,Corporation Commissioner,Ashley Nicole Mccray,DEM,160026,0,10,145,155,
Comanche,Corporation Commissioner,Jackie Short,IND,160026,0,3,25,28,
Comanche,U.S. House,Tom Cole,REP,160026,2,7,148,157,4
Comanche,U.S. House,Mary Brannon,DEM,160026,0,9,117,126,4
Comanche,U.S. House,Ruby Peters,IND,160026,0,2,31,33,4
Comanche,State House,Trey Caldwell,REP,160026,2,8,152,162,63
Comanche,State House,Joan Gabelmann,DEM,160026,0,10,144,154,63
Comanche,Governor,Chris Powell,LIB,160027,0,0,14,14,
Comanche,Governor,Kevin Stitt,REP,160027,3,7,116,126,
Comanche,Governor,Drew Edmondson,DEM,160027,7,18,149,174,
Comanche,Lieutenant Governor,Matt Pinnell,REP,160027,3,8,119,130,
Comanche,Lieutenant Governor,Anastasia Pittman,DEM,160027,6,14,137,157,
Comanche,Lieutenant Governor,Ivan Holmes,IND,160027,1,3,23,27,
Comanche,State Auditor,John Yeutter,LIB,160027,4,11,97,112,
Comanche,State Auditor,Cindy Byrd,REP,160027,4,11,147,162,
Comanche,Attorney General,Mike Hunter,REP,160027,4,8,136,148,
Comanche,Attorney General,Mark Myles,DEM,160027,6,17,139,162,
Comanche,State Treasurer,Randy Mcdaniel,REP,160027,4,9,134,147,
Comanche,State Treasurer,Charles De Coune,IND,160027,4,13,108,125,
Comanche,Superintendent of Public Instruction,Joy Hofmeister,REP,160027,3,7,116,126,
Comanche,Superintendent of Public Instruction,John Cox,DEM,160027,6,15,124,145,
Comanche,Superintendent of Public Instruction,Larry Huff,IND,160027,1,3,36,40,
Comanche,Commissioner of Labor,Leslie Osborn,REP,160027,4,7,119,130,
Comanche,Commissioner of Labor,Fred Dorrell,DEM,160027,5,16,127,148,
Comanche,Commissioner of Labor,Brandt Dismukes,IND,160027,1,2,25,28,
Comanche,Insurance Commissioner,Glen Mulready,REP,160027,3,8,127,138,
Comanche,Insurance Commissioner,Kimberly Fobbs,DEM,160027,7,17,146,170,
Comanche,Corporation Commissioner,Bob Anthony,REP,160027,3,8,122,133,
Comanche,Corporation Commissioner,Ashley Nicole Mccray,DEM,160027,6,16,130,152,
Comanche,Corporation Commissioner,Jackie Short,IND,160027,1,1,25,27,
Comanche,U.S. House,Tom Cole,REP,160027,4,8,129,141,4
Comanche,U.S. House,Mary Brannon,DEM,160027,5,15,124,144,4
Comanche,U.S. House,Ruby Peters,IND,160027,1,2,23,26,4
Comanche,State House,Rande Worthen,REP,160027,4,8,127,139,64
Comanche,State House,Ashley Mccarter,DEM,160027,5,15,132,152,64
Comanche,State House,David Pilon,IND,160027,1,2,17,20,64
Comanche,Governor,Chris Powell,LIB,160029,0,2,5,7,
Comanche,Governor,Kevin Stitt,REP,160029,1,1,30,32,
Comanche,Governor,Drew Edmondson,DEM,160029,9,10,152,171,
Comanche,Lieutenant Governor,Matt Pinnell,REP,160029,1,3,34,38,
Comanche,Lieutenant Governor,Anastasia Pittman,DEM,160029,9,9,146,164,
Comanche,Lieutenant Governor,Ivan Holmes,IND,160029,0,1,6,7,
Comanche,State Auditor,John Yeutter,LIB,160029,4,7,94,105,
Comanche,State Auditor,Cindy Byrd,REP,160029,3,4,53,60,
Comanche,Attorney General,Mike Hunter,REP,160029,3,3,37,43,
Comanche,Attorney General,Mark Myles,DEM,160029,7,10,150,167,
Comanche,State Treasurer,Randy Mcdaniel,REP,160029,3,5,50,58,
Comanche,State Treasurer,Charles De Coune,IND,160029,4,6,94,104,
Comanche,Superintendent of Public Instruction,Joy Hofmeister,REP,160029,3,3,29,35,
Comanche,Superintendent of Public Instruction,John Cox,DEM,160029,7,10,143,160,
Comanche,Superintendent of Public Instruction,Larry Huff,IND,160029,0,0,15,15,
Comanche,Commissioner of Labor,Leslie Osborn,REP,160029,3,2,28,33,
Comanche,Commissioner of Labor,Fred Dorrell,DEM,160029,7,10,146,163,
Comanche,Commissioner of Labor,Brandt Dismukes,IND,160029,0,1,11,12,
Comanche,Insurance Commissioner,Glen Mulready,REP,160029,3,4,26,33,
Comanche,Insurance Commissioner,Kimberly Fobbs,DEM,160029,7,9,158,174,
Comanche,Corporation Commissioner,Bob Anthony,REP,160029,5,3,31,39,
Comanche,Corporation Commissioner,Ashley Nicole Mccray,DEM,160029,5,10,146,161,
Comanche,Corporation Commissioner,Jackie Short,IND,160029,0,0,9,9,
Comanche,U.S. House,Tom Cole,REP,160029,3,2,42,47,4
Comanche,U.S. House,Mary Brannon,DEM,160029,7,9,126,142,4
Comanche,U.S. House,Ruby Peters,IND,160029,0,2,19,21,4
Comanche,State House,Trey Caldwell,REP,160029,5,4,33,42,63
Comanche,State House,Joan Gabelmann,DEM,160029,5,9,153,167,63
Comanche,Governor,Chris Powell,LIB,160030,0,0,7,7,
Comanche,Governor,Kevin Stitt,REP,160030,3,6,78,87,
Comanche,Governor,Drew Edmondson,DEM,160030,0,9,122,131,
Comanche,Lieutenant Governor,Matt Pinnell,REP,160030,3,6,80,89,
Comanche,Lieutenant Governor,Anastasia Pittman,DEM,160030,0,9,122,131,
Comanche,Lieutenant Governor,Ivan Holmes,IND,160030,0,0,6,6,
Comanche,State Auditor,John Yeutter,LIB,160030,0,2,74,76,
Comanche,State Auditor,Cindy Byrd,REP,160030,3,9,107,119,
Comanche,Attorney General,Mike Hunter,REP,160030,3,6,91,100,
Comanche,Attorney General,Mark Myles,DEM,160030,0,9,115,124,
Comanche,State Treasurer,Randy Mcdaniel,REP,160030,3,9,93,105,
Comanche,State Treasurer,Charles De Coune,IND,160030,0,2,84,86,
Comanche,Superintendent of Public Instruction,Joy Hofmeister,REP,160030,2,7,88,97,
Comanche,Superintendent of Public Instruction,John Cox,DEM,160030,0,8,108,116,
Comanche,Superintendent of Public Instruction,Larry Huff,IND,160030,1,0,11,12,
Comanche,Commissioner of Labor,Leslie Osborn,REP,160030,2,6,85,93,
Comanche,Commissioner of Labor,Fred Dorrell,DEM,160030,0,8,111,119,
Comanche,Commissioner of Labor,Brandt Dismukes,IND,160030,1,1,11,13,
Comanche,Insurance Commissioner,Glen Mulready,REP,160030,3,7,85,95,
Comanche,Insurance Commissioner,Kimberly Fobbs,DEM,160030,0,8,121,129,
Comanche,Corporation Commissioner,Bob Anthony,REP,160030,3,7,84,94,
Comanche,Corporation Commissioner,Ashley Nicole Mccray,DEM,160030,0,8,111,119,
Comanche,Corporation Commissioner,Jackie Short,IND,160030,0,0,12,12,
Comanche,U.S. House,Tom Cole,REP,160030,2,8,93,103,4
Comanche,U.S. House,Mary Brannon,DEM,160030,1,6,100,107,4
Comanche,U.S. House,Ruby Peters,IND,160030,0,1,14,15,4
Comanche,State House,Toni Hasenbeck,REP,160030,3,7,93,103,65
Comanche,State House,Brandon Thompson,DEM,160030,0,8,114,122,65
Comanche,Governor,Chris Powell,LIB,160031,4,10,55,69,
Comanche,Governor,Kevin Stitt,REP,160031,72,232,687,991,
Comanche,Governor,Drew Edmondson,DEM,160031,71,252,587,910,
Comanche,Lieutenant Governor,Matt Pinnell,REP,160031,91,281,783,1155,
Comanche,Lieutenant Governor,Anastasia Pittman,DEM,160031,55,206,482,743,
Comanche,Lieutenant Governor,Ivan Holmes,IND,160031,2,8,53,63,
Comanche,State Auditor,John Yeutter,LIB,160031,32,113,309,454,
Comanche,State Auditor,Cindy Byrd,REP,160031,103,332,915,1350,
Comanche,Attorney General,Mike Hunter,REP,160031,90,275,801,1166,
Comanche,Attorney General,Mark Myles,DEM,160031,53,215,509,777,
Comanche,State Treasurer,Randy Mcdaniel,REP,160031,101,304,843,1248,
Comanche,State Treasurer,Charles De Coune,IND,160031,35,138,383,556,
Comanche,Superintendent of Public Instruction,Joy Hofmeister,REP,160031,86,271,709,1066,
Comanche,Superintendent of Public Instruction,John Cox,DEM,160031,59,194,504,757,
Comanche,Superintendent of Public Instruction,Larry Huff,IND,160031,2,28,107,137,
Comanche,Commissioner of Labor,Leslie Osborn,REP,160031,95,273,746,1114,
Comanche,Commissioner of Labor,Fred Dorrell,DEM,160031,48,197,464,709,
Comanche,Commissioner of Labor,Brandt Dismukes,IND,160031,3,15,85,103,
Comanche,Insurance Commissioner,Glen Mulready,REP,160031,90,269,766,1125,
Comanche,Insurance Commissioner,Kimberly Fobbs,DEM,160031,56,218,529,803,
Comanche,Corporation Commissioner,Bob Anthony,REP,160031,89,269,741,1099,
Comanche,Corporation Commissioner,Ashley Nicole Mccray,DEM,160031,50,204,478,732,
Comanche,Corporation Commissioner,Jackie Short,IND,160031,7,16,81,104,
Comanche,U.S. House,Tom Cole,REP,160031,93,297,818,1208,4
Comanche,U.S. House,Mary Brannon,DEM,160031,47,178,428,653,4
Comanche,U.S. House,Ruby Peters,IND,160031,6,20,81,107,4
Comanche,State House,Rande Worthen,REP,160031,96,286,761,1143,64
Comanche,State House,Ashley Mccarter,DEM,160031,51,201,509,761,64
Comanche,State House,David Pilon,IND,160031,0,6,50,56,64
Comanche,Governor,Chris Powell,LIB,160032,0,0,1,1,
Comanche,Governor,Kevin Stitt,REP,160032,0,1,5,6,
Comanche,Governor,Drew Edmondson,DEM,160032,1,2,57,60,
Comanche,Lieutenant Governor,Matt Pinnell,REP,160032,0,0,4,4,
Comanche,Lieutenant Governor,Anastasia Pittman,DEM,160032,1,3,58,62,
Comanche,Lieutenant Governor,Ivan Holmes,IND,160032,0,0,1,1,
Comanche,State Auditor,John Yeutter,LIB,160032,0,2,35,37,
Comanche,State Auditor,Cindy Byrd,REP,160032,1,0,12,13,
Comanche,Attorney General,Mike Hunter,REP,160032,0,0,5,5,
Comanche,Attorney General,Mark Myles,DEM,160032,1,3,58,62,
Comanche,State Treasurer,Randy Mcdaniel,REP,160032,0,0,9,9,
Comanche,State Treasurer,Charles De Coune,IND,160032,1,2,37,40,
Comanche,Superintendent of Public Instruction,Joy Hofmeister,REP,160032,1,0,6,7,
Comanche,Superintendent of Public Instruction,John Cox,DEM,160032,0,2,55,57,
Comanche,Superintendent of Public Instruction,Larry Huff,IND,160032,0,1,2,3,
Comanche,Commissioner of Labor,Leslie Osborn,REP,160032,1,0,5,6,
Comanche,Commissioner of Labor,Fred Dorrell,DEM,160032,0,2,57,59,
Comanche,Commissioner of Labor,Brandt Dismukes,IND,160032,0,1,1,2,
Comanche,Insurance Commissioner,Glen Mulready,REP,160032,0,0,4,4,
Comanche,Insurance Commissioner,Kimberly Fobbs,DEM,160032,1,3,59,63,
Comanche,Corporation Commissioner,Bob Anthony,REP,160032,0,0,4,4,
Comanche,Corporation Commissioner,Ashley Nicole Mccray,DEM,160032,1,3,58,62,
Comanche,Corporation Commissioner,Jackie Short,IND,160032,0,0,1,1,
Comanche,U.S. House,Tom Cole,REP,160032,1,0,6,7,4
Comanche,U.S. House,Mary Brannon,DEM,160032,0,2,48,50,4
Comanche,U.S. House,Ruby Peters,IND,160032,0,1,9,10,4
Comanche,State House,Rande Worthen,REP,160032,1,0,6,7,64
Comanche,State House,Ashley Mccarter,DEM,160032,0,3,56,59,64
Comanche,State House,David Pilon,IND,160032,0,0,1,1,64
Comanche,Governor,Chris Powell,LIB,160033,0,4,16,20,
Comanche,Governor,Kevin Stitt,REP,160033,21,10,118,149,
Comanche,Governor,Drew Edmondson,DEM,160033,19,24,143,186,
Comanche,Lieutenant Governor,Matt Pinnell,REP,160033,22,14,140,176,
Comanche,Lieutenant Governor,Anastasia Pittman,DEM,160033,14,23,120,157,
Comanche,Lieutenant Governor,Ivan Holmes,IND,160033,3,1,16,20,
Comanche,State Auditor,John Yeutter,LIB,160033,10,16,92,118,
Comanche,State Auditor,Cindy Byrd,REP,160033,23,18,160,201,
Comanche,Attorney General,Mike Hunter,REP,160033,24,15,143,182,
Comanche,Attorney General,Mark Myles,DEM,160033,17,22,130,169,
Comanche,State Treasurer,Randy Mcdaniel,REP,160033,25,16,148,189,
Comanche,State Treasurer,Charles De Coune,IND,160033,6,17,104,127,
Comanche,Superintendent of Public Instruction,Joy Hofmeister,REP,160033,22,12,122,156,
Comanche,Superintendent of Public Instruction,John Cox,DEM,160033,15,22,130,167,
Comanche,Superintendent of Public Instruction,Larry Huff,IND,160033,2,4,24,30,
Comanche,Commissioner of Labor,Leslie Osborn,REP,160033,24,13,132,169,
Comanche,Commissioner of Labor,Fred Dorrell,DEM,160033,14,18,122,154,
Comanche,Commissioner of Labor,Brandt Dismukes,IND,160033,1,6,18,25,
Comanche,Insurance Commissioner,Glen Mulready,REP,160033,22,13,139,174,
Comanche,Insurance Commissioner,Kimberly Fobbs,DEM,160033,16,23,132,171,
Comanche,Corporation Commissioner,Bob Anthony,REP,160033,25,15,130,170,
Comanche,Corporation Commissioner,Ashley Nicole Mccray,DEM,160033,13,18,127,158,
Comanche,Corporation Commissioner,Jackie Short,IND,160033,2,4,17,23,
Comanche,U.S. House,Tom Cole,REP,160033,25,13,144,182,4
Comanche,U.S. House,Mary Brannon,DEM,160033,13,21,113,147,4
Comanche,U.S. House,Ruby Peters,IND,160033,2,4,20,26,4
Comanche,State House,Rande Worthen,REP,160033,23,14,140,177,64
Comanche,State House,Ashley Mccarter,DEM,160033,15,21,124,160,64
Comanche,State House,David Pilon,IND,160033,1,2,13,16,64
Comanche,Governor,Chris Powell,LIB,160034,1,2,38,41,
Comanche,Governor,Kevin Stitt,REP,160034,21,69,436,526,
Comanche,Governor,Drew Edmondson,DEM,160034,23,89,439,551,
Comanche,Lieutenant Governor,Matt Pinnell,REP,160034,24,77,476,577,
Comanche,Lieutenant Governor,Anastasia Pittman,DEM,160034,20,72,390,482,
Comanche,Lieutenant Governor,Ivan Holmes,IND,160034,1,10,39,50,
Comanche,State Auditor,John Yeutter,LIB,160034,7,50,278,335,
Comanche,State Auditor,Cindy Byrd,REP,160034,30,99,570,699,
Comanche,Attorney General,Mike Hunter,REP,160034,23,84,498,605,
Comanche,Attorney General,Mark Myles,DEM,160034,21,75,404,500,
Comanche,State Treasurer,Randy Mcdaniel,REP,160034,28,91,543,662,
Comanche,State Treasurer,Charles De Coune,IND,160034,10,59,298,367,
Comanche,Superintendent of Public Instruction,Joy Hofmeister,REP,160034,26,73,461,560,
Comanche,Superintendent of Public Instruction,John Cox,DEM,160034,17,70,366,453,
Comanche,Superintendent of Public Instruction,Larry Huff,IND,160034,2,16,78,96,
Comanche,Commissioner of Labor,Leslie Osborn,REP,160034,26,81,474,581,
Comanche,Commissioner of Labor,Fred Dorrell,DEM,160034,18,70,366,454,
Comanche,Commissioner of Labor,Brandt Dismukes,IND,160034,1,8,58,67,
Comanche,Insurance Commissioner,Glen Mulready,REP,160034,23,81,475,579,
Comanche,Insurance Commissioner,Kimberly Fobbs,DEM,160034,21,77,421,519,
Comanche,Corporation Commissioner,Bob Anthony,REP,160034,26,82,466,574,
Comanche,Corporation Commissioner,Ashley Nicole Mccray,DEM,160034,17,70,372,459,
Comanche,Corporation Commissioner,Jackie Short,IND,160034,2,8,56,66,
Comanche,U.S. House,Tom Cole,REP,160034,26,92,518,636,4
Comanche,U.S. House,Mary Brannon,DEM,160034,16,59,339,414,4
Comanche,U.S. House,Ruby Peters,IND,160034,2,10,50,62,4
Comanche,State House,Trey Caldwell,REP,160034,28,89,557,674,63
Comanche,State House,Joan Gabelmann,DEM,160034,17,70,345,432,63
Comanche,Governor,Chris Powell,LIB,160035,1,1,9,11,
Comanche,Governor,Kevin Stitt,REP,160035,12,16,182,210,
Comanche,Governor,Drew Edmondson,DEM,160035,6,9,94,109,
Comanche,Lieutenant Governor,Matt Pinnell,REP,160035,14,19,194,227,
Comanche,Lieutenant Governor,Anastasia Pittman,DEM,160035,3,7,77,87,
Comanche,Lieutenant Governor,Ivan Holmes,IND,160035,2,0,13,15,
Comanche,State Auditor,John Yeutter,LIB,160035,1,6,46,53,
Comanche,State Auditor,Cindy Byrd,REP,160035,17,19,215,251,
Comanche,Attorney General,Mike Hunter,REP,160035,14,19,200,233,
Comanche,Attorney General,Mark Myles,DEM,160035,5,7,82,94,
Comanche,State Treasurer,Randy Mcdaniel,REP,160035,14,20,201,235,
Comanche,State Treasurer,Charles De Coune,IND,160035,4,4,60,68,
Comanche,Superintendent of Public Instruction,Joy Hofmeister,REP,160035,12,19,181,212,
Comanche,Superintendent of Public Instruction,John Cox,DEM,160035,3,6,80,89,
Comanche,Superintendent of Public Instruction,Larry Huff,IND,160035,4,1,22,27,
Comanche,Commissioner of Labor,Leslie Osborn,REP,160035,11,21,188,220,
Comanche,Commissioner of Labor,Fred Dorrell,DEM,160035,7,5,82,94,
Comanche,Commissioner of Labor,Brandt Dismukes,IND,160035,0,0,10,10,
Comanche,Insurance Commissioner,Glen Mulready,REP,160035,14,20,187,221,
Comanche,Insurance Commissioner,Kimberly Fobbs,DEM,160035,5,6,95,106,
Comanche,Corporation Commissioner,Bob Anthony,REP,160035,14,19,190,223,
Comanche,Corporation Commissioner,Ashley Nicole Mccray,DEM,160035,3,6,82,91,
Comanche,Corporation Commissioner,Jackie Short,IND,160035,2,1,11,14,
Comanche,U.S. House,Tom Cole,REP,160035,13,19,207,239,4
Comanche,U.S. House,Mary Brannon,DEM,160035,5,7,69,81,4
Comanche,U.S. House,Ruby Peters,IND,160035,0,0,9,9,4
Comanche,State Senate,John Michael Montgomery,REP,160035,13,21,199,233,32
Comanche,State Senate,Jacobi Crowley,DEM,160035,5,5,85,95,32
Comanche,State House,Trey Caldwell,REP,160035,13,22,211,246,63
Comanche,State House,Joan Gabelmann,DEM,160035,5,4,70,79,63
Comanche,Governor,Chris Powell,LIB,160036,0,0,9,9,
Comanche,Governor,Kevin Stitt,REP,160036,7,16,165,188,
Comanche,Governor,Drew Edmondson,DEM,160036,9,6,110,125,
Comanche,Lieutenant Governor,Matt Pinnell,REP,160036,8,15,177,200,
Comanche,Lieutenant Governor,Anastasia Pittman,DEM,160036,6,6,89,101,
Comanche,Lieutenant Governor,Ivan Holmes,IND,160036,2,1,16,19,
Comanche,State Auditor,John Yeutter,LIB,160036,5,7,68,80,
Comanche,State Auditor,Cindy Byrd,REP,160036,10,15,188,213,
Comanche,Attorney General,Mike Hunter,REP,160036,7,16,184,207,
Comanche,Attorney General,Mark Myles,DEM,160036,8,6,94,108,
Comanche,State Treasurer,Randy Mcdaniel,REP,160036,9,16,181,206,
Comanche,State Treasurer,Charles De Coune,IND,160036,5,6,74,85,
Comanche,Superintendent of Public Instruction,Joy Hofmeister,REP,160036,7,15,174,196,
Comanche,Superintendent of Public Instruction,John Cox,DEM,160036,8,4,82,94,
Comanche,Superintendent of Public Instruction,Larry Huff,IND,160036,1,3,25,29,
Comanche,Commissioner of Labor,Leslie Osborn,REP,160036,9,16,175,200,
Comanche,Commissioner of Labor,Fred Dorrell,DEM,160036,7,5,84,96,
Comanche,Commissioner of Labor,Brandt Dismukes,IND,160036,0,1,19,20,
Comanche,Insurance Commissioner,Glen Mulready,REP,160036,8,16,184,208,
Comanche,Insurance Commissioner,Kimberly Fobbs,DEM,160036,7,6,92,105,
Comanche,Corporation Commissioner,Bob Anthony,REP,160036,7,14,176,197,
Comanche,Corporation Commissioner,Ashley Nicole Mccray,DEM,160036,8,7,83,98,
Comanche,Corporation Commissioner,Jackie Short,IND,160036,0,1,19,20,
Comanche,U.S. House,Tom Cole,REP,160036,9,16,193,218,4
Comanche,U.S. House,Mary Brannon,DEM,160036,7,5,79,91,4
Comanche,U.S. House,Ruby Peters,IND,160036,0,1,12,13,4
Comanche,State Senate,John Michael Montgomery,REP,160036,8,17,194,219,32
Comanche,State Senate,Jacobi Crowley,DEM,160036,8,5,86,99,32
Comanche,State House,Trey Caldwell,REP,160036,9,17,194,220,63
Comanche,State House,Joan Gabelmann,DEM,160036,7,5,89,101,63
Comanche,Governor,Chris Powell,LIB,160037,0,0,5,5,
Comanche,Governor,Kevin Stitt,REP,160037,7,5,147,159,
Comanche,Governor,Drew Edmondson,DEM,160037,0,2,71,73,
Comanche,Lieutenant Governor,Matt Pinnell,REP,160037,7,6,166,179,
Comanche,Lieutenant Governor,Anastasia Pittman,DEM,160037,0,0,47,47,
Comanche,Lieutenant Governor,Ivan Holmes,IND,160037,0,0,7,7,
Comanche,State Auditor,John Yeutter,LIB,160037,1,1,34,36,
Comanche,State Auditor,Cindy Byrd,REP,160037,6,5,179,190,
Comanche,Attorney General,Mike Hunter,REP,160037,7,6,163,176,
Comanche,Attorney General,Mark Myles,DEM,160037,0,0,56,56,
Comanche,State Treasurer,Randy Mcdaniel,REP,160037,6,5,183,194,
Comanche,State Treasurer,Charles De Coune,IND,160037,1,1,30,32,
Comanche,Superintendent of Public Instruction,Joy Hofmeister,REP,160037,7,6,149,162,
Comanche,Superintendent of Public Instruction,John Cox,DEM,160037,0,0,51,51,
Comanche,Superintendent of Public Instruction,Larry Huff,IND,160037,0,0,21,21,
Comanche,Commissioner of Labor,Leslie Osborn,REP,160037,7,5,153,165,
Comanche,Commissioner of Labor,Fred Dorrell,DEM,160037,0,1,55,56,
Comanche,Commissioner of Labor,Brandt Dismukes,IND,160037,0,0,10,10,
Comanche,Insurance Commissioner,Glen Mulready,REP,160037,6,6,157,169,
Comanche,Insurance Commissioner,Kimberly Fobbs,DEM,160037,1,1,59,61,
Comanche,Corporation Commissioner,Bob Anthony,REP,160037,7,3,157,167,
Comanche,Corporation Commissioner,Ashley Nicole Mccray,DEM,160037,0,2,50,52,
Comanche,Corporation Commissioner,Jackie Short,IND,160037,0,2,11,13,
Comanche,U.S. House,Tom Cole,REP,160037,7,5,178,190,4
Comanche,U.S. House,Mary Brannon,DEM,160037,0,1,37,38,4
Comanche,U.S. House,Ruby Peters,IND,160037,0,1,5,6,4
Comanche,State Senate,John Michael Montgomery,REP,160037,7,7,160,174,32
Comanche,State Senate,Jacobi Crowley,DEM,160037,0,0,61,61,32
Comanche,State House,Trey Caldwell,REP,160037,6,6,182,194,63
Comanche,State House,Joan Gabelmann,DEM,160037,1,0,40,41,63
Comanche,Governor,Chris Powell,LIB,160038,4,12,40,56,
Comanche,Governor,Kevin Stitt,REP,160038,36,376,652,1064,
Comanche,Governor,Drew Edmondson,DEM,160038,37,184,327,548,
Comanche,Lieutenant Governor,Matt Pinnell,REP,160038,42,418,725,1185,
Comanche,Lieutenant Governor,Anastasia Pittman,DEM,160038,30,137,235,402,
Comanche,Lieutenant Governor,Ivan Holmes,IND,160038,3,13,50,66,
Comanche,State Auditor,John Yeutter,LIB,160038,24,89,181,294,
Comanche,State Auditor,Cindy Byrd,REP,160038,47,452,775,1274,
Comanche,Attorney General,Mike Hunter,REP,160038,45,428,735,1208,
Comanche,Attorney General,Mark Myles,DEM,160038,31,131,266,428,
Comanche,State Treasurer,Randy Mcdaniel,REP,160038,44,438,745,1227,
Comanche,State Treasurer,Charles De Coune,IND,160038,28,98,208,334,
Comanche,Superintendent of Public Instruction,Joy Hofmeister,REP,160038,40,386,647,1073,
Comanche,Superintendent of Public Instruction,John Cox,DEM,160038,32,144,264,440,
Comanche,Superintendent of Public Instruction,Larry Huff,IND,160038,5,37,96,138,
Comanche,Commissioner of Labor,Leslie Osborn,REP,160038,37,399,678,1114,
Comanche,Commissioner of Labor,Fred Dorrell,DEM,160038,32,134,244,410,
Comanche,Commissioner of Labor,Brandt Dismukes,IND,160038,6,26,73,105,
Comanche,Insurance Commissioner,Glen Mulready,REP,160038,41,396,698,1135,
Comanche,Insurance Commissioner,Kimberly Fobbs,DEM,160038,36,162,296,494,
Comanche,Corporation Commissioner,Bob Anthony,REP,160038,43,393,660,1096,
Comanche,Corporation Commissioner,Ashley Nicole Mccray,DEM,160038,31,135,264,430,
Comanche,Corporation Commissioner,Jackie Short,IND,160038,4,36,72,112,
Comanche,U.S. House,Tom Cole,REP,160038,47,438,739,1224,4
Comanche,U.S. House,Mary Brannon,DEM,160038,33,114,228,375,4
Comanche,U.S. House,Ruby Peters,IND,160038,0,18,51,69,4
Comanche,State House,Toni Hasenbeck,REP,160038,44,358,656,1058,65
Comanche,State House,Brandon Thompson,DEM,160038,35,209,361,605,65
Comanche,Governor,Chris Powell,LIB,160039,0,3,20,23,
Comanche,Governor,Kevin Stitt,REP,160039,8,37,403,448,
Comanche,Governor,Drew Edmondson,DEM,160039,12,31,187,230,
Comanche,Lieutenant Governor,Matt Pinnell,REP,160039,9,45,444,498,
Comanche,Lieutenant Governor,Anastasia Pittman,DEM,160039,10,23,136,169,
Comanche,Lieutenant Governor,Ivan Holmes,IND,160039,0,3,25,28,
Comanche,State Auditor,John Yeutter,LIB,160039,7,13,92,112,
Comanche,State Auditor,Cindy Byrd,REP,160039,12,51,492,555,
Comanche,Attorney General,Mike Hunter,REP,160039,11,40,463,514,
Comanche,Attorney General,Mark Myles,DEM,160039,9,30,140,179,
Comanche,State Treasurer,Randy Mcdaniel,REP,160039,11,46,473,530,
Comanche,State Treasurer,Charles De Coune,IND,160039,8,20,102,130,
Comanche,Superintendent of Public Instruction,Joy Hofmeister,REP,160039,8,40,403,451,
Comanche,Superintendent of Public Instruction,John Cox,DEM,160039,12,24,137,173,
Comanche,Superintendent of Public Instruction,Larry Huff,IND,160039,0,6,63,69,
Comanche,Commissioner of Labor,Leslie Osborn,REP,160039,10,40,428,478,
Comanche,Commissioner of Labor,Fred Dorrell,DEM,160039,10,25,135,170,
Comanche,Commissioner of Labor,Brandt Dismukes,IND,160039,0,5,39,44,
Comanche,Insurance Commissioner,Glen Mulready,REP,160039,9,44,442,495,
Comanche,Insurance Commissioner,Kimberly Fobbs,DEM,160039,11,27,159,197,
Comanche,Corporation Commissioner,Bob Anthony,REP,160039,12,37,429,478,
Comanche,Corporation Commissioner,Ashley Nicole Mccray,DEM,160039,7,28,135,170,
Comanche,Corporation Commissioner,Jackie Short,IND,160039,1,5,37,43,
Comanche,U.S. House,Tom Cole,REP,160039,10,48,479,537,4
Comanche,U.S. House,Mary Brannon,DEM,160039,10,19,103,132,4
Comanche,U.S. House,Ruby Peters,IND,160039,0,3,28,31,4
Comanche,State House,Toni Hasenbeck,REP,160039,9,34,367,410,65
Comanche,State House,Brandon Thompson,DEM,160039,11,36,243,290,65
Comanche,Governor,Chris Powell,LIB,160040,0,0,38,38,
Comanche,Governor,Kevin Stitt,REP,160040,9,35,477,521,
Comanche,Governor,Drew Edmondson,DEM,160040,2,17,216,235,
Comanche,Lieutenant Governor,Matt Pinnell,REP,160040,9,36,520,565,
Comanche,Lieutenant Governor,Anastasia Pittman,DEM,160040,2,14,173,189,
Comanche,Lieutenant Governor,Ivan Holmes,IND,160040,0,1,30,31,
Comanche,State Auditor,John Yeutter,LIB,160040,3,9,101,113,
Comanche,State Auditor,Cindy Byrd,REP,160040,7,42,598,647,
Comanche,Attorney General,Mike Hunter,REP,160040,8,35,541,584,
Comanche,Attorney General,Mark Myles,DEM,160040,2,16,178,196,
Comanche,State Treasurer,Randy Mcdaniel,REP,160040,8,40,578,626,
Comanche,State Treasurer,Charles De Coune,IND,160040,2,10,119,131,
Comanche,Superintendent of Public Instruction,Joy Hofmeister,REP,160040,7,33,456,496,
Comanche,Superintendent of Public Instruction,John Cox,DEM,160040,3,15,196,214,
Comanche,Superintendent of Public Instruction,Larry Huff,IND,160040,0,4,73,77,
Comanche,Commissioner of Labor,Leslie Osborn,REP,160040,7,35,484,526,
Comanche,Commissioner of Labor,Fred Dorrell,DEM,160040,2,15,176,193,
Comanche,Commissioner of Labor,Brandt Dismukes,IND,160040,1,1,58,60,
Comanche,Insurance Commissioner,Glen Mulready,REP,160040,8,33,514,555,
Comanche,Insurance Commissioner,Kimberly Fobbs,DEM,160040,2,18,199,219,
Comanche,Corporation Commissioner,Bob Anthony,REP,160040,8,30,511,549,
Comanche,Corporation Commissioner,Ashley Nicole Mccray,DEM,160040,2,17,151,170,
Comanche,Corporation Commissioner,Jackie Short,IND,160040,0,3,56,59,
Comanche,U.S. House,Tom Cole,REP,160040,9,37,539,585,4
Comanche,U.S. House,Mary Brannon,DEM,160040,2,13,151,166,4
Comanche,U.S. House,Ruby Peters,IND,160040,0,1,39,40,4
Comanche,State House,Toni Hasenbeck,REP,160040,8,32,398,438,65
Comanche,State House,Brandon Thompson,DEM,160040,3,20,330,353,65
Comanche,Governor,Chris Powell,LIB,160041,0,0,27,27,
Comanche,Governor,Kevin Stitt,REP,160041,5,9,281,295,
Comanche,Governor,Drew Edmondson,DEM,160041,7,7,126,140,
Comanche,Lieutenant Governor,Matt Pinnell,REP,160041,6,11,303,320,
Comanche,Lieutenant Governor,Anastasia Pittman,DEM,160041,5,5,101,111,
Comanche,Lieutenant Governor,Ivan Holmes,IND,160041,0,0,24,24,
Comanche,State Auditor,John Yeutter,LIB,160041,1,1,59,61,
Comanche,State Auditor,Cindy Byrd,REP,160041,11,14,343,368,
Comanche,Attorney General,Mike Hunter,REP,160041,8,12,318,338,
Comanche,Attorney General,Mark Myles,DEM,160041,3,4,105,112,
Comanche,State Treasurer,Randy Mcdaniel,REP,160041,5,14,331,350,
Comanche,State Treasurer,Charles De Coune,IND,160041,6,1,66,73,
Comanche,Superintendent of Public Instruction,Joy Hofmeister,REP,160041,6,14,274,294,
Comanche,Superintendent of Public Instruction,John Cox,DEM,160041,3,2,110,115,
Comanche,Superintendent of Public Instruction,Larry Huff,IND,160041,2,0,46,48,
Comanche,Commissioner of Labor,Leslie Osborn,REP,160041,8,11,284,303,
Comanche,Commissioner of Labor,Fred Dorrell,DEM,160041,2,5,120,127,
Comanche,Commissioner of Labor,Brandt Dismukes,IND,160041,1,0,22,23,
Comanche,Insurance Commissioner,Glen Mulready,REP,160041,6,12,299,317,
Comanche,Insurance Commissioner,Kimberly Fobbs,DEM,160041,5,3,121,129,
Comanche,Corporation Commissioner,Bob Anthony,REP,160041,4,13,291,308,
Comanche,Corporation Commissioner,Ashley Nicole Mccray,DEM,160041,4,2,110,116,
Comanche,Corporation Commissioner,Jackie Short,IND,160041,3,1,24,28,
Comanche,U.S. House,Tom Cole,REP,160041,8,12,328,348,4
Comanche,U.S. House,Mary Brannon,DEM,160041,4,4,82,90,4
Comanche,U.S. House,Ruby Peters,IND,160041,0,0,23,23,4
Comanche,State Senate,John Michael Montgomery,REP,160041,8,11,335,354,32
Comanche,State Senate,Jacobi Crowley,DEM,160041,4,5,95,104,32
Comanche,State House,Trey Caldwell,REP,160041,10,12,352,374,63
Comanche,State House,Joan Gabelmann,DEM,160041,2,4,79,85,63
Comanche,Governor,Chris Powell,LIB,160042,3,9,42,54,
Comanche,Governor,Kevin Stitt,REP,160042,85,80,822,987,
Comanche,Governor,Drew Edmondson,DEM,160042,76,114,591,781,
Comanche,Lieutenant Governor,Matt Pinnell,REP,160042,109,92,907,1108,
Comanche,Lieutenant Governor,Anastasia Pittman,DEM,160042,51,108,491,650,
Comanche,Lieutenant Governor,Ivan Holmes,IND,160042,4,4,45,53,
Comanche,State Auditor,John Yeutter,LIB,160042,40,51,311,402,
Comanche,State Auditor,Cindy Byrd,REP,160042,112,111,1034,1257,
Comanche,Attorney General,Mike Hunter,REP,160042,102,97,937,1136,
Comanche,Attorney General,Mark Myles,DEM,160042,62,106,502,670,
Comanche,State Treasurer,Randy Mcdaniel,REP,160042,106,108,1005,1219,
Comanche,State Treasurer,Charles De Coune,IND,160042,49,61,334,444,
Comanche,Superintendent of Public Instruction,Joy Hofmeister,REP,160042,97,99,842,1038,
Comanche,Superintendent of Public Instruction,John Cox,DEM,160042,56,100,500,656,
Comanche,Superintendent of Public Instruction,Larry Huff,IND,160042,11,5,96,112,
Comanche,Commissioner of Labor,Leslie Osborn,REP,160042,91,94,869,1054,
Comanche,Commissioner of Labor,Fred Dorrell,DEM,160042,64,103,487,654,
Comanche,Commissioner of Labor,Brandt Dismukes,IND,160042,8,7,74,89,
Comanche,Insurance Commissioner,Glen Mulready,REP,160042,102,83,891,1076,
Comanche,Insurance Commissioner,Kimberly Fobbs,DEM,160042,62,119,533,714,
Comanche,Corporation Commissioner,Bob Anthony,REP,160042,98,91,886,1075,
Comanche,Corporation Commissioner,Ashley Nicole Mccray,DEM,160042,58,108,473,639,
Comanche,Corporation Commissioner,Jackie Short,IND,160042,8,5,74,87,
Comanche,U.S. House,Tom Cole,REP,160042,108,103,957,1168,4
Comanche,U.S. House,Mary Brannon,DEM,160042,51,96,422,569,4
Comanche,U.S. House,Ruby Peters,IND,160042,5,5,69,79,4
Comanche,State Senate,John Michael Montgomery,REP,160042,99,90,922,1111,32
Comanche,State Senate,Jacobi Crowley,DEM,160042,62,114,524,700,32
Comanche,State House,Trey Caldwell,REP,160042,109,107,999,1215,63
Comanche,State House,Joan Gabelmann,DEM,160042,55,96,450,601,63
Comanche,Governor,Chris Powell,LIB,160043,0,0,8,8,
Comanche,Governor,Kevin Stitt,REP,160043,6,14,166,186,
Comanche,Governor,Drew Edmondson,DEM,160043,4,4,73,81,
Comanche,Lieutenant Governor,Matt Pinnell,REP,160043,8,16,190,214,
Comanche,Lieutenant Governor,Anastasia Pittman,DEM,160043,2,2,52,56,
Comanche,Lieutenant Governor,Ivan Holmes,IND,160043,0,0,3,3,
Comanche,State Auditor,John Yeutter,LIB,160043,1,0,31,32,
Comanche,State Auditor,Cindy Byrd,REP,160043,8,18,207,233,
Comanche,Attorney General,Mike Hunter,REP,160043,8,16,199,223,
Comanche,Attorney General,Mark Myles,DEM,160043,2,2,44,48,
Comanche,State Treasurer,Randy Mcdaniel,REP,160043,8,16,200,224,
Comanche,State Treasurer,Charles De Coune,IND,160043,1,1,39,41,
Comanche,Superintendent of Public Instruction,Joy Hofmeister,REP,160043,8,14,174,196,
Comanche,Superintendent of Public Instruction,John Cox,DEM,160043,2,3,52,57,
Comanche,Superintendent of Public Instruction,Larry Huff,IND,160043,0,1,17,18,
Comanche,Commissioner of Labor,Leslie Osborn,REP,160043,9,14,178,201,
Comanche,Commissioner of Labor,Fred Dorrell,DEM,160043,1,3,50,54,
Comanche,Commissioner of Labor,Brandt Dismukes,IND,160043,0,1,14,15,
Comanche,Insurance Commissioner,Glen Mulready,REP,160043,8,16,191,215,
Comanche,Insurance Commissioner,Kimberly Fobbs,DEM,160043,2,2,51,55,
Comanche,Corporation Commissioner,Bob Anthony,REP,160043,9,16,188,213,
Comanche,Corporation Commissioner,Ashley Nicole Mccray,DEM,160043,1,2,39,42,
Comanche,Corporation Commissioner,Jackie Short,IND,160043,0,0,15,15,
Comanche,U.S. House,Tom Cole,REP,160043,9,16,206,231,4
Comanche,U.S. House,Mary Brannon,DEM,160043,1,2,31,34,4
Comanche,U.S. House,Ruby Peters,IND,160043,0,0,8,8,4
Comanche,State House,Trey Caldwell,REP,160043,9,17,216,242,63
Comanche,State House,Joan Gabelmann,DEM,160043,1,1,31,33,63
Comanche,Governor,Chris Powell,LIB,160045,0,4,20,24,
Comanche,Governor,Kevin Stitt,REP,160045,22,37,426,485,
Comanche,Governor,Drew Edmondson,DEM,160045,10,29,199,238,
Comanche,Lieutenant Governor,Matt Pinnell,REP,160045,20,43,470,533,
Comanche,Lieutenant Governor,Anastasia Pittman,DEM,160045,10,26,152,188,
Comanche,Lieutenant Governor,Ivan Holmes,IND,160045,0,1,20,21,
Comanche,State Auditor,John Yeutter,LIB,160045,4,17,96,117,
Comanche,State Auditor,Cindy Byrd,REP,160045,25,46,514,585,
Comanche,Attorney General,Mike Hunter,REP,160045,19,42,463,524,
Comanche,Attorney General,Mark Myles,DEM,160045,11,27,178,216,
Comanche,State Treasurer,Randy Mcdaniel,REP,160045,25,43,496,564,
Comanche,State Treasurer,Charles De Coune,IND,160045,5,20,115,140,
Comanche,Superintendent of Public Instruction,Joy Hofmeister,REP,160045,20,38,431,489,
Comanche,Superintendent of Public Instruction,John Cox,DEM,160045,8,28,164,200,
Comanche,Superintendent of Public Instruction,Larry Huff,IND,160045,2,4,47,53,
Comanche,Commissioner of Labor,Leslie Osborn,REP,160045,17,40,443,500,
Comanche,Commissioner of Labor,Fred Dorrell,DEM,160045,11,25,174,210,
Comanche,Commissioner of Labor,Brandt Dismukes,IND,160045,1,5,24,30,
Comanche,Insurance Commissioner,Glen Mulready,REP,160045,19,41,467,527,
Comanche,Insurance Commissioner,Kimberly Fobbs,DEM,160045,11,29,171,211,
Comanche,Corporation Commissioner,Bob Anthony,REP,160045,19,37,440,496,
Comanche,Corporation Commissioner,Ashley Nicole Mccray,DEM,160045,9,28,163,200,
Comanche,Corporation Commissioner,Jackie Short,IND,160045,3,5,37,45,
Comanche,U.S. House,Tom Cole,REP,160045,23,42,482,547,4
Comanche,U.S. House,Mary Brannon,DEM,160045,8,24,143,175,4
Comanche,U.S. House,Ruby Peters,IND,160045,1,4,20,25,4
Comanche,State House,Trey Caldwell,REP,160045,23,43,495,561,63
Comanche,State House,Joan Gabelmann,DEM,160045,9,27,151,187,63
Comanche,Governor,Chris Powell,LIB,160046,0,0,9,9,
Comanche,Governor,Kevin Stitt,REP,160046,2,5,191,198,
Comanche,Governor,Drew Edmondson,DEM,160046,4,4,60,68,
Comanche,Lieutenant Governor,Matt Pinnell,REP,160046,5,5,198,208,
Comanche,Lieutenant Governor,Anastasia Pittman,DEM,160046,1,2,41,44,
Comanche,Lieutenant Governor,Ivan Holmes,IND,160046,0,2,12,14,
Comanche,State Auditor,John Yeutter,LIB,160046,1,1,27,29,
Comanche,State Auditor,Cindy Byrd,REP,160046,4,8,212,224,
Comanche,Attorney General,Mike Hunter,REP,160046,3,6,206,215,
Comanche,Attorney General,Mark Myles,DEM,160046,3,3,45,51,
Comanche,State Treasurer,Randy Mcdaniel,REP,160046,2,5,208,215,
Comanche,State Treasurer,Charles De Coune,IND,160046,3,4,31,38,
Comanche,Superintendent of Public Instruction,Joy Hofmeister,REP,160046,6,5,193,204,
Comanche,Superintendent of Public Instruction,John Cox,DEM,160046,0,4,39,43,
Comanche,Superintendent of Public Instruction,Larry Huff,IND,160046,0,0,21,21,
Comanche,Commissioner of Labor,Leslie Osborn,REP,160046,3,6,184,193,
Comanche,Commissioner of Labor,Fred Dorrell,DEM,160046,2,3,47,52,
Comanche,Commissioner of Labor,Brandt Dismukes,IND,160046,0,0,14,14,
Comanche,Insurance Commissioner,Glen Mulready,REP,160046,2,5,191,198,
Comanche,Insurance Commissioner,Kimberly Fobbs,DEM,160046,3,4,56,63,
Comanche,Corporation Commissioner,Bob Anthony,REP,160046,2,6,192,200,
Comanche,Corporation Commissioner,Ashley Nicole Mccray,DEM,160046,3,3,46,52,
Comanche,Corporation Commissioner,Jackie Short,IND,160046,0,0,11,11,
Comanche,U.S. House,Tom Cole,REP,160046,5,5,212,222,4
Comanche,U.S. House,Mary Brannon,DEM,160046,1,4,36,41,4
Comanche,U.S. House,Ruby Peters,IND,160046,0,0,9,9,4
Comanche,State House,Trey Caldwell,REP,160046,5,5,218,228,63
Comanche,State House,Joan Gabelmann,DEM,160046,1,4,38,43,63
Comanche,Governor,Chris Powell,LIB,160048,1,1,29,31,
Comanche,Governor,Kevin Stitt,REP,160048,5,10,242,257,
Comanche,Governor,Drew Edmondson,DEM,160048,2,6,161,169,
Comanche,Lieutenant Governor,Matt Pinnell,REP,160048,7,11,275,293,
Comanche,Lieutenant Governor,Anastasia Pittman,DEM,160048,1,5,127,133,
Comanche,Lieutenant Governor,Ivan Holmes,IND,160048,0,1,27,28,
Comanche,State Auditor,John Yeutter,LIB,160048,1,5,97,103,
Comanche,State Auditor,Cindy Byrd,REP,160048,7,12,314,333,
Comanche,Attorney General,Mike Hunter,REP,160048,7,11,291,309,
Comanche,Attorney General,Mark Myles,DEM,160048,1,6,138,145,
Comanche,State Treasurer,Randy Mcdaniel,REP,160048,6,11,305,322,
Comanche,State Treasurer,Charles De Coune,IND,160048,2,6,101,109,
Comanche,Superintendent of Public Instruction,Joy Hofmeister,REP,160048,7,8,253,268,
Comanche,Superintendent of Public Instruction,John Cox,DEM,160048,1,7,140,148,
Comanche,Superintendent of Public Instruction,Larry Huff,IND,160048,0,2,38,40,
Comanche,Commissioner of Labor,Leslie Osborn,REP,160048,7,9,262,278,
Comanche,Commissioner of Labor,Fred Dorrell,DEM,160048,1,6,130,137,
Comanche,Commissioner of Labor,Brandt Dismukes,IND,160048,0,2,34,36,
Comanche,Insurance Commissioner,Glen Mulready,REP,160048,7,10,281,298,
Comanche,Insurance Commissioner,Kimberly Fobbs,DEM,160048,1,7,145,153,
Comanche,Corporation Commissioner,Bob Anthony,REP,160048,7,8,267,282,
Comanche,Corporation Commissioner,Ashley Nicole Mccray,DEM,160048,1,6,127,134,
Comanche,Corporation Commissioner,Jackie Short,IND,160048,0,3,29,32,
Comanche,U.S. House,Tom Cole,REP,160048,7,8,308,323,4
Comanche,U.S. House,Mary Brannon,DEM,160048,1,8,100,109,4
Comanche,U.S. House,Ruby Peters,IND,160048,0,1,27,28,4
Comanche,State House,Trey Caldwell,REP,160048,7,13,329,349,63
Comanche,State House,Joan Gabelmann,DEM,160048,1,4,104,109,63
Comanche,Governor,Chris Powell,LIB,160049,0,1,20,21,
Comanche,Governor,Kevin Stitt,REP,160049,12,12,323,347,
Comanche,Governor,Drew Edmondson,DEM,160049,5,13,162,180,
Comanche,Lieutenant Governor,Matt Pinnell,REP,160049,12,14,360,386,
Comanche,Lieutenant Governor,Anastasia Pittman,DEM,160049,5,10,128,143,
Comanche,Lieutenant Governor,Ivan Holmes,IND,160049,0,1,12,13,
Comanche,State Auditor,John Yeutter,LIB,160049,0,4,81,85,
Comanche,State Auditor,Cindy Byrd,REP,160049,12,17,398,427,
Comanche,Attorney General,Mike Hunter,REP,160049,12,16,373,401,
Comanche,Attorney General,Mark Myles,DEM,160049,5,8,119,132,
Comanche,State Treasurer,Randy Mcdaniel,REP,160049,12,16,398,426,
Comanche,State Treasurer,Charles De Coune,IND,160049,3,5,81,89,
Comanche,Superintendent of Public Instruction,Joy Hofmeister,REP,160049,12,11,326,349,
Comanche,Superintendent of Public Instruction,John Cox,DEM,160049,5,13,126,144,
Comanche,Superintendent of Public Instruction,Larry Huff,IND,160049,0,2,47,49,
Comanche,Commissioner of Labor,Leslie Osborn,REP,160049,12,14,349,375,
Comanche,Commissioner of Labor,Fred Dorrell,DEM,160049,5,11,121,137,
Comanche,Commissioner of Labor,Brandt Dismukes,IND,160049,0,0,23,23,
Comanche,Insurance Commissioner,Glen Mulready,REP,160049,12,16,358,386,
Comanche,Insurance Commissioner,Kimberly Fobbs,DEM,160049,5,8,138,151,
Comanche,Corporation Commissioner,Bob Anthony,REP,160049,12,17,371,400,
Comanche,Corporation Commissioner,Ashley Nicole Mccray,DEM,160049,5,8,109,122,
Comanche,Corporation Commissioner,Jackie Short,IND,160049,0,0,18,18,
Comanche,U.S. House,Tom Cole,REP,160049,12,14,380,406,4
Comanche,U.S. House,Mary Brannon,DEM,160049,5,10,101,116,4
Comanche,U.S. House,Ruby Peters,IND,160049,0,2,17,19,4
Comanche,State House,Toni Hasenbeck,REP,160049,10,17,332,359,65
Comanche,State House,Brandon Thompson,DEM,160049,7,9,165,181,65
Comanche,Governor,Chris Powell,LIB,160050,2,4,24,30,
Comanche,Governor,Kevin Stitt,REP,160050,66,105,596,767,
Comanche,Governor,Drew Edmondson,DEM,160050,47,94,474,615,
Comanche,Lieutenant Governor,Matt Pinnell,REP,160050,64,121,665,850,
Comanche,Lieutenant Governor,Anastasia Pittman,DEM,160050,45,79,382,506,
Comanche,Lieutenant Governor,Ivan Holmes,IND,160050,1,3,40,44,
Comanche,State Auditor,John Yeutter,LIB,160050,21,57,230,308,
Comanche,State Auditor,Cindy Byrd,REP,160050,77,131,776,984,
Comanche,Attorney General,Mike Hunter,REP,160050,67,124,702,893,
Comanche,Attorney General,Mark Myles,DEM,160050,46,79,381,506,
Comanche,State Treasurer,Randy Mcdaniel,REP,160050,72,126,731,929,
Comanche,State Treasurer,Charles De Coune,IND,160050,25,62,270,357,
Comanche,Superintendent of Public Instruction,Joy Hofmeister,REP,160050,77,105,640,822,
Comanche,Superintendent of Public Instruction,John Cox,DEM,160050,31,82,373,486,
Comanche,Superintendent of Public Instruction,Larry Huff,IND,160050,4,16,81,101,
Comanche,Commissioner of Labor,Leslie Osborn,REP,160050,73,116,657,846,
Comanche,Commissioner of Labor,Fred Dorrell,DEM,160050,36,73,369,478,
Comanche,Commissioner of Labor,Brandt Dismukes,IND,160050,2,12,52,66,
Comanche,Insurance Commissioner,Glen Mulready,REP,160050,71,118,675,864,
Comanche,Insurance Commissioner,Kimberly Fobbs,DEM,160050,40,84,400,524,
Comanche,Corporation Commissioner,Bob Anthony,REP,160050,68,118,654,840,
Comanche,Corporation Commissioner,Ashley Nicole Mccray,DEM,160050,41,73,379,493,
Comanche,Corporation Commissioner,Jackie Short,IND,160050,3,12,43,58,
Comanche,U.S. House,Tom Cole,REP,160050,69,128,710,907,4
Comanche,U.S. House,Mary Brannon,DEM,160050,40,57,310,407,4
Comanche,U.S. House,Ruby Peters,IND,160050,2,17,74,93,4
Comanche,State Senate,John Michael Montgomery,REP,160050,73,119,680,872,32
Comanche,State Senate,Jacobi Crowley,DEM,160050,38,84,414,536,32
Comanche,State House,Daniel Pae,REP,160050,66,126,695,887,62
Comanche,State House,Larry Bush,DEM,160050,44,77,398,519,62
Comanche,Governor,Chris Powell,LIB,160051,1,1,25,27,
Comanche,Governor,Kevin Stitt,REP,160051,19,42,428,489,
Comanche,Governor,Drew Edmondson,DEM,160051,16,18,260,294,
Comanche,Lieutenant Governor,Matt Pinnell,REP,160051,27,45,474,546,
Comanche,Lieutenant Governor,Anastasia Pittman,DEM,160051,6,14,205,225,
Comanche,Lieutenant Governor,Ivan Holmes,IND,160051,0,2,29,31,
Comanche,State Auditor,John Yeutter,LIB,160051,3,10,146,159,
Comanche,State Auditor,Cindy Byrd,REP,160051,29,44,529,602,
Comanche,Attorney General,Mike Hunter,REP,160051,26,44,498,568,
Comanche,Attorney General,Mark Myles,DEM,160051,7,17,211,235,
Comanche,State Treasurer,Randy Mcdaniel,REP,160051,26,45,522,593,
Comanche,State Treasurer,Charles De Coune,IND,160051,6,9,156,171,
Comanche,Superintendent of Public Instruction,Joy Hofmeister,REP,160051,24,41,439,504,
Comanche,Superintendent of Public Instruction,John Cox,DEM,160051,12,18,214,244,
Comanche,Superintendent of Public Instruction,Larry Huff,IND,160051,0,1,53,54,
Comanche,Commissioner of Labor,Leslie Osborn,REP,160051,25,43,461,529,
Comanche,Commissioner of Labor,Fred Dorrell,DEM,160051,7,15,202,224,
Comanche,Commissioner of Labor,Brandt Dismukes,IND,160051,1,3,45,49,
Comanche,Insurance Commissioner,Glen Mulready,REP,160051,23,45,473,541,
Comanche,Insurance Commissioner,Kimberly Fobbs,DEM,160051,9,16,232,257,
Comanche,Corporation Commissioner,Bob Anthony,REP,160051,22,38,465,525,
Comanche,Corporation Commissioner,Ashley Nicole Mccray,DEM,160051,10,21,201,232,
Comanche,Corporation Commissioner,Jackie Short,IND,160051,2,2,44,48,
Comanche,U.S. House,Tom Cole,REP,160051,30,43,506,579,4
Comanche,U.S. House,Mary Brannon,DEM,160051,6,16,178,200,4
Comanche,U.S. House,Ruby Peters,IND,160051,0,2,30,32,4
Comanche,State Senate,John Michael Montgomery,REP,160051,27,44,491,562,32
Comanche,State Senate,Jacobi Crowley,DEM,160051,9,17,219,245,32
Comanche,State House,Trey Caldwell,REP,160051,29,44,521,594,63
Comanche,State House,Joan Gabelmann,DEM,160051,5,17,184,206,63
Comanche,Governor,Chris Powell,LIB,160053,0,0,0,0,
Comanche,Governor,Kevin Stitt,REP,160053,0,0,0,0,
Comanche,Governor,Drew Edmondson,DEM,160053,0,0,0,0,
Comanche,Lieutenant Governor,Matt Pinnell,REP,160053,0,0,0,0,
Comanche,Lieutenant Governor,Anastasia Pittman,DEM,160053,0,0,0,0,
Comanche,Lieutenant Governor,Ivan Holmes,IND,160053,0,0,0,0,
Comanche,State Auditor,John Yeutter,LIB,160053,0,0,0,0,
Comanche,State Auditor,Cindy Byrd,REP,160053,0,0,0,0,
Comanche,Attorney General,Mike Hunter,REP,160053,0,0,0,0,
Comanche,Attorney General,Mark Myles,DEM,160053,0,0,0,0,
Comanche,State Treasurer,Randy Mcdaniel,REP,160053,0,0,0,0,
Comanche,State Treasurer,Charles De Coune,IND,160053,0,0,0,0,
Comanche,Superintendent of Public Instruction,Joy Hofmeister,REP,160053,0,0,0,0,
Comanche,Superintendent of Public Instruction,John Cox,DEM,160053,0,0,0,0,
Comanche,Superintendent of Public Instruction,Larry Huff,IND,160053,0,0,0,0,
Comanche,Commissioner of Labor,Leslie Osborn,REP,160053,0,0,0,0,
Comanche,Commissioner of Labor,Fred Dorrell,DEM,160053,0,0,0,0,
Comanche,Commissioner of Labor,Brandt Dismukes,IND,160053,0,0,0,0,
Comanche,Insurance Commissioner,Glen Mulready,REP,160053,0,0,0,0,
Comanche,Insurance Commissioner,Kimberly Fobbs,DEM,160053,0,0,0,0,
Comanche,Corporation Commissioner,Bob Anthony,REP,160053,0,0,0,0,
Comanche,Corporation Commissioner,Ashley Nicole Mccray,DEM,160053,0,0,0,0,
Comanche,Corporation Commissioner,Jackie Short,IND,160053,0,0,0,0,
Comanche,U.S. House,Tom Cole,REP,160053,0,0,0,0,4
Comanche,U.S. House,Mary Brannon,DEM,160053,0,0,0,0,4
Comanche,U.S. House,Ruby Peters,IND,160053,0,0,0,0,4
Comanche,State Senate,John Michael Montgomery,REP,160053,0,0,0,0,32
Comanche,State Senate,Jacobi Crowley,DEM,160053,0,0,0,0,32
Comanche,State House,Toni Hasenbeck,REP,160053,0,0,0,0,65
Comanche,State House,Brandon Thompson,DEM,160053,0,0,0,0,65
Cotton,Governor,Chris Powell,LIB,170001,0,0,4,4,
Cotton,Governor,Kevin Stitt,REP,170001,4,12,57,73,
Cotton,Governor,Drew Edmondson,DEM,170001,3,5,18,26,
Cotton,Lieutenant Governor,Matt Pinnell,REP,170001,3,12,59,74,
Cotton,Lieutenant Governor,Anastasia Pittman,DEM,170001,3,3,16,22,
Cotton,Lieutenant Governor,Ivan Holmes,IND,170001,1,1,4,6,
Cotton,State Auditor,John Yeutter,LIB,170001,3,2,10,15,
Cotton,State Auditor,Cindy Byrd,REP,170001,4,13,66,83,
Cotton,Attorney General,Mike Hunter,REP,170001,3,13,66,82,
Cotton,Attorney General,Mark Myles,DEM,170001,4,3,13,20,
Cotton,State Treasurer,Randy Mcdaniel,REP,170001,3,12,64,79,
Cotton,State Treasurer,Charles De Coune,IND,170001,4,3,11,18,
Cotton,Superintendent of Public Instruction,Joy Hofmeister,REP,170001,3,11,52,66,
Cotton,Superintendent of Public Instruction,John Cox,DEM,170001,3,3,16,22,
Cotton,Superintendent of Public Instruction,Larry Huff,IND,170001,1,2,11,14,
Cotton,Commissioner of Labor,Leslie Osborn,REP,170001,4,10,58,72,
Cotton,Commissioner of Labor,Fred Dorrell,DEM,170001,3,5,13,21,
Cotton,Commissioner of Labor,Brandt Dismukes,IND,170001,0,1,7,8,
Cotton,Insurance Commissioner,Glen Mulready,REP,170001,3,12,60,75,
Cotton,Insurance Commissioner,Kimberly Fobbs,DEM,170001,4,4,18,26,
Cotton,Corporation Commissioner,Bob Anthony,REP,170001,3,13,58,74,
Cotton,Corporation Commissioner,Ashley Nicole Mccray,DEM,170001,3,3,12,18,
Cotton,Corporation Commissioner,Jackie Short,IND,170001,1,0,9,10,
Cotton,U.S. House,Tom Cole,REP,170001,3,15,67,85,4
Cotton,U.S. House,Mary Brannon,DEM,170001,3,2,8,13,4
Cotton,U.S. House,Ruby Peters,IND,170001,1,0,4,5,4
Cotton,State House,Toni Hasenbeck,REP,170001,3,10,47,60,65
Cotton,State House,Brandon Thompson,DEM,170001,4,6,32,42,65
Cotton,Governor,Chris Powell,LIB,170003,0,4,14,18,
Cotton,Governor,Kevin Stitt,REP,170003,19,48,184,251,
Cotton,Governor,Drew Edmondson,DEM,170003,6,11,84,101,
Cotton,Lieutenant Governor,Matt Pinnell,REP,170003,19,49,198,266,
Cotton,Lieutenant Governor,Anastasia Pittman,DEM,170003,6,10,68,84,
Cotton,Lieutenant Governor,Ivan Holmes,IND,170003,0,3,14,17,
Cotton,State Auditor,John Yeutter,LIB,170003,3,8,50,61,
Cotton,State Auditor,Cindy Byrd,REP,170003,21,55,220,296,
Cotton,Attorney General,Mike Hunter,REP,170003,18,56,211,285,
Cotton,Attorney General,Mark Myles,DEM,170003,7,7,67,81,
Cotton,State Treasurer,Randy Mcdaniel,REP,170003,20,54,219,293,
Cotton,State Treasurer,Charles De Coune,IND,170003,4,9,52,65,
Cotton,Superintendent of Public Instruction,Joy Hofmeister,REP,170003,19,51,194,264,
Cotton,Superintendent of Public Instruction,John Cox,DEM,170003,5,10,55,70,
Cotton,Superintendent of Public Instruction,Larry Huff,IND,170003,1,4,29,34,
Cotton,Commissioner of Labor,Leslie Osborn,REP,170003,19,50,194,263,
Cotton,Commissioner of Labor,Fred Dorrell,DEM,170003,6,9,62,77,
Cotton,Commissioner of Labor,Brandt Dismukes,IND,170003,0,4,19,23,
Cotton,Insurance Commissioner,Glen Mulready,REP,170003,19,54,196,269,
Cotton,Insurance Commissioner,Kimberly Fobbs,DEM,170003,6,9,80,95,
Cotton,Corporation Commissioner,Bob Anthony,REP,170003,19,53,194,266,
Cotton,Corporation Commissioner,Ashley Nicole Mccray,DEM,170003,6,8,63,77,
Cotton,Corporation Commissioner,Jackie Short,IND,170003,0,3,17,20,
Cotton,U.S. House,Tom Cole,REP,170003,19,56,227,302,4
Cotton,U.S. House,Mary Brannon,DEM,170003,6,6,43,55,4
Cotton,U.S. House,Ruby Peters,IND,170003,0,3,11,14,4
Cotton,State House,Toni Hasenbeck,REP,170003,18,30,152,200,65
Cotton,State House,Brandon Thompson,DEM,170003,7,34,127,168,65
Cotton,Governor,Chris Powell,LIB,170004,2,1,12,15,
Cotton,Governor,Kevin Stitt,REP,170004,8,33,118,159,
Cotton,Governor,Drew Edmondson,DEM,170004,5,13,81,99,
Cotton,Lieutenant Governor,Matt Pinnell,REP,170004,12,33,139,184,
Cotton,Lieutenant Governor,Anastasia Pittman,DEM,170004,2,13,61,76,
Cotton,Lieutenant Governor,Ivan Holmes,IND,170004,1,0,7,8,
Cotton,State Auditor,John Yeutter,LIB,170004,4,4,41,49,
Cotton,State Auditor,Cindy Byrd,REP,170004,10,41,150,201,
Cotton,Attorney General,Mike Hunter,REP,170004,12,35,145,192,
Cotton,Attorney General,Mark Myles,DEM,170004,2,11,62,75,
Cotton,State Treasurer,Randy Mcdaniel,REP,170004,13,41,148,202,
Cotton,State Treasurer,Charles De Coune,IND,170004,1,3,41,45,
Cotton,Superintendent of Public Instruction,Joy Hofmeister,REP,170004,7,33,131,171,
Cotton,Superintendent of Public Instruction,John Cox,DEM,170004,6,9,58,73,
Cotton,Superintendent of Public Instruction,Larry Huff,IND,170004,1,3,20,24,
Cotton,Commissioner of Labor,Leslie Osborn,REP,170004,8,34,126,168,
Cotton,Commissioner of Labor,Fred Dorrell,DEM,170004,5,10,63,78,
Cotton,Commissioner of Labor,Brandt Dismukes,IND,170004,1,2,15,18,
Cotton,Insurance Commissioner,Glen Mulready,REP,170004,9,35,130,174,
Cotton,Insurance Commissioner,Kimberly Fobbs,DEM,170004,4,12,72,88,
Cotton,Corporation Commissioner,Bob Anthony,REP,170004,9,35,141,185,
Cotton,Corporation Commissioner,Ashley Nicole Mccray,DEM,170004,2,10,56,68,
Cotton,Corporation Commissioner,Jackie Short,IND,170004,3,1,9,13,
Cotton,U.S. House,Tom Cole,REP,170004,11,36,144,191,4
Cotton,U.S. House,Mary Brannon,DEM,170004,2,9,57,68,4
Cotton,U.S. House,Ruby Peters,IND,170004,1,1,7,9,4
Cotton,State House,Toni Hasenbeck,REP,170004,6,30,116,152,65
Cotton,State House,Brandon Thompson,DEM,170004,8,14,91,113,65
Cotton,Governor,Chris Powell,LIB,170005,0,1,13,14,
Cotton,Governor,Kevin Stitt,REP,170005,5,26,181,212,
Cotton,Governor,Drew Edmondson,DEM,170005,6,7,104,117,
Cotton,Lieutenant Governor,Matt Pinnell,REP,170005,6,28,196,230,
Cotton,Lieutenant Governor,Anastasia Pittman,DEM,170005,5,6,95,106,
Cotton,Lieutenant Governor,Ivan Holmes,IND,170005,0,0,7,7,
Cotton,State Auditor,John Yeutter,LIB,170005,1,2,57,60,
Cotton,State Auditor,Cindy Byrd,REP,170005,8,31,223,262,
Cotton,Attorney General,Mike Hunter,REP,170005,7,28,205,240,
Cotton,Attorney General,Mark Myles,DEM,170005,3,6,92,101,
Cotton,State Treasurer,Randy Mcdaniel,REP,170005,8,30,225,263,
Cotton,State Treasurer,Charles De Coune,IND,170005,1,3,54,58,
Cotton,Superintendent of Public Instruction,Joy Hofmeister,REP,170005,7,27,173,207,
Cotton,Superintendent of Public Instruction,John Cox,DEM,170005,4,7,97,108,
Cotton,Superintendent of Public Instruction,Larry Huff,IND,170005,0,0,27,27,
Cotton,Commissioner of Labor,Leslie Osborn,REP,170005,8,28,180,216,
Cotton,Commissioner of Labor,Fred Dorrell,DEM,170005,3,4,97,104,
Cotton,Commissioner of Labor,Brandt Dismukes,IND,170005,0,2,21,23,
Cotton,Insurance Commissioner,Glen Mulready,REP,170005,7,26,201,234,
Cotton,Insurance Commissioner,Kimberly Fobbs,DEM,170005,4,8,96,108,
Cotton,Corporation Commissioner,Bob Anthony,REP,170005,8,28,199,235,
Cotton,Corporation Commissioner,Ashley Nicole Mccray,DEM,170005,3,6,85,94,
Cotton,Corporation Commissioner,Jackie Short,IND,170005,0,0,14,14,
Cotton,U.S. House,Tom Cole,REP,170005,8,29,204,241,4
Cotton,U.S. House,Mary Brannon,DEM,170005,3,4,80,87,4
Cotton,U.S. House,Ruby Peters,IND,170005,0,1,14,15,4
Cotton,State House,Toni Hasenbeck,REP,170005,7,21,158,186,65
Cotton,State House,Brandon Thompson,DEM,170005,4,13,139,156,65
Cotton,Governor,Chris Powell,LIB,170007,0,7,7,14,
Cotton,Governor,Kevin Stitt,REP,170007,2,28,142,172,
Cotton,Governor,Drew Edmondson,DEM,170007,2,13,75,90,
Cotton,Lieutenant Governor,Matt Pinnell,REP,170007,2,32,157,191,
Cotton,Lieutenant Governor,Anastasia Pittman,DEM,170007,2,11,53,66,
Cotton,Lieutenant Governor,Ivan Holmes,IND,170007,0,4,10,14,
Cotton,State Auditor,John Yeutter,LIB,170007,0,11,39,50,
Cotton,State Auditor,Cindy Byrd,REP,170007,3,32,170,205,
Cotton,Attorney General,Mike Hunter,REP,170007,2,34,168,204,
Cotton,Attorney General,Mark Myles,DEM,170007,2,12,54,68,
Cotton,State Treasurer,Randy Mcdaniel,REP,170007,1,33,171,205,
Cotton,State Treasurer,Charles De Coune,IND,170007,1,9,36,46,
Cotton,Superintendent of Public Instruction,Joy Hofmeister,REP,170007,2,30,157,189,
Cotton,Superintendent of Public Instruction,John Cox,DEM,170007,2,11,53,66,
Cotton,Superintendent of Public Instruction,Larry Huff,IND,170007,0,6,13,19,
Cotton,Commissioner of Labor,Leslie Osborn,REP,170007,2,33,159,194,
Cotton,Commissioner of Labor,Fred Dorrell,DEM,170007,2,10,53,65,
Cotton,Commissioner of Labor,Brandt Dismukes,IND,170007,0,4,9,13,
Cotton,Insurance Commissioner,Glen Mulready,REP,170007,2,33,159,194,
Cotton,Insurance Commissioner,Kimberly Fobbs,DEM,170007,2,14,59,75,
Cotton,Corporation Commissioner,Bob Anthony,REP,170007,2,30,162,194,
Cotton,Corporation Commissioner,Ashley Nicole Mccray,DEM,170007,2,11,52,65,
Cotton,Corporation Commissioner,Jackie Short,IND,170007,0,6,4,10,
Cotton,U.S. House,Tom Cole,REP,170007,2,35,170,207,4
Cotton,U.S. House,Mary Brannon,DEM,170007,2,9,48,59,4
Cotton,U.S. House,Ruby Peters,IND,170007,0,4,5,9,4
Cotton,State House,Toni Hasenbeck,REP,170007,1,25,117,143,65
Cotton,State House,Brandon Thompson,DEM,170007,3,23,107,133,65
Cotton,Governor,Chris Powell,LIB,170008,0,1,0,1,
Cotton,Governor,Kevin Stitt,REP,170008,2,3,35,40,
Cotton,Governor,Drew Edmondson,DEM,170008,1,2,15,18,
Cotton,Lieutenant Governor,Matt Pinnell,REP,170008,2,5,37,44,
Cotton,Lieutenant Governor,Anastasia Pittman,DEM,170008,1,1,13,15,
Cotton,Lieutenant Governor,Ivan Holmes,IND,170008,0,0,0,0,
Cotton,State Auditor,John Yeutter,LIB,170008,0,1,5,6,
Cotton,State Auditor,Cindy Byrd,REP,170008,3,5,39,47,
Cotton,Attorney General,Mike Hunter,REP,170008,2,4,38,44,
Cotton,Attorney General,Mark Myles,DEM,170008,1,2,11,14,
Cotton,State Treasurer,Randy Mcdaniel,REP,170008,3,5,37,45,
Cotton,State Treasurer,Charles De Coune,IND,170008,0,1,7,8,
Cotton,Superintendent of Public Instruction,Joy Hofmeister,REP,170008,1,5,31,37,
Cotton,Superintendent of Public Instruction,John Cox,DEM,170008,2,1,16,19,
Cotton,Superintendent of Public Instruction,Larry Huff,IND,170008,0,0,2,2,
Cotton,Commissioner of Labor,Leslie Osborn,REP,170008,2,4,39,45,
Cotton,Commissioner of Labor,Fred Dorrell,DEM,170008,1,2,10,13,
Cotton,Commissioner of Labor,Brandt Dismukes,IND,170008,0,0,0,0,
Cotton,Insurance Commissioner,Glen Mulready,REP,170008,2,5,36,43,
Cotton,Insurance Commissioner,Kimberly Fobbs,DEM,170008,1,1,13,15,
Cotton,Corporation Commissioner,Bob Anthony,REP,170008,2,5,37,44,
Cotton,Corporation Commissioner,Ashley Nicole Mccray,DEM,170008,1,1,12,14,
Cotton,Corporation Commissioner,Jackie Short,IND,170008,0,0,0,0,
Cotton,U.S. House,Tom Cole,REP,170008,2,5,37,44,4
Cotton,U.S. House,Mary Brannon,DEM,170008,1,1,12,14,4
Cotton,U.S. House,Ruby Peters,IND,170008,0,0,0,0,4
Cotton,State House,Toni Hasenbeck,REP,170008,0,3,28,31,65
Cotton,State House,Brandon Thompson,DEM,170008,3,3,21,27,65
Cotton,Governor,Chris Powell,LIB,170009,0,2,11,13,
Cotton,Governor,Kevin Stitt,REP,170009,4,33,114,151,
Cotton,Governor,Drew Edmondson,DEM,170009,5,8,78,91,
Cotton,Lieutenant Governor,Matt Pinnell,REP,170009,4,37,142,183,
Cotton,Lieutenant Governor,Anastasia Pittman,DEM,170009,4,2,55,61,
Cotton,Lieutenant Governor,Ivan Holmes,IND,170009,0,3,4,7,
Cotton,State Auditor,John Yeutter,LIB,170009,3,3,34,40,
Cotton,State Auditor,Cindy Byrd,REP,170009,4,38,162,204,
Cotton,Attorney General,Mike Hunter,REP,170009,4,34,147,185,
Cotton,Attorney General,Mark Myles,DEM,170009,4,7,54,65,
Cotton,State Treasurer,Randy Mcdaniel,REP,170009,4,37,158,199,
Cotton,State Treasurer,Charles De Coune,IND,170009,3,4,40,47,
Cotton,Superintendent of Public Instruction,Joy Hofmeister,REP,170009,4,30,128,162,
Cotton,Superintendent of Public Instruction,John Cox,DEM,170009,5,5,57,67,
Cotton,Superintendent of Public Instruction,Larry Huff,IND,170009,0,7,16,23,
Cotton,Commissioner of Labor,Leslie Osborn,REP,170009,4,35,134,173,
Cotton,Commissioner of Labor,Fred Dorrell,DEM,170009,4,4,53,61,
Cotton,Commissioner of Labor,Brandt Dismukes,IND,170009,0,2,14,16,
Cotton,Insurance Commissioner,Glen Mulready,REP,170009,4,33,142,179,
Cotton,Insurance Commissioner,Kimberly Fobbs,DEM,170009,4,7,58,69,
Cotton,Corporation Commissioner,Bob Anthony,REP,170009,3,32,135,170,
Cotton,Corporation Commissioner,Ashley Nicole Mccray,DEM,170009,4,4,50,58,
Cotton,Corporation Commissioner,Jackie Short,IND,170009,1,6,14,21,
Cotton,U.S. House,Tom Cole,REP,170009,6,36,150,192,4
Cotton,U.S. House,Mary Brannon,DEM,170009,3,3,46,52,4
Cotton,U.S. House,Ruby Peters,IND,170009,0,3,7,10,4
Cotton,State House,Toni Hasenbeck,REP,170009,2,21,97,120,65
Cotton,State House,Brandon Thompson,DEM,170009,7,22,106,135,65
Cotton,Governor,Chris Powell,LIB,170010,0,0,6,6,
Cotton,Governor,Kevin Stitt,REP,170010,1,4,100,105,
Cotton,Governor,Drew Edmondson,DEM,170010,3,2,21,26,
Cotton,Lieutenant Governor,Matt Pinnell,REP,170010,2,4,109,115,
Cotton,Lieutenant Governor,Anastasia Pittman,DEM,170010,2,2,14,18,
Cotton,Lieutenant Governor,Ivan Holmes,IND,170010,0,0,3,3,
Cotton,State Auditor,John Yeutter,LIB,170010,0,0,10,10,
Cotton,State Auditor,Cindy Byrd,REP,170010,3,4,112,119,
Cotton,Attorney General,Mike Hunter,REP,170010,2,4,107,113,
Cotton,Attorney General,Mark Myles,DEM,170010,2,2,18,22,
Cotton,State Treasurer,Randy Mcdaniel,REP,170010,3,4,113,120,
Cotton,State Treasurer,Charles De Coune,IND,170010,0,0,9,9,
Cotton,Superintendent of Public Instruction,Joy Hofmeister,REP,170010,2,4,99,105,
Cotton,Superintendent of Public Instruction,John Cox,DEM,170010,2,2,20,24,
Cotton,Superintendent of Public Instruction,Larry Huff,IND,170010,0,0,7,7,
Cotton,Commissioner of Labor,Leslie Osborn,REP,170010,2,4,105,111,
Cotton,Commissioner of Labor,Fred Dorrell,DEM,170010,0,2,15,17,
Cotton,Commissioner of Labor,Brandt Dismukes,IND,170010,0,0,5,5,
Cotton,Insurance Commissioner,Glen Mulready,REP,170010,2,4,111,117,
Cotton,Insurance Commissioner,Kimberly Fobbs,DEM,170010,1,2,16,19,
Cotton,Corporation Commissioner,Bob Anthony,REP,170010,2,4,103,109,
Cotton,Corporation Commissioner,Ashley Nicole Mccray,DEM,170010,2,2,16,20,
Cotton,Corporation Commissioner,Jackie Short,IND,170010,0,0,7,7,
Cotton,U.S. House,Tom Cole,REP,170010,3,4,111,118,4
Cotton,U.S. House,Mary Brannon,DEM,170010,1,2,11,14,4
Cotton,U.S. House,Ruby Peters,IND,170010,0,0,5,5,4
Cotton,State House,Toni Hasenbeck,REP,170010,2,4,86,92,65
Cotton,State House,Brandon Thompson,DEM,170010,2,2,38,42,65
Cotton,Governor,Chris Powell,LIB,170011,0,0,10,10,
Cotton,Governor,Kevin Stitt,REP,170011,0,7,142,149,
Cotton,Governor,Drew Edmondson,DEM,170011,0,4,26,30,
Cotton,Lieutenant Governor,Matt Pinnell,REP,170011,0,9,156,165,
Cotton,Lieutenant Governor,Anastasia Pittman,DEM,170011,0,2,14,16,
Cotton,Lieutenant Governor,Ivan Holmes,IND,170011,0,0,7,7,
Cotton,State Auditor,John Yeutter,LIB,170011,0,0,11,11,
Cotton,State Auditor,Cindy Byrd,REP,170011,0,9,159,168,
Cotton,Attorney General,Mike Hunter,REP,170011,0,9,154,163,
Cotton,Attorney General,Mark Myles,DEM,170011,0,2,22,24,
Cotton,State Treasurer,Randy Mcdaniel,REP,170011,0,9,161,170,
Cotton,State Treasurer,Charles De Coune,IND,170011,0,0,12,12,
Cotton,Superintendent of Public Instruction,Joy Hofmeister,REP,170011,0,9,141,150,
Cotton,Superintendent of Public Instruction,John Cox,DEM,170011,0,2,15,17,
Cotton,Superintendent of Public Instruction,Larry Huff,IND,170011,0,0,16,16,
Cotton,Commissioner of Labor,Leslie Osborn,REP,170011,0,8,139,147,
Cotton,Commissioner of Labor,Fred Dorrell,DEM,170011,0,3,26,29,
Cotton,Commissioner of Labor,Brandt Dismukes,IND,170011,0,0,8,8,
Cotton,Insurance Commissioner,Glen Mulready,REP,170011,0,9,151,160,
Cotton,Insurance Commissioner,Kimberly Fobbs,DEM,170011,0,2,23,25,
Cotton,Corporation Commissioner,Bob Anthony,REP,170011,0,8,150,158,
Cotton,Corporation Commissioner,Ashley Nicole Mccray,DEM,170011,0,3,14,17,
Cotton,Corporation Commissioner,Jackie Short,IND,170011,0,0,12,12,
Cotton,U.S. House,Tom Cole,REP,170011,0,9,151,160,4
Cotton,U.S. House,Mary Brannon,DEM,170011,0,2,14,16,4
Cotton,U.S. House,Ruby Peters,IND,170011,0,0,9,9,4
Cotton,State House,Toni Hasenbeck,REP,170011,0,7,140,147,65
Cotton,State House,Brandon Thompson,DEM,170011,0,4,39,43,65
Craig,Governor,Chris Powell,LIB,180140,0,0,18,18,
Craig,Governor,Kevin Stitt,REP,180140,3,11,353,367,
Craig,Governor,Drew Edmondson,DEM,180140,4,8,166,178,
Craig,Lieutenant Governor,Matt Pinnell,REP,180140,3,11,400,414,
Craig,Lieutenant Governor,Anastasia Pittman,DEM,180140,4,8,119,131,
Craig,Lieutenant Governor,Ivan Holmes,IND,180140,0,0,20,20,
Craig,State Auditor,John Yeutter,LIB,180140,1,5,93,99,
Craig,State Auditor,Cindy Byrd,REP,180140,6,13,423,442,
Craig,Attorney General,Mike Hunter,REP,180140,5,11,407,423,
Craig,Attorney General,Mark Myles,DEM,180140,2,8,129,139,
Craig,State Treasurer,Randy Mcdaniel,REP,180140,6,11,422,439,
Craig,State Treasurer,Charles De Coune,IND,180140,1,6,92,99,
Craig,Superintendent of Public Instruction,Joy Hofmeister,REP,180140,6,9,319,334,
Craig,Superintendent of Public Instruction,John Cox,DEM,180140,1,10,178,189,
Craig,Superintendent of Public Instruction,Larry Huff,IND,180140,0,0,45,45,
Craig,Commissioner of Labor,Leslie Osborn,REP,180140,5,15,365,385,
Craig,Commissioner of Labor,Fred Dorrell,DEM,180140,2,4,143,149,
Craig,Commissioner of Labor,Brandt Dismukes,IND,180140,0,0,27,27,
Craig,Insurance Commissioner,Glen Mulready,REP,180140,3,9,378,390,
Craig,Insurance Commissioner,Kimberly Fobbs,DEM,180140,4,10,156,170,
Craig,Corporation Commissioner,Bob Anthony,REP,180140,4,10,364,378,
Craig,Corporation Commissioner,Ashley Nicole Mccray,DEM,180140,3,9,138,150,
Craig,Corporation Commissioner,Jackie Short,IND,180140,0,0,31,31,
Craig,U.S. House,Richard Castaldo,LIB,180140,0,0,8,8,2
Craig,U.S. House,Markwayne Mullin,REP,180140,6,12,386,404,2
Craig,U.S. House,Jason Nichols,DEM,180140,1,7,126,134,2
Craig,U.S. House,John Foreman,IND,180140,0,0,20,20,2
Craig,State House,Rusty Cornwell,REP,180140,6,11,360,377,6
Craig,State House,John Myers,DEM,180140,1,8,180,189,6
Craig,Governor,Chris Powell,LIB,180320,0,0,5,5,
Craig,Governor,Kevin Stitt,REP,180320,9,10,83,102,
Craig,Governor,Drew Edmondson,DEM,180320,4,2,36,42,
Craig,Lieutenant Governor,Matt Pinnell,REP,180320,10,10,81,101,
Craig,Lieutenant Governor,Anastasia Pittman,DEM,180320,3,2,37,42,
Craig,Lieutenant Governor,Ivan Holmes,IND,180320,0,0,6,6,
Craig,State Auditor,John Yeutter,LIB,180320,3,1,27,31,
Craig,State Auditor,Cindy Byrd,REP,180320,10,11,87,108,
Craig,Attorney General,Mike Hunter,REP,180320,11,11,82,104,
Craig,Attorney General,Mark Myles,DEM,180320,2,1,40,43,
Craig,State Treasurer,Randy Mcdaniel,REP,180320,11,11,95,117,
Craig,State Treasurer,Charles De Coune,IND,180320,2,1,21,24,
Craig,Superintendent of Public Instruction,Joy Hofmeister,REP,180320,6,10,70,86,
Craig,Superintendent of Public Instruction,John Cox,DEM,180320,4,2,47,53,
Craig,Superintendent of Public Instruction,Larry Huff,IND,180320,3,0,7,10,
Craig,Commissioner of Labor,Leslie Osborn,REP,180320,12,7,78,97,
Craig,Commissioner of Labor,Fred Dorrell,DEM,180320,1,5,40,46,
Craig,Commissioner of Labor,Brandt Dismukes,IND,180320,0,0,4,4,
Craig,Insurance Commissioner,Glen Mulready,REP,180320,10,10,77,97,
Craig,Insurance Commissioner,Kimberly Fobbs,DEM,180320,3,2,45,50,
Craig,Corporation Commissioner,Bob Anthony,REP,180320,9,10,78,97,
Craig,Corporation Commissioner,Ashley Nicole Mccray,DEM,180320,4,2,35,41,
Craig,Corporation Commissioner,Jackie Short,IND,180320,0,0,9,9,
Craig,U.S. House,Richard Castaldo,LIB,180320,0,0,1,1,2
Craig,U.S. House,Markwayne Mullin,REP,180320,11,11,91,113,2
Craig,U.S. House,Jason Nichols,DEM,180320,1,1,25,27,2
Craig,U.S. House,John Foreman,IND,180320,1,0,7,8,2
Craig,State House,Rusty Cornwell,REP,180320,6,5,78,89,6
Craig,State House,John Myers,DEM,180320,7,7,47,61,6
Craig,Governor,Chris Powell,LIB,180410,0,1,12,13,
Craig,Governor,Kevin Stitt,REP,180410,2,15,197,214,
Craig,Governor,Drew Edmondson,DEM,180410,3,4,121,128,
Craig,Lieutenant Governor,Matt Pinnell,REP,180410,2,17,220,239,
Craig,Lieutenant Governor,Anastasia Pittman,DEM,180410,3,3,94,100,
Craig,Lieutenant Governor,Ivan Holmes,IND,180410,0,0,12,12,
Craig,State Auditor,John Yeutter,LIB,180410,3,1,79,83,
Craig,State Auditor,Cindy Byrd,REP,180410,2,18,228,248,
Craig,Attorney General,Mike Hunter,REP,180410,2,17,211,230,
Craig,Attorney General,Mark Myles,DEM,180410,3,3,113,119,
Craig,State Treasurer,Randy Mcdaniel,REP,180410,2,18,233,253,
Craig,State Treasurer,Charles De Coune,IND,180410,3,1,73,77,
Craig,Superintendent of Public Instruction,Joy Hofmeister,REP,180410,3,17,184,204,
Craig,Superintendent of Public Instruction,John Cox,DEM,180410,2,3,118,123,
Craig,Superintendent of Public Instruction,Larry Huff,IND,180410,0,0,26,26,
Craig,Commissioner of Labor,Leslie Osborn,REP,180410,2,15,194,211,
Craig,Commissioner of Labor,Fred Dorrell,DEM,180410,3,5,111,119,
Craig,Commissioner of Labor,Brandt Dismukes,IND,180410,0,0,18,18,
Craig,Insurance Commissioner,Glen Mulready,REP,180410,2,15,209,226,
Craig,Insurance Commissioner,Kimberly Fobbs,DEM,180410,3,5,114,122,
Craig,Corporation Commissioner,Bob Anthony,REP,180410,2,16,200,218,
Craig,Corporation Commissioner,Ashley Nicole Mccray,DEM,180410,3,3,98,104,
Craig,Corporation Commissioner,Jackie Short,IND,180410,0,1,25,26,
Craig,U.S. House,Richard Castaldo,LIB,180410,0,0,6,6,2
Craig,U.S. House,Markwayne Mullin,REP,180410,2,17,225,244,2
Craig,U.S. House,Jason Nichols,DEM,180410,3,3,91,97,2
Craig,U.S. House,John Foreman,IND,180410,0,0,9,9,2
Craig,State House,Rusty Cornwell,REP,180410,2,13,216,231,6
Craig,State House,John Myers,DEM,180410,3,7,111,121,6
Craig,Governor,Chris Powell,LIB,180520,0,0,6,6,
Craig,Governor,Kevin Stitt,REP,180520,2,13,215,230,
Craig,Governor,Drew Edmondson,DEM,180520,4,10,106,120,
Craig,Lieutenant Governor,Matt Pinnell,REP,180520,2,14,226,242,
Craig,Lieutenant Governor,Anastasia Pittman,DEM,180520,3,9,92,104,
Craig,Lieutenant Governor,Ivan Holmes,IND,180520,1,0,7,8,
Craig,State Auditor,John Yeutter,LIB,180520,2,5,54,61,
Craig,State Auditor,Cindy Byrd,REP,180520,4,17,261,282,
Craig,Attorney General,Mike Hunter,REP,180520,2,13,239,254,
Craig,Attorney General,Mark Myles,DEM,180520,4,10,86,100,
Craig,State Treasurer,Randy Mcdaniel,REP,180520,4,14,257,275,
Craig,State Treasurer,Charles De Coune,IND,180520,2,8,56,66,
Craig,Superintendent of Public Instruction,Joy Hofmeister,REP,180520,2,10,191,203,
Craig,Superintendent of Public Instruction,John Cox,DEM,180520,4,13,107,124,
Craig,Superintendent of Public Instruction,Larry Huff,IND,180520,0,0,28,28,
Craig,Commissioner of Labor,Leslie Osborn,REP,180520,2,13,213,228,
Craig,Commissioner of Labor,Fred Dorrell,DEM,180520,4,10,99,113,
Craig,Commissioner of Labor,Brandt Dismukes,IND,180520,0,0,10,10,
Craig,Insurance Commissioner,Glen Mulready,REP,180520,2,15,227,244,
Craig,Insurance Commissioner,Kimberly Fobbs,DEM,180520,4,8,94,106,
Craig,Corporation Commissioner,Bob Anthony,REP,180520,2,15,224,241,
Craig,Corporation Commissioner,Ashley Nicole Mccray,DEM,180520,4,8,89,101,
Craig,Corporation Commissioner,Jackie Short,IND,180520,0,0,11,11,
Craig,U.S. House,Richard Castaldo,LIB,180520,0,0,1,1,2
Craig,U.S. House,Markwayne Mullin,REP,180520,2,13,243,258,2
Craig,U.S. House,Jason Nichols,DEM,180520,4,9,71,84,2
Craig,U.S. House,John Foreman,IND,180520,0,1,12,13,2
Craig,State House,Rusty Cornwell,REP,180520,2,11,211,224,6
Craig,State House,John Myers,DEM,180520,4,12,117,133,6
Craig,Governor,Chris Powell,LIB,180611,0,0,21,21,
Craig,Governor,Kevin Stitt,REP,180611,3,21,156,180,
Craig,Governor,Drew Edmondson,DEM,180611,3,15,154,172,
Craig,Lieutenant Governor,Matt Pinnell,REP,180611,3,25,207,235,
Craig,Lieutenant Governor,Anastasia Pittman,DEM,180611,3,11,111,125,
Craig,Lieutenant Governor,Ivan Holmes,IND,180611,0,0,12,12,
Craig,State Auditor,John Yeutter,LIB,180611,1,6,82,89,
Craig,State Auditor,Cindy Byrd,REP,180611,4,28,232,264,
Craig,Attorney General,Mike Hunter,REP,180611,3,24,197,224,
Craig,Attorney General,Mark Myles,DEM,180611,3,12,132,147,
Craig,State Treasurer,Randy Mcdaniel,REP,180611,3,27,244,274,
Craig,State Treasurer,Charles De Coune,IND,180611,2,7,67,76,
Craig,Superintendent of Public Instruction,Joy Hofmeister,REP,180611,3,21,177,201,
Craig,Superintendent of Public Instruction,John Cox,DEM,180611,2,13,133,148,
Craig,Superintendent of Public Instruction,Larry Huff,IND,180611,1,2,23,26,
Craig,Commissioner of Labor,Leslie Osborn,REP,180611,3,24,189,216,
Craig,Commissioner of Labor,Fred Dorrell,DEM,180611,3,12,127,142,
Craig,Commissioner of Labor,Brandt Dismukes,IND,180611,0,0,14,14,
Craig,Insurance Commissioner,Glen Mulready,REP,180611,3,20,197,220,
Craig,Insurance Commissioner,Kimberly Fobbs,DEM,180611,3,15,133,151,
Craig,Corporation Commissioner,Bob Anthony,REP,180611,3,22,182,207,
Craig,Corporation Commissioner,Ashley Nicole Mccray,DEM,180611,2,12,124,138,
Craig,Corporation Commissioner,Jackie Short,IND,180611,1,2,23,26,
Craig,U.S. House,Richard Castaldo,LIB,180611,0,0,10,10,2
Craig,U.S. House,Markwayne Mullin,REP,180611,3,23,211,237,2
Craig,U.S. House,Jason Nichols,DEM,180611,2,12,102,116,2
Craig,U.S. House,John Foreman,IND,180611,0,1,10,11,2
Craig,State House,Rusty Cornwell,REP,180611,3,21,198,222,6
Craig,State House,John Myers,DEM,180611,3,15,136,154,6
Craig,Governor,Chris Powell,LIB,180612,0,0,10,10,
Craig,Governor,Kevin Stitt,REP,180612,3,18,120,141,
Craig,Governor,Drew Edmondson,DEM,180612,9,9,108,126,
Craig,Lieutenant Governor,Matt Pinnell,REP,180612,6,18,147,171,
Craig,Lieutenant Governor,Anastasia Pittman,DEM,180612,5,8,81,94,
Craig,Lieutenant Governor,Ivan Holmes,IND,180612,0,1,8,9,
Craig,State Auditor,John Yeutter,LIB,180612,3,3,48,54,
Craig,State Auditor,Cindy Byrd,REP,180612,6,20,172,198,
Craig,Attorney General,Mike Hunter,REP,180612,5,19,149,173,
Craig,Attorney General,Mark Myles,DEM,180612,5,8,90,103,
Craig,State Treasurer,Randy Mcdaniel,REP,180612,6,20,173,199,
Craig,State Treasurer,Charles De Coune,IND,180612,2,3,45,50,
Craig,Superintendent of Public Instruction,Joy Hofmeister,REP,180612,7,15,132,154,
Craig,Superintendent of Public Instruction,John Cox,DEM,180612,5,11,90,106,
Craig,Superintendent of Public Instruction,Larry Huff,IND,180612,0,1,14,15,
Craig,Commissioner of Labor,Leslie Osborn,REP,180612,5,19,135,159,
Craig,Commissioner of Labor,Fred Dorrell,DEM,180612,5,7,92,104,
Craig,Commissioner of Labor,Brandt Dismukes,IND,180612,0,1,6,7,
Craig,Insurance Commissioner,Glen Mulready,REP,180612,6,17,146,169,
Craig,Insurance Commissioner,Kimberly Fobbs,DEM,180612,5,9,87,101,
Craig,Corporation Commissioner,Bob Anthony,REP,180612,7,16,146,169,
Craig,Corporation Commissioner,Ashley Nicole Mccray,DEM,180612,4,9,81,94,
Craig,Corporation Commissioner,Jackie Short,IND,180612,0,1,8,9,
Craig,U.S. House,Richard Castaldo,LIB,180612,0,0,0,0,2
Craig,U.S. House,Markwayne Mullin,REP,180612,8,19,150,177,2
Craig,U.S. House,Jason Nichols,DEM,180612,3,8,79,90,2
Craig,U.S. House,John Foreman,IND,180612,0,0,8,8,2
Craig,State House,Rusty Cornwell,REP,180612,6,19,139,164,6
Craig,State House,John Myers,DEM,180612,6,8,99,113,6
Craig,Governor,Chris Powell,LIB,180621,0,3,17,20,
Craig,Governor,Kevin Stitt,REP,180621,7,39,286,332,
Craig,Governor,Drew Edmondson,DEM,180621,14,36,216,266,
Craig,Lieutenant Governor,Matt Pinnell,REP,180621,12,48,332,392,
Craig,Lieutenant Governor,Anastasia Pittman,DEM,180621,9,27,177,213,
Craig,Lieutenant Governor,Ivan Holmes,IND,180621,0,2,12,14,
Craig,State Auditor,John Yeutter,LIB,180621,5,19,106,130,
Craig,State Auditor,Cindy Byrd,REP,180621,15,57,379,451,
Craig,Attorney General,Mike Hunter,REP,180621,11,46,337,394,
Craig,Attorney General,Mark Myles,DEM,180621,10,31,180,221,
Craig,State Treasurer,Randy Mcdaniel,REP,180621,15,52,387,454,
Craig,State Treasurer,Charles De Coune,IND,180621,5,23,99,127,
Craig,Superintendent of Public Instruction,Joy Hofmeister,REP,180621,11,43,281,335,
Craig,Superintendent of Public Instruction,John Cox,DEM,180621,10,31,202,243,
Craig,Superintendent of Public Instruction,Larry Huff,IND,180621,0,4,37,41,
Craig,Commissioner of Labor,Leslie Osborn,REP,180621,12,43,310,365,
Craig,Commissioner of Labor,Fred Dorrell,DEM,180621,9,31,183,223,
Craig,Commissioner of Labor,Brandt Dismukes,IND,180621,0,3,22,25,
Craig,Insurance Commissioner,Glen Mulready,REP,180621,9,46,320,375,
Craig,Insurance Commissioner,Kimberly Fobbs,DEM,180621,12,30,193,235,
Craig,Corporation Commissioner,Bob Anthony,REP,180621,10,42,312,364,
Craig,Corporation Commissioner,Ashley Nicole Mccray,DEM,180621,10,29,181,220,
Craig,Corporation Commissioner,Jackie Short,IND,180621,1,6,21,28,
Craig,U.S. House,Richard Castaldo,LIB,180621,0,0,5,5,2
Craig,U.S. House,Markwayne Mullin,REP,180621,13,46,336,395,2
Craig,U.S. House,Jason Nichols,DEM,180621,8,29,169,206,2
Craig,U.S. House,John Foreman,IND,180621,0,3,9,12,2
Craig,State House,Rusty Cornwell,REP,180621,11,40,312,363,6
Craig,State House,John Myers,DEM,180621,10,38,208,256,6
Craig,Governor,Chris Powell,LIB,180622,0,2,11,13,
Craig,Governor,Kevin Stitt,REP,180622,3,14,162,179,
Craig,Governor,Drew Edmondson,DEM,180622,6,17,161,184,
Craig,Lieutenant Governor,Matt Pinnell,REP,180622,2,16,186,204,
Craig,Lieutenant Governor,Anastasia Pittman,DEM,180622,7,14,135,156,
Craig,Lieutenant Governor,Ivan Holmes,IND,180622,0,1,10,11,
Craig,State Auditor,John Yeutter,LIB,180622,5,10,90,105,
Craig,State Auditor,Cindy Byrd,REP,180622,3,19,222,244,
Craig,Attorney General,Mike Hunter,REP,180622,3,16,184,203,
Craig,Attorney General,Mark Myles,DEM,180622,6,15,147,168,
Craig,State Treasurer,Randy Mcdaniel,REP,180622,3,20,218,241,
Craig,State Treasurer,Charles De Coune,IND,180622,5,9,93,107,
Craig,Superintendent of Public Instruction,Joy Hofmeister,REP,180622,3,16,163,182,
Craig,Superintendent of Public Instruction,John Cox,DEM,180622,6,14,149,169,
Craig,Superintendent of Public Instruction,Larry Huff,IND,180622,0,3,22,25,
Craig,Commissioner of Labor,Leslie Osborn,REP,180622,2,16,177,195,
Craig,Commissioner of Labor,Fred Dorrell,DEM,180622,7,14,137,158,
Craig,Commissioner of Labor,Brandt Dismukes,IND,180622,0,2,17,19,
Craig,Insurance Commissioner,Glen Mulready,REP,180622,3,16,177,196,
Craig,Insurance Commissioner,Kimberly Fobbs,DEM,180622,6,16,152,174,
Craig,Corporation Commissioner,Bob Anthony,REP,180622,3,16,174,193,
Craig,Corporation Commissioner,Ashley Nicole Mccray,DEM,180622,6,14,137,157,
Craig,Corporation Commissioner,Jackie Short,IND,180622,0,1,19,20,
Craig,U.S. House,Richard Castaldo,LIB,180622,0,0,6,6,2
Craig,U.S. House,Markwayne Mullin,REP,180622,3,17,182,202,2
Craig,U.S. House,Jason Nichols,DEM,180622,6,16,139,161,2
Craig,U.S. House,John Foreman,IND,180622,0,0,6,6,2
Craig,State House,Rusty Cornwell,REP,180622,4,15,171,190,6
Craig,State House,John Myers,DEM,180622,5,18,163,186,6
Craig,Governor,Chris Powell,LIB,180710,0,0,11,11,
Craig,Governor,Kevin Stitt,REP,180710,12,12,200,224,
Craig,Governor,Drew Edmondson,DEM,180710,10,10,84,104,
Craig,Lieutenant Governor,Matt Pinnell,REP,180710,15,14,217,246,
Craig,Lieutenant Governor,Anastasia Pittman,DEM,180710,7,7,68,82,
Craig,Lieutenant Governor,Ivan Holmes,IND,180710,0,1,8,9,
Craig,State Auditor,John Yeutter,LIB,180710,7,5,55,67,
Craig,State Auditor,Cindy Byrd,REP,180710,11,16,224,251,
Craig,Attorney General,Mike Hunter,REP,180710,15,13,213,241,
Craig,Attorney General,Mark Myles,DEM,180710,6,9,77,92,
Craig,State Treasurer,Randy Mcdaniel,REP,180710,16,16,239,271,
Craig,State Treasurer,Charles De Coune,IND,180710,3,5,45,53,
Craig,Superintendent of Public Instruction,Joy Hofmeister,REP,180710,12,12,190,214,
Craig,Superintendent of Public Instruction,John Cox,DEM,180710,8,8,84,100,
Craig,Superintendent of Public Instruction,Larry Huff,IND,180710,1,2,17,20,
Craig,Commissioner of Labor,Leslie Osborn,REP,180710,10,12,207,229,
Craig,Commissioner of Labor,Fred Dorrell,DEM,180710,8,8,63,79,
Craig,Commissioner of Labor,Brandt Dismukes,IND,180710,3,2,17,22,
Craig,Insurance Commissioner,Glen Mulready,REP,180710,14,11,212,237,
Craig,Insurance Commissioner,Kimberly Fobbs,DEM,180710,7,11,77,95,
Craig,Corporation Commissioner,Bob Anthony,REP,180710,12,13,200,225,
Craig,Corporation Commissioner,Ashley Nicole Mccray,DEM,180710,6,8,70,84,
Craig,Corporation Commissioner,Jackie Short,IND,180710,3,1,20,24,
Craig,U.S. House,Richard Castaldo,LIB,180710,0,0,3,3,2
Craig,U.S. House,Markwayne Mullin,REP,180710,15,16,228,259,2
Craig,U.S. House,Jason Nichols,DEM,180710,6,5,56,67,2
Craig,U.S. House,John Foreman,IND,180710,1,1,6,8,2
Craig,State House,Rusty Cornwell,REP,180710,11,14,201,226,6
Craig,State House,John Myers,DEM,180710,10,8,93,111,6
Craig,Governor,Chris Powell,LIB,180810,1,0,12,13,
Craig,Governor,Kevin Stitt,REP,180810,4,32,303,339,
Craig,Governor,Drew Edmondson,DEM,180810,7,12,113,132,
Craig,Lieutenant Governor,Matt Pinnell,REP,180810,7,32,324,363,
Craig,Lieutenant Governor,Anastasia Pittman,DEM,180810,5,11,91,107,
Craig,Lieutenant Governor,Ivan Holmes,IND,180810,0,0,13,13,
Craig,State Auditor,John Yeutter,LIB,180810,1,1,88,90,
Craig,State Auditor,Cindy Byrd,REP,180810,7,42,330,379,
Craig,Attorney General,Mike Hunter,REP,180810,5,33,327,365,
Craig,Attorney General,Mark Myles,DEM,180810,7,11,98,116,
Craig,State Treasurer,Randy Mcdaniel,REP,180810,7,42,347,396,
Craig,State Treasurer,Charles De Coune,IND,180810,3,2,68,73,
Craig,Superintendent of Public Instruction,Joy Hofmeister,REP,180810,4,30,275,309,
Craig,Superintendent of Public Instruction,John Cox,DEM,180810,6,9,117,132,
Craig,Superintendent of Public Instruction,Larry Huff,IND,180810,1,2,34,37,
Craig,Commissioner of Labor,Leslie Osborn,REP,180810,5,28,305,338,
Craig,Commissioner of Labor,Fred Dorrell,DEM,180810,6,13,94,113,
Craig,Commissioner of Labor,Brandt Dismukes,IND,180810,1,1,23,25,
Craig,Insurance Commissioner,Glen Mulready,REP,180810,6,31,316,353,
Craig,Insurance Commissioner,Kimberly Fobbs,DEM,180810,6,13,107,126,
Craig,Corporation Commissioner,Bob Anthony,REP,180810,5,31,305,341,
Craig,Corporation Commissioner,Ashley Nicole Mccray,DEM,180810,6,12,88,106,
Craig,Corporation Commissioner,Jackie Short,IND,180810,1,1,32,34,
Craig,U.S. House,Richard Castaldo,LIB,180810,1,1,3,5,2
Craig,U.S. House,Markwayne Mullin,REP,180810,6,33,335,374,2
Craig,U.S. House,Jason Nichols,DEM,180810,5,9,84,98,2
Craig,U.S. House,John Foreman,IND,180810,0,1,7,8,2
Craig,State House,Rusty Cornwell,REP,180810,4,26,303,333,6
Craig,State House,John Myers,DEM,180810,8,18,125,151,6
Craig,Governor,Chris Powell,LIB,180820,0,0,27,27,
Craig,Governor,Kevin Stitt,REP,180820,10,30,304,344,
Craig,Governor,Drew Edmondson,DEM,180820,3,14,124,141,
Craig,Lieutenant Governor,Matt Pinnell,REP,180820,10,33,336,379,
Craig,Lieutenant Governor,Anastasia Pittman,DEM,180820,3,9,97,109,
Craig,Lieutenant Governor,Ivan Holmes,IND,180820,0,1,15,16,
Craig,State Auditor,John Yeutter,LIB,180820,1,8,72,81,
Craig,State Auditor,Cindy Byrd,REP,180820,12,35,365,412,
Craig,Attorney General,Mike Hunter,REP,180820,10,34,336,380,
Craig,Attorney General,Mark Myles,DEM,180820,3,9,104,116,
Craig,State Treasurer,Randy Mcdaniel,REP,180820,11,33,375,419,
Craig,State Treasurer,Charles De Coune,IND,180820,2,8,62,72,
Craig,Superintendent of Public Instruction,Joy Hofmeister,REP,180820,9,22,287,318,
Craig,Superintendent of Public Instruction,John Cox,DEM,180820,4,14,126,144,
Craig,Superintendent of Public Instruction,Larry Huff,IND,180820,0,5,37,42,
Craig,Commissioner of Labor,Leslie Osborn,REP,180820,10,31,323,364,
Craig,Commissioner of Labor,Fred Dorrell,DEM,180820,3,10,98,111,
Craig,Commissioner of Labor,Brandt Dismukes,IND,180820,0,1,22,23,
Craig,Insurance Commissioner,Glen Mulready,REP,180820,10,33,337,380,
Craig,Insurance Commissioner,Kimberly Fobbs,DEM,180820,3,9,108,120,
Craig,Corporation Commissioner,Bob Anthony,REP,180820,10,28,324,362,
Craig,Corporation Commissioner,Ashley Nicole Mccray,DEM,180820,2,11,97,110,
Craig,Corporation Commissioner,Jackie Short,IND,180820,1,3,23,27,
Craig,U.S. House,Richard Castaldo,LIB,180820,0,0,9,9,2
Craig,U.S. House,Markwayne Mullin,REP,180820,10,35,325,370,2
Craig,U.S. House,Jason Nichols,DEM,180820,3,8,100,111,2
Craig,U.S. House,John Foreman,IND,180820,0,0,19,19,2
Craig,State House,Rusty Cornwell,REP,180820,10,33,302,345,6
Craig,State House,John Myers,DEM,180820,3,11,150,164,6
Craig,Governor,Chris Powell,LIB,180910,0,1,6,7,
Craig,Governor,Kevin Stitt,REP,180910,4,30,177,211,
Craig,Governor,Drew Edmondson,DEM,180910,4,11,105,120,
Craig,Lieutenant Governor,Matt Pinnell,REP,180910,6,33,195,234,
Craig,Lieutenant Governor,Anastasia Pittman,DEM,180910,2,7,87,96,
Craig,Lieutenant Governor,Ivan Holmes,IND,180910,0,1,6,7,
Craig,State Auditor,John Yeutter,LIB,180910,2,6,41,49,
Craig,State Auditor,Cindy Byrd,REP,180910,6,33,239,278,
Craig,Attorney General,Mike Hunter,REP,180910,6,33,200,239,
Craig,Attorney General,Mark Myles,DEM,180910,2,7,87,96,
Craig,State Treasurer,Randy Mcdaniel,REP,180910,6,31,230,267,
Craig,State Treasurer,Charles De Coune,IND,180910,2,8,49,59,
Craig,Superintendent of Public Instruction,Joy Hofmeister,REP,180910,4,25,183,212,
Craig,Superintendent of Public Instruction,John Cox,DEM,180910,2,14,88,104,
Craig,Superintendent of Public Instruction,Larry Huff,IND,180910,1,2,16,19,
Craig,Commissioner of Labor,Leslie Osborn,REP,180910,7,28,190,225,
Craig,Commissioner of Labor,Fred Dorrell,DEM,180910,0,10,89,99,
Craig,Commissioner of Labor,Brandt Dismukes,IND,180910,0,1,7,8,
Craig,Insurance Commissioner,Glen Mulready,REP,180910,6,30,184,220,
Craig,Insurance Commissioner,Kimberly Fobbs,DEM,180910,1,9,98,108,
Craig,Corporation Commissioner,Bob Anthony,REP,180910,6,33,182,221,
Craig,Corporation Commissioner,Ashley Nicole Mccray,DEM,180910,1,9,92,102,
Craig,Corporation Commissioner,Jackie Short,IND,180910,0,0,11,11,
Craig,U.S. House,Richard Castaldo,LIB,180910,0,0,6,6,2
Craig,U.S. House,Markwayne Mullin,REP,180910,5,33,210,248,2
Craig,U.S. House,Jason Nichols,DEM,180910,3,9,69,81,2
Craig,U.S. House,John Foreman,IND,180910,0,0,3,3,2
Craig,State House,Rusty Cornwell,REP,180910,5,27,172,204,6
Craig,State House,John Myers,DEM,180910,3,14,116,133,6
Creek,Governor,Chris Powell,LIB,190111,1,4,22,27,
Creek,Governor,Kevin Stitt,REP,190111,12,52,329,393,
Creek,Governor,Drew Edmondson,DEM,190111,5,32,194,231,
Creek,Lieutenant Governor,Matt Pinnell,REP,190111,11,60,355,426,
Creek,Lieutenant Governor,Anastasia Pittman,DEM,190111,6,24,160,190,
Creek,Lieutenant Governor,Ivan Holmes,IND,190111,0,4,25,29,
Creek,State Auditor,John Yeutter,LIB,190111,4,9,121,134,
Creek,State Auditor,Cindy Byrd,REP,190111,12,70,387,469,
Creek,Attorney General,Mike Hunter,REP,190111,12,58,369,439,
Creek,Attorney General,Mark Myles,DEM,190111,5,30,162,197,
Creek,State Treasurer,Randy Mcdaniel,REP,190111,11,68,374,453,
Creek,State Treasurer,Charles De Coune,IND,190111,5,13,129,147,
Creek,Superintendent of Public Instruction,Joy Hofmeister,REP,190111,13,57,328,398,
Creek,Superintendent of Public Instruction,John Cox,DEM,190111,3,25,155,183,
Creek,Superintendent of Public Instruction,Larry Huff,IND,190111,1,6,53,60,
Creek,Commissioner of Labor,Leslie Osborn,REP,190111,11,54,340,405,
Creek,Commissioner of Labor,Fred Dorrell,DEM,190111,4,29,157,190,
Creek,Commissioner of Labor,Brandt Dismukes,IND,190111,2,4,35,41,
Creek,Insurance Commissioner,Glen Mulready,REP,190111,13,57,349,419,
Creek,Insurance Commissioner,Kimberly Fobbs,DEM,190111,4,30,182,216,
Creek,Corporation Commissioner,Bob Anthony,REP,190111,13,61,341,415,
Creek,Corporation Commissioner,Ashley Nicole Mccray,DEM,190111,3,25,160,188,
Creek,Corporation Commissioner,Jackie Short,IND,190111,1,2,36,39,
Creek,U.S. House,Frank Lucas,REP,190111,13,65,371,449,3
Creek,U.S. House,Frankie Robbins,DEM,190111,4,23,162,189,3
Creek,State Senate,James Leewright,REP,190111,14,64,388,466,12
Creek,State Senate,Rick Parris,DEM,190111,4,24,151,179,12
Creek,Governor,Chris Powell,LIB,190112,0,0,8,8,
Creek,Governor,Kevin Stitt,REP,190112,2,9,131,142,
Creek,Governor,Drew Edmondson,DEM,190112,3,9,49,61,
Creek,Lieutenant Governor,Matt Pinnell,REP,190112,2,10,134,146,
Creek,Lieutenant Governor,Anastasia Pittman,DEM,190112,3,7,45,55,
Creek,Lieutenant Governor,Ivan Holmes,IND,190112,0,1,9,10,
Creek,State Auditor,John Yeutter,LIB,190112,2,3,29,34,
Creek,State Auditor,Cindy Byrd,REP,190112,3,14,147,164,
Creek,Attorney General,Mike Hunter,REP,190112,2,11,141,154,
Creek,Attorney General,Mark Myles,DEM,190112,3,6,47,56,
Creek,State Treasurer,Randy Mcdaniel,REP,190112,2,12,147,161,
Creek,State Treasurer,Charles De Coune,IND,190112,3,5,31,39,
Creek,Superintendent of Public Instruction,Joy Hofmeister,REP,190112,1,11,125,137,
Creek,Superintendent of Public Instruction,John Cox,DEM,190112,2,6,40,48,
Creek,Superintendent of Public Instruction,Larry Huff,IND,190112,2,1,23,26,
Creek,Commissioner of Labor,Leslie Osborn,REP,190112,2,13,138,153,
Creek,Commissioner of Labor,Fred Dorrell,DEM,190112,3,5,32,40,
Creek,Commissioner of Labor,Brandt Dismukes,IND,190112,0,0,15,15,
Creek,Insurance Commissioner,Glen Mulready,REP,190112,2,12,142,156,
Creek,Insurance Commissioner,Kimberly Fobbs,DEM,190112,3,6,44,53,
Creek,Corporation Commissioner,Bob Anthony,REP,190112,2,12,129,143,
Creek,Corporation Commissioner,Ashley Nicole Mccray,DEM,190112,2,6,39,47,
Creek,Corporation Commissioner,Jackie Short,IND,190112,1,0,20,21,
Creek,U.S. House,Frank Lucas,REP,190112,2,11,146,159,3
Creek,U.S. House,Frankie Robbins,DEM,190112,3,7,39,49,3
Creek,State Senate,James Leewright,REP,190112,2,12,145,159,12
Creek,State Senate,Rick Parris,DEM,190112,3,6,41,50,12
Creek,Governor,Chris Powell,LIB,190121,0,1,23,24,
Creek,Governor,Kevin Stitt,REP,190121,14,85,545,644,
Creek,Governor,Drew Edmondson,DEM,190121,14,40,247,301,
Creek,Lieutenant Governor,Matt Pinnell,REP,190121,18,87,609,714,
Creek,Lieutenant Governor,Anastasia Pittman,DEM,190121,10,35,180,225,
Creek,Lieutenant Governor,Ivan Holmes,IND,190121,0,4,26,30,
Creek,State Auditor,John Yeutter,LIB,190121,6,22,146,174,
Creek,State Auditor,Cindy Byrd,REP,190121,19,91,619,729,
Creek,Attorney General,Mike Hunter,REP,190121,15,91,622,728,
Creek,Attorney General,Mark Myles,DEM,190121,13,34,193,240,
Creek,State Treasurer,Randy Mcdaniel,REP,190121,18,91,605,714,
Creek,State Treasurer,Charles De Coune,IND,190121,7,22,158,187,
Creek,Superintendent of Public Instruction,Joy Hofmeister,REP,190121,15,77,517,609,
Creek,Superintendent of Public Instruction,John Cox,DEM,190121,13,38,212,263,
Creek,Superintendent of Public Instruction,Larry Huff,IND,190121,0,10,81,91,
Creek,Commissioner of Labor,Leslie Osborn,REP,190121,19,87,559,665,
Creek,Commissioner of Labor,Fred Dorrell,DEM,190121,9,32,197,238,
Creek,Commissioner of Labor,Brandt Dismukes,IND,190121,0,6,50,56,
Creek,Insurance Commissioner,Glen Mulready,REP,190121,14,93,594,701,
Creek,Insurance Commissioner,Kimberly Fobbs,DEM,190121,13,33,216,262,
Creek,Corporation Commissioner,Bob Anthony,REP,190121,17,94,565,676,
Creek,Corporation Commissioner,Ashley Nicole Mccray,DEM,190121,10,27,192,229,
Creek,Corporation Commissioner,Jackie Short,IND,190121,0,6,55,61,
Creek,U.S. House,Frank Lucas,REP,190121,16,87,606,709,3
Creek,U.S. House,Frankie Robbins,DEM,190121,12,39,207,258,3
Creek,State Senate,James Leewright,REP,190121,17,85,620,722,12
Creek,State Senate,Rick Parris,DEM,190121,11,40,190,241,12
Creek,State House,Kyle Hilbert,REP,190121,15,85,606,706,29
Creek,State House,Jesse Goodwin,DEM,190121,12,40,205,257,29
Creek,Governor,Chris Powell,LIB,190122,0,0,10,10,
Creek,Governor,Kevin Stitt,REP,190122,0,6,41,47,
Creek,Governor,Drew Edmondson,DEM,190122,4,13,138,155,
Creek,Lieutenant Governor,Matt Pinnell,REP,190122,0,6,52,58,
Creek,Lieutenant Governor,Anastasia Pittman,DEM,190122,4,13,131,148,
Creek,Lieutenant Governor,Ivan Holmes,IND,190122,0,0,5,5,
Creek,State Auditor,John Yeutter,LIB,190122,2,10,53,65,
Creek,State Auditor,Cindy Byrd,REP,190122,0,6,62,68,
Creek,Attorney General,Mike Hunter,REP,190122,0,6,56,62,
Creek,Attorney General,Mark Myles,DEM,190122,4,13,132,149,
Creek,State Treasurer,Randy Mcdaniel,REP,190122,0,6,60,66,
Creek,State Treasurer,Charles De Coune,IND,190122,2,10,58,70,
Creek,Superintendent of Public Instruction,Joy Hofmeister,REP,190122,0,5,51,56,
Creek,Superintendent of Public Instruction,John Cox,DEM,190122,4,13,123,140,
Creek,Superintendent of Public Instruction,Larry Huff,IND,190122,0,1,13,14,
Creek,Commissioner of Labor,Leslie Osborn,REP,190122,0,6,46,52,
Creek,Commissioner of Labor,Fred Dorrell,DEM,190122,4,13,131,148,
Creek,Commissioner of Labor,Brandt Dismukes,IND,190122,0,0,8,8,
Creek,Insurance Commissioner,Glen Mulready,REP,190122,0,7,51,58,
Creek,Insurance Commissioner,Kimberly Fobbs,DEM,190122,4,12,136,152,
Creek,Corporation Commissioner,Bob Anthony,REP,190122,0,5,46,51,
Creek,Corporation Commissioner,Ashley Nicole Mccray,DEM,190122,4,14,135,153,
Creek,Corporation Commissioner,Jackie Short,IND,190122,0,0,7,7,
Creek,U.S. House,Frank Lucas,REP,190122,0,6,53,59,3
Creek,U.S. House,Frankie Robbins,DEM,190122,4,13,134,151,3
Creek,State Senate,James Leewright,REP,190122,0,6,57,63,12
Creek,State Senate,Rick Parris,DEM,190122,4,13,131,148,12
Creek,Governor,Chris Powell,LIB,190131,2,2,19,23,
Creek,Governor,Kevin Stitt,REP,190131,4,24,194,222,
Creek,Governor,Drew Edmondson,DEM,190131,8,31,120,159,
Creek,Lieutenant Governor,Matt Pinnell,REP,190131,5,32,211,248,
Creek,Lieutenant Governor,Anastasia Pittman,DEM,190131,7,24,108,139,
Creek,Lieutenant Governor,Ivan Holmes,IND,190131,1,1,12,14,
Creek,State Auditor,John Yeutter,LIB,190131,5,11,71,87,
Creek,State Auditor,Cindy Byrd,REP,190131,5,40,231,276,
Creek,Attorney General,Mike Hunter,REP,190131,4,32,218,254,
Creek,Attorney General,Mark Myles,DEM,190131,9,25,111,145,
Creek,State Treasurer,Randy Mcdaniel,REP,190131,5,37,221,263,
Creek,State Treasurer,Charles De Coune,IND,190131,5,14,79,98,
Creek,Superintendent of Public Instruction,Joy Hofmeister,REP,190131,6,38,179,223,
Creek,Superintendent of Public Instruction,John Cox,DEM,190131,7,17,115,139,
Creek,Superintendent of Public Instruction,Larry Huff,IND,190131,1,2,37,40,
Creek,Commissioner of Labor,Leslie Osborn,REP,190131,5,35,190,230,
Creek,Commissioner of Labor,Fred Dorrell,DEM,190131,7,21,113,141,
Creek,Commissioner of Labor,Brandt Dismukes,IND,190131,1,1,26,28,
Creek,Insurance Commissioner,Glen Mulready,REP,190131,5,33,219,257,
Creek,Insurance Commissioner,Kimberly Fobbs,DEM,190131,9,24,109,142,
Creek,Corporation Commissioner,Bob Anthony,REP,190131,4,34,189,227,
Creek,Corporation Commissioner,Ashley Nicole Mccray,DEM,190131,8,21,106,135,
Creek,Corporation Commissioner,Jackie Short,IND,190131,1,1,34,36,
Creek,U.S. House,Frank Lucas,REP,190131,4,34,218,256,3
Creek,U.S. House,Frankie Robbins,DEM,190131,8,23,111,142,3
Creek,State Senate,James Leewright,REP,190131,5,35,232,272,12
Creek,State Senate,Rick Parris,DEM,190131,8,22,101,131,12
Creek,Governor,Chris Powell,LIB,190132,4,4,19,27,
Creek,Governor,Kevin Stitt,REP,190132,22,91,376,489,
Creek,Governor,Drew Edmondson,DEM,190132,17,44,171,232,
Creek,Lieutenant Governor,Matt Pinnell,REP,190132,24,104,396,524,
Creek,Lieutenant Governor,Anastasia Pittman,DEM,190132,16,32,138,186,
Creek,Lieutenant Governor,Ivan Holmes,IND,190132,1,3,29,33,
Creek,State Auditor,John Yeutter,LIB,190132,7,19,99,125,
Creek,State Auditor,Cindy Byrd,REP,190132,30,109,435,574,
Creek,Attorney General,Mike Hunter,REP,190132,25,101,426,552,
Creek,Attorney General,Mark Myles,DEM,190132,17,37,138,192,
Creek,State Treasurer,Randy Mcdaniel,REP,190132,27,105,423,555,
Creek,State Treasurer,Charles De Coune,IND,190132,10,24,109,143,
Creek,Superintendent of Public Instruction,Joy Hofmeister,REP,190132,25,94,362,481,
Creek,Superintendent of Public Instruction,John Cox,DEM,190132,15,34,154,203,
Creek,Superintendent of Public Instruction,Larry Huff,IND,190132,2,11,48,61,
Creek,Commissioner of Labor,Leslie Osborn,REP,190132,27,98,387,512,
Creek,Commissioner of Labor,Fred Dorrell,DEM,190132,14,36,137,187,
Creek,Commissioner of Labor,Brandt Dismukes,IND,190132,0,5,31,36,
Creek,Insurance Commissioner,Glen Mulready,REP,190132,24,102,412,538,
Creek,Insurance Commissioner,Kimberly Fobbs,DEM,190132,17,37,148,202,
Creek,Corporation Commissioner,Bob Anthony,REP,190132,23,97,391,511,
Creek,Corporation Commissioner,Ashley Nicole Mccray,DEM,190132,16,33,139,188,
Creek,Corporation Commissioner,Jackie Short,IND,190132,0,9,31,40,
Creek,U.S. House,Frank Lucas,REP,190132,25,103,410,538,3
Creek,U.S. House,Frankie Robbins,DEM,190132,14,36,150,200,3
Creek,State Senate,James Leewright,REP,190132,26,103,414,543,12
Creek,State Senate,Rick Parris,DEM,190132,15,36,144,195,12
Creek,Governor,Chris Powell,LIB,190142,1,7,54,62,
Creek,Governor,Kevin Stitt,REP,190142,38,186,689,913,
Creek,Governor,Drew Edmondson,DEM,190142,19,146,478,643,
Creek,Lieutenant Governor,Matt Pinnell,REP,190142,36,216,778,1030,
Creek,Lieutenant Governor,Anastasia Pittman,DEM,190142,16,114,387,517,
Creek,Lieutenant Governor,Ivan Holmes,IND,190142,4,5,49,58,
Creek,State Auditor,John Yeutter,LIB,190142,15,60,280,355,
Creek,State Auditor,Cindy Byrd,REP,190142,40,242,869,1151,
Creek,Attorney General,Mike Hunter,REP,190142,39,215,823,1077,
Creek,Attorney General,Mark Myles,DEM,190142,19,118,382,519,
Creek,State Treasurer,Randy Mcdaniel,REP,190142,39,232,845,1116,
Creek,State Treasurer,Charles De Coune,IND,190142,14,68,299,381,
Creek,Superintendent of Public Instruction,Joy Hofmeister,REP,190142,36,216,752,1004,
Creek,Superintendent of Public Instruction,John Cox,DEM,190142,19,109,339,467,
Creek,Superintendent of Public Instruction,Larry Huff,IND,190142,3,14,118,135,
Creek,Commissioner of Labor,Leslie Osborn,REP,190142,36,206,761,1003,
Creek,Commissioner of Labor,Fred Dorrell,DEM,190142,15,116,363,494,
Creek,Commissioner of Labor,Brandt Dismukes,IND,190142,7,8,73,88,
Creek,Insurance Commissioner,Glen Mulready,REP,190142,39,222,781,1042,
Creek,Insurance Commissioner,Kimberly Fobbs,DEM,190142,18,112,418,548,
Creek,Corporation Commissioner,Bob Anthony,REP,190142,41,226,773,1040,
Creek,Corporation Commissioner,Ashley Nicole Mccray,DEM,190142,14,105,344,463,
Creek,Corporation Commissioner,Jackie Short,IND,190142,3,5,89,97,
Creek,U.S. House,Frank Lucas,REP,190142,40,224,818,1082,3
Creek,U.S. House,Frankie Robbins,DEM,190142,17,111,387,515,3
Creek,State Senate,James Leewright,REP,190142,43,237,841,1121,12
Creek,State Senate,Rick Parris,DEM,190142,15,99,365,479,12
Creek,Governor,Chris Powell,LIB,190143,0,2,23,25,
Creek,Governor,Kevin Stitt,REP,190143,11,67,291,369,
Creek,Governor,Drew Edmondson,DEM,190143,16,49,209,274,
Creek,Lieutenant Governor,Matt Pinnell,REP,190143,8,71,312,391,
Creek,Lieutenant Governor,Anastasia Pittman,DEM,190143,17,45,179,241,
Creek,Lieutenant Governor,Ivan Holmes,IND,190143,1,2,24,27,
Creek,State Auditor,John Yeutter,LIB,190143,7,20,134,161,
Creek,State Auditor,Cindy Byrd,REP,190143,12,79,354,445,
Creek,Attorney General,Mike Hunter,REP,190143,10,73,331,414,
Creek,Attorney General,Mark Myles,DEM,190143,16,43,182,241,
Creek,State Treasurer,Randy Mcdaniel,REP,190143,9,76,337,422,
Creek,State Treasurer,Charles De Coune,IND,190143,10,26,146,182,
Creek,Superintendent of Public Instruction,Joy Hofmeister,REP,190143,10,69,302,381,
Creek,Superintendent of Public Instruction,John Cox,DEM,190143,16,40,169,225,
Creek,Superintendent of Public Instruction,Larry Huff,IND,190143,0,7,45,52,
Creek,Commissioner of Labor,Leslie Osborn,REP,190143,8,69,300,377,
Creek,Commissioner of Labor,Fred Dorrell,DEM,190143,15,43,179,237,
Creek,Commissioner of Labor,Brandt Dismukes,IND,190143,2,2,31,35,
Creek,Insurance Commissioner,Glen Mulready,REP,190143,9,68,323,400,
Creek,Insurance Commissioner,Kimberly Fobbs,DEM,190143,17,48,190,255,
Creek,Corporation Commissioner,Bob Anthony,REP,190143,9,68,302,379,
Creek,Corporation Commissioner,Ashley Nicole Mccray,DEM,190143,16,45,178,239,
Creek,Corporation Commissioner,Jackie Short,IND,190143,1,5,33,39,
Creek,U.S. House,Frank Lucas,REP,190143,9,71,331,411,3
Creek,U.S. House,Frankie Robbins,DEM,190143,17,45,183,245,3
Creek,State Senate,James Leewright,REP,190143,11,78,339,428,12
Creek,State Senate,Rick Parris,DEM,190143,14,40,175,229,12
Creek,Governor,Chris Powell,LIB,190211,0,0,10,10,
Creek,Governor,Kevin Stitt,REP,190211,6,6,160,172,
Creek,Governor,Drew Edmondson,DEM,190211,6,3,123,132,
Creek,Lieutenant Governor,Matt Pinnell,REP,190211,6,8,173,187,
Creek,Lieutenant Governor,Anastasia Pittman,DEM,190211,6,1,111,118,
Creek,Lieutenant Governor,Ivan Holmes,IND,190211,0,0,10,10,
Creek,State Auditor,John Yeutter,LIB,190211,2,1,69,72,
Creek,State Auditor,Cindy Byrd,REP,190211,7,8,202,217,
Creek,Attorney General,Mike Hunter,REP,190211,8,8,185,201,
Creek,Attorney General,Mark Myles,DEM,190211,4,1,110,115,
Creek,State Treasurer,Randy Mcdaniel,REP,190211,8,7,197,212,
Creek,State Treasurer,Charles De Coune,IND,190211,1,2,74,77,
Creek,Superintendent of Public Instruction,Joy Hofmeister,REP,190211,7,6,172,185,
Creek,Superintendent of Public Instruction,John Cox,DEM,190211,5,2,98,105,
Creek,Superintendent of Public Instruction,Larry Huff,IND,190211,0,1,26,27,
Creek,Commissioner of Labor,Leslie Osborn,REP,190211,5,7,171,183,
Creek,Commissioner of Labor,Fred Dorrell,DEM,190211,5,2,107,114,
Creek,Commissioner of Labor,Brandt Dismukes,IND,190211,1,0,16,17,
Creek,Insurance Commissioner,Glen Mulready,REP,190211,6,7,169,182,
Creek,Insurance Commissioner,Kimberly Fobbs,DEM,190211,6,2,124,132,
Creek,Corporation Commissioner,Bob Anthony,REP,190211,6,7,159,172,
Creek,Corporation Commissioner,Ashley Nicole Mccray,DEM,190211,5,1,122,128,
Creek,Corporation Commissioner,Jackie Short,IND,190211,1,1,13,15,
Creek,U.S. House,Frank Lucas,REP,190211,7,8,185,200,3
Creek,U.S. House,Frankie Robbins,DEM,190211,5,1,110,116,3
Creek,State Senate,James Leewright,REP,190211,7,8,210,225,12
Creek,State Senate,Rick Parris,DEM,190211,4,1,85,90,12
Creek,State House,Kyle Hilbert,REP,190211,8,8,207,223,29
Creek,State House,Jesse Goodwin,DEM,190211,4,1,89,94,29
Creek,Governor,Chris Powell,LIB,190221,0,0,6,6,
Creek,Governor,Kevin Stitt,REP,190221,4,3,124,131,
Creek,Governor,Drew Edmondson,DEM,190221,1,2,100,103,
Creek,Lieutenant Governor,Matt Pinnell,REP,190221,5,3,135,143,
Creek,Lieutenant Governor,Anastasia Pittman,DEM,190221,0,0,85,85,
Creek,Lieutenant Governor,Ivan Holmes,IND,190221,0,1,9,10,
Creek,State Auditor,John Yeutter,LIB,190221,0,1,44,45,
Creek,State Auditor,Cindy Byrd,REP,190221,5,3,175,183,
Creek,Attorney General,Mike Hunter,REP,190221,5,3,153,161,
Creek,Attorney General,Mark Myles,DEM,190221,0,2,74,76,
Creek,State Treasurer,Randy Mcdaniel,REP,190221,5,3,167,175,
Creek,State Treasurer,Charles De Coune,IND,190221,0,1,55,56,
Creek,Superintendent of Public Instruction,Joy Hofmeister,REP,190221,5,2,135,142,
Creek,Superintendent of Public Instruction,John Cox,DEM,190221,0,1,77,78,
Creek,Superintendent of Public Instruction,Larry Huff,IND,190221,0,1,16,17,
Creek,Commissioner of Labor,Leslie Osborn,REP,190221,4,3,133,140,
Creek,Commissioner of Labor,Fred Dorrell,DEM,190221,1,1,85,87,
Creek,Commissioner of Labor,Brandt Dismukes,IND,190221,0,0,10,10,
Creek,Insurance Commissioner,Glen Mulready,REP,190221,4,3,146,153,
Creek,Insurance Commissioner,Kimberly Fobbs,DEM,190221,1,1,83,85,
Creek,Corporation Commissioner,Bob Anthony,REP,190221,5,4,128,137,
Creek,Corporation Commissioner,Ashley Nicole Mccray,DEM,190221,0,0,85,85,
Creek,Corporation Commissioner,Jackie Short,IND,190221,0,0,16,16,
Creek,U.S. House,Frank Lucas,REP,190221,5,3,144,152,3
Creek,U.S. House,Frankie Robbins,DEM,190221,0,1,83,84,3
Creek,State Senate,James Leewright,REP,190221,5,3,153,161,12
Creek,State Senate,Rick Parris,DEM,190221,0,1,76,77,12
Creek,State House,Kyle Hilbert,REP,190221,5,3,151,159,29
Creek,State House,Jesse Goodwin,DEM,190221,0,1,79,80,29
Creek,Governor,Chris Powell,LIB,190231,0,0,13,13,
Creek,Governor,Kevin Stitt,REP,190231,4,5,192,201,
Creek,Governor,Drew Edmondson,DEM,190231,5,3,133,141,
Creek,Lieutenant Governor,Matt Pinnell,REP,190231,4,7,211,222,
Creek,Lieutenant Governor,Anastasia Pittman,DEM,190231,5,1,110,116,
Creek,Lieutenant Governor,Ivan Holmes,IND,190231,0,0,15,15,
Creek,State Auditor,John Yeutter,LIB,190231,2,3,81,86,
Creek,State Auditor,Cindy Byrd,REP,190231,3,5,233,241,
Creek,Attorney General,Mike Hunter,REP,190231,5,6,226,237,
Creek,Attorney General,Mark Myles,DEM,190231,4,2,110,116,
Creek,State Treasurer,Randy Mcdaniel,REP,190231,5,6,230,241,
Creek,State Treasurer,Charles De Coune,IND,190231,0,2,84,86,
Creek,Superintendent of Public Instruction,Joy Hofmeister,REP,190231,3,3,196,202,
Creek,Superintendent of Public Instruction,John Cox,DEM,190231,4,2,113,119,
Creek,Superintendent of Public Instruction,Larry Huff,IND,190231,2,3,28,33,
Creek,Commissioner of Labor,Leslie Osborn,REP,190231,2,7,201,210,
Creek,Commissioner of Labor,Fred Dorrell,DEM,190231,5,1,116,122,
Creek,Commissioner of Labor,Brandt Dismukes,IND,190231,2,0,18,20,
Creek,Insurance Commissioner,Glen Mulready,REP,190231,4,7,216,227,
Creek,Insurance Commissioner,Kimberly Fobbs,DEM,190231,5,1,120,126,
Creek,Corporation Commissioner,Bob Anthony,REP,190231,4,3,198,205,
Creek,Corporation Commissioner,Ashley Nicole Mccray,DEM,190231,4,2,112,118,
Creek,Corporation Commissioner,Jackie Short,IND,190231,1,3,26,30,
Creek,U.S. House,Frank Lucas,REP,190231,4,6,219,229,3
Creek,U.S. House,Frankie Robbins,DEM,190231,5,2,119,126,3
Creek,State Senate,James Leewright,REP,190231,4,7,236,247,12
Creek,State Senate,Rick Parris,DEM,190231,5,1,104,110,12
Creek,State House,Kyle Hilbert,REP,190231,4,6,232,242,29
Creek,State House,Jesse Goodwin,DEM,190231,5,2,106,113,29
Creek,Governor,Chris Powell,LIB,190241,0,0,8,8,
Creek,Governor,Kevin Stitt,REP,190241,8,6,218,232,
Creek,Governor,Drew Edmondson,DEM,190241,4,4,130,138,
Creek,Lieutenant Governor,Matt Pinnell,REP,190241,8,8,247,263,
Creek,Lieutenant Governor,Anastasia Pittman,DEM,190241,4,2,94,100,
Creek,Lieutenant Governor,Ivan Holmes,IND,190241,0,0,11,11,
Creek,State Auditor,John Yeutter,LIB,190241,2,2,78,82,
Creek,State Auditor,Cindy Byrd,REP,190241,9,7,255,271,
Creek,Attorney General,Mike Hunter,REP,190241,9,7,259,275,
Creek,Attorney General,Mark Myles,DEM,190241,3,3,93,99,
Creek,State Treasurer,Randy Mcdaniel,REP,190241,9,8,259,276,
Creek,State Treasurer,Charles De Coune,IND,190241,1,2,73,76,
Creek,Superintendent of Public Instruction,Joy Hofmeister,REP,190241,7,10,241,258,
Creek,Superintendent of Public Instruction,John Cox,DEM,190241,2,0,97,99,
Creek,Superintendent of Public Instruction,Larry Huff,IND,190241,3,0,17,20,
Creek,Commissioner of Labor,Leslie Osborn,REP,190241,10,6,247,263,
Creek,Commissioner of Labor,Fred Dorrell,DEM,190241,2,3,95,100,
Creek,Commissioner of Labor,Brandt Dismukes,IND,190241,0,0,9,9,
Creek,Insurance Commissioner,Glen Mulready,REP,190241,8,6,243,257,
Creek,Insurance Commissioner,Kimberly Fobbs,DEM,190241,4,3,107,114,
Creek,Corporation Commissioner,Bob Anthony,REP,190241,6,8,233,247,
Creek,Corporation Commissioner,Ashley Nicole Mccray,DEM,190241,4,2,100,106,
Creek,Corporation Commissioner,Jackie Short,IND,190241,2,0,19,21,
Creek,U.S. House,Frank Lucas,REP,190241,8,8,251,267,3
Creek,U.S. House,Frankie Robbins,DEM,190241,4,2,97,103,3
Creek,State Senate,James Leewright,REP,190241,9,7,257,273,12
Creek,State Senate,Rick Parris,DEM,190241,3,2,95,100,12
Creek,State House,Kyle Hilbert,REP,190241,9,8,269,286,29
Creek,State House,Jesse Goodwin,DEM,190241,3,2,82,87,29
Creek,Governor,Chris Powell,LIB,190311,1,0,25,26,
Creek,Governor,Kevin Stitt,REP,190311,14,9,422,445,
Creek,Governor,Drew Edmondson,DEM,190311,10,7,174,191,
Creek,Lieutenant Governor,Matt Pinnell,REP,190311,12,9,452,473,
Creek,Lieutenant Governor,Anastasia Pittman,DEM,190311,10,7,146,163,
Creek,Lieutenant Governor,Ivan Holmes,IND,190311,2,0,22,24,
Creek,State Auditor,John Yeutter,LIB,190311,7,1,119,127,
Creek,State Auditor,Cindy Byrd,REP,190311,13,11,470,494,
Creek,Attorney General,Mike Hunter,REP,190311,13,10,465,488,
Creek,Attorney General,Mark Myles,DEM,190311,11,6,150,167,
Creek,State Treasurer,Randy Mcdaniel,REP,190311,10,9,472,491,
Creek,State Treasurer,Charles De Coune,IND,190311,9,3,114,126,
Creek,Superintendent of Public Instruction,Joy Hofmeister,REP,190311,10,8,394,412,
Creek,Superintendent of Public Instruction,John Cox,DEM,190311,9,7,156,172,
Creek,Superintendent of Public Instruction,Larry Huff,IND,190311,5,1,66,72,
Creek,Commissioner of Labor,Leslie Osborn,REP,190311,11,9,415,435,
Creek,Commissioner of Labor,Fred Dorrell,DEM,190311,10,7,162,179,
Creek,Commissioner of Labor,Brandt Dismukes,IND,190311,3,0,35,38,
Creek,Insurance Commissioner,Glen Mulready,REP,190311,13,8,441,462,
Creek,Insurance Commissioner,Kimberly Fobbs,DEM,190311,11,8,171,190,
Creek,Corporation Commissioner,Bob Anthony,REP,190311,13,9,433,455,
Creek,Corporation Commissioner,Ashley Nicole Mccray,DEM,190311,7,7,147,161,
Creek,Corporation Commissioner,Jackie Short,IND,190311,4,0,36,40,
Creek,U.S. House,Frank Lucas,REP,190311,12,9,462,483,3
Creek,U.S. House,Frankie Robbins,DEM,190311,12,7,156,175,3
Creek,State Senate,James Leewright,REP,190311,13,10,473,496,12
Creek,State Senate,Rick Parris,DEM,190311,11,6,145,162,12
Creek,State House,Ty Burns,REP,190311,13,10,438,461,35
Creek,State House,Jasha Lyons Echo-Hawk,DEM,190311,11,6,179,196,35
Creek,Governor,Chris Powell,LIB,190401,0,1,26,27,
Creek,Governor,Kevin Stitt,REP,190401,11,60,366,437,
Creek,Governor,Drew Edmondson,DEM,190401,9,28,142,179,
Creek,Lieutenant Governor,Matt Pinnell,REP,190401,12,66,403,481,
Creek,Lieutenant Governor,Anastasia Pittman,DEM,190401,6,21,115,142,
Creek,Lieutenant Governor,Ivan Holmes,IND,190401,2,2,16,20,
Creek,State Auditor,John Yeutter,LIB,190401,6,11,88,105,
Creek,State Auditor,Cindy Byrd,REP,190401,12,72,414,498,
Creek,Attorney General,Mike Hunter,REP,190401,12,65,401,478,
Creek,Attorney General,Mark Myles,DEM,190401,8,24,131,163,
Creek,State Treasurer,Randy Mcdaniel,REP,190401,12,69,399,480,
Creek,State Treasurer,Charles De Coune,IND,190401,6,15,100,121,
Creek,Superintendent of Public Instruction,Joy Hofmeister,REP,190401,12,62,342,416,
Creek,Superintendent of Public Instruction,John Cox,DEM,190401,7,23,129,159,
Creek,Superintendent of Public Instruction,Larry Huff,IND,190401,1,4,60,65,
Creek,Commissioner of Labor,Leslie Osborn,REP,190401,12,66,378,456,
Creek,Commissioner of Labor,Fred Dorrell,DEM,190401,7,21,118,146,
Creek,Commissioner of Labor,Brandt Dismukes,IND,190401,1,1,24,26,
Creek,Insurance Commissioner,Glen Mulready,REP,190401,12,63,394,469,
Creek,Insurance Commissioner,Kimberly Fobbs,DEM,190401,8,26,129,163,
Creek,Corporation Commissioner,Bob Anthony,REP,190401,12,65,387,464,
Creek,Corporation Commissioner,Ashley Nicole Mccray,DEM,190401,6,22,113,141,
Creek,Corporation Commissioner,Jackie Short,IND,190401,2,2,29,33,
Creek,U.S. House,Frank Lucas,REP,190401,10,66,405,481,3
Creek,U.S. House,Frankie Robbins,DEM,190401,10,23,123,156,3
Creek,State Senate,James Leewright,REP,190401,12,67,408,487,12
Creek,State Senate,Rick Parris,DEM,190401,8,21,123,152,12
Creek,State House,Kyle Hilbert,REP,190401,12,63,400,475,29
Creek,State House,Jesse Goodwin,DEM,190401,8,25,131,164,29
Creek,Governor,Chris Powell,LIB,190402,0,2,18,20,
Creek,Governor,Kevin Stitt,REP,190402,19,97,363,479,
Creek,Governor,Drew Edmondson,DEM,190402,6,36,156,198,
Creek,Lieutenant Governor,Matt Pinnell,REP,190402,19,102,389,510,
Creek,Lieutenant Governor,Anastasia Pittman,DEM,190402,6,31,119,156,
Creek,Lieutenant Governor,Ivan Holmes,IND,190402,0,1,28,29,
Creek,State Auditor,John Yeutter,LIB,190402,2,23,95,120,
Creek,State Auditor,Cindy Byrd,REP,190402,22,103,416,541,
Creek,Attorney General,Mike Hunter,REP,190402,17,99,391,507,
Creek,Attorney General,Mark Myles,DEM,190402,8,35,139,182,
Creek,State Treasurer,Randy Mcdaniel,REP,190402,20,102,416,538,
Creek,State Treasurer,Charles De Coune,IND,190402,4,24,96,124,
Creek,Superintendent of Public Instruction,Joy Hofmeister,REP,190402,19,92,347,458,
Creek,Superintendent of Public Instruction,John Cox,DEM,190402,4,36,133,173,
Creek,Superintendent of Public Instruction,Larry Huff,IND,190402,2,6,55,63,
Creek,Commissioner of Labor,Leslie Osborn,REP,190402,17,95,376,488,
Creek,Commissioner of Labor,Fred Dorrell,DEM,190402,8,37,125,170,
Creek,Commissioner of Labor,Brandt Dismukes,IND,190402,0,2,28,30,
Creek,Insurance Commissioner,Glen Mulready,REP,190402,18,101,389,508,
Creek,Insurance Commissioner,Kimberly Fobbs,DEM,190402,7,34,143,184,
Creek,Corporation Commissioner,Bob Anthony,REP,190402,15,100,379,494,
Creek,Corporation Commissioner,Ashley Nicole Mccray,DEM,190402,7,29,114,150,
Creek,Corporation Commissioner,Jackie Short,IND,190402,2,5,38,45,
Creek,U.S. House,Frank Lucas,REP,190402,19,100,394,513,3
Creek,U.S. House,Frankie Robbins,DEM,190402,6,35,137,178,3
Creek,State Senate,James Leewright,REP,190402,20,106,411,537,12
Creek,State Senate,Rick Parris,DEM,190402,5,28,120,153,12
Creek,State House,Kyle Hilbert,REP,190402,20,102,391,513,29
Creek,State House,Jesse Goodwin,DEM,190402,5,33,139,177,29
Creek,Governor,Chris Powell,LIB,190403,0,1,30,31,
Creek,Governor,Kevin Stitt,REP,190403,16,47,440,503,
Creek,Governor,Drew Edmondson,DEM,190403,8,25,149,182,
Creek,Lieutenant Governor,Matt Pinnell,REP,190403,18,49,464,531,
Creek,Lieutenant Governor,Anastasia Pittman,DEM,190403,6,22,125,153,
Creek,Lieutenant Governor,Ivan Holmes,IND,190403,0,2,25,27,
Creek,State Auditor,John Yeutter,LIB,190403,2,16,105,123,
Creek,State Auditor,Cindy Byrd,REP,190403,21,53,487,561,
Creek,Attorney General,Mike Hunter,REP,190403,17,50,482,549,
Creek,Attorney General,Mark Myles,DEM,190403,7,23,129,159,
Creek,State Treasurer,Randy Mcdaniel,REP,190403,16,50,476,542,
Creek,State Treasurer,Charles De Coune,IND,190403,7,19,114,140,
Creek,Superintendent of Public Instruction,Joy Hofmeister,REP,190403,15,43,424,482,
Creek,Superintendent of Public Instruction,John Cox,DEM,190403,6,25,131,162,
Creek,Superintendent of Public Instruction,Larry Huff,IND,190403,3,4,58,65,
Creek,Commissioner of Labor,Leslie Osborn,REP,190403,16,45,436,497,
Creek,Commissioner of Labor,Fred Dorrell,DEM,190403,7,26,129,162,
Creek,Commissioner of Labor,Brandt Dismukes,IND,190403,1,1,40,42,
Creek,Insurance Commissioner,Glen Mulready,REP,190403,15,49,468,532,
Creek,Insurance Commissioner,Kimberly Fobbs,DEM,190403,9,24,139,172,
Creek,Corporation Commissioner,Bob Anthony,REP,190403,14,44,441,499,
Creek,Corporation Commissioner,Ashley Nicole Mccray,DEM,190403,8,25,125,158,
Creek,Corporation Commissioner,Jackie Short,IND,190403,2,3,43,48,
Creek,U.S. House,Frank Lucas,REP,190403,19,48,476,543,3
Creek,U.S. House,Frankie Robbins,DEM,190403,6,24,136,166,3
Creek,State Senate,James Leewright,REP,190403,16,51,480,547,12
Creek,State Senate,Rick Parris,DEM,190403,8,22,132,162,12
Creek,State House,Kyle Hilbert,REP,190403,15,49,469,533,29
Creek,State House,Jesse Goodwin,DEM,190403,9,23,143,175,29
Creek,Governor,Chris Powell,LIB,190404,2,3,42,47,
Creek,Governor,Kevin Stitt,REP,190404,53,40,895,988,
Creek,Governor,Drew Edmondson,DEM,190404,22,34,405,461,
Creek,Lieutenant Governor,Matt Pinnell,REP,190404,55,44,1013,1112,
Creek,Lieutenant Governor,Anastasia Pittman,DEM,190404,18,31,289,338,
Creek,Lieutenant Governor,Ivan Holmes,IND,190404,4,2,31,37,
Creek,State Auditor,John Yeutter,LIB,190404,13,19,185,217,
Creek,State Auditor,Cindy Byrd,REP,190404,59,47,1063,1169,
Creek,Attorney General,Mike Hunter,REP,190404,57,41,1013,1111,
Creek,Attorney General,Mark Myles,DEM,190404,20,31,306,357,
Creek,State Treasurer,Randy Mcdaniel,REP,190404,56,42,1025,1123,
Creek,State Treasurer,Charles De Coune,IND,190404,17,23,222,262,
Creek,Superintendent of Public Instruction,Joy Hofmeister,REP,190404,51,46,933,1030,
Creek,Superintendent of Public Instruction,John Cox,DEM,190404,18,25,306,349,
Creek,Superintendent of Public Instruction,Larry Huff,IND,190404,8,5,86,99,
Creek,Commissioner of Labor,Leslie Osborn,REP,190404,54,43,971,1068,
Creek,Commissioner of Labor,Fred Dorrell,DEM,190404,19,30,281,330,
Creek,Commissioner of Labor,Brandt Dismukes,IND,190404,2,3,57,62,
Creek,Insurance Commissioner,Glen Mulready,REP,190404,57,45,995,1097,
Creek,Insurance Commissioner,Kimberly Fobbs,DEM,190404,17,32,318,367,
Creek,Corporation Commissioner,Bob Anthony,REP,190404,52,44,970,1066,
Creek,Corporation Commissioner,Ashley Nicole Mccray,DEM,190404,19,27,287,333,
Creek,Corporation Commissioner,Jackie Short,IND,190404,3,6,62,71,
Creek,U.S. House,Frank Lucas,REP,190404,60,44,1029,1133,3
Creek,U.S. House,Frankie Robbins,DEM,190404,16,32,293,341,3
Creek,State Senate,James Leewright,REP,190404,58,43,1018,1119,12
Creek,State Senate,Rick Parris,DEM,190404,18,33,309,360,12
Creek,State House,Kyle Hilbert,REP,190404,59,41,1021,1121,29
Creek,State House,Jesse Goodwin,DEM,190404,17,34,301,352,29
Creek,Governor,Chris Powell,LIB,190405,1,0,33,34,
Creek,Governor,Kevin Stitt,REP,190405,27,35,489,551,
Creek,Governor,Drew Edmondson,DEM,190405,15,8,190,213,
Creek,Lieutenant Governor,Matt Pinnell,REP,190405,29,39,526,594,
Creek,Lieutenant Governor,Anastasia Pittman,DEM,190405,12,4,147,163,
Creek,Lieutenant Governor,Ivan Holmes,IND,190405,1,0,36,37,
Creek,State Auditor,John Yeutter,LIB,190405,7,1,129,137,
Creek,State Auditor,Cindy Byrd,REP,190405,32,42,549,623,
Creek,Attorney General,Mike Hunter,REP,190405,30,41,545,616,
Creek,Attorney General,Mark Myles,DEM,190405,13,1,160,174,
Creek,State Treasurer,Randy Mcdaniel,REP,190405,30,40,541,611,
Creek,State Treasurer,Charles De Coune,IND,190405,9,3,133,145,
Creek,Superintendent of Public Instruction,Joy Hofmeister,REP,190405,30,40,471,541,
Creek,Superintendent of Public Instruction,John Cox,DEM,190405,11,2,160,173,
Creek,Superintendent of Public Instruction,Larry Huff,IND,190405,2,1,77,80,
Creek,Commissioner of Labor,Leslie Osborn,REP,190405,30,43,490,563,
Creek,Commissioner of Labor,Fred Dorrell,DEM,190405,13,0,162,175,
Creek,Commissioner of Labor,Brandt Dismukes,IND,190405,0,0,53,53,
Creek,Insurance Commissioner,Glen Mulready,REP,190405,28,39,523,590,
Creek,Insurance Commissioner,Kimberly Fobbs,DEM,190405,15,4,182,201,
Creek,Corporation Commissioner,Bob Anthony,REP,190405,29,40,506,575,
Creek,Corporation Commissioner,Ashley Nicole Mccray,DEM,190405,14,3,140,157,
Creek,Corporation Commissioner,Jackie Short,IND,190405,0,0,61,61,
Creek,U.S. House,Frank Lucas,REP,190405,30,40,538,608,3
Creek,U.S. House,Frankie Robbins,DEM,190405,13,3,169,185,3
Creek,State Senate,James Leewright,REP,190405,31,42,538,611,12
Creek,State Senate,Rick Parris,DEM,190405,12,1,168,181,12
Creek,State House,Ty Burns,REP,190405,31,40,532,603,35
Creek,State House,Jasha Lyons Echo-Hawk,DEM,190405,12,3,176,191,35
Creek,Governor,Chris Powell,LIB,190406,0,0,24,24,
Creek,Governor,Kevin Stitt,REP,190406,9,6,285,300,
Creek,Governor,Drew Edmondson,DEM,190406,2,0,115,117,
Creek,Lieutenant Governor,Matt Pinnell,REP,190406,8,6,305,319,
Creek,Lieutenant Governor,Anastasia Pittman,DEM,190406,3,0,98,101,
Creek,Lieutenant Governor,Ivan Holmes,IND,190406,0,0,18,18,
Creek,State Auditor,John Yeutter,LIB,190406,2,0,80,82,
Creek,State Auditor,Cindy Byrd,REP,190406,9,6,321,336,
Creek,Attorney General,Mike Hunter,REP,190406,8,6,311,325,
Creek,Attorney General,Mark Myles,DEM,190406,3,0,111,114,
Creek,State Treasurer,Randy Mcdaniel,REP,190406,8,6,315,329,
Creek,State Treasurer,Charles De Coune,IND,190406,2,0,87,89,
Creek,Superintendent of Public Instruction,Joy Hofmeister,REP,190406,8,4,265,277,
Creek,Superintendent of Public Instruction,John Cox,DEM,190406,3,2,114,119,
Creek,Superintendent of Public Instruction,Larry Huff,IND,190406,0,0,41,41,
Creek,Commissioner of Labor,Leslie Osborn,REP,190406,8,6,278,292,
Creek,Commissioner of Labor,Fred Dorrell,DEM,190406,2,0,116,118,
Creek,Commissioner of Labor,Brandt Dismukes,IND,190406,0,0,26,26,
Creek,Insurance Commissioner,Glen Mulready,REP,190406,7,6,299,312,
Creek,Insurance Commissioner,Kimberly Fobbs,DEM,190406,2,0,123,125,
Creek,Corporation Commissioner,Bob Anthony,REP,190406,7,5,292,304,
Creek,Corporation Commissioner,Ashley Nicole Mccray,DEM,190406,3,0,112,115,
Creek,Corporation Commissioner,Jackie Short,IND,190406,0,1,18,19,
Creek,U.S. House,Frank Lucas,REP,190406,9,6,321,336,3
Creek,U.S. House,Frankie Robbins,DEM,190406,2,0,100,102,3
Creek,State Senate,James Leewright,REP,190406,7,6,317,330,12
Creek,State Senate,Rick Parris,DEM,190406,3,0,104,107,12
Creek,State House,Ty Burns,REP,190406,8,6,311,325,35
Creek,State House,Jasha Lyons Echo-Hawk,DEM,190406,2,0,109,111,35
Creek,Governor,Chris Powell,LIB,190407,0,0,15,15,
Creek,Governor,Kevin Stitt,REP,190407,1,12,171,184,
Creek,Governor,Drew Edmondson,DEM,190407,2,0,61,63,
Creek,Lieutenant Governor,Matt Pinnell,REP,190407,1,12,190,203,
Creek,Lieutenant Governor,Anastasia Pittman,DEM,190407,2,0,47,49,
Creek,Lieutenant Governor,Ivan Holmes,IND,190407,0,0,10,10,
Creek,State Auditor,John Yeutter,LIB,190407,0,0,44,44,
Creek,State Auditor,Cindy Byrd,REP,190407,2,12,195,209,
Creek,Attorney General,Mike Hunter,REP,190407,1,12,194,207,
Creek,Attorney General,Mark Myles,DEM,190407,2,0,53,55,
Creek,State Treasurer,Randy Mcdaniel,REP,190407,2,10,188,200,
Creek,State Treasurer,Charles De Coune,IND,190407,0,2,52,54,
Creek,Superintendent of Public Instruction,Joy Hofmeister,REP,190407,2,10,157,169,
Creek,Superintendent of Public Instruction,John Cox,DEM,190407,1,0,64,65,
Creek,Superintendent of Public Instruction,Larry Huff,IND,190407,0,2,25,27,
Creek,Commissioner of Labor,Leslie Osborn,REP,190407,1,10,175,186,
Creek,Commissioner of Labor,Fred Dorrell,DEM,190407,2,2,54,58,
Creek,Commissioner of Labor,Brandt Dismukes,IND,190407,0,0,15,15,
Creek,Insurance Commissioner,Glen Mulready,REP,190407,2,12,187,201,
Creek,Insurance Commissioner,Kimberly Fobbs,DEM,190407,1,0,58,59,
Creek,Corporation Commissioner,Bob Anthony,REP,190407,2,11,175,188,
Creek,Corporation Commissioner,Ashley Nicole Mccray,DEM,190407,1,0,50,51,
Creek,Corporation Commissioner,Jackie Short,IND,190407,0,1,20,21,
Creek,U.S. House,Frank Lucas,REP,190407,1,11,193,205,3
Creek,U.S. House,Frankie Robbins,DEM,190407,2,1,52,55,3
Creek,State Senate,James Leewright,REP,190407,1,12,188,201,12
Creek,State Senate,Rick Parris,DEM,190407,2,0,58,60,12
Creek,State House,Ty Burns,REP,190407,1,11,181,193,35
Creek,State House,Jasha Lyons Echo-Hawk,DEM,190407,2,1,63,66,35
Creek,Governor,Chris Powell,LIB,190408,2,0,9,11,
Creek,Governor,Kevin Stitt,REP,190408,4,9,221,234,
Creek,Governor,Drew Edmondson,DEM,190408,1,2,80,83,
Creek,Lieutenant Governor,Matt Pinnell,REP,190408,6,11,231,248,
Creek,Lieutenant Governor,Anastasia Pittman,DEM,190408,1,0,59,60,
Creek,Lieutenant Governor,Ivan Holmes,IND,190408,0,0,14,14,
Creek,State Auditor,John Yeutter,LIB,190408,0,0,48,48,
Creek,State Auditor,Cindy Byrd,REP,190408,6,11,244,261,
Creek,Attorney General,Mike Hunter,REP,190408,6,11,247,264,
Creek,Attorney General,Mark Myles,DEM,190408,1,0,59,60,
Creek,State Treasurer,Randy Mcdaniel,REP,190408,6,11,246,263,
Creek,State Treasurer,Charles De Coune,IND,190408,0,0,43,43,
Creek,Superintendent of Public Instruction,Joy Hofmeister,REP,190408,5,7,205,217,
Creek,Superintendent of Public Instruction,John Cox,DEM,190408,2,2,75,79,
Creek,Superintendent of Public Instruction,Larry Huff,IND,190408,0,2,29,31,
Creek,Commissioner of Labor,Leslie Osborn,REP,190408,6,11,230,247,
Creek,Commissioner of Labor,Fred Dorrell,DEM,190408,1,0,62,63,
Creek,Commissioner of Labor,Brandt Dismukes,IND,190408,0,0,11,11,
Creek,Insurance Commissioner,Glen Mulready,REP,190408,5,10,231,246,
Creek,Insurance Commissioner,Kimberly Fobbs,DEM,190408,2,1,69,72,
Creek,Corporation Commissioner,Bob Anthony,REP,190408,4,11,230,245,
Creek,Corporation Commissioner,Ashley Nicole Mccray,DEM,190408,2,0,54,56,
Creek,Corporation Commissioner,Jackie Short,IND,190408,1,0,19,20,
Creek,U.S. House,Frank Lucas,REP,190408,5,11,237,253,3
Creek,U.S. House,Frankie Robbins,DEM,190408,1,0,67,68,3
Creek,State Senate,James Leewright,REP,190408,6,11,245,262,12
Creek,State Senate,Rick Parris,DEM,190408,1,0,59,60,12
Creek,State House,Kyle Hilbert,REP,190408,6,11,246,263,29
Creek,State House,Jesse Goodwin,DEM,190408,1,0,57,58,29
Creek,Governor,Chris Powell,LIB,190409,1,0,23,24,
Creek,Governor,Kevin Stitt,REP,190409,7,28,480,515,
Creek,Governor,Drew Edmondson,DEM,190409,4,9,194,207,
Creek,Lieutenant Governor,Matt Pinnell,REP,190409,5,28,518,551,
Creek,Lieutenant Governor,Anastasia Pittman,DEM,190409,6,8,149,163,
Creek,Lieutenant Governor,Ivan Holmes,IND,190409,2,1,22,25,
Creek,State Auditor,John Yeutter,LIB,190409,1,6,119,126,
Creek,State Auditor,Cindy Byrd,REP,190409,11,31,540,582,
Creek,Attorney General,Mike Hunter,REP,190409,9,32,520,561,
Creek,Attorney General,Mark Myles,DEM,190409,4,4,164,172,
Creek,State Treasurer,Randy Mcdaniel,REP,190409,7,31,537,575,
Creek,State Treasurer,Charles De Coune,IND,190409,4,6,124,134,
Creek,Superintendent of Public Instruction,Joy Hofmeister,REP,190409,7,24,455,486,
Creek,Superintendent of Public Instruction,John Cox,DEM,190409,4,9,175,188,
Creek,Superintendent of Public Instruction,Larry Huff,IND,190409,1,4,56,61,
Creek,Commissioner of Labor,Leslie Osborn,REP,190409,6,28,496,530,
Creek,Commissioner of Labor,Fred Dorrell,DEM,190409,6,8,159,173,
Creek,Commissioner of Labor,Brandt Dismukes,IND,190409,1,1,25,27,
Creek,Insurance Commissioner,Glen Mulready,REP,190409,6,30,514,550,
Creek,Insurance Commissioner,Kimberly Fobbs,DEM,190409,7,6,167,180,
Creek,Corporation Commissioner,Bob Anthony,REP,190409,6,26,497,529,
Creek,Corporation Commissioner,Ashley Nicole Mccray,DEM,190409,6,8,157,171,
Creek,Corporation Commissioner,Jackie Short,IND,190409,1,3,30,34,
Creek,U.S. House,Frank Lucas,REP,190409,10,28,530,568,3
Creek,U.S. House,Frankie Robbins,DEM,190409,3,9,157,169,3
Creek,State Senate,James Leewright,REP,190409,10,32,559,601,12
Creek,State Senate,Rick Parris,DEM,190409,3,5,131,139,12
Creek,State House,Kyle Hilbert,REP,190409,10,32,540,582,29
Creek,State House,Jesse Goodwin,DEM,190409,3,5,147,155,29
Creek,Governor,Chris Powell,LIB,190410,0,0,9,9,
Creek,Governor,Kevin Stitt,REP,190410,5,2,142,149,
Creek,Governor,Drew Edmondson,DEM,190410,2,2,24,28,
Creek,Lieutenant Governor,Matt Pinnell,REP,190410,5,2,144,151,
Creek,Lieutenant Governor,Anastasia Pittman,DEM,190410,2,2,19,23,
Creek,Lieutenant Governor,Ivan Holmes,IND,190410,0,0,11,11,
Creek,State Auditor,John Yeutter,LIB,190410,2,1,27,30,
Creek,State Auditor,Cindy Byrd,REP,190410,5,2,146,153,
Creek,Attorney General,Mike Hunter,REP,190410,5,2,147,154,
Creek,Attorney General,Mark Myles,DEM,190410,2,2,27,31,
Creek,State Treasurer,Randy Mcdaniel,REP,190410,6,2,148,156,
Creek,State Treasurer,Charles De Coune,IND,190410,1,1,20,22,
Creek,Superintendent of Public Instruction,Joy Hofmeister,REP,190410,6,1,119,126,
Creek,Superintendent of Public Instruction,John Cox,DEM,190410,1,2,33,36,
Creek,Superintendent of Public Instruction,Larry Huff,IND,190410,0,0,21,21,
Creek,Commissioner of Labor,Leslie Osborn,REP,190410,5,2,137,144,
Creek,Commissioner of Labor,Fred Dorrell,DEM,190410,2,2,28,32,
Creek,Commissioner of Labor,Brandt Dismukes,IND,190410,0,0,5,5,
Creek,Insurance Commissioner,Glen Mulready,REP,190410,6,2,144,152,
Creek,Insurance Commissioner,Kimberly Fobbs,DEM,190410,1,2,27,30,
Creek,Corporation Commissioner,Bob Anthony,REP,190410,6,2,136,144,
Creek,Corporation Commissioner,Ashley Nicole Mccray,DEM,190410,1,2,25,28,
Creek,Corporation Commissioner,Jackie Short,IND,190410,0,0,10,10,
Creek,U.S. House,Frank Lucas,REP,190410,5,2,147,154,3
Creek,U.S. House,Frankie Robbins,DEM,190410,2,2,26,30,3
Creek,State Senate,James Leewright,REP,190410,5,2,146,153,12
Creek,State Senate,Rick Parris,DEM,190410,2,2,28,32,12
Creek,State House,Kyle Hilbert,REP,190410,6,2,144,152,29
Creek,State House,Jesse Goodwin,DEM,190410,1,2,30,33,29
Creek,Governor,Chris Powell,LIB,190411,0,0,17,17,
Creek,Governor,Kevin Stitt,REP,190411,4,14,239,257,
Creek,Governor,Drew Edmondson,DEM,190411,1,5,124,130,
Creek,Lieutenant Governor,Matt Pinnell,REP,190411,4,17,263,284,
Creek,Lieutenant Governor,Anastasia Pittman,DEM,190411,1,2,95,98,
Creek,Lieutenant Governor,Ivan Holmes,IND,190411,0,0,19,19,
Creek,State Auditor,John Yeutter,LIB,190411,0,2,72,74,
Creek,State Auditor,Cindy Byrd,REP,190411,4,15,280,299,
Creek,Attorney General,Mike Hunter,REP,190411,4,14,268,286,
Creek,Attorney General,Mark Myles,DEM,190411,1,5,109,115,
Creek,State Treasurer,Randy Mcdaniel,REP,190411,4,16,281,301,
Creek,State Treasurer,Charles De Coune,IND,190411,0,2,63,65,
Creek,Superintendent of Public Instruction,Joy Hofmeister,REP,190411,1,12,214,227,
Creek,Superintendent of Public Instruction,John Cox,DEM,190411,1,5,126,132,
Creek,Superintendent of Public Instruction,Larry Huff,IND,190411,2,2,37,41,
Creek,Commissioner of Labor,Leslie Osborn,REP,190411,3,14,241,258,
Creek,Commissioner of Labor,Fred Dorrell,DEM,190411,1,4,109,114,
Creek,Commissioner of Labor,Brandt Dismukes,IND,190411,0,1,24,25,
Creek,Insurance Commissioner,Glen Mulready,REP,190411,3,13,258,274,
Creek,Insurance Commissioner,Kimberly Fobbs,DEM,190411,1,6,115,122,
Creek,Corporation Commissioner,Bob Anthony,REP,190411,1,17,239,257,
Creek,Corporation Commissioner,Ashley Nicole Mccray,DEM,190411,3,2,113,118,
Creek,Corporation Commissioner,Jackie Short,IND,190411,0,0,23,23,
Creek,U.S. House,Frank Lucas,REP,190411,3,14,269,286,3
Creek,U.S. House,Frankie Robbins,DEM,190411,1,5,108,114,3
Creek,State Senate,James Leewright,REP,190411,3,14,283,300,12
Creek,State Senate,Rick Parris,DEM,190411,1,5,96,102,12
Creek,State House,Kyle Hilbert,REP,190411,3,14,301,318,29
Creek,State House,Jesse Goodwin,DEM,190411,1,5,79,85,29
Creek,Governor,Chris Powell,LIB,190412,1,1,8,10,
Creek,Governor,Kevin Stitt,REP,190412,9,13,263,285,
Creek,Governor,Drew Edmondson,DEM,190412,5,7,108,120,
Creek,Lieutenant Governor,Matt Pinnell,REP,190412,9,13,283,305,
Creek,Lieutenant Governor,Anastasia Pittman,DEM,190412,5,4,83,92,
Creek,Lieutenant Governor,Ivan Holmes,IND,190412,1,3,14,18,
Creek,State Auditor,John Yeutter,LIB,190412,1,6,61,68,
Creek,State Auditor,Cindy Byrd,REP,190412,10,13,299,322,
Creek,Attorney General,Mike Hunter,REP,190412,9,13,287,309,
Creek,Attorney General,Mark Myles,DEM,190412,6,7,90,103,
Creek,State Treasurer,Randy Mcdaniel,REP,190412,9,13,294,316,
Creek,State Treasurer,Charles De Coune,IND,190412,2,5,68,75,
Creek,Superintendent of Public Instruction,Joy Hofmeister,REP,190412,9,13,254,276,
Creek,Superintendent of Public Instruction,John Cox,DEM,190412,6,4,95,105,
Creek,Superintendent of Public Instruction,Larry Huff,IND,190412,0,3,28,31,
Creek,Commissioner of Labor,Leslie Osborn,REP,190412,10,13,267,290,
Creek,Commissioner of Labor,Fred Dorrell,DEM,190412,5,7,94,106,
Creek,Commissioner of Labor,Brandt Dismukes,IND,190412,0,0,12,12,
Creek,Insurance Commissioner,Glen Mulready,REP,190412,9,13,274,296,
Creek,Insurance Commissioner,Kimberly Fobbs,DEM,190412,6,7,100,113,
Creek,Corporation Commissioner,Bob Anthony,REP,190412,9,12,267,288,
Creek,Corporation Commissioner,Ashley Nicole Mccray,DEM,190412,6,7,98,111,
Creek,Corporation Commissioner,Jackie Short,IND,190412,0,1,13,14,
Creek,U.S. House,Frank Lucas,REP,190412,9,13,282,304,3
Creek,U.S. House,Frankie Robbins,DEM,190412,6,7,95,108,3
Creek,State Senate,James Leewright,REP,190412,9,15,295,319,12
Creek,State Senate,Rick Parris,DEM,190412,6,5,84,95,12
Creek,State House,Kyle Hilbert,REP,190412,10,16,283,309,29
Creek,State House,Jesse Goodwin,DEM,190412,5,4,93,102,29
Creek,Governor,Chris Powell,LIB,190413,0,0,10,10,
Creek,Governor,Kevin Stitt,REP,190413,15,21,442,478,
Creek,Governor,Drew Edmondson,DEM,190413,1,8,169,178,
Creek,Lieutenant Governor,Matt Pinnell,REP,190413,15,20,478,513,
Creek,Lieutenant Governor,Anastasia Pittman,DEM,190413,1,9,131,141,
Creek,Lieutenant Governor,Ivan Holmes,IND,190413,0,0,10,10,
Creek,State Auditor,John Yeutter,LIB,190413,1,2,79,82,
Creek,State Auditor,Cindy Byrd,REP,190413,14,25,505,544,
Creek,Attorney General,Mike Hunter,REP,190413,15,25,494,534,
Creek,Attorney General,Mark Myles,DEM,190413,1,4,121,126,
Creek,State Treasurer,Randy Mcdaniel,REP,190413,15,24,504,543,
Creek,State Treasurer,Charles De Coune,IND,190413,0,4,79,83,
Creek,Superintendent of Public Instruction,Joy Hofmeister,REP,190413,14,20,436,470,
Creek,Superintendent of Public Instruction,John Cox,DEM,190413,1,7,147,155,
Creek,Superintendent of Public Instruction,Larry Huff,IND,190413,1,2,35,38,
Creek,Commissioner of Labor,Leslie Osborn,REP,190413,15,21,466,502,
Creek,Commissioner of Labor,Fred Dorrell,DEM,190413,1,8,130,139,
Creek,Commissioner of Labor,Brandt Dismukes,IND,190413,0,0,19,19,
Creek,Insurance Commissioner,Glen Mulready,REP,190413,15,23,476,514,
Creek,Insurance Commissioner,Kimberly Fobbs,DEM,190413,1,6,141,148,
Creek,Corporation Commissioner,Bob Anthony,REP,190413,15,22,454,491,
Creek,Corporation Commissioner,Ashley Nicole Mccray,DEM,190413,1,6,137,144,
Creek,Corporation Commissioner,Jackie Short,IND,190413,0,1,28,29,
Creek,U.S. House,Frank Lucas,REP,190413,15,25,492,532,3
Creek,U.S. House,Frankie Robbins,DEM,190413,1,4,129,134,3
Creek,State Senate,James Leewright,REP,190413,15,25,513,553,12
Creek,State Senate,Rick Parris,DEM,190413,1,4,108,113,12
Creek,State House,Kyle Hilbert,REP,190413,15,25,504,544,29
Creek,State House,Jesse Goodwin,DEM,190413,1,4,118,123,29
Creek,Governor,Chris Powell,LIB,190414,0,4,34,38,
Creek,Governor,Kevin Stitt,REP,190414,28,154,773,955,
Creek,Governor,Drew Edmondson,DEM,190414,21,47,276,344,
Creek,Lieutenant Governor,Matt Pinnell,REP,190414,31,159,812,1002,
Creek,Lieutenant Governor,Anastasia Pittman,DEM,190414,19,42,230,291,
Creek,Lieutenant Governor,Ivan Holmes,IND,190414,0,4,39,43,
Creek,State Auditor,John Yeutter,LIB,190414,13,27,183,223,
Creek,State Auditor,Cindy Byrd,REP,190414,36,166,858,1060,
Creek,Attorney General,Mike Hunter,REP,190414,33,158,837,1028,
Creek,Attorney General,Mark Myles,DEM,190414,17,43,240,300,
Creek,State Treasurer,Randy Mcdaniel,REP,190414,33,160,844,1037,
Creek,State Treasurer,Charles De Coune,IND,190414,16,36,197,249,
Creek,Superintendent of Public Instruction,Joy Hofmeister,REP,190414,26,144,746,916,
Creek,Superintendent of Public Instruction,John Cox,DEM,190414,21,46,235,302,
Creek,Superintendent of Public Instruction,Larry Huff,IND,190414,3,14,99,116,
Creek,Commissioner of Labor,Leslie Osborn,REP,190414,28,150,773,951,
Creek,Commissioner of Labor,Fred Dorrell,DEM,190414,17,45,242,304,
Creek,Commissioner of Labor,Brandt Dismukes,IND,190414,5,7,53,65,
Creek,Insurance Commissioner,Glen Mulready,REP,190414,31,149,811,991,
Creek,Insurance Commissioner,Kimberly Fobbs,DEM,190414,19,53,263,335,
Creek,Corporation Commissioner,Bob Anthony,REP,190414,31,151,777,959,
Creek,Corporation Commissioner,Ashley Nicole Mccray,DEM,190414,15,46,226,287,
Creek,Corporation Commissioner,Jackie Short,IND,190414,4,7,73,84,
Creek,U.S. House,Frank Lucas,REP,190414,32,164,840,1036,3
Creek,U.S. House,Frankie Robbins,DEM,190414,18,40,237,295,3
Creek,State Senate,James Leewright,REP,190414,33,162,847,1042,12
Creek,State Senate,Rick Parris,DEM,190414,17,43,229,289,12
Creek,State House,Kyle Hilbert,REP,190414,32,156,814,1002,29
Creek,State House,Jesse Goodwin,DEM,190414,18,48,262,328,29
Creek,Governor,Chris Powell,LIB,190415,0,0,16,16,
Creek,Governor,Kevin Stitt,REP,190415,4,19,216,239,
Creek,Governor,Drew Edmondson,DEM,190415,0,10,79,89,
Creek,Lieutenant Governor,Matt Pinnell,REP,190415,3,21,235,259,
Creek,Lieutenant Governor,Anastasia Pittman,DEM,190415,0,6,60,66,
Creek,Lieutenant Governor,Ivan Holmes,IND,190415,1,1,14,16,
Creek,State Auditor,John Yeutter,LIB,190415,2,6,60,68,
Creek,State Auditor,Cindy Byrd,REP,190415,2,21,236,259,
Creek,Attorney General,Mike Hunter,REP,190415,4,21,235,260,
Creek,Attorney General,Mark Myles,DEM,190415,0,8,70,78,
Creek,State Treasurer,Randy Mcdaniel,REP,190415,4,21,236,261,
Creek,State Treasurer,Charles De Coune,IND,190415,0,6,61,67,
Creek,Superintendent of Public Instruction,Joy Hofmeister,REP,190415,3,16,209,228,
Creek,Superintendent of Public Instruction,John Cox,DEM,190415,0,9,68,77,
Creek,Superintendent of Public Instruction,Larry Huff,IND,190415,1,3,33,37,
Creek,Commissioner of Labor,Leslie Osborn,REP,190415,4,21,228,253,
Creek,Commissioner of Labor,Fred Dorrell,DEM,190415,0,6,55,61,
Creek,Commissioner of Labor,Brandt Dismukes,IND,190415,0,1,20,21,
Creek,Insurance Commissioner,Glen Mulready,REP,190415,4,21,237,262,
Creek,Insurance Commissioner,Kimberly Fobbs,DEM,190415,0,7,70,77,
Creek,Corporation Commissioner,Bob Anthony,REP,190415,3,21,215,239,
Creek,Corporation Commissioner,Ashley Nicole Mccray,DEM,190415,1,7,69,77,
Creek,Corporation Commissioner,Jackie Short,IND,190415,0,1,19,20,
Creek,U.S. House,Kevin Hern,REP,190415,4,21,234,259,1
Creek,U.S. House,Tim Gilpin,DEM,190415,0,8,75,83,1
Creek,State Senate,James Leewright,REP,190415,4,21,239,264,12
Creek,State Senate,Rick Parris,DEM,190415,0,8,70,78,12
Creek,State House,Kyle Hilbert,REP,190415,4,21,230,255,29
Creek,State House,Jesse Goodwin,DEM,190415,0,8,77,85,29
Creek,Governor,Chris Powell,LIB,190416,0,1,24,25,
Creek,Governor,Kevin Stitt,REP,190416,10,23,449,482,
Creek,Governor,Drew Edmondson,DEM,190416,1,6,153,160,
Creek,Lieutenant Governor,Matt Pinnell,REP,190416,10,23,501,534,
Creek,Lieutenant Governor,Anastasia Pittman,DEM,190416,1,7,99,107,
Creek,Lieutenant Governor,Ivan Holmes,IND,190416,0,1,22,23,
Creek,State Auditor,John Yeutter,LIB,190416,2,4,95,101,
Creek,State Auditor,Cindy Byrd,REP,190416,9,24,500,533,
Creek,Attorney General,Mike Hunter,REP,190416,10,25,497,532,
Creek,Attorney General,Mark Myles,DEM,190416,1,6,126,133,
Creek,State Treasurer,Randy Mcdaniel,REP,190416,10,24,495,529,
Creek,State Treasurer,Charles De Coune,IND,190416,1,5,98,104,
Creek,Superintendent of Public Instruction,Joy Hofmeister,REP,190416,10,19,442,471,
Creek,Superintendent of Public Instruction,John Cox,DEM,190416,1,6,122,129,
Creek,Superintendent of Public Instruction,Larry Huff,IND,190416,0,4,60,64,
Creek,Commissioner of Labor,Leslie Osborn,REP,190416,10,21,462,493,
Creek,Commissioner of Labor,Fred Dorrell,DEM,190416,1,5,123,129,
Creek,Commissioner of Labor,Brandt Dismukes,IND,190416,0,3,28,31,
Creek,Insurance Commissioner,Glen Mulready,REP,190416,10,21,479,510,
Creek,Insurance Commissioner,Kimberly Fobbs,DEM,190416,1,8,139,148,
Creek,Corporation Commissioner,Bob Anthony,REP,190416,10,21,471,502,
Creek,Corporation Commissioner,Ashley Nicole Mccray,DEM,190416,1,7,119,127,
Creek,Corporation Commissioner,Jackie Short,IND,190416,0,2,30,32,
Creek,U.S. House,Kevin Hern,REP,190416,10,23,489,522,1
Creek,U.S. House,Tim Gilpin,DEM,190416,1,8,135,144,1
Creek,State Senate,James Leewright,REP,190416,10,24,501,535,12
Creek,State Senate,Rick Parris,DEM,190416,1,7,121,129,12
Creek,Governor,Chris Powell,LIB,190417,1,3,42,46,
Creek,Governor,Kevin Stitt,REP,190417,29,149,844,1022,
Creek,Governor,Drew Edmondson,DEM,190417,7,66,298,371,
Creek,Lieutenant Governor,Matt Pinnell,REP,190417,31,164,917,1112,
Creek,Lieutenant Governor,Anastasia Pittman,DEM,190417,5,51,226,282,
Creek,Lieutenant Governor,Ivan Holmes,IND,190417,0,3,35,38,
Creek,State Auditor,John Yeutter,LIB,190417,3,31,187,221,
Creek,State Auditor,Cindy Byrd,REP,190417,31,171,954,1156,
Creek,Attorney General,Mike Hunter,REP,190417,30,162,939,1131,
Creek,Attorney General,Mark Myles,DEM,190417,7,54,236,297,
Creek,State Treasurer,Randy Mcdaniel,REP,190417,31,167,955,1153,
Creek,State Treasurer,Charles De Coune,IND,190417,4,38,180,222,
Creek,Superintendent of Public Instruction,Joy Hofmeister,REP,190417,28,142,831,1001,
Creek,Superintendent of Public Instruction,John Cox,DEM,190417,7,63,251,321,
Creek,Superintendent of Public Instruction,Larry Huff,IND,190417,1,13,97,111,
Creek,Commissioner of Labor,Leslie Osborn,REP,190417,29,149,890,1068,
Creek,Commissioner of Labor,Fred Dorrell,DEM,190417,6,56,225,287,
Creek,Commissioner of Labor,Brandt Dismukes,IND,190417,1,11,52,64,
Creek,Insurance Commissioner,Glen Mulready,REP,190417,32,155,895,1082,
Creek,Insurance Commissioner,Kimberly Fobbs,DEM,190417,5,63,276,344,
Creek,Corporation Commissioner,Bob Anthony,REP,190417,29,163,895,1087,
Creek,Corporation Commissioner,Ashley Nicole Mccray,DEM,190417,6,52,214,272,
Creek,Corporation Commissioner,Jackie Short,IND,190417,1,3,67,71,
Creek,U.S. House,Kevin Hern,REP,190417,31,158,917,1106,1
Creek,U.S. House,Tim Gilpin,DEM,190417,6,60,262,328,1
Creek,State Senate,James Leewright,REP,190417,30,160,942,1132,12
Creek,State Senate,Rick Parris,DEM,190417,7,57,235,299,12
Creek,Governor,Chris Powell,LIB,190418,2,0,21,23,
Creek,Governor,Kevin Stitt,REP,190418,32,127,547,706,
Creek,Governor,Drew Edmondson,DEM,190418,15,83,235,333,
Creek,Lieutenant Governor,Matt Pinnell,REP,190418,35,145,607,787,
Creek,Lieutenant Governor,Anastasia Pittman,DEM,190418,13,63,174,250,
Creek,Lieutenant Governor,Ivan Holmes,IND,190418,1,1,17,19,
Creek,State Auditor,John Yeutter,LIB,190418,9,39,136,184,
Creek,State Auditor,Cindy Byrd,REP,190418,38,154,623,815,
Creek,Attorney General,Mike Hunter,REP,190418,33,146,605,784,
Creek,Attorney General,Mark Myles,DEM,190418,15,62,187,264,
Creek,State Treasurer,Randy Mcdaniel,REP,190418,37,150,616,803,
Creek,State Treasurer,Charles De Coune,IND,190418,10,43,139,192,
Creek,Superintendent of Public Instruction,Joy Hofmeister,REP,190418,33,140,550,723,
Creek,Superintendent of Public Instruction,John Cox,DEM,190418,13,57,191,261,
Creek,Superintendent of Public Instruction,Larry Huff,IND,190418,1,12,53,66,
Creek,Commissioner of Labor,Leslie Osborn,REP,190418,35,134,560,729,
Creek,Commissioner of Labor,Fred Dorrell,DEM,190418,13,66,183,262,
Creek,Commissioner of Labor,Brandt Dismukes,IND,190418,1,6,36,43,
Creek,Insurance Commissioner,Glen Mulready,REP,190418,35,138,587,760,
Creek,Insurance Commissioner,Kimberly Fobbs,DEM,190418,14,68,196,278,
Creek,Corporation Commissioner,Bob Anthony,REP,190418,32,142,578,752,
Creek,Corporation Commissioner,Ashley Nicole Mccray,DEM,190418,15,55,170,240,
Creek,Corporation Commissioner,Jackie Short,IND,190418,2,9,41,52,
Creek,U.S. House,Frank Lucas,REP,190418,37,150,613,800,3
Creek,U.S. House,Frankie Robbins,DEM,190418,12,59,177,248,3
Creek,State Senate,James Leewright,REP,190418,38,149,613,800,12
Creek,State Senate,Rick Parris,DEM,190418,11,58,172,241,12
Creek,Governor,Chris Powell,LIB,190419,0,0,22,22,
Creek,Governor,Kevin Stitt,REP,190419,21,54,464,539,
Creek,Governor,Drew Edmondson,DEM,190419,7,33,235,275,
Creek,Lieutenant Governor,Matt Pinnell,REP,190419,19,64,527,610,
Creek,Lieutenant Governor,Anastasia Pittman,DEM,190419,8,24,166,198,
Creek,Lieutenant Governor,Ivan Holmes,IND,190419,1,0,22,23,
Creek,State Auditor,John Yeutter,LIB,190419,3,8,129,140,
Creek,State Auditor,Cindy Byrd,REP,190419,23,76,548,647,
Creek,Attorney General,Mike Hunter,REP,190419,23,62,517,602,
Creek,Attorney General,Mark Myles,DEM,190419,5,27,192,224,
Creek,State Treasurer,Randy Mcdaniel,REP,190419,22,66,528,616,
Creek,State Treasurer,Charles De Coune,IND,190419,5,19,147,171,
Creek,Superintendent of Public Instruction,Joy Hofmeister,REP,190419,21,55,498,574,
Creek,Superintendent of Public Instruction,John Cox,DEM,190419,6,24,169,199,
Creek,Superintendent of Public Instruction,Larry Huff,IND,190419,1,9,50,60,
Creek,Commissioner of Labor,Leslie Osborn,REP,190419,24,61,498,583,
Creek,Commissioner of Labor,Fred Dorrell,DEM,190419,4,26,172,202,
Creek,Commissioner of Labor,Brandt Dismukes,IND,190419,0,1,35,36,
Creek,Insurance Commissioner,Glen Mulready,REP,190419,21,59,508,588,
Creek,Insurance Commissioner,Kimberly Fobbs,DEM,190419,6,27,199,232,
Creek,Corporation Commissioner,Bob Anthony,REP,190419,18,66,495,579,
Creek,Corporation Commissioner,Ashley Nicole Mccray,DEM,190419,9,21,176,206,
Creek,Corporation Commissioner,Jackie Short,IND,190419,1,1,40,42,
Creek,U.S. House,Frank Lucas,REP,190419,19,62,529,610,3
Creek,U.S. House,Frankie Robbins,DEM,190419,9,26,183,218,3
Creek,State Senate,James Leewright,REP,190419,19,61,532,612,12
Creek,State Senate,Rick Parris,DEM,190419,9,27,180,216,12
Creek,Governor,Chris Powell,LIB,190420,0,0,13,13,
Creek,Governor,Kevin Stitt,REP,190420,8,13,300,321,
Creek,Governor,Drew Edmondson,DEM,190420,19,12,161,192,
Creek,Lieutenant Governor,Matt Pinnell,REP,190420,9,15,348,372,
Creek,Lieutenant Governor,Anastasia Pittman,DEM,190420,18,10,110,138,
Creek,Lieutenant Governor,Ivan Holmes,IND,190420,0,0,10,10,
Creek,State Auditor,John Yeutter,LIB,190420,8,8,74,90,
Creek,State Auditor,Cindy Byrd,REP,190420,14,13,360,387,
Creek,Attorney General,Mike Hunter,REP,190420,8,14,361,383,
Creek,Attorney General,Mark Myles,DEM,190420,19,11,109,139,
Creek,State Treasurer,Randy Mcdaniel,REP,190420,10,15,348,373,
Creek,State Treasurer,Charles De Coune,IND,190420,13,8,87,108,
Creek,Superintendent of Public Instruction,Joy Hofmeister,REP,190420,11,16,325,352,
Creek,Superintendent of Public Instruction,John Cox,DEM,190420,15,9,105,129,
Creek,Superintendent of Public Instruction,Larry Huff,IND,190420,1,0,30,31,
Creek,Commissioner of Labor,Leslie Osborn,REP,190420,7,13,329,349,
Creek,Commissioner of Labor,Fred Dorrell,DEM,190420,20,11,102,133,
Creek,Commissioner of Labor,Brandt Dismukes,IND,190420,0,0,27,27,
Creek,Insurance Commissioner,Glen Mulready,REP,190420,7,15,349,371,
Creek,Insurance Commissioner,Kimberly Fobbs,DEM,190420,20,9,105,134,
Creek,Corporation Commissioner,Bob Anthony,REP,190420,7,16,331,354,
Creek,Corporation Commissioner,Ashley Nicole Mccray,DEM,190420,18,9,108,135,
Creek,Corporation Commissioner,Jackie Short,IND,190420,2,0,22,24,
Creek,U.S. House,Frank Lucas,REP,190420,10,14,343,367,3
Creek,U.S. House,Frankie Robbins,DEM,190420,17,11,123,151,3
Creek,State Senate,James Leewright,REP,190420,8,11,347,366,12
Creek,State Senate,Rick Parris,DEM,190420,18,14,118,150,12
Creek,State House,J. Lee Miller Jr.,LIB,190420,0,2,18,20,68
Creek,State House,Lonnie Sims,REP,190420,6,12,301,319,68
Creek,State House,Michael Ross,DEM,190420,17,11,101,129,68
Creek,State House,Heather Chenoweth,IND,190420,3,0,44,47,68
Creek,Governor,Chris Powell,LIB,190421,1,0,21,22,
Creek,Governor,Kevin Stitt,REP,190421,37,41,449,527,
Creek,Governor,Drew Edmondson,DEM,190421,23,20,223,266,
Creek,Lieutenant Governor,Matt Pinnell,REP,190421,38,43,493,574,
Creek,Lieutenant Governor,Anastasia Pittman,DEM,190421,20,18,184,222,
Creek,Lieutenant Governor,Ivan Holmes,IND,190421,0,0,13,13,
Creek,State Auditor,John Yeutter,LIB,190421,7,14,134,155,
Creek,State Auditor,Cindy Byrd,REP,190421,42,44,505,591,
Creek,Attorney General,Mike Hunter,REP,190421,39,46,498,583,
Creek,Attorney General,Mark Myles,DEM,190421,18,15,185,218,
Creek,State Treasurer,Randy Mcdaniel,REP,190421,39,48,503,590,
Creek,State Treasurer,Charles De Coune,IND,190421,13,10,134,157,
Creek,Superintendent of Public Instruction,Joy Hofmeister,REP,190421,40,39,465,544,
Creek,Superintendent of Public Instruction,John Cox,DEM,190421,17,21,179,217,
Creek,Superintendent of Public Instruction,Larry Huff,IND,190421,2,1,43,46,
Creek,Commissioner of Labor,Leslie Osborn,REP,190421,41,42,470,553,
Creek,Commissioner of Labor,Fred Dorrell,DEM,190421,16,17,185,218,
Creek,Commissioner of Labor,Brandt Dismukes,IND,190421,1,1,23,25,
Creek,Insurance Commissioner,Glen Mulready,REP,190421,37,45,474,556,
Creek,Insurance Commissioner,Kimberly Fobbs,DEM,190421,21,14,204,239,
Creek,Corporation Commissioner,Bob Anthony,REP,190421,36,41,476,553,
Creek,Corporation Commissioner,Ashley Nicole Mccray,DEM,190421,21,19,181,221,
Creek,Corporation Commissioner,Jackie Short,IND,190421,1,1,26,28,
Creek,U.S. House,Frank Lucas,REP,190421,37,44,495,576,3
Creek,U.S. House,Frankie Robbins,DEM,190421,22,16,191,229,3
Creek,State Senate,James Leewright,REP,190421,36,41,477,554,12
Creek,State Senate,Rick Parris,DEM,190421,22,20,201,243,12
Creek,Governor,Chris Powell,LIB,190422,0,0,22,22,
Creek,Governor,Kevin Stitt,REP,190422,20,24,275,319,
Creek,Governor,Drew Edmondson,DEM,190422,3,6,89,98,
Creek,Lieutenant Governor,Matt Pinnell,REP,190422,21,24,296,341,
Creek,Lieutenant Governor,Anastasia Pittman,DEM,190422,2,4,81,87,
Creek,Lieutenant Governor,Ivan Holmes,IND,190422,0,1,8,9,
Creek,State Auditor,John Yeutter,LIB,190422,4,6,65,75,
Creek,State Auditor,Cindy Byrd,REP,190422,19,23,300,342,
Creek,Attorney General,Mike Hunter,REP,190422,21,24,291,336,
Creek,Attorney General,Mark Myles,DEM,190422,2,5,91,98,
Creek,State Treasurer,Randy Mcdaniel,REP,190422,22,22,297,341,
Creek,State Treasurer,Charles De Coune,IND,190422,1,7,63,71,
Creek,Superintendent of Public Instruction,Joy Hofmeister,REP,190422,20,20,269,309,
Creek,Superintendent of Public Instruction,John Cox,DEM,190422,2,6,87,95,
Creek,Superintendent of Public Instruction,Larry Huff,IND,190422,1,3,27,31,
Creek,Commissioner of Labor,Leslie Osborn,REP,190422,20,22,283,325,
Creek,Commissioner of Labor,Fred Dorrell,DEM,190422,2,3,81,86,
Creek,Commissioner of Labor,Brandt Dismukes,IND,190422,1,4,13,18,
Creek,Insurance Commissioner,Glen Mulready,REP,190422,22,25,287,334,
Creek,Insurance Commissioner,Kimberly Fobbs,DEM,190422,1,4,91,96,
Creek,Corporation Commissioner,Bob Anthony,REP,190422,21,22,266,309,
Creek,Corporation Commissioner,Ashley Nicole Mccray,DEM,190422,0,5,91,96,
Creek,Corporation Commissioner,Jackie Short,IND,190422,2,2,23,27,
Creek,U.S. House,Frank Lucas,REP,190422,22,24,299,345,3
Creek,U.S. House,Frankie Robbins,DEM,190422,1,5,82,88,3
Creek,State Senate,James Leewright,REP,190422,22,25,302,349,12
Creek,State Senate,Rick Parris,DEM,190422,1,4,80,85,12
Creek,State House,Kyle Hilbert,REP,190422,21,24,292,337,29
Creek,State House,Jesse Goodwin,DEM,190422,2,5,90,97,29
Custer,Governor,Chris Powell,LIB,200001,0,0,33,33,
Custer,Governor,Kevin Stitt,REP,200001,10,22,193,225,
Custer,Governor,Drew Edmondson,DEM,200001,6,18,176,200,
Custer,Lieutenant Governor,Matt Pinnell,REP,200001,11,25,225,261,
Custer,Lieutenant Governor,Anastasia Pittman,DEM,200001,5,14,155,174,
Custer,Lieutenant Governor,Ivan Holmes,IND,200001,0,2,19,21,
Custer,State Auditor,John Yeutter,LIB,200001,4,11,106,121,
Custer,State Auditor,Cindy Byrd,REP,200001,11,28,267,306,
Custer,Attorney General,Mike Hunter,REP,200001,11,24,246,281,
Custer,Attorney General,Mark Myles,DEM,200001,5,17,152,174,
Custer,State Treasurer,Randy Mcdaniel,REP,200001,10,27,269,306,
Custer,State Treasurer,Charles De Coune,IND,200001,5,13,102,120,
Custer,Superintendent of Public Instruction,Joy Hofmeister,REP,200001,11,25,198,234,
Custer,Superintendent of Public Instruction,John Cox,DEM,200001,4,13,154,171,
Custer,Superintendent of Public Instruction,Larry Huff,IND,200001,1,3,47,51,
Custer,Commissioner of Labor,Leslie Osborn,REP,200001,12,23,236,271,
Custer,Commissioner of Labor,Fred Dorrell,DEM,200001,4,17,136,157,
Custer,Commissioner of Labor,Brandt Dismukes,IND,200001,0,1,26,27,
Custer,Insurance Commissioner,Glen Mulready,REP,200001,11,24,230,265,
Custer,Insurance Commissioner,Kimberly Fobbs,DEM,200001,5,16,164,185,
Custer,Corporation Commissioner,Bob Anthony,REP,200001,11,24,224,259,
Custer,Corporation Commissioner,Ashley Nicole Mccray,DEM,200001,4,16,149,169,
Custer,Corporation Commissioner,Jackie Short,IND,200001,1,2,24,27,
Custer,U.S. House,Frank Lucas,REP,200001,11,29,260,300,3
Custer,U.S. House,Frankie Robbins,DEM,200001,5,12,141,158,3
Custer,State Senate,Brent Howard,REP,200001,8,21,201,230,38
Custer,State Senate,Jeff Berrong,DEM,200001,8,21,200,229,38
Custer,Governor,Chris Powell,LIB,200003,0,2,28,30,
Custer,Governor,Kevin Stitt,REP,200003,12,56,355,423,
Custer,Governor,Drew Edmondson,DEM,200003,9,23,207,239,
Custer,Lieutenant Governor,Matt Pinnell,REP,200003,14,64,432,510,
Custer,Lieutenant Governor,Anastasia Pittman,DEM,200003,7,16,131,154,
Custer,Lieutenant Governor,Ivan Holmes,IND,200003,0,1,25,26,
Custer,State Auditor,John Yeutter,LIB,200003,2,11,105,118,
Custer,State Auditor,Cindy Byrd,REP,200003,19,68,468,555,
Custer,Attorney General,Mike Hunter,REP,200003,16,64,434,514,
Custer,Attorney General,Mark Myles,DEM,200003,5,18,154,177,
Custer,State Treasurer,Randy Mcdaniel,REP,200003,15,70,462,547,
Custer,State Treasurer,Charles De Coune,IND,200003,6,11,111,128,
Custer,Superintendent of Public Instruction,Joy Hofmeister,REP,200003,13,64,407,484,
Custer,Superintendent of Public Instruction,John Cox,DEM,200003,5,15,131,151,
Custer,Superintendent of Public Instruction,Larry Huff,IND,200003,3,3,52,58,
Custer,Commissioner of Labor,Leslie Osborn,REP,200003,15,69,415,499,
Custer,Commissioner of Labor,Fred Dorrell,DEM,200003,6,11,131,148,
Custer,Commissioner of Labor,Brandt Dismukes,IND,200003,0,2,35,37,
Custer,Insurance Commissioner,Glen Mulready,REP,200003,12,67,415,494,
Custer,Insurance Commissioner,Kimberly Fobbs,DEM,200003,8,14,164,186,
Custer,Corporation Commissioner,Bob Anthony,REP,200003,15,66,393,474,
Custer,Corporation Commissioner,Ashley Nicole Mccray,DEM,200003,6,13,161,180,
Custer,Corporation Commissioner,Jackie Short,IND,200003,0,3,33,36,
Custer,U.S. House,Frank Lucas,REP,200003,17,70,457,544,3
Custer,U.S. House,Frankie Robbins,DEM,200003,4,12,133,149,3
Custer,State Senate,Brent Howard,REP,200003,10,49,357,416,38
Custer,State Senate,Jeff Berrong,DEM,200003,11,33,232,276,38
Custer,Governor,Chris Powell,LIB,200005,4,4,17,25,
Custer,Governor,Kevin Stitt,REP,200005,13,67,330,410,
Custer,Governor,Drew Edmondson,DEM,200005,12,42,215,269,
Custer,Lieutenant Governor,Matt Pinnell,REP,200005,18,79,404,501,
Custer,Lieutenant Governor,Anastasia Pittman,DEM,200005,9,30,143,182,
Custer,Lieutenant Governor,Ivan Holmes,IND,200005,1,3,15,19,
Custer,State Auditor,John Yeutter,LIB,200005,8,13,88,109,
Custer,State Auditor,Cindy Byrd,REP,200005,17,91,443,551,
Custer,Attorney General,Mike Hunter,REP,200005,20,80,416,516,
Custer,Attorney General,Mark Myles,DEM,200005,8,33,142,183,
Custer,State Treasurer,Randy Mcdaniel,REP,200005,18,86,441,545,
Custer,State Treasurer,Charles De Coune,IND,200005,6,17,95,118,
Custer,Superintendent of Public Instruction,Joy Hofmeister,REP,200005,14,76,405,495,
Custer,Superintendent of Public Instruction,John Cox,DEM,200005,9,28,116,153,
Custer,Superintendent of Public Instruction,Larry Huff,IND,200005,5,9,38,52,
Custer,Commissioner of Labor,Leslie Osborn,REP,200005,13,83,400,496,
Custer,Commissioner of Labor,Fred Dorrell,DEM,200005,13,23,125,161,
Custer,Commissioner of Labor,Brandt Dismukes,IND,200005,2,4,26,32,
Custer,Insurance Commissioner,Glen Mulready,REP,200005,13,78,382,473,
Custer,Insurance Commissioner,Kimberly Fobbs,DEM,200005,13,34,172,219,
Custer,Corporation Commissioner,Bob Anthony,REP,200005,13,71,388,472,
Custer,Corporation Commissioner,Ashley Nicole Mccray,DEM,200005,9,32,133,174,
Custer,Corporation Commissioner,Jackie Short,IND,200005,5,8,38,51,
Custer,U.S. House,Frank Lucas,REP,200005,20,85,445,550,3
Custer,U.S. House,Frankie Robbins,DEM,200005,8,28,116,152,3
Custer,State Senate,Brent Howard,REP,200005,12,56,329,397,38
Custer,State Senate,Jeff Berrong,DEM,200005,13,57,231,301,38
Custer,Governor,Chris Powell,LIB,200007,0,0,8,8,
Custer,Governor,Kevin Stitt,REP,200007,17,33,192,242,
Custer,Governor,Drew Edmondson,DEM,200007,11,21,159,191,
Custer,Lieutenant Governor,Matt Pinnell,REP,200007,18,30,212,260,
Custer,Lieutenant Governor,Anastasia Pittman,DEM,200007,10,22,137,169,
Custer,Lieutenant Governor,Ivan Holmes,IND,200007,0,1,8,9,
Custer,State Auditor,John Yeutter,LIB,200007,2,11,87,100,
Custer,State Auditor,Cindy Byrd,REP,200007,22,37,256,315,
Custer,Attorney General,Mike Hunter,REP,200007,20,34,223,277,
Custer,Attorney General,Mark Myles,DEM,200007,8,20,133,161,
Custer,State Treasurer,Randy Mcdaniel,REP,200007,21,36,249,306,
Custer,State Treasurer,Charles De Coune,IND,200007,3,13,92,108,
Custer,Superintendent of Public Instruction,Joy Hofmeister,REP,200007,21,32,204,257,
Custer,Superintendent of Public Instruction,John Cox,DEM,200007,7,17,126,150,
Custer,Superintendent of Public Instruction,Larry Huff,IND,200007,0,3,28,31,
Custer,Commissioner of Labor,Leslie Osborn,REP,200007,20,31,218,269,
Custer,Commissioner of Labor,Fred Dorrell,DEM,200007,8,20,123,151,
Custer,Commissioner of Labor,Brandt Dismukes,IND,200007,0,1,14,15,
Custer,Insurance Commissioner,Glen Mulready,REP,200007,18,34,216,268,
Custer,Insurance Commissioner,Kimberly Fobbs,DEM,200007,10,18,138,166,
Custer,Corporation Commissioner,Bob Anthony,REP,200007,17,32,211,260,
Custer,Corporation Commissioner,Ashley Nicole Mccray,DEM,200007,10,20,130,160,
Custer,Corporation Commissioner,Jackie Short,IND,200007,1,1,14,16,
Custer,U.S. House,Frank Lucas,REP,200007,19,38,229,286,3
Custer,U.S. House,Frankie Robbins,DEM,200007,9,16,126,151,3
Custer,State Senate,Brent Howard,REP,200007,18,32,188,238,38
Custer,State Senate,Jeff Berrong,DEM,200007,10,21,172,203,38
Custer,Governor,Chris Powell,LIB,200012,0,4,17,21,
Custer,Governor,Kevin Stitt,REP,200012,11,35,290,336,
Custer,Governor,Drew Edmondson,DEM,200012,2,13,100,115,
Custer,Lieutenant Governor,Matt Pinnell,REP,200012,9,33,310,352,
Custer,Lieutenant Governor,Anastasia Pittman,DEM,200012,2,15,83,100,
Custer,Lieutenant Governor,Ivan Holmes,IND,200012,2,4,13,19,
Custer,State Auditor,John Yeutter,LIB,200012,0,11,52,63,
Custer,State Auditor,Cindy Byrd,REP,200012,13,39,343,395,
Custer,Attorney General,Mike Hunter,REP,200012,9,39,326,374,
Custer,Attorney General,Mark Myles,DEM,200012,3,13,79,95,
Custer,State Treasurer,Randy Mcdaniel,REP,200012,11,41,346,398,
Custer,State Treasurer,Charles De Coune,IND,200012,1,10,46,57,
Custer,Superintendent of Public Instruction,Joy Hofmeister,REP,200012,10,35,291,336,
Custer,Superintendent of Public Instruction,John Cox,DEM,200012,3,11,79,93,
Custer,Superintendent of Public Instruction,Larry Huff,IND,200012,0,6,33,39,
Custer,Commissioner of Labor,Leslie Osborn,REP,200012,10,38,311,359,
Custer,Commissioner of Labor,Fred Dorrell,DEM,200012,3,11,73,87,
Custer,Commissioner of Labor,Brandt Dismukes,IND,200012,0,3,17,20,
Custer,Insurance Commissioner,Glen Mulready,REP,200012,10,38,309,357,
Custer,Insurance Commissioner,Kimberly Fobbs,DEM,200012,3,14,94,111,
Custer,Corporation Commissioner,Bob Anthony,REP,200012,9,33,309,351,
Custer,Corporation Commissioner,Ashley Nicole Mccray,DEM,200012,3,15,73,91,
Custer,Corporation Commissioner,Jackie Short,IND,200012,1,4,22,27,
Custer,U.S. House,Frank Lucas,REP,200012,11,42,343,396,3
Custer,U.S. House,Frankie Robbins,DEM,200012,2,10,64,76,3
Custer,Governor,Chris Powell,LIB,200013,0,0,13,13,
Custer,Governor,Kevin Stitt,REP,200013,3,12,142,157,
Custer,Governor,Drew Edmondson,DEM,200013,0,9,61,70,
Custer,Lieutenant Governor,Matt Pinnell,REP,200013,3,13,156,172,
Custer,Lieutenant Governor,Anastasia Pittman,DEM,200013,0,6,53,59,
Custer,Lieutenant Governor,Ivan Holmes,IND,200013,0,1,6,7,
Custer,State Auditor,John Yeutter,LIB,200013,0,4,36,40,
Custer,State Auditor,Cindy Byrd,REP,200013,3,15,168,186,
Custer,Attorney General,Mike Hunter,REP,200013,3,15,163,181,
Custer,Attorney General,Mark Myles,DEM,200013,0,6,48,54,
Custer,State Treasurer,Randy Mcdaniel,REP,200013,3,14,169,186,
Custer,State Treasurer,Charles De Coune,IND,200013,0,5,33,38,
Custer,Superintendent of Public Instruction,Joy Hofmeister,REP,200013,3,15,141,159,
Custer,Superintendent of Public Instruction,John Cox,DEM,200013,0,6,53,59,
Custer,Superintendent of Public Instruction,Larry Huff,IND,200013,0,0,20,20,
Custer,Commissioner of Labor,Leslie Osborn,REP,200013,3,15,153,171,
Custer,Commissioner of Labor,Fred Dorrell,DEM,200013,0,6,47,53,
Custer,Commissioner of Labor,Brandt Dismukes,IND,200013,0,0,13,13,
Custer,Insurance Commissioner,Glen Mulready,REP,200013,3,14,146,163,
Custer,Insurance Commissioner,Kimberly Fobbs,DEM,200013,0,7,68,75,
Custer,Corporation Commissioner,Bob Anthony,REP,200013,3,14,156,173,
Custer,Corporation Commissioner,Ashley Nicole Mccray,DEM,200013,0,6,42,48,
Custer,Corporation Commissioner,Jackie Short,IND,200013,0,0,17,17,
Custer,U.S. House,Frank Lucas,REP,200013,3,15,176,194,3
Custer,U.S. House,Frankie Robbins,DEM,200013,0,6,40,46,3
Custer,Governor,Chris Powell,LIB,200018,0,0,31,31,
Custer,Governor,Kevin Stitt,REP,200018,27,50,547,624,
Custer,Governor,Drew Edmondson,DEM,200018,16,27,255,298,
Custer,Lieutenant Governor,Matt Pinnell,REP,200018,31,53,613,697,
Custer,Lieutenant Governor,Anastasia Pittman,DEM,200018,11,20,203,234,
Custer,Lieutenant Governor,Ivan Holmes,IND,200018,0,2,15,17,
Custer,State Auditor,John Yeutter,LIB,200018,5,12,133,150,
Custer,State Auditor,Cindy Byrd,REP,200018,34,60,677,771,
Custer,Attorney General,Mike Hunter,REP,200018,26,53,626,705,
Custer,Attorney General,Mark Myles,DEM,200018,16,23,195,234,
Custer,State Treasurer,Randy Mcdaniel,REP,200018,33,56,654,743,
Custer,State Treasurer,Charles De Coune,IND,200018,6,15,150,171,
Custer,Superintendent of Public Instruction,Joy Hofmeister,REP,200018,27,49,585,661,
Custer,Superintendent of Public Instruction,John Cox,DEM,200018,14,20,174,208,
Custer,Superintendent of Public Instruction,Larry Huff,IND,200018,0,6,66,72,
Custer,Commissioner of Labor,Leslie Osborn,REP,200018,31,53,617,701,
Custer,Commissioner of Labor,Fred Dorrell,DEM,200018,11,19,175,205,
Custer,Commissioner of Labor,Brandt Dismukes,IND,200018,0,2,30,32,
Custer,Insurance Commissioner,Glen Mulready,REP,200018,31,56,598,685,
Custer,Insurance Commissioner,Kimberly Fobbs,DEM,200018,12,19,217,248,
Custer,Corporation Commissioner,Bob Anthony,REP,200018,30,52,568,650,
Custer,Corporation Commissioner,Ashley Nicole Mccray,DEM,200018,11,22,203,236,
Custer,Corporation Commissioner,Jackie Short,IND,200018,1,1,49,51,
Custer,U.S. House,Frank Lucas,REP,200018,31,59,640,730,3
Custer,U.S. House,Frankie Robbins,DEM,200018,11,18,188,217,3
Custer,State Senate,Brent Howard,REP,200018,18,47,472,537,38
Custer,State Senate,Jeff Berrong,DEM,200018,24,30,355,409,38
Custer,Governor,Chris Powell,LIB,200019,2,1,30,33,
Custer,Governor,Kevin Stitt,REP,200019,18,49,509,576,
Custer,Governor,Drew Edmondson,DEM,200019,16,18,269,303,
Custer,Lieutenant Governor,Matt Pinnell,REP,200019,17,50,573,640,
Custer,Lieutenant Governor,Anastasia Pittman,DEM,200019,14,15,204,233,
Custer,Lieutenant Governor,Ivan Holmes,IND,200019,4,2,26,32,
Custer,State Auditor,John Yeutter,LIB,200019,7,7,133,147,
Custer,State Auditor,Cindy Byrd,REP,200019,23,60,647,730,
Custer,Attorney General,Mike Hunter,REP,200019,19,54,601,674,
Custer,Attorney General,Mark Myles,DEM,200019,17,14,202,233,
Custer,State Treasurer,Randy Mcdaniel,REP,200019,20,51,619,690,
Custer,State Treasurer,Charles De Coune,IND,200019,12,15,154,181,
Custer,Superintendent of Public Instruction,Joy Hofmeister,REP,200019,18,51,564,633,
Custer,Superintendent of Public Instruction,John Cox,DEM,200019,13,12,174,199,
Custer,Superintendent of Public Instruction,Larry Huff,IND,200019,5,5,70,80,
Custer,Commissioner of Labor,Leslie Osborn,REP,200019,19,51,583,653,
Custer,Commissioner of Labor,Fred Dorrell,DEM,200019,13,14,171,198,
Custer,Commissioner of Labor,Brandt Dismukes,IND,200019,4,3,45,52,
Custer,Insurance Commissioner,Glen Mulready,REP,200019,19,50,583,652,
Custer,Insurance Commissioner,Kimberly Fobbs,DEM,200019,15,17,211,243,
Custer,Corporation Commissioner,Bob Anthony,REP,200019,20,51,554,625,
Custer,Corporation Commissioner,Ashley Nicole Mccray,DEM,200019,12,15,195,222,
Custer,Corporation Commissioner,Jackie Short,IND,200019,4,3,50,57,
Custer,U.S. House,Frank Lucas,REP,200019,22,55,625,702,3
Custer,U.S. House,Frankie Robbins,DEM,200019,13,14,181,208,3
Custer,State Senate,Brent Howard,REP,200019,13,47,470,530,38
Custer,State Senate,Jeff Berrong,DEM,200019,22,22,339,383,38
Custer,Governor,Chris Powell,LIB,200020,0,1,28,29,
Custer,Governor,Kevin Stitt,REP,200020,29,51,662,742,
Custer,Governor,Drew Edmondson,DEM,200020,14,23,283,320,
Custer,Lieutenant Governor,Matt Pinnell,REP,200020,32,56,761,849,
Custer,Lieutenant Governor,Anastasia Pittman,DEM,200020,12,19,187,218,
Custer,Lieutenant Governor,Ivan Holmes,IND,200020,0,0,20,20,
Custer,State Auditor,John Yeutter,LIB,200020,8,12,115,135,
Custer,State Auditor,Cindy Byrd,REP,200020,36,59,841,936,
Custer,Attorney General,Mike Hunter,REP,200020,31,48,765,844,
Custer,Attorney General,Mark Myles,DEM,200020,12,27,195,234,
Custer,State Treasurer,Randy Mcdaniel,REP,200020,34,58,806,898,
Custer,State Treasurer,Charles De Coune,IND,200020,10,13,143,166,
Custer,Superintendent of Public Instruction,Joy Hofmeister,REP,200020,29,53,735,817,
Custer,Superintendent of Public Instruction,John Cox,DEM,200020,12,19,158,189,
Custer,Superintendent of Public Instruction,Larry Huff,IND,200020,3,3,70,76,
Custer,Commissioner of Labor,Leslie Osborn,REP,200020,32,56,763,851,
Custer,Commissioner of Labor,Fred Dorrell,DEM,200020,11,17,165,193,
Custer,Commissioner of Labor,Brandt Dismukes,IND,200020,1,2,31,34,
Custer,Insurance Commissioner,Glen Mulready,REP,200020,32,54,737,823,
Custer,Insurance Commissioner,Kimberly Fobbs,DEM,200020,12,21,215,248,
Custer,Corporation Commissioner,Bob Anthony,REP,200020,29,50,715,794,
Custer,Corporation Commissioner,Ashley Nicole Mccray,DEM,200020,14,21,191,226,
Custer,Corporation Commissioner,Jackie Short,IND,200020,1,4,50,55,
Custer,U.S. House,Frank Lucas,REP,200020,34,56,805,895,3
Custer,U.S. House,Frankie Robbins,DEM,200020,10,19,164,193,3
Custer,State Senate,Brent Howard,REP,200020,20,46,562,628,38
Custer,State Senate,Jeff Berrong,DEM,200020,24,29,409,462,38
Custer,Governor,Chris Powell,LIB,200021,1,2,53,56,
Custer,Governor,Kevin Stitt,REP,200021,14,14,411,439,
Custer,Governor,Drew Edmondson,DEM,200021,15,18,393,426,
Custer,Lieutenant Governor,Matt Pinnell,REP,200021,18,19,474,511,
Custer,Lieutenant Governor,Anastasia Pittman,DEM,200021,10,15,333,358,
Custer,Lieutenant Governor,Ivan Holmes,IND,200021,2,0,46,48,
Custer,State Auditor,John Yeutter,LIB,200021,5,12,224,241,
Custer,State Auditor,Cindy Byrd,REP,200021,20,18,594,632,
Custer,Attorney General,Mike Hunter,REP,200021,19,18,500,537,
Custer,Attorney General,Mark Myles,DEM,200021,11,16,348,375,
Custer,State Treasurer,Randy Mcdaniel,REP,200021,18,17,544,579,
Custer,State Treasurer,Charles De Coune,IND,200021,7,14,271,292,
Custer,Superintendent of Public Instruction,Joy Hofmeister,REP,200021,16,18,460,494,
Custer,Superintendent of Public Instruction,John Cox,DEM,200021,11,14,310,335,
Custer,Superintendent of Public Instruction,Larry Huff,IND,200021,3,2,82,87,
Custer,Commissioner of Labor,Leslie Osborn,REP,200021,19,17,485,521,
Custer,Commissioner of Labor,Fred Dorrell,DEM,200021,9,14,302,325,
Custer,Commissioner of Labor,Brandt Dismukes,IND,200021,2,3,58,63,
Custer,Insurance Commissioner,Glen Mulready,REP,200021,17,19,487,523,
Custer,Insurance Commissioner,Kimberly Fobbs,DEM,200021,13,15,354,382,
Custer,Corporation Commissioner,Bob Anthony,REP,200021,17,16,459,492,
Custer,Corporation Commissioner,Ashley Nicole Mccray,DEM,200021,10,15,309,334,
Custer,Corporation Commissioner,Jackie Short,IND,200021,3,3,76,82,
Custer,U.S. House,Frank Lucas,REP,200021,19,19,518,556,3
Custer,U.S. House,Frankie Robbins,DEM,200021,11,15,333,359,3
Custer,State Senate,Brent Howard,REP,200021,9,14,417,440,38
Custer,State Senate,Jeff Berrong,DEM,200021,20,20,436,476,38
Custer,Governor,Chris Powell,LIB,200022,0,0,8,8,
Custer,Governor,Kevin Stitt,REP,200022,10,18,193,221,
Custer,Governor,Drew Edmondson,DEM,200022,3,3,34,40,
Custer,Lieutenant Governor,Matt Pinnell,REP,200022,10,18,199,227,
Custer,Lieutenant Governor,Anastasia Pittman,DEM,200022,3,3,28,34,
Custer,Lieutenant Governor,Ivan Holmes,IND,200022,0,0,8,8,
Custer,State Auditor,John Yeutter,LIB,200022,1,2,28,31,
Custer,State Auditor,Cindy Byrd,REP,200022,12,19,205,236,
Custer,Attorney General,Mike Hunter,REP,200022,12,17,203,232,
Custer,Attorney General,Mark Myles,DEM,200022,1,3,31,35,
Custer,State Treasurer,Randy Mcdaniel,REP,200022,12,19,207,238,
Custer,State Treasurer,Charles De Coune,IND,200022,1,2,24,27,
Custer,Superintendent of Public Instruction,Joy Hofmeister,REP,200022,9,17,187,213,
Custer,Superintendent of Public Instruction,John Cox,DEM,200022,3,2,27,32,
Custer,Superintendent of Public Instruction,Larry Huff,IND,200022,1,2,20,23,
Custer,Commissioner of Labor,Leslie Osborn,REP,200022,10,17,200,227,
Custer,Commissioner of Labor,Fred Dorrell,DEM,200022,2,4,27,33,
Custer,Commissioner of Labor,Brandt Dismukes,IND,200022,1,0,6,7,
Custer,Insurance Commissioner,Glen Mulready,REP,200022,12,16,196,224,
Custer,Insurance Commissioner,Kimberly Fobbs,DEM,200022,1,5,37,43,
Custer,Corporation Commissioner,Bob Anthony,REP,200022,12,17,181,210,
Custer,Corporation Commissioner,Ashley Nicole Mccray,DEM,200022,1,4,37,42,
Custer,Corporation Commissioner,Jackie Short,IND,200022,0,0,14,14,
Custer,U.S. House,Frank Lucas,REP,200022,12,18,204,234,3
Custer,U.S. House,Frankie Robbins,DEM,200022,1,3,30,34,3
Custer,Governor,Chris Powell,LIB,200023,1,1,27,29,
Custer,Governor,Kevin Stitt,REP,200023,20,17,431,468,
Custer,Governor,Drew Edmondson,DEM,200023,4,11,142,157,
Custer,Lieutenant Governor,Matt Pinnell,REP,200023,23,21,479,523,
Custer,Lieutenant Governor,Anastasia Pittman,DEM,200023,2,7,92,101,
Custer,Lieutenant Governor,Ivan Holmes,IND,200023,0,1,19,20,
Custer,State Auditor,John Yeutter,LIB,200023,3,6,75,84,
Custer,State Auditor,Cindy Byrd,REP,200023,21,23,502,546,
Custer,Attorney General,Mike Hunter,REP,200023,21,21,489,531,
Custer,Attorney General,Mark Myles,DEM,200023,4,8,106,118,
Custer,State Treasurer,Randy Mcdaniel,REP,200023,22,22,501,545,
Custer,State Treasurer,Charles De Coune,IND,200023,3,7,77,87,
Custer,Superintendent of Public Instruction,Joy Hofmeister,REP,200023,18,23,433,474,
Custer,Superintendent of Public Instruction,John Cox,DEM,200023,4,4,104,112,
Custer,Superintendent of Public Instruction,Larry Huff,IND,200023,3,2,55,60,
Custer,Commissioner of Labor,Leslie Osborn,REP,200023,24,19,463,506,
Custer,Commissioner of Labor,Fred Dorrell,DEM,200023,1,8,94,103,
Custer,Commissioner of Labor,Brandt Dismukes,IND,200023,0,2,29,31,
Custer,Insurance Commissioner,Glen Mulready,REP,200023,22,19,470,511,
Custer,Insurance Commissioner,Kimberly Fobbs,DEM,200023,3,10,112,125,
Custer,Corporation Commissioner,Bob Anthony,REP,200023,17,21,440,478,
Custer,Corporation Commissioner,Ashley Nicole Mccray,DEM,200023,6,7,116,129,
Custer,Corporation Commissioner,Jackie Short,IND,200023,2,1,35,38,
Custer,U.S. House,Frank Lucas,REP,200023,24,22,508,554,3
Custer,U.S. House,Frankie Robbins,DEM,200023,1,7,87,95,3
Custer,Governor,Chris Powell,LIB,200026,0,0,18,18,
Custer,Governor,Kevin Stitt,REP,200026,16,20,340,376,
Custer,Governor,Drew Edmondson,DEM,200026,3,11,73,87,
Custer,Lieutenant Governor,Matt Pinnell,REP,200026,17,22,348,387,
Custer,Lieutenant Governor,Anastasia Pittman,DEM,200026,2,8,62,72,
Custer,Lieutenant Governor,Ivan Holmes,IND,200026,0,1,13,14,
Custer,State Auditor,John Yeutter,LIB,200026,3,4,44,51,
Custer,State Auditor,Cindy Byrd,REP,200026,15,27,370,412,
Custer,Attorney General,Mike Hunter,REP,200026,16,22,360,398,
Custer,Attorney General,Mark Myles,DEM,200026,3,8,67,78,
Custer,State Treasurer,Randy Mcdaniel,REP,200026,17,27,377,421,
Custer,State Treasurer,Charles De Coune,IND,200026,1,4,38,43,
Custer,Superintendent of Public Instruction,Joy Hofmeister,REP,200026,14,20,283,317,
Custer,Superintendent of Public Instruction,John Cox,DEM,200026,4,7,95,106,
Custer,Superintendent of Public Instruction,Larry Huff,IND,200026,1,4,49,54,
Custer,Commissioner of Labor,Leslie Osborn,REP,200026,15,20,336,371,
Custer,Commissioner of Labor,Fred Dorrell,DEM,200026,4,8,69,81,
Custer,Commissioner of Labor,Brandt Dismukes,IND,200026,0,3,16,19,
Custer,Insurance Commissioner,Glen Mulready,REP,200026,14,21,347,382,
Custer,Insurance Commissioner,Kimberly Fobbs,DEM,200026,5,9,75,89,
Custer,Corporation Commissioner,Bob Anthony,REP,200026,13,23,337,373,
Custer,Corporation Commissioner,Ashley Nicole Mccray,DEM,200026,6,6,67,79,
Custer,Corporation Commissioner,Jackie Short,IND,200026,0,2,23,25,
Custer,U.S. House,Frank Lucas,REP,200026,17,25,376,418,3
Custer,U.S. House,Frankie Robbins,DEM,200026,2,6,56,64,3
Delaware,Governor,Chris Powell,LIB,210001,1,0,23,24,
Delaware,Governor,Kevin Stitt,REP,210001,33,12,543,588,
Delaware,Governor,Drew Edmondson,DEM,210001,18,11,220,249,
Delaware,Lieutenant Governor,Matt Pinnell,REP,210001,33,14,620,667,
Delaware,Lieutenant Governor,Anastasia Pittman,DEM,210001,15,9,148,172,
Delaware,Lieutenant Governor,Ivan Holmes,IND,210001,3,0,18,21,
Delaware,State Auditor,John Yeutter,LIB,210001,7,7,112,126,
Delaware,State Auditor,Cindy Byrd,REP,210001,41,13,624,678,
Delaware,Attorney General,Mike Hunter,REP,210001,36,15,612,663,
Delaware,Attorney General,Mark Myles,DEM,210001,14,8,169,191,
Delaware,State Treasurer,Randy Mcdaniel,REP,210001,38,14,621,673,
Delaware,State Treasurer,Charles De Coune,IND,210001,12,6,116,134,
Delaware,Superintendent of Public Instruction,Joy Hofmeister,REP,210001,34,17,555,606,
Delaware,Superintendent of Public Instruction,John Cox,DEM,210001,13,6,180,199,
Delaware,Superintendent of Public Instruction,Larry Huff,IND,210001,4,0,51,55,
Delaware,Commissioner of Labor,Leslie Osborn,REP,210001,34,14,592,640,
Delaware,Commissioner of Labor,Fred Dorrell,DEM,210001,13,9,164,186,
Delaware,Commissioner of Labor,Brandt Dismukes,IND,210001,4,0,23,27,
Delaware,Insurance Commissioner,Glen Mulready,REP,210001,35,15,601,651,
Delaware,Insurance Commissioner,Kimberly Fobbs,DEM,210001,15,8,176,199,
Delaware,Corporation Commissioner,Bob Anthony,REP,210001,34,15,593,642,
Delaware,Corporation Commissioner,Ashley Nicole Mccray,DEM,210001,15,8,154,177,
Delaware,Corporation Commissioner,Jackie Short,IND,210001,3,0,32,35,
Delaware,U.S. House,Richard Castaldo,LIB,210001,0,1,19,20,2
Delaware,U.S. House,Markwayne Mullin,REP,210001,35,13,591,639,2
Delaware,U.S. House,Jason Nichols,DEM,210001,15,9,164,188,2
Delaware,U.S. House,John Foreman,IND,210001,2,0,14,16,2
Delaware,State House,Josh West,REP,210001,39,14,597,650,5
Delaware,State House,Ed Trumbull,DEM,210001,12,9,187,208,5
Delaware,Governor,Chris Powell,LIB,210002,0,0,14,14,
Delaware,Governor,Kevin Stitt,REP,210002,17,4,247,268,
Delaware,Governor,Drew Edmondson,DEM,210002,8,1,104,113,
Delaware,Lieutenant Governor,Matt Pinnell,REP,210002,18,4,266,288,
Delaware,Lieutenant Governor,Anastasia Pittman,DEM,210002,8,1,79,88,
Delaware,Lieutenant Governor,Ivan Holmes,IND,210002,0,0,17,17,
Delaware,State Auditor,John Yeutter,LIB,210002,4,0,64,68,
Delaware,State Auditor,Cindy Byrd,REP,210002,22,4,268,294,
Delaware,Attorney General,Mike Hunter,REP,210002,18,4,263,285,
Delaware,Attorney General,Mark Myles,DEM,210002,8,1,99,108,
Delaware,State Treasurer,Randy Mcdaniel,REP,210002,20,4,272,296,
Delaware,State Treasurer,Charles De Coune,IND,210002,5,0,62,67,
Delaware,Superintendent of Public Instruction,Joy Hofmeister,REP,210002,16,4,229,249,
Delaware,Superintendent of Public Instruction,John Cox,DEM,210002,8,1,106,115,
Delaware,Superintendent of Public Instruction,Larry Huff,IND,210002,2,0,28,30,
Delaware,Commissioner of Labor,Leslie Osborn,REP,210002,18,4,245,267,
Delaware,Commissioner of Labor,Fred Dorrell,DEM,210002,8,1,96,105,
Delaware,Commissioner of Labor,Brandt Dismukes,IND,210002,0,0,17,17,
Delaware,Insurance Commissioner,Glen Mulready,REP,210002,19,4,264,287,
Delaware,Insurance Commissioner,Kimberly Fobbs,DEM,210002,7,1,96,104,
Delaware,Corporation Commissioner,Bob Anthony,REP,210002,17,4,247,268,
Delaware,Corporation Commissioner,Ashley Nicole Mccray,DEM,210002,9,1,89,99,
Delaware,Corporation Commissioner,Jackie Short,IND,210002,0,0,24,24,
Delaware,U.S. House,Richard Castaldo,LIB,210002,0,0,12,12,2
Delaware,U.S. House,Markwayne Mullin,REP,210002,19,4,257,280,2
Delaware,U.S. House,Jason Nichols,DEM,210002,7,1,83,91,2
Delaware,U.S. House,John Foreman,IND,210002,0,0,11,11,2
Delaware,State House,Josh West,REP,210002,17,4,269,290,5
Delaware,State House,Ed Trumbull,DEM,210002,9,1,97,107,5
Delaware,Governor,Chris Powell,LIB,210003,1,0,30,31,
Delaware,Governor,Kevin Stitt,REP,210003,34,19,467,520,
Delaware,Governor,Drew Edmondson,DEM,210003,16,7,255,278,
Delaware,Lieutenant Governor,Matt Pinnell,REP,210003,36,19,523,578,
Delaware,Lieutenant Governor,Anastasia Pittman,DEM,210003,16,7,202,225,
Delaware,Lieutenant Governor,Ivan Holmes,IND,210003,0,0,25,25,
Delaware,State Auditor,John Yeutter,LIB,210003,9,2,141,152,
Delaware,State Auditor,Cindy Byrd,REP,210003,36,20,539,595,
Delaware,Attorney General,Mike Hunter,REP,210003,34,19,533,586,
Delaware,Attorney General,Mark Myles,DEM,210003,15,7,213,235,
Delaware,State Treasurer,Randy Mcdaniel,REP,210003,35,20,533,588,
Delaware,State Treasurer,Charles De Coune,IND,210003,10,2,149,161,
Delaware,Superintendent of Public Instruction,Joy Hofmeister,REP,210003,33,18,487,538,
Delaware,Superintendent of Public Instruction,John Cox,DEM,210003,16,7,216,239,
Delaware,Superintendent of Public Instruction,Larry Huff,IND,210003,3,1,45,49,
Delaware,Commissioner of Labor,Leslie Osborn,REP,210003,38,17,503,558,
Delaware,Commissioner of Labor,Fred Dorrell,DEM,210003,13,7,206,226,
Delaware,Commissioner of Labor,Brandt Dismukes,IND,210003,1,2,33,36,
Delaware,Insurance Commissioner,Glen Mulready,REP,210003,34,19,519,572,
Delaware,Insurance Commissioner,Kimberly Fobbs,DEM,210003,15,7,225,247,
Delaware,Corporation Commissioner,Bob Anthony,REP,210003,37,16,499,552,
Delaware,Corporation Commissioner,Ashley Nicole Mccray,DEM,210003,13,8,204,225,
Delaware,Corporation Commissioner,Jackie Short,IND,210003,2,2,40,44,
Delaware,U.S. House,Richard Castaldo,LIB,210003,1,0,13,14,2
Delaware,U.S. House,Markwayne Mullin,REP,210003,32,18,496,546,2
Delaware,U.S. House,Jason Nichols,DEM,210003,14,7,225,246,2
Delaware,U.S. House,John Foreman,IND,210003,3,1,20,24,2
Delaware,State House,Josh West,REP,210003,34,19,503,556,5
Delaware,State House,Ed Trumbull,DEM,210003,17,7,244,268,5
Delaware,Governor,Chris Powell,LIB,210004,1,0,10,11,
Delaware,Governor,Kevin Stitt,REP,210004,14,15,268,297,
Delaware,Governor,Drew Edmondson,DEM,210004,13,12,115,140,
Delaware,Lieutenant Governor,Matt Pinnell,REP,210004,14,17,290,321,
Delaware,Lieutenant Governor,Anastasia Pittman,DEM,210004,13,10,94,117,
Delaware,Lieutenant Governor,Ivan Holmes,IND,210004,1,0,6,7,
Delaware,State Auditor,John Yeutter,LIB,210004,6,6,66,78,
Delaware,State Auditor,Cindy Byrd,REP,210004,18,18,301,337,
Delaware,Attorney General,Mike Hunter,REP,210004,14,16,291,321,
Delaware,Attorney General,Mark Myles,DEM,210004,14,11,97,122,
Delaware,State Treasurer,Randy Mcdaniel,REP,210004,16,19,294,329,
Delaware,State Treasurer,Charles De Coune,IND,210004,7,6,71,84,
Delaware,Superintendent of Public Instruction,Joy Hofmeister,REP,210004,14,16,268,298,
Delaware,Superintendent of Public Instruction,John Cox,DEM,210004,12,11,100,123,
Delaware,Superintendent of Public Instruction,Larry Huff,IND,210004,1,0,21,22,
Delaware,Commissioner of Labor,Leslie Osborn,REP,210004,15,17,269,301,
Delaware,Commissioner of Labor,Fred Dorrell,DEM,210004,11,10,105,126,
Delaware,Commissioner of Labor,Brandt Dismukes,IND,210004,1,0,13,14,
Delaware,Insurance Commissioner,Glen Mulready,REP,210004,15,17,281,313,
Delaware,Insurance Commissioner,Kimberly Fobbs,DEM,210004,13,10,107,130,
Delaware,Corporation Commissioner,Bob Anthony,REP,210004,15,19,258,292,
Delaware,Corporation Commissioner,Ashley Nicole Mccray,DEM,210004,12,8,106,126,
Delaware,Corporation Commissioner,Jackie Short,IND,210004,0,0,21,21,
Delaware,U.S. House,Richard Castaldo,LIB,210004,1,0,10,11,2
Delaware,U.S. House,Markwayne Mullin,REP,210004,14,16,272,302,2
Delaware,U.S. House,Jason Nichols,DEM,210004,12,11,96,119,2
Delaware,U.S. House,John Foreman,IND,210004,1,0,13,14,2
Delaware,State House,William Leonard,REP,210004,16,16,239,271,7
Delaware,State House,Ben Loring,DEM,210004,12,11,148,171,7
Delaware,Governor,Chris Powell,LIB,210005,1,1,18,20,
Delaware,Governor,Kevin Stitt,REP,210005,29,34,475,538,
Delaware,Governor,Drew Edmondson,DEM,210005,6,16,216,238,
Delaware,Lieutenant Governor,Matt Pinnell,REP,210005,28,34,527,589,
Delaware,Lieutenant Governor,Anastasia Pittman,DEM,210005,6,16,159,181,
Delaware,Lieutenant Governor,Ivan Holmes,IND,210005,3,1,20,24,
Delaware,State Auditor,John Yeutter,LIB,210005,9,8,106,123,
Delaware,State Auditor,Cindy Byrd,REP,210005,28,37,560,625,
Delaware,Attorney General,Mike Hunter,REP,210005,29,35,546,610,
Delaware,Attorney General,Mark Myles,DEM,210005,8,15,157,180,
Delaware,State Treasurer,Randy Mcdaniel,REP,210005,28,34,549,611,
Delaware,State Treasurer,Charles De Coune,IND,210005,9,11,120,140,
Delaware,Superintendent of Public Instruction,Joy Hofmeister,REP,210005,26,32,464,522,
Delaware,Superintendent of Public Instruction,John Cox,DEM,210005,6,16,204,226,
Delaware,Superintendent of Public Instruction,Larry Huff,IND,210005,5,3,35,43,
Delaware,Commissioner of Labor,Leslie Osborn,REP,210005,31,32,514,577,
Delaware,Commissioner of Labor,Fred Dorrell,DEM,210005,5,14,163,182,
Delaware,Commissioner of Labor,Brandt Dismukes,IND,210005,1,4,19,24,
Delaware,Insurance Commissioner,Glen Mulready,REP,210005,27,33,521,581,
Delaware,Insurance Commissioner,Kimberly Fobbs,DEM,210005,9,17,177,203,
Delaware,Corporation Commissioner,Bob Anthony,REP,210005,28,33,503,564,
Delaware,Corporation Commissioner,Ashley Nicole Mccray,DEM,210005,6,13,159,178,
Delaware,Corporation Commissioner,Jackie Short,IND,210005,3,4,33,40,
Delaware,U.S. House,Richard Castaldo,LIB,210005,2,1,15,18,2
Delaware,U.S. House,Markwayne Mullin,REP,210005,29,35,503,567,2
Delaware,U.S. House,Jason Nichols,DEM,210005,5,15,172,192,2
Delaware,U.S. House,John Foreman,IND,210005,1,0,16,17,2
Delaware,State House,Josh West,REP,210005,27,34,506,567,5
Delaware,State House,Ed Trumbull,DEM,210005,10,17,205,232,5
Delaware,Governor,Chris Powell,LIB,210006,0,0,30,30,
Delaware,Governor,Kevin Stitt,REP,210006,22,21,380,423,
Delaware,Governor,Drew Edmondson,DEM,210006,9,15,171,195,
Delaware,Lieutenant Governor,Matt Pinnell,REP,210006,21,23,408,452,
Delaware,Lieutenant Governor,Anastasia Pittman,DEM,210006,9,12,151,172,
Delaware,Lieutenant Governor,Ivan Holmes,IND,210006,1,1,16,18,
Delaware,State Auditor,John Yeutter,LIB,210006,4,9,93,106,
Delaware,State Auditor,Cindy Byrd,REP,210006,24,27,437,488,
Delaware,Attorney General,Mike Hunter,REP,210006,23,23,426,472,
Delaware,Attorney General,Mark Myles,DEM,210006,8,12,146,166,
Delaware,State Treasurer,Randy Mcdaniel,REP,210006,23,26,429,478,
Delaware,State Treasurer,Charles De Coune,IND,210006,5,9,98,112,
Delaware,Superintendent of Public Instruction,Joy Hofmeister,REP,210006,18,20,377,415,
Delaware,Superintendent of Public Instruction,John Cox,DEM,210006,8,15,154,177,
Delaware,Superintendent of Public Instruction,Larry Huff,IND,210006,5,1,44,50,
Delaware,Commissioner of Labor,Leslie Osborn,REP,210006,24,23,393,440,
Delaware,Commissioner of Labor,Fred Dorrell,DEM,210006,6,9,144,159,
Delaware,Commissioner of Labor,Brandt Dismukes,IND,210006,1,1,30,32,
Delaware,Insurance Commissioner,Glen Mulready,REP,210006,22,22,412,456,
Delaware,Insurance Commissioner,Kimberly Fobbs,DEM,210006,9,13,156,178,
Delaware,Corporation Commissioner,Bob Anthony,REP,210006,19,22,391,432,
Delaware,Corporation Commissioner,Ashley Nicole Mccray,DEM,210006,8,12,142,162,
Delaware,Corporation Commissioner,Jackie Short,IND,210006,4,1,36,41,
Delaware,U.S. House,Richard Castaldo,LIB,210006,0,0,17,17,2
Delaware,U.S. House,Markwayne Mullin,REP,210006,24,22,402,448,2
Delaware,U.S. House,Jason Nichols,DEM,210006,7,14,146,167,2
Delaware,U.S. House,John Foreman,IND,210006,0,0,14,14,2
Delaware,State House,William Leonard,REP,210006,18,18,366,402,7
Delaware,State House,Ben Loring,DEM,210006,13,18,203,234,7
Delaware,Governor,Chris Powell,LIB,210007,3,0,39,42,
Delaware,Governor,Kevin Stitt,REP,210007,92,129,752,973,
Delaware,Governor,Drew Edmondson,DEM,210007,45,64,353,462,
Delaware,Lieutenant Governor,Matt Pinnell,REP,210007,102,132,854,1088,
Delaware,Lieutenant Governor,Anastasia Pittman,DEM,210007,29,55,249,333,
Delaware,Lieutenant Governor,Ivan Holmes,IND,210007,9,5,36,50,
Delaware,State Auditor,John Yeutter,LIB,210007,16,29,187,232,
Delaware,State Auditor,Cindy Byrd,REP,210007,110,143,891,1144,
Delaware,Attorney General,Mike Hunter,REP,210007,110,130,864,1104,
Delaware,Attorney General,Mark Myles,DEM,210007,31,62,270,363,
Delaware,State Treasurer,Randy Mcdaniel,REP,210007,105,139,879,1123,
Delaware,State Treasurer,Charles De Coune,IND,210007,20,33,199,252,
Delaware,Superintendent of Public Instruction,Joy Hofmeister,REP,210007,97,123,798,1018,
Delaware,Superintendent of Public Instruction,John Cox,DEM,210007,36,59,287,382,
Delaware,Superintendent of Public Instruction,Larry Huff,IND,210007,9,10,56,75,
Delaware,Commissioner of Labor,Leslie Osborn,REP,210007,97,134,822,1053,
Delaware,Commissioner of Labor,Fred Dorrell,DEM,210007,38,51,263,352,
Delaware,Commissioner of Labor,Brandt Dismukes,IND,210007,5,3,40,48,
Delaware,Insurance Commissioner,Glen Mulready,REP,210007,99,130,838,1067,
Delaware,Insurance Commissioner,Kimberly Fobbs,DEM,210007,40,60,292,392,
Delaware,Corporation Commissioner,Bob Anthony,REP,210007,100,132,811,1043,
Delaware,Corporation Commissioner,Ashley Nicole Mccray,DEM,210007,32,56,262,350,
Delaware,Corporation Commissioner,Jackie Short,IND,210007,7,2,59,68,
Delaware,U.S. House,Richard Castaldo,LIB,210007,5,0,31,36,2
Delaware,U.S. House,Markwayne Mullin,REP,210007,99,131,797,1027,2
Delaware,U.S. House,Jason Nichols,DEM,210007,34,59,283,376,2
Delaware,U.S. House,John Foreman,IND,210007,3,3,28,34,2
Delaware,State House,Josh West,REP,210007,94,123,791,1008,5
Delaware,State House,Ed Trumbull,DEM,210007,45,70,359,474,5
Delaware,Governor,Chris Powell,LIB,210008,0,0,12,12,
Delaware,Governor,Kevin Stitt,REP,210008,10,28,214,252,
Delaware,Governor,Drew Edmondson,DEM,210008,4,11,57,72,
Delaware,Lieutenant Governor,Matt Pinnell,REP,210008,11,29,220,260,
Delaware,Lieutenant Governor,Anastasia Pittman,DEM,210008,3,10,53,66,
Delaware,Lieutenant Governor,Ivan Holmes,IND,210008,0,0,9,9,
Delaware,State Auditor,John Yeutter,LIB,210008,1,12,44,57,
Delaware,State Auditor,Cindy Byrd,REP,210008,9,27,232,268,
Delaware,Attorney General,Mike Hunter,REP,210008,8,27,235,270,
Delaware,Attorney General,Mark Myles,DEM,210008,4,12,47,63,
Delaware,State Treasurer,Randy Mcdaniel,REP,210008,8,28,230,266,
Delaware,State Treasurer,Charles De Coune,IND,210008,3,11,47,61,
Delaware,Superintendent of Public Instruction,Joy Hofmeister,REP,210008,11,24,184,219,
Delaware,Superintendent of Public Instruction,John Cox,DEM,210008,1,15,68,84,
Delaware,Superintendent of Public Instruction,Larry Huff,IND,210008,2,0,28,30,
Delaware,Commissioner of Labor,Leslie Osborn,REP,210008,8,24,211,243,
Delaware,Commissioner of Labor,Fred Dorrell,DEM,210008,3,15,50,68,
Delaware,Commissioner of Labor,Brandt Dismukes,IND,210008,0,0,18,18,
Delaware,Insurance Commissioner,Glen Mulready,REP,210008,8,27,223,258,
Delaware,Insurance Commissioner,Kimberly Fobbs,DEM,210008,4,12,59,75,
Delaware,Corporation Commissioner,Bob Anthony,REP,210008,8,28,208,244,
Delaware,Corporation Commissioner,Ashley Nicole Mccray,DEM,210008,2,9,52,63,
Delaware,Corporation Commissioner,Jackie Short,IND,210008,1,1,21,23,
Delaware,U.S. House,Richard Castaldo,LIB,210008,0,2,10,12,2
Delaware,U.S. House,Markwayne Mullin,REP,210008,11,24,217,252,2
Delaware,U.S. House,Jason Nichols,DEM,210008,2,11,49,62,2
Delaware,U.S. House,John Foreman,IND,210008,1,1,6,8,2
Delaware,State House,Josh West,REP,210008,12,29,221,262,5
Delaware,State House,Ed Trumbull,DEM,210008,2,10,62,74,5
Delaware,Governor,Chris Powell,LIB,210009,3,2,32,37,
Delaware,Governor,Kevin Stitt,REP,210009,57,111,738,906,
Delaware,Governor,Drew Edmondson,DEM,210009,25,59,299,383,
Delaware,Lieutenant Governor,Matt Pinnell,REP,210009,62,119,804,985,
Delaware,Lieutenant Governor,Anastasia Pittman,DEM,210009,19,51,234,304,
Delaware,Lieutenant Governor,Ivan Holmes,IND,210009,5,1,25,31,
Delaware,State Auditor,John Yeutter,LIB,210009,20,28,154,202,
Delaware,State Auditor,Cindy Byrd,REP,210009,56,128,845,1029,
Delaware,Attorney General,Mike Hunter,REP,210009,61,117,812,990,
Delaware,Attorney General,Mark Myles,DEM,210009,24,51,238,313,
Delaware,State Treasurer,Randy Mcdaniel,REP,210009,58,126,830,1014,
Delaware,State Treasurer,Charles De Coune,IND,210009,22,32,166,220,
Delaware,Superintendent of Public Instruction,Joy Hofmeister,REP,210009,49,113,733,895,
Delaware,Superintendent of Public Instruction,John Cox,DEM,210009,26,49,240,315,
Delaware,Superintendent of Public Instruction,Larry Huff,IND,210009,11,9,82,102,
Delaware,Commissioner of Labor,Leslie Osborn,REP,210009,55,118,767,940,
Delaware,Commissioner of Labor,Fred Dorrell,DEM,210009,24,48,223,295,
Delaware,Commissioner of Labor,Brandt Dismukes,IND,210009,4,5,47,56,
Delaware,Insurance Commissioner,Glen Mulready,REP,210009,59,116,787,962,
Delaware,Insurance Commissioner,Kimberly Fobbs,DEM,210009,24,55,257,336,
Delaware,Corporation Commissioner,Bob Anthony,REP,210009,57,115,767,939,
Delaware,Corporation Commissioner,Ashley Nicole Mccray,DEM,210009,19,51,235,305,
Delaware,Corporation Commissioner,Jackie Short,IND,210009,6,5,47,58,
Delaware,U.S. House,Richard Castaldo,LIB,210009,3,1,39,43,2
Delaware,U.S. House,Markwayne Mullin,REP,210009,58,112,762,932,2
Delaware,U.S. House,Jason Nichols,DEM,210009,18,57,238,313,2
Delaware,U.S. House,John Foreman,IND,210009,6,1,20,27,2
Delaware,State House,Josh West,REP,210009,63,105,768,936,5
Delaware,State House,Ed Trumbull,DEM,210009,22,66,298,386,5
Delaware,Governor,Chris Powell,LIB,210010,0,0,0,0,
Delaware,Governor,Kevin Stitt,REP,210010,1,7,17,25,
Delaware,Governor,Drew Edmondson,DEM,210010,0,3,6,9,
Delaware,Lieutenant Governor,Matt Pinnell,REP,210010,1,9,17,27,
Delaware,Lieutenant Governor,Anastasia Pittman,DEM,210010,0,0,6,6,
Delaware,Lieutenant Governor,Ivan Holmes,IND,210010,0,0,0,0,
Delaware,State Auditor,John Yeutter,LIB,210010,1,1,3,5,
Delaware,State Auditor,Cindy Byrd,REP,210010,0,8,19,27,
Delaware,Attorney General,Mike Hunter,REP,210010,0,9,16,25,
Delaware,Attorney General,Mark Myles,DEM,210010,1,1,7,9,
Delaware,State Treasurer,Randy Mcdaniel,REP,210010,1,8,20,29,
Delaware,State Treasurer,Charles De Coune,IND,210010,0,1,2,3,
Delaware,Superintendent of Public Instruction,Joy Hofmeister,REP,210010,0,7,14,21,
Delaware,Superintendent of Public Instruction,John Cox,DEM,210010,1,2,8,11,
Delaware,Superintendent of Public Instruction,Larry Huff,IND,210010,0,0,1,1,
Delaware,Commissioner of Labor,Leslie Osborn,REP,210010,0,8,18,26,
Delaware,Commissioner of Labor,Fred Dorrell,DEM,210010,1,1,4,6,
Delaware,Commissioner of Labor,Brandt Dismukes,IND,210010,0,0,0,0,
Delaware,Insurance Commissioner,Glen Mulready,REP,210010,0,9,16,25,
Delaware,Insurance Commissioner,Kimberly Fobbs,DEM,210010,0,1,7,8,
Delaware,Corporation Commissioner,Bob Anthony,REP,210010,0,9,17,26,
Delaware,Corporation Commissioner,Ashley Nicole Mccray,DEM,210010,0,1,5,6,
Delaware,Corporation Commissioner,Jackie Short,IND,210010,0,0,1,1,
Delaware,U.S. House,Richard Castaldo,LIB,210010,0,0,0,0,2
Delaware,U.S. House,Markwayne Mullin,REP,210010,2,8,17,27,2
Delaware,U.S. House,Jason Nichols,DEM,210010,0,1,4,5,2
Delaware,U.S. House,John Foreman,IND,210010,0,1,2,3,2
Delaware,State House,David Hardin,REP,210010,1,8,14,23,86
Delaware,State House,Rhonda Cox,DEM,210010,1,2,9,12,86
Delaware,Governor,Chris Powell,LIB,210011,1,0,24,25,
Delaware,Governor,Kevin Stitt,REP,210011,20,28,436,484,
Delaware,Governor,Drew Edmondson,DEM,210011,17,10,165,192,
Delaware,Lieutenant Governor,Matt Pinnell,REP,210011,21,32,477,530,
Delaware,Lieutenant Governor,Anastasia Pittman,DEM,210011,15,6,125,146,
Delaware,Lieutenant Governor,Ivan Holmes,IND,210011,2,0,21,23,
Delaware,State Auditor,John Yeutter,LIB,210011,6,2,83,91,
Delaware,State Auditor,Cindy Byrd,REP,210011,25,32,495,552,
Delaware,Attorney General,Mike Hunter,REP,210011,22,32,475,529,
Delaware,Attorney General,Mark Myles,DEM,210011,15,5,145,165,
Delaware,State Treasurer,Randy Mcdaniel,REP,210011,24,32,493,549,
Delaware,State Treasurer,Charles De Coune,IND,210011,7,2,84,93,
Delaware,Superintendent of Public Instruction,Joy Hofmeister,REP,210011,22,31,440,493,
Delaware,Superintendent of Public Instruction,John Cox,DEM,210011,14,6,139,159,
Delaware,Superintendent of Public Instruction,Larry Huff,IND,210011,2,1,42,45,
Delaware,Commissioner of Labor,Leslie Osborn,REP,210011,22,33,452,507,
Delaware,Commissioner of Labor,Fred Dorrell,DEM,210011,16,4,143,163,
Delaware,Commissioner of Labor,Brandt Dismukes,IND,210011,0,0,20,20,
Delaware,Insurance Commissioner,Glen Mulready,REP,210011,20,32,464,516,
Delaware,Insurance Commissioner,Kimberly Fobbs,DEM,210011,18,5,153,176,
Delaware,Corporation Commissioner,Bob Anthony,REP,210011,19,31,440,490,
Delaware,Corporation Commissioner,Ashley Nicole Mccray,DEM,210011,16,7,150,173,
Delaware,Corporation Commissioner,Jackie Short,IND,210011,3,0,29,32,
Delaware,U.S. House,Richard Castaldo,LIB,210011,0,0,16,16,2
Delaware,U.S. House,Markwayne Mullin,REP,210011,20,33,461,514,2
Delaware,U.S. House,Jason Nichols,DEM,210011,17,5,132,154,2
Delaware,U.S. House,John Foreman,IND,210011,1,0,17,18,2
Delaware,State House,William Leonard,REP,210011,22,30,414,466,7
Delaware,State House,Ben Loring,DEM,210011,16,8,206,230,7
Delaware,Governor,Chris Powell,LIB,210012,2,0,7,9,
Delaware,Governor,Kevin Stitt,REP,210012,17,35,283,335,
Delaware,Governor,Drew Edmondson,DEM,210012,8,19,144,171,
Delaware,Lieutenant Governor,Matt Pinnell,REP,210012,19,34,310,363,
Delaware,Lieutenant Governor,Anastasia Pittman,DEM,210012,8,20,111,139,
Delaware,Lieutenant Governor,Ivan Holmes,IND,210012,0,0,8,8,
Delaware,State Auditor,John Yeutter,LIB,210012,1,11,77,89,
Delaware,State Auditor,Cindy Byrd,REP,210012,20,39,331,390,
Delaware,Attorney General,Mike Hunter,REP,210012,19,34,313,366,
Delaware,Attorney General,Mark Myles,DEM,210012,8,20,116,144,
Delaware,State Treasurer,Randy Mcdaniel,REP,210012,20,38,317,375,
Delaware,State Treasurer,Charles De Coune,IND,210012,1,12,85,98,
Delaware,Superintendent of Public Instruction,Joy Hofmeister,REP,210012,20,29,267,316,
Delaware,Superintendent of Public Instruction,John Cox,DEM,210012,6,21,137,164,
Delaware,Superintendent of Public Instruction,Larry Huff,IND,210012,1,4,26,31,
Delaware,Commissioner of Labor,Leslie Osborn,REP,210012,19,39,286,344,
Delaware,Commissioner of Labor,Fred Dorrell,DEM,210012,7,15,117,139,
Delaware,Commissioner of Labor,Brandt Dismukes,IND,210012,1,0,20,21,
Delaware,Insurance Commissioner,Glen Mulready,REP,210012,18,35,297,350,
Delaware,Insurance Commissioner,Kimberly Fobbs,DEM,210012,8,18,126,152,
Delaware,Corporation Commissioner,Bob Anthony,REP,210012,18,37,294,349,
Delaware,Corporation Commissioner,Ashley Nicole Mccray,DEM,210012,7,16,112,135,
Delaware,Corporation Commissioner,Jackie Short,IND,210012,2,1,22,25,
Delaware,U.S. House,Richard Castaldo,LIB,210012,1,1,13,15,2
Delaware,U.S. House,Markwayne Mullin,REP,210012,18,35,295,348,2
Delaware,U.S. House,Jason Nichols,DEM,210012,8,18,109,135,2
Delaware,U.S. House,John Foreman,IND,210012,1,0,19,20,2
Delaware,State House,Josh West,REP,210012,19,34,282,335,5
Delaware,State House,Ed Trumbull,DEM,210012,9,20,150,179,5
Delaware,Governor,Chris Powell,LIB,210014,0,2,18,20,
Delaware,Governor,Kevin Stitt,REP,210014,9,39,235,283,
Delaware,Governor,Drew Edmondson,DEM,210014,9,50,144,203,
Delaware,Lieutenant Governor,Matt Pinnell,REP,210014,12,53,263,328,
Delaware,Lieutenant Governor,Anastasia Pittman,DEM,210014,6,35,106,147,
Delaware,Lieutenant Governor,Ivan Holmes,IND,210014,0,2,20,22,
Delaware,State Auditor,John Yeutter,LIB,210014,3,18,68,89,
Delaware,State Auditor,Cindy Byrd,REP,210014,13,62,300,375,
Delaware,Attorney General,Mike Hunter,REP,210014,12,60,260,332,
Delaware,Attorney General,Mark Myles,DEM,210014,6,30,130,166,
Delaware,State Treasurer,Randy Mcdaniel,REP,210014,11,61,292,364,
Delaware,State Treasurer,Charles De Coune,IND,210014,5,21,70,96,
Delaware,Superintendent of Public Instruction,Joy Hofmeister,REP,210014,10,38,149,197,
Delaware,Superintendent of Public Instruction,John Cox,DEM,210014,7,51,223,281,
Delaware,Superintendent of Public Instruction,Larry Huff,IND,210014,1,2,20,23,
Delaware,Commissioner of Labor,Leslie Osborn,REP,210014,14,52,248,314,
Delaware,Commissioner of Labor,Fred Dorrell,DEM,210014,4,35,123,162,
Delaware,Commissioner of Labor,Brandt Dismukes,IND,210014,0,2,15,17,
Delaware,Insurance Commissioner,Glen Mulready,REP,210014,12,56,251,319,
Delaware,Insurance Commissioner,Kimberly Fobbs,DEM,210014,6,34,135,175,
Delaware,Corporation Commissioner,Bob Anthony,REP,210014,12,50,250,312,
Delaware,Corporation Commissioner,Ashley Nicole Mccray,DEM,210014,6,38,117,161,
Delaware,Corporation Commissioner,Jackie Short,IND,210014,0,3,21,24,
Delaware,U.S. House,Richard Castaldo,LIB,210014,1,1,7,9,2
Delaware,U.S. House,Markwayne Mullin,REP,210014,11,48,249,308,2
Delaware,U.S. House,Jason Nichols,DEM,210014,6,38,130,174,2
Delaware,U.S. House,John Foreman,IND,210014,1,4,10,15,2
Delaware,State House,Josh West,REP,210014,11,49,248,308,5
Delaware,State House,Ed Trumbull,DEM,210014,7,41,147,195,5
Delaware,Governor,Chris Powell,LIB,210015,2,3,20,25,
Delaware,Governor,Kevin Stitt,REP,210015,19,50,343,412,
Delaware,Governor,Drew Edmondson,DEM,210015,9,33,154,196,
Delaware,Lieutenant Governor,Matt Pinnell,REP,210015,22,55,369,446,
Delaware,Lieutenant Governor,Anastasia Pittman,DEM,210015,7,31,130,168,
Delaware,Lieutenant Governor,Ivan Holmes,IND,210015,1,0,15,16,
Delaware,State Auditor,John Yeutter,LIB,210015,7,17,110,134,
Delaware,State Auditor,Cindy Byrd,REP,210015,22,61,373,456,
Delaware,Attorney General,Mike Hunter,REP,210015,20,50,373,443,
Delaware,Attorney General,Mark Myles,DEM,210015,10,36,138,184,
Delaware,State Treasurer,Randy Mcdaniel,REP,210015,20,55,375,450,
Delaware,State Treasurer,Charles De Coune,IND,210015,9,23,114,146,
Delaware,Superintendent of Public Instruction,Joy Hofmeister,REP,210015,16,45,294,355,
Delaware,Superintendent of Public Instruction,John Cox,DEM,210015,6,38,177,221,
Delaware,Superintendent of Public Instruction,Larry Huff,IND,210015,8,3,45,56,
Delaware,Commissioner of Labor,Leslie Osborn,REP,210015,24,49,343,416,
Delaware,Commissioner of Labor,Fred Dorrell,DEM,210015,6,32,147,185,
Delaware,Commissioner of Labor,Brandt Dismukes,IND,210015,0,1,23,24,
Delaware,Insurance Commissioner,Glen Mulready,REP,210015,18,49,356,423,
Delaware,Insurance Commissioner,Kimberly Fobbs,DEM,210015,10,36,154,200,
Delaware,Corporation Commissioner,Bob Anthony,REP,210015,18,49,351,418,
Delaware,Corporation Commissioner,Ashley Nicole Mccray,DEM,210015,8,34,131,173,
Delaware,Corporation Commissioner,Jackie Short,IND,210015,2,1,30,33,
Delaware,U.S. House,Richard Castaldo,LIB,210015,0,0,9,9,2
Delaware,U.S. House,Markwayne Mullin,REP,210015,21,53,353,427,2
Delaware,U.S. House,Jason Nichols,DEM,210015,7,30,136,173,2
Delaware,U.S. House,John Foreman,IND,210015,2,1,19,22,2
Delaware,State House,Josh West,REP,210015,23,55,364,442,5
Delaware,State House,Ed Trumbull,DEM,210015,7,29,149,185,5
Delaware,Governor,Chris Powell,LIB,210016,1,5,11,17,
Delaware,Governor,Kevin Stitt,REP,210016,4,28,163,195,
Delaware,Governor,Drew Edmondson,DEM,210016,14,24,127,165,
Delaware,Lieutenant Governor,Matt Pinnell,REP,210016,4,31,190,225,
Delaware,Lieutenant Governor,Anastasia Pittman,DEM,210016,14,21,99,134,
Delaware,Lieutenant Governor,Ivan Holmes,IND,210016,1,4,8,13,
Delaware,State Auditor,John Yeutter,LIB,210016,5,15,73,93,
Delaware,State Auditor,Cindy Byrd,REP,210016,10,38,198,246,
Delaware,Attorney General,Mike Hunter,REP,210016,6,33,178,217,
Delaware,Attorney General,Mark Myles,DEM,210016,12,24,113,149,
Delaware,State Treasurer,Randy Mcdaniel,REP,210016,8,36,198,242,
Delaware,State Treasurer,Charles De Coune,IND,210016,7,18,71,96,
Delaware,Superintendent of Public Instruction,Joy Hofmeister,REP,210016,6,26,113,145,
Delaware,Superintendent of Public Instruction,John Cox,DEM,210016,10,26,157,193,
Delaware,Superintendent of Public Instruction,Larry Huff,IND,210016,3,5,28,36,
Delaware,Commissioner of Labor,Leslie Osborn,REP,210016,5,31,174,210,
Delaware,Commissioner of Labor,Fred Dorrell,DEM,210016,11,23,103,137,
Delaware,Commissioner of Labor,Brandt Dismukes,IND,210016,3,3,16,22,
Delaware,Insurance Commissioner,Glen Mulready,REP,210016,5,33,167,205,
Delaware,Insurance Commissioner,Kimberly Fobbs,DEM,210016,14,24,123,161,
Delaware,Corporation Commissioner,Bob Anthony,REP,210016,5,32,158,195,
Delaware,Corporation Commissioner,Ashley Nicole Mccray,DEM,210016,12,22,114,148,
Delaware,Corporation Commissioner,Jackie Short,IND,210016,1,3,20,24,
Delaware,U.S. House,Richard Castaldo,LIB,210016,1,1,10,12,2
Delaware,U.S. House,Markwayne Mullin,REP,210016,4,29,182,215,2
Delaware,U.S. House,Jason Nichols,DEM,210016,13,22,92,127,2
Delaware,U.S. House,John Foreman,IND,210016,2,5,14,21,2
Delaware,State House,Josh West,REP,210016,8,27,181,216,5
Delaware,State House,Ed Trumbull,DEM,210016,12,30,118,160,5
Delaware,Governor,Chris Powell,LIB,210017,0,0,10,10,
Delaware,Governor,Kevin Stitt,REP,210017,2,35,118,155,
Delaware,Governor,Drew Edmondson,DEM,210017,10,27,81,118,
Delaware,Lieutenant Governor,Matt Pinnell,REP,210017,2,46,126,174,
Delaware,Lieutenant Governor,Anastasia Pittman,DEM,210017,10,14,67,91,
Delaware,Lieutenant Governor,Ivan Holmes,IND,210017,0,2,6,8,
Delaware,State Auditor,John Yeutter,LIB,210017,5,8,42,55,
Delaware,State Auditor,Cindy Byrd,REP,210017,5,46,142,193,
Delaware,Attorney General,Mike Hunter,REP,210017,2,45,129,176,
Delaware,Attorney General,Mark Myles,DEM,210017,9,16,76,101,
Delaware,State Treasurer,Randy Mcdaniel,REP,210017,3,44,139,186,
Delaware,State Treasurer,Charles De Coune,IND,210017,6,9,53,68,
Delaware,Superintendent of Public Instruction,Joy Hofmeister,REP,210017,3,31,85,119,
Delaware,Superintendent of Public Instruction,John Cox,DEM,210017,8,30,107,145,
Delaware,Superintendent of Public Instruction,Larry Huff,IND,210017,1,1,15,17,
Delaware,Commissioner of Labor,Leslie Osborn,REP,210017,2,38,127,167,
Delaware,Commissioner of Labor,Fred Dorrell,DEM,210017,9,21,68,98,
Delaware,Commissioner of Labor,Brandt Dismukes,IND,210017,1,0,7,8,
Delaware,Insurance Commissioner,Glen Mulready,REP,210017,2,41,121,164,
Delaware,Insurance Commissioner,Kimberly Fobbs,DEM,210017,10,19,78,107,
Delaware,Corporation Commissioner,Bob Anthony,REP,210017,3,39,121,163,
Delaware,Corporation Commissioner,Ashley Nicole Mccray,DEM,210017,9,18,70,97,
Delaware,Corporation Commissioner,Jackie Short,IND,210017,0,4,11,15,
Delaware,U.S. House,Richard Castaldo,LIB,210017,1,2,5,8,2
Delaware,U.S. House,Markwayne Mullin,REP,210017,2,41,126,169,2
Delaware,U.S. House,Jason Nichols,DEM,210017,9,18,72,99,2
Delaware,U.S. House,John Foreman,IND,210017,0,0,5,5,2
Delaware,State House,Josh West,REP,210017,3,41,131,175,5
Delaware,State House,Ed Trumbull,DEM,210017,9,20,75,104,5
Delaware,Governor,Chris Powell,LIB,210018,0,0,12,12,
Delaware,Governor,Kevin Stitt,REP,210018,8,32,192,232,
Delaware,Governor,Drew Edmondson,DEM,210018,3,13,68,84,
Delaware,Lieutenant Governor,Matt Pinnell,REP,210018,7,28,202,237,
Delaware,Lieutenant Governor,Anastasia Pittman,DEM,210018,3,15,59,77,
Delaware,Lieutenant Governor,Ivan Holmes,IND,210018,1,0,8,9,
Delaware,State Auditor,John Yeutter,LIB,210018,4,5,40,49,
Delaware,State Auditor,Cindy Byrd,REP,210018,6,35,219,260,
Delaware,Attorney General,Mike Hunter,REP,210018,7,33,214,254,
Delaware,Attorney General,Mark Myles,DEM,210018,4,11,54,69,
Delaware,State Treasurer,Randy Mcdaniel,REP,210018,7,35,207,249,
Delaware,State Treasurer,Charles De Coune,IND,210018,3,4,48,55,
Delaware,Superintendent of Public Instruction,Joy Hofmeister,REP,210018,4,25,149,178,
Delaware,Superintendent of Public Instruction,John Cox,DEM,210018,6,20,102,128,
Delaware,Superintendent of Public Instruction,Larry Huff,IND,210018,1,1,20,22,
Delaware,Commissioner of Labor,Leslie Osborn,REP,210018,6,31,188,225,
Delaware,Commissioner of Labor,Fred Dorrell,DEM,210018,4,13,64,81,
Delaware,Commissioner of Labor,Brandt Dismukes,IND,210018,1,1,13,15,
Delaware,Insurance Commissioner,Glen Mulready,REP,210018,8,31,195,234,
Delaware,Insurance Commissioner,Kimberly Fobbs,DEM,210018,3,14,74,91,
Delaware,Corporation Commissioner,Bob Anthony,REP,210018,6,32,191,229,
Delaware,Corporation Commissioner,Ashley Nicole Mccray,DEM,210018,4,14,58,76,
Delaware,Corporation Commissioner,Jackie Short,IND,210018,1,0,19,20,
Delaware,U.S. House,Richard Castaldo,LIB,210018,2,2,8,12,2
Delaware,U.S. House,Markwayne Mullin,REP,210018,7,32,199,238,2
Delaware,U.S. House,Jason Nichols,DEM,210018,2,11,60,73,2
Delaware,U.S. House,John Foreman,IND,210018,0,0,5,5,2
Delaware,State House,Josh West,REP,210018,8,34,192,234,5
Delaware,State House,Ed Trumbull,DEM,210018,3,12,79,94,5
Delaware,Governor,Chris Powell,LIB,210019,3,2,28,33,
Delaware,Governor,Kevin Stitt,REP,210019,20,24,439,483,
Delaware,Governor,Drew Edmondson,DEM,210019,15,14,208,237,
Delaware,Lieutenant Governor,Matt Pinnell,REP,210019,24,26,468,518,
Delaware,Lieutenant Governor,Anastasia Pittman,DEM,210019,11,14,167,192,
Delaware,Lieutenant Governor,Ivan Holmes,IND,210019,1,0,31,32,
Delaware,State Auditor,John Yeutter,LIB,210019,7,7,126,140,
Delaware,State Auditor,Cindy Byrd,REP,210019,28,30,501,559,
Delaware,Attorney General,Mike Hunter,REP,210019,24,25,487,536,
Delaware,Attorney General,Mark Myles,DEM,210019,13,15,176,204,
Delaware,State Treasurer,Randy Mcdaniel,REP,210019,29,28,499,556,
Delaware,State Treasurer,Charles De Coune,IND,210019,6,9,129,144,
Delaware,Superintendent of Public Instruction,Joy Hofmeister,REP,210019,20,21,331,372,
Delaware,Superintendent of Public Instruction,John Cox,DEM,210019,18,18,296,332,
Delaware,Superintendent of Public Instruction,Larry Huff,IND,210019,0,1,41,42,
Delaware,Commissioner of Labor,Leslie Osborn,REP,210019,21,27,430,478,
Delaware,Commissioner of Labor,Fred Dorrell,DEM,210019,13,13,200,226,
Delaware,Commissioner of Labor,Brandt Dismukes,IND,210019,1,0,30,31,
Delaware,Insurance Commissioner,Glen Mulready,REP,210019,22,25,450,497,
Delaware,Insurance Commissioner,Kimberly Fobbs,DEM,210019,13,15,207,235,
Delaware,Corporation Commissioner,Bob Anthony,REP,210019,22,26,439,487,
Delaware,Corporation Commissioner,Ashley Nicole Mccray,DEM,210019,14,12,184,210,
Delaware,Corporation Commissioner,Jackie Short,IND,210019,0,2,40,42,
Delaware,U.S. House,Richard Castaldo,LIB,210019,1,1,9,11,2
Delaware,U.S. House,Markwayne Mullin,REP,210019,26,25,471,522,2
Delaware,U.S. House,Jason Nichols,DEM,210019,11,14,175,200,2
Delaware,U.S. House,John Foreman,IND,210019,0,0,17,17,2
Delaware,State House,David Hardin,REP,210019,19,20,385,424,86
Delaware,State House,Rhonda Cox,DEM,210019,19,19,284,322,86
Delaware,Governor,Chris Powell,LIB,210020,0,1,10,11,
Delaware,Governor,Kevin Stitt,REP,210020,1,0,68,69,
Delaware,Governor,Drew Edmondson,DEM,210020,2,0,69,71,
Delaware,Lieutenant Governor,Matt Pinnell,REP,210020,1,0,89,90,
Delaware,Lieutenant Governor,Anastasia Pittman,DEM,210020,2,1,47,50,
Delaware,Lieutenant Governor,Ivan Holmes,IND,210020,0,0,8,8,
Delaware,State Auditor,John Yeutter,LIB,210020,1,1,38,40,
Delaware,State Auditor,Cindy Byrd,REP,210020,1,0,96,97,
Delaware,Attorney General,Mike Hunter,REP,210020,1,0,93,94,
Delaware,Attorney General,Mark Myles,DEM,210020,2,1,50,53,
Delaware,State Treasurer,Randy Mcdaniel,REP,210020,1,0,104,105,
Delaware,State Treasurer,Charles De Coune,IND,210020,1,1,30,32,
Delaware,Superintendent of Public Instruction,Joy Hofmeister,REP,210020,1,0,49,50,
Delaware,Superintendent of Public Instruction,John Cox,DEM,210020,2,0,80,82,
Delaware,Superintendent of Public Instruction,Larry Huff,IND,210020,0,1,15,16,
Delaware,Commissioner of Labor,Leslie Osborn,REP,210020,1,0,73,74,
Delaware,Commissioner of Labor,Fred Dorrell,DEM,210020,2,0,60,62,
Delaware,Commissioner of Labor,Brandt Dismukes,IND,210020,0,1,9,10,
Delaware,Insurance Commissioner,Glen Mulready,REP,210020,1,0,88,89,
Delaware,Insurance Commissioner,Kimberly Fobbs,DEM,210020,2,1,54,57,
Delaware,Corporation Commissioner,Bob Anthony,REP,210020,1,0,85,86,
Delaware,Corporation Commissioner,Ashley Nicole Mccray,DEM,210020,2,1,46,49,
Delaware,Corporation Commissioner,Jackie Short,IND,210020,0,0,12,12,
Delaware,U.S. House,Richard Castaldo,LIB,210020,0,0,6,6,2
Delaware,U.S. House,Markwayne Mullin,REP,210020,1,0,90,91,2
Delaware,U.S. House,Jason Nichols,DEM,210020,2,0,47,49,2
Delaware,U.S. House,John Foreman,IND,210020,0,1,3,4,2
Delaware,State House,Josh West,REP,210020,1,0,86,87,5
Delaware,State House,Ed Trumbull,DEM,210020,2,1,56,59,5
Delaware,Governor,Chris Powell,LIB,210021,1,0,6,7,
Delaware,Governor,Kevin Stitt,REP,210021,0,0,74,74,
Delaware,Governor,Drew Edmondson,DEM,210021,0,2,37,39,
Delaware,Lieutenant Governor,Matt Pinnell,REP,210021,0,0,83,83,
Delaware,Lieutenant Governor,Anastasia Pittman,DEM,210021,0,2,29,31,
Delaware,Lieutenant Governor,Ivan Holmes,IND,210021,1,0,3,4,
Delaware,State Auditor,John Yeutter,LIB,210021,0,1,22,23,
Delaware,State Auditor,Cindy Byrd,REP,210021,1,0,87,88,
Delaware,Attorney General,Mike Hunter,REP,210021,1,0,80,81,
Delaware,Attorney General,Mark Myles,DEM,210021,0,2,36,38,
Delaware,State Treasurer,Randy Mcdaniel,REP,210021,1,0,88,89,
Delaware,State Treasurer,Charles De Coune,IND,210021,0,0,20,20,
Delaware,Superintendent of Public Instruction,Joy Hofmeister,REP,210021,0,0,55,55,
Delaware,Superintendent of Public Instruction,John Cox,DEM,210021,1,2,49,52,
Delaware,Superintendent of Public Instruction,Larry Huff,IND,210021,0,0,13,13,
Delaware,Commissioner of Labor,Leslie Osborn,REP,210021,1,0,69,70,
Delaware,Commissioner of Labor,Fred Dorrell,DEM,210021,0,2,39,41,
Delaware,Commissioner of Labor,Brandt Dismukes,IND,210021,0,0,7,7,
Delaware,Insurance Commissioner,Glen Mulready,REP,210021,1,0,76,77,
Delaware,Insurance Commissioner,Kimberly Fobbs,DEM,210021,0,2,40,42,
Delaware,Corporation Commissioner,Bob Anthony,REP,210021,1,0,77,78,
Delaware,Corporation Commissioner,Ashley Nicole Mccray,DEM,210021,0,2,31,33,
Delaware,Corporation Commissioner,Jackie Short,IND,210021,0,0,5,5,
Delaware,U.S. House,Richard Castaldo,LIB,210021,0,0,1,1,2
Delaware,U.S. House,Markwayne Mullin,REP,210021,1,0,72,73,2
Delaware,U.S. House,Jason Nichols,DEM,210021,0,2,37,39,2
Delaware,U.S. House,John Foreman,IND,210021,0,0,7,7,2
Delaware,State House,Josh West,REP,210021,1,0,64,65,5
Delaware,State House,Ed Trumbull,DEM,210021,0,2,52,54,5
Delaware,Governor,Chris Powell,LIB,210022,1,0,39,40,
Delaware,Governor,Kevin Stitt,REP,210022,33,51,529,613,
Delaware,Governor,Drew Edmondson,DEM,210022,28,13,327,368,
Delaware,Lieutenant Governor,Matt Pinnell,REP,210022,36,52,592,680,
Delaware,Lieutenant Governor,Anastasia Pittman,DEM,210022,22,10,264,296,
Delaware,Lieutenant Governor,Ivan Holmes,IND,210022,2,1,27,30,
Delaware,State Auditor,John Yeutter,LIB,210022,17,8,184,209,
Delaware,State Auditor,Cindy Byrd,REP,210022,40,51,643,734,
Delaware,Attorney General,Mike Hunter,REP,210022,36,52,600,688,
Delaware,Attorney General,Mark Myles,DEM,210022,24,11,286,321,
Delaware,State Treasurer,Randy Mcdaniel,REP,210022,39,52,660,751,
Delaware,State Treasurer,Charles De Coune,IND,210022,17,7,167,191,
Delaware,Superintendent of Public Instruction,Joy Hofmeister,REP,210022,24,45,456,525,
Delaware,Superintendent of Public Instruction,John Cox,DEM,210022,35,15,388,438,
Delaware,Superintendent of Public Instruction,Larry Huff,IND,210022,3,3,46,52,
Delaware,Commissioner of Labor,Leslie Osborn,REP,210022,35,48,555,638,
Delaware,Commissioner of Labor,Fred Dorrell,DEM,210022,21,12,291,324,
Delaware,Commissioner of Labor,Brandt Dismukes,IND,210022,4,2,31,37,
Delaware,Insurance Commissioner,Glen Mulready,REP,210022,35,51,566,652,
Delaware,Insurance Commissioner,Kimberly Fobbs,DEM,210022,25,12,312,349,
Delaware,Corporation Commissioner,Bob Anthony,REP,210022,31,51,559,641,
Delaware,Corporation Commissioner,Ashley Nicole Mccray,DEM,210022,23,10,276,309,
Delaware,Corporation Commissioner,Jackie Short,IND,210022,6,2,45,53,
Delaware,U.S. House,Richard Castaldo,LIB,210022,0,2,14,16,2
Delaware,U.S. House,Markwayne Mullin,REP,210022,40,50,579,669,2
Delaware,U.S. House,Jason Nichols,DEM,210022,24,10,264,298,2
Delaware,U.S. House,John Foreman,IND,210022,0,2,36,38,2
Delaware,State House,David Hardin,REP,210022,29,49,486,564,86
Delaware,State House,Rhonda Cox,DEM,210022,33,14,404,451,86
Delaware,Governor,Chris Powell,LIB,210023,2,0,12,14,
Delaware,Governor,Kevin Stitt,REP,210023,23,12,383,418,
Delaware,Governor,Drew Edmondson,DEM,210023,14,7,110,131,
Delaware,Lieutenant Governor,Matt Pinnell,REP,210023,27,15,406,448,
Delaware,Lieutenant Governor,Anastasia Pittman,DEM,210023,11,4,88,103,
Delaware,Lieutenant Governor,Ivan Holmes,IND,210023,1,0,5,6,
Delaware,State Auditor,John Yeutter,LIB,210023,5,3,58,66,
Delaware,State Auditor,Cindy Byrd,REP,210023,35,15,411,461,
Delaware,Attorney General,Mike Hunter,REP,210023,27,12,412,451,
Delaware,Attorney General,Mark Myles,DEM,210023,13,7,86,106,
Delaware,State Treasurer,Randy Mcdaniel,REP,210023,28,16,419,463,
Delaware,State Treasurer,Charles De Coune,IND,210023,12,2,53,67,
Delaware,Superintendent of Public Instruction,Joy Hofmeister,REP,210023,27,10,319,356,
Delaware,Superintendent of Public Instruction,John Cox,DEM,210023,11,9,157,177,
Delaware,Superintendent of Public Instruction,Larry Huff,IND,210023,2,0,24,26,
Delaware,Commissioner of Labor,Leslie Osborn,REP,210023,29,12,367,408,
Delaware,Commissioner of Labor,Fred Dorrell,DEM,210023,10,7,109,126,
Delaware,Commissioner of Labor,Brandt Dismukes,IND,210023,1,0,11,12,
Delaware,Insurance Commissioner,Glen Mulready,REP,210023,24,12,394,430,
Delaware,Insurance Commissioner,Kimberly Fobbs,DEM,210023,16,7,99,122,
Delaware,Corporation Commissioner,Bob Anthony,REP,210023,26,12,390,428,
Delaware,Corporation Commissioner,Ashley Nicole Mccray,DEM,210023,10,7,90,107,
Delaware,Corporation Commissioner,Jackie Short,IND,210023,3,0,13,16,
Delaware,U.S. House,Richard Castaldo,LIB,210023,0,0,10,10,2
Delaware,U.S. House,Markwayne Mullin,REP,210023,27,10,399,436,2
Delaware,U.S. House,Jason Nichols,DEM,210023,10,8,82,100,2
Delaware,U.S. House,John Foreman,IND,210023,3,1,12,16,2
Delaware,State House,David Hardin,REP,210023,25,11,369,405,86
Delaware,State House,Rhonda Cox,DEM,210023,15,8,132,155,86
Dewey,Governor,Chris Powell,LIB,220001,0,0,4,4,
Dewey,Governor,Kevin Stitt,REP,220001,7,18,148,173,
Dewey,Governor,Drew Edmondson,DEM,220001,4,5,39,48,
Dewey,Lieutenant Governor,Matt Pinnell,REP,220001,8,21,157,186,
Dewey,Lieutenant Governor,Anastasia Pittman,DEM,220001,3,2,28,33,
Dewey,Lieutenant Governor,Ivan Holmes,IND,220001,0,0,3,3,
Dewey,State Auditor,John Yeutter,LIB,220001,1,2,24,27,
Dewey,State Auditor,Cindy Byrd,REP,220001,9,21,158,188,
Dewey,Attorney General,Mike Hunter,REP,220001,8,20,155,183,
Dewey,Attorney General,Mark Myles,DEM,220001,3,3,33,39,
Dewey,State Treasurer,Randy Mcdaniel,REP,220001,8,19,163,190,
Dewey,State Treasurer,Charles De Coune,IND,220001,2,4,18,24,
Dewey,Superintendent of Public Instruction,Joy Hofmeister,REP,220001,7,19,113,139,
Dewey,Superintendent of Public Instruction,John Cox,DEM,220001,2,2,68,72,
Dewey,Superintendent of Public Instruction,Larry Huff,IND,220001,2,2,8,12,
Dewey,Commissioner of Labor,Leslie Osborn,REP,220001,7,18,147,172,
Dewey,Commissioner of Labor,Fred Dorrell,DEM,220001,4,4,37,45,
Dewey,Commissioner of Labor,Brandt Dismukes,IND,220001,0,0,4,4,
Dewey,Insurance Commissioner,Glen Mulready,REP,220001,7,18,151,176,
Dewey,Insurance Commissioner,Kimberly Fobbs,DEM,220001,4,4,33,41,
Dewey,Corporation Commissioner,Bob Anthony,REP,220001,8,20,156,184,
Dewey,Corporation Commissioner,Ashley Nicole Mccray,DEM,220001,3,2,25,30,
Dewey,Corporation Commissioner,Jackie Short,IND,220001,0,0,8,8,
Dewey,U.S. House,Frank Lucas,REP,220001,9,21,159,189,3
Dewey,U.S. House,Frankie Robbins,DEM,220001,2,1,29,32,3
Dewey,Governor,Chris Powell,LIB,220002,0,0,0,0,
Dewey,Governor,Kevin Stitt,REP,220002,3,1,58,62,
Dewey,Governor,Drew Edmondson,DEM,220002,2,0,13,15,
Dewey,Lieutenant Governor,Matt Pinnell,REP,220002,5,1,60,66,
Dewey,Lieutenant Governor,Anastasia Pittman,DEM,220002,0,0,9,9,
Dewey,Lieutenant Governor,Ivan Holmes,IND,220002,0,0,1,1,
Dewey,State Auditor,John Yeutter,LIB,220002,0,0,4,4,
Dewey,State Auditor,Cindy Byrd,REP,220002,5,1,62,68,
Dewey,Attorney General,Mike Hunter,REP,220002,3,1,61,65,
Dewey,Attorney General,Mark Myles,DEM,220002,2,0,7,9,
Dewey,State Treasurer,Randy Mcdaniel,REP,220002,3,1,63,67,
Dewey,State Treasurer,Charles De Coune,IND,220002,2,0,3,5,
Dewey,Superintendent of Public Instruction,Joy Hofmeister,REP,220002,3,1,59,63,
Dewey,Superintendent of Public Instruction,John Cox,DEM,220002,2,0,6,8,
Dewey,Superintendent of Public Instruction,Larry Huff,IND,220002,0,0,3,3,
Dewey,Commissioner of Labor,Leslie Osborn,REP,220002,5,1,57,63,
Dewey,Commissioner of Labor,Fred Dorrell,DEM,220002,0,0,10,10,
Dewey,Commissioner of Labor,Brandt Dismukes,IND,220002,0,0,0,0,
Dewey,Insurance Commissioner,Glen Mulready,REP,220002,3,1,59,63,
Dewey,Insurance Commissioner,Kimberly Fobbs,DEM,220002,2,0,9,11,
Dewey,Corporation Commissioner,Bob Anthony,REP,220002,4,1,61,66,
Dewey,Corporation Commissioner,Ashley Nicole Mccray,DEM,220002,1,0,7,8,
Dewey,Corporation Commissioner,Jackie Short,IND,220002,0,0,1,1,
Dewey,U.S. House,Frank Lucas,REP,220002,5,1,66,72,3
Dewey,U.S. House,Frankie Robbins,DEM,220002,0,0,4,4,3
Dewey,Governor,Chris Powell,LIB,220003,0,0,7,7,
Dewey,Governor,Kevin Stitt,REP,220003,7,6,192,205,
Dewey,Governor,Drew Edmondson,DEM,220003,1,0,51,52,
Dewey,Lieutenant Governor,Matt Pinnell,REP,220003,6,5,202,213,
Dewey,Lieutenant Governor,Anastasia Pittman,DEM,220003,1,1,38,40,
Dewey,Lieutenant Governor,Ivan Holmes,IND,220003,1,0,6,7,
Dewey,State Auditor,John Yeutter,LIB,220003,0,1,20,21,
Dewey,State Auditor,Cindy Byrd,REP,220003,6,4,216,226,
Dewey,Attorney General,Mike Hunter,REP,220003,5,6,210,221,
Dewey,Attorney General,Mark Myles,DEM,220003,3,0,37,40,
Dewey,State Treasurer,Randy Mcdaniel,REP,220003,7,5,217,229,
Dewey,State Treasurer,Charles De Coune,IND,220003,0,1,14,15,
Dewey,Superintendent of Public Instruction,Joy Hofmeister,REP,220003,5,3,170,178,
Dewey,Superintendent of Public Instruction,John Cox,DEM,220003,2,3,65,70,
Dewey,Superintendent of Public Instruction,Larry Huff,IND,220003,1,0,14,15,
Dewey,Commissioner of Labor,Leslie Osborn,REP,220003,7,6,194,207,
Dewey,Commissioner of Labor,Fred Dorrell,DEM,220003,1,0,41,42,
Dewey,Commissioner of Labor,Brandt Dismukes,IND,220003,0,0,7,7,
Dewey,Insurance Commissioner,Glen Mulready,REP,220003,7,6,199,212,
Dewey,Insurance Commissioner,Kimberly Fobbs,DEM,220003,1,0,46,47,
Dewey,Corporation Commissioner,Bob Anthony,REP,220003,5,4,196,205,
Dewey,Corporation Commissioner,Ashley Nicole Mccray,DEM,220003,3,0,41,44,
Dewey,Corporation Commissioner,Jackie Short,IND,220003,0,2,9,11,
Dewey,U.S. House,Frank Lucas,REP,220003,6,5,212,223,3
Dewey,U.S. House,Frankie Robbins,DEM,220003,2,1,37,40,3
Dewey,Governor,Chris Powell,LIB,220004,0,1,1,2,
Dewey,Governor,Kevin Stitt,REP,220004,1,2,83,86,
Dewey,Governor,Drew Edmondson,DEM,220004,0,0,24,24,
Dewey,Lieutenant Governor,Matt Pinnell,REP,220004,2,2,90,94,
Dewey,Lieutenant Governor,Anastasia Pittman,DEM,220004,0,0,16,16,
Dewey,Lieutenant Governor,Ivan Holmes,IND,220004,0,1,1,2,
Dewey,State Auditor,John Yeutter,LIB,220004,0,0,16,16,
Dewey,State Auditor,Cindy Byrd,REP,220004,2,3,84,89,
Dewey,Attorney General,Mike Hunter,REP,220004,2,3,88,93,
Dewey,Attorney General,Mark Myles,DEM,220004,0,0,19,19,
Dewey,State Treasurer,Randy Mcdaniel,REP,220004,2,3,88,93,
Dewey,State Treasurer,Charles De Coune,IND,220004,0,0,11,11,
Dewey,Superintendent of Public Instruction,Joy Hofmeister,REP,220004,2,3,74,79,
Dewey,Superintendent of Public Instruction,John Cox,DEM,220004,0,0,19,19,
Dewey,Superintendent of Public Instruction,Larry Huff,IND,220004,0,0,12,12,
Dewey,Commissioner of Labor,Leslie Osborn,REP,220004,2,3,80,85,
Dewey,Commissioner of Labor,Fred Dorrell,DEM,220004,0,0,21,21,
Dewey,Commissioner of Labor,Brandt Dismukes,IND,220004,0,0,4,4,
Dewey,Insurance Commissioner,Glen Mulready,REP,220004,2,3,84,89,
Dewey,Insurance Commissioner,Kimberly Fobbs,DEM,220004,0,0,22,22,
Dewey,Corporation Commissioner,Bob Anthony,REP,220004,2,3,79,84,
Dewey,Corporation Commissioner,Ashley Nicole Mccray,DEM,220004,0,0,21,21,
Dewey,Corporation Commissioner,Jackie Short,IND,220004,0,0,6,6,
Dewey,U.S. House,Frank Lucas,REP,220004,2,2,90,94,3
Dewey,U.S. House,Frankie Robbins,DEM,220004,0,1,18,19,3
Dewey,Governor,Chris Powell,LIB,220005,0,0,18,18,
Dewey,Governor,Kevin Stitt,REP,220005,13,26,350,389,
Dewey,Governor,Drew Edmondson,DEM,220005,6,5,67,78,
Dewey,Lieutenant Governor,Matt Pinnell,REP,220005,13,28,376,417,
Dewey,Lieutenant Governor,Anastasia Pittman,DEM,220005,5,3,47,55,
Dewey,Lieutenant Governor,Ivan Holmes,IND,220005,1,0,9,10,
Dewey,State Auditor,John Yeutter,LIB,220005,1,2,42,45,
Dewey,State Auditor,Cindy Byrd,REP,220005,17,28,382,427,
Dewey,Attorney General,Mike Hunter,REP,220005,18,27,384,429,
Dewey,Attorney General,Mark Myles,DEM,220005,1,4,46,51,
Dewey,State Treasurer,Randy Mcdaniel,REP,220005,17,25,401,443,
Dewey,State Treasurer,Charles De Coune,IND,220005,1,6,24,31,
Dewey,Superintendent of Public Instruction,Joy Hofmeister,REP,220005,11,22,326,359,
Dewey,Superintendent of Public Instruction,John Cox,DEM,220005,8,6,74,88,
Dewey,Superintendent of Public Instruction,Larry Huff,IND,220005,0,3,30,33,
Dewey,Commissioner of Labor,Leslie Osborn,REP,220005,15,24,369,408,
Dewey,Commissioner of Labor,Fred Dorrell,DEM,220005,4,6,46,56,
Dewey,Commissioner of Labor,Brandt Dismukes,IND,220005,0,1,15,16,
Dewey,Insurance Commissioner,Glen Mulready,REP,220005,17,24,370,411,
Dewey,Insurance Commissioner,Kimberly Fobbs,DEM,220005,2,7,59,68,
Dewey,Corporation Commissioner,Bob Anthony,REP,220005,17,22,367,406,
Dewey,Corporation Commissioner,Ashley Nicole Mccray,DEM,220005,2,7,42,51,
Dewey,Corporation Commissioner,Jackie Short,IND,220005,0,2,23,25,
Dewey,U.S. House,Frank Lucas,REP,220005,16,28,399,443,3
Dewey,U.S. House,Frankie Robbins,DEM,220005,3,3,34,40,3
Dewey,Governor,Chris Powell,LIB,220007,0,0,1,1,
Dewey,Governor,Kevin Stitt,REP,220007,2,2,58,62,
Dewey,Governor,Drew Edmondson,DEM,220007,1,0,8,9,
Dewey,Lieutenant Governor,Matt Pinnell,REP,220007,3,2,61,66,
Dewey,Lieutenant Governor,Anastasia Pittman,DEM,220007,0,0,7,7,
Dewey,Lieutenant Governor,Ivan Holmes,IND,220007,0,0,0,0,
Dewey,State Auditor,John Yeutter,LIB,220007,0,0,8,8,
Dewey,State Auditor,Cindy Byrd,REP,220007,3,2,58,63,
Dewey,Attorney General,Mike Hunter,REP,220007,2,2,62,66,
Dewey,Attorney General,Mark Myles,DEM,220007,1,0,5,6,
Dewey,State Treasurer,Randy Mcdaniel,REP,220007,3,2,62,67,
Dewey,State Treasurer,Charles De Coune,IND,220007,0,0,5,5,
Dewey,Superintendent of Public Instruction,Joy Hofmeister,REP,220007,3,2,51,56,
Dewey,Superintendent of Public Instruction,John Cox,DEM,220007,0,0,11,11,
Dewey,Superintendent of Public Instruction,Larry Huff,IND,220007,0,0,5,5,
Dewey,Commissioner of Labor,Leslie Osborn,REP,220007,2,2,59,63,
Dewey,Commissioner of Labor,Fred Dorrell,DEM,220007,1,0,6,7,
Dewey,Commissioner of Labor,Brandt Dismukes,IND,220007,0,0,2,2,
Dewey,Insurance Commissioner,Glen Mulready,REP,220007,3,2,57,62,
Dewey,Insurance Commissioner,Kimberly Fobbs,DEM,220007,0,0,11,11,
Dewey,Corporation Commissioner,Bob Anthony,REP,220007,2,2,50,54,
Dewey,Corporation Commissioner,Ashley Nicole Mccray,DEM,220007,1,0,12,13,
Dewey,Corporation Commissioner,Jackie Short,IND,220007,0,0,6,6,
Dewey,U.S. House,Frank Lucas,REP,220007,3,2,60,65,3
Dewey,U.S. House,Frankie Robbins,DEM,220007,0,0,7,7,3
Dewey,Governor,Chris Powell,LIB,220008,0,0,12,12,
Dewey,Governor,Kevin Stitt,REP,220008,19,23,255,297,
Dewey,Governor,Drew Edmondson,DEM,220008,2,2,58,62,
Dewey,Lieutenant Governor,Matt Pinnell,REP,220008,19,24,273,316,
Dewey,Lieutenant Governor,Anastasia Pittman,DEM,220008,1,1,41,43,
Dewey,Lieutenant Governor,Ivan Holmes,IND,220008,1,0,6,7,
Dewey,State Auditor,John Yeutter,LIB,220008,1,1,46,48,
Dewey,State Auditor,Cindy Byrd,REP,220008,17,24,272,313,
Dewey,Attorney General,Mike Hunter,REP,220008,16,24,261,301,
Dewey,Attorney General,Mark Myles,DEM,220008,5,1,59,65,
Dewey,State Treasurer,Randy Mcdaniel,REP,220008,17,24,274,315,
Dewey,State Treasurer,Charles De Coune,IND,220008,2,1,44,47,
Dewey,Superintendent of Public Instruction,Joy Hofmeister,REP,220008,15,19,220,254,
Dewey,Superintendent of Public Instruction,John Cox,DEM,220008,6,5,77,88,
Dewey,Superintendent of Public Instruction,Larry Huff,IND,220008,0,1,23,24,
Dewey,Commissioner of Labor,Leslie Osborn,REP,220008,17,22,258,297,
Dewey,Commissioner of Labor,Fred Dorrell,DEM,220008,4,3,49,56,
Dewey,Commissioner of Labor,Brandt Dismukes,IND,220008,0,0,13,13,
Dewey,Insurance Commissioner,Glen Mulready,REP,220008,19,23,262,304,
Dewey,Insurance Commissioner,Kimberly Fobbs,DEM,220008,1,2,55,58,
Dewey,Corporation Commissioner,Bob Anthony,REP,220008,19,22,249,290,
Dewey,Corporation Commissioner,Ashley Nicole Mccray,DEM,220008,2,3,48,53,
Dewey,Corporation Commissioner,Jackie Short,IND,220008,0,0,24,24,
Dewey,U.S. House,Frank Lucas,REP,220008,20,22,283,325,3
Dewey,U.S. House,Frankie Robbins,DEM,220008,1,3,39,43,3
Dewey,Governor,Chris Powell,LIB,220009,0,0,4,4,
Dewey,Governor,Kevin Stitt,REP,220009,2,1,103,106,
Dewey,Governor,Drew Edmondson,DEM,220009,3,2,11,16,
Dewey,Lieutenant Governor,Matt Pinnell,REP,220009,4,3,105,112,
Dewey,Lieutenant Governor,Anastasia Pittman,DEM,220009,0,0,9,9,
Dewey,Lieutenant Governor,Ivan Holmes,IND,220009,1,0,4,5,
Dewey,State Auditor,John Yeutter,LIB,220009,0,0,5,5,
Dewey,State Auditor,Cindy Byrd,REP,220009,4,3,114,121,
Dewey,Attorney General,Mike Hunter,REP,220009,3,3,96,102,
Dewey,Attorney General,Mark Myles,DEM,220009,2,0,21,23,
Dewey,State Treasurer,Randy Mcdaniel,REP,220009,3,3,107,113,
Dewey,State Treasurer,Charles De Coune,IND,220009,2,0,9,11,
Dewey,Superintendent of Public Instruction,Joy Hofmeister,REP,220009,3,3,96,102,
Dewey,Superintendent of Public Instruction,John Cox,DEM,220009,2,0,11,13,
Dewey,Superintendent of Public Instruction,Larry Huff,IND,220009,0,0,11,11,
Dewey,Commissioner of Labor,Leslie Osborn,REP,220009,3,3,96,102,
Dewey,Commissioner of Labor,Fred Dorrell,DEM,220009,1,0,13,14,
Dewey,Commissioner of Labor,Brandt Dismukes,IND,220009,1,0,7,8,
Dewey,Insurance Commissioner,Glen Mulready,REP,220009,1,3,104,108,
Dewey,Insurance Commissioner,Kimberly Fobbs,DEM,220009,4,0,12,16,
Dewey,Corporation Commissioner,Bob Anthony,REP,220009,2,3,97,102,
Dewey,Corporation Commissioner,Ashley Nicole Mccray,DEM,220009,3,0,13,16,
Dewey,Corporation Commissioner,Jackie Short,IND,220009,0,0,7,7,
Dewey,U.S. House,Frank Lucas,REP,220009,4,3,109,116,3
Dewey,U.S. House,Frankie Robbins,DEM,220009,1,0,10,11,3
Dewey,Governor,Chris Powell,LIB,220010,0,0,1,1,
Dewey,Governor,Kevin Stitt,REP,220010,1,0,23,24,
Dewey,Governor,Drew Edmondson,DEM,220010,0,0,11,11,
Dewey,Lieutenant Governor,Matt Pinnell,REP,220010,1,0,26,27,
Dewey,Lieutenant Governor,Anastasia Pittman,DEM,220010,0,0,9,9,
Dewey,Lieutenant Governor,Ivan Holmes,IND,220010,0,0,0,0,
Dewey,State Auditor,John Yeutter,LIB,220010,0,0,4,4,
Dewey,State Auditor,Cindy Byrd,REP,220010,1,0,28,29,
Dewey,Attorney General,Mike Hunter,REP,220010,1,0,18,19,
Dewey,Attorney General,Mark Myles,DEM,220010,0,0,16,16,
Dewey,State Treasurer,Randy Mcdaniel,REP,220010,1,0,26,27,
Dewey,State Treasurer,Charles De Coune,IND,220010,0,0,5,5,
Dewey,Superintendent of Public Instruction,Joy Hofmeister,REP,220010,1,0,22,23,
Dewey,Superintendent of Public Instruction,John Cox,DEM,220010,0,0,12,12,
Dewey,Superintendent of Public Instruction,Larry Huff,IND,220010,0,0,1,1,
Dewey,Commissioner of Labor,Leslie Osborn,REP,220010,1,0,23,24,
Dewey,Commissioner of Labor,Fred Dorrell,DEM,220010,0,0,9,9,
Dewey,Commissioner of Labor,Brandt Dismukes,IND,220010,0,0,2,2,
Dewey,Insurance Commissioner,Glen Mulready,REP,220010,1,0,24,25,
Dewey,Insurance Commissioner,Kimberly Fobbs,DEM,220010,0,0,8,8,
Dewey,Corporation Commissioner,Bob Anthony,REP,220010,1,0,18,19,
Dewey,Corporation Commissioner,Ashley Nicole Mccray,DEM,220010,0,0,14,14,
Dewey,Corporation Commissioner,Jackie Short,IND,220010,0,0,2,2,
Dewey,U.S. House,Frank Lucas,REP,220010,1,0,29,30,3
Dewey,U.S. House,Frankie Robbins,DEM,220010,0,0,6,6,3
Ellis,Governor,Chris Powell,LIB,230001,1,7,8,16,
Ellis,Governor,Kevin Stitt,REP,230001,23,54,223,300,
Ellis,Governor,Drew Edmondson,DEM,230001,3,13,49,65,
Ellis,Lieutenant Governor,Matt Pinnell,REP,230001,23,59,226,308,
Ellis,Lieutenant Governor,Anastasia Pittman,DEM,230001,4,13,46,63,
Ellis,Lieutenant Governor,Ivan Holmes,IND,230001,0,1,5,6,
Ellis,State Auditor,John Yeutter,LIB,230001,0,9,27,36,
Ellis,State Auditor,Cindy Byrd,REP,230001,27,61,242,330,
Ellis,Attorney General,Mike Hunter,REP,230001,21,60,242,323,
Ellis,Attorney General,Mark Myles,DEM,230001,6,12,37,55,
Ellis,State Treasurer,Randy Mcdaniel,REP,230001,26,63,242,331,
Ellis,State Treasurer,Charles De Coune,IND,230001,1,5,29,35,
Ellis,Superintendent of Public Instruction,Joy Hofmeister,REP,230001,22,48,199,269,
Ellis,Superintendent of Public Instruction,John Cox,DEM,230001,4,18,58,80,
Ellis,Superintendent of Public Instruction,Larry Huff,IND,230001,1,7,20,28,
Ellis,Commissioner of Labor,Leslie Osborn,REP,230001,24,54,228,306,
Ellis,Commissioner of Labor,Fred Dorrell,DEM,230001,1,8,40,49,
Ellis,Commissioner of Labor,Brandt Dismukes,IND,230001,2,7,9,18,
Ellis,Insurance Commissioner,Glen Mulready,REP,230001,24,56,234,314,
Ellis,Insurance Commissioner,Kimberly Fobbs,DEM,230001,2,13,42,57,
Ellis,Corporation Commissioner,Bob Anthony,REP,230001,23,53,216,292,
Ellis,Corporation Commissioner,Ashley Nicole Mccray,DEM,230001,3,13,52,68,
Ellis,Corporation Commissioner,Jackie Short,IND,230001,0,6,10,16,
Ellis,U.S. House,Frank Lucas,REP,230001,25,60,244,329,3
Ellis,U.S. House,Frankie Robbins,DEM,230001,2,14,36,52,3
Ellis,State House,Kenton Patzkowsky,REP,230001,19,51,195,265,61
Ellis,State House,Ashley Lehnert,DEM,230001,8,22,84,114,61
Ellis,Governor,Chris Powell,LIB,230003,0,2,15,17,
Ellis,Governor,Kevin Stitt,REP,230003,14,12,366,392,
Ellis,Governor,Drew Edmondson,DEM,230003,7,4,41,52,
Ellis,Lieutenant Governor,Matt Pinnell,REP,230003,16,13,384,413,
Ellis,Lieutenant Governor,Anastasia Pittman,DEM,230003,5,4,27,36,
Ellis,Lieutenant Governor,Ivan Holmes,IND,230003,0,0,10,10,
Ellis,State Auditor,John Yeutter,LIB,230003,7,3,44,54,
Ellis,State Auditor,Cindy Byrd,REP,230003,14,15,373,402,
Ellis,Attorney General,Mike Hunter,REP,230003,13,15,375,403,
Ellis,Attorney General,Mark Myles,DEM,230003,7,2,41,50,
Ellis,State Treasurer,Randy Mcdaniel,REP,230003,15,14,388,417,
Ellis,State Treasurer,Charles De Coune,IND,230003,6,3,29,38,
Ellis,Superintendent of Public Instruction,Joy Hofmeister,REP,230003,13,13,348,374,
Ellis,Superintendent of Public Instruction,John Cox,DEM,230003,5,2,38,45,
Ellis,Superintendent of Public Instruction,Larry Huff,IND,230003,2,2,35,39,
Ellis,Commissioner of Labor,Leslie Osborn,REP,230003,13,14,376,403,
Ellis,Commissioner of Labor,Fred Dorrell,DEM,230003,7,2,35,44,
Ellis,Commissioner of Labor,Brandt Dismukes,IND,230003,1,1,10,12,
Ellis,Insurance Commissioner,Glen Mulready,REP,230003,16,11,367,394,
Ellis,Insurance Commissioner,Kimberly Fobbs,DEM,230003,5,5,44,54,
Ellis,Corporation Commissioner,Bob Anthony,REP,230003,16,12,341,369,
Ellis,Corporation Commissioner,Ashley Nicole Mccray,DEM,230003,3,3,47,53,
Ellis,Corporation Commissioner,Jackie Short,IND,230003,2,1,28,31,
Ellis,U.S. House,Frank Lucas,REP,230003,14,16,381,411,3
Ellis,U.S. House,Frankie Robbins,DEM,230003,7,1,40,48,3
Ellis,State House,Kenton Patzkowsky,REP,230003,12,11,331,354,61
Ellis,State House,Ashley Lehnert,DEM,230003,8,6,91,105,61
Ellis,Governor,Chris Powell,LIB,230004,0,1,2,3,
Ellis,Governor,Kevin Stitt,REP,230004,0,4,58,62,
Ellis,Governor,Drew Edmondson,DEM,230004,0,0,20,20,
Ellis,Lieutenant Governor,Matt Pinnell,REP,230004,0,5,62,67,
Ellis,Lieutenant Governor,Anastasia Pittman,DEM,230004,0,0,14,14,
Ellis,Lieutenant Governor,Ivan Holmes,IND,230004,0,0,2,2,
Ellis,State Auditor,John Yeutter,LIB,230004,0,0,10,10,
Ellis,State Auditor,Cindy Byrd,REP,230004,0,5,64,69,
Ellis,Attorney General,Mike Hunter,REP,230004,0,5,63,68,
Ellis,Attorney General,Mark Myles,DEM,230004,0,0,15,15,
Ellis,State Treasurer,Randy Mcdaniel,REP,230004,0,5,64,69,
Ellis,State Treasurer,Charles De Coune,IND,230004,0,0,13,13,
Ellis,Superintendent of Public Instruction,Joy Hofmeister,REP,230004,0,4,55,59,
Ellis,Superintendent of Public Instruction,John Cox,DEM,230004,0,0,15,15,
Ellis,Superintendent of Public Instruction,Larry Huff,IND,230004,0,1,9,10,
Ellis,Commissioner of Labor,Leslie Osborn,REP,230004,0,5,58,63,
Ellis,Commissioner of Labor,Fred Dorrell,DEM,230004,0,0,14,14,
Ellis,Commissioner of Labor,Brandt Dismukes,IND,230004,0,0,5,5,
Ellis,Insurance Commissioner,Glen Mulready,REP,230004,0,5,61,66,
Ellis,Insurance Commissioner,Kimberly Fobbs,DEM,230004,0,0,16,16,
Ellis,Corporation Commissioner,Bob Anthony,REP,230004,0,5,56,61,
Ellis,Corporation Commissioner,Ashley Nicole Mccray,DEM,230004,0,0,12,12,
Ellis,Corporation Commissioner,Jackie Short,IND,230004,0,0,9,9,
Ellis,U.S. House,Frank Lucas,REP,230004,0,5,65,70,3
Ellis,U.S. House,Frankie Robbins,DEM,230004,0,0,16,16,3
Ellis,State House,Kenton Patzkowsky,REP,230004,0,5,56,61,61
Ellis,State House,Ashley Lehnert,DEM,230004,0,0,22,22,61
Ellis,Governor,Chris Powell,LIB,230006,0,0,1,1,
Ellis,Governor,Kevin Stitt,REP,230006,3,2,30,35,
Ellis,Governor,Drew Edmondson,DEM,230006,5,0,3,8,
Ellis,Lieutenant Governor,Matt Pinnell,REP,230006,6,1,31,38,
Ellis,Lieutenant Governor,Anastasia Pittman,DEM,230006,2,1,3,6,
Ellis,Lieutenant Governor,Ivan Holmes,IND,230006,0,0,0,0,
Ellis,State Auditor,John Yeutter,LIB,230006,0,0,3,3,
Ellis,State Auditor,Cindy Byrd,REP,230006,6,2,31,39,
Ellis,Attorney General,Mike Hunter,REP,230006,6,2,28,36,
Ellis,Attorney General,Mark Myles,DEM,230006,2,0,6,8,
Ellis,State Treasurer,Randy Mcdaniel,REP,230006,4,2,31,37,
Ellis,State Treasurer,Charles De Coune,IND,230006,2,0,3,5,
Ellis,Superintendent of Public Instruction,Joy Hofmeister,REP,230006,5,1,27,33,
Ellis,Superintendent of Public Instruction,John Cox,DEM,230006,2,1,4,7,
Ellis,Superintendent of Public Instruction,Larry Huff,IND,230006,1,0,3,4,
Ellis,Commissioner of Labor,Leslie Osborn,REP,230006,6,2,31,39,
Ellis,Commissioner of Labor,Fred Dorrell,DEM,230006,2,0,2,4,
Ellis,Commissioner of Labor,Brandt Dismukes,IND,230006,0,0,1,1,
Ellis,Insurance Commissioner,Glen Mulready,REP,230006,5,2,30,37,
Ellis,Insurance Commissioner,Kimberly Fobbs,DEM,230006,3,0,4,7,
Ellis,Corporation Commissioner,Bob Anthony,REP,230006,5,2,30,37,
Ellis,Corporation Commissioner,Ashley Nicole Mccray,DEM,230006,3,0,3,6,
Ellis,Corporation Commissioner,Jackie Short,IND,230006,0,0,1,1,
Ellis,U.S. House,Frank Lucas,REP,230006,5,2,30,37,3
Ellis,U.S. House,Frankie Robbins,DEM,230006,3,0,4,7,3
Ellis,State House,Kenton Patzkowsky,REP,230006,6,1,28,35,61
Ellis,State House,Ashley Lehnert,DEM,230006,2,1,6,9,61
Ellis,Governor,Chris Powell,LIB,230007,0,1,8,9,
Ellis,Governor,Kevin Stitt,REP,230007,7,13,158,178,
Ellis,Governor,Drew Edmondson,DEM,230007,4,2,31,37,
Ellis,Lieutenant Governor,Matt Pinnell,REP,230007,6,13,167,186,
Ellis,Lieutenant Governor,Anastasia Pittman,DEM,230007,4,3,28,35,
Ellis,Lieutenant Governor,Ivan Holmes,IND,230007,0,0,2,2,
Ellis,State Auditor,John Yeutter,LIB,230007,2,3,27,32,
Ellis,State Auditor,Cindy Byrd,REP,230007,8,12,167,187,
Ellis,Attorney General,Mike Hunter,REP,230007,8,12,175,195,
Ellis,Attorney General,Mark Myles,DEM,230007,3,4,21,28,
Ellis,State Treasurer,Randy Mcdaniel,REP,230007,8,12,173,193,
Ellis,State Treasurer,Charles De Coune,IND,230007,2,3,21,26,
Ellis,Superintendent of Public Instruction,Joy Hofmeister,REP,230007,8,11,143,162,
Ellis,Superintendent of Public Instruction,John Cox,DEM,230007,3,4,31,38,
Ellis,Superintendent of Public Instruction,Larry Huff,IND,230007,0,1,22,23,
Ellis,Commissioner of Labor,Leslie Osborn,REP,230007,7,13,171,191,
Ellis,Commissioner of Labor,Fred Dorrell,DEM,230007,4,3,15,22,
Ellis,Commissioner of Labor,Brandt Dismukes,IND,230007,0,0,7,7,
Ellis,Insurance Commissioner,Glen Mulready,REP,230007,7,13,166,186,
Ellis,Insurance Commissioner,Kimberly Fobbs,DEM,230007,4,3,30,37,
Ellis,Corporation Commissioner,Bob Anthony,REP,230007,8,13,156,177,
Ellis,Corporation Commissioner,Ashley Nicole Mccray,DEM,230007,3,3,29,35,
Ellis,Corporation Commissioner,Jackie Short,IND,230007,0,0,12,12,
Ellis,U.S. House,Frank Lucas,REP,230007,9,15,176,200,3
Ellis,U.S. House,Frankie Robbins,DEM,230007,2,1,21,24,3
Ellis,State House,Kenton Patzkowsky,REP,230007,7,13,159,179,61
Ellis,State House,Ashley Lehnert,DEM,230007,4,3,38,45,61
Ellis,Governor,Chris Powell,LIB,230008,0,0,9,9,
Ellis,Governor,Kevin Stitt,REP,230008,9,8,133,150,
Ellis,Governor,Drew Edmondson,DEM,230008,4,2,29,35,
Ellis,Lieutenant Governor,Matt Pinnell,REP,230008,9,9,148,166,
Ellis,Lieutenant Governor,Anastasia Pittman,DEM,230008,4,1,16,21,
Ellis,Lieutenant Governor,Ivan Holmes,IND,230008,0,0,6,6,
Ellis,State Auditor,John Yeutter,LIB,230008,1,1,13,15,
Ellis,State Auditor,Cindy Byrd,REP,230008,11,9,152,172,
Ellis,Attorney General,Mike Hunter,REP,230008,11,8,142,161,
Ellis,Attorney General,Mark Myles,DEM,230008,2,2,29,33,
Ellis,State Treasurer,Randy Mcdaniel,REP,230008,12,9,150,171,
Ellis,State Treasurer,Charles De Coune,IND,230008,0,1,15,16,
Ellis,Superintendent of Public Instruction,Joy Hofmeister,REP,230008,7,10,136,153,
Ellis,Superintendent of Public Instruction,John Cox,DEM,230008,6,0,23,29,
Ellis,Superintendent of Public Instruction,Larry Huff,IND,230008,0,0,12,12,
Ellis,Commissioner of Labor,Leslie Osborn,REP,230008,12,9,143,164,
Ellis,Commissioner of Labor,Fred Dorrell,DEM,230008,1,1,16,18,
Ellis,Commissioner of Labor,Brandt Dismukes,IND,230008,0,0,9,9,
Ellis,Insurance Commissioner,Glen Mulready,REP,230008,10,9,144,163,
Ellis,Insurance Commissioner,Kimberly Fobbs,DEM,230008,3,1,23,27,
Ellis,Corporation Commissioner,Bob Anthony,REP,230008,8,9,131,148,
Ellis,Corporation Commissioner,Ashley Nicole Mccray,DEM,230008,5,1,28,34,
Ellis,Corporation Commissioner,Jackie Short,IND,230008,0,0,11,11,
Ellis,U.S. House,Frank Lucas,REP,230008,10,9,153,172,3
Ellis,U.S. House,Frankie Robbins,DEM,230008,3,1,18,22,3
Ellis,State House,Kenton Patzkowsky,REP,230008,6,8,140,154,61
Ellis,State House,Ashley Lehnert,DEM,230008,6,2,31,39,61
Ellis,Governor,Chris Powell,LIB,230009,0,0,0,0,
Ellis,Governor,Kevin Stitt,REP,230009,2,17,50,69,
Ellis,Governor,Drew Edmondson,DEM,230009,3,2,14,19,
Ellis,Lieutenant Governor,Matt Pinnell,REP,230009,2,16,47,65,
Ellis,Lieutenant Governor,Anastasia Pittman,DEM,230009,3,2,11,16,
Ellis,Lieutenant Governor,Ivan Holmes,IND,230009,0,0,3,3,
Ellis,State Auditor,John Yeutter,LIB,230009,0,2,3,5,
Ellis,State Auditor,Cindy Byrd,REP,230009,5,15,58,78,
Ellis,Attorney General,Mike Hunter,REP,230009,4,14,53,71,
Ellis,Attorney General,Mark Myles,DEM,230009,0,4,10,14,
Ellis,State Treasurer,Randy Mcdaniel,REP,230009,5,16,52,73,
Ellis,State Treasurer,Charles De Coune,IND,230009,0,1,8,9,
Ellis,Superintendent of Public Instruction,Joy Hofmeister,REP,230009,4,10,46,60,
Ellis,Superintendent of Public Instruction,John Cox,DEM,230009,1,6,8,15,
Ellis,Superintendent of Public Instruction,Larry Huff,IND,230009,0,2,9,11,
Ellis,Commissioner of Labor,Leslie Osborn,REP,230009,5,12,51,68,
Ellis,Commissioner of Labor,Fred Dorrell,DEM,230009,0,3,6,9,
Ellis,Commissioner of Labor,Brandt Dismukes,IND,230009,0,1,5,6,
Ellis,Insurance Commissioner,Glen Mulready,REP,230009,2,15,49,66,
Ellis,Insurance Commissioner,Kimberly Fobbs,DEM,230009,3,3,12,18,
Ellis,Corporation Commissioner,Bob Anthony,REP,230009,4,15,47,66,
Ellis,Corporation Commissioner,Ashley Nicole Mccray,DEM,230009,1,3,10,14,
Ellis,Corporation Commissioner,Jackie Short,IND,230009,0,0,4,4,
Ellis,U.S. House,Frank Lucas,REP,230009,5,15,56,76,3
Ellis,U.S. House,Frankie Robbins,DEM,230009,0,3,8,11,3
Ellis,State House,Kenton Patzkowsky,REP,230009,4,12,43,59,61
Ellis,State House,Ashley Lehnert,DEM,230009,1,6,18,25,61
Garfield,Governor,Chris Powell,LIB,240101,2,1,14,17,
Garfield,Governor,Kevin Stitt,REP,240101,12,11,134,157,
Garfield,Governor,Drew Edmondson,DEM,240101,7,10,144,161,
Garfield,Lieutenant Governor,Matt Pinnell,REP,240101,13,11,158,182,
Garfield,Lieutenant Governor,Anastasia Pittman,DEM,240101,6,11,124,141,
Garfield,Lieutenant Governor,Ivan Holmes,IND,240101,2,1,9,12,
Garfield,State Auditor,John Yeutter,LIB,240101,3,10,95,108,
Garfield,State Auditor,Cindy Byrd,REP,240101,14,11,177,202,
Garfield,Attorney General,Mike Hunter,REP,240101,13,13,157,183,
Garfield,Attorney General,Mark Myles,DEM,240101,8,10,132,150,
Garfield,State Treasurer,Randy Mcdaniel,REP,240101,13,12,174,199,
Garfield,State Treasurer,Charles De Coune,IND,240101,4,9,100,113,
Garfield,Superintendent of Public Instruction,Joy Hofmeister,REP,240101,12,13,159,184,
Garfield,Superintendent of Public Instruction,John Cox,DEM,240101,7,9,105,121,
Garfield,Superintendent of Public Instruction,Larry Huff,IND,240101,2,1,26,29,
Garfield,Commissioner of Labor,Leslie Osborn,REP,240101,13,11,149,173,
Garfield,Commissioner of Labor,Fred Dorrell,DEM,240101,7,10,127,144,
Garfield,Commissioner of Labor,Brandt Dismukes,IND,240101,1,2,13,16,
Garfield,Insurance Commissioner,Glen Mulready,REP,240101,14,11,149,174,
Garfield,Insurance Commissioner,Kimberly Fobbs,DEM,240101,7,12,139,158,
Garfield,Corporation Commissioner,Bob Anthony,REP,240101,13,11,152,176,
Garfield,Corporation Commissioner,Ashley Nicole Mccray,DEM,240101,6,11,124,141,
Garfield,Corporation Commissioner,Jackie Short,IND,240101,2,1,13,16,
Garfield,U.S. House,Frank Lucas,REP,240101,13,12,160,185,3
Garfield,U.S. House,Frankie Robbins,DEM,240101,8,11,131,150,3
Garfield,State House,Chad Caldwell,REP,240101,11,9,138,158,40
Garfield,State House,Norman Grey,DEM,240101,10,13,153,176,40
Garfield,Governor,Chris Powell,LIB,240102,0,2,16,18,
Garfield,Governor,Kevin Stitt,REP,240102,5,20,152,177,
Garfield,Governor,Drew Edmondson,DEM,240102,10,14,163,187,
Garfield,Lieutenant Governor,Matt Pinnell,REP,240102,7,21,172,200,
Garfield,Lieutenant Governor,Anastasia Pittman,DEM,240102,8,12,129,149,
Garfield,Lieutenant Governor,Ivan Holmes,IND,240102,0,3,27,30,
Garfield,State Auditor,John Yeutter,LIB,240102,6,12,92,110,
Garfield,State Auditor,Cindy Byrd,REP,240102,9,22,216,247,
Garfield,Attorney General,Mike Hunter,REP,240102,7,22,178,207,
Garfield,Attorney General,Mark Myles,DEM,240102,7,14,148,169,
Garfield,State Treasurer,Randy Mcdaniel,REP,240102,9,24,195,228,
Garfield,State Treasurer,Charles De Coune,IND,240102,6,10,114,130,
Garfield,Superintendent of Public Instruction,Joy Hofmeister,REP,240102,8,17,185,210,
Garfield,Superintendent of Public Instruction,John Cox,DEM,240102,7,13,114,134,
Garfield,Superintendent of Public Instruction,Larry Huff,IND,240102,0,6,33,39,
Garfield,Commissioner of Labor,Leslie Osborn,REP,240102,9,21,181,211,
Garfield,Commissioner of Labor,Fred Dorrell,DEM,240102,6,12,120,138,
Garfield,Commissioner of Labor,Brandt Dismukes,IND,240102,0,3,26,29,
Garfield,Insurance Commissioner,Glen Mulready,REP,240102,8,22,177,207,
Garfield,Insurance Commissioner,Kimberly Fobbs,DEM,240102,7,14,154,175,
Garfield,Corporation Commissioner,Bob Anthony,REP,240102,9,19,169,197,
Garfield,Corporation Commissioner,Ashley Nicole Mccray,DEM,240102,6,12,126,144,
Garfield,Corporation Commissioner,Jackie Short,IND,240102,0,5,35,40,
Garfield,U.S. House,Frank Lucas,REP,240102,8,25,195,228,3
Garfield,U.S. House,Frankie Robbins,DEM,240102,7,12,137,156,3
Garfield,State House,Chad Caldwell,REP,240102,6,20,165,191,40
Garfield,State House,Norman Grey,DEM,240102,9,16,165,190,40
Garfield,Governor,Chris Powell,LIB,240103,0,0,41,41,
Garfield,Governor,Kevin Stitt,REP,240103,9,18,252,279,
Garfield,Governor,Drew Edmondson,DEM,240103,5,20,209,234,
Garfield,Lieutenant Governor,Matt Pinnell,REP,240103,9,18,296,323,
Garfield,Lieutenant Governor,Anastasia Pittman,DEM,240103,4,19,185,208,
Garfield,Lieutenant Governor,Ivan Holmes,IND,240103,0,1,19,20,
Garfield,State Auditor,John Yeutter,LIB,240103,3,13,143,159,
Garfield,State Auditor,Cindy Byrd,REP,240103,9,23,341,373,
Garfield,Attorney General,Mike Hunter,REP,240103,8,19,310,337,
Garfield,Attorney General,Mark Myles,DEM,240103,5,19,188,212,
Garfield,State Treasurer,Randy Mcdaniel,REP,240103,8,22,309,339,
Garfield,State Treasurer,Charles De Coune,IND,240103,5,14,170,189,
Garfield,Superintendent of Public Instruction,Joy Hofmeister,REP,240103,9,21,288,318,
Garfield,Superintendent of Public Instruction,John Cox,DEM,240103,4,15,163,182,
Garfield,Superintendent of Public Instruction,Larry Huff,IND,240103,0,2,51,53,
Garfield,Commissioner of Labor,Leslie Osborn,REP,240103,8,20,299,327,
Garfield,Commissioner of Labor,Fred Dorrell,DEM,240103,5,15,170,190,
Garfield,Commissioner of Labor,Brandt Dismukes,IND,240103,0,3,30,33,
Garfield,Insurance Commissioner,Glen Mulready,REP,240103,9,19,290,318,
Garfield,Insurance Commissioner,Kimberly Fobbs,DEM,240103,4,19,207,230,
Garfield,Corporation Commissioner,Bob Anthony,REP,240103,7,20,274,301,
Garfield,Corporation Commissioner,Ashley Nicole Mccray,DEM,240103,5,17,187,209,
Garfield,Corporation Commissioner,Jackie Short,IND,240103,1,1,37,39,
Garfield,U.S. House,Frank Lucas,REP,240103,9,18,317,344,3
Garfield,U.S. House,Frankie Robbins,DEM,240103,4,20,182,206,3
Garfield,State House,Chad Caldwell,REP,240103,8,19,272,299,40
Garfield,State House,Norman Grey,DEM,240103,5,19,227,251,40
Garfield,Governor,Chris Powell,LIB,240104,1,2,31,34,
Garfield,Governor,Kevin Stitt,REP,240104,18,20,243,281,
Garfield,Governor,Drew Edmondson,DEM,240104,10,20,241,271,
Garfield,Lieutenant Governor,Matt Pinnell,REP,240104,23,22,285,330,
Garfield,Lieutenant Governor,Anastasia Pittman,DEM,240104,4,14,195,213,
Garfield,Lieutenant Governor,Ivan Holmes,IND,240104,2,5,33,40,
Garfield,State Auditor,John Yeutter,LIB,240104,2,14,145,161,
Garfield,State Auditor,Cindy Byrd,REP,240104,25,27,335,387,
Garfield,Attorney General,Mike Hunter,REP,240104,23,21,314,358,
Garfield,Attorney General,Mark Myles,DEM,240104,6,20,199,225,
Garfield,State Treasurer,Randy Mcdaniel,REP,240104,24,25,309,358,
Garfield,State Treasurer,Charles De Coune,IND,240104,3,16,166,185,
Garfield,Superintendent of Public Instruction,Joy Hofmeister,REP,240104,24,24,289,337,
Garfield,Superintendent of Public Instruction,John Cox,DEM,240104,4,13,174,191,
Garfield,Superintendent of Public Instruction,Larry Huff,IND,240104,1,3,51,55,
Garfield,Commissioner of Labor,Leslie Osborn,REP,240104,20,20,283,323,
Garfield,Commissioner of Labor,Fred Dorrell,DEM,240104,8,16,192,216,
Garfield,Commissioner of Labor,Brandt Dismukes,IND,240104,1,4,37,42,
Garfield,Insurance Commissioner,Glen Mulready,REP,240104,23,20,286,329,
Garfield,Insurance Commissioner,Kimberly Fobbs,DEM,240104,6,21,220,247,
Garfield,Corporation Commissioner,Bob Anthony,REP,240104,23,21,275,319,
Garfield,Corporation Commissioner,Ashley Nicole Mccray,DEM,240104,6,17,187,210,
Garfield,Corporation Commissioner,Jackie Short,IND,240104,0,3,47,50,
Garfield,U.S. House,Frank Lucas,REP,240104,23,24,317,364,3
Garfield,U.S. House,Frankie Robbins,DEM,240104,6,17,195,218,3
Garfield,State House,Chad Caldwell,REP,240104,21,21,271,313,40
Garfield,State House,Norman Grey,DEM,240104,8,20,243,271,40
Garfield,Governor,Chris Powell,LIB,240105,0,2,23,25,
Garfield,Governor,Kevin Stitt,REP,240105,5,20,212,237,
Garfield,Governor,Drew Edmondson,DEM,240105,7,23,131,161,
Garfield,Lieutenant Governor,Matt Pinnell,REP,240105,5,24,236,265,
Garfield,Lieutenant Governor,Anastasia Pittman,DEM,240105,6,17,104,127,
Garfield,Lieutenant Governor,Ivan Holmes,IND,240105,0,3,22,25,
Garfield,State Auditor,John Yeutter,LIB,240105,4,12,95,111,
Garfield,State Auditor,Cindy Byrd,REP,240105,8,26,256,290,
Garfield,Attorney General,Mike Hunter,REP,240105,6,28,246,280,
Garfield,Attorney General,Mark Myles,DEM,240105,5,15,114,134,
Garfield,State Treasurer,Randy Mcdaniel,REP,240105,6,24,253,283,
Garfield,State Treasurer,Charles De Coune,IND,240105,5,13,99,117,
Garfield,Superintendent of Public Instruction,Joy Hofmeister,REP,240105,6,25,228,259,
Garfield,Superintendent of Public Instruction,John Cox,DEM,240105,6,14,98,118,
Garfield,Superintendent of Public Instruction,Larry Huff,IND,240105,0,5,38,43,
Garfield,Commissioner of Labor,Leslie Osborn,REP,240105,6,23,229,258,
Garfield,Commissioner of Labor,Fred Dorrell,DEM,240105,5,16,104,125,
Garfield,Commissioner of Labor,Brandt Dismukes,IND,240105,0,3,30,33,
Garfield,Insurance Commissioner,Glen Mulready,REP,240105,5,26,234,265,
Garfield,Insurance Commissioner,Kimberly Fobbs,DEM,240105,6,16,127,149,
Garfield,Corporation Commissioner,Bob Anthony,REP,240105,6,23,218,247,
Garfield,Corporation Commissioner,Ashley Nicole Mccray,DEM,240105,5,16,102,123,
Garfield,Corporation Commissioner,Jackie Short,IND,240105,1,6,42,49,
Garfield,U.S. House,Frank Lucas,REP,240105,5,29,247,281,3
Garfield,U.S. House,Frankie Robbins,DEM,240105,7,16,115,138,3
Garfield,State House,Denise Crosswhite Hader,REP,240105,5,20,223,248,41
Garfield,State House,Jennie Scott,DEM,240105,7,24,139,170,41
Garfield,Governor,Chris Powell,LIB,240106,0,0,24,24,
Garfield,Governor,Kevin Stitt,REP,240106,7,9,204,220,
Garfield,Governor,Drew Edmondson,DEM,240106,0,6,103,109,
Garfield,Lieutenant Governor,Matt Pinnell,REP,240106,7,10,250,267,
Garfield,Lieutenant Governor,Anastasia Pittman,DEM,240106,0,3,60,63,
Garfield,Lieutenant Governor,Ivan Holmes,IND,240106,0,2,16,18,
Garfield,State Auditor,John Yeutter,LIB,240106,1,4,43,48,
Garfield,State Auditor,Cindy Byrd,REP,240106,5,11,274,290,
Garfield,Attorney General,Mike Hunter,REP,240106,7,11,264,282,
Garfield,Attorney General,Mark Myles,DEM,240106,0,4,63,67,
Garfield,State Treasurer,Randy Mcdaniel,REP,240106,7,13,262,282,
Garfield,State Treasurer,Charles De Coune,IND,240106,0,2,54,56,
Garfield,Superintendent of Public Instruction,Joy Hofmeister,REP,240106,7,11,258,276,
Garfield,Superintendent of Public Instruction,John Cox,DEM,240106,0,2,48,50,
Garfield,Superintendent of Public Instruction,Larry Huff,IND,240106,0,2,23,25,
Garfield,Commissioner of Labor,Leslie Osborn,REP,240106,7,11,247,265,
Garfield,Commissioner of Labor,Fred Dorrell,DEM,240106,0,2,60,62,
Garfield,Commissioner of Labor,Brandt Dismukes,IND,240106,0,2,19,21,
Garfield,Insurance Commissioner,Glen Mulready,REP,240106,6,10,255,271,
Garfield,Insurance Commissioner,Kimberly Fobbs,DEM,240106,0,4,72,76,
Garfield,Corporation Commissioner,Bob Anthony,REP,240106,7,12,231,250,
Garfield,Corporation Commissioner,Ashley Nicole Mccray,DEM,240106,0,1,72,73,
Garfield,Corporation Commissioner,Jackie Short,IND,240106,0,2,23,25,
Garfield,U.S. House,Frank Lucas,REP,240106,7,13,267,287,3
Garfield,U.S. House,Frankie Robbins,DEM,240106,0,2,62,64,3
Garfield,Governor,Chris Powell,LIB,240107,0,0,2,2,
Garfield,Governor,Kevin Stitt,REP,240107,3,3,51,57,
Garfield,Governor,Drew Edmondson,DEM,240107,2,3,17,22,
Garfield,Lieutenant Governor,Matt Pinnell,REP,240107,3,6,55,64,
Garfield,Lieutenant Governor,Anastasia Pittman,DEM,240107,2,0,13,15,
Garfield,Lieutenant Governor,Ivan Holmes,IND,240107,0,0,2,2,
Garfield,State Auditor,John Yeutter,LIB,240107,0,0,8,8,
Garfield,State Auditor,Cindy Byrd,REP,240107,3,6,59,68,
Garfield,Attorney General,Mike Hunter,REP,240107,4,6,58,68,
Garfield,Attorney General,Mark Myles,DEM,240107,1,0,12,13,
Garfield,State Treasurer,Randy Mcdaniel,REP,240107,3,4,60,67,
Garfield,State Treasurer,Charles De Coune,IND,240107,0,1,7,8,
Garfield,Superintendent of Public Instruction,Joy Hofmeister,REP,240107,3,5,51,59,
Garfield,Superintendent of Public Instruction,John Cox,DEM,240107,1,1,15,17,
Garfield,Superintendent of Public Instruction,Larry Huff,IND,240107,0,0,4,4,
Garfield,Commissioner of Labor,Leslie Osborn,REP,240107,3,5,57,65,
Garfield,Commissioner of Labor,Fred Dorrell,DEM,240107,1,0,13,14,
Garfield,Commissioner of Labor,Brandt Dismukes,IND,240107,0,0,0,0,
Garfield,Insurance Commissioner,Glen Mulready,REP,240107,2,5,53,60,
Garfield,Insurance Commissioner,Kimberly Fobbs,DEM,240107,2,0,17,19,
Garfield,Corporation Commissioner,Bob Anthony,REP,240107,3,6,53,62,
Garfield,Corporation Commissioner,Ashley Nicole Mccray,DEM,240107,1,0,14,15,
Garfield,Corporation Commissioner,Jackie Short,IND,240107,0,0,3,3,
Garfield,U.S. House,Frank Lucas,REP,240107,3,5,59,67,3
Garfield,U.S. House,Frankie Robbins,DEM,240107,1,1,11,13,3
Garfield,State House,Denise Crosswhite Hader,REP,240107,3,3,53,59,41
Garfield,State House,Jennie Scott,DEM,240107,1,3,17,21,41
Garfield,Governor,Chris Powell,LIB,240108,0,0,3,3,
Garfield,Governor,Kevin Stitt,REP,240108,2,3,66,71,
Garfield,Governor,Drew Edmondson,DEM,240108,4,1,21,26,
Garfield,Lieutenant Governor,Matt Pinnell,REP,240108,2,4,74,80,
Garfield,Lieutenant Governor,Anastasia Pittman,DEM,240108,4,0,15,19,
Garfield,Lieutenant Governor,Ivan Holmes,IND,240108,0,0,2,2,
Garfield,State Auditor,John Yeutter,LIB,240108,4,0,10,14,
Garfield,State Auditor,Cindy Byrd,REP,240108,2,4,77,83,
Garfield,Attorney General,Mike Hunter,REP,240108,2,3,73,78,
Garfield,Attorney General,Mark Myles,DEM,240108,4,1,17,22,
Garfield,State Treasurer,Randy Mcdaniel,REP,240108,1,3,72,76,
Garfield,State Treasurer,Charles De Coune,IND,240108,5,1,14,20,
Garfield,Superintendent of Public Instruction,Joy Hofmeister,REP,240108,1,3,71,75,
Garfield,Superintendent of Public Instruction,John Cox,DEM,240108,4,1,15,20,
Garfield,Superintendent of Public Instruction,Larry Huff,IND,240108,1,0,5,6,
Garfield,Commissioner of Labor,Leslie Osborn,REP,240108,2,3,74,79,
Garfield,Commissioner of Labor,Fred Dorrell,DEM,240108,4,1,14,19,
Garfield,Commissioner of Labor,Brandt Dismukes,IND,240108,0,0,3,3,
Garfield,Insurance Commissioner,Glen Mulready,REP,240108,2,3,68,73,
Garfield,Insurance Commissioner,Kimberly Fobbs,DEM,240108,4,1,23,28,
Garfield,Corporation Commissioner,Bob Anthony,REP,240108,1,3,69,73,
Garfield,Corporation Commissioner,Ashley Nicole Mccray,DEM,240108,4,1,19,24,
Garfield,Corporation Commissioner,Jackie Short,IND,240108,1,0,3,4,
Garfield,U.S. House,Frank Lucas,REP,240108,2,3,74,79,3
Garfield,U.S. House,Frankie Robbins,DEM,240108,4,1,17,22,3
Garfield,Governor,Chris Powell,LIB,240109,0,0,12,12,
Garfield,Governor,Kevin Stitt,REP,240109,4,8,150,162,
Garfield,Governor,Drew Edmondson,DEM,240109,6,1,52,59,
Garfield,Lieutenant Governor,Matt Pinnell,REP,240109,6,9,171,186,
Garfield,Lieutenant Governor,Anastasia Pittman,DEM,240109,2,0,31,33,
Garfield,Lieutenant Governor,Ivan Holmes,IND,240109,1,0,9,10,
Garfield,State Auditor,John Yeutter,LIB,240109,2,0,26,28,
Garfield,State Auditor,Cindy Byrd,REP,240109,7,9,177,193,
Garfield,Attorney General,Mike Hunter,REP,240109,6,9,172,187,
Garfield,Attorney General,Mark Myles,DEM,240109,4,0,40,44,
Garfield,State Treasurer,Randy Mcdaniel,REP,240109,7,8,178,193,
Garfield,State Treasurer,Charles De Coune,IND,240109,2,1,23,26,
Garfield,Superintendent of Public Instruction,Joy Hofmeister,REP,240109,7,8,167,182,
Garfield,Superintendent of Public Instruction,John Cox,DEM,240109,3,1,31,35,
Garfield,Superintendent of Public Instruction,Larry Huff,IND,240109,0,0,14,14,
Garfield,Commissioner of Labor,Leslie Osborn,REP,240109,7,9,165,181,
Garfield,Commissioner of Labor,Fred Dorrell,DEM,240109,1,0,32,33,
Garfield,Commissioner of Labor,Brandt Dismukes,IND,240109,2,0,10,12,
Garfield,Insurance Commissioner,Glen Mulready,REP,240109,6,9,169,184,
Garfield,Insurance Commissioner,Kimberly Fobbs,DEM,240109,4,0,39,43,
Garfield,Corporation Commissioner,Bob Anthony,REP,240109,5,7,158,170,
Garfield,Corporation Commissioner,Ashley Nicole Mccray,DEM,240109,5,2,41,48,
Garfield,Corporation Commissioner,Jackie Short,IND,240109,0,0,11,11,
Garfield,U.S. House,Frank Lucas,REP,240109,6,9,174,189,3
Garfield,U.S. House,Frankie Robbins,DEM,240109,4,0,39,43,3
Garfield,Governor,Chris Powell,LIB,240110,2,3,15,20,
Garfield,Governor,Kevin Stitt,REP,240110,10,51,264,325,
Garfield,Governor,Drew Edmondson,DEM,240110,12,29,163,204,
Garfield,Lieutenant Governor,Matt Pinnell,REP,240110,12,57,305,374,
Garfield,Lieutenant Governor,Anastasia Pittman,DEM,240110,12,24,119,155,
Garfield,Lieutenant Governor,Ivan Holmes,IND,240110,0,2,17,19,
Garfield,State Auditor,John Yeutter,LIB,240110,5,13,69,87,
Garfield,State Auditor,Cindy Byrd,REP,240110,14,68,342,424,
Garfield,Attorney General,Mike Hunter,REP,240110,10,58,325,393,
Garfield,Attorney General,Mark Myles,DEM,240110,14,25,114,153,
Garfield,State Treasurer,Randy Mcdaniel,REP,240110,10,64,321,395,
Garfield,State Treasurer,Charles De Coune,IND,240110,9,17,92,118,
Garfield,Superintendent of Public Instruction,Joy Hofmeister,REP,240110,11,59,294,364,
Garfield,Superintendent of Public Instruction,John Cox,DEM,240110,10,21,106,137,
Garfield,Superintendent of Public Instruction,Larry Huff,IND,240110,3,3,37,43,
Garfield,Commissioner of Labor,Leslie Osborn,REP,240110,13,54,301,368,
Garfield,Commissioner of Labor,Fred Dorrell,DEM,240110,10,24,116,150,
Garfield,Commissioner of Labor,Brandt Dismukes,IND,240110,0,5,19,24,
Garfield,Insurance Commissioner,Glen Mulready,REP,240110,12,59,298,369,
Garfield,Insurance Commissioner,Kimberly Fobbs,DEM,240110,11,23,138,172,
Garfield,Corporation Commissioner,Bob Anthony,REP,240110,10,55,283,348,
Garfield,Corporation Commissioner,Ashley Nicole Mccray,DEM,240110,10,22,126,158,
Garfield,Corporation Commissioner,Jackie Short,IND,240110,3,6,29,38,
Garfield,U.S. House,Frank Lucas,REP,240110,12,58,323,393,3
Garfield,U.S. House,Frankie Robbins,DEM,240110,11,25,117,153,3
Garfield,State House,Denise Crosswhite Hader,REP,240110,12,44,264,320,41
Garfield,State House,Jennie Scott,DEM,240110,12,39,175,226,41
Garfield,Governor,Chris Powell,LIB,240201,1,9,41,51,
Garfield,Governor,Kevin Stitt,REP,240201,28,78,445,551,
Garfield,Governor,Drew Edmondson,DEM,240201,30,94,360,484,
Garfield,Lieutenant Governor,Matt Pinnell,REP,240201,36,97,538,671,
Garfield,Lieutenant Governor,Anastasia Pittman,DEM,240201,20,70,262,352,
Garfield,Lieutenant Governor,Ivan Holmes,IND,240201,3,12,43,58,
Garfield,State Auditor,John Yeutter,LIB,240201,15,36,191,242,
Garfield,State Auditor,Cindy Byrd,REP,240201,41,130,601,772,
Garfield,Attorney General,Mike Hunter,REP,240201,37,104,555,696,
Garfield,Attorney General,Mark Myles,DEM,240201,22,75,285,382,
Garfield,State Treasurer,Randy Mcdaniel,REP,240201,37,103,580,720,
Garfield,State Treasurer,Charles De Coune,IND,240201,18,60,212,290,
Garfield,Superintendent of Public Instruction,Joy Hofmeister,REP,240201,36,111,538,685,
Garfield,Superintendent of Public Instruction,John Cox,DEM,240201,16,54,226,296,
Garfield,Superintendent of Public Instruction,Larry Huff,IND,240201,7,15,80,102,
Garfield,Commissioner of Labor,Leslie Osborn,REP,240201,36,104,534,674,
Garfield,Commissioner of Labor,Fred Dorrell,DEM,240201,17,65,245,327,
Garfield,Commissioner of Labor,Brandt Dismukes,IND,240201,6,10,55,71,
Garfield,Insurance Commissioner,Glen Mulready,REP,240201,34,102,562,698,
Garfield,Insurance Commissioner,Kimberly Fobbs,DEM,240201,25,76,274,375,
Garfield,Corporation Commissioner,Bob Anthony,REP,240201,36,95,527,658,
Garfield,Corporation Commissioner,Ashley Nicole Mccray,DEM,240201,19,71,253,343,
Garfield,Corporation Commissioner,Jackie Short,IND,240201,4,14,60,78,
Garfield,U.S. House,Frank Lucas,REP,240201,35,99,585,719,3
Garfield,U.S. House,Frankie Robbins,DEM,240201,23,81,258,362,3
Garfield,State House,Chad Caldwell,REP,240201,28,76,463,567,40
Garfield,State House,Norman Grey,DEM,240201,29,105,380,514,40
Garfield,Governor,Chris Powell,LIB,240202,3,2,37,42,
Garfield,Governor,Kevin Stitt,REP,240202,46,81,493,620,
Garfield,Governor,Drew Edmondson,DEM,240202,23,51,286,360,
Garfield,Lieutenant Governor,Matt Pinnell,REP,240202,52,93,557,702,
Garfield,Lieutenant Governor,Anastasia Pittman,DEM,240202,17,38,222,277,
Garfield,Lieutenant Governor,Ivan Holmes,IND,240202,2,3,30,35,
Garfield,State Auditor,John Yeutter,LIB,240202,9,20,158,187,
Garfield,State Auditor,Cindy Byrd,REP,240202,57,104,606,767,
Garfield,Attorney General,Mike Hunter,REP,240202,52,100,569,721,
Garfield,Attorney General,Mark Myles,DEM,240202,19,33,236,288,
Garfield,State Treasurer,Randy Mcdaniel,REP,240202,53,100,572,725,
Garfield,State Treasurer,Charles De Coune,IND,240202,13,24,188,225,
Garfield,Superintendent of Public Instruction,Joy Hofmeister,REP,240202,55,96,542,693,
Garfield,Superintendent of Public Instruction,John Cox,DEM,240202,16,27,198,241,
Garfield,Superintendent of Public Instruction,Larry Huff,IND,240202,0,8,69,77,
Garfield,Commissioner of Labor,Leslie Osborn,REP,240202,53,94,545,692,
Garfield,Commissioner of Labor,Fred Dorrell,DEM,240202,16,37,209,262,
Garfield,Commissioner of Labor,Brandt Dismukes,IND,240202,2,1,46,49,
Garfield,Insurance Commissioner,Glen Mulready,REP,240202,50,90,555,695,
Garfield,Insurance Commissioner,Kimberly Fobbs,DEM,240202,20,43,242,305,
Garfield,Corporation Commissioner,Bob Anthony,REP,240202,54,87,528,669,
Garfield,Corporation Commissioner,Ashley Nicole Mccray,DEM,240202,14,39,215,268,
Garfield,Corporation Commissioner,Jackie Short,IND,240202,3,7,57,67,
Garfield,U.S. House,Frank Lucas,REP,240202,53,100,583,736,3
Garfield,U.S. House,Frankie Robbins,DEM,240202,18,34,226,278,3
Garfield,State House,Chad Caldwell,REP,240202,47,76,491,614,40
Garfield,State House,Norman Grey,DEM,240202,23,57,321,401,40
Garfield,Governor,Chris Powell,LIB,240203,3,3,27,33,
Garfield,Governor,Kevin Stitt,REP,240203,8,22,222,252,
Garfield,Governor,Drew Edmondson,DEM,240203,7,14,140,161,
Garfield,Lieutenant Governor,Matt Pinnell,REP,240203,9,23,243,275,
Garfield,Lieutenant Governor,Anastasia Pittman,DEM,240203,6,12,119,137,
Garfield,Lieutenant Governor,Ivan Holmes,IND,240203,2,4,24,30,
Garfield,State Auditor,John Yeutter,LIB,240203,6,13,85,104,
Garfield,State Auditor,Cindy Byrd,REP,240203,11,24,275,310,
Garfield,Attorney General,Mike Hunter,REP,240203,10,25,260,295,
Garfield,Attorney General,Mark Myles,DEM,240203,8,14,123,145,
Garfield,State Treasurer,Randy Mcdaniel,REP,240203,13,28,247,288,
Garfield,State Treasurer,Charles De Coune,IND,240203,4,9,113,126,
Garfield,Superintendent of Public Instruction,Joy Hofmeister,REP,240203,11,22,232,265,
Garfield,Superintendent of Public Instruction,John Cox,DEM,240203,6,13,101,120,
Garfield,Superintendent of Public Instruction,Larry Huff,IND,240203,1,4,54,59,
Garfield,Commissioner of Labor,Leslie Osborn,REP,240203,9,23,245,277,
Garfield,Commissioner of Labor,Fred Dorrell,DEM,240203,7,13,106,126,
Garfield,Commissioner of Labor,Brandt Dismukes,IND,240203,1,3,30,34,
Garfield,Insurance Commissioner,Glen Mulready,REP,240203,11,26,246,283,
Garfield,Insurance Commissioner,Kimberly Fobbs,DEM,240203,6,13,137,156,
Garfield,Corporation Commissioner,Bob Anthony,REP,240203,10,21,228,259,
Garfield,Corporation Commissioner,Ashley Nicole Mccray,DEM,240203,6,14,122,142,
Garfield,Corporation Commissioner,Jackie Short,IND,240203,2,4,33,39,
Garfield,U.S. House,Frank Lucas,REP,240203,12,24,259,295,3
Garfield,U.S. House,Frankie Robbins,DEM,240203,6,15,127,148,3
Garfield,State House,Chad Caldwell,REP,240203,11,20,228,259,40
Garfield,State House,Norman Grey,DEM,240203,7,19,161,187,40
Garfield,Governor,Chris Powell,LIB,240204,2,6,48,56,
Garfield,Governor,Kevin Stitt,REP,240204,33,103,670,806,
Garfield,Governor,Drew Edmondson,DEM,240204,12,56,336,404,
Garfield,Lieutenant Governor,Matt Pinnell,REP,240204,37,117,756,910,
Garfield,Lieutenant Governor,Anastasia Pittman,DEM,240204,8,46,250,304,
Garfield,Lieutenant Governor,Ivan Holmes,IND,240204,2,4,45,51,
Garfield,State Auditor,John Yeutter,LIB,240204,8,29,175,212,
Garfield,State Auditor,Cindy Byrd,REP,240204,36,130,841,1007,
Garfield,Attorney General,Mike Hunter,REP,240204,36,118,762,916,
Garfield,Attorney General,Mark Myles,DEM,240204,10,49,285,344,
Garfield,State Treasurer,Randy Mcdaniel,REP,240204,40,126,786,952,
Garfield,State Treasurer,Charles De Coune,IND,240204,5,32,236,273,
Garfield,Superintendent of Public Instruction,Joy Hofmeister,REP,240204,37,123,747,907,
Garfield,Superintendent of Public Instruction,John Cox,DEM,240204,8,28,219,255,
Garfield,Superintendent of Public Instruction,Larry Huff,IND,240204,2,14,82,98,
Garfield,Commissioner of Labor,Leslie Osborn,REP,240204,40,122,747,909,
Garfield,Commissioner of Labor,Fred Dorrell,DEM,240204,5,40,235,280,
Garfield,Commissioner of Labor,Brandt Dismukes,IND,240204,2,3,59,64,
Garfield,Insurance Commissioner,Glen Mulready,REP,240204,36,121,751,908,
Garfield,Insurance Commissioner,Kimberly Fobbs,DEM,240204,10,42,289,341,
Garfield,Corporation Commissioner,Bob Anthony,REP,240204,35,112,707,854,
Garfield,Corporation Commissioner,Ashley Nicole Mccray,DEM,240204,9,42,264,315,
Garfield,Corporation Commissioner,Jackie Short,IND,240204,2,11,77,90,
Garfield,U.S. House,Frank Lucas,REP,240204,35,121,796,952,3
Garfield,U.S. House,Frankie Robbins,DEM,240204,11,46,254,311,3
Garfield,State House,Chad Caldwell,REP,240204,33,97,634,764,40
Garfield,State House,Norman Grey,DEM,240204,13,70,414,497,40
Garfield,Governor,Chris Powell,LIB,240206,0,2,37,39,
Garfield,Governor,Kevin Stitt,REP,240206,4,22,335,361,
Garfield,Governor,Drew Edmondson,DEM,240206,9,22,174,205,
Garfield,Lieutenant Governor,Matt Pinnell,REP,240206,6,25,378,409,
Garfield,Lieutenant Governor,Anastasia Pittman,DEM,240206,7,18,139,164,
Garfield,Lieutenant Governor,Ivan Holmes,IND,240206,0,3,27,30,
Garfield,State Auditor,John Yeutter,LIB,240206,6,12,76,94,
Garfield,State Auditor,Cindy Byrd,REP,240206,7,28,440,475,
Garfield,Attorney General,Mike Hunter,REP,240206,5,25,406,436,
Garfield,Attorney General,Mark Myles,DEM,240206,8,21,136,165,
Garfield,State Treasurer,Randy Mcdaniel,REP,240206,6,25,409,440,
Garfield,State Treasurer,Charles De Coune,IND,240206,7,16,110,133,
Garfield,Superintendent of Public Instruction,Joy Hofmeister,REP,240206,4,26,381,411,
Garfield,Superintendent of Public Instruction,John Cox,DEM,240206,9,16,115,140,
Garfield,Superintendent of Public Instruction,Larry Huff,IND,240206,0,4,47,51,
Garfield,Commissioner of Labor,Leslie Osborn,REP,240206,6,26,388,420,
Garfield,Commissioner of Labor,Fred Dorrell,DEM,240206,7,18,118,143,
Garfield,Commissioner of Labor,Brandt Dismukes,IND,240206,0,2,34,36,
Garfield,Insurance Commissioner,Glen Mulready,REP,240206,5,27,388,420,
Garfield,Insurance Commissioner,Kimberly Fobbs,DEM,240206,8,19,152,179,
Garfield,Corporation Commissioner,Bob Anthony,REP,240206,5,25,366,396,
Garfield,Corporation Commissioner,Ashley Nicole Mccray,DEM,240206,8,18,138,164,
Garfield,Corporation Commissioner,Jackie Short,IND,240206,0,3,37,40,
Garfield,U.S. House,Frank Lucas,REP,240206,6,27,416,449,3
Garfield,U.S. House,Frankie Robbins,DEM,240206,7,19,125,151,3
Garfield,State House,Chad Caldwell,REP,240206,5,24,334,363,40
Garfield,State House,Norman Grey,DEM,240206,8,22,212,242,40
Garfield,Governor,Chris Powell,LIB,240207,2,1,22,25,
Garfield,Governor,Kevin Stitt,REP,240207,8,23,375,406,
Garfield,Governor,Drew Edmondson,DEM,240207,11,11,121,143,
Garfield,Lieutenant Governor,Matt Pinnell,REP,240207,10,24,420,454,
Garfield,Lieutenant Governor,Anastasia Pittman,DEM,240207,9,9,72,90,
Garfield,Lieutenant Governor,Ivan Holmes,IND,240207,2,2,24,28,
Garfield,State Auditor,John Yeutter,LIB,240207,6,5,51,62,
Garfield,State Auditor,Cindy Byrd,REP,240207,12,28,452,492,
Garfield,Attorney General,Mike Hunter,REP,240207,14,27,438,479,
Garfield,Attorney General,Mark Myles,DEM,240207,7,8,76,91,
Garfield,State Treasurer,Randy Mcdaniel,REP,240207,14,28,431,473,
Garfield,State Treasurer,Charles De Coune,IND,240207,5,5,68,78,
Garfield,Superintendent of Public Instruction,Joy Hofmeister,REP,240207,11,27,404,442,
Garfield,Superintendent of Public Instruction,John Cox,DEM,240207,6,5,63,74,
Garfield,Superintendent of Public Instruction,Larry Huff,IND,240207,4,3,48,55,
Garfield,Commissioner of Labor,Leslie Osborn,REP,240207,13,26,422,461,
Garfield,Commissioner of Labor,Fred Dorrell,DEM,240207,6,7,64,77,
Garfield,Commissioner of Labor,Brandt Dismukes,IND,240207,2,2,26,30,
Garfield,Insurance Commissioner,Glen Mulready,REP,240207,11,28,421,460,
Garfield,Insurance Commissioner,Kimberly Fobbs,DEM,240207,10,7,90,107,
Garfield,Corporation Commissioner,Bob Anthony,REP,240207,10,24,384,418,
Garfield,Corporation Commissioner,Ashley Nicole Mccray,DEM,240207,7,10,88,105,
Garfield,Corporation Commissioner,Jackie Short,IND,240207,4,1,39,44,
Garfield,U.S. House,Frank Lucas,REP,240207,12,28,436,476,3
Garfield,U.S. House,Frankie Robbins,DEM,240207,9,7,79,95,3
Garfield,State House,Chad Caldwell,REP,240207,8,20,361,389,40
Garfield,State House,Norman Grey,DEM,240207,13,15,151,179,40
Garfield,Governor,Chris Powell,LIB,240208,0,0,2,2,
Garfield,Governor,Kevin Stitt,REP,240208,2,6,84,92,
Garfield,Governor,Drew Edmondson,DEM,240208,0,1,16,17,
Garfield,Lieutenant Governor,Matt Pinnell,REP,240208,2,6,89,97,
Garfield,Lieutenant Governor,Anastasia Pittman,DEM,240208,0,0,11,11,
Garfield,Lieutenant Governor,Ivan Holmes,IND,240208,0,1,1,2,
Garfield,State Auditor,John Yeutter,LIB,240208,0,1,12,13,
Garfield,State Auditor,Cindy Byrd,REP,240208,2,6,87,95,
Garfield,Attorney General,Mike Hunter,REP,240208,1,6,91,98,
Garfield,Attorney General,Mark Myles,DEM,240208,1,1,10,12,
Garfield,State Treasurer,Randy Mcdaniel,REP,240208,2,6,86,94,
Garfield,State Treasurer,Charles De Coune,IND,240208,0,1,13,14,
Garfield,Superintendent of Public Instruction,Joy Hofmeister,REP,240208,1,6,83,90,
Garfield,Superintendent of Public Instruction,John Cox,DEM,240208,1,0,11,12,
Garfield,Superintendent of Public Instruction,Larry Huff,IND,240208,0,1,6,7,
Garfield,Commissioner of Labor,Leslie Osborn,REP,240208,1,6,84,91,
Garfield,Commissioner of Labor,Fred Dorrell,DEM,240208,0,1,12,13,
Garfield,Commissioner of Labor,Brandt Dismukes,IND,240208,1,0,3,4,
Garfield,Insurance Commissioner,Glen Mulready,REP,240208,1,5,87,93,
Garfield,Insurance Commissioner,Kimberly Fobbs,DEM,240208,1,2,13,16,
Garfield,Corporation Commissioner,Bob Anthony,REP,240208,2,6,77,85,
Garfield,Corporation Commissioner,Ashley Nicole Mccray,DEM,240208,0,1,15,16,
Garfield,Corporation Commissioner,Jackie Short,IND,240208,0,0,6,6,
Garfield,U.S. House,Frank Lucas,REP,240208,2,6,89,97,3
Garfield,U.S. House,Frankie Robbins,DEM,240208,0,1,11,12,3
Garfield,State House,Denise Crosswhite Hader,REP,240208,2,4,85,91,41
Garfield,State House,Jennie Scott,DEM,240208,0,3,16,19,41
Garfield,Governor,Chris Powell,LIB,240210,0,0,17,17,
Garfield,Governor,Kevin Stitt,REP,240210,1,5,203,209,
Garfield,Governor,Drew Edmondson,DEM,240210,1,3,71,75,
Garfield,Lieutenant Governor,Matt Pinnell,REP,240210,0,4,238,242,
Garfield,Lieutenant Governor,Anastasia Pittman,DEM,240210,1,3,45,49,
Garfield,Lieutenant Governor,Ivan Holmes,IND,240210,1,1,8,10,
Garfield,State Auditor,John Yeutter,LIB,240210,2,3,28,33,
Garfield,State Auditor,Cindy Byrd,REP,240210,0,4,255,259,
Garfield,Attorney General,Mike Hunter,REP,240210,1,5,237,243,
Garfield,Attorney General,Mark Myles,DEM,240210,1,3,51,55,
Garfield,State Treasurer,Randy Mcdaniel,REP,240210,0,5,247,252,
Garfield,State Treasurer,Charles De Coune,IND,240210,2,3,34,39,
Garfield,Superintendent of Public Instruction,Joy Hofmeister,REP,240210,2,5,206,213,
Garfield,Superintendent of Public Instruction,John Cox,DEM,240210,0,3,44,47,
Garfield,Superintendent of Public Instruction,Larry Huff,IND,240210,0,0,39,39,
Garfield,Commissioner of Labor,Leslie Osborn,REP,240210,1,5,229,235,
Garfield,Commissioner of Labor,Fred Dorrell,DEM,240210,1,2,49,52,
Garfield,Commissioner of Labor,Brandt Dismukes,IND,240210,0,1,12,13,
Garfield,Insurance Commissioner,Glen Mulready,REP,240210,1,5,228,234,
Garfield,Insurance Commissioner,Kimberly Fobbs,DEM,240210,1,3,60,64,
Garfield,Corporation Commissioner,Bob Anthony,REP,240210,0,5,202,207,
Garfield,Corporation Commissioner,Ashley Nicole Mccray,DEM,240210,1,2,65,68,
Garfield,Corporation Commissioner,Jackie Short,IND,240210,1,1,23,25,
Garfield,U.S. House,Frank Lucas,REP,240210,0,5,244,249,3
Garfield,U.S. House,Frankie Robbins,DEM,240210,2,3,47,52,3
Garfield,Governor,Chris Powell,LIB,240211,0,1,10,11,
Garfield,Governor,Kevin Stitt,REP,240211,17,35,352,404,
Garfield,Governor,Drew Edmondson,DEM,240211,6,7,96,109,
Garfield,Lieutenant Governor,Matt Pinnell,REP,240211,18,34,398,450,
Garfield,Lieutenant Governor,Anastasia Pittman,DEM,240211,4,9,39,52,
Garfield,Lieutenant Governor,Ivan Holmes,IND,240211,0,0,18,18,
Garfield,State Auditor,John Yeutter,LIB,240211,4,4,51,59,
Garfield,State Auditor,Cindy Byrd,REP,240211,18,38,399,455,
Garfield,Attorney General,Mike Hunter,REP,240211,19,35,399,453,
Garfield,Attorney General,Mark Myles,DEM,240211,4,8,55,67,
Garfield,State Treasurer,Randy Mcdaniel,REP,240211,17,36,401,454,
Garfield,State Treasurer,Charles De Coune,IND,240211,5,6,49,60,
Garfield,Superintendent of Public Instruction,Joy Hofmeister,REP,240211,19,34,375,428,
Garfield,Superintendent of Public Instruction,John Cox,DEM,240211,3,4,47,54,
Garfield,Superintendent of Public Instruction,Larry Huff,IND,240211,1,5,33,39,
Garfield,Commissioner of Labor,Leslie Osborn,REP,240211,16,33,380,429,
Garfield,Commissioner of Labor,Fred Dorrell,DEM,240211,5,6,47,58,
Garfield,Commissioner of Labor,Brandt Dismukes,IND,240211,2,4,24,30,
Garfield,Insurance Commissioner,Glen Mulready,REP,240211,18,35,400,453,
Garfield,Insurance Commissioner,Kimberly Fobbs,DEM,240211,4,7,51,62,
Garfield,Corporation Commissioner,Bob Anthony,REP,240211,16,34,374,424,
Garfield,Corporation Commissioner,Ashley Nicole Mccray,DEM,240211,4,7,54,65,
Garfield,Corporation Commissioner,Jackie Short,IND,240211,3,2,27,32,
Garfield,U.S. House,Frank Lucas,REP,240211,20,33,409,462,3
Garfield,U.S. House,Frankie Robbins,DEM,240211,3,10,46,59,3
Garfield,Governor,Chris Powell,LIB,240212,2,0,18,20,
Garfield,Governor,Kevin Stitt,REP,240212,7,12,217,236,
Garfield,Governor,Drew Edmondson,DEM,240212,6,2,60,68,
Garfield,Lieutenant Governor,Matt Pinnell,REP,240212,9,12,251,272,
Garfield,Lieutenant Governor,Anastasia Pittman,DEM,240212,6,1,36,43,
Garfield,Lieutenant Governor,Ivan Holmes,IND,240212,0,0,7,7,
Garfield,State Auditor,John Yeutter,LIB,240212,2,2,37,41,
Garfield,State Auditor,Cindy Byrd,REP,240212,11,10,248,269,
Garfield,Attorney General,Mike Hunter,REP,240212,11,10,259,280,
Garfield,Attorney General,Mark Myles,DEM,240212,4,2,34,40,
Garfield,State Treasurer,Randy Mcdaniel,REP,240212,9,11,249,269,
Garfield,State Treasurer,Charles De Coune,IND,240212,4,1,34,39,
Garfield,Superintendent of Public Instruction,Joy Hofmeister,REP,240212,6,12,231,249,
Garfield,Superintendent of Public Instruction,John Cox,DEM,240212,6,2,41,49,
Garfield,Superintendent of Public Instruction,Larry Huff,IND,240212,2,0,21,23,
Garfield,Commissioner of Labor,Leslie Osborn,REP,240212,9,10,236,255,
Garfield,Commissioner of Labor,Fred Dorrell,DEM,240212,4,2,40,46,
Garfield,Commissioner of Labor,Brandt Dismukes,IND,240212,2,0,16,18,
Garfield,Insurance Commissioner,Glen Mulready,REP,240212,10,9,245,264,
Garfield,Insurance Commissioner,Kimberly Fobbs,DEM,240212,5,2,47,54,
Garfield,Corporation Commissioner,Bob Anthony,REP,240212,9,10,224,243,
Garfield,Corporation Commissioner,Ashley Nicole Mccray,DEM,240212,4,2,46,52,
Garfield,Corporation Commissioner,Jackie Short,IND,240212,2,0,23,25,
Garfield,U.S. House,Frank Lucas,REP,240212,11,12,247,270,3
Garfield,U.S. House,Frankie Robbins,DEM,240212,4,2,47,53,3
Garfield,Governor,Chris Powell,LIB,240301,1,2,17,20,
Garfield,Governor,Kevin Stitt,REP,240301,7,49,270,326,
Garfield,Governor,Drew Edmondson,DEM,240301,10,19,145,174,
Garfield,Lieutenant Governor,Matt Pinnell,REP,240301,9,54,322,385,
Garfield,Lieutenant Governor,Anastasia Pittman,DEM,240301,7,16,97,120,
Garfield,Lieutenant Governor,Ivan Holmes,IND,240301,2,0,12,14,
Garfield,State Auditor,John Yeutter,LIB,240301,2,11,65,78,
Garfield,State Auditor,Cindy Byrd,REP,240301,11,56,348,415,
Garfield,Attorney General,Mike Hunter,REP,240301,10,53,329,392,
Garfield,Attorney General,Mark Myles,DEM,240301,7,16,99,122,
Garfield,State Treasurer,Randy Mcdaniel,REP,240301,11,54,329,394,
Garfield,State Treasurer,Charles De Coune,IND,240301,5,13,80,98,
Garfield,Superintendent of Public Instruction,Joy Hofmeister,REP,240301,10,49,298,357,
Garfield,Superintendent of Public Instruction,John Cox,DEM,240301,6,15,89,110,
Garfield,Superintendent of Public Instruction,Larry Huff,IND,240301,2,5,38,45,
Garfield,Commissioner of Labor,Leslie Osborn,REP,240301,10,52,311,373,
Garfield,Commissioner of Labor,Fred Dorrell,DEM,240301,6,16,97,119,
Garfield,Commissioner of Labor,Brandt Dismukes,IND,240301,2,1,15,18,
Garfield,Insurance Commissioner,Glen Mulready,REP,240301,10,53,319,382,
Garfield,Insurance Commissioner,Kimberly Fobbs,DEM,240301,6,16,108,130,
Garfield,Corporation Commissioner,Bob Anthony,REP,240301,9,49,300,358,
Garfield,Corporation Commissioner,Ashley Nicole Mccray,DEM,240301,6,15,102,123,
Garfield,Corporation Commissioner,Jackie Short,IND,240301,2,5,27,34,
Garfield,U.S. House,Frank Lucas,REP,240301,8,54,326,388,3
Garfield,U.S. House,Frankie Robbins,DEM,240301,8,16,105,129,3
Garfield,State House,Chad Caldwell,REP,240301,9,45,275,329,40
Garfield,State House,Norman Grey,DEM,240301,9,24,155,188,40
Garfield,Governor,Chris Powell,LIB,240302,1,6,45,52,
Garfield,Governor,Kevin Stitt,REP,240302,41,134,741,916,
Garfield,Governor,Drew Edmondson,DEM,240302,27,73,372,472,
Garfield,Lieutenant Governor,Matt Pinnell,REP,240302,43,160,855,1058,
Garfield,Lieutenant Governor,Anastasia Pittman,DEM,240302,17,42,257,316,
Garfield,Lieutenant Governor,Ivan Holmes,IND,240302,6,10,39,55,
Garfield,State Auditor,John Yeutter,LIB,240302,14,20,196,230,
Garfield,State Auditor,Cindy Byrd,REP,240302,48,179,913,1140,
Garfield,Attorney General,Mike Hunter,REP,240302,49,161,852,1062,
Garfield,Attorney General,Mark Myles,DEM,240302,18,50,298,366,
Garfield,State Treasurer,Randy Mcdaniel,REP,240302,48,168,883,1099,
Garfield,State Treasurer,Charles De Coune,IND,240302,13,32,218,263,
Garfield,Superintendent of Public Instruction,Joy Hofmeister,REP,240302,43,171,827,1041,
Garfield,Superintendent of Public Instruction,John Cox,DEM,240302,19,34,240,293,
Garfield,Superintendent of Public Instruction,Larry Huff,IND,240302,5,9,83,97,
Garfield,Commissioner of Labor,Leslie Osborn,REP,240302,49,155,836,1040,
Garfield,Commissioner of Labor,Fred Dorrell,DEM,240302,15,48,259,322,
Garfield,Commissioner of Labor,Brandt Dismukes,IND,240302,2,8,44,54,
Garfield,Insurance Commissioner,Glen Mulready,REP,240302,48,162,848,1058,
Garfield,Insurance Commissioner,Kimberly Fobbs,DEM,240302,18,47,296,361,
Garfield,Corporation Commissioner,Bob Anthony,REP,240302,42,157,783,982,
Garfield,Corporation Commissioner,Ashley Nicole Mccray,DEM,240302,20,47,279,346,
Garfield,Corporation Commissioner,Jackie Short,IND,240302,6,9,84,99,
Garfield,U.S. House,Frank Lucas,REP,240302,51,157,854,1062,3
Garfield,U.S. House,Frankie Robbins,DEM,240302,20,55,295,370,3
Garfield,State House,Denise Crosswhite Hader,REP,240302,39,135,732,906,41
Garfield,State House,Jennie Scott,DEM,240302,28,77,415,520,41
Garfield,Governor,Chris Powell,LIB,240304,0,4,34,38,
Garfield,Governor,Kevin Stitt,REP,240304,49,151,657,857,
Garfield,Governor,Drew Edmondson,DEM,240304,31,54,294,379,
Garfield,Lieutenant Governor,Matt Pinnell,REP,240304,54,170,760,984,
Garfield,Lieutenant Governor,Anastasia Pittman,DEM,240304,25,35,191,251,
Garfield,Lieutenant Governor,Ivan Holmes,IND,240304,1,3,24,28,
Garfield,State Auditor,John Yeutter,LIB,240304,8,24,139,171,
Garfield,State Auditor,Cindy Byrd,REP,240304,58,178,799,1035,
Garfield,Attorney General,Mike Hunter,REP,240304,52,166,754,972,
Garfield,Attorney General,Mark Myles,DEM,240304,27,42,214,283,
Garfield,State Treasurer,Randy Mcdaniel,REP,240304,54,171,768,993,
Garfield,State Treasurer,Charles De Coune,IND,240304,11,32,169,212,
Garfield,Superintendent of Public Instruction,Joy Hofmeister,REP,240304,54,169,745,968,
Garfield,Superintendent of Public Instruction,John Cox,DEM,240304,22,31,166,219,
Garfield,Superintendent of Public Instruction,Larry Huff,IND,240304,2,10,61,73,
Garfield,Commissioner of Labor,Leslie Osborn,REP,240304,53,167,736,956,
Garfield,Commissioner of Labor,Fred Dorrell,DEM,240304,23,35,190,248,
Garfield,Commissioner of Labor,Brandt Dismukes,IND,240304,1,5,28,34,
Garfield,Insurance Commissioner,Glen Mulready,REP,240304,52,171,747,970,
Garfield,Insurance Commissioner,Kimberly Fobbs,DEM,240304,23,36,212,271,
Garfield,Corporation Commissioner,Bob Anthony,REP,240304,53,159,709,921,
Garfield,Corporation Commissioner,Ashley Nicole Mccray,DEM,240304,24,40,212,276,
Garfield,Corporation Commissioner,Jackie Short,IND,240304,0,8,43,51,
Garfield,U.S. House,Frank Lucas,REP,240304,56,167,776,999,3
Garfield,U.S. House,Frankie Robbins,DEM,240304,24,42,198,264,3
Garfield,State House,Denise Crosswhite Hader,REP,240304,44,129,640,813,41
Garfield,State House,Jennie Scott,DEM,240304,35,80,328,443,41
Garfield,Governor,Chris Powell,LIB,240305,0,4,16,20,
Garfield,Governor,Kevin Stitt,REP,240305,47,137,608,792,
Garfield,Governor,Drew Edmondson,DEM,240305,14,68,226,308,
Garfield,Lieutenant Governor,Matt Pinnell,REP,240305,48,159,695,902,
Garfield,Lieutenant Governor,Anastasia Pittman,DEM,240305,12,42,144,198,
Garfield,Lieutenant Governor,Ivan Holmes,IND,240305,0,7,7,14,
Garfield,State Auditor,John Yeutter,LIB,240305,6,21,97,124,
Garfield,State Auditor,Cindy Byrd,REP,240305,50,175,730,955,
Garfield,Attorney General,Mike Hunter,REP,240305,49,161,705,915,
Garfield,Attorney General,Mark Myles,DEM,240305,12,46,136,194,
Garfield,State Treasurer,Randy Mcdaniel,REP,240305,48,158,709,915,
Garfield,State Treasurer,Charles De Coune,IND,240305,8,39,118,165,
Garfield,Superintendent of Public Instruction,Joy Hofmeister,REP,240305,49,152,666,867,
Garfield,Superintendent of Public Instruction,John Cox,DEM,240305,9,39,130,178,
Garfield,Superintendent of Public Instruction,Larry Huff,IND,240305,3,16,51,70,
Garfield,Commissioner of Labor,Leslie Osborn,REP,240305,47,150,671,868,
Garfield,Commissioner of Labor,Fred Dorrell,DEM,240305,13,43,133,189,
Garfield,Commissioner of Labor,Brandt Dismukes,IND,240305,1,7,29,37,
Garfield,Insurance Commissioner,Glen Mulready,REP,240305,48,158,681,887,
Garfield,Insurance Commissioner,Kimberly Fobbs,DEM,240305,13,46,153,212,
Garfield,Corporation Commissioner,Bob Anthony,REP,240305,47,147,654,848,
Garfield,Corporation Commissioner,Ashley Nicole Mccray,DEM,240305,12,49,143,204,
Garfield,Corporation Commissioner,Jackie Short,IND,240305,2,11,40,53,
Garfield,U.S. House,Frank Lucas,REP,240305,48,166,710,924,3
Garfield,U.S. House,Frankie Robbins,DEM,240305,13,42,137,192,3
Garfield,State House,Chad Caldwell,REP,240305,44,129,578,751,40
Garfield,State House,Norman Grey,DEM,240305,16,79,266,361,40
Garfield,Governor,Chris Powell,LIB,240306,1,1,16,18,
Garfield,Governor,Kevin Stitt,REP,240306,13,52,296,361,
Garfield,Governor,Drew Edmondson,DEM,240306,12,23,141,176,
Garfield,Lieutenant Governor,Matt Pinnell,REP,240306,14,59,345,418,
Garfield,Lieutenant Governor,Anastasia Pittman,DEM,240306,11,17,96,124,
Garfield,Lieutenant Governor,Ivan Holmes,IND,240306,0,0,16,16,
Garfield,State Auditor,John Yeutter,LIB,240306,6,7,58,71,
Garfield,State Auditor,Cindy Byrd,REP,240306,18,66,372,456,
Garfield,Attorney General,Mike Hunter,REP,240306,16,63,351,430,
Garfield,Attorney General,Mark Myles,DEM,240306,9,14,99,122,
Garfield,State Treasurer,Randy Mcdaniel,REP,240306,19,66,344,429,
Garfield,State Treasurer,Charles De Coune,IND,240306,4,6,79,89,
Garfield,Superintendent of Public Instruction,Joy Hofmeister,REP,240306,13,60,315,388,
Garfield,Superintendent of Public Instruction,John Cox,DEM,240306,8,14,102,124,
Garfield,Superintendent of Public Instruction,Larry Huff,IND,240306,4,3,35,42,
Garfield,Commissioner of Labor,Leslie Osborn,REP,240306,15,57,327,399,
Garfield,Commissioner of Labor,Fred Dorrell,DEM,240306,9,18,95,122,
Garfield,Commissioner of Labor,Brandt Dismukes,IND,240306,0,1,23,24,
Garfield,Insurance Commissioner,Glen Mulready,REP,240306,15,60,337,412,
Garfield,Insurance Commissioner,Kimberly Fobbs,DEM,240306,10,16,111,137,
Garfield,Corporation Commissioner,Bob Anthony,REP,240306,10,55,331,396,
Garfield,Corporation Commissioner,Ashley Nicole Mccray,DEM,240306,11,16,90,117,
Garfield,Corporation Commissioner,Jackie Short,IND,240306,4,4,28,36,
Garfield,U.S. House,Frank Lucas,REP,240306,15,62,352,429,3
Garfield,U.S. House,Frankie Robbins,DEM,240306,10,15,101,126,3
Garfield,State House,Chad Caldwell,REP,240306,12,47,292,351,40
Garfield,State House,Norman Grey,DEM,240306,13,29,163,205,40
Garfield,Governor,Chris Powell,LIB,240307,0,0,8,8,
Garfield,Governor,Kevin Stitt,REP,240307,18,14,155,187,
Garfield,Governor,Drew Edmondson,DEM,240307,5,5,44,54,
Garfield,Lieutenant Governor,Matt Pinnell,REP,240307,18,14,175,207,
Garfield,Lieutenant Governor,Anastasia Pittman,DEM,240307,6,4,28,38,
Garfield,Lieutenant Governor,Ivan Holmes,IND,240307,0,1,4,5,
Garfield,State Auditor,John Yeutter,LIB,240307,2,1,21,24,
Garfield,State Auditor,Cindy Byrd,REP,240307,18,17,180,215,
Garfield,Attorney General,Mike Hunter,REP,240307,18,15,176,209,
Garfield,Attorney General,Mark Myles,DEM,240307,6,4,31,41,
Garfield,State Treasurer,Randy Mcdaniel,REP,240307,19,16,178,213,
Garfield,State Treasurer,Charles De Coune,IND,240307,1,2,23,26,
Garfield,Superintendent of Public Instruction,Joy Hofmeister,REP,240307,17,16,169,202,
Garfield,Superintendent of Public Instruction,John Cox,DEM,240307,7,3,26,36,
Garfield,Superintendent of Public Instruction,Larry Huff,IND,240307,0,0,11,11,
Garfield,Commissioner of Labor,Leslie Osborn,REP,240307,16,15,167,198,
Garfield,Commissioner of Labor,Fred Dorrell,DEM,240307,8,4,30,42,
Garfield,Commissioner of Labor,Brandt Dismukes,IND,240307,0,0,8,8,
Garfield,Insurance Commissioner,Glen Mulready,REP,240307,18,14,165,197,
Garfield,Insurance Commissioner,Kimberly Fobbs,DEM,240307,5,5,39,49,
Garfield,Corporation Commissioner,Bob Anthony,REP,240307,16,15,160,191,
Garfield,Corporation Commissioner,Ashley Nicole Mccray,DEM,240307,8,4,33,45,
Garfield,Corporation Commissioner,Jackie Short,IND,240307,0,0,13,13,
Garfield,U.S. House,Frank Lucas,REP,240307,20,16,174,210,3
Garfield,U.S. House,Frankie Robbins,DEM,240307,4,3,32,39,3
Garfield,State House,Chad Caldwell,REP,240307,19,14,147,180,40
Garfield,State House,Norman Grey,DEM,240307,4,5,59,68,40
Garfield,Governor,Chris Powell,LIB,240308,1,0,9,10,
Garfield,Governor,Kevin Stitt,REP,240308,32,54,353,439,
Garfield,Governor,Drew Edmondson,DEM,240308,17,28,114,159,
Garfield,Lieutenant Governor,Matt Pinnell,REP,240308,37,65,397,499,
Garfield,Lieutenant Governor,Anastasia Pittman,DEM,240308,10,14,66,90,
Garfield,Lieutenant Governor,Ivan Holmes,IND,240308,1,3,9,13,
Garfield,State Auditor,John Yeutter,LIB,240308,9,9,49,67,
Garfield,State Auditor,Cindy Byrd,REP,240308,34,70,411,515,
Garfield,Attorney General,Mike Hunter,REP,240308,35,61,410,506,
Garfield,Attorney General,Mark Myles,DEM,240308,13,21,61,95,
Garfield,State Treasurer,Randy Mcdaniel,REP,240308,34,64,408,506,
Garfield,State Treasurer,Charles De Coune,IND,240308,7,15,54,76,
Garfield,Superintendent of Public Instruction,Joy Hofmeister,REP,240308,29,67,365,461,
Garfield,Superintendent of Public Instruction,John Cox,DEM,240308,15,12,74,101,
Garfield,Superintendent of Public Instruction,Larry Huff,IND,240308,4,3,29,36,
Garfield,Commissioner of Labor,Leslie Osborn,REP,240308,33,66,393,492,
Garfield,Commissioner of Labor,Fred Dorrell,DEM,240308,12,14,59,85,
Garfield,Commissioner of Labor,Brandt Dismukes,IND,240308,2,2,15,19,
Garfield,Insurance Commissioner,Glen Mulready,REP,240308,29,62,394,485,
Garfield,Insurance Commissioner,Kimberly Fobbs,DEM,240308,18,19,72,109,
Garfield,Corporation Commissioner,Bob Anthony,REP,240308,31,60,370,461,
Garfield,Corporation Commissioner,Ashley Nicole Mccray,DEM,240308,13,18,78,109,
Garfield,Corporation Commissioner,Jackie Short,IND,240308,4,4,22,30,
Garfield,U.S. House,Frank Lucas,REP,240308,37,62,400,499,3
Garfield,U.S. House,Frankie Robbins,DEM,240308,12,20,73,105,3
Garfield,State House,Denise Crosswhite Hader,REP,240308,33,51,347,431,41
Garfield,State House,Jennie Scott,DEM,240308,15,31,125,171,41
Garfield,Governor,Chris Powell,LIB,240309,0,0,17,17,
Garfield,Governor,Kevin Stitt,REP,240309,3,27,285,315,
Garfield,Governor,Drew Edmondson,DEM,240309,7,4,93,104,
Garfield,Lieutenant Governor,Matt Pinnell,REP,240309,6,29,331,366,
Garfield,Lieutenant Governor,Anastasia Pittman,DEM,240309,2,2,46,50,
Garfield,Lieutenant Governor,Ivan Holmes,IND,240309,2,0,15,17,
Garfield,State Auditor,John Yeutter,LIB,240309,1,2,56,59,
Garfield,State Auditor,Cindy Byrd,REP,240309,6,29,327,362,
Garfield,Attorney General,Mike Hunter,REP,240309,6,29,340,375,
Garfield,Attorney General,Mark Myles,DEM,240309,4,2,52,58,
Garfield,State Treasurer,Randy Mcdaniel,REP,240309,5,30,328,363,
Garfield,State Treasurer,Charles De Coune,IND,240309,4,1,56,61,
Garfield,Superintendent of Public Instruction,Joy Hofmeister,REP,240309,5,26,308,339,
Garfield,Superintendent of Public Instruction,John Cox,DEM,240309,4,3,50,57,
Garfield,Superintendent of Public Instruction,Larry Huff,IND,240309,1,2,34,37,
Garfield,Commissioner of Labor,Leslie Osborn,REP,240309,5,29,322,356,
Garfield,Commissioner of Labor,Fred Dorrell,DEM,240309,4,1,42,47,
Garfield,Commissioner of Labor,Brandt Dismukes,IND,240309,1,1,23,25,
Garfield,Insurance Commissioner,Glen Mulready,REP,240309,5,29,335,369,
Garfield,Insurance Commissioner,Kimberly Fobbs,DEM,240309,4,2,54,60,
Garfield,Corporation Commissioner,Bob Anthony,REP,240309,6,25,304,335,
Garfield,Corporation Commissioner,Ashley Nicole Mccray,DEM,240309,4,3,64,71,
Garfield,Corporation Commissioner,Jackie Short,IND,240309,0,3,22,25,
Garfield,U.S. House,Frank Lucas,REP,240309,5,28,343,376,3
Garfield,U.S. House,Frankie Robbins,DEM,240309,5,2,50,57,3
Garfield,State House,Denise Crosswhite Hader,REP,240309,3,24,291,318,41
Garfield,State House,Jennie Scott,DEM,240309,7,7,99,113,41
Garfield,Governor,Chris Powell,LIB,240310,1,1,21,23,
Garfield,Governor,Kevin Stitt,REP,240310,15,25,310,350,
Garfield,Governor,Drew Edmondson,DEM,240310,8,19,105,132,
Garfield,Lieutenant Governor,Matt Pinnell,REP,240310,20,29,343,392,
Garfield,Lieutenant Governor,Anastasia Pittman,DEM,240310,4,16,72,92,
Garfield,Lieutenant Governor,Ivan Holmes,IND,240310,0,0,20,20,
Garfield,State Auditor,John Yeutter,LIB,240310,3,9,45,57,
Garfield,State Auditor,Cindy Byrd,REP,240310,20,35,376,431,
Garfield,Attorney General,Mike Hunter,REP,240310,15,30,341,386,
Garfield,Attorney General,Mark Myles,DEM,240310,8,15,90,113,
Garfield,State Treasurer,Randy Mcdaniel,REP,240310,20,31,348,399,
Garfield,State Treasurer,Charles De Coune,IND,240310,3,13,72,88,
Garfield,Superintendent of Public Instruction,Joy Hofmeister,REP,240310,18,28,336,382,
Garfield,Superintendent of Public Instruction,John Cox,DEM,240310,6,13,69,88,
Garfield,Superintendent of Public Instruction,Larry Huff,IND,240310,0,4,29,33,
Garfield,Commissioner of Labor,Leslie Osborn,REP,240310,19,31,336,386,
Garfield,Commissioner of Labor,Fred Dorrell,DEM,240310,5,13,69,87,
Garfield,Commissioner of Labor,Brandt Dismukes,IND,240310,0,1,24,25,
Garfield,Insurance Commissioner,Glen Mulready,REP,240310,19,29,343,391,
Garfield,Insurance Commissioner,Kimberly Fobbs,DEM,240310,4,15,89,108,
Garfield,Corporation Commissioner,Bob Anthony,REP,240310,20,24,321,365,
Garfield,Corporation Commissioner,Ashley Nicole Mccray,DEM,240310,4,18,83,105,
Garfield,Corporation Commissioner,Jackie Short,IND,240310,0,2,30,32,
Garfield,U.S. House,Frank Lucas,REP,240310,21,29,349,399,3
Garfield,U.S. House,Frankie Robbins,DEM,240310,4,16,85,105,3
Garfield,State House,Denise Crosswhite Hader,REP,240310,19,29,297,345,41
Garfield,State House,Jennie Scott,DEM,240310,5,16,136,157,41
Garfield,Governor,Chris Powell,LIB,240311,3,8,45,56,
Garfield,Governor,Kevin Stitt,REP,240311,16,57,489,562,
Garfield,Governor,Drew Edmondson,DEM,240311,10,32,153,195,
Garfield,Lieutenant Governor,Matt Pinnell,REP,240311,20,71,560,651,
Garfield,Lieutenant Governor,Anastasia Pittman,DEM,240311,5,22,98,125,
Garfield,Lieutenant Governor,Ivan Holmes,IND,240311,2,3,27,32,
Garfield,State Auditor,John Yeutter,LIB,240311,6,13,79,98,
Garfield,State Auditor,Cindy Byrd,REP,240311,21,77,590,688,
Garfield,Attorney General,Mike Hunter,REP,240311,18,75,577,670,
Garfield,Attorney General,Mark Myles,DEM,240311,8,20,106,134,
Garfield,State Treasurer,Randy Mcdaniel,REP,240311,19,72,574,665,
Garfield,State Treasurer,Charles De Coune,IND,240311,7,22,92,121,
Garfield,Superintendent of Public Instruction,Joy Hofmeister,REP,240311,21,73,517,611,
Garfield,Superintendent of Public Instruction,John Cox,DEM,240311,4,19,112,135,
Garfield,Superintendent of Public Instruction,Larry Huff,IND,240311,2,5,57,64,
Garfield,Commissioner of Labor,Leslie Osborn,REP,240311,21,73,550,644,
Garfield,Commissioner of Labor,Fred Dorrell,DEM,240311,5,17,96,118,
Garfield,Commissioner of Labor,Brandt Dismukes,IND,240311,1,5,38,44,
Garfield,Insurance Commissioner,Glen Mulready,REP,240311,17,72,544,633,
Garfield,Insurance Commissioner,Kimberly Fobbs,DEM,240311,10,23,134,167,
Garfield,Corporation Commissioner,Bob Anthony,REP,240311,22,68,517,607,
Garfield,Corporation Commissioner,Ashley Nicole Mccray,DEM,240311,5,23,103,131,
Garfield,Corporation Commissioner,Jackie Short,IND,240311,1,5,63,69,
Garfield,U.S. House,Frank Lucas,REP,240311,23,75,580,678,3
Garfield,U.S. House,Frankie Robbins,DEM,240311,6,21,105,132,3
Garfield,State House,Denise Crosswhite Hader,REP,240311,16,59,488,563,41
Garfield,State House,Jennie Scott,DEM,240311,12,38,197,247,41
Garvin,Governor,Chris Powell,LIB,250001,0,0,10,10,
Garvin,Governor,Kevin Stitt,REP,250001,9,9,267,285,
Garvin,Governor,Drew Edmondson,DEM,250001,5,0,77,82,
Garvin,Lieutenant Governor,Matt Pinnell,REP,250001,10,9,275,294,
Garvin,Lieutenant Governor,Anastasia Pittman,DEM,250001,3,0,66,69,
Garvin,Lieutenant Governor,Ivan Holmes,IND,250001,1,0,10,11,
Garvin,State Auditor,John Yeutter,LIB,250001,5,0,38,43,
Garvin,State Auditor,Cindy Byrd,REP,250001,9,9,303,321,
Garvin,Attorney General,Mike Hunter,REP,250001,8,9,278,295,
Garvin,Attorney General,Mark Myles,DEM,250001,6,0,69,75,
Garvin,State Treasurer,Randy Mcdaniel,REP,250001,9,9,304,322,
Garvin,State Treasurer,Charles De Coune,IND,250001,5,0,34,39,
Garvin,Superintendent of Public Instruction,Joy Hofmeister,REP,250001,9,6,259,274,
Garvin,Superintendent of Public Instruction,John Cox,DEM,250001,5,2,59,66,
Garvin,Superintendent of Public Instruction,Larry Huff,IND,250001,0,1,32,33,
Garvin,Commissioner of Labor,Leslie Osborn,REP,250001,9,9,265,283,
Garvin,Commissioner of Labor,Fred Dorrell,DEM,250001,4,0,69,73,
Garvin,Commissioner of Labor,Brandt Dismukes,IND,250001,1,0,12,13,
Garvin,Insurance Commissioner,Glen Mulready,REP,250001,10,9,266,285,
Garvin,Insurance Commissioner,Kimberly Fobbs,DEM,250001,4,0,78,82,
Garvin,Corporation Commissioner,Bob Anthony,REP,250001,11,9,262,282,
Garvin,Corporation Commissioner,Ashley Nicole Mccray,DEM,250001,3,0,65,68,
Garvin,Corporation Commissioner,Jackie Short,IND,250001,0,0,17,17,
Garvin,U.S. House,Tom Cole,REP,250001,9,9,287,305,4
Garvin,U.S. House,Mary Brannon,DEM,250001,5,0,49,54,4
Garvin,U.S. House,Ruby Peters,IND,250001,0,0,12,12,4
Garvin,State House,Cynthia Roe,REP,250001,11,9,270,290,42
Garvin,State House,Liz George,DEM,250001,3,0,80,83,42
Garvin,Governor,Chris Powell,LIB,250002,0,1,17,18,
Garvin,Governor,Kevin Stitt,REP,250002,5,9,298,312,
Garvin,Governor,Drew Edmondson,DEM,250002,7,5,119,131,
Garvin,Lieutenant Governor,Matt Pinnell,REP,250002,7,12,340,359,
Garvin,Lieutenant Governor,Anastasia Pittman,DEM,250002,5,3,81,89,
Garvin,Lieutenant Governor,Ivan Holmes,IND,250002,0,1,14,15,
Garvin,State Auditor,John Yeutter,LIB,250002,3,4,57,64,
Garvin,State Auditor,Cindy Byrd,REP,250002,9,11,360,380,
Garvin,Attorney General,Mike Hunter,REP,250002,8,13,343,364,
Garvin,Attorney General,Mark Myles,DEM,250002,4,3,85,92,
Garvin,State Treasurer,Randy Mcdaniel,REP,250002,7,13,355,375,
Garvin,State Treasurer,Charles De Coune,IND,250002,3,2,61,66,
Garvin,Superintendent of Public Instruction,Joy Hofmeister,REP,250002,4,11,309,324,
Garvin,Superintendent of Public Instruction,John Cox,DEM,250002,5,3,81,89,
Garvin,Superintendent of Public Instruction,Larry Huff,IND,250002,3,2,41,46,
Garvin,Commissioner of Labor,Leslie Osborn,REP,250002,5,13,328,346,
Garvin,Commissioner of Labor,Fred Dorrell,DEM,250002,5,3,76,84,
Garvin,Commissioner of Labor,Brandt Dismukes,IND,250002,0,0,16,16,
Garvin,Insurance Commissioner,Glen Mulready,REP,250002,7,12,331,350,
Garvin,Insurance Commissioner,Kimberly Fobbs,DEM,250002,5,4,92,101,
Garvin,Corporation Commissioner,Bob Anthony,REP,250002,7,10,316,333,
Garvin,Corporation Commissioner,Ashley Nicole Mccray,DEM,250002,4,4,87,95,
Garvin,Corporation Commissioner,Jackie Short,IND,250002,0,1,28,29,
Garvin,U.S. House,Tom Cole,REP,250002,5,12,344,361,4
Garvin,U.S. House,Mary Brannon,DEM,250002,5,4,72,81,4
Garvin,U.S. House,Ruby Peters,IND,250002,0,0,18,18,4
Garvin,State House,Cynthia Roe,REP,250002,6,8,312,326,42
Garvin,State House,Liz George,DEM,250002,6,8,120,134,42
Garvin,Governor,Chris Powell,LIB,250003,0,0,24,24,
Garvin,Governor,Kevin Stitt,REP,250003,10,10,368,388,
Garvin,Governor,Drew Edmondson,DEM,250003,0,1,117,118,
Garvin,Lieutenant Governor,Matt Pinnell,REP,250003,9,11,401,421,
Garvin,Lieutenant Governor,Anastasia Pittman,DEM,250003,1,0,89,90,
Garvin,Lieutenant Governor,Ivan Holmes,IND,250003,0,0,16,16,
Garvin,State Auditor,John Yeutter,LIB,250003,2,0,56,58,
Garvin,State Auditor,Cindy Byrd,REP,250003,8,10,430,448,
Garvin,Attorney General,Mike Hunter,REP,250003,9,9,425,443,
Garvin,Attorney General,Mark Myles,DEM,250003,1,2,81,84,
Garvin,State Treasurer,Randy Mcdaniel,REP,250003,9,10,430,449,
Garvin,State Treasurer,Charles De Coune,IND,250003,1,1,59,61,
Garvin,Superintendent of Public Instruction,Joy Hofmeister,REP,250003,8,9,361,378,
Garvin,Superintendent of Public Instruction,John Cox,DEM,250003,1,1,107,109,
Garvin,Superintendent of Public Instruction,Larry Huff,IND,250003,1,1,36,38,
Garvin,Commissioner of Labor,Leslie Osborn,REP,250003,8,11,410,429,
Garvin,Commissioner of Labor,Fred Dorrell,DEM,250003,2,0,79,81,
Garvin,Commissioner of Labor,Brandt Dismukes,IND,250003,0,0,15,15,
Garvin,Insurance Commissioner,Glen Mulready,REP,250003,9,10,397,416,
Garvin,Insurance Commissioner,Kimberly Fobbs,DEM,250003,1,1,107,109,
Garvin,Corporation Commissioner,Bob Anthony,REP,250003,8,9,383,400,
Garvin,Corporation Commissioner,Ashley Nicole Mccray,DEM,250003,1,1,103,105,
Garvin,Corporation Commissioner,Jackie Short,IND,250003,1,1,19,21,
Garvin,U.S. House,Tom Cole,REP,250003,9,10,403,422,4
Garvin,U.S. House,Mary Brannon,DEM,250003,1,1,83,85,4
Garvin,U.S. House,Ruby Peters,IND,250003,0,0,20,20,4
Garvin,State House,Cynthia Roe,REP,250003,10,10,396,416,42
Garvin,State House,Liz George,DEM,250003,0,1,112,113,42
Garvin,Governor,Chris Powell,LIB,250005,0,1,24,25,
Garvin,Governor,Kevin Stitt,REP,250005,16,27,431,474,
Garvin,Governor,Drew Edmondson,DEM,250005,11,12,131,154,
Garvin,Lieutenant Governor,Matt Pinnell,REP,250005,17,31,477,525,
Garvin,Lieutenant Governor,Anastasia Pittman,DEM,250005,10,6,82,98,
Garvin,Lieutenant Governor,Ivan Holmes,IND,250005,0,1,23,24,
Garvin,State Auditor,John Yeutter,LIB,250005,5,7,68,80,
Garvin,State Auditor,Cindy Byrd,REP,250005,19,31,498,548,
Garvin,Attorney General,Mike Hunter,REP,250005,18,31,481,530,
Garvin,Attorney General,Mark Myles,DEM,250005,8,6,98,112,
Garvin,State Treasurer,Randy Mcdaniel,REP,250005,23,30,501,554,
Garvin,State Treasurer,Charles De Coune,IND,250005,3,7,64,74,
Garvin,Superintendent of Public Instruction,Joy Hofmeister,REP,250005,19,24,404,447,
Garvin,Superintendent of Public Instruction,John Cox,DEM,250005,7,10,115,132,
Garvin,Superintendent of Public Instruction,Larry Huff,IND,250005,0,5,63,68,
Garvin,Commissioner of Labor,Leslie Osborn,REP,250005,17,28,474,519,
Garvin,Commissioner of Labor,Fred Dorrell,DEM,250005,7,9,74,90,
Garvin,Commissioner of Labor,Brandt Dismukes,IND,250005,2,2,30,34,
Garvin,Insurance Commissioner,Glen Mulready,REP,250005,17,31,464,512,
Garvin,Insurance Commissioner,Kimberly Fobbs,DEM,250005,9,8,112,129,
Garvin,Corporation Commissioner,Bob Anthony,REP,250005,16,24,424,464,
Garvin,Corporation Commissioner,Ashley Nicole Mccray,DEM,250005,9,10,106,125,
Garvin,Corporation Commissioner,Jackie Short,IND,250005,2,5,46,53,
Garvin,U.S. House,Tom Cole,REP,250005,21,31,482,534,4
Garvin,U.S. House,Mary Brannon,DEM,250005,6,6,87,99,4
Garvin,U.S. House,Ruby Peters,IND,250005,0,1,14,15,4
Garvin,State House,Cynthia Roe,REP,250005,18,27,447,492,42
Garvin,State House,Liz George,DEM,250005,9,12,135,156,42
Garvin,Governor,Chris Powell,LIB,250006,0,1,12,13,
Garvin,Governor,Kevin Stitt,REP,250006,4,11,151,166,
Garvin,Governor,Drew Edmondson,DEM,250006,1,4,109,114,
Garvin,Lieutenant Governor,Matt Pinnell,REP,250006,4,11,171,186,
Garvin,Lieutenant Governor,Anastasia Pittman,DEM,250006,1,5,89,95,
Garvin,Lieutenant Governor,Ivan Holmes,IND,250006,0,0,11,11,
Garvin,State Auditor,John Yeutter,LIB,250006,1,1,39,41,
Garvin,State Auditor,Cindy Byrd,REP,250006,4,13,202,219,
Garvin,Attorney General,Mike Hunter,REP,250006,4,11,177,192,
Garvin,Attorney General,Mark Myles,DEM,250006,1,4,92,97,
Garvin,State Treasurer,Randy Mcdaniel,REP,250006,4,13,193,210,
Garvin,State Treasurer,Charles De Coune,IND,250006,1,1,48,50,
Garvin,Superintendent of Public Instruction,Joy Hofmeister,REP,250006,4,12,143,159,
Garvin,Superintendent of Public Instruction,John Cox,DEM,250006,0,4,101,105,
Garvin,Superintendent of Public Instruction,Larry Huff,IND,250006,1,0,27,28,
Garvin,Commissioner of Labor,Leslie Osborn,REP,250006,4,10,168,182,
Garvin,Commissioner of Labor,Fred Dorrell,DEM,250006,1,5,83,89,
Garvin,Commissioner of Labor,Brandt Dismukes,IND,250006,0,0,17,17,
Garvin,Insurance Commissioner,Glen Mulready,REP,250006,4,12,164,180,
Garvin,Insurance Commissioner,Kimberly Fobbs,DEM,250006,1,3,103,107,
Garvin,Corporation Commissioner,Bob Anthony,REP,250006,5,11,159,175,
Garvin,Corporation Commissioner,Ashley Nicole Mccray,DEM,250006,0,3,93,96,
Garvin,Corporation Commissioner,Jackie Short,IND,250006,0,1,18,19,
Garvin,U.S. House,Tom Cole,REP,250006,5,12,172,189,4
Garvin,U.S. House,Mary Brannon,DEM,250006,0,3,82,85,4
Garvin,U.S. House,Ruby Peters,IND,250006,0,0,16,16,4
Garvin,State House,Cynthia Roe,REP,250006,3,10,150,163,42
Garvin,State House,Liz George,DEM,250006,2,5,119,126,42
Garvin,Governor,Chris Powell,LIB,250007,0,3,13,16,
Garvin,Governor,Kevin Stitt,REP,250007,6,44,174,224,
Garvin,Governor,Drew Edmondson,DEM,250007,6,34,112,152,
Garvin,Lieutenant Governor,Matt Pinnell,REP,250007,8,59,199,266,
Garvin,Lieutenant Governor,Anastasia Pittman,DEM,250007,4,19,86,109,
Garvin,Lieutenant Governor,Ivan Holmes,IND,250007,0,2,11,13,
Garvin,State Auditor,John Yeutter,LIB,250007,2,13,40,55,
Garvin,State Auditor,Cindy Byrd,REP,250007,8,62,241,311,
Garvin,Attorney General,Mike Hunter,REP,250007,6,58,213,277,
Garvin,Attorney General,Mark Myles,DEM,250007,6,22,81,109,
Garvin,State Treasurer,Randy Mcdaniel,REP,250007,7,59,223,289,
Garvin,State Treasurer,Charles De Coune,IND,250007,3,17,56,76,
Garvin,Superintendent of Public Instruction,Joy Hofmeister,REP,250007,6,55,201,262,
Garvin,Superintendent of Public Instruction,John Cox,DEM,250007,6,19,77,102,
Garvin,Superintendent of Public Instruction,Larry Huff,IND,250007,0,7,17,24,
Garvin,Commissioner of Labor,Leslie Osborn,REP,250007,7,55,207,269,
Garvin,Commissioner of Labor,Fred Dorrell,DEM,250007,5,23,76,104,
Garvin,Commissioner of Labor,Brandt Dismukes,IND,250007,0,2,12,14,
Garvin,Insurance Commissioner,Glen Mulready,REP,250007,7,55,205,267,
Garvin,Insurance Commissioner,Kimberly Fobbs,DEM,250007,5,23,87,115,
Garvin,Corporation Commissioner,Bob Anthony,REP,250007,7,54,184,245,
Garvin,Corporation Commissioner,Ashley Nicole Mccray,DEM,250007,5,20,92,117,
Garvin,Corporation Commissioner,Jackie Short,IND,250007,0,4,19,23,
Garvin,U.S. House,Tom Cole,REP,250007,7,58,203,268,4
Garvin,U.S. House,Mary Brannon,DEM,250007,4,21,79,104,4
Garvin,U.S. House,Ruby Peters,IND,250007,1,1,15,17,4
Garvin,State House,Cynthia Roe,REP,250007,9,50,189,248,42
Garvin,State House,Liz George,DEM,250007,3,30,107,140,42
Garvin,Governor,Chris Powell,LIB,250008,0,2,18,20,
Garvin,Governor,Kevin Stitt,REP,250008,12,61,181,254,
Garvin,Governor,Drew Edmondson,DEM,250008,3,15,119,137,
Garvin,Lieutenant Governor,Matt Pinnell,REP,250008,12,63,214,289,
Garvin,Lieutenant Governor,Anastasia Pittman,DEM,250008,3,13,91,107,
Garvin,Lieutenant Governor,Ivan Holmes,IND,250008,0,1,10,11,
Garvin,State Auditor,John Yeutter,LIB,250008,1,14,60,75,
Garvin,State Auditor,Cindy Byrd,REP,250008,13,61,242,316,
Garvin,Attorney General,Mike Hunter,REP,250008,12,59,221,292,
Garvin,Attorney General,Mark Myles,DEM,250008,3,18,94,115,
Garvin,State Treasurer,Randy Mcdaniel,REP,250008,13,59,229,301,
Garvin,State Treasurer,Charles De Coune,IND,250008,2,15,71,88,
Garvin,Superintendent of Public Instruction,Joy Hofmeister,REP,250008,12,59,205,276,
Garvin,Superintendent of Public Instruction,John Cox,DEM,250008,3,15,84,102,
Garvin,Superintendent of Public Instruction,Larry Huff,IND,250008,0,3,27,30,
Garvin,Commissioner of Labor,Leslie Osborn,REP,250008,12,56,202,270,
Garvin,Commissioner of Labor,Fred Dorrell,DEM,250008,3,17,93,113,
Garvin,Commissioner of Labor,Brandt Dismukes,IND,250008,0,3,17,20,
Garvin,Insurance Commissioner,Glen Mulready,REP,250008,12,59,207,278,
Garvin,Insurance Commissioner,Kimberly Fobbs,DEM,250008,3,16,106,125,
Garvin,Corporation Commissioner,Bob Anthony,REP,250008,12,54,192,258,
Garvin,Corporation Commissioner,Ashley Nicole Mccray,DEM,250008,3,16,104,123,
Garvin,Corporation Commissioner,Jackie Short,IND,250008,0,5,18,23,
Garvin,U.S. House,Tom Cole,REP,250008,12,60,208,280,4
Garvin,U.S. House,Mary Brannon,DEM,250008,3,15,90,108,4
Garvin,U.S. House,Ruby Peters,IND,250008,0,1,19,20,4
Garvin,State House,Cynthia Roe,REP,250008,12,57,199,268,42
Garvin,State House,Liz George,DEM,250008,3,20,119,142,42
Garvin,Governor,Chris Powell,LIB,250009,0,0,10,10,
Garvin,Governor,Kevin Stitt,REP,250009,8,40,387,435,
Garvin,Governor,Drew Edmondson,DEM,250009,3,14,182,199,
Garvin,Lieutenant Governor,Matt Pinnell,REP,250009,7,43,432,482,
Garvin,Lieutenant Governor,Anastasia Pittman,DEM,250009,4,11,131,146,
Garvin,Lieutenant Governor,Ivan Holmes,IND,250009,0,0,15,15,
Garvin,State Auditor,John Yeutter,LIB,250009,1,8,87,96,
Garvin,State Auditor,Cindy Byrd,REP,250009,10,45,469,524,
Garvin,Attorney General,Mike Hunter,REP,250009,7,41,431,479,
Garvin,Attorney General,Mark Myles,DEM,250009,4,13,142,159,
Garvin,State Treasurer,Randy Mcdaniel,REP,250009,8,43,463,514,
Garvin,State Treasurer,Charles De Coune,IND,250009,3,9,89,101,
Garvin,Superintendent of Public Instruction,Joy Hofmeister,REP,250009,9,40,394,443,
Garvin,Superintendent of Public Instruction,John Cox,DEM,250009,2,8,140,150,
Garvin,Superintendent of Public Instruction,Larry Huff,IND,250009,0,6,44,50,
Garvin,Commissioner of Labor,Leslie Osborn,REP,250009,9,39,410,458,
Garvin,Commissioner of Labor,Fred Dorrell,DEM,250009,2,12,133,147,
Garvin,Commissioner of Labor,Brandt Dismukes,IND,250009,0,3,29,32,
Garvin,Insurance Commissioner,Glen Mulready,REP,250009,8,43,418,469,
Garvin,Insurance Commissioner,Kimberly Fobbs,DEM,250009,3,13,152,168,
Garvin,Corporation Commissioner,Bob Anthony,REP,250009,9,41,403,453,
Garvin,Corporation Commissioner,Ashley Nicole Mccray,DEM,250009,1,14,142,157,
Garvin,Corporation Commissioner,Jackie Short,IND,250009,1,1,31,33,
Garvin,U.S. House,Tom Cole,REP,250009,7,42,427,476,4
Garvin,U.S. House,Mary Brannon,DEM,250009,2,13,139,154,4
Garvin,U.S. House,Ruby Peters,IND,250009,2,1,12,15,4
Garvin,State House,Cynthia Roe,REP,250009,8,40,408,456,42
Garvin,State House,Liz George,DEM,250009,3,16,169,188,42
Garvin,Governor,Chris Powell,LIB,250013,0,0,5,5,
Garvin,Governor,Kevin Stitt,REP,250013,4,8,150,162,
Garvin,Governor,Drew Edmondson,DEM,250013,3,7,75,85,
Garvin,Lieutenant Governor,Matt Pinnell,REP,250013,6,9,161,176,
Garvin,Lieutenant Governor,Anastasia Pittman,DEM,250013,1,6,62,69,
Garvin,Lieutenant Governor,Ivan Holmes,IND,250013,0,0,6,6,
Garvin,State Auditor,John Yeutter,LIB,250013,0,3,33,36,
Garvin,State Auditor,Cindy Byrd,REP,250013,6,12,174,192,
Garvin,Attorney General,Mike Hunter,REP,250013,5,10,163,178,
Garvin,Attorney General,Mark Myles,DEM,250013,2,5,65,72,
Garvin,State Treasurer,Randy Mcdaniel,REP,250013,6,13,171,190,
Garvin,State Treasurer,Charles De Coune,IND,250013,0,2,38,40,
Garvin,Superintendent of Public Instruction,Joy Hofmeister,REP,250013,2,12,154,168,
Garvin,Superintendent of Public Instruction,John Cox,DEM,250013,3,2,61,66,
Garvin,Superintendent of Public Instruction,Larry Huff,IND,250013,2,1,14,17,
Garvin,Commissioner of Labor,Leslie Osborn,REP,250013,3,10,155,168,
Garvin,Commissioner of Labor,Fred Dorrell,DEM,250013,3,4,71,78,
Garvin,Commissioner of Labor,Brandt Dismukes,IND,250013,1,1,2,4,
Garvin,Insurance Commissioner,Glen Mulready,REP,250013,4,9,156,169,
Garvin,Insurance Commissioner,Kimberly Fobbs,DEM,250013,3,6,73,82,
Garvin,Corporation Commissioner,Bob Anthony,REP,250013,5,11,151,167,
Garvin,Corporation Commissioner,Ashley Nicole Mccray,DEM,250013,2,4,67,73,
Garvin,Corporation Commissioner,Jackie Short,IND,250013,0,0,11,11,
Garvin,U.S. House,Tom Cole,REP,250013,5,10,166,181,4
Garvin,U.S. House,Mary Brannon,DEM,250013,2,4,59,65,4
Garvin,U.S. House,Ruby Peters,IND,250013,0,1,5,6,4
Garvin,State House,Tammy Townley,REP,250013,4,9,156,169,48
Garvin,State House,Cheryl Key,DEM,250013,3,6,72,81,48
Garvin,Governor,Chris Powell,LIB,250015,0,1,9,10,
Garvin,Governor,Kevin Stitt,REP,250015,6,47,238,291,
Garvin,Governor,Drew Edmondson,DEM,250015,7,35,142,184,
Garvin,Lieutenant Governor,Matt Pinnell,REP,250015,8,56,276,340,
Garvin,Lieutenant Governor,Anastasia Pittman,DEM,250015,5,26,105,136,
Garvin,Lieutenant Governor,Ivan Holmes,IND,250015,0,1,7,8,
Garvin,State Auditor,John Yeutter,LIB,250015,1,14,59,74,
Garvin,State Auditor,Cindy Byrd,REP,250015,11,58,307,376,
Garvin,Attorney General,Mike Hunter,REP,250015,8,53,271,332,
Garvin,Attorney General,Mark Myles,DEM,250015,5,30,112,147,
Garvin,State Treasurer,Randy Mcdaniel,REP,250015,8,61,292,361,
Garvin,State Treasurer,Charles De Coune,IND,250015,3,13,69,85,
Garvin,Superintendent of Public Instruction,Joy Hofmeister,REP,250015,8,50,262,320,
Garvin,Superintendent of Public Instruction,John Cox,DEM,250015,5,27,108,140,
Garvin,Superintendent of Public Instruction,Larry Huff,IND,250015,0,6,15,21,
Garvin,Commissioner of Labor,Leslie Osborn,REP,250015,7,54,268,329,
Garvin,Commissioner of Labor,Fred Dorrell,DEM,250015,6,26,99,131,
Garvin,Commissioner of Labor,Brandt Dismukes,IND,250015,0,2,13,15,
Garvin,Insurance Commissioner,Glen Mulready,REP,250015,8,54,269,331,
Garvin,Insurance Commissioner,Kimberly Fobbs,DEM,250015,5,29,111,145,
Garvin,Corporation Commissioner,Bob Anthony,REP,250015,8,54,261,323,
Garvin,Corporation Commissioner,Ashley Nicole Mccray,DEM,250015,4,29,99,132,
Garvin,Corporation Commissioner,Jackie Short,IND,250015,1,0,20,21,
Garvin,U.S. House,Tom Cole,REP,250015,9,55,275,339,4
Garvin,U.S. House,Mary Brannon,DEM,250015,4,28,95,127,4
Garvin,U.S. House,Ruby Peters,IND,250015,0,0,16,16,4
Garvin,State House,Cynthia Roe,REP,250015,8,53,261,322,42
Garvin,State House,Liz George,DEM,250015,5,30,125,160,42
Garvin,Governor,Chris Powell,LIB,250016,0,1,7,8,
Garvin,Governor,Kevin Stitt,REP,250016,15,51,275,341,
Garvin,Governor,Drew Edmondson,DEM,250016,2,9,110,121,
Garvin,Lieutenant Governor,Matt Pinnell,REP,250016,15,49,292,356,
Garvin,Lieutenant Governor,Anastasia Pittman,DEM,250016,2,11,87,100,
Garvin,Lieutenant Governor,Ivan Holmes,IND,250016,0,0,10,10,
Garvin,State Auditor,John Yeutter,LIB,250016,1,5,58,64,
Garvin,State Auditor,Cindy Byrd,REP,250016,16,49,304,369,
Garvin,Attorney General,Mike Hunter,REP,250016,15,50,294,359,
Garvin,Attorney General,Mark Myles,DEM,250016,2,10,93,105,
Garvin,State Treasurer,Randy Mcdaniel,REP,250016,15,50,296,361,
Garvin,State Treasurer,Charles De Coune,IND,250016,2,5,65,72,
Garvin,Superintendent of Public Instruction,Joy Hofmeister,REP,250016,12,43,268,323,
Garvin,Superintendent of Public Instruction,John Cox,DEM,250016,4,12,89,105,
Garvin,Superintendent of Public Instruction,Larry Huff,IND,250016,1,4,29,34,
Garvin,Commissioner of Labor,Leslie Osborn,REP,250016,14,46,286,346,
Garvin,Commissioner of Labor,Fred Dorrell,DEM,250016,2,10,88,100,
Garvin,Commissioner of Labor,Brandt Dismukes,IND,250016,1,4,12,17,
Garvin,Insurance Commissioner,Glen Mulready,REP,250016,15,50,282,347,
Garvin,Insurance Commissioner,Kimberly Fobbs,DEM,250016,2,10,103,115,
Garvin,Corporation Commissioner,Bob Anthony,REP,250016,15,46,274,335,
Garvin,Corporation Commissioner,Ashley Nicole Mccray,DEM,250016,2,14,99,115,
Garvin,Corporation Commissioner,Jackie Short,IND,250016,0,0,16,16,
Garvin,U.S. House,Tom Cole,REP,250016,15,51,296,362,4
Garvin,U.S. House,Mary Brannon,DEM,250016,2,9,89,100,4
Garvin,U.S. House,Ruby Peters,IND,250016,0,0,4,4,4
Garvin,State House,Cynthia Roe,REP,250016,15,50,280,345,42
Garvin,State House,Liz George,DEM,250016,2,10,104,116,42
Garvin,Governor,Chris Powell,LIB,250017,0,4,15,19,
Garvin,Governor,Kevin Stitt,REP,250017,2,26,171,199,
Garvin,Governor,Drew Edmondson,DEM,250017,6,21,143,170,
Garvin,Lieutenant Governor,Matt Pinnell,REP,250017,3,28,192,223,
Garvin,Lieutenant Governor,Anastasia Pittman,DEM,250017,5,21,121,147,
Garvin,Lieutenant Governor,Ivan Holmes,IND,250017,0,3,10,13,
Garvin,State Auditor,John Yeutter,LIB,250017,2,12,80,94,
Garvin,State Auditor,Cindy Byrd,REP,250017,5,35,223,263,
Garvin,Attorney General,Mike Hunter,REP,250017,3,32,192,227,
Garvin,Attorney General,Mark Myles,DEM,250017,5,20,132,157,
Garvin,State Treasurer,Randy Mcdaniel,REP,250017,4,33,211,248,
Garvin,State Treasurer,Charles De Coune,IND,250017,2,15,92,109,
Garvin,Superintendent of Public Instruction,Joy Hofmeister,REP,250017,4,31,188,223,
Garvin,Superintendent of Public Instruction,John Cox,DEM,250017,4,17,116,137,
Garvin,Superintendent of Public Instruction,Larry Huff,IND,250017,0,4,23,27,
Garvin,Commissioner of Labor,Leslie Osborn,REP,250017,3,28,184,215,
Garvin,Commissioner of Labor,Fred Dorrell,DEM,250017,4,17,121,142,
Garvin,Commissioner of Labor,Brandt Dismukes,IND,250017,0,3,18,21,
Garvin,Insurance Commissioner,Glen Mulready,REP,250017,3,30,183,216,
Garvin,Insurance Commissioner,Kimberly Fobbs,DEM,250017,4,22,138,164,
Garvin,Corporation Commissioner,Bob Anthony,REP,250017,4,27,177,208,
Garvin,Corporation Commissioner,Ashley Nicole Mccray,DEM,250017,4,23,123,150,
Garvin,Corporation Commissioner,Jackie Short,IND,250017,0,2,23,25,
Garvin,U.S. House,Tom Cole,REP,250017,4,29,188,221,4
Garvin,U.S. House,Mary Brannon,DEM,250017,4,20,119,143,4
Garvin,U.S. House,Ruby Peters,IND,250017,0,3,16,19,4
Garvin,State House,Cynthia Roe,REP,250017,2,26,180,208,42
Garvin,State House,Liz George,DEM,250017,6,26,145,177,42
Garvin,Governor,Chris Powell,LIB,250018,0,7,28,35,
Garvin,Governor,Kevin Stitt,REP,250018,21,114,389,524,
Garvin,Governor,Drew Edmondson,DEM,250018,8,53,254,315,
Garvin,Lieutenant Governor,Matt Pinnell,REP,250018,22,127,443,592,
Garvin,Lieutenant Governor,Anastasia Pittman,DEM,250018,8,38,203,249,
Garvin,Lieutenant Governor,Ivan Holmes,IND,250018,1,10,23,34,
Garvin,State Auditor,John Yeutter,LIB,250018,2,28,129,159,
Garvin,State Auditor,Cindy Byrd,REP,250018,26,136,495,657,
Garvin,Attorney General,Mike Hunter,REP,250018,23,131,467,621,
Garvin,Attorney General,Mark Myles,DEM,250018,8,41,200,249,
Garvin,State Treasurer,Randy Mcdaniel,REP,250018,22,136,477,635,
Garvin,State Treasurer,Charles De Coune,IND,250018,6,30,147,183,
Garvin,Superintendent of Public Instruction,Joy Hofmeister,REP,250018,25,125,415,565,
Garvin,Superintendent of Public Instruction,John Cox,DEM,250018,5,36,193,234,
Garvin,Superintendent of Public Instruction,Larry Huff,IND,250018,1,13,60,74,
Garvin,Commissioner of Labor,Leslie Osborn,REP,250018,27,122,445,594,
Garvin,Commissioner of Labor,Fred Dorrell,DEM,250018,4,37,191,232,
Garvin,Commissioner of Labor,Brandt Dismukes,IND,250018,0,12,28,40,
Garvin,Insurance Commissioner,Glen Mulready,REP,250018,23,126,441,590,
Garvin,Insurance Commissioner,Kimberly Fobbs,DEM,250018,8,46,225,279,
Garvin,Corporation Commissioner,Bob Anthony,REP,250018,23,129,422,574,
Garvin,Corporation Commissioner,Ashley Nicole Mccray,DEM,250018,8,37,204,249,
Garvin,Corporation Commissioner,Jackie Short,IND,250018,0,8,41,49,
Garvin,U.S. House,Tom Cole,REP,250018,23,131,456,610,4
Garvin,U.S. House,Mary Brannon,DEM,250018,7,38,187,232,4
Garvin,U.S. House,Ruby Peters,IND,250018,0,5,23,28,4
Garvin,State House,Sherrie Conley,REP,250018,23,120,365,508,20
Garvin,State House,Steve Jarman,DEM,250018,8,53,302,363,20
Garvin,Governor,Chris Powell,LIB,250020,0,1,19,20,
Garvin,Governor,Kevin Stitt,REP,250020,11,22,400,433,
Garvin,Governor,Drew Edmondson,DEM,250020,2,16,220,238,
Garvin,Lieutenant Governor,Matt Pinnell,REP,250020,12,24,433,469,
Garvin,Lieutenant Governor,Anastasia Pittman,DEM,250020,1,15,186,202,
Garvin,Lieutenant Governor,Ivan Holmes,IND,250020,0,0,16,16,
Garvin,State Auditor,John Yeutter,LIB,250020,1,8,94,103,
Garvin,State Auditor,Cindy Byrd,REP,250020,12,27,491,530,
Garvin,Attorney General,Mike Hunter,REP,250020,12,25,450,487,
Garvin,Attorney General,Mark Myles,DEM,250020,1,14,186,201,
Garvin,State Treasurer,Randy Mcdaniel,REP,250020,10,25,471,506,
Garvin,State Treasurer,Charles De Coune,IND,250020,3,11,110,124,
Garvin,Superintendent of Public Instruction,Joy Hofmeister,REP,250020,11,24,403,438,
Garvin,Superintendent of Public Instruction,John Cox,DEM,250020,1,10,176,187,
Garvin,Superintendent of Public Instruction,Larry Huff,IND,250020,1,5,51,57,
Garvin,Commissioner of Labor,Leslie Osborn,REP,250020,12,24,427,463,
Garvin,Commissioner of Labor,Fred Dorrell,DEM,250020,1,13,179,193,
Garvin,Commissioner of Labor,Brandt Dismukes,IND,250020,0,2,24,26,
Garvin,Insurance Commissioner,Glen Mulready,REP,250020,12,23,422,457,
Garvin,Insurance Commissioner,Kimberly Fobbs,DEM,250020,1,16,212,229,
Garvin,Corporation Commissioner,Bob Anthony,REP,250020,12,24,408,444,
Garvin,Corporation Commissioner,Ashley Nicole Mccray,DEM,250020,1,12,195,208,
Garvin,Corporation Commissioner,Jackie Short,IND,250020,0,3,34,37,
Garvin,U.S. House,Tom Cole,REP,250020,12,20,445,477,4
Garvin,U.S. House,Mary Brannon,DEM,250020,1,16,175,192,4
Garvin,U.S. House,Ruby Peters,IND,250020,0,3,18,21,4
Garvin,State House,Charles Mccall,REP,250020,10,19,406,435,22
Garvin,State House,Wayne Eidson,DEM,250020,1,18,200,219,22
Garvin,State House,Renae Ward,IND,250020,2,2,33,37,22
Garvin,Governor,Chris Powell,LIB,250021,0,0,1,1,
Garvin,Governor,Kevin Stitt,REP,250021,1,0,7,8,
Garvin,Governor,Drew Edmondson,DEM,250021,0,0,5,5,
Garvin,Lieutenant Governor,Matt Pinnell,REP,250021,1,0,6,7,
Garvin,Lieutenant Governor,Anastasia Pittman,DEM,250021,0,0,5,5,
Garvin,Lieutenant Governor,Ivan Holmes,IND,250021,0,0,2,2,
Garvin,State Auditor,John Yeutter,LIB,250021,0,0,5,5,
Garvin,State Auditor,Cindy Byrd,REP,250021,1,0,6,7,
Garvin,Attorney General,Mike Hunter,REP,250021,1,0,8,9,
Garvin,Attorney General,Mark Myles,DEM,250021,0,0,5,5,
Garvin,State Treasurer,Randy Mcdaniel,REP,250021,1,0,6,7,
Garvin,State Treasurer,Charles De Coune,IND,250021,0,0,4,4,
Garvin,Superintendent of Public Instruction,Joy Hofmeister,REP,250021,1,0,7,8,
Garvin,Superintendent of Public Instruction,John Cox,DEM,250021,0,0,4,4,
Garvin,Superintendent of Public Instruction,Larry Huff,IND,250021,0,0,2,2,
Garvin,Commissioner of Labor,Leslie Osborn,REP,250021,1,0,6,7,
Garvin,Commissioner of Labor,Fred Dorrell,DEM,250021,0,0,5,5,
Garvin,Commissioner of Labor,Brandt Dismukes,IND,250021,0,0,1,1,
Garvin,Insurance Commissioner,Glen Mulready,REP,250021,1,0,8,9,
Garvin,Insurance Commissioner,Kimberly Fobbs,DEM,250021,0,0,5,5,
Garvin,Corporation Commissioner,Bob Anthony,REP,250021,1,0,6,7,
Garvin,Corporation Commissioner,Ashley Nicole Mccray,DEM,250021,0,0,4,4,
Garvin,Corporation Commissioner,Jackie Short,IND,250021,0,0,3,3,
Garvin,U.S. House,Tom Cole,REP,250021,1,0,7,8,4
Garvin,U.S. House,Mary Brannon,DEM,250021,0,0,5,5,4
Garvin,U.S. House,Ruby Peters,IND,250021,0,0,1,1,4
Garvin,State House,Sherrie Conley,REP,250021,1,0,8,9,20
Garvin,State House,Steve Jarman,DEM,250021,0,0,5,5,20
Garvin,Governor,Chris Powell,LIB,250024,0,0,20,20,
Garvin,Governor,Kevin Stitt,REP,250024,2,20,324,346,
Garvin,Governor,Drew Edmondson,DEM,250024,6,14,178,198,
Garvin,Lieutenant Governor,Matt Pinnell,REP,250024,3,25,365,393,
Garvin,Lieutenant Governor,Anastasia Pittman,DEM,250024,5,9,133,147,
Garvin,Lieutenant Governor,Ivan Holmes,IND,250024,0,0,19,19,
Garvin,State Auditor,John Yeutter,LIB,250024,1,1,64,66,
Garvin,State Auditor,Cindy Byrd,REP,250024,3,26,424,453,
Garvin,Attorney General,Mike Hunter,REP,250024,3,27,374,404,
Garvin,Attorney General,Mark Myles,DEM,250024,5,7,142,154,
Garvin,State Treasurer,Randy Mcdaniel,REP,250024,3,25,405,433,
Garvin,State Treasurer,Charles De Coune,IND,250024,1,3,83,87,
Garvin,Superintendent of Public Instruction,Joy Hofmeister,REP,250024,2,25,355,382,
Garvin,Superintendent of Public Instruction,John Cox,DEM,250024,5,9,126,140,
Garvin,Superintendent of Public Instruction,Larry Huff,IND,250024,1,0,37,38,
Garvin,Commissioner of Labor,Leslie Osborn,REP,250024,3,26,361,390,
Garvin,Commissioner of Labor,Fred Dorrell,DEM,250024,5,8,127,140,
Garvin,Commissioner of Labor,Brandt Dismukes,IND,250024,0,0,26,26,
Garvin,Insurance Commissioner,Glen Mulready,REP,250024,2,22,362,386,
Garvin,Insurance Commissioner,Kimberly Fobbs,DEM,250024,6,12,153,171,
Garvin,Corporation Commissioner,Bob Anthony,REP,250024,2,27,352,381,
Garvin,Corporation Commissioner,Ashley Nicole Mccray,DEM,250024,6,7,132,145,
Garvin,Corporation Commissioner,Jackie Short,IND,250024,0,0,31,31,
Garvin,U.S. House,Tom Cole,REP,250024,3,26,385,414,4
Garvin,U.S. House,Mary Brannon,DEM,250024,5,7,124,136,4
Garvin,U.S. House,Ruby Peters,IND,250024,0,1,10,11,4
Garvin,State House,Charles Mccall,REP,250024,2,21,321,344,22
Garvin,State House,Wayne Eidson,DEM,250024,6,13,176,195,22
Garvin,State House,Renae Ward,IND,250024,0,0,21,21,22
Garvin,Governor,Chris Powell,LIB,250025,0,2,13,15,
Garvin,Governor,Kevin Stitt,REP,250025,15,21,262,298,
Garvin,Governor,Drew Edmondson,DEM,250025,6,15,86,107,
Garvin,Lieutenant Governor,Matt Pinnell,REP,250025,15,25,291,331,
Garvin,Lieutenant Governor,Anastasia Pittman,DEM,250025,6,13,54,73,
Garvin,Lieutenant Governor,Ivan Holmes,IND,250025,0,0,13,13,
Garvin,State Auditor,John Yeutter,LIB,250025,1,6,43,50,
Garvin,State Auditor,Cindy Byrd,REP,250025,17,25,309,351,
Garvin,Attorney General,Mike Hunter,REP,250025,16,22,296,334,
Garvin,Attorney General,Mark Myles,DEM,250025,5,16,64,85,
Garvin,State Treasurer,Randy Mcdaniel,REP,250025,16,26,299,341,
Garvin,State Treasurer,Charles De Coune,IND,250025,2,5,53,60,
Garvin,Superintendent of Public Instruction,Joy Hofmeister,REP,250025,15,22,265,302,
Garvin,Superintendent of Public Instruction,John Cox,DEM,250025,6,10,64,80,
Garvin,Superintendent of Public Instruction,Larry Huff,IND,250025,0,6,33,39,
Garvin,Commissioner of Labor,Leslie Osborn,REP,250025,16,24,282,322,
Garvin,Commissioner of Labor,Fred Dorrell,DEM,250025,4,12,57,73,
Garvin,Commissioner of Labor,Brandt Dismukes,IND,250025,1,1,15,17,
Garvin,Insurance Commissioner,Glen Mulready,REP,250025,14,22,282,318,
Garvin,Insurance Commissioner,Kimberly Fobbs,DEM,250025,7,15,71,93,
Garvin,Corporation Commissioner,Bob Anthony,REP,250025,15,21,280,316,
Garvin,Corporation Commissioner,Ashley Nicole Mccray,DEM,250025,6,12,57,75,
Garvin,Corporation Commissioner,Jackie Short,IND,250025,0,4,19,23,
Garvin,U.S. House,Tom Cole,REP,250025,17,24,298,339,4
Garvin,U.S. House,Mary Brannon,DEM,250025,4,13,45,62,4
Garvin,U.S. House,Ruby Peters,IND,250025,0,1,17,18,4
Garvin,State House,Sherrie Conley,REP,250025,15,21,260,296,20
Garvin,State House,Steve Jarman,DEM,250025,6,16,96,118,20
Grady,Governor,Chris Powell,LIB,260001,0,0,22,22,
Grady,Governor,Kevin Stitt,REP,260001,11,26,253,290,
Grady,Governor,Drew Edmondson,DEM,260001,11,21,174,206,
Grady,Lieutenant Governor,Matt Pinnell,REP,260001,13,31,301,345,
Grady,Lieutenant Governor,Anastasia Pittman,DEM,260001,8,13,134,155,
Grady,Lieutenant Governor,Ivan Holmes,IND,260001,0,2,11,13,
Grady,State Auditor,John Yeutter,LIB,260001,6,4,79,89,
Grady,State Auditor,Cindy Byrd,REP,260001,14,39,343,396,
Grady,Attorney General,Mike Hunter,REP,260001,11,30,312,353,
Grady,Attorney General,Mark Myles,DEM,260001,10,16,132,158,
Grady,State Treasurer,Randy Mcdaniel,REP,260001,13,33,337,383,
Grady,State Treasurer,Charles De Coune,IND,260001,7,11,80,98,
Grady,Superintendent of Public Instruction,Joy Hofmeister,REP,260001,14,34,266,314,
Grady,Superintendent of Public Instruction,John Cox,DEM,260001,7,12,146,165,
Grady,Superintendent of Public Instruction,Larry Huff,IND,260001,0,1,33,34,
Grady,Commissioner of Labor,Leslie Osborn,REP,260001,14,34,305,353,
Grady,Commissioner of Labor,Fred Dorrell,DEM,260001,7,11,113,131,
Grady,Commissioner of Labor,Brandt Dismukes,IND,260001,1,2,27,30,
Grady,Insurance Commissioner,Glen Mulready,REP,260001,12,26,310,348,
Grady,Insurance Commissioner,Kimberly Fobbs,DEM,260001,10,20,133,163,
Grady,Corporation Commissioner,Bob Anthony,REP,260001,14,32,283,329,
Grady,Corporation Commissioner,Ashley Nicole Mccray,DEM,260001,8,11,137,156,
Grady,Corporation Commissioner,Jackie Short,IND,260001,0,2,24,26,
Grady,U.S. House,Tom Cole,REP,260001,14,33,326,373,4
Grady,U.S. House,Mary Brannon,DEM,260001,8,11,104,123,4
Grady,U.S. House,Ruby Peters,IND,260001,0,2,16,18,4
Grady,State House,Charles Wells,REP,260001,9,21,199,229,56
Grady,State House,David Perryman,DEM,260001,13,24,250,287,56
Grady,Governor,Chris Powell,LIB,260002,1,2,19,22,
Grady,Governor,Kevin Stitt,REP,260002,22,49,390,461,
Grady,Governor,Drew Edmondson,DEM,260002,12,25,187,224,
Grady,Lieutenant Governor,Matt Pinnell,REP,260002,21,55,436,512,
Grady,Lieutenant Governor,Anastasia Pittman,DEM,260002,13,20,135,168,
Grady,Lieutenant Governor,Ivan Holmes,IND,260002,1,1,21,23,
Grady,State Auditor,John Yeutter,LIB,260002,6,10,75,91,
Grady,State Auditor,Cindy Byrd,REP,260002,28,60,492,580,
Grady,Attorney General,Mike Hunter,REP,260002,22,56,441,519,
Grady,Attorney General,Mark Myles,DEM,260002,13,19,144,176,
Grady,State Treasurer,Randy Mcdaniel,REP,260002,26,57,463,546,
Grady,State Treasurer,Charles De Coune,IND,260002,8,13,96,117,
Grady,Superintendent of Public Instruction,Joy Hofmeister,REP,260002,24,50,399,473,
Grady,Superintendent of Public Instruction,John Cox,DEM,260002,9,22,150,181,
Grady,Superintendent of Public Instruction,Larry Huff,IND,260002,2,4,41,47,
Grady,Commissioner of Labor,Leslie Osborn,REP,260002,24,53,441,518,
Grady,Commissioner of Labor,Fred Dorrell,DEM,260002,10,19,123,152,
Grady,Commissioner of Labor,Brandt Dismukes,IND,260002,1,4,23,28,
Grady,Insurance Commissioner,Glen Mulready,REP,260002,21,57,438,516,
Grady,Insurance Commissioner,Kimberly Fobbs,DEM,260002,13,19,145,177,
Grady,Corporation Commissioner,Bob Anthony,REP,260002,21,52,398,471,
Grady,Corporation Commissioner,Ashley Nicole Mccray,DEM,260002,13,20,153,186,
Grady,Corporation Commissioner,Jackie Short,IND,260002,1,4,36,41,
Grady,U.S. House,Tom Cole,REP,260002,23,57,449,529,4
Grady,U.S. House,Mary Brannon,DEM,260002,11,19,122,152,4
Grady,U.S. House,Ruby Peters,IND,260002,0,0,23,23,4
Grady,State House,Charles Wells,REP,260002,18,40,288,346,56
Grady,State House,David Perryman,DEM,260002,17,36,303,356,56
Grady,Governor,Chris Powell,LIB,260003,2,4,20,26,
Grady,Governor,Kevin Stitt,REP,260003,16,41,295,352,
Grady,Governor,Drew Edmondson,DEM,260003,9,22,223,254,
Grady,Lieutenant Governor,Matt Pinnell,REP,260003,19,41,346,406,
Grady,Lieutenant Governor,Anastasia Pittman,DEM,260003,8,22,172,202,
Grady,Lieutenant Governor,Ivan Holmes,IND,260003,2,4,14,20,
Grady,State Auditor,John Yeutter,LIB,260003,5,13,106,124,
Grady,State Auditor,Cindy Byrd,REP,260003,21,48,402,471,
Grady,Attorney General,Mike Hunter,REP,260003,21,43,365,429,
Grady,Attorney General,Mark Myles,DEM,260003,8,22,168,198,
Grady,State Treasurer,Randy Mcdaniel,REP,260003,20,48,392,460,
Grady,State Treasurer,Charles De Coune,IND,260003,6,13,108,127,
Grady,Superintendent of Public Instruction,Joy Hofmeister,REP,260003,21,41,308,370,
Grady,Superintendent of Public Instruction,John Cox,DEM,260003,8,21,179,208,
Grady,Superintendent of Public Instruction,Larry Huff,IND,260003,0,5,46,51,
Grady,Commissioner of Labor,Leslie Osborn,REP,260003,19,43,357,419,
Grady,Commissioner of Labor,Fred Dorrell,DEM,260003,8,21,150,179,
Grady,Commissioner of Labor,Brandt Dismukes,IND,260003,2,3,23,28,
Grady,Insurance Commissioner,Glen Mulready,REP,260003,18,42,340,400,
Grady,Insurance Commissioner,Kimberly Fobbs,DEM,260003,10,25,186,221,
Grady,Corporation Commissioner,Bob Anthony,REP,260003,20,41,331,392,
Grady,Corporation Commissioner,Ashley Nicole Mccray,DEM,260003,7,19,165,191,
Grady,Corporation Commissioner,Jackie Short,IND,260003,2,6,31,39,
Grady,U.S. House,Tom Cole,REP,260003,18,43,370,431,4
Grady,U.S. House,Mary Brannon,DEM,260003,9,19,148,176,4
Grady,U.S. House,Ruby Peters,IND,260003,1,5,15,21,4
Grady,Governor,Chris Powell,LIB,260005,1,1,17,19,
Grady,Governor,Kevin Stitt,REP,260005,3,23,130,156,
Grady,Governor,Drew Edmondson,DEM,260005,9,30,160,199,
Grady,Lieutenant Governor,Matt Pinnell,REP,260005,4,28,145,177,
Grady,Lieutenant Governor,Anastasia Pittman,DEM,260005,7,26,143,176,
Grady,Lieutenant Governor,Ivan Holmes,IND,260005,1,0,15,16,
Grady,State Auditor,John Yeutter,LIB,260005,9,16,104,129,
Grady,State Auditor,Cindy Byrd,REP,260005,4,28,178,210,
Grady,Attorney General,Mike Hunter,REP,260005,4,27,146,177,
Grady,Attorney General,Mark Myles,DEM,260005,9,27,156,192,
Grady,State Treasurer,Randy Mcdaniel,REP,260005,5,30,169,204,
Grady,State Treasurer,Charles De Coune,IND,260005,7,16,108,131,
Grady,Superintendent of Public Instruction,Joy Hofmeister,REP,260005,4,26,132,162,
Grady,Superintendent of Public Instruction,John Cox,DEM,260005,9,25,148,182,
Grady,Superintendent of Public Instruction,Larry Huff,IND,260005,0,3,24,27,
Grady,Commissioner of Labor,Leslie Osborn,REP,260005,4,27,155,186,
Grady,Commissioner of Labor,Fred Dorrell,DEM,260005,9,22,136,167,
Grady,Commissioner of Labor,Brandt Dismukes,IND,260005,0,5,12,17,
Grady,Insurance Commissioner,Glen Mulready,REP,260005,4,27,138,169,
Grady,Insurance Commissioner,Kimberly Fobbs,DEM,260005,9,27,163,199,
Grady,Corporation Commissioner,Bob Anthony,REP,260005,6,29,135,170,
Grady,Corporation Commissioner,Ashley Nicole Mccray,DEM,260005,7,23,144,174,
Grady,Corporation Commissioner,Jackie Short,IND,260005,0,2,22,24,
Grady,U.S. House,Tom Cole,REP,260005,4,30,155,189,4
Grady,U.S. House,Mary Brannon,DEM,260005,9,24,132,165,4
Grady,U.S. House,Ruby Peters,IND,260005,0,0,15,15,4
Grady,State House,Charles Wells,REP,260005,3,16,94,113,56
Grady,State House,David Perryman,DEM,260005,10,38,212,260,56
Grady,Governor,Chris Powell,LIB,260006,2,5,22,29,
Grady,Governor,Kevin Stitt,REP,260006,16,31,248,295,
Grady,Governor,Drew Edmondson,DEM,260006,22,32,146,200,
Grady,Lieutenant Governor,Matt Pinnell,REP,260006,15,35,276,326,
Grady,Lieutenant Governor,Anastasia Pittman,DEM,260006,21,29,124,174,
Grady,Lieutenant Governor,Ivan Holmes,IND,260006,4,3,14,21,
Grady,State Auditor,John Yeutter,LIB,260006,8,22,82,112,
Grady,State Auditor,Cindy Byrd,REP,260006,22,41,311,374,
Grady,Attorney General,Mike Hunter,REP,260006,22,45,280,347,
Grady,Attorney General,Mark Myles,DEM,260006,18,23,133,174,
Grady,State Treasurer,Randy Mcdaniel,REP,260006,21,40,297,358,
Grady,State Treasurer,Charles De Coune,IND,260006,9,22,97,128,
Grady,Superintendent of Public Instruction,Joy Hofmeister,REP,260006,20,28,251,299,
Grady,Superintendent of Public Instruction,John Cox,DEM,260006,15,31,122,168,
Grady,Superintendent of Public Instruction,Larry Huff,IND,260006,3,8,38,49,
Grady,Commissioner of Labor,Leslie Osborn,REP,260006,19,36,274,329,
Grady,Commissioner of Labor,Fred Dorrell,DEM,260006,16,22,110,148,
Grady,Commissioner of Labor,Brandt Dismukes,IND,260006,3,10,24,37,
Grady,Insurance Commissioner,Glen Mulready,REP,260006,21,36,275,332,
Grady,Insurance Commissioner,Kimberly Fobbs,DEM,260006,17,32,138,187,
Grady,Corporation Commissioner,Bob Anthony,REP,260006,16,35,253,304,
Grady,Corporation Commissioner,Ashley Nicole Mccray,DEM,260006,20,30,127,177,
Grady,Corporation Commissioner,Jackie Short,IND,260006,3,3,31,37,
Grady,U.S. House,Tom Cole,REP,260006,21,42,274,337,4
Grady,U.S. House,Mary Brannon,DEM,260006,15,24,118,157,4
Grady,U.S. House,Ruby Peters,IND,260006,3,2,17,22,4
Grady,State House,Charles Wells,REP,260006,17,28,200,245,56
Grady,State House,David Perryman,DEM,260006,23,40,215,278,56
Grady,Governor,Chris Powell,LIB,260008,1,0,25,26,
Grady,Governor,Kevin Stitt,REP,260008,6,30,201,237,
Grady,Governor,Drew Edmondson,DEM,260008,8,18,185,211,
Grady,Lieutenant Governor,Matt Pinnell,REP,260008,7,31,228,266,
Grady,Lieutenant Governor,Anastasia Pittman,DEM,260008,6,16,155,177,
Grady,Lieutenant Governor,Ivan Holmes,IND,260008,2,1,26,29,
Grady,State Auditor,John Yeutter,LIB,260008,6,10,123,139,
Grady,State Auditor,Cindy Byrd,REP,260008,9,35,258,302,
Grady,Attorney General,Mike Hunter,REP,260008,9,30,237,276,
Grady,Attorney General,Mark Myles,DEM,260008,6,18,168,192,
Grady,State Treasurer,Randy Mcdaniel,REP,260008,7,35,249,291,
Grady,State Treasurer,Charles De Coune,IND,260008,8,11,133,152,
Grady,Superintendent of Public Instruction,Joy Hofmeister,REP,260008,6,22,204,232,
Grady,Superintendent of Public Instruction,John Cox,DEM,260008,6,19,158,183,
Grady,Superintendent of Public Instruction,Larry Huff,IND,260008,3,7,41,51,
Grady,Commissioner of Labor,Leslie Osborn,REP,260008,5,31,235,271,
Grady,Commissioner of Labor,Fred Dorrell,DEM,260008,8,15,138,161,
Grady,Commissioner of Labor,Brandt Dismukes,IND,260008,2,1,30,33,
Grady,Insurance Commissioner,Glen Mulready,REP,260008,8,32,224,264,
Grady,Insurance Commissioner,Kimberly Fobbs,DEM,260008,7,16,177,200,
Grady,Corporation Commissioner,Bob Anthony,REP,260008,4,30,213,247,
Grady,Corporation Commissioner,Ashley Nicole Mccray,DEM,260008,9,14,161,184,
Grady,Corporation Commissioner,Jackie Short,IND,260008,2,4,30,36,
Grady,U.S. House,Tom Cole,REP,260008,7,31,235,273,4
Grady,U.S. House,Mary Brannon,DEM,260008,7,16,150,173,4
Grady,U.S. House,Ruby Peters,IND,260008,1,0,24,25,4
Grady,State House,Charles Wells,REP,260008,5,21,142,168,56
Grady,State House,David Perryman,DEM,260008,10,27,264,301,56
Grady,Governor,Chris Powell,LIB,260009,0,3,27,30,
Grady,Governor,Kevin Stitt,REP,260009,21,44,285,350,
Grady,Governor,Drew Edmondson,DEM,260009,14,42,284,340,
Grady,Lieutenant Governor,Matt Pinnell,REP,260009,23,53,337,413,
Grady,Lieutenant Governor,Anastasia Pittman,DEM,260009,11,34,237,282,
Grady,Lieutenant Governor,Ivan Holmes,IND,260009,0,2,17,19,
Grady,State Auditor,John Yeutter,LIB,260009,7,21,152,180,
Grady,State Auditor,Cindy Byrd,REP,260009,23,64,398,485,
Grady,Attorney General,Mike Hunter,REP,260009,23,53,345,421,
Grady,Attorney General,Mark Myles,DEM,260009,12,35,246,293,
Grady,State Treasurer,Randy Mcdaniel,REP,260009,25,58,373,456,
Grady,State Treasurer,Charles De Coune,IND,260009,5,26,169,200,
Grady,Superintendent of Public Instruction,Joy Hofmeister,REP,260009,20,49,323,392,
Grady,Superintendent of Public Instruction,John Cox,DEM,260009,14,35,229,278,
Grady,Superintendent of Public Instruction,Larry Huff,IND,260009,0,5,39,44,
Grady,Commissioner of Labor,Leslie Osborn,REP,260009,23,55,346,424,
Grady,Commissioner of Labor,Fred Dorrell,DEM,260009,10,32,212,254,
Grady,Commissioner of Labor,Brandt Dismukes,IND,260009,2,2,30,34,
Grady,Insurance Commissioner,Glen Mulready,REP,260009,22,51,335,408,
Grady,Insurance Commissioner,Kimberly Fobbs,DEM,260009,11,38,252,301,
Grady,Corporation Commissioner,Bob Anthony,REP,260009,21,53,329,403,
Grady,Corporation Commissioner,Ashley Nicole Mccray,DEM,260009,11,30,230,271,
Grady,Corporation Commissioner,Jackie Short,IND,260009,2,6,30,38,
Grady,U.S. House,Tom Cole,REP,260009,25,58,348,431,4
Grady,U.S. House,Mary Brannon,DEM,260009,10,31,221,262,4
Grady,U.S. House,Ruby Peters,IND,260009,0,0,22,22,4
Grady,State House,Charles Wells,REP,260009,19,40,219,278,56
Grady,State House,David Perryman,DEM,260009,15,49,374,438,56
Grady,Governor,Chris Powell,LIB,260011,1,0,13,14,
Grady,Governor,Kevin Stitt,REP,260011,11,26,172,209,
Grady,Governor,Drew Edmondson,DEM,260011,5,11,65,81,
Grady,Lieutenant Governor,Matt Pinnell,REP,260011,13,30,191,234,
Grady,Lieutenant Governor,Anastasia Pittman,DEM,260011,4,7,48,59,
Grady,Lieutenant Governor,Ivan Holmes,IND,260011,1,0,11,12,
Grady,State Auditor,John Yeutter,LIB,260011,4,6,42,52,
Grady,State Auditor,Cindy Byrd,REP,260011,13,29,201,243,
Grady,Attorney General,Mike Hunter,REP,260011,12,31,197,240,
Grady,Attorney General,Mark Myles,DEM,260011,4,6,53,63,
Grady,State Treasurer,Randy Mcdaniel,REP,260011,12,31,202,245,
Grady,State Treasurer,Charles De Coune,IND,260011,4,4,43,51,
Grady,Superintendent of Public Instruction,Joy Hofmeister,REP,260011,11,26,171,208,
Grady,Superintendent of Public Instruction,John Cox,DEM,260011,4,8,56,68,
Grady,Superintendent of Public Instruction,Larry Huff,IND,260011,3,2,24,29,
Grady,Commissioner of Labor,Leslie Osborn,REP,260011,12,31,185,228,
Grady,Commissioner of Labor,Fred Dorrell,DEM,260011,5,5,52,62,
Grady,Commissioner of Labor,Brandt Dismukes,IND,260011,0,1,14,15,
Grady,Insurance Commissioner,Glen Mulready,REP,260011,13,29,196,238,
Grady,Insurance Commissioner,Kimberly Fobbs,DEM,260011,4,8,55,67,
Grady,Corporation Commissioner,Bob Anthony,REP,260011,12,28,181,221,
Grady,Corporation Commissioner,Ashley Nicole Mccray,DEM,260011,5,8,52,65,
Grady,Corporation Commissioner,Jackie Short,IND,260011,1,1,16,18,
Grady,U.S. House,Tom Cole,REP,260011,13,32,198,243,4
Grady,U.S. House,Mary Brannon,DEM,260011,4,5,42,51,4
Grady,U.S. House,Ruby Peters,IND,260011,0,0,10,10,4
Grady,Governor,Chris Powell,LIB,260016,1,0,3,4,
Grady,Governor,Kevin Stitt,REP,260016,4,1,71,76,
Grady,Governor,Drew Edmondson,DEM,260016,3,0,26,29,
Grady,Lieutenant Governor,Matt Pinnell,REP,260016,6,1,82,89,
Grady,Lieutenant Governor,Anastasia Pittman,DEM,260016,2,0,17,19,
Grady,Lieutenant Governor,Ivan Holmes,IND,260016,0,0,2,2,
Grady,State Auditor,John Yeutter,LIB,260016,1,0,8,9,
Grady,State Auditor,Cindy Byrd,REP,260016,6,1,84,91,
Grady,Attorney General,Mike Hunter,REP,260016,4,1,83,88,
Grady,Attorney General,Mark Myles,DEM,260016,4,0,15,19,
Grady,State Treasurer,Randy Mcdaniel,REP,260016,6,1,90,97,
Grady,State Treasurer,Charles De Coune,IND,260016,1,0,7,8,
Grady,Superintendent of Public Instruction,Joy Hofmeister,REP,260016,4,1,74,79,
Grady,Superintendent of Public Instruction,John Cox,DEM,260016,3,0,14,17,
Grady,Superintendent of Public Instruction,Larry Huff,IND,260016,1,0,11,12,
Grady,Commissioner of Labor,Leslie Osborn,REP,260016,6,1,75,82,
Grady,Commissioner of Labor,Fred Dorrell,DEM,260016,2,0,22,24,
Grady,Commissioner of Labor,Brandt Dismukes,IND,260016,0,0,2,2,
Grady,Insurance Commissioner,Glen Mulready,REP,260016,4,1,79,84,
Grady,Insurance Commissioner,Kimberly Fobbs,DEM,260016,4,0,18,22,
Grady,Corporation Commissioner,Bob Anthony,REP,260016,6,1,75,82,
Grady,Corporation Commissioner,Ashley Nicole Mccray,DEM,260016,2,0,18,20,
Grady,Corporation Commissioner,Jackie Short,IND,260016,0,0,6,6,
Grady,U.S. House,Tom Cole,REP,260016,5,1,80,86,4
Grady,U.S. House,Mary Brannon,DEM,260016,3,0,18,21,4
Grady,U.S. House,Ruby Peters,IND,260016,0,0,2,2,4
Grady,Governor,Chris Powell,LIB,260017,0,0,10,10,
Grady,Governor,Kevin Stitt,REP,260017,1,8,125,134,
Grady,Governor,Drew Edmondson,DEM,260017,0,1,59,60,
Grady,Lieutenant Governor,Matt Pinnell,REP,260017,1,9,136,146,
Grady,Lieutenant Governor,Anastasia Pittman,DEM,260017,0,0,45,45,
Grady,Lieutenant Governor,Ivan Holmes,IND,260017,0,0,11,11,
Grady,State Auditor,John Yeutter,LIB,260017,0,1,41,42,
Grady,State Auditor,Cindy Byrd,REP,260017,1,7,144,152,
Grady,Attorney General,Mike Hunter,REP,260017,1,8,144,153,
Grady,Attorney General,Mark Myles,DEM,260017,0,1,48,49,
Grady,State Treasurer,Randy Mcdaniel,REP,260017,1,8,140,149,
Grady,State Treasurer,Charles De Coune,IND,260017,0,1,44,45,
Grady,Superintendent of Public Instruction,Joy Hofmeister,REP,260017,1,5,124,130,
Grady,Superintendent of Public Instruction,John Cox,DEM,260017,0,4,41,45,
Grady,Superintendent of Public Instruction,Larry Huff,IND,260017,0,0,28,28,
Grady,Commissioner of Labor,Leslie Osborn,REP,260017,1,9,138,148,
Grady,Commissioner of Labor,Fred Dorrell,DEM,260017,0,0,44,44,
Grady,Commissioner of Labor,Brandt Dismukes,IND,260017,0,0,10,10,
Grady,Insurance Commissioner,Glen Mulready,REP,260017,1,9,137,147,
Grady,Insurance Commissioner,Kimberly Fobbs,DEM,260017,0,0,55,55,
Grady,Corporation Commissioner,Bob Anthony,REP,260017,1,7,130,138,
Grady,Corporation Commissioner,Ashley Nicole Mccray,DEM,260017,0,1,48,49,
Grady,Corporation Commissioner,Jackie Short,IND,260017,0,1,14,15,
Grady,U.S. House,Tom Cole,REP,260017,1,9,139,149,4
Grady,U.S. House,Mary Brannon,DEM,260017,0,0,40,40,4
Grady,U.S. House,Ruby Peters,IND,260017,0,0,13,13,4
Grady,State House,Charles Wells,REP,260017,0,4,95,99,56
Grady,State House,David Perryman,DEM,260017,1,5,98,104,56
Grady,Governor,Chris Powell,LIB,260020,0,1,12,13,
Grady,Governor,Kevin Stitt,REP,260020,7,18,126,151,
Grady,Governor,Drew Edmondson,DEM,260020,6,9,72,87,
Grady,Lieutenant Governor,Matt Pinnell,REP,260020,7,19,141,167,
Grady,Lieutenant Governor,Anastasia Pittman,DEM,260020,5,9,54,68,
Grady,Lieutenant Governor,Ivan Holmes,IND,260020,1,0,10,11,
Grady,State Auditor,John Yeutter,LIB,260020,3,4,35,42,
Grady,State Auditor,Cindy Byrd,REP,260020,9,22,159,190,
Grady,Attorney General,Mike Hunter,REP,260020,9,19,146,174,
Grady,Attorney General,Mark Myles,DEM,260020,4,9,59,72,
Grady,State Treasurer,Randy Mcdaniel,REP,260020,10,23,156,189,
Grady,State Treasurer,Charles De Coune,IND,260020,2,3,34,39,
Grady,Superintendent of Public Instruction,Joy Hofmeister,REP,260020,5,18,131,154,
Grady,Superintendent of Public Instruction,John Cox,DEM,260020,7,9,49,65,
Grady,Superintendent of Public Instruction,Larry Huff,IND,260020,1,1,27,29,
Grady,Commissioner of Labor,Leslie Osborn,REP,260020,7,19,142,168,
Grady,Commissioner of Labor,Fred Dorrell,DEM,260020,5,8,49,62,
Grady,Commissioner of Labor,Brandt Dismukes,IND,260020,1,1,13,15,
Grady,Insurance Commissioner,Glen Mulready,REP,260020,9,20,146,175,
Grady,Insurance Commissioner,Kimberly Fobbs,DEM,260020,4,8,59,71,
Grady,Corporation Commissioner,Bob Anthony,REP,260020,8,16,129,153,
Grady,Corporation Commissioner,Ashley Nicole Mccray,DEM,260020,5,11,64,80,
Grady,Corporation Commissioner,Jackie Short,IND,260020,0,1,15,16,
Grady,U.S. House,Tom Cole,REP,260020,9,19,155,183,4
Grady,U.S. House,Mary Brannon,DEM,260020,4,9,47,60,4
Grady,U.S. House,Ruby Peters,IND,260020,0,0,7,7,4
Grady,Governor,Chris Powell,LIB,260021,1,1,17,19,
Grady,Governor,Kevin Stitt,REP,260021,5,7,121,133,
Grady,Governor,Drew Edmondson,DEM,260021,1,5,55,61,
Grady,Lieutenant Governor,Matt Pinnell,REP,260021,5,9,143,157,
Grady,Lieutenant Governor,Anastasia Pittman,DEM,260021,1,4,39,44,
Grady,Lieutenant Governor,Ivan Holmes,IND,260021,1,0,9,10,
Grady,State Auditor,John Yeutter,LIB,260021,2,2,28,32,
Grady,State Auditor,Cindy Byrd,REP,260021,4,11,156,171,
Grady,Attorney General,Mike Hunter,REP,260021,5,9,148,162,
Grady,Attorney General,Mark Myles,DEM,260021,2,4,40,46,
Grady,State Treasurer,Randy Mcdaniel,REP,260021,5,11,152,168,
Grady,State Treasurer,Charles De Coune,IND,260021,1,2,31,34,
Grady,Superintendent of Public Instruction,Joy Hofmeister,REP,260021,5,8,136,149,
Grady,Superintendent of Public Instruction,John Cox,DEM,260021,1,5,36,42,
Grady,Superintendent of Public Instruction,Larry Huff,IND,260021,1,0,18,19,
Grady,Commissioner of Labor,Leslie Osborn,REP,260021,6,9,140,155,
Grady,Commissioner of Labor,Fred Dorrell,DEM,260021,1,4,34,39,
Grady,Commissioner of Labor,Brandt Dismukes,IND,260021,0,0,14,14,
Grady,Insurance Commissioner,Glen Mulready,REP,260021,6,8,136,150,
Grady,Insurance Commissioner,Kimberly Fobbs,DEM,260021,1,5,52,58,
Grady,Corporation Commissioner,Bob Anthony,REP,260021,4,10,136,150,
Grady,Corporation Commissioner,Ashley Nicole Mccray,DEM,260021,2,3,39,44,
Grady,Corporation Commissioner,Jackie Short,IND,260021,1,0,14,15,
Grady,U.S. House,Tom Cole,REP,260021,5,10,148,163,4
Grady,U.S. House,Mary Brannon,DEM,260021,1,3,36,40,4
Grady,U.S. House,Ruby Peters,IND,260021,1,0,7,8,4
Grady,State House,Charles Wells,REP,260021,2,6,91,99,56
Grady,State House,David Perryman,DEM,260021,5,7,97,109,56
Grady,Governor,Chris Powell,LIB,260023,0,1,5,6,
Grady,Governor,Kevin Stitt,REP,260023,3,5,78,86,
Grady,Governor,Drew Edmondson,DEM,260023,3,1,17,21,
Grady,Lieutenant Governor,Matt Pinnell,REP,260023,3,5,84,92,
Grady,Lieutenant Governor,Anastasia Pittman,DEM,260023,3,2,15,20,
Grady,Lieutenant Governor,Ivan Holmes,IND,260023,0,0,2,2,
Grady,State Auditor,John Yeutter,LIB,260023,1,1,11,13,
Grady,State Auditor,Cindy Byrd,REP,260023,5,5,85,95,
Grady,Attorney General,Mike Hunter,REP,260023,3,5,83,91,
Grady,Attorney General,Mark Myles,DEM,260023,3,2,18,23,
Grady,State Treasurer,Randy Mcdaniel,REP,260023,3,5,88,96,
Grady,State Treasurer,Charles De Coune,IND,260023,3,1,7,11,
Grady,Superintendent of Public Instruction,Joy Hofmeister,REP,260023,5,5,74,84,
Grady,Superintendent of Public Instruction,John Cox,DEM,260023,1,2,22,25,
Grady,Superintendent of Public Instruction,Larry Huff,IND,260023,0,0,5,5,
Grady,Commissioner of Labor,Leslie Osborn,REP,260023,5,5,82,92,
Grady,Commissioner of Labor,Fred Dorrell,DEM,260023,1,2,17,20,
Grady,Commissioner of Labor,Brandt Dismukes,IND,260023,0,0,2,2,
Grady,Insurance Commissioner,Glen Mulready,REP,260023,3,5,80,88,
Grady,Insurance Commissioner,Kimberly Fobbs,DEM,260023,3,2,19,24,
Grady,Corporation Commissioner,Bob Anthony,REP,260023,5,5,80,90,
Grady,Corporation Commissioner,Ashley Nicole Mccray,DEM,260023,1,2,15,18,
Grady,Corporation Commissioner,Jackie Short,IND,260023,0,0,2,2,
Grady,U.S. House,Tom Cole,REP,260023,3,5,84,92,4
Grady,U.S. House,Mary Brannon,DEM,260023,3,2,15,20,4
Grady,U.S. House,Ruby Peters,IND,260023,0,0,3,3,4
Grady,Governor,Chris Powell,LIB,260025,1,1,14,16,
Grady,Governor,Kevin Stitt,REP,260025,7,24,207,238,
Grady,Governor,Drew Edmondson,DEM,260025,6,18,106,130,
Grady,Lieutenant Governor,Matt Pinnell,REP,260025,9,29,245,283,
Grady,Lieutenant Governor,Anastasia Pittman,DEM,260025,5,13,70,88,
Grady,Lieutenant Governor,Ivan Holmes,IND,260025,0,0,11,11,
Grady,State Auditor,John Yeutter,LIB,260025,3,10,51,64,
Grady,State Auditor,Cindy Byrd,REP,260025,8,30,264,302,
Grady,Attorney General,Mike Hunter,REP,260025,9,29,254,292,
Grady,Attorney General,Mark Myles,DEM,260025,5,14,73,92,
Grady,State Treasurer,Randy Mcdaniel,REP,260025,11,30,254,295,
Grady,State Treasurer,Charles De Coune,IND,260025,1,10,55,66,
Grady,Superintendent of Public Instruction,Joy Hofmeister,REP,260025,5,28,214,247,
Grady,Superintendent of Public Instruction,John Cox,DEM,260025,7,12,73,92,
Grady,Superintendent of Public Instruction,Larry Huff,IND,260025,2,3,39,44,
Grady,Commissioner of Labor,Leslie Osborn,REP,260025,9,24,228,261,
Grady,Commissioner of Labor,Fred Dorrell,DEM,260025,5,17,79,101,
Grady,Commissioner of Labor,Brandt Dismukes,IND,260025,0,2,19,21,
Grady,Insurance Commissioner,Glen Mulready,REP,260025,9,24,230,263,
Grady,Insurance Commissioner,Kimberly Fobbs,DEM,260025,5,18,93,116,
Grady,Corporation Commissioner,Bob Anthony,REP,260025,11,22,218,251,
Grady,Corporation Commissioner,Ashley Nicole Mccray,DEM,260025,3,19,86,108,
Grady,Corporation Commissioner,Jackie Short,IND,260025,0,2,19,21,
Grady,U.S. House,Tom Cole,REP,260025,9,26,249,284,4
Grady,U.S. House,Mary Brannon,DEM,260025,5,17,75,97,4
Grady,U.S. House,Ruby Peters,IND,260025,0,0,3,3,4
Grady,Governor,Chris Powell,LIB,260026,0,0,6,6,
Grady,Governor,Kevin Stitt,REP,260026,10,15,93,118,
Grady,Governor,Drew Edmondson,DEM,260026,3,4,26,33,
Grady,Lieutenant Governor,Matt Pinnell,REP,260026,12,14,99,125,
Grady,Lieutenant Governor,Anastasia Pittman,DEM,260026,1,4,22,27,
Grady,Lieutenant Governor,Ivan Holmes,IND,260026,0,1,4,5,
Grady,State Auditor,John Yeutter,LIB,260026,1,4,17,22,
Grady,State Auditor,Cindy Byrd,REP,260026,12,14,101,127,
Grady,Attorney General,Mike Hunter,REP,260026,10,14,95,119,
Grady,Attorney General,Mark Myles,DEM,260026,3,5,30,38,
Grady,State Treasurer,Randy Mcdaniel,REP,260026,11,14,101,126,
Grady,State Treasurer,Charles De Coune,IND,260026,2,4,21,27,
Grady,Superintendent of Public Instruction,Joy Hofmeister,REP,260026,11,10,84,105,
Grady,Superintendent of Public Instruction,John Cox,DEM,260026,1,7,29,37,
Grady,Superintendent of Public Instruction,Larry Huff,IND,260026,1,2,12,15,
Grady,Commissioner of Labor,Leslie Osborn,REP,260026,10,13,93,116,
Grady,Commissioner of Labor,Fred Dorrell,DEM,260026,2,6,27,35,
Grady,Commissioner of Labor,Brandt Dismukes,IND,260026,1,0,4,5,
Grady,Insurance Commissioner,Glen Mulready,REP,260026,11,14,94,119,
Grady,Insurance Commissioner,Kimberly Fobbs,DEM,260026,2,5,31,38,
Grady,Corporation Commissioner,Bob Anthony,REP,260026,11,14,94,119,
Grady,Corporation Commissioner,Ashley Nicole Mccray,DEM,260026,2,4,27,33,
Grady,Corporation Commissioner,Jackie Short,IND,260026,0,1,2,3,
Grady,U.S. House,Tom Cole,REP,260026,11,14,99,124,4
Grady,U.S. House,Mary Brannon,DEM,260026,1,5,24,30,4
Grady,U.S. House,Ruby Peters,IND,260026,1,0,2,3,4
Grady,Governor,Chris Powell,LIB,260027,2,0,8,10,
Grady,Governor,Kevin Stitt,REP,260027,7,39,160,206,
Grady,Governor,Drew Edmondson,DEM,260027,2,8,76,86,
Grady,Lieutenant Governor,Matt Pinnell,REP,260027,7,39,177,223,
Grady,Lieutenant Governor,Anastasia Pittman,DEM,260027,1,7,57,65,
Grady,Lieutenant Governor,Ivan Holmes,IND,260027,3,1,10,14,
Grady,State Auditor,John Yeutter,LIB,260027,2,9,38,49,
Grady,State Auditor,Cindy Byrd,REP,260027,9,36,196,241,
Grady,Attorney General,Mike Hunter,REP,260027,7,38,177,222,
Grady,Attorney General,Mark Myles,DEM,260027,4,9,66,79,
Grady,State Treasurer,Randy Mcdaniel,REP,260027,9,38,194,241,
Grady,State Treasurer,Charles De Coune,IND,260027,2,7,40,49,
Grady,Superintendent of Public Instruction,Joy Hofmeister,REP,260027,6,35,155,196,
Grady,Superintendent of Public Instruction,John Cox,DEM,260027,2,9,63,74,
Grady,Superintendent of Public Instruction,Larry Huff,IND,260027,3,2,25,30,
Grady,Commissioner of Labor,Leslie Osborn,REP,260027,9,35,179,223,
Grady,Commissioner of Labor,Fred Dorrell,DEM,260027,1,6,49,56,
Grady,Commissioner of Labor,Brandt Dismukes,IND,260027,1,6,14,21,
Grady,Insurance Commissioner,Glen Mulready,REP,260027,9,37,173,219,
Grady,Insurance Commissioner,Kimberly Fobbs,DEM,260027,2,9,65,76,
Grady,Corporation Commissioner,Bob Anthony,REP,260027,6,34,166,206,
Grady,Corporation Commissioner,Ashley Nicole Mccray,DEM,260027,2,9,57,68,
Grady,Corporation Commissioner,Jackie Short,IND,260027,3,4,17,24,
Grady,U.S. House,Tom Cole,REP,260027,9,39,183,231,4
Grady,U.S. House,Mary Brannon,DEM,260027,0,7,49,56,4
Grady,U.S. House,Ruby Peters,IND,260027,2,1,12,15,4
Grady,State House,Charles Wells,REP,260027,7,32,120,159,56
Grady,State House,David Perryman,DEM,260027,4,15,122,141,56
Grady,Governor,Chris Powell,LIB,260028,0,0,33,33,
Grady,Governor,Kevin Stitt,REP,260028,22,22,459,503,
Grady,Governor,Drew Edmondson,DEM,260028,13,15,203,231,
Grady,Lieutenant Governor,Matt Pinnell,REP,260028,26,21,521,568,
Grady,Lieutenant Governor,Anastasia Pittman,DEM,260028,8,15,141,164,
Grady,Lieutenant Governor,Ivan Holmes,IND,260028,1,1,24,26,
Grady,State Auditor,John Yeutter,LIB,260028,9,11,104,124,
Grady,State Auditor,Cindy Byrd,REP,260028,25,23,549,597,
Grady,Attorney General,Mike Hunter,REP,260028,26,22,523,571,
Grady,Attorney General,Mark Myles,DEM,260028,8,15,159,182,
Grady,State Treasurer,Randy Mcdaniel,REP,260028,25,23,537,585,
Grady,State Treasurer,Charles De Coune,IND,260028,9,11,111,131,
Grady,Superintendent of Public Instruction,Joy Hofmeister,REP,260028,25,17,451,493,
Grady,Superintendent of Public Instruction,John Cox,DEM,260028,9,15,163,187,
Grady,Superintendent of Public Instruction,Larry Huff,IND,260028,1,4,68,73,
Grady,Commissioner of Labor,Leslie Osborn,REP,260028,24,19,514,557,
Grady,Commissioner of Labor,Fred Dorrell,DEM,260028,8,14,124,146,
Grady,Commissioner of Labor,Brandt Dismukes,IND,260028,3,4,43,50,
Grady,Insurance Commissioner,Glen Mulready,REP,260028,25,20,515,560,
Grady,Insurance Commissioner,Kimberly Fobbs,DEM,260028,10,17,162,189,
Grady,Corporation Commissioner,Bob Anthony,REP,260028,24,19,489,532,
Grady,Corporation Commissioner,Ashley Nicole Mccray,DEM,260028,7,14,147,168,
Grady,Corporation Commissioner,Jackie Short,IND,260028,2,4,48,54,
Grady,U.S. House,Tom Cole,REP,260028,26,18,526,570,4
Grady,U.S. House,Mary Brannon,DEM,260028,7,16,130,153,4
Grady,U.S. House,Ruby Peters,IND,260028,1,3,32,36,4
Grady,Governor,Chris Powell,LIB,260029,2,0,33,35,
Grady,Governor,Kevin Stitt,REP,260029,31,17,608,656,
Grady,Governor,Drew Edmondson,DEM,260029,6,4,237,247,
Grady,Lieutenant Governor,Matt Pinnell,REP,260029,30,18,673,721,
Grady,Lieutenant Governor,Anastasia Pittman,DEM,260029,7,3,170,180,
Grady,Lieutenant Governor,Ivan Holmes,IND,260029,1,0,31,32,
Grady,State Auditor,John Yeutter,LIB,260029,6,3,125,134,
Grady,State Auditor,Cindy Byrd,REP,260029,29,18,713,760,
Grady,Attorney General,Mike Hunter,REP,260029,29,18,677,724,
Grady,Attorney General,Mark Myles,DEM,260029,9,3,189,201,
Grady,State Treasurer,Randy Mcdaniel,REP,260029,31,17,720,768,
Grady,State Treasurer,Charles De Coune,IND,260029,4,4,123,131,
Grady,Superintendent of Public Instruction,Joy Hofmeister,REP,260029,28,13,589,630,
Grady,Superintendent of Public Instruction,John Cox,DEM,260029,6,4,197,207,
Grady,Superintendent of Public Instruction,Larry Huff,IND,260029,5,4,89,98,
Grady,Commissioner of Labor,Leslie Osborn,REP,260029,32,15,675,722,
Grady,Commissioner of Labor,Fred Dorrell,DEM,260029,5,3,157,165,
Grady,Commissioner of Labor,Brandt Dismukes,IND,260029,2,2,38,42,
Grady,Insurance Commissioner,Glen Mulready,REP,260029,32,18,669,719,
Grady,Insurance Commissioner,Kimberly Fobbs,DEM,260029,7,3,191,201,
Grady,Corporation Commissioner,Bob Anthony,REP,260029,30,19,623,672,
Grady,Corporation Commissioner,Ashley Nicole Mccray,DEM,260029,6,2,197,205,
Grady,Corporation Commissioner,Jackie Short,IND,260029,3,0,51,54,
Grady,U.S. House,Tom Cole,REP,260029,30,17,679,726,4
Grady,U.S. House,Mary Brannon,DEM,260029,7,3,164,174,4
Grady,U.S. House,Ruby Peters,IND,260029,2,1,31,34,4
Grady,State House,Charles Wells,REP,260029,27,15,454,496,56
Grady,State House,David Perryman,DEM,260029,12,6,418,436,56
Grady,Governor,Chris Powell,LIB,260031,1,0,13,14,
Grady,Governor,Kevin Stitt,REP,260031,13,13,246,272,
Grady,Governor,Drew Edmondson,DEM,260031,2,5,104,111,
Grady,Lieutenant Governor,Matt Pinnell,REP,260031,13,14,253,280,
Grady,Lieutenant Governor,Anastasia Pittman,DEM,260031,2,3,90,95,
Grady,Lieutenant Governor,Ivan Holmes,IND,260031,0,0,16,16,
Grady,State Auditor,John Yeutter,LIB,260031,5,3,54,62,
Grady,State Auditor,Cindy Byrd,REP,260031,9,15,284,308,
Grady,Attorney General,Mike Hunter,REP,260031,12,14,271,297,
Grady,Attorney General,Mark Myles,DEM,260031,4,4,92,100,
Grady,State Treasurer,Randy Mcdaniel,REP,260031,12,16,272,300,
Grady,State Treasurer,Charles De Coune,IND,260031,2,2,66,70,
Grady,Superintendent of Public Instruction,Joy Hofmeister,REP,260031,11,13,236,260,
Grady,Superintendent of Public Instruction,John Cox,DEM,260031,4,3,91,98,
Grady,Superintendent of Public Instruction,Larry Huff,IND,260031,0,2,35,37,
Grady,Commissioner of Labor,Leslie Osborn,REP,260031,12,13,264,289,
Grady,Commissioner of Labor,Fred Dorrell,DEM,260031,3,3,83,89,
Grady,Commissioner of Labor,Brandt Dismukes,IND,260031,0,2,16,18,
Grady,Insurance Commissioner,Glen Mulready,REP,260031,13,14,257,284,
Grady,Insurance Commissioner,Kimberly Fobbs,DEM,260031,3,4,103,110,
Grady,Corporation Commissioner,Bob Anthony,REP,260031,10,14,254,278,
Grady,Corporation Commissioner,Ashley Nicole Mccray,DEM,260031,6,3,86,95,
Grady,Corporation Commissioner,Jackie Short,IND,260031,0,1,21,22,
Grady,U.S. House,Tom Cole,REP,260031,15,13,269,297,4
Grady,U.S. House,Mary Brannon,DEM,260031,1,5,82,88,4
Grady,U.S. House,Ruby Peters,IND,260031,0,0,11,11,4
Grady,Governor,Chris Powell,LIB,260032,0,2,28,30,
Grady,Governor,Kevin Stitt,REP,260032,23,63,381,467,
Grady,Governor,Drew Edmondson,DEM,260032,10,21,152,183,
Grady,Lieutenant Governor,Matt Pinnell,REP,260032,23,63,420,506,
Grady,Lieutenant Governor,Anastasia Pittman,DEM,260032,9,21,123,153,
Grady,Lieutenant Governor,Ivan Holmes,IND,260032,0,2,16,18,
Grady,State Auditor,John Yeutter,LIB,260032,4,13,87,104,
Grady,State Auditor,Cindy Byrd,REP,260032,25,68,449,542,
Grady,Attorney General,Mike Hunter,REP,260032,23,66,423,512,
Grady,Attorney General,Mark Myles,DEM,260032,9,18,133,160,
Grady,State Treasurer,Randy Mcdaniel,REP,260032,24,69,447,540,
Grady,State Treasurer,Charles De Coune,IND,260032,5,12,86,103,
Grady,Superintendent of Public Instruction,Joy Hofmeister,REP,260032,24,56,384,464,
Grady,Superintendent of Public Instruction,John Cox,DEM,260032,7,18,127,152,
Grady,Superintendent of Public Instruction,Larry Huff,IND,260032,2,10,47,59,
Grady,Commissioner of Labor,Leslie Osborn,REP,260032,24,61,403,488,
Grady,Commissioner of Labor,Fred Dorrell,DEM,260032,8,17,117,142,
Grady,Commissioner of Labor,Brandt Dismukes,IND,260032,0,6,34,40,
Grady,Insurance Commissioner,Glen Mulready,REP,260032,23,68,422,513,
Grady,Insurance Commissioner,Kimberly Fobbs,DEM,260032,8,17,131,156,
Grady,Corporation Commissioner,Bob Anthony,REP,260032,24,57,402,483,
Grady,Corporation Commissioner,Ashley Nicole Mccray,DEM,260032,8,20,116,144,
Grady,Corporation Commissioner,Jackie Short,IND,260032,0,8,39,47,
Grady,U.S. House,Tom Cole,REP,260032,25,62,432,519,4
Grady,U.S. House,Mary Brannon,DEM,260032,8,18,109,135,4
Grady,U.S. House,Ruby Peters,IND,260032,0,4,21,25,4
Grady,Governor,Chris Powell,LIB,260033,0,0,15,15,
Grady,Governor,Kevin Stitt,REP,260033,5,11,109,125,
Grady,Governor,Drew Edmondson,DEM,260033,2,4,48,54,
Grady,Lieutenant Governor,Matt Pinnell,REP,260033,5,12,119,136,
Grady,Lieutenant Governor,Anastasia Pittman,DEM,260033,2,3,35,40,
Grady,Lieutenant Governor,Ivan Holmes,IND,260033,0,0,17,17,
Grady,State Auditor,John Yeutter,LIB,260033,0,2,31,33,
Grady,State Auditor,Cindy Byrd,REP,260033,6,13,128,147,
Grady,Attorney General,Mike Hunter,REP,260033,6,13,125,144,
Grady,Attorney General,Mark Myles,DEM,260033,1,2,40,43,
Grady,State Treasurer,Randy Mcdaniel,REP,260033,6,14,127,147,
Grady,State Treasurer,Charles De Coune,IND,260033,0,1,29,30,
Grady,Superintendent of Public Instruction,Joy Hofmeister,REP,260033,3,12,109,124,
Grady,Superintendent of Public Instruction,John Cox,DEM,260033,3,3,43,49,
Grady,Superintendent of Public Instruction,Larry Huff,IND,260033,1,0,20,21,
Grady,Commissioner of Labor,Leslie Osborn,REP,260033,6,15,120,141,
Grady,Commissioner of Labor,Fred Dorrell,DEM,260033,1,0,36,37,
Grady,Commissioner of Labor,Brandt Dismukes,IND,260033,0,0,14,14,
Grady,Insurance Commissioner,Glen Mulready,REP,260033,6,11,114,131,
Grady,Insurance Commissioner,Kimberly Fobbs,DEM,260033,1,4,51,56,
Grady,Corporation Commissioner,Bob Anthony,REP,260033,3,12,120,135,
Grady,Corporation Commissioner,Ashley Nicole Mccray,DEM,260033,3,3,37,43,
Grady,Corporation Commissioner,Jackie Short,IND,260033,1,0,15,16,
Grady,U.S. House,Tom Cole,REP,260033,5,12,128,145,4
Grady,U.S. House,Mary Brannon,DEM,260033,2,3,34,39,4
Grady,U.S. House,Ruby Peters,IND,260033,0,0,10,10,4
Grady,State House,Charles Wells,REP,260033,4,8,85,97,56
Grady,State House,David Perryman,DEM,260033,3,7,82,92,56
Grady,Governor,Chris Powell,LIB,260035,0,0,5,5,
Grady,Governor,Kevin Stitt,REP,260035,0,4,79,83,
Grady,Governor,Drew Edmondson,DEM,260035,0,3,36,39,
Grady,Lieutenant Governor,Matt Pinnell,REP,260035,0,5,87,92,
Grady,Lieutenant Governor,Anastasia Pittman,DEM,260035,0,2,28,30,
Grady,Lieutenant Governor,Ivan Holmes,IND,260035,0,0,3,3,
Grady,State Auditor,John Yeutter,LIB,260035,0,0,21,21,
Grady,State Auditor,Cindy Byrd,REP,260035,0,6,93,99,
Grady,Attorney General,Mike Hunter,REP,260035,0,6,89,95,
Grady,Attorney General,Mark Myles,DEM,260035,0,1,30,31,
Grady,State Treasurer,Randy Mcdaniel,REP,260035,0,6,93,99,
Grady,State Treasurer,Charles De Coune,IND,260035,0,0,19,19,
Grady,Superintendent of Public Instruction,Joy Hofmeister,REP,260035,0,3,84,87,
Grady,Superintendent of Public Instruction,John Cox,DEM,260035,0,1,30,31,
Grady,Superintendent of Public Instruction,Larry Huff,IND,260035,0,3,4,7,
Grady,Commissioner of Labor,Leslie Osborn,REP,260035,0,4,94,98,
Grady,Commissioner of Labor,Fred Dorrell,DEM,260035,0,2,21,23,
Grady,Commissioner of Labor,Brandt Dismukes,IND,260035,0,1,4,5,
Grady,Insurance Commissioner,Glen Mulready,REP,260035,0,6,85,91,
Grady,Insurance Commissioner,Kimberly Fobbs,DEM,260035,0,1,33,34,
Grady,Corporation Commissioner,Bob Anthony,REP,260035,0,4,83,87,
Grady,Corporation Commissioner,Ashley Nicole Mccray,DEM,260035,0,3,33,36,
Grady,Corporation Commissioner,Jackie Short,IND,260035,0,0,2,2,
Grady,U.S. House,Tom Cole,REP,260035,0,5,87,92,4
Grady,U.S. House,Mary Brannon,DEM,260035,0,2,26,28,4
Grady,U.S. House,Ruby Peters,IND,260035,0,0,4,4,4
Grady,State House,Charles Wells,REP,260035,0,4,59,63,56
Grady,State House,David Perryman,DEM,260035,0,3,61,64,56
Grady,Governor,Chris Powell,LIB,260036,4,1,38,43,
Grady,Governor,Kevin Stitt,REP,260036,26,21,605,652,
Grady,Governor,Drew Edmondson,DEM,260036,16,4,255,275,
Grady,Lieutenant Governor,Matt Pinnell,REP,260036,34,22,657,713,
Grady,Lieutenant Governor,Anastasia Pittman,DEM,260036,9,3,207,219,
Grady,Lieutenant Governor,Ivan Holmes,IND,260036,1,1,33,35,
Grady,State Auditor,John Yeutter,LIB,260036,11,3,149,163,
Grady,State Auditor,Cindy Byrd,REP,260036,33,21,701,755,
Grady,Attorney General,Mike Hunter,REP,260036,35,22,656,713,
Grady,Attorney General,Mark Myles,DEM,260036,9,4,233,246,
Grady,State Treasurer,Randy Mcdaniel,REP,260036,35,21,712,768,
Grady,State Treasurer,Charles De Coune,IND,260036,10,3,133,146,
Grady,Superintendent of Public Instruction,Joy Hofmeister,REP,260036,29,20,583,632,
Grady,Superintendent of Public Instruction,John Cox,DEM,260036,12,4,233,249,
Grady,Superintendent of Public Instruction,Larry Huff,IND,260036,4,2,74,80,
Grady,Commissioner of Labor,Leslie Osborn,REP,260036,30,20,634,684,
Grady,Commissioner of Labor,Fred Dorrell,DEM,260036,6,4,206,216,
Grady,Commissioner of Labor,Brandt Dismukes,IND,260036,8,2,47,57,
Grady,Insurance Commissioner,Glen Mulready,REP,260036,33,22,643,698,
Grady,Insurance Commissioner,Kimberly Fobbs,DEM,260036,11,4,244,259,
Grady,Corporation Commissioner,Bob Anthony,REP,260036,32,22,615,669,
Grady,Corporation Commissioner,Ashley Nicole Mccray,DEM,260036,9,3,222,234,
Grady,Corporation Commissioner,Jackie Short,IND,260036,4,1,51,56,
Grady,U.S. House,Tom Cole,REP,260036,31,21,681,733,4
Grady,U.S. House,Mary Brannon,DEM,260036,11,3,183,197,4
Grady,U.S. House,Ruby Peters,IND,260036,3,2,32,37,4
Grady,State House,Toni Hasenbeck,REP,260036,34,21,582,637,65
Grady,State House,Brandon Thompson,DEM,260036,11,5,314,330,65
Grady,Governor,Chris Powell,LIB,260037,4,3,49,56,
Grady,Governor,Kevin Stitt,REP,260037,112,52,1109,1273,
Grady,Governor,Drew Edmondson,DEM,260037,65,18,355,438,
Grady,Lieutenant Governor,Matt Pinnell,REP,260037,127,56,1214,1397,
Grady,Lieutenant Governor,Anastasia Pittman,DEM,260037,51,17,241,309,
Grady,Lieutenant Governor,Ivan Holmes,IND,260037,2,0,48,50,
Grady,State Auditor,John Yeutter,LIB,260037,30,16,212,258,
Grady,State Auditor,Cindy Byrd,REP,260037,142,53,1242,1437,
Grady,Attorney General,Mike Hunter,REP,260037,125,57,1204,1386,
Grady,Attorney General,Mark Myles,DEM,260037,55,16,298,369,
Grady,State Treasurer,Randy Mcdaniel,REP,260037,129,53,1218,1400,
Grady,State Treasurer,Charles De Coune,IND,260037,42,18,231,291,
Grady,Superintendent of Public Instruction,Joy Hofmeister,REP,260037,130,46,1086,1262,
Grady,Superintendent of Public Instruction,John Cox,DEM,260037,43,17,268,328,
Grady,Superintendent of Public Instruction,Larry Huff,IND,260037,9,8,139,156,
Grady,Commissioner of Labor,Leslie Osborn,REP,260037,126,53,1176,1355,
Grady,Commissioner of Labor,Fred Dorrell,DEM,260037,43,12,252,307,
Grady,Commissioner of Labor,Brandt Dismukes,IND,260037,11,8,65,84,
Grady,Insurance Commissioner,Glen Mulready,REP,260037,124,57,1184,1365,
Grady,Insurance Commissioner,Kimberly Fobbs,DEM,260037,52,16,305,373,
Grady,Corporation Commissioner,Bob Anthony,REP,260037,102,52,1060,1214,
Grady,Corporation Commissioner,Ashley Nicole Mccray,DEM,260037,61,15,336,412,
Grady,Corporation Commissioner,Jackie Short,IND,260037,15,6,94,115,
Grady,U.S. House,Tom Cole,REP,260037,124,57,1195,1376,4
Grady,U.S. House,Mary Brannon,DEM,260037,47,13,255,315,4
Grady,U.S. House,Ruby Peters,IND,260037,7,3,54,64,4
Grady,Governor,Chris Powell,LIB,260038,4,2,49,55,
Grady,Governor,Kevin Stitt,REP,260038,51,33,857,941,
Grady,Governor,Drew Edmondson,DEM,260038,48,10,337,395,
Grady,Lieutenant Governor,Matt Pinnell,REP,260038,61,36,927,1024,
Grady,Lieutenant Governor,Anastasia Pittman,DEM,260038,39,8,271,318,
Grady,Lieutenant Governor,Ivan Holmes,IND,260038,3,1,39,43,
Grady,State Auditor,John Yeutter,LIB,260038,24,8,197,229,
Grady,State Auditor,Cindy Byrd,REP,260038,71,35,998,1104,
Grady,Attorney General,Mike Hunter,REP,260038,62,36,951,1049,
Grady,Attorney General,Mark Myles,DEM,260038,40,9,277,326,
Grady,State Treasurer,Randy Mcdaniel,REP,260038,64,38,971,1073,
Grady,State Treasurer,Charles De Coune,IND,260038,30,6,220,256,
Grady,Superintendent of Public Instruction,Joy Hofmeister,REP,260038,57,34,834,925,
Grady,Superintendent of Public Instruction,John Cox,DEM,260038,37,8,274,319,
Grady,Superintendent of Public Instruction,Larry Huff,IND,260038,8,3,128,139,
Grady,Commissioner of Labor,Leslie Osborn,REP,260038,59,37,918,1014,
Grady,Commissioner of Labor,Fred Dorrell,DEM,260038,40,7,236,283,
Grady,Commissioner of Labor,Brandt Dismukes,IND,260038,3,1,69,73,
Grady,Insurance Commissioner,Glen Mulready,REP,260038,62,36,919,1017,
Grady,Insurance Commissioner,Kimberly Fobbs,DEM,260038,41,9,302,352,
Grady,Corporation Commissioner,Bob Anthony,REP,260038,55,32,818,905,
Grady,Corporation Commissioner,Ashley Nicole Mccray,DEM,260038,39,11,339,389,
Grady,Corporation Commissioner,Jackie Short,IND,260038,7,1,69,77,
Grady,U.S. House,Tom Cole,REP,260038,65,35,951,1051,4
Grady,U.S. House,Mary Brannon,DEM,260038,34,9,238,281,4
Grady,U.S. House,Ruby Peters,IND,260038,5,1,44,50,4
Grady,Governor,Chris Powell,LIB,260039,0,1,33,34,
Grady,Governor,Kevin Stitt,REP,260039,37,32,621,690,
Grady,Governor,Drew Edmondson,DEM,260039,20,6,237,263,
Grady,Lieutenant Governor,Matt Pinnell,REP,260039,42,33,685,760,
Grady,Lieutenant Governor,Anastasia Pittman,DEM,260039,14,6,173,193,
Grady,Lieutenant Governor,Ivan Holmes,IND,260039,2,0,28,30,
Grady,State Auditor,John Yeutter,LIB,260039,9,5,127,141,
Grady,State Auditor,Cindy Byrd,REP,260039,45,31,716,792,
Grady,Attorney General,Mike Hunter,REP,260039,43,33,679,755,
Grady,Attorney General,Mark Myles,DEM,260039,14,5,206,225,
Grady,State Treasurer,Randy Mcdaniel,REP,260039,42,32,692,766,
Grady,State Treasurer,Charles De Coune,IND,260039,13,5,150,168,
Grady,Superintendent of Public Instruction,Joy Hofmeister,REP,260039,38,29,589,656,
Grady,Superintendent of Public Instruction,John Cox,DEM,260039,15,6,194,215,
Grady,Superintendent of Public Instruction,Larry Huff,IND,260039,4,4,98,106,
Grady,Commissioner of Labor,Leslie Osborn,REP,260039,38,30,670,738,
Grady,Commissioner of Labor,Fred Dorrell,DEM,260039,18,6,158,182,
Grady,Commissioner of Labor,Brandt Dismukes,IND,260039,1,2,41,44,
Grady,Insurance Commissioner,Glen Mulready,REP,260039,42,32,683,757,
Grady,Insurance Commissioner,Kimberly Fobbs,DEM,260039,15,5,197,217,
Grady,Corporation Commissioner,Bob Anthony,REP,260039,42,31,604,677,
Grady,Corporation Commissioner,Ashley Nicole Mccray,DEM,260039,12,4,210,226,
Grady,Corporation Commissioner,Jackie Short,IND,260039,2,4,67,73,
Grady,U.S. House,Tom Cole,REP,260039,41,32,685,758,4
Grady,U.S. House,Mary Brannon,DEM,260039,12,5,171,188,4
Grady,U.S. House,Ruby Peters,IND,260039,4,2,34,40,4
Grady,Governor,Chris Powell,LIB,260040,4,2,51,57,
Grady,Governor,Kevin Stitt,REP,260040,71,29,887,987,
Grady,Governor,Drew Edmondson,DEM,260040,29,16,337,382,
Grady,Lieutenant Governor,Matt Pinnell,REP,260040,77,34,993,1104,
Grady,Lieutenant Governor,Anastasia Pittman,DEM,260040,21,12,238,271,
Grady,Lieutenant Governor,Ivan Holmes,IND,260040,4,1,40,45,
Grady,State Auditor,John Yeutter,LIB,260040,21,13,195,229,
Grady,State Auditor,Cindy Byrd,REP,260040,77,33,1047,1157,
Grady,Attorney General,Mike Hunter,REP,260040,84,32,1013,1129,
Grady,Attorney General,Mark Myles,DEM,260040,17,15,250,282,
Grady,State Treasurer,Randy Mcdaniel,REP,260040,84,32,1036,1152,
Grady,State Treasurer,Charles De Coune,IND,260040,15,13,202,230,
Grady,Superintendent of Public Instruction,Joy Hofmeister,REP,260040,72,32,902,1006,
Grady,Superintendent of Public Instruction,John Cox,DEM,260040,22,10,236,268,
Grady,Superintendent of Public Instruction,Larry Huff,IND,260040,8,6,129,143,
Grady,Commissioner of Labor,Leslie Osborn,REP,260040,82,35,1002,1119,
Grady,Commissioner of Labor,Fred Dorrell,DEM,260040,16,11,202,229,
Grady,Commissioner of Labor,Brandt Dismukes,IND,260040,6,2,60,68,
Grady,Insurance Commissioner,Glen Mulready,REP,260040,76,31,986,1093,
Grady,Insurance Commissioner,Kimberly Fobbs,DEM,260040,25,16,270,311,
Grady,Corporation Commissioner,Bob Anthony,REP,260040,79,31,918,1028,
Grady,Corporation Commissioner,Ashley Nicole Mccray,DEM,260040,19,13,271,303,
Grady,Corporation Commissioner,Jackie Short,IND,260040,4,3,79,86,
Grady,U.S. House,Tom Cole,REP,260040,78,33,1014,1125,4
Grady,U.S. House,Mary Brannon,DEM,260040,24,14,212,250,4
Grady,U.S. House,Ruby Peters,IND,260040,1,0,46,47,4
Grady,State House,Brian Hill,REP,260040,77,30,934,1041,47
Grady,State House,Sarah Carnes,DEM,260040,24,17,327,368,47
Grady,Governor,Chris Powell,LIB,260041,1,0,44,45,
Grady,Governor,Kevin Stitt,REP,260041,69,41,922,1032,
Grady,Governor,Drew Edmondson,DEM,260041,43,16,382,441,
Grady,Lieutenant Governor,Matt Pinnell,REP,260041,74,44,1031,1149,
Grady,Lieutenant Governor,Anastasia Pittman,DEM,260041,31,12,278,321,
Grady,Lieutenant Governor,Ivan Holmes,IND,260041,4,0,36,40,
Grady,State Auditor,John Yeutter,LIB,260041,14,6,192,212,
Grady,State Auditor,Cindy Byrd,REP,260041,91,47,1091,1229,
Grady,Attorney General,Mike Hunter,REP,260041,80,43,1052,1175,
Grady,Attorney General,Mark Myles,DEM,260041,31,14,288,333,
Grady,State Treasurer,Randy Mcdaniel,REP,260041,79,41,1061,1181,
Grady,State Treasurer,Charles De Coune,IND,260041,25,12,225,262,
Grady,Superintendent of Public Instruction,Joy Hofmeister,REP,260041,79,41,949,1069,
Grady,Superintendent of Public Instruction,John Cox,DEM,260041,29,14,283,326,
Grady,Superintendent of Public Instruction,Larry Huff,IND,260041,4,2,110,116,
Grady,Commissioner of Labor,Leslie Osborn,REP,260041,88,41,1048,1177,
Grady,Commissioner of Labor,Fred Dorrell,DEM,260041,21,16,235,272,
Grady,Commissioner of Labor,Brandt Dismukes,IND,260041,2,0,56,58,
Grady,Insurance Commissioner,Glen Mulready,REP,260041,77,41,1007,1125,
Grady,Insurance Commissioner,Kimberly Fobbs,DEM,260041,28,16,321,365,
Grady,Corporation Commissioner,Bob Anthony,REP,260041,74,47,968,1089,
Grady,Corporation Commissioner,Ashley Nicole Mccray,DEM,260041,30,8,297,335,
Grady,Corporation Commissioner,Jackie Short,IND,260041,7,2,70,79,
Grady,U.S. House,Tom Cole,REP,260041,80,43,1038,1161,4
Grady,U.S. House,Mary Brannon,DEM,260041,27,14,267,308,4
Grady,U.S. House,Ruby Peters,IND,260041,4,0,39,43,4
Grady,State House,Brian Hill,REP,260041,73,42,989,1104,47
Grady,State House,Sarah Carnes,DEM,260041,32,15,343,390,47
Grant,Governor,Chris Powell,LIB,270011,0,0,3,3,
Grant,Governor,Kevin Stitt,REP,270011,1,1,56,58,
Grant,Governor,Drew Edmondson,DEM,270011,1,1,31,33,
Grant,Lieutenant Governor,Matt Pinnell,REP,270011,1,1,67,69,
Grant,Lieutenant Governor,Anastasia Pittman,DEM,270011,1,1,20,22,
Grant,Lieutenant Governor,Ivan Holmes,IND,270011,0,0,2,2,
Grant,State Auditor,John Yeutter,LIB,270011,1,0,14,15,
Grant,State Auditor,Cindy Byrd,REP,270011,1,1,74,76,
Grant,Attorney General,Mike Hunter,REP,270011,1,0,65,66,
Grant,Attorney General,Mark Myles,DEM,270011,1,1,24,26,
Grant,State Treasurer,Randy Mcdaniel,REP,270011,1,1,70,72,
Grant,State Treasurer,Charles De Coune,IND,270011,1,0,17,18,
Grant,Superintendent of Public Instruction,Joy Hofmeister,REP,270011,1,0,65,66,
Grant,Superintendent of Public Instruction,John Cox,DEM,270011,1,1,20,22,
Grant,Superintendent of Public Instruction,Larry Huff,IND,270011,0,0,4,4,
Grant,Commissioner of Labor,Leslie Osborn,REP,270011,1,0,64,65,
Grant,Commissioner of Labor,Fred Dorrell,DEM,270011,0,1,21,22,
Grant,Commissioner of Labor,Brandt Dismukes,IND,270011,1,0,4,5,
Grant,Insurance Commissioner,Glen Mulready,REP,270011,1,0,59,60,
Grant,Insurance Commissioner,Kimberly Fobbs,DEM,270011,1,1,29,31,
Grant,Corporation Commissioner,Bob Anthony,REP,270011,1,0,61,62,
Grant,Corporation Commissioner,Ashley Nicole Mccray,DEM,270011,1,1,22,24,
Grant,Corporation Commissioner,Jackie Short,IND,270011,0,0,6,6,
Grant,U.S. House,Frank Lucas,REP,270011,1,1,66,68,3
Grant,U.S. House,Frankie Robbins,DEM,270011,1,0,24,25,3
Grant,Governor,Chris Powell,LIB,270017,1,1,8,10,
Grant,Governor,Kevin Stitt,REP,270017,8,13,191,212,
Grant,Governor,Drew Edmondson,DEM,270017,2,0,31,33,
Grant,Lieutenant Governor,Matt Pinnell,REP,270017,11,13,201,225,
Grant,Lieutenant Governor,Anastasia Pittman,DEM,270017,0,0,24,24,
Grant,Lieutenant Governor,Ivan Holmes,IND,270017,0,1,4,5,
Grant,State Auditor,John Yeutter,LIB,270017,0,1,28,29,
Grant,State Auditor,Cindy Byrd,REP,270017,10,12,191,213,
Grant,Attorney General,Mike Hunter,REP,270017,10,14,199,223,
Grant,Attorney General,Mark Myles,DEM,270017,0,0,28,28,
Grant,State Treasurer,Randy Mcdaniel,REP,270017,9,12,200,221,
Grant,State Treasurer,Charles De Coune,IND,270017,0,2,21,23,
Grant,Superintendent of Public Instruction,Joy Hofmeister,REP,270017,7,11,173,191,
Grant,Superintendent of Public Instruction,John Cox,DEM,270017,3,1,27,31,
Grant,Superintendent of Public Instruction,Larry Huff,IND,270017,0,2,27,29,
Grant,Commissioner of Labor,Leslie Osborn,REP,270017,9,12,196,217,
Grant,Commissioner of Labor,Fred Dorrell,DEM,270017,0,1,20,21,
Grant,Commissioner of Labor,Brandt Dismukes,IND,270017,0,1,9,10,
Grant,Insurance Commissioner,Glen Mulready,REP,270017,7,14,195,216,
Grant,Insurance Commissioner,Kimberly Fobbs,DEM,270017,1,0,33,34,
Grant,Corporation Commissioner,Bob Anthony,REP,270017,8,13,185,206,
Grant,Corporation Commissioner,Ashley Nicole Mccray,DEM,270017,1,0,30,31,
Grant,Corporation Commissioner,Jackie Short,IND,270017,1,1,12,14,
Grant,U.S. House,Frank Lucas,REP,270017,8,14,200,222,3
Grant,U.S. House,Frankie Robbins,DEM,270017,2,0,29,31,3
Grant,Governor,Chris Powell,LIB,270023,0,0,24,24,
Grant,Governor,Kevin Stitt,REP,270023,7,15,268,290,
Grant,Governor,Drew Edmondson,DEM,270023,2,5,95,102,
Grant,Lieutenant Governor,Matt Pinnell,REP,270023,9,17,306,332,
Grant,Lieutenant Governor,Anastasia Pittman,DEM,270023,0,2,66,68,
Grant,Lieutenant Governor,Ivan Holmes,IND,270023,0,1,13,14,
Grant,State Auditor,John Yeutter,LIB,270023,0,1,50,51,
Grant,State Auditor,Cindy Byrd,REP,270023,8,19,323,350,
Grant,Attorney General,Mike Hunter,REP,270023,7,18,315,340,
Grant,Attorney General,Mark Myles,DEM,270023,1,2,69,72,
Grant,State Treasurer,Randy Mcdaniel,REP,270023,6,19,324,349,
Grant,State Treasurer,Charles De Coune,IND,270023,1,1,49,51,
Grant,Superintendent of Public Instruction,Joy Hofmeister,REP,270023,5,14,261,280,
Grant,Superintendent of Public Instruction,John Cox,DEM,270023,1,3,84,88,
Grant,Superintendent of Public Instruction,Larry Huff,IND,270023,1,3,39,43,
Grant,Commissioner of Labor,Leslie Osborn,REP,270023,8,18,304,330,
Grant,Commissioner of Labor,Fred Dorrell,DEM,270023,0,2,60,62,
Grant,Commissioner of Labor,Brandt Dismukes,IND,270023,0,0,17,17,
Grant,Insurance Commissioner,Glen Mulready,REP,270023,7,16,303,326,
Grant,Insurance Commissioner,Kimberly Fobbs,DEM,270023,1,3,77,81,
Grant,Corporation Commissioner,Bob Anthony,REP,270023,6,12,282,300,
Grant,Corporation Commissioner,Ashley Nicole Mccray,DEM,270023,0,6,81,87,
Grant,Corporation Commissioner,Jackie Short,IND,270023,2,1,19,22,
Grant,U.S. House,Frank Lucas,REP,270023,7,18,300,325,3
Grant,U.S. House,Frankie Robbins,DEM,270023,1,1,84,86,3
Grant,Governor,Chris Powell,LIB,270025,0,2,10,12,
Grant,Governor,Kevin Stitt,REP,270025,10,20,151,181,
Grant,Governor,Drew Edmondson,DEM,270025,0,0,52,52,
Grant,Lieutenant Governor,Matt Pinnell,REP,270025,9,20,166,195,
Grant,Lieutenant Governor,Anastasia Pittman,DEM,270025,0,2,37,39,
Grant,Lieutenant Governor,Ivan Holmes,IND,270025,1,0,8,9,
Grant,State Auditor,John Yeutter,LIB,270025,1,0,28,29,
Grant,State Auditor,Cindy Byrd,REP,270025,9,22,172,203,
Grant,Attorney General,Mike Hunter,REP,270025,10,19,170,199,
Grant,Attorney General,Mark Myles,DEM,270025,0,3,42,45,
Grant,State Treasurer,Randy Mcdaniel,REP,270025,9,22,174,205,
Grant,State Treasurer,Charles De Coune,IND,270025,1,0,28,29,
Grant,Superintendent of Public Instruction,Joy Hofmeister,REP,270025,9,16,159,184,
Grant,Superintendent of Public Instruction,John Cox,DEM,270025,0,3,32,35,
Grant,Superintendent of Public Instruction,Larry Huff,IND,270025,1,3,22,26,
Grant,Commissioner of Labor,Leslie Osborn,REP,270025,9,19,166,194,
Grant,Commissioner of Labor,Fred Dorrell,DEM,270025,0,1,33,34,
Grant,Commissioner of Labor,Brandt Dismukes,IND,270025,1,1,9,11,
Grant,Insurance Commissioner,Glen Mulready,REP,270025,10,18,169,197,
Grant,Insurance Commissioner,Kimberly Fobbs,DEM,270025,0,4,38,42,
Grant,Corporation Commissioner,Bob Anthony,REP,270025,10,16,159,185,
Grant,Corporation Commissioner,Ashley Nicole Mccray,DEM,270025,0,3,39,42,
Grant,Corporation Commissioner,Jackie Short,IND,270025,0,3,13,16,
Grant,U.S. House,Frank Lucas,REP,270025,10,19,175,204,3
Grant,U.S. House,Frankie Robbins,DEM,270025,0,3,38,41,3
Grant,Governor,Chris Powell,LIB,270026,0,0,4,4,
Grant,Governor,Kevin Stitt,REP,270026,2,6,155,163,
Grant,Governor,Drew Edmondson,DEM,270026,0,3,36,39,
Grant,Lieutenant Governor,Matt Pinnell,REP,270026,2,5,160,167,
Grant,Lieutenant Governor,Anastasia Pittman,DEM,270026,0,4,23,27,
Grant,Lieutenant Governor,Ivan Holmes,IND,270026,0,0,11,11,
Grant,State Auditor,John Yeutter,LIB,270026,0,0,29,29,
Grant,State Auditor,Cindy Byrd,REP,270026,2,9,165,176,
Grant,Attorney General,Mike Hunter,REP,270026,2,6,168,176,
Grant,Attorney General,Mark Myles,DEM,270026,0,3,28,31,
Grant,State Treasurer,Randy Mcdaniel,REP,270026,2,6,161,169,
Grant,State Treasurer,Charles De Coune,IND,270026,0,3,32,35,
Grant,Superintendent of Public Instruction,Joy Hofmeister,REP,270026,2,6,142,150,
Grant,Superintendent of Public Instruction,John Cox,DEM,270026,0,1,36,37,
Grant,Superintendent of Public Instruction,Larry Huff,IND,270026,0,2,19,21,
Grant,Commissioner of Labor,Leslie Osborn,REP,270026,2,6,156,164,
Grant,Commissioner of Labor,Fred Dorrell,DEM,270026,0,2,29,31,
Grant,Commissioner of Labor,Brandt Dismukes,IND,270026,0,1,12,13,
Grant,Insurance Commissioner,Glen Mulready,REP,270026,2,5,161,168,
Grant,Insurance Commissioner,Kimberly Fobbs,DEM,270026,0,4,34,38,
Grant,Corporation Commissioner,Bob Anthony,REP,270026,2,5,152,159,
Grant,Corporation Commissioner,Ashley Nicole Mccray,DEM,270026,0,3,26,29,
Grant,Corporation Commissioner,Jackie Short,IND,270026,0,1,17,18,
Grant,U.S. House,Frank Lucas,REP,270026,2,6,166,174,3
Grant,U.S. House,Frankie Robbins,DEM,270026,0,3,29,32,3
Grant,Governor,Chris Powell,LIB,270029,0,0,3,3,
Grant,Governor,Kevin Stitt,REP,270029,1,15,114,130,
Grant,Governor,Drew Edmondson,DEM,270029,6,5,24,35,
Grant,Lieutenant Governor,Matt Pinnell,REP,270029,3,13,111,127,
Grant,Lieutenant Governor,Anastasia Pittman,DEM,270029,4,5,19,28,
Grant,Lieutenant Governor,Ivan Holmes,IND,270029,0,2,10,12,
Grant,State Auditor,John Yeutter,LIB,270029,2,2,16,20,
Grant,State Auditor,Cindy Byrd,REP,270029,5,16,123,144,
Grant,Attorney General,Mike Hunter,REP,270029,5,17,118,140,
Grant,Attorney General,Mark Myles,DEM,270029,2,3,20,25,
Grant,State Treasurer,Randy Mcdaniel,REP,270029,4,17,117,138,
Grant,State Treasurer,Charles De Coune,IND,270029,3,1,20,24,
Grant,Superintendent of Public Instruction,Joy Hofmeister,REP,270029,5,13,106,124,
Grant,Superintendent of Public Instruction,John Cox,DEM,270029,2,4,21,27,
Grant,Superintendent of Public Instruction,Larry Huff,IND,270029,0,3,13,16,
Grant,Commissioner of Labor,Leslie Osborn,REP,270029,3,15,116,134,
Grant,Commissioner of Labor,Fred Dorrell,DEM,270029,4,4,19,27,
Grant,Commissioner of Labor,Brandt Dismukes,IND,270029,0,0,5,5,
Grant,Insurance Commissioner,Glen Mulready,REP,270029,3,15,116,134,
Grant,Insurance Commissioner,Kimberly Fobbs,DEM,270029,4,4,23,31,
Grant,Corporation Commissioner,Bob Anthony,REP,270029,3,16,110,129,
Grant,Corporation Commissioner,Ashley Nicole Mccray,DEM,270029,3,2,21,26,
Grant,Corporation Commissioner,Jackie Short,IND,270029,1,2,9,12,
Grant,U.S. House,Frank Lucas,REP,270029,4,17,112,133,3
Grant,U.S. House,Frankie Robbins,DEM,270029,3,3,28,34,3
Grant,Governor,Chris Powell,LIB,270030,0,1,19,20,
Grant,Governor,Kevin Stitt,REP,270030,8,23,185,216,
Grant,Governor,Drew Edmondson,DEM,270030,1,11,72,84,
Grant,Lieutenant Governor,Matt Pinnell,REP,270030,9,28,204,241,
Grant,Lieutenant Governor,Anastasia Pittman,DEM,270030,0,7,52,59,
Grant,Lieutenant Governor,Ivan Holmes,IND,270030,0,1,15,16,
Grant,State Auditor,John Yeutter,LIB,270030,0,4,48,52,
Grant,State Auditor,Cindy Byrd,REP,270030,9,32,215,256,
Grant,Attorney General,Mike Hunter,REP,270030,9,28,207,244,
Grant,Attorney General,Mark Myles,DEM,270030,0,8,62,70,
Grant,State Treasurer,Randy Mcdaniel,REP,270030,9,31,211,251,
Grant,State Treasurer,Charles De Coune,IND,270030,0,5,46,51,
Grant,Superintendent of Public Instruction,Joy Hofmeister,REP,270030,7,29,184,220,
Grant,Superintendent of Public Instruction,John Cox,DEM,270030,2,5,60,67,
Grant,Superintendent of Public Instruction,Larry Huff,IND,270030,0,2,28,30,
Grant,Commissioner of Labor,Leslie Osborn,REP,270030,9,30,194,233,
Grant,Commissioner of Labor,Fred Dorrell,DEM,270030,0,4,56,60,
Grant,Commissioner of Labor,Brandt Dismukes,IND,270030,0,2,15,17,
Grant,Insurance Commissioner,Glen Mulready,REP,270030,9,28,200,237,
Grant,Insurance Commissioner,Kimberly Fobbs,DEM,270030,0,8,67,75,
Grant,Corporation Commissioner,Bob Anthony,REP,270030,9,27,187,223,
Grant,Corporation Commissioner,Ashley Nicole Mccray,DEM,270030,0,6,69,75,
Grant,Corporation Commissioner,Jackie Short,IND,270030,0,3,14,17,
Grant,U.S. House,Frank Lucas,REP,270030,9,18,193,220,3
Grant,U.S. House,Frankie Robbins,DEM,270030,0,18,83,101,3
Greer,Governor,Chris Powell,LIB,280101,0,2,20,22,
Greer,Governor,Kevin Stitt,REP,280101,10,29,169,208,
Greer,Governor,Drew Edmondson,DEM,280101,1,16,93,110,
Greer,Lieutenant Governor,Matt Pinnell,REP,280101,11,29,182,222,
Greer,Lieutenant Governor,Anastasia Pittman,DEM,280101,0,17,89,106,
Greer,Lieutenant Governor,Ivan Holmes,IND,280101,0,0,7,7,
Greer,State Auditor,John Yeutter,LIB,280101,1,6,51,58,
Greer,State Auditor,Cindy Byrd,REP,280101,10,34,207,251,
Greer,Attorney General,Mike Hunter,REP,280101,11,30,193,234,
Greer,Attorney General,Mark Myles,DEM,280101,0,17,85,102,
Greer,State Treasurer,Randy Mcdaniel,REP,280101,11,34,200,245,
Greer,State Treasurer,Charles De Coune,IND,280101,0,7,62,69,
Greer,Superintendent of Public Instruction,Joy Hofmeister,REP,280101,9,31,171,211,
Greer,Superintendent of Public Instruction,John Cox,DEM,280101,1,13,87,101,
Greer,Superintendent of Public Instruction,Larry Huff,IND,280101,1,2,20,23,
Greer,Commissioner of Labor,Leslie Osborn,REP,280101,10,33,184,227,
Greer,Commissioner of Labor,Fred Dorrell,DEM,280101,1,11,83,95,
Greer,Commissioner of Labor,Brandt Dismukes,IND,280101,0,0,7,7,
Greer,Insurance Commissioner,Glen Mulready,REP,280101,11,28,187,226,
Greer,Insurance Commissioner,Kimberly Fobbs,DEM,280101,0,16,87,103,
Greer,Corporation Commissioner,Bob Anthony,REP,280101,11,26,186,223,
Greer,Corporation Commissioner,Ashley Nicole Mccray,DEM,280101,0,16,82,98,
Greer,Corporation Commissioner,Jackie Short,IND,280101,0,2,9,11,
Greer,U.S. House,Frank Lucas,REP,280101,11,33,199,243,3
Greer,U.S. House,Frankie Robbins,DEM,280101,0,13,80,93,3
Greer,State Senate,Brent Howard,REP,280101,9,29,172,210,38
Greer,State Senate,Jeff Berrong,DEM,280101,2,16,109,127,38
Greer,Governor,Chris Powell,LIB,280102,1,3,13,17,
Greer,Governor,Kevin Stitt,REP,280102,11,40,221,272,
Greer,Governor,Drew Edmondson,DEM,280102,7,10,130,147,
Greer,Lieutenant Governor,Matt Pinnell,REP,280102,9,41,251,301,
Greer,Lieutenant Governor,Anastasia Pittman,DEM,280102,10,10,97,117,
Greer,Lieutenant Governor,Ivan Holmes,IND,280102,0,2,14,16,
Greer,State Auditor,John Yeutter,LIB,280102,3,9,68,80,
Greer,State Auditor,Cindy Byrd,REP,280102,14,42,269,325,
Greer,Attorney General,Mike Hunter,REP,280102,13,42,254,309,
Greer,Attorney General,Mark Myles,DEM,280102,6,11,108,125,
Greer,State Treasurer,Randy Mcdaniel,REP,280102,15,45,270,330,
Greer,State Treasurer,Charles De Coune,IND,280102,1,6,71,78,
Greer,Superintendent of Public Instruction,Joy Hofmeister,REP,280102,8,40,230,278,
Greer,Superintendent of Public Instruction,John Cox,DEM,280102,9,7,100,116,
Greer,Superintendent of Public Instruction,Larry Huff,IND,280102,2,6,32,40,
Greer,Commissioner of Labor,Leslie Osborn,REP,280102,14,42,236,292,
Greer,Commissioner of Labor,Fred Dorrell,DEM,280102,5,10,100,115,
Greer,Commissioner of Labor,Brandt Dismukes,IND,280102,0,1,25,26,
Greer,Insurance Commissioner,Glen Mulready,REP,280102,12,42,239,293,
Greer,Insurance Commissioner,Kimberly Fobbs,DEM,280102,5,11,120,136,
Greer,Corporation Commissioner,Bob Anthony,REP,280102,12,37,240,289,
Greer,Corporation Commissioner,Ashley Nicole Mccray,DEM,280102,6,12,101,119,
Greer,Corporation Commissioner,Jackie Short,IND,280102,0,4,20,24,
Greer,U.S. House,Frank Lucas,REP,280102,14,44,269,327,3
Greer,U.S. House,Frankie Robbins,DEM,280102,5,9,95,109,3
Greer,State Senate,Brent Howard,REP,280102,11,38,227,276,38
Greer,State Senate,Jeff Berrong,DEM,280102,8,15,136,159,38
Greer,Governor,Chris Powell,LIB,280103,0,0,0,0,
Greer,Governor,Kevin Stitt,REP,280103,0,2,12,14,
Greer,Governor,Drew Edmondson,DEM,280103,1,1,4,6,
Greer,Lieutenant Governor,Matt Pinnell,REP,280103,0,2,12,14,
Greer,Lieutenant Governor,Anastasia Pittman,DEM,280103,1,1,4,6,
Greer,Lieutenant Governor,Ivan Holmes,IND,280103,0,0,0,0,
Greer,State Auditor,John Yeutter,LIB,280103,0,0,3,3,
Greer,State Auditor,Cindy Byrd,REP,280103,1,3,13,17,
Greer,Attorney General,Mike Hunter,REP,280103,1,2,10,13,
Greer,Attorney General,Mark Myles,DEM,280103,0,1,6,7,
Greer,State Treasurer,Randy Mcdaniel,REP,280103,0,2,13,15,
Greer,State Treasurer,Charles De Coune,IND,280103,1,1,3,5,
Greer,Superintendent of Public Instruction,Joy Hofmeister,REP,280103,1,2,12,15,
Greer,Superintendent of Public Instruction,John Cox,DEM,280103,0,1,3,4,
Greer,Superintendent of Public Instruction,Larry Huff,IND,280103,0,0,1,1,
Greer,Commissioner of Labor,Leslie Osborn,REP,280103,0,1,10,11,
Greer,Commissioner of Labor,Fred Dorrell,DEM,280103,0,1,5,6,
Greer,Commissioner of Labor,Brandt Dismukes,IND,280103,1,1,0,2,
Greer,Insurance Commissioner,Glen Mulready,REP,280103,0,2,12,14,
Greer,Insurance Commissioner,Kimberly Fobbs,DEM,280103,1,1,4,6,
Greer,Corporation Commissioner,Bob Anthony,REP,280103,0,2,12,14,
Greer,Corporation Commissioner,Ashley Nicole Mccray,DEM,280103,1,1,3,5,
Greer,Corporation Commissioner,Jackie Short,IND,280103,0,0,1,1,
Greer,U.S. House,Frank Lucas,REP,280103,0,2,12,14,3
Greer,U.S. House,Frankie Robbins,DEM,280103,1,1,4,6,3
Greer,State Senate,Brent Howard,REP,280103,1,2,11,14,38
Greer,State Senate,Jeff Berrong,DEM,280103,0,1,5,6,38
Greer,Governor,Chris Powell,LIB,280105,0,0,2,2,
Greer,Governor,Kevin Stitt,REP,280105,2,9,43,54,
Greer,Governor,Drew Edmondson,DEM,280105,0,1,19,20,
Greer,Lieutenant Governor,Matt Pinnell,REP,280105,2,9,45,56,
Greer,Lieutenant Governor,Anastasia Pittman,DEM,280105,0,1,15,16,
Greer,Lieutenant Governor,Ivan Holmes,IND,280105,0,0,2,2,
Greer,State Auditor,John Yeutter,LIB,280105,0,1,11,12,
Greer,State Auditor,Cindy Byrd,REP,280105,2,9,51,62,
Greer,Attorney General,Mike Hunter,REP,280105,2,9,51,62,
Greer,Attorney General,Mark Myles,DEM,280105,0,1,12,13,
Greer,State Treasurer,Randy Mcdaniel,REP,280105,2,9,49,60,
Greer,State Treasurer,Charles De Coune,IND,280105,0,1,11,12,
Greer,Superintendent of Public Instruction,Joy Hofmeister,REP,280105,2,8,39,49,
Greer,Superintendent of Public Instruction,John Cox,DEM,280105,0,1,19,20,
Greer,Superintendent of Public Instruction,Larry Huff,IND,280105,0,1,6,7,
Greer,Commissioner of Labor,Leslie Osborn,REP,280105,2,9,43,54,
Greer,Commissioner of Labor,Fred Dorrell,DEM,280105,0,1,13,14,
Greer,Commissioner of Labor,Brandt Dismukes,IND,280105,0,0,5,5,
Greer,Insurance Commissioner,Glen Mulready,REP,280105,2,9,45,56,
Greer,Insurance Commissioner,Kimberly Fobbs,DEM,280105,0,1,15,16,
Greer,Corporation Commissioner,Bob Anthony,REP,280105,2,8,48,58,
Greer,Corporation Commissioner,Ashley Nicole Mccray,DEM,280105,0,2,12,14,
Greer,Corporation Commissioner,Jackie Short,IND,280105,0,0,5,5,
Greer,U.S. House,Frank Lucas,REP,280105,2,9,51,62,3
Greer,U.S. House,Frankie Robbins,DEM,280105,0,1,12,13,3
Greer,State Senate,Brent Howard,REP,280105,2,9,44,55,38
Greer,State Senate,Jeff Berrong,DEM,280105,0,1,20,21,38
Greer,State House,Todd Russ,REP,280105,2,9,42,53,55
Greer,State House,Dennis Dugger,DEM,280105,0,1,22,23,55
Greer,Governor,Chris Powell,LIB,280106,0,0,1,1,
Greer,Governor,Kevin Stitt,REP,280106,2,6,51,59,
Greer,Governor,Drew Edmondson,DEM,280106,0,3,15,18,
Greer,Lieutenant Governor,Matt Pinnell,REP,280106,2,6,51,59,
Greer,Lieutenant Governor,Anastasia Pittman,DEM,280106,0,3,9,12,
Greer,Lieutenant Governor,Ivan Holmes,IND,280106,0,0,6,6,
Greer,State Auditor,John Yeutter,LIB,280106,0,1,8,9,
Greer,State Auditor,Cindy Byrd,REP,280106,2,7,56,65,
Greer,Attorney General,Mike Hunter,REP,280106,2,6,54,62,
Greer,Attorney General,Mark Myles,DEM,280106,0,3,12,15,
Greer,State Treasurer,Randy Mcdaniel,REP,280106,2,7,54,63,
Greer,State Treasurer,Charles De Coune,IND,280106,0,1,10,11,
Greer,Superintendent of Public Instruction,Joy Hofmeister,REP,280106,2,7,48,57,
Greer,Superintendent of Public Instruction,John Cox,DEM,280106,0,2,7,9,
Greer,Superintendent of Public Instruction,Larry Huff,IND,280106,0,0,11,11,
Greer,Commissioner of Labor,Leslie Osborn,REP,280106,2,6,48,56,
Greer,Commissioner of Labor,Fred Dorrell,DEM,280106,0,3,14,17,
Greer,Commissioner of Labor,Brandt Dismukes,IND,280106,0,0,4,4,
Greer,Insurance Commissioner,Glen Mulready,REP,280106,2,6,53,61,
Greer,Insurance Commissioner,Kimberly Fobbs,DEM,280106,0,3,13,16,
Greer,Corporation Commissioner,Bob Anthony,REP,280106,2,6,51,59,
Greer,Corporation Commissioner,Ashley Nicole Mccray,DEM,280106,0,3,8,11,
Greer,Corporation Commissioner,Jackie Short,IND,280106,0,0,6,6,
Greer,U.S. House,Frank Lucas,REP,280106,2,6,58,66,3
Greer,U.S. House,Frankie Robbins,DEM,280106,0,3,9,12,3
Greer,State Senate,Brent Howard,REP,280106,2,6,56,64,38
Greer,State Senate,Jeff Berrong,DEM,280106,0,3,11,14,38
Greer,Governor,Chris Powell,LIB,280202,0,0,12,12,
Greer,Governor,Kevin Stitt,REP,280202,9,6,212,227,
Greer,Governor,Drew Edmondson,DEM,280202,1,7,96,104,
Greer,Lieutenant Governor,Matt Pinnell,REP,280202,8,7,245,260,
Greer,Lieutenant Governor,Anastasia Pittman,DEM,280202,2,6,56,64,
Greer,Lieutenant Governor,Ivan Holmes,IND,280202,0,0,19,19,
Greer,State Auditor,John Yeutter,LIB,280202,1,0,51,52,
Greer,State Auditor,Cindy Byrd,REP,280202,9,11,256,276,
Greer,Attorney General,Mike Hunter,REP,280202,10,8,247,265,
Greer,Attorney General,Mark Myles,DEM,280202,0,5,71,76,
Greer,State Treasurer,Randy Mcdaniel,REP,280202,9,9,266,284,
Greer,State Treasurer,Charles De Coune,IND,280202,1,3,44,48,
Greer,Superintendent of Public Instruction,Joy Hofmeister,REP,280202,9,7,234,250,
Greer,Superintendent of Public Instruction,John Cox,DEM,280202,0,5,57,62,
Greer,Superintendent of Public Instruction,Larry Huff,IND,280202,1,1,30,32,
Greer,Commissioner of Labor,Leslie Osborn,REP,280202,9,6,240,255,
Greer,Commissioner of Labor,Fred Dorrell,DEM,280202,1,7,59,67,
Greer,Commissioner of Labor,Brandt Dismukes,IND,280202,0,0,18,18,
Greer,Insurance Commissioner,Glen Mulready,REP,280202,8,7,239,254,
Greer,Insurance Commissioner,Kimberly Fobbs,DEM,280202,2,6,76,84,
Greer,Corporation Commissioner,Bob Anthony,REP,280202,8,7,238,253,
Greer,Corporation Commissioner,Ashley Nicole Mccray,DEM,280202,2,5,58,65,
Greer,Corporation Commissioner,Jackie Short,IND,280202,0,1,24,25,
Greer,U.S. House,Frank Lucas,REP,280202,9,8,255,272,3
Greer,U.S. House,Frankie Robbins,DEM,280202,1,5,65,71,3
Greer,State Senate,Brent Howard,REP,280202,8,11,221,240,38
Greer,State Senate,Jeff Berrong,DEM,280202,2,2,98,102,38
Greer,Governor,Chris Powell,LIB,280203,0,0,4,4,
Greer,Governor,Kevin Stitt,REP,280203,4,7,77,88,
Greer,Governor,Drew Edmondson,DEM,280203,3,3,38,44,
Greer,Lieutenant Governor,Matt Pinnell,REP,280203,4,9,82,95,
Greer,Lieutenant Governor,Anastasia Pittman,DEM,280203,3,1,30,34,
Greer,Lieutenant Governor,Ivan Holmes,IND,280203,0,0,4,4,
Greer,State Auditor,John Yeutter,LIB,280203,2,0,19,21,
Greer,State Auditor,Cindy Byrd,REP,280203,5,10,92,107,
Greer,Attorney General,Mike Hunter,REP,280203,4,10,91,105,
Greer,Attorney General,Mark Myles,DEM,280203,3,0,26,29,
Greer,State Treasurer,Randy Mcdaniel,REP,280203,6,10,92,108,
Greer,State Treasurer,Charles De Coune,IND,280203,1,0,18,19,
Greer,Superintendent of Public Instruction,Joy Hofmeister,REP,280203,4,10,86,100,
Greer,Superintendent of Public Instruction,John Cox,DEM,280203,3,0,24,27,
Greer,Superintendent of Public Instruction,Larry Huff,IND,280203,0,0,9,9,
Greer,Commissioner of Labor,Leslie Osborn,REP,280203,4,9,75,88,
Greer,Commissioner of Labor,Fred Dorrell,DEM,280203,3,1,35,39,
Greer,Commissioner of Labor,Brandt Dismukes,IND,280203,0,0,4,4,
Greer,Insurance Commissioner,Glen Mulready,REP,280203,4,9,80,93,
Greer,Insurance Commissioner,Kimberly Fobbs,DEM,280203,3,1,33,37,
Greer,Corporation Commissioner,Bob Anthony,REP,280203,4,9,78,91,
Greer,Corporation Commissioner,Ashley Nicole Mccray,DEM,280203,3,1,32,36,
Greer,Corporation Commissioner,Jackie Short,IND,280203,0,0,7,7,
Greer,U.S. House,Frank Lucas,REP,280203,4,8,97,109,3
Greer,U.S. House,Frankie Robbins,DEM,280203,3,2,23,28,3
Greer,State Senate,Brent Howard,REP,280203,3,7,78,88,38
Greer,State Senate,Jeff Berrong,DEM,280203,4,3,39,46,38
Greer,State House,Todd Russ,REP,280203,3,8,71,82,55
Greer,State House,Dennis Dugger,DEM,280203,4,2,49,55,55
Greer,Governor,Chris Powell,LIB,280302,0,0,0,0,
Greer,Governor,Kevin Stitt,REP,280302,1,0,23,24,
Greer,Governor,Drew Edmondson,DEM,280302,0,4,16,20,
Greer,Lieutenant Governor,Matt Pinnell,REP,280302,1,1,22,24,
Greer,Lieutenant Governor,Anastasia Pittman,DEM,280302,0,3,14,17,
Greer,Lieutenant Governor,Ivan Holmes,IND,280302,0,0,2,2,
Greer,State Auditor,John Yeutter,LIB,280302,0,0,11,11,
Greer,State Auditor,Cindy Byrd,REP,280302,1,2,23,26,
Greer,Attorney General,Mike Hunter,REP,280302,0,2,24,26,
Greer,Attorney General,Mark Myles,DEM,280302,1,2,13,16,
Greer,State Treasurer,Randy Mcdaniel,REP,280302,1,1,25,27,
Greer,State Treasurer,Charles De Coune,IND,280302,0,1,9,10,
Greer,Superintendent of Public Instruction,Joy Hofmeister,REP,280302,0,2,22,24,
Greer,Superintendent of Public Instruction,John Cox,DEM,280302,1,2,10,13,
Greer,Superintendent of Public Instruction,Larry Huff,IND,280302,0,0,7,7,
Greer,Commissioner of Labor,Leslie Osborn,REP,280302,1,1,19,21,
Greer,Commissioner of Labor,Fred Dorrell,DEM,280302,0,3,17,20,
Greer,Commissioner of Labor,Brandt Dismukes,IND,280302,0,0,1,1,
Greer,Insurance Commissioner,Glen Mulready,REP,280302,0,0,20,20,
Greer,Insurance Commissioner,Kimberly Fobbs,DEM,280302,1,4,15,20,
Greer,Corporation Commissioner,Bob Anthony,REP,280302,0,2,20,22,
Greer,Corporation Commissioner,Ashley Nicole Mccray,DEM,280302,1,2,12,15,
Greer,Corporation Commissioner,Jackie Short,IND,280302,0,0,4,4,
Greer,U.S. House,Frank Lucas,REP,280302,0,3,26,29,3
Greer,U.S. House,Frankie Robbins,DEM,280302,1,1,12,14,3
Greer,State Senate,Brent Howard,REP,280302,0,0,17,17,38
Greer,State Senate,Jeff Berrong,DEM,280302,1,4,19,24,38
Greer,State House,Todd Russ,REP,280302,0,2,19,21,55
Greer,State House,Dennis Dugger,DEM,280302,1,2,18,21,55
Harmon,Governor,Chris Powell,LIB,290101,0,0,2,2,
Harmon,Governor,Kevin Stitt,REP,290101,0,3,18,21,
Harmon,Governor,Drew Edmondson,DEM,290101,0,4,15,19,
Harmon,Lieutenant Governor,Matt Pinnell,REP,290101,0,4,23,27,
Harmon,Lieutenant Governor,Anastasia Pittman,DEM,290101,0,3,12,15,
Harmon,Lieutenant Governor,Ivan Holmes,IND,290101,0,0,0,0,
Harmon,State Auditor,John Yeutter,LIB,290101,0,0,7,7,
Harmon,State Auditor,Cindy Byrd,REP,290101,0,7,20,27,
Harmon,Attorney General,Mike Hunter,REP,290101,0,6,18,24,
Harmon,Attorney General,Mark Myles,DEM,290101,0,1,17,18,
Harmon,State Treasurer,Randy Mcdaniel,REP,290101,0,7,19,26,
Harmon,State Treasurer,Charles De Coune,IND,290101,0,0,11,11,
Harmon,Superintendent of Public Instruction,Joy Hofmeister,REP,290101,0,5,22,27,
Harmon,Superintendent of Public Instruction,John Cox,DEM,290101,0,2,11,13,
Harmon,Superintendent of Public Instruction,Larry Huff,IND,290101,0,0,2,2,
Harmon,Commissioner of Labor,Leslie Osborn,REP,290101,0,5,16,21,
Harmon,Commissioner of Labor,Fred Dorrell,DEM,290101,0,2,18,20,
Harmon,Commissioner of Labor,Brandt Dismukes,IND,290101,0,0,1,1,
Harmon,Insurance Commissioner,Glen Mulready,REP,290101,0,4,14,18,
Harmon,Insurance Commissioner,Kimberly Fobbs,DEM,290101,0,3,21,24,
Harmon,Corporation Commissioner,Bob Anthony,REP,290101,0,5,19,24,
Harmon,Corporation Commissioner,Ashley Nicole Mccray,DEM,290101,0,2,16,18,
Harmon,Corporation Commissioner,Jackie Short,IND,290101,0,0,0,0,
Harmon,U.S. House,Frank Lucas,REP,290101,0,7,23,30,3
Harmon,U.S. House,Frankie Robbins,DEM,290101,0,0,12,12,3
Harmon,State Senate,Brent Howard,REP,290101,0,5,16,21,38
Harmon,State Senate,Jeff Berrong,DEM,290101,0,2,19,21,38
Harmon,Governor,Chris Powell,LIB,290102,0,0,11,11,
Harmon,Governor,Kevin Stitt,REP,290102,3,19,142,164,
Harmon,Governor,Drew Edmondson,DEM,290102,3,5,79,87,
Harmon,Lieutenant Governor,Matt Pinnell,REP,290102,5,20,168,193,
Harmon,Lieutenant Governor,Anastasia Pittman,DEM,290102,1,4,55,60,
Harmon,Lieutenant Governor,Ivan Holmes,IND,290102,0,0,5,5,
Harmon,State Auditor,John Yeutter,LIB,290102,0,3,34,37,
Harmon,State Auditor,Cindy Byrd,REP,290102,5,21,179,205,
Harmon,Attorney General,Mike Hunter,REP,290102,5,23,168,196,
Harmon,Attorney General,Mark Myles,DEM,290102,1,1,57,59,
Harmon,State Treasurer,Randy Mcdaniel,REP,290102,5,22,186,213,
Harmon,State Treasurer,Charles De Coune,IND,290102,0,2,33,35,
Harmon,Superintendent of Public Instruction,Joy Hofmeister,REP,290102,5,21,150,176,
Harmon,Superintendent of Public Instruction,John Cox,DEM,290102,1,1,61,63,
Harmon,Superintendent of Public Instruction,Larry Huff,IND,290102,0,2,17,19,
Harmon,Commissioner of Labor,Leslie Osborn,REP,290102,5,19,151,175,
Harmon,Commissioner of Labor,Fred Dorrell,DEM,290102,1,2,67,70,
Harmon,Commissioner of Labor,Brandt Dismukes,IND,290102,0,3,7,10,
Harmon,Insurance Commissioner,Glen Mulready,REP,290102,5,22,152,179,
Harmon,Insurance Commissioner,Kimberly Fobbs,DEM,290102,1,2,73,76,
Harmon,Corporation Commissioner,Bob Anthony,REP,290102,5,22,156,183,
Harmon,Corporation Commissioner,Ashley Nicole Mccray,DEM,290102,1,1,60,62,
Harmon,Corporation Commissioner,Jackie Short,IND,290102,0,1,11,12,
Harmon,U.S. House,Frank Lucas,REP,290102,5,23,178,206,3
Harmon,U.S. House,Frankie Robbins,DEM,290102,1,1,51,53,3
Harmon,State Senate,Brent Howard,REP,290102,5,20,141,166,38
Harmon,State Senate,Jeff Berrong,DEM,290102,1,4,90,95,38
Harmon,Governor,Chris Powell,LIB,290201,0,1,4,5,
Harmon,Governor,Kevin Stitt,REP,290201,2,19,72,93,
Harmon,Governor,Drew Edmondson,DEM,290201,2,6,72,80,
Harmon,Lieutenant Governor,Matt Pinnell,REP,290201,2,22,87,111,
Harmon,Lieutenant Governor,Anastasia Pittman,DEM,290201,2,3,53,58,
Harmon,Lieutenant Governor,Ivan Holmes,IND,290201,0,1,5,6,
Harmon,State Auditor,John Yeutter,LIB,290201,0,1,37,38,
Harmon,State Auditor,Cindy Byrd,REP,290201,2,22,98,122,
Harmon,Attorney General,Mike Hunter,REP,290201,3,23,87,113,
Harmon,Attorney General,Mark Myles,DEM,290201,1,3,59,63,
Harmon,State Treasurer,Randy Mcdaniel,REP,290201,2,23,98,123,
Harmon,State Treasurer,Charles De Coune,IND,290201,0,0,42,42,
Harmon,Superintendent of Public Instruction,Joy Hofmeister,REP,290201,2,19,87,108,
Harmon,Superintendent of Public Instruction,John Cox,DEM,290201,2,5,47,54,
Harmon,Superintendent of Public Instruction,Larry Huff,IND,290201,0,2,15,17,
Harmon,Commissioner of Labor,Leslie Osborn,REP,290201,2,22,82,106,
Harmon,Commissioner of Labor,Fred Dorrell,DEM,290201,2,4,56,62,
Harmon,Commissioner of Labor,Brandt Dismukes,IND,290201,0,0,6,6,
Harmon,Insurance Commissioner,Glen Mulready,REP,290201,3,20,75,98,
Harmon,Insurance Commissioner,Kimberly Fobbs,DEM,290201,1,6,70,77,
Harmon,Corporation Commissioner,Bob Anthony,REP,290201,3,22,78,103,
Harmon,Corporation Commissioner,Ashley Nicole Mccray,DEM,290201,1,3,63,67,
Harmon,Corporation Commissioner,Jackie Short,IND,290201,0,1,7,8,
Harmon,U.S. House,Frank Lucas,REP,290201,3,23,97,123,3
Harmon,U.S. House,Frankie Robbins,DEM,290201,1,3,51,55,3
Harmon,State Senate,Brent Howard,REP,290201,2,20,76,98,38
Harmon,State Senate,Jeff Berrong,DEM,290201,2,6,73,81,38
Harmon,Governor,Chris Powell,LIB,290203,1,1,2,4,
Harmon,Governor,Kevin Stitt,REP,290203,0,1,9,10,
Harmon,Governor,Drew Edmondson,DEM,290203,0,3,3,6,
Harmon,Lieutenant Governor,Matt Pinnell,REP,290203,0,2,10,12,
Harmon,Lieutenant Governor,Anastasia Pittman,DEM,290203,0,2,3,5,
Harmon,Lieutenant Governor,Ivan Holmes,IND,290203,1,1,1,3,
Harmon,State Auditor,John Yeutter,LIB,290203,0,1,2,3,
Harmon,State Auditor,Cindy Byrd,REP,290203,1,4,12,17,
Harmon,Attorney General,Mike Hunter,REP,290203,1,3,12,16,
Harmon,Attorney General,Mark Myles,DEM,290203,0,2,2,4,
Harmon,State Treasurer,Randy Mcdaniel,REP,290203,1,3,11,15,
Harmon,State Treasurer,Charles De Coune,IND,290203,0,2,3,5,
Harmon,Superintendent of Public Instruction,Joy Hofmeister,REP,290203,0,1,10,11,
Harmon,Superintendent of Public Instruction,John Cox,DEM,290203,0,3,1,4,
Harmon,Superintendent of Public Instruction,Larry Huff,IND,290203,1,1,3,5,
Harmon,Commissioner of Labor,Leslie Osborn,REP,290203,0,2,9,11,
Harmon,Commissioner of Labor,Fred Dorrell,DEM,290203,0,3,3,6,
Harmon,Commissioner of Labor,Brandt Dismukes,IND,290203,1,0,1,2,
Harmon,Insurance Commissioner,Glen Mulready,REP,290203,1,2,11,14,
Harmon,Insurance Commissioner,Kimberly Fobbs,DEM,290203,0,3,3,6,
Harmon,Corporation Commissioner,Bob Anthony,REP,290203,0,2,10,12,
Harmon,Corporation Commissioner,Ashley Nicole Mccray,DEM,290203,0,1,3,4,
Harmon,Corporation Commissioner,Jackie Short,IND,290203,1,2,1,4,
Harmon,U.S. House,Frank Lucas,REP,290203,1,3,12,16,3
Harmon,U.S. House,Frankie Robbins,DEM,290203,0,2,2,4,3
Harmon,State Senate,Brent Howard,REP,290203,1,1,11,13,38
Harmon,State Senate,Jeff Berrong,DEM,290203,0,4,3,7,38
Harmon,Governor,Chris Powell,LIB,290204,0,0,0,0,
Harmon,Governor,Kevin Stitt,REP,290204,0,1,10,11,
Harmon,Governor,Drew Edmondson,DEM,290204,0,1,5,6,
Harmon,Lieutenant Governor,Matt Pinnell,REP,290204,0,1,15,16,
Harmon,Lieutenant Governor,Anastasia Pittman,DEM,290204,0,1,0,1,
Harmon,Lieutenant Governor,Ivan Holmes,IND,290204,0,0,0,0,
Harmon,State Auditor,John Yeutter,LIB,290204,0,0,0,0,
Harmon,State Auditor,Cindy Byrd,REP,290204,0,2,14,16,
Harmon,Attorney General,Mike Hunter,REP,290204,0,1,14,15,
Harmon,Attorney General,Mark Myles,DEM,290204,0,1,1,2,
Harmon,State Treasurer,Randy Mcdaniel,REP,290204,0,2,15,17,
Harmon,State Treasurer,Charles De Coune,IND,290204,0,0,0,0,
Harmon,Superintendent of Public Instruction,Joy Hofmeister,REP,290204,0,2,13,15,
Harmon,Superintendent of Public Instruction,John Cox,DEM,290204,0,0,2,2,
Harmon,Superintendent of Public Instruction,Larry Huff,IND,290204,0,0,0,0,
Harmon,Commissioner of Labor,Leslie Osborn,REP,290204,0,1,12,13,
Harmon,Commissioner of Labor,Fred Dorrell,DEM,290204,0,1,3,4,
Harmon,Commissioner of Labor,Brandt Dismukes,IND,290204,0,0,0,0,
Harmon,Insurance Commissioner,Glen Mulready,REP,290204,0,1,13,14,
Harmon,Insurance Commissioner,Kimberly Fobbs,DEM,290204,0,1,1,2,
Harmon,Corporation Commissioner,Bob Anthony,REP,290204,0,1,12,13,
Harmon,Corporation Commissioner,Ashley Nicole Mccray,DEM,290204,0,1,0,1,
Harmon,Corporation Commissioner,Jackie Short,IND,290204,0,0,0,0,
Harmon,U.S. House,Frank Lucas,REP,290204,0,1,12,13,3
Harmon,U.S. House,Frankie Robbins,DEM,290204,0,1,2,3,3
Harmon,State Senate,Brent Howard,REP,290204,0,1,11,12,38
Harmon,State Senate,Jeff Berrong,DEM,290204,0,1,4,5,38
Harmon,Governor,Chris Powell,LIB,290301,0,0,1,1,
Harmon,Governor,Kevin Stitt,REP,290301,3,12,50,65,
Harmon,Governor,Drew Edmondson,DEM,290301,1,6,44,51,
Harmon,Lieutenant Governor,Matt Pinnell,REP,290301,3,12,54,69,
Harmon,Lieutenant Governor,Anastasia Pittman,DEM,290301,0,6,38,44,
Harmon,Lieutenant Governor,Ivan Holmes,IND,290301,1,0,3,4,
Harmon,State Auditor,John Yeutter,LIB,290301,1,0,22,23,
Harmon,State Auditor,Cindy Byrd,REP,290301,3,13,62,78,
Harmon,Attorney General,Mike Hunter,REP,290301,4,11,60,75,
Harmon,Attorney General,Mark Myles,DEM,290301,0,7,35,42,
Harmon,State Treasurer,Randy Mcdaniel,REP,290301,4,12,67,83,
Harmon,State Treasurer,Charles De Coune,IND,290301,0,1,19,20,
Harmon,Superintendent of Public Instruction,Joy Hofmeister,REP,290301,4,10,51,65,
Harmon,Superintendent of Public Instruction,John Cox,DEM,290301,0,7,38,45,
Harmon,Superintendent of Public Instruction,Larry Huff,IND,290301,0,1,6,7,
Harmon,Commissioner of Labor,Leslie Osborn,REP,290301,4,12,50,66,
Harmon,Commissioner of Labor,Fred Dorrell,DEM,290301,0,6,42,48,
Harmon,Commissioner of Labor,Brandt Dismukes,IND,290301,0,0,3,3,
Harmon,Insurance Commissioner,Glen Mulready,REP,290301,4,11,54,69,
Harmon,Insurance Commissioner,Kimberly Fobbs,DEM,290301,0,7,40,47,
Harmon,Corporation Commissioner,Bob Anthony,REP,290301,4,12,52,68,
Harmon,Corporation Commissioner,Ashley Nicole Mccray,DEM,290301,0,6,38,44,
Harmon,Corporation Commissioner,Jackie Short,IND,290301,0,0,3,3,
Harmon,U.S. House,Frank Lucas,REP,290301,4,12,62,78,3
Harmon,U.S. House,Frankie Robbins,DEM,290301,0,6,32,38,3
Harmon,State Senate,Brent Howard,REP,290301,4,11,56,71,38
Harmon,State Senate,Jeff Berrong,DEM,290301,0,7,38,45,38
Harmon,Governor,Chris Powell,LIB,290302,0,0,3,3,
Harmon,Governor,Kevin Stitt,REP,290302,1,2,76,79,
Harmon,Governor,Drew Edmondson,DEM,290302,2,2,24,28,
Harmon,Lieutenant Governor,Matt Pinnell,REP,290302,1,3,86,90,
Harmon,Lieutenant Governor,Anastasia Pittman,DEM,290302,2,1,14,17,
Harmon,Lieutenant Governor,Ivan Holmes,IND,290302,0,0,1,1,
Harmon,State Auditor,John Yeutter,LIB,290302,0,0,7,7,
Harmon,State Auditor,Cindy Byrd,REP,290302,1,3,87,91,
Harmon,Attorney General,Mike Hunter,REP,290302,1,3,85,89,
Harmon,Attorney General,Mark Myles,DEM,290302,2,1,17,20,
Harmon,State Treasurer,Randy Mcdaniel,REP,290302,1,3,84,88,
Harmon,State Treasurer,Charles De Coune,IND,290302,0,0,12,12,
Harmon,Superintendent of Public Instruction,Joy Hofmeister,REP,290302,1,3,79,83,
Harmon,Superintendent of Public Instruction,John Cox,DEM,290302,2,1,16,19,
Harmon,Superintendent of Public Instruction,Larry Huff,IND,290302,0,0,8,8,
Harmon,Commissioner of Labor,Leslie Osborn,REP,290302,1,3,80,84,
Harmon,Commissioner of Labor,Fred Dorrell,DEM,290302,2,1,19,22,
Harmon,Commissioner of Labor,Brandt Dismukes,IND,290302,0,0,1,1,
Harmon,Insurance Commissioner,Glen Mulready,REP,290302,1,3,82,86,
Harmon,Insurance Commissioner,Kimberly Fobbs,DEM,290302,2,1,19,22,
Harmon,Corporation Commissioner,Bob Anthony,REP,290302,1,3,81,85,
Harmon,Corporation Commissioner,Ashley Nicole Mccray,DEM,290302,2,1,19,22,
Harmon,Corporation Commissioner,Jackie Short,IND,290302,0,0,1,1,
Harmon,U.S. House,Frank Lucas,REP,290302,1,3,89,93,3
Harmon,U.S. House,Frankie Robbins,DEM,290302,2,1,14,17,3
Harmon,State Senate,Brent Howard,REP,290302,1,2,80,83,38
Harmon,State Senate,Jeff Berrong,DEM,290302,2,2,24,28,38
Harper,Governor,Chris Powell,LIB,300201,0,1,16,17,
Harper,Governor,Kevin Stitt,REP,300201,10,16,343,369,
Harper,Governor,Drew Edmondson,DEM,300201,3,0,68,71,
Harper,Lieutenant Governor,Matt Pinnell,REP,300201,11,17,369,397,
Harper,Lieutenant Governor,Anastasia Pittman,DEM,300201,1,0,44,45,
Harper,Lieutenant Governor,Ivan Holmes,IND,300201,1,0,10,11,
Harper,State Auditor,John Yeutter,LIB,300201,2,0,48,50,
Harper,State Auditor,Cindy Byrd,REP,300201,11,17,368,396,
Harper,Attorney General,Mike Hunter,REP,300201,10,15,370,395,
Harper,Attorney General,Mark Myles,DEM,300201,3,2,54,59,
Harper,State Treasurer,Randy Mcdaniel,REP,300201,10,16,380,406,
Harper,State Treasurer,Charles De Coune,IND,300201,3,1,36,40,
Harper,Superintendent of Public Instruction,Joy Hofmeister,REP,300201,10,13,325,348,
Harper,Superintendent of Public Instruction,John Cox,DEM,300201,3,2,72,77,
Harper,Superintendent of Public Instruction,Larry Huff,IND,300201,0,2,27,29,
Harper,Commissioner of Labor,Leslie Osborn,REP,300201,12,16,368,396,
Harper,Commissioner of Labor,Fred Dorrell,DEM,300201,1,1,45,47,
Harper,Commissioner of Labor,Brandt Dismukes,IND,300201,0,0,8,8,
Harper,Insurance Commissioner,Glen Mulready,REP,300201,11,17,359,387,
Harper,Insurance Commissioner,Kimberly Fobbs,DEM,300201,1,0,56,57,
Harper,Corporation Commissioner,Bob Anthony,REP,300201,10,16,340,366,
Harper,Corporation Commissioner,Ashley Nicole Mccray,DEM,300201,2,0,62,64,
Harper,Corporation Commissioner,Jackie Short,IND,300201,1,1,19,21,
Harper,U.S. House,Frank Lucas,REP,300201,12,17,378,407,3
Harper,U.S. House,Frankie Robbins,DEM,300201,1,0,47,48,3
Harper,State House,Kenton Patzkowsky,REP,300201,7,14,271,292,61
Harper,State House,Ashley Lehnert,DEM,300201,6,3,156,165,61
Harper,Governor,Chris Powell,LIB,300203,0,0,2,2,
Harper,Governor,Kevin Stitt,REP,300203,6,3,73,82,
Harper,Governor,Drew Edmondson,DEM,300203,0,1,9,10,
Harper,Lieutenant Governor,Matt Pinnell,REP,300203,6,3,73,82,
Harper,Lieutenant Governor,Anastasia Pittman,DEM,300203,0,1,9,10,
Harper,Lieutenant Governor,Ivan Holmes,IND,300203,0,0,1,1,
Harper,State Auditor,John Yeutter,LIB,300203,0,0,5,5,
Harper,State Auditor,Cindy Byrd,REP,300203,6,4,78,88,
Harper,Attorney General,Mike Hunter,REP,300203,5,4,75,84,
Harper,Attorney General,Mark Myles,DEM,300203,1,0,8,9,
Harper,State Treasurer,Randy Mcdaniel,REP,300203,6,4,78,88,
Harper,State Treasurer,Charles De Coune,IND,300203,0,0,4,4,
Harper,Superintendent of Public Instruction,Joy Hofmeister,REP,300203,4,1,65,70,
Harper,Superintendent of Public Instruction,John Cox,DEM,300203,0,3,11,14,
Harper,Superintendent of Public Instruction,Larry Huff,IND,300203,2,0,8,10,
Harper,Commissioner of Labor,Leslie Osborn,REP,300203,5,3,75,83,
Harper,Commissioner of Labor,Fred Dorrell,DEM,300203,1,1,6,8,
Harper,Commissioner of Labor,Brandt Dismukes,IND,300203,0,0,3,3,
Harper,Insurance Commissioner,Glen Mulready,REP,300203,5,1,71,77,
Harper,Insurance Commissioner,Kimberly Fobbs,DEM,300203,1,3,13,17,
Harper,Corporation Commissioner,Bob Anthony,REP,300203,4,3,71,78,
Harper,Corporation Commissioner,Ashley Nicole Mccray,DEM,300203,0,1,10,11,
Harper,Corporation Commissioner,Jackie Short,IND,300203,2,0,3,5,
Harper,U.S. House,Frank Lucas,REP,300203,6,4,78,88,3
Harper,U.S. House,Frankie Robbins,DEM,300203,0,0,6,6,3
Harper,State House,Kenton Patzkowsky,REP,300203,6,1,64,71,61
Harper,State House,Ashley Lehnert,DEM,300203,0,3,20,23,61
Harper,Governor,Chris Powell,LIB,300301,0,0,4,4,
Harper,Governor,Kevin Stitt,REP,300301,5,22,143,170,
Harper,Governor,Drew Edmondson,DEM,300301,1,7,45,53,
Harper,Lieutenant Governor,Matt Pinnell,REP,300301,5,21,157,183,
Harper,Lieutenant Governor,Anastasia Pittman,DEM,300301,1,8,25,34,
Harper,Lieutenant Governor,Ivan Holmes,IND,300301,0,0,7,7,
Harper,State Auditor,John Yeutter,LIB,300301,1,5,20,26,
Harper,State Auditor,Cindy Byrd,REP,300301,5,22,164,191,
Harper,Attorney General,Mike Hunter,REP,300301,4,21,151,176,
Harper,Attorney General,Mark Myles,DEM,300301,2,7,38,47,
Harper,State Treasurer,Randy Mcdaniel,REP,300301,5,21,164,190,
Harper,State Treasurer,Charles De Coune,IND,300301,1,5,19,25,
Harper,Superintendent of Public Instruction,Joy Hofmeister,REP,300301,4,21,147,172,
Harper,Superintendent of Public Instruction,John Cox,DEM,300301,2,7,37,46,
Harper,Superintendent of Public Instruction,Larry Huff,IND,300301,0,1,7,8,
Harper,Commissioner of Labor,Leslie Osborn,REP,300301,4,22,156,182,
Harper,Commissioner of Labor,Fred Dorrell,DEM,300301,2,5,25,32,
Harper,Commissioner of Labor,Brandt Dismukes,IND,300301,0,2,8,10,
Harper,Insurance Commissioner,Glen Mulready,REP,300301,4,19,148,171,
Harper,Insurance Commissioner,Kimberly Fobbs,DEM,300301,2,9,39,50,
Harper,Corporation Commissioner,Bob Anthony,REP,300301,4,18,150,172,
Harper,Corporation Commissioner,Ashley Nicole Mccray,DEM,300301,1,10,33,44,
Harper,Corporation Commissioner,Jackie Short,IND,300301,1,1,6,8,
Harper,U.S. House,Frank Lucas,REP,300301,5,24,169,198,3
Harper,U.S. House,Frankie Robbins,DEM,300301,1,5,22,28,3
Harper,State House,Kenton Patzkowsky,REP,300301,5,15,134,154,61
Harper,State House,Ashley Lehnert,DEM,300301,1,14,57,72,61
Harper,Governor,Chris Powell,LIB,300302,0,0,1,1,
Harper,Governor,Kevin Stitt,REP,300302,3,4,36,43,
Harper,Governor,Drew Edmondson,DEM,300302,0,1,5,6,
Harper,Lieutenant Governor,Matt Pinnell,REP,300302,3,4,35,42,
Harper,Lieutenant Governor,Anastasia Pittman,DEM,300302,0,1,4,5,
Harper,Lieutenant Governor,Ivan Holmes,IND,300302,0,0,4,4,
Harper,State Auditor,John Yeutter,LIB,300302,0,0,4,4,
Harper,State Auditor,Cindy Byrd,REP,300302,3,4,38,45,
Harper,Attorney General,Mike Hunter,REP,300302,3,2,38,43,
Harper,Attorney General,Mark Myles,DEM,300302,0,3,5,8,
Harper,State Treasurer,Randy Mcdaniel,REP,300302,3,4,39,46,
Harper,State Treasurer,Charles De Coune,IND,300302,0,1,4,5,
Harper,Superintendent of Public Instruction,Joy Hofmeister,REP,300302,3,4,30,37,
Harper,Superintendent of Public Instruction,John Cox,DEM,300302,0,1,9,10,
Harper,Superintendent of Public Instruction,Larry Huff,IND,300302,0,0,4,4,
Harper,Commissioner of Labor,Leslie Osborn,REP,300302,3,4,37,44,
Harper,Commissioner of Labor,Fred Dorrell,DEM,300302,0,1,5,6,
Harper,Commissioner of Labor,Brandt Dismukes,IND,300302,0,0,1,1,
Harper,Insurance Commissioner,Glen Mulready,REP,300302,3,3,37,43,
Harper,Insurance Commissioner,Kimberly Fobbs,DEM,300302,0,1,4,5,
Harper,Corporation Commissioner,Bob Anthony,REP,300302,2,4,37,43,
Harper,Corporation Commissioner,Ashley Nicole Mccray,DEM,300302,0,1,2,3,
Harper,Corporation Commissioner,Jackie Short,IND,300302,1,0,4,5,
Harper,U.S. House,Frank Lucas,REP,300302,3,4,40,47,3
Harper,U.S. House,Frankie Robbins,DEM,300302,0,1,2,3,3
Harper,State House,Kenton Patzkowsky,REP,300302,3,3,36,42,61
Harper,State House,Ashley Lehnert,DEM,300302,0,2,6,8,61
Harper,Governor,Chris Powell,LIB,300303,0,0,2,2,
Harper,Governor,Kevin Stitt,REP,300303,2,11,74,87,
Harper,Governor,Drew Edmondson,DEM,300303,0,5,14,19,
Harper,Lieutenant Governor,Matt Pinnell,REP,300303,2,11,78,91,
Harper,Lieutenant Governor,Anastasia Pittman,DEM,300303,0,5,10,15,
Harper,Lieutenant Governor,Ivan Holmes,IND,300303,0,0,2,2,
Harper,State Auditor,John Yeutter,LIB,300303,0,3,5,8,
Harper,State Auditor,Cindy Byrd,REP,300303,2,12,85,99,
Harper,Attorney General,Mike Hunter,REP,300303,2,10,83,95,
Harper,Attorney General,Mark Myles,DEM,300303,0,6,7,13,
Harper,State Treasurer,Randy Mcdaniel,REP,300303,2,14,83,99,
Harper,State Treasurer,Charles De Coune,IND,300303,0,1,7,8,
Harper,Superintendent of Public Instruction,Joy Hofmeister,REP,300303,2,11,72,85,
Harper,Superintendent of Public Instruction,John Cox,DEM,300303,0,4,14,18,
Harper,Superintendent of Public Instruction,Larry Huff,IND,300303,0,1,4,5,
Harper,Commissioner of Labor,Leslie Osborn,REP,300303,2,12,82,96,
Harper,Commissioner of Labor,Fred Dorrell,DEM,300303,0,4,6,10,
Harper,Commissioner of Labor,Brandt Dismukes,IND,300303,0,0,2,2,
Harper,Insurance Commissioner,Glen Mulready,REP,300303,2,14,79,95,
Harper,Insurance Commissioner,Kimberly Fobbs,DEM,300303,0,2,11,13,
Harper,Corporation Commissioner,Bob Anthony,REP,300303,2,12,78,92,
Harper,Corporation Commissioner,Ashley Nicole Mccray,DEM,300303,0,4,10,14,
Harper,Corporation Commissioner,Jackie Short,IND,300303,0,0,2,2,
Harper,U.S. House,Frank Lucas,REP,300303,2,15,83,100,3
Harper,U.S. House,Frankie Robbins,DEM,300303,0,1,7,8,3
Harper,State House,Kenton Patzkowsky,REP,300303,2,13,70,85,61
Harper,State House,Ashley Lehnert,DEM,300303,0,3,20,23,61
Harper,Governor,Chris Powell,LIB,300402,1,2,19,22,
Harper,Governor,Kevin Stitt,REP,300402,7,28,162,197,
Harper,Governor,Drew Edmondson,DEM,300402,4,9,42,55,
Harper,Lieutenant Governor,Matt Pinnell,REP,300402,8,35,178,221,
Harper,Lieutenant Governor,Anastasia Pittman,DEM,300402,4,4,34,42,
Harper,Lieutenant Governor,Ivan Holmes,IND,300402,0,1,12,13,
Harper,State Auditor,John Yeutter,LIB,300402,1,4,25,30,
Harper,State Auditor,Cindy Byrd,REP,300402,8,36,193,237,
Harper,Attorney General,Mike Hunter,REP,300402,9,35,188,232,
Harper,Attorney General,Mark Myles,DEM,300402,3,5,34,42,
Harper,State Treasurer,Randy Mcdaniel,REP,300402,7,34,198,239,
Harper,State Treasurer,Charles De Coune,IND,300402,3,4,21,28,
Harper,Superintendent of Public Instruction,Joy Hofmeister,REP,300402,9,31,166,206,
Harper,Superintendent of Public Instruction,John Cox,DEM,300402,3,5,36,44,
Harper,Superintendent of Public Instruction,Larry Huff,IND,300402,0,4,19,23,
Harper,Commissioner of Labor,Leslie Osborn,REP,300402,8,33,182,223,
Harper,Commissioner of Labor,Fred Dorrell,DEM,300402,4,4,30,38,
Harper,Commissioner of Labor,Brandt Dismukes,IND,300402,0,2,8,10,
Harper,Insurance Commissioner,Glen Mulready,REP,300402,7,33,187,227,
Harper,Insurance Commissioner,Kimberly Fobbs,DEM,300402,5,6,35,46,
Harper,Corporation Commissioner,Bob Anthony,REP,300402,9,35,172,216,
Harper,Corporation Commissioner,Ashley Nicole Mccray,DEM,300402,3,3,34,40,
Harper,Corporation Commissioner,Jackie Short,IND,300402,0,2,16,18,
Harper,U.S. House,Frank Lucas,REP,300402,9,36,195,240,3
Harper,U.S. House,Frankie Robbins,DEM,300402,3,4,26,33,3
Harper,State House,Kenton Patzkowsky,REP,300402,8,30,161,199,61
Harper,State House,Ashley Lehnert,DEM,300402,4,10,59,73,61
Haskell,Governor,Chris Powell,LIB,310007,0,0,14,14,
Haskell,Governor,Kevin Stitt,REP,310007,4,5,128,137,
Haskell,Governor,Drew Edmondson,DEM,310007,2,8,47,57,
Haskell,Lieutenant Governor,Matt Pinnell,REP,310007,4,7,135,146,
Haskell,Lieutenant Governor,Anastasia Pittman,DEM,310007,2,6,47,55,
Haskell,Lieutenant Governor,Ivan Holmes,IND,310007,0,0,6,6,
Haskell,State Auditor,John Yeutter,LIB,310007,0,4,33,37,
Haskell,State Auditor,Cindy Byrd,REP,310007,6,9,139,154,
Haskell,Attorney General,Mike Hunter,REP,310007,4,9,138,151,
Haskell,Attorney General,Mark Myles,DEM,310007,2,3,50,55,
Haskell,State Treasurer,Randy Mcdaniel,REP,310007,4,11,150,165,
Haskell,State Treasurer,Charles De Coune,IND,310007,2,2,23,27,
Haskell,Superintendent of Public Instruction,Joy Hofmeister,REP,310007,5,7,98,110,
Haskell,Superintendent of Public Instruction,John Cox,DEM,310007,0,4,66,70,
Haskell,Superintendent of Public Instruction,Larry Huff,IND,310007,1,2,22,25,
Haskell,Commissioner of Labor,Leslie Osborn,REP,310007,4,5,132,141,
Haskell,Commissioner of Labor,Fred Dorrell,DEM,310007,2,7,47,56,
Haskell,Commissioner of Labor,Brandt Dismukes,IND,310007,0,1,7,8,
Haskell,Insurance Commissioner,Glen Mulready,REP,310007,4,5,140,149,
Haskell,Insurance Commissioner,Kimberly Fobbs,DEM,310007,2,8,45,55,
Haskell,Corporation Commissioner,Bob Anthony,REP,310007,4,7,133,144,
Haskell,Corporation Commissioner,Ashley Nicole Mccray,DEM,310007,2,4,42,48,
Haskell,Corporation Commissioner,Jackie Short,IND,310007,0,2,11,13,
Haskell,U.S. House,Richard Castaldo,LIB,310007,0,0,3,3,2
Haskell,U.S. House,Markwayne Mullin,REP,310007,4,8,141,153,2
Haskell,U.S. House,Jason Nichols,DEM,310007,2,4,41,47,2
Haskell,U.S. House,John Foreman,IND,310007,0,1,5,6,2
Haskell,State House,Randy Randleman,REP,310007,4,8,136,148,15
Haskell,State House,Judy Ross Moore,DEM,310007,2,5,53,60,15
Haskell,Governor,Chris Powell,LIB,310009,0,0,0,0,
Haskell,Governor,Kevin Stitt,REP,310009,1,4,43,48,
Haskell,Governor,Drew Edmondson,DEM,310009,2,3,25,30,
Haskell,Lieutenant Governor,Matt Pinnell,REP,310009,1,6,45,52,
Haskell,Lieutenant Governor,Anastasia Pittman,DEM,310009,2,0,19,21,
Haskell,Lieutenant Governor,Ivan Holmes,IND,310009,0,0,4,4,
Haskell,State Auditor,John Yeutter,LIB,310009,1,0,7,8,
Haskell,State Auditor,Cindy Byrd,REP,310009,1,6,53,60,
Haskell,Attorney General,Mike Hunter,REP,310009,1,6,47,54,
Haskell,Attorney General,Mark Myles,DEM,310009,2,0,21,23,
Haskell,State Treasurer,Randy Mcdaniel,REP,310009,1,6,49,56,
Haskell,State Treasurer,Charles De Coune,IND,310009,1,0,10,11,
Haskell,Superintendent of Public Instruction,Joy Hofmeister,REP,310009,1,4,40,45,
Haskell,Superintendent of Public Instruction,John Cox,DEM,310009,2,2,27,31,
Haskell,Superintendent of Public Instruction,Larry Huff,IND,310009,0,0,1,1,
Haskell,Commissioner of Labor,Leslie Osborn,REP,310009,1,5,41,47,
Haskell,Commissioner of Labor,Fred Dorrell,DEM,310009,1,0,22,23,
Haskell,Commissioner of Labor,Brandt Dismukes,IND,310009,0,1,5,6,
Haskell,Insurance Commissioner,Glen Mulready,REP,310009,1,6,43,50,
Haskell,Insurance Commissioner,Kimberly Fobbs,DEM,310009,2,0,23,25,
Haskell,Corporation Commissioner,Bob Anthony,REP,310009,1,6,44,51,
Haskell,Corporation Commissioner,Ashley Nicole Mccray,DEM,310009,2,0,19,21,
Haskell,Corporation Commissioner,Jackie Short,IND,310009,0,0,3,3,
Haskell,U.S. House,Richard Castaldo,LIB,310009,0,0,0,0,2
Haskell,U.S. House,Markwayne Mullin,REP,310009,1,6,49,56,2
Haskell,U.S. House,Jason Nichols,DEM,310009,2,0,14,16,2
Haskell,U.S. House,John Foreman,IND,310009,0,0,3,3,2
Haskell,State House,Randy Randleman,REP,310009,1,6,43,50,15
Haskell,State House,Judy Ross Moore,DEM,310009,2,1,26,29,15
Haskell,Governor,Chris Powell,LIB,310011,0,1,4,5,
Haskell,Governor,Kevin Stitt,REP,310011,4,5,75,84,
Haskell,Governor,Drew Edmondson,DEM,310011,0,7,24,31,
Haskell,Lieutenant Governor,Matt Pinnell,REP,310011,3,5,76,84,
Haskell,Lieutenant Governor,Anastasia Pittman,DEM,310011,1,7,17,25,
Haskell,Lieutenant Governor,Ivan Holmes,IND,310011,0,1,6,7,
Haskell,State Auditor,John Yeutter,LIB,310011,0,5,15,20,
Haskell,State Auditor,Cindy Byrd,REP,310011,4,5,77,86,
Haskell,Attorney General,Mike Hunter,REP,310011,1,6,81,88,
Haskell,Attorney General,Mark Myles,DEM,310011,3,7,19,29,
Haskell,State Treasurer,Randy Mcdaniel,REP,310011,4,8,81,93,
Haskell,State Treasurer,Charles De Coune,IND,310011,0,2,11,13,
Haskell,Superintendent of Public Instruction,Joy Hofmeister,REP,310011,0,5,56,61,
Haskell,Superintendent of Public Instruction,John Cox,DEM,310011,4,7,33,44,
Haskell,Superintendent of Public Instruction,Larry Huff,IND,310011,0,1,12,13,
Haskell,Commissioner of Labor,Leslie Osborn,REP,310011,3,5,74,82,
Haskell,Commissioner of Labor,Fred Dorrell,DEM,310011,1,7,24,32,
Haskell,Commissioner of Labor,Brandt Dismukes,IND,310011,0,1,3,4,
Haskell,Insurance Commissioner,Glen Mulready,REP,310011,3,6,80,89,
Haskell,Insurance Commissioner,Kimberly Fobbs,DEM,310011,1,7,20,28,
Haskell,Corporation Commissioner,Bob Anthony,REP,310011,3,5,75,83,
Haskell,Corporation Commissioner,Ashley Nicole Mccray,DEM,310011,1,7,17,25,
Haskell,Corporation Commissioner,Jackie Short,IND,310011,0,1,7,8,
Haskell,U.S. House,Richard Castaldo,LIB,310011,0,1,2,3,2
Haskell,U.S. House,Markwayne Mullin,REP,310011,3,5,80,88,2
Haskell,U.S. House,Jason Nichols,DEM,310011,1,7,16,24,2
Haskell,U.S. House,John Foreman,IND,310011,0,0,4,4,2
Haskell,State House,Randy Randleman,REP,310011,2,6,78,86,15
Haskell,State House,Judy Ross Moore,DEM,310011,2,7,24,33,15
Haskell,Governor,Chris Powell,LIB,310015,0,1,5,6,
Haskell,Governor,Kevin Stitt,REP,310015,0,28,153,181,
Haskell,Governor,Drew Edmondson,DEM,310015,3,14,63,80,
Haskell,Lieutenant Governor,Matt Pinnell,REP,310015,1,29,160,190,
Haskell,Lieutenant Governor,Anastasia Pittman,DEM,310015,2,12,58,72,
Haskell,Lieutenant Governor,Ivan Holmes,IND,310015,0,2,1,3,
Haskell,State Auditor,John Yeutter,LIB,310015,2,13,31,46,
Haskell,State Auditor,Cindy Byrd,REP,310015,0,26,169,195,
Haskell,Attorney General,Mike Hunter,REP,310015,0,28,163,191,
Haskell,Attorney General,Mark Myles,DEM,310015,3,15,54,72,
Haskell,State Treasurer,Randy Mcdaniel,REP,310015,1,32,178,211,
Haskell,State Treasurer,Charles De Coune,IND,310015,2,8,22,32,
Haskell,Superintendent of Public Instruction,Joy Hofmeister,REP,310015,0,26,136,162,
Haskell,Superintendent of Public Instruction,John Cox,DEM,310015,3,16,63,82,
Haskell,Superintendent of Public Instruction,Larry Huff,IND,310015,0,1,18,19,
Haskell,Commissioner of Labor,Leslie Osborn,REP,310015,1,25,149,175,
Haskell,Commissioner of Labor,Fred Dorrell,DEM,310015,2,16,61,79,
Haskell,Commissioner of Labor,Brandt Dismukes,IND,310015,0,2,4,6,
Haskell,Insurance Commissioner,Glen Mulready,REP,310015,1,28,154,183,
Haskell,Insurance Commissioner,Kimberly Fobbs,DEM,310015,2,15,61,78,
Haskell,Corporation Commissioner,Bob Anthony,REP,310015,1,29,147,177,
Haskell,Corporation Commissioner,Ashley Nicole Mccray,DEM,310015,2,13,60,75,
Haskell,Corporation Commissioner,Jackie Short,IND,310015,0,1,10,11,
Haskell,U.S. House,Richard Castaldo,LIB,310015,0,1,1,2,2
Haskell,U.S. House,Markwayne Mullin,REP,310015,1,30,159,190,2
Haskell,U.S. House,Jason Nichols,DEM,310015,2,11,52,65,2
Haskell,U.S. House,John Foreman,IND,310015,0,0,6,6,2
Haskell,State House,Randy Randleman,REP,310015,0,30,153,183,15
Haskell,State House,Judy Ross Moore,DEM,310015,3,13,68,84,15
Haskell,Governor,Chris Powell,LIB,310016,0,1,8,9,
Haskell,Governor,Kevin Stitt,REP,310016,3,46,159,208,
Haskell,Governor,Drew Edmondson,DEM,310016,7,26,88,121,
Haskell,Lieutenant Governor,Matt Pinnell,REP,310016,3,49,182,234,
Haskell,Lieutenant Governor,Anastasia Pittman,DEM,310016,6,23,64,93,
Haskell,Lieutenant Governor,Ivan Holmes,IND,310016,1,1,8,10,
Haskell,State Auditor,John Yeutter,LIB,310016,5,6,39,50,
Haskell,State Auditor,Cindy Byrd,REP,310016,3,60,187,250,
Haskell,Attorney General,Mike Hunter,REP,310016,3,49,187,239,
Haskell,Attorney General,Mark Myles,DEM,310016,7,24,64,95,
Haskell,State Treasurer,Randy Mcdaniel,REP,310016,3,57,186,246,
Haskell,State Treasurer,Charles De Coune,IND,310016,5,9,45,59,
Haskell,Superintendent of Public Instruction,Joy Hofmeister,REP,310016,3,47,169,219,
Haskell,Superintendent of Public Instruction,John Cox,DEM,310016,7,19,70,96,
Haskell,Superintendent of Public Instruction,Larry Huff,IND,310016,0,7,14,21,
Haskell,Commissioner of Labor,Leslie Osborn,REP,310016,3,49,167,219,
Haskell,Commissioner of Labor,Fred Dorrell,DEM,310016,7,24,71,102,
Haskell,Commissioner of Labor,Brandt Dismukes,IND,310016,0,0,9,9,
Haskell,Insurance Commissioner,Glen Mulready,REP,310016,3,49,176,228,
Haskell,Insurance Commissioner,Kimberly Fobbs,DEM,310016,7,22,71,100,
Haskell,Corporation Commissioner,Bob Anthony,REP,310016,3,48,178,229,
Haskell,Corporation Commissioner,Ashley Nicole Mccray,DEM,310016,7,23,62,92,
Haskell,Corporation Commissioner,Jackie Short,IND,310016,0,1,9,10,
Haskell,U.S. House,Richard Castaldo,LIB,310016,0,0,3,3,2
Haskell,U.S. House,Markwayne Mullin,REP,310016,3,50,188,241,2
Haskell,U.S. House,Jason Nichols,DEM,310016,7,23,59,89,2
Haskell,U.S. House,John Foreman,IND,310016,0,0,1,1,2
Haskell,State House,Randy Randleman,REP,310016,3,42,170,215,15
Haskell,State House,Judy Ross Moore,DEM,310016,7,30,84,121,15
Haskell,Governor,Chris Powell,LIB,310019,0,0,11,11,
Haskell,Governor,Kevin Stitt,REP,310019,4,19,242,265,
Haskell,Governor,Drew Edmondson,DEM,310019,2,23,119,144,
Haskell,Lieutenant Governor,Matt Pinnell,REP,310019,4,19,262,285,
Haskell,Lieutenant Governor,Anastasia Pittman,DEM,310019,2,22,97,121,
Haskell,Lieutenant Governor,Ivan Holmes,IND,310019,0,1,9,10,
Haskell,State Auditor,John Yeutter,LIB,310019,1,8,55,64,
Haskell,State Auditor,Cindy Byrd,REP,310019,4,28,286,318,
Haskell,Attorney General,Mike Hunter,REP,310019,4,21,273,298,
Haskell,Attorney General,Mark Myles,DEM,310019,2,21,94,117,
Haskell,State Treasurer,Randy Mcdaniel,REP,310019,4,27,292,323,
Haskell,State Treasurer,Charles De Coune,IND,310019,0,10,49,59,
Haskell,Superintendent of Public Instruction,Joy Hofmeister,REP,310019,3,17,224,244,
Haskell,Superintendent of Public Instruction,John Cox,DEM,310019,2,23,120,145,
Haskell,Superintendent of Public Instruction,Larry Huff,IND,310019,1,2,27,30,
Haskell,Commissioner of Labor,Leslie Osborn,REP,310019,4,20,246,270,
Haskell,Commissioner of Labor,Fred Dorrell,DEM,310019,2,18,105,125,
Haskell,Commissioner of Labor,Brandt Dismukes,IND,310019,0,4,15,19,
Haskell,Insurance Commissioner,Glen Mulready,REP,310019,4,20,256,280,
Haskell,Insurance Commissioner,Kimberly Fobbs,DEM,310019,2,22,109,133,
Haskell,Corporation Commissioner,Bob Anthony,REP,310019,4,22,268,294,
Haskell,Corporation Commissioner,Ashley Nicole Mccray,DEM,310019,2,19,90,111,
Haskell,Corporation Commissioner,Jackie Short,IND,310019,0,1,11,12,
Haskell,U.S. House,Richard Castaldo,LIB,310019,0,0,0,0,2
Haskell,U.S. House,Markwayne Mullin,REP,310019,4,21,280,305,2
Haskell,U.S. House,Jason Nichols,DEM,310019,2,20,80,102,2
Haskell,U.S. House,John Foreman,IND,310019,0,1,10,11,2
Haskell,State House,Randy Randleman,REP,310019,4,17,240,261,15
Haskell,State House,Judy Ross Moore,DEM,310019,2,25,133,160,15
Haskell,Governor,Chris Powell,LIB,310023,0,0,18,18,
Haskell,Governor,Kevin Stitt,REP,310023,10,21,272,303,
Haskell,Governor,Drew Edmondson,DEM,310023,9,10,160,179,
Haskell,Lieutenant Governor,Matt Pinnell,REP,310023,12,24,296,332,
Haskell,Lieutenant Governor,Anastasia Pittman,DEM,310023,7,6,132,145,
Haskell,Lieutenant Governor,Ivan Holmes,IND,310023,0,0,20,20,
Haskell,State Auditor,John Yeutter,LIB,310023,2,2,93,97,
Haskell,State Auditor,Cindy Byrd,REP,310023,16,24,320,360,
Haskell,Attorney General,Mike Hunter,REP,310023,12,26,305,343,
Haskell,Attorney General,Mark Myles,DEM,310023,7,5,142,154,
Haskell,State Treasurer,Randy Mcdaniel,REP,310023,15,26,333,374,
Haskell,State Treasurer,Charles De Coune,IND,310023,2,1,80,83,
Haskell,Superintendent of Public Instruction,Joy Hofmeister,REP,310023,11,21,266,298,
Haskell,Superintendent of Public Instruction,John Cox,DEM,310023,8,10,152,170,
Haskell,Superintendent of Public Instruction,Larry Huff,IND,310023,0,0,31,31,
Haskell,Commissioner of Labor,Leslie Osborn,REP,310023,11,23,278,312,
Haskell,Commissioner of Labor,Fred Dorrell,DEM,310023,8,6,146,160,
Haskell,Commissioner of Labor,Brandt Dismukes,IND,310023,0,0,21,21,
Haskell,Insurance Commissioner,Glen Mulready,REP,310023,12,21,294,327,
Haskell,Insurance Commissioner,Kimberly Fobbs,DEM,310023,7,8,152,167,
Haskell,Corporation Commissioner,Bob Anthony,REP,310023,11,22,286,319,
Haskell,Corporation Commissioner,Ashley Nicole Mccray,DEM,310023,7,7,140,154,
Haskell,Corporation Commissioner,Jackie Short,IND,310023,1,1,20,22,
Haskell,U.S. House,Richard Castaldo,LIB,310023,0,1,10,11,2
Haskell,U.S. House,Markwayne Mullin,REP,310023,11,24,302,337,2
Haskell,U.S. House,Jason Nichols,DEM,310023,8,6,127,141,2
Haskell,U.S. House,John Foreman,IND,310023,0,0,10,10,2
Haskell,State House,Randy Randleman,REP,310023,10,21,286,317,15
Haskell,State House,Judy Ross Moore,DEM,310023,9,10,162,181,15
Haskell,Governor,Chris Powell,LIB,310027,0,4,12,16,
Haskell,Governor,Kevin Stitt,REP,310027,6,58,241,305,
Haskell,Governor,Drew Edmondson,DEM,310027,5,34,126,165,
Haskell,Lieutenant Governor,Matt Pinnell,REP,310027,5,66,267,338,
Haskell,Lieutenant Governor,Anastasia Pittman,DEM,310027,5,26,97,128,
Haskell,Lieutenant Governor,Ivan Holmes,IND,310027,1,2,12,15,
Haskell,State Auditor,John Yeutter,LIB,310027,3,16,46,65,
Haskell,State Auditor,Cindy Byrd,REP,310027,5,70,309,384,
Haskell,Attorney General,Mike Hunter,REP,310027,6,70,278,354,
Haskell,Attorney General,Mark Myles,DEM,310027,5,25,97,127,
Haskell,State Treasurer,Randy Mcdaniel,REP,310027,6,74,307,387,
Haskell,State Treasurer,Charles De Coune,IND,310027,4,13,49,66,
Haskell,Superintendent of Public Instruction,Joy Hofmeister,REP,310027,6,59,253,318,
Haskell,Superintendent of Public Instruction,John Cox,DEM,310027,5,31,106,142,
Haskell,Superintendent of Public Instruction,Larry Huff,IND,310027,0,6,19,25,
Haskell,Commissioner of Labor,Leslie Osborn,REP,310027,5,64,267,336,
Haskell,Commissioner of Labor,Fred Dorrell,DEM,310027,5,30,96,131,
Haskell,Commissioner of Labor,Brandt Dismukes,IND,310027,1,1,12,14,
Haskell,Insurance Commissioner,Glen Mulready,REP,310027,5,64,267,336,
Haskell,Insurance Commissioner,Kimberly Fobbs,DEM,310027,6,31,105,142,
Haskell,Corporation Commissioner,Bob Anthony,REP,310027,5,64,267,336,
Haskell,Corporation Commissioner,Ashley Nicole Mccray,DEM,310027,5,23,91,119,
Haskell,Corporation Commissioner,Jackie Short,IND,310027,1,6,17,24,
Haskell,U.S. House,Richard Castaldo,LIB,310027,0,0,3,3,2
Haskell,U.S. House,Markwayne Mullin,REP,310027,6,72,281,359,2
Haskell,U.S. House,Jason Nichols,DEM,310027,3,22,84,109,2
Haskell,U.S. House,John Foreman,IND,310027,2,2,8,12,2
Haskell,State House,Randy Randleman,REP,310027,5,62,252,319,15
Haskell,State House,Judy Ross Moore,DEM,310027,6,33,124,163,15
Haskell,Governor,Chris Powell,LIB,310030,0,0,6,6,
Haskell,Governor,Kevin Stitt,REP,310030,6,29,189,224,
Haskell,Governor,Drew Edmondson,DEM,310030,5,21,78,104,
Haskell,Lieutenant Governor,Matt Pinnell,REP,310030,6,31,208,245,
Haskell,Lieutenant Governor,Anastasia Pittman,DEM,310030,5,19,60,84,
Haskell,Lieutenant Governor,Ivan Holmes,IND,310030,0,0,3,3,
Haskell,State Auditor,John Yeutter,LIB,310030,3,10,45,58,
Haskell,State Auditor,Cindy Byrd,REP,310030,7,36,220,263,
Haskell,Attorney General,Mike Hunter,REP,310030,6,35,211,252,
Haskell,Attorney General,Mark Myles,DEM,310030,5,15,61,81,
Haskell,State Treasurer,Randy Mcdaniel,REP,310030,7,35,218,260,
Haskell,State Treasurer,Charles De Coune,IND,310030,3,10,46,59,
Haskell,Superintendent of Public Instruction,Joy Hofmeister,REP,310030,6,29,180,215,
Haskell,Superintendent of Public Instruction,John Cox,DEM,310030,5,18,81,104,
Haskell,Superintendent of Public Instruction,Larry Huff,IND,310030,0,2,10,12,
Haskell,Commissioner of Labor,Leslie Osborn,REP,310030,6,29,195,230,
Haskell,Commissioner of Labor,Fred Dorrell,DEM,310030,5,19,67,91,
Haskell,Commissioner of Labor,Brandt Dismukes,IND,310030,0,2,7,9,
Haskell,Insurance Commissioner,Glen Mulready,REP,310030,6,32,201,239,
Haskell,Insurance Commissioner,Kimberly Fobbs,DEM,310030,5,18,69,92,
Haskell,Corporation Commissioner,Bob Anthony,REP,310030,6,32,202,240,
Haskell,Corporation Commissioner,Ashley Nicole Mccray,DEM,310030,5,17,60,82,
Haskell,Corporation Commissioner,Jackie Short,IND,310030,0,1,8,9,
Haskell,U.S. House,Richard Castaldo,LIB,310030,0,0,3,3,2
Haskell,U.S. House,Markwayne Mullin,REP,310030,6,30,219,255,2
Haskell,U.S. House,Jason Nichols,DEM,310030,5,17,49,71,2
Haskell,U.S. House,John Foreman,IND,310030,0,3,3,6,2
Haskell,State House,Randy Randleman,REP,310030,6,25,191,222,15
Haskell,State House,Judy Ross Moore,DEM,310030,5,24,84,113,15
Haskell,Governor,Chris Powell,LIB,310031,1,0,12,13,
Haskell,Governor,Kevin Stitt,REP,310031,6,32,299,337,
Haskell,Governor,Drew Edmondson,DEM,310031,21,10,181,212,
Haskell,Lieutenant Governor,Matt Pinnell,REP,310031,8,33,315,356,
Haskell,Lieutenant Governor,Anastasia Pittman,DEM,310031,18,9,157,184,
Haskell,Lieutenant Governor,Ivan Holmes,IND,310031,0,0,16,16,
Haskell,State Auditor,John Yeutter,LIB,310031,6,5,79,90,
Haskell,State Auditor,Cindy Byrd,REP,310031,17,34,372,423,
Haskell,Attorney General,Mike Hunter,REP,310031,7,32,327,366,
Haskell,Attorney General,Mark Myles,DEM,310031,19,10,161,190,
Haskell,State Treasurer,Randy Mcdaniel,REP,310031,8,33,364,405,
Haskell,State Treasurer,Charles De Coune,IND,310031,12,6,87,105,
Haskell,Superintendent of Public Instruction,Joy Hofmeister,REP,310031,7,26,260,293,
Haskell,Superintendent of Public Instruction,John Cox,DEM,310031,14,10,167,191,
Haskell,Superintendent of Public Instruction,Larry Huff,IND,310031,5,6,62,73,
Haskell,Commissioner of Labor,Leslie Osborn,REP,310031,8,28,302,338,
Haskell,Commissioner of Labor,Fred Dorrell,DEM,310031,18,12,166,196,
Haskell,Commissioner of Labor,Brandt Dismukes,IND,310031,0,2,22,24,
Haskell,Insurance Commissioner,Glen Mulready,REP,310031,7,32,325,364,
Haskell,Insurance Commissioner,Kimberly Fobbs,DEM,310031,19,10,162,191,
Haskell,Corporation Commissioner,Bob Anthony,REP,310031,7,31,309,347,
Haskell,Corporation Commissioner,Ashley Nicole Mccray,DEM,310031,18,10,152,180,
Haskell,Corporation Commissioner,Jackie Short,IND,310031,1,1,27,29,
Haskell,U.S. House,Richard Castaldo,LIB,310031,0,0,3,3,2
Haskell,U.S. House,Markwayne Mullin,REP,310031,10,33,324,367,2
Haskell,U.S. House,Jason Nichols,DEM,310031,18,9,150,177,2
Haskell,U.S. House,John Foreman,IND,310031,0,0,12,12,2
Haskell,State House,Randy Randleman,REP,310031,7,31,319,357,15
Haskell,State House,Judy Ross Moore,DEM,310031,21,11,173,205,15
Haskell,Governor,Chris Powell,LIB,310032,0,0,9,9,
Haskell,Governor,Kevin Stitt,REP,310032,1,28,227,256,
Haskell,Governor,Drew Edmondson,DEM,310032,1,20,102,123,
Haskell,Lieutenant Governor,Matt Pinnell,REP,310032,1,30,237,268,
Haskell,Lieutenant Governor,Anastasia Pittman,DEM,310032,1,17,89,107,
Haskell,Lieutenant Governor,Ivan Holmes,IND,310032,0,1,7,8,
Haskell,State Auditor,John Yeutter,LIB,310032,0,7,57,64,
Haskell,State Auditor,Cindy Byrd,REP,310032,2,36,257,295,
Haskell,Attorney General,Mike Hunter,REP,310032,1,29,235,265,
Haskell,Attorney General,Mark Myles,DEM,310032,1,19,95,115,
Haskell,State Treasurer,Randy Mcdaniel,REP,310032,1,34,245,280,
Haskell,State Treasurer,Charles De Coune,IND,310032,1,9,64,74,
Haskell,Superintendent of Public Instruction,Joy Hofmeister,REP,310032,1,21,184,206,
Haskell,Superintendent of Public Instruction,John Cox,DEM,310032,1,26,127,154,
Haskell,Superintendent of Public Instruction,Larry Huff,IND,310032,0,2,24,26,
Haskell,Commissioner of Labor,Leslie Osborn,REP,310032,1,27,215,243,
Haskell,Commissioner of Labor,Fred Dorrell,DEM,310032,1,20,96,117,
Haskell,Commissioner of Labor,Brandt Dismukes,IND,310032,0,1,16,17,
Haskell,Insurance Commissioner,Glen Mulready,REP,310032,1,30,216,247,
Haskell,Insurance Commissioner,Kimberly Fobbs,DEM,310032,1,18,113,132,
Haskell,Corporation Commissioner,Bob Anthony,REP,310032,1,29,208,238,
Haskell,Corporation Commissioner,Ashley Nicole Mccray,DEM,310032,1,19,101,121,
Haskell,Corporation Commissioner,Jackie Short,IND,310032,0,0,21,21,
Haskell,U.S. House,Richard Castaldo,LIB,310032,0,0,3,3,2
Haskell,U.S. House,Markwayne Mullin,REP,310032,1,34,244,279,2
Haskell,U.S. House,Jason Nichols,DEM,310032,1,14,79,94,2
Haskell,U.S. House,John Foreman,IND,310032,0,0,8,8,2
Haskell,State House,Randy Randleman,REP,310032,1,25,216,242,15
Haskell,State House,Judy Ross Moore,DEM,310032,1,24,119,144,15
Hughes,Governor,Chris Powell,LIB,320010,0,0,0,0,
Hughes,Governor,Kevin Stitt,REP,320010,0,0,0,0,
Hughes,Governor,Drew Edmondson,DEM,320010,0,0,0,0,
Hughes,Lieutenant Governor,Matt Pinnell,REP,320010,0,0,0,0,
Hughes,Lieutenant Governor,Anastasia Pittman,DEM,320010,0,0,0,0,
Hughes,Lieutenant Governor,Ivan Holmes,IND,320010,0,0,0,0,
Hughes,State Auditor,John Yeutter,LIB,320010,0,0,0,0,
Hughes,State Auditor,Cindy Byrd,REP,320010,0,0,0,0,
Hughes,Attorney General,Mike Hunter,REP,320010,0,0,0,0,
Hughes,Attorney General,Mark Myles,DEM,320010,0,0,0,0,
Hughes,State Treasurer,Randy Mcdaniel,REP,320010,0,0,0,0,
Hughes,State Treasurer,Charles De Coune,IND,320010,0,0,0,0,
Hughes,Superintendent of Public Instruction,Joy Hofmeister,REP,320010,0,0,0,0,
Hughes,Superintendent of Public Instruction,John Cox,DEM,320010,0,0,0,0,
Hughes,Superintendent of Public Instruction,Larry Huff,IND,320010,0,0,0,0,
Hughes,Commissioner of Labor,Leslie Osborn,REP,320010,0,0,0,0,
Hughes,Commissioner of Labor,Fred Dorrell,DEM,320010,0,0,0,0,
Hughes,Commissioner of Labor,Brandt Dismukes,IND,320010,0,0,0,0,
Hughes,Insurance Commissioner,Glen Mulready,REP,320010,0,0,0,0,
Hughes,Insurance Commissioner,Kimberly Fobbs,DEM,320010,0,0,0,0,
Hughes,Corporation Commissioner,Bob Anthony,REP,320010,0,0,0,0,
Hughes,Corporation Commissioner,Ashley Nicole Mccray,DEM,320010,0,0,0,0,
Hughes,Corporation Commissioner,Jackie Short,IND,320010,0,0,0,0,
Hughes,U.S. House,Richard Castaldo,LIB,320010,0,0,0,0,2
Hughes,U.S. House,Markwayne Mullin,REP,320010,0,0,0,0,2
Hughes,U.S. House,Jason Nichols,DEM,320010,0,0,0,0,2
Hughes,U.S. House,John Foreman,IND,320010,0,0,0,0,2
Hughes,State House,Logan Phillips,REP,320010,0,0,0,0,24
Hughes,State House,Steve Kouplen,DEM,320010,0,0,0,0,24
Hughes,Governor,Chris Powell,LIB,320011,2,1,19,22,
Hughes,Governor,Kevin Stitt,REP,320011,16,34,256,306,
Hughes,Governor,Drew Edmondson,DEM,320011,3,30,128,161,
Hughes,Lieutenant Governor,Matt Pinnell,REP,320011,16,37,292,345,
Hughes,Lieutenant Governor,Anastasia Pittman,DEM,320011,2,25,95,122,
Hughes,Lieutenant Governor,Ivan Holmes,IND,320011,2,2,11,15,
Hughes,State Auditor,John Yeutter,LIB,320011,2,7,60,69,
Hughes,State Auditor,Cindy Byrd,REP,320011,18,52,324,394,
Hughes,Attorney General,Mike Hunter,REP,320011,17,41,297,355,
Hughes,Attorney General,Mark Myles,DEM,320011,4,21,96,121,
Hughes,State Treasurer,Randy Mcdaniel,REP,320011,17,42,326,385,
Hughes,State Treasurer,Charles De Coune,IND,320011,3,16,57,76,
Hughes,Superintendent of Public Instruction,Joy Hofmeister,REP,320011,11,39,241,291,
Hughes,Superintendent of Public Instruction,John Cox,DEM,320011,3,19,118,140,
Hughes,Superintendent of Public Instruction,Larry Huff,IND,320011,5,5,41,51,
Hughes,Commissioner of Labor,Leslie Osborn,REP,320011,15,38,279,332,
Hughes,Commissioner of Labor,Fred Dorrell,DEM,320011,4,18,99,121,
Hughes,Commissioner of Labor,Brandt Dismukes,IND,320011,0,3,13,16,
Hughes,Insurance Commissioner,Glen Mulready,REP,320011,17,33,274,324,
Hughes,Insurance Commissioner,Kimberly Fobbs,DEM,320011,3,25,115,143,
Hughes,Corporation Commissioner,Bob Anthony,REP,320011,12,40,263,315,
Hughes,Corporation Commissioner,Ashley Nicole Mccray,DEM,320011,6,17,118,141,
Hughes,Corporation Commissioner,Jackie Short,IND,320011,2,3,18,23,
Hughes,U.S. House,Richard Castaldo,LIB,320011,1,1,11,13,2
Hughes,U.S. House,Markwayne Mullin,REP,320011,14,35,266,315,2
Hughes,U.S. House,Jason Nichols,DEM,320011,5,22,108,135,2
Hughes,U.S. House,John Foreman,IND,320011,0,2,10,12,2
Hughes,State House,Logan Phillips,REP,320011,13,22,203,238,24
Hughes,State House,Steve Kouplen,DEM,320011,8,42,198,248,24
Hughes,Governor,Chris Powell,LIB,320012,1,1,3,5,
Hughes,Governor,Kevin Stitt,REP,320012,3,32,142,177,
Hughes,Governor,Drew Edmondson,DEM,320012,8,17,99,124,
Hughes,Lieutenant Governor,Matt Pinnell,REP,320012,4,36,163,203,
Hughes,Lieutenant Governor,Anastasia Pittman,DEM,320012,8,14,67,89,
Hughes,Lieutenant Governor,Ivan Holmes,IND,320012,0,0,11,11,
Hughes,State Auditor,John Yeutter,LIB,320012,2,4,46,52,
Hughes,State Auditor,Cindy Byrd,REP,320012,7,45,183,235,
Hughes,Attorney General,Mike Hunter,REP,320012,4,37,163,204,
Hughes,Attorney General,Mark Myles,DEM,320012,8,12,77,97,
Hughes,State Treasurer,Randy Mcdaniel,REP,320012,4,45,180,229,
Hughes,State Treasurer,Charles De Coune,IND,320012,5,4,51,60,
Hughes,Superintendent of Public Instruction,Joy Hofmeister,REP,320012,4,34,146,184,
Hughes,Superintendent of Public Instruction,John Cox,DEM,320012,7,13,75,95,
Hughes,Superintendent of Public Instruction,Larry Huff,IND,320012,1,2,21,24,
Hughes,Commissioner of Labor,Leslie Osborn,REP,320012,4,32,150,186,
Hughes,Commissioner of Labor,Fred Dorrell,DEM,320012,7,13,79,99,
Hughes,Commissioner of Labor,Brandt Dismukes,IND,320012,1,2,11,14,
Hughes,Insurance Commissioner,Glen Mulready,REP,320012,3,32,147,182,
Hughes,Insurance Commissioner,Kimberly Fobbs,DEM,320012,8,15,91,114,
Hughes,Corporation Commissioner,Bob Anthony,REP,320012,3,32,153,188,
Hughes,Corporation Commissioner,Ashley Nicole Mccray,DEM,320012,8,13,76,97,
Hughes,Corporation Commissioner,Jackie Short,IND,320012,1,3,12,16,
Hughes,U.S. House,Richard Castaldo,LIB,320012,1,1,2,4,2
Hughes,U.S. House,Markwayne Mullin,REP,320012,3,35,146,184,2
Hughes,U.S. House,Jason Nichols,DEM,320012,8,12,82,102,2
Hughes,U.S. House,John Foreman,IND,320012,0,0,12,12,2
Hughes,State House,Logan Phillips,REP,320012,3,21,120,144,24
Hughes,State House,Steve Kouplen,DEM,320012,9,27,119,155,24
Hughes,Governor,Chris Powell,LIB,320016,0,2,6,8,
Hughes,Governor,Kevin Stitt,REP,320016,4,11,76,91,
Hughes,Governor,Drew Edmondson,DEM,320016,3,5,31,39,
Hughes,Lieutenant Governor,Matt Pinnell,REP,320016,6,12,80,98,
Hughes,Lieutenant Governor,Anastasia Pittman,DEM,320016,1,5,25,31,
Hughes,Lieutenant Governor,Ivan Holmes,IND,320016,0,0,6,6,
Hughes,State Auditor,John Yeutter,LIB,320016,0,2,16,18,
Hughes,State Auditor,Cindy Byrd,REP,320016,7,14,94,115,
Hughes,Attorney General,Mike Hunter,REP,320016,6,9,78,93,
Hughes,Attorney General,Mark Myles,DEM,320016,1,7,33,41,
Hughes,State Treasurer,Randy Mcdaniel,REP,320016,6,12,91,109,
Hughes,State Treasurer,Charles De Coune,IND,320016,1,3,20,24,
Hughes,Superintendent of Public Instruction,Joy Hofmeister,REP,320016,6,12,72,90,
Hughes,Superintendent of Public Instruction,John Cox,DEM,320016,1,5,28,34,
Hughes,Superintendent of Public Instruction,Larry Huff,IND,320016,0,1,13,14,
Hughes,Commissioner of Labor,Leslie Osborn,REP,320016,6,12,82,100,
Hughes,Commissioner of Labor,Fred Dorrell,DEM,320016,1,4,21,26,
Hughes,Commissioner of Labor,Brandt Dismukes,IND,320016,0,0,9,9,
Hughes,Insurance Commissioner,Glen Mulready,REP,320016,6,11,80,97,
Hughes,Insurance Commissioner,Kimberly Fobbs,DEM,320016,1,5,30,36,
Hughes,Corporation Commissioner,Bob Anthony,REP,320016,6,9,77,92,
Hughes,Corporation Commissioner,Ashley Nicole Mccray,DEM,320016,1,6,22,29,
Hughes,Corporation Commissioner,Jackie Short,IND,320016,0,2,11,13,
Hughes,U.S. House,Richard Castaldo,LIB,320016,0,1,3,4,2
Hughes,U.S. House,Markwayne Mullin,REP,320016,6,11,78,95,2
Hughes,U.S. House,Jason Nichols,DEM,320016,1,5,27,33,2
Hughes,U.S. House,John Foreman,IND,320016,0,0,4,4,2
Hughes,State House,Logan Phillips,REP,320016,3,7,57,67,24
Hughes,State House,Steve Kouplen,DEM,320016,4,11,56,71,24
Hughes,Governor,Chris Powell,LIB,320018,0,1,9,10,
Hughes,Governor,Kevin Stitt,REP,320018,2,13,132,147,
Hughes,Governor,Drew Edmondson,DEM,320018,1,10,37,48,
Hughes,Lieutenant Governor,Matt Pinnell,REP,320018,2,13,142,157,
Hughes,Lieutenant Governor,Anastasia Pittman,DEM,320018,1,11,31,43,
Hughes,Lieutenant Governor,Ivan Holmes,IND,320018,0,0,4,4,
Hughes,State Auditor,John Yeutter,LIB,320018,0,1,20,21,
Hughes,State Auditor,Cindy Byrd,REP,320018,2,19,147,168,
Hughes,Attorney General,Mike Hunter,REP,320018,2,17,136,155,
Hughes,Attorney General,Mark Myles,DEM,320018,1,7,39,47,
Hughes,State Treasurer,Randy Mcdaniel,REP,320018,2,19,153,174,
Hughes,State Treasurer,Charles De Coune,IND,320018,0,1,13,14,
Hughes,Superintendent of Public Instruction,Joy Hofmeister,REP,320018,2,15,124,141,
Hughes,Superintendent of Public Instruction,John Cox,DEM,320018,1,8,37,46,
Hughes,Superintendent of Public Instruction,Larry Huff,IND,320018,0,1,17,18,
Hughes,Commissioner of Labor,Leslie Osborn,REP,320018,2,13,140,155,
Hughes,Commissioner of Labor,Fred Dorrell,DEM,320018,1,11,32,44,
Hughes,Commissioner of Labor,Brandt Dismukes,IND,320018,0,0,2,2,
Hughes,Insurance Commissioner,Glen Mulready,REP,320018,2,16,141,159,
Hughes,Insurance Commissioner,Kimberly Fobbs,DEM,320018,1,8,34,43,
Hughes,Corporation Commissioner,Bob Anthony,REP,320018,2,14,128,144,
Hughes,Corporation Commissioner,Ashley Nicole Mccray,DEM,320018,1,10,39,50,
Hughes,Corporation Commissioner,Jackie Short,IND,320018,0,0,10,10,
Hughes,U.S. House,Richard Castaldo,LIB,320018,0,0,2,2,2
Hughes,U.S. House,Markwayne Mullin,REP,320018,2,14,140,156,2
Hughes,U.S. House,Jason Nichols,DEM,320018,1,9,32,42,2
Hughes,U.S. House,John Foreman,IND,320018,0,1,3,4,2
Hughes,State House,David Smith,REP,320018,2,11,121,134,18
Hughes,State House,Donnie Condit,DEM,320018,1,13,58,72,18
Hughes,Governor,Chris Powell,LIB,320019,0,0,4,4,
Hughes,Governor,Kevin Stitt,REP,320019,7,8,45,60,
Hughes,Governor,Drew Edmondson,DEM,320019,1,4,28,33,
Hughes,Lieutenant Governor,Matt Pinnell,REP,320019,8,8,48,64,
Hughes,Lieutenant Governor,Anastasia Pittman,DEM,320019,0,4,25,29,
Hughes,Lieutenant Governor,Ivan Holmes,IND,320019,0,0,3,3,
Hughes,State Auditor,John Yeutter,LIB,320019,2,1,13,16,
Hughes,State Auditor,Cindy Byrd,REP,320019,6,11,55,72,
Hughes,Attorney General,Mike Hunter,REP,320019,8,8,49,65,
Hughes,Attorney General,Mark Myles,DEM,320019,0,4,23,27,
Hughes,State Treasurer,Randy Mcdaniel,REP,320019,6,11,56,73,
Hughes,State Treasurer,Charles De Coune,IND,320019,2,1,12,15,
Hughes,Superintendent of Public Instruction,Joy Hofmeister,REP,320019,5,8,47,60,
Hughes,Superintendent of Public Instruction,John Cox,DEM,320019,0,3,21,24,
Hughes,Superintendent of Public Instruction,Larry Huff,IND,320019,2,1,7,10,
Hughes,Commissioner of Labor,Leslie Osborn,REP,320019,8,9,46,63,
Hughes,Commissioner of Labor,Fred Dorrell,DEM,320019,0,3,23,26,
Hughes,Commissioner of Labor,Brandt Dismukes,IND,320019,0,0,3,3,
Hughes,Insurance Commissioner,Glen Mulready,REP,320019,8,7,51,66,
Hughes,Insurance Commissioner,Kimberly Fobbs,DEM,320019,0,4,24,28,
Hughes,Corporation Commissioner,Bob Anthony,REP,320019,7,8,45,60,
Hughes,Corporation Commissioner,Ashley Nicole Mccray,DEM,320019,0,3,23,26,
Hughes,Corporation Commissioner,Jackie Short,IND,320019,1,1,7,9,
Hughes,U.S. House,Richard Castaldo,LIB,320019,0,0,3,3,2
Hughes,U.S. House,Markwayne Mullin,REP,320019,8,8,44,60,2
Hughes,U.S. House,Jason Nichols,DEM,320019,0,3,24,27,2
Hughes,U.S. House,John Foreman,IND,320019,0,1,3,4,2
Hughes,State House,Logan Phillips,REP,320019,5,4,35,44,24
Hughes,State House,Steve Kouplen,DEM,320019,3,8,39,50,24
Hughes,Governor,Chris Powell,LIB,320020,0,3,19,22,
Hughes,Governor,Kevin Stitt,REP,320020,11,24,303,338,
Hughes,Governor,Drew Edmondson,DEM,320020,10,9,211,230,
Hughes,Lieutenant Governor,Matt Pinnell,REP,320020,12,27,338,377,
Hughes,Lieutenant Governor,Anastasia Pittman,DEM,320020,9,6,169,184,
Hughes,Lieutenant Governor,Ivan Holmes,IND,320020,0,2,27,29,
Hughes,State Auditor,John Yeutter,LIB,320020,6,7,126,139,
Hughes,State Auditor,Cindy Byrd,REP,320020,12,28,374,414,
Hughes,Attorney General,Mike Hunter,REP,320020,11,24,345,380,
Hughes,Attorney General,Mark Myles,DEM,320020,10,12,188,210,
Hughes,State Treasurer,Randy Mcdaniel,REP,320020,12,26,381,419,
Hughes,State Treasurer,Charles De Coune,IND,320020,6,9,124,139,
Hughes,Superintendent of Public Instruction,Joy Hofmeister,REP,320020,12,19,298,329,
Hughes,Superintendent of Public Instruction,John Cox,DEM,320020,8,10,192,210,
Hughes,Superintendent of Public Instruction,Larry Huff,IND,320020,1,6,45,52,
Hughes,Commissioner of Labor,Leslie Osborn,REP,320020,11,26,326,363,
Hughes,Commissioner of Labor,Fred Dorrell,DEM,320020,9,7,177,193,
Hughes,Commissioner of Labor,Brandt Dismukes,IND,320020,1,1,25,27,
Hughes,Insurance Commissioner,Glen Mulready,REP,320020,11,24,320,355,
Hughes,Insurance Commissioner,Kimberly Fobbs,DEM,320020,10,9,207,226,
Hughes,Corporation Commissioner,Bob Anthony,REP,320020,13,25,322,360,
Hughes,Corporation Commissioner,Ashley Nicole Mccray,DEM,320020,8,7,181,196,
Hughes,Corporation Commissioner,Jackie Short,IND,320020,0,2,27,29,
Hughes,U.S. House,Richard Castaldo,LIB,320020,1,3,16,20,2
Hughes,U.S. House,Markwayne Mullin,REP,320020,11,23,306,340,2
Hughes,U.S. House,Jason Nichols,DEM,320020,8,7,188,203,2
Hughes,U.S. House,John Foreman,IND,320020,1,1,19,21,2
Hughes,State House,Logan Phillips,REP,320020,12,18,243,273,24
Hughes,State House,Steve Kouplen,DEM,320020,9,18,284,311,24
Hughes,Governor,Chris Powell,LIB,320021,0,0,8,8,
Hughes,Governor,Kevin Stitt,REP,320021,1,10,107,118,
Hughes,Governor,Drew Edmondson,DEM,320021,5,18,89,112,
Hughes,Lieutenant Governor,Matt Pinnell,REP,320021,2,14,123,139,
Hughes,Lieutenant Governor,Anastasia Pittman,DEM,320021,4,13,69,86,
Hughes,Lieutenant Governor,Ivan Holmes,IND,320021,0,0,10,10,
Hughes,State Auditor,John Yeutter,LIB,320021,0,6,42,48,
Hughes,State Auditor,Cindy Byrd,REP,320021,5,18,152,175,
Hughes,Attorney General,Mike Hunter,REP,320021,2,15,134,151,
Hughes,Attorney General,Mark Myles,DEM,320021,4,12,68,84,
Hughes,State Treasurer,Randy Mcdaniel,REP,320021,2,15,145,162,
Hughes,State Treasurer,Charles De Coune,IND,320021,4,9,45,58,
Hughes,Superintendent of Public Instruction,Joy Hofmeister,REP,320021,2,12,109,123,
Hughes,Superintendent of Public Instruction,John Cox,DEM,320021,4,15,73,92,
Hughes,Superintendent of Public Instruction,Larry Huff,IND,320021,0,1,20,21,
Hughes,Commissioner of Labor,Leslie Osborn,REP,320021,1,15,123,139,
Hughes,Commissioner of Labor,Fred Dorrell,DEM,320021,5,12,76,93,
Hughes,Commissioner of Labor,Brandt Dismukes,IND,320021,0,0,4,4,
Hughes,Insurance Commissioner,Glen Mulready,REP,320021,2,13,116,131,
Hughes,Insurance Commissioner,Kimberly Fobbs,DEM,320021,4,14,85,103,
Hughes,Corporation Commissioner,Bob Anthony,REP,320021,2,12,114,128,
Hughes,Corporation Commissioner,Ashley Nicole Mccray,DEM,320021,4,15,76,95,
Hughes,Corporation Commissioner,Jackie Short,IND,320021,0,0,12,12,
Hughes,U.S. House,Richard Castaldo,LIB,320021,0,0,7,7,2
Hughes,U.S. House,Markwayne Mullin,REP,320021,2,15,115,132,2
Hughes,U.S. House,Jason Nichols,DEM,320021,4,11,73,88,2
Hughes,U.S. House,John Foreman,IND,320021,0,1,8,9,2
Hughes,State House,Logan Phillips,REP,320021,1,13,101,115,24
Hughes,State House,Steve Kouplen,DEM,320021,5,15,101,121,24
Hughes,Governor,Chris Powell,LIB,320022,0,0,11,11,
Hughes,Governor,Kevin Stitt,REP,320022,6,2,111,119,
Hughes,Governor,Drew Edmondson,DEM,320022,4,3,74,81,
Hughes,Lieutenant Governor,Matt Pinnell,REP,320022,6,2,122,130,
Hughes,Lieutenant Governor,Anastasia Pittman,DEM,320022,4,2,62,68,
Hughes,Lieutenant Governor,Ivan Holmes,IND,320022,0,0,11,11,
Hughes,State Auditor,John Yeutter,LIB,320022,1,0,40,41,
Hughes,State Auditor,Cindy Byrd,REP,320022,9,2,136,147,
Hughes,Attorney General,Mike Hunter,REP,320022,5,2,126,133,
Hughes,Attorney General,Mark Myles,DEM,320022,5,2,67,74,
Hughes,State Treasurer,Randy Mcdaniel,REP,320022,8,2,139,149,
Hughes,State Treasurer,Charles De Coune,IND,320022,2,0,39,41,
Hughes,Superintendent of Public Instruction,Joy Hofmeister,REP,320022,6,3,106,115,
Hughes,Superintendent of Public Instruction,John Cox,DEM,320022,4,2,64,70,
Hughes,Superintendent of Public Instruction,Larry Huff,IND,320022,0,0,20,20,
Hughes,Commissioner of Labor,Leslie Osborn,REP,320022,6,2,125,133,
Hughes,Commissioner of Labor,Fred Dorrell,DEM,320022,4,2,59,65,
Hughes,Commissioner of Labor,Brandt Dismukes,IND,320022,0,0,6,6,
Hughes,Insurance Commissioner,Glen Mulready,REP,320022,6,2,120,128,
Hughes,Insurance Commissioner,Kimberly Fobbs,DEM,320022,4,2,68,74,
Hughes,Corporation Commissioner,Bob Anthony,REP,320022,7,2,112,121,
Hughes,Corporation Commissioner,Ashley Nicole Mccray,DEM,320022,3,2,65,70,
Hughes,Corporation Commissioner,Jackie Short,IND,320022,0,0,12,12,
Hughes,U.S. House,Richard Castaldo,LIB,320022,0,0,5,5,2
Hughes,U.S. House,Markwayne Mullin,REP,320022,6,3,118,127,2
Hughes,U.S. House,Jason Nichols,DEM,320022,4,2,61,67,2
Hughes,U.S. House,John Foreman,IND,320022,0,0,8,8,2
Hughes,State House,Logan Phillips,REP,320022,3,1,100,104,24
Hughes,State House,Steve Kouplen,DEM,320022,7,3,94,104,24
Hughes,Governor,Chris Powell,LIB,320023,0,0,4,4,
Hughes,Governor,Kevin Stitt,REP,320023,5,6,54,65,
Hughes,Governor,Drew Edmondson,DEM,320023,1,2,28,31,
Hughes,Lieutenant Governor,Matt Pinnell,REP,320023,5,6,61,72,
Hughes,Lieutenant Governor,Anastasia Pittman,DEM,320023,1,2,17,20,
Hughes,Lieutenant Governor,Ivan Holmes,IND,320023,0,0,4,4,
Hughes,State Auditor,John Yeutter,LIB,320023,0,1,13,14,
Hughes,State Auditor,Cindy Byrd,REP,320023,6,7,65,78,
Hughes,Attorney General,Mike Hunter,REP,320023,6,6,58,70,
Hughes,Attorney General,Mark Myles,DEM,320023,0,1,25,26,
Hughes,State Treasurer,Randy Mcdaniel,REP,320023,6,7,70,83,
Hughes,State Treasurer,Charles De Coune,IND,320023,0,1,9,10,
Hughes,Superintendent of Public Instruction,Joy Hofmeister,REP,320023,5,6,47,58,
Hughes,Superintendent of Public Instruction,John Cox,DEM,320023,1,2,28,31,
Hughes,Superintendent of Public Instruction,Larry Huff,IND,320023,0,0,9,9,
Hughes,Commissioner of Labor,Leslie Osborn,REP,320023,5,6,55,66,
Hughes,Commissioner of Labor,Fred Dorrell,DEM,320023,1,2,23,26,
Hughes,Commissioner of Labor,Brandt Dismukes,IND,320023,0,0,5,5,
Hughes,Insurance Commissioner,Glen Mulready,REP,320023,5,5,58,68,
Hughes,Insurance Commissioner,Kimberly Fobbs,DEM,320023,1,2,24,27,
Hughes,Corporation Commissioner,Bob Anthony,REP,320023,6,7,54,67,
Hughes,Corporation Commissioner,Ashley Nicole Mccray,DEM,320023,0,1,24,25,
Hughes,Corporation Commissioner,Jackie Short,IND,320023,0,0,7,7,
Hughes,U.S. House,Richard Castaldo,LIB,320023,0,1,0,1,2
Hughes,U.S. House,Markwayne Mullin,REP,320023,5,6,58,69,2
Hughes,U.S. House,Jason Nichols,DEM,320023,1,1,22,24,2
Hughes,U.S. House,John Foreman,IND,320023,0,0,5,5,2
Hughes,State House,Logan Phillips,REP,320023,2,5,47,54,24
Hughes,State House,Steve Kouplen,DEM,320023,4,3,38,45,24
Hughes,Governor,Chris Powell,LIB,320030,0,1,9,10,
Hughes,Governor,Kevin Stitt,REP,320030,3,3,95,101,
Hughes,Governor,Drew Edmondson,DEM,320030,2,1,42,45,
Hughes,Lieutenant Governor,Matt Pinnell,REP,320030,3,4,102,109,
Hughes,Lieutenant Governor,Anastasia Pittman,DEM,320030,2,0,37,39,
Hughes,Lieutenant Governor,Ivan Holmes,IND,320030,0,1,5,6,
Hughes,State Auditor,John Yeutter,LIB,320030,0,1,23,24,
Hughes,State Auditor,Cindy Byrd,REP,320030,3,4,120,127,
Hughes,Attorney General,Mike Hunter,REP,320030,3,4,112,119,
Hughes,Attorney General,Mark Myles,DEM,320030,2,0,32,34,
Hughes,State Treasurer,Randy Mcdaniel,REP,320030,3,3,116,122,
Hughes,State Treasurer,Charles De Coune,IND,320030,0,1,24,25,
Hughes,Superintendent of Public Instruction,Joy Hofmeister,REP,320030,2,1,94,97,
Hughes,Superintendent of Public Instruction,John Cox,DEM,320030,2,1,33,36,
Hughes,Superintendent of Public Instruction,Larry Huff,IND,320030,1,3,19,23,
Hughes,Commissioner of Labor,Leslie Osborn,REP,320030,3,4,99,106,
Hughes,Commissioner of Labor,Fred Dorrell,DEM,320030,2,0,37,39,
Hughes,Commissioner of Labor,Brandt Dismukes,IND,320030,0,1,10,11,
Hughes,Insurance Commissioner,Glen Mulready,REP,320030,3,5,101,109,
Hughes,Insurance Commissioner,Kimberly Fobbs,DEM,320030,2,0,42,44,
Hughes,Corporation Commissioner,Bob Anthony,REP,320030,3,4,98,105,
Hughes,Corporation Commissioner,Ashley Nicole Mccray,DEM,320030,2,0,40,42,
Hughes,Corporation Commissioner,Jackie Short,IND,320030,0,1,8,9,
Hughes,U.S. House,Richard Castaldo,LIB,320030,0,1,2,3,2
Hughes,U.S. House,Markwayne Mullin,REP,320030,3,4,96,103,2
Hughes,U.S. House,Jason Nichols,DEM,320030,2,0,40,42,2
Hughes,U.S. House,John Foreman,IND,320030,0,0,6,6,2
Hughes,State House,David Smith,REP,320030,1,4,79,84,18
Hughes,State House,Donnie Condit,DEM,320030,4,1,66,71,18
Hughes,Governor,Chris Powell,LIB,320031,0,0,7,7,
Hughes,Governor,Kevin Stitt,REP,320031,3,7,146,156,
Hughes,Governor,Drew Edmondson,DEM,320031,1,2,55,58,
Hughes,Lieutenant Governor,Matt Pinnell,REP,320031,3,7,151,161,
Hughes,Lieutenant Governor,Anastasia Pittman,DEM,320031,1,2,52,55,
Hughes,Lieutenant Governor,Ivan Holmes,IND,320031,0,0,4,4,
Hughes,State Auditor,John Yeutter,LIB,320031,0,0,31,31,
Hughes,State Auditor,Cindy Byrd,REP,320031,3,8,174,185,
Hughes,Attorney General,Mike Hunter,REP,320031,3,7,156,166,
Hughes,Attorney General,Mark Myles,DEM,320031,1,2,49,52,
Hughes,State Treasurer,Randy Mcdaniel,REP,320031,3,7,171,181,
Hughes,State Treasurer,Charles De Coune,IND,320031,1,2,32,35,
Hughes,Superintendent of Public Instruction,Joy Hofmeister,REP,320031,3,5,145,153,
Hughes,Superintendent of Public Instruction,John Cox,DEM,320031,1,1,51,53,
Hughes,Superintendent of Public Instruction,Larry Huff,IND,320031,0,3,12,15,
Hughes,Commissioner of Labor,Leslie Osborn,REP,320031,3,7,154,164,
Hughes,Commissioner of Labor,Fred Dorrell,DEM,320031,1,2,44,47,
Hughes,Commissioner of Labor,Brandt Dismukes,IND,320031,0,0,9,9,
Hughes,Insurance Commissioner,Glen Mulready,REP,320031,3,7,144,154,
Hughes,Insurance Commissioner,Kimberly Fobbs,DEM,320031,1,2,60,63,
Hughes,Corporation Commissioner,Bob Anthony,REP,320031,3,7,143,153,
Hughes,Corporation Commissioner,Ashley Nicole Mccray,DEM,320031,0,1,55,56,
Hughes,Corporation Commissioner,Jackie Short,IND,320031,1,1,8,10,
Hughes,U.S. House,Richard Castaldo,LIB,320031,0,0,1,1,2
Hughes,U.S. House,Markwayne Mullin,REP,320031,3,7,150,160,2
Hughes,U.S. House,Jason Nichols,DEM,320031,1,1,46,48,2
Hughes,U.S. House,John Foreman,IND,320031,0,1,10,11,2
Hughes,State House,David Smith,REP,320031,3,3,106,112,18
Hughes,State House,Donnie Condit,DEM,320031,1,5,101,107,18
Hughes,Governor,Chris Powell,LIB,320032,0,0,8,8,
Hughes,Governor,Kevin Stitt,REP,320032,5,0,102,107,
Hughes,Governor,Drew Edmondson,DEM,320032,0,0,81,81,
Hughes,Lieutenant Governor,Matt Pinnell,REP,320032,5,0,124,129,
Hughes,Lieutenant Governor,Anastasia Pittman,DEM,320032,0,0,59,59,
Hughes,Lieutenant Governor,Ivan Holmes,IND,320032,0,0,6,6,
Hughes,State Auditor,John Yeutter,LIB,320032,0,0,37,37,
Hughes,State Auditor,Cindy Byrd,REP,320032,5,0,132,137,
Hughes,Attorney General,Mike Hunter,REP,320032,2,0,122,124,
Hughes,Attorney General,Mark Myles,DEM,320032,3,0,66,69,
Hughes,State Treasurer,Randy Mcdaniel,REP,320032,4,0,126,130,
Hughes,State Treasurer,Charles De Coune,IND,320032,1,0,45,46,
Hughes,Superintendent of Public Instruction,Joy Hofmeister,REP,320032,3,0,102,105,
Hughes,Superintendent of Public Instruction,John Cox,DEM,320032,2,0,76,78,
Hughes,Superintendent of Public Instruction,Larry Huff,IND,320032,0,0,11,11,
Hughes,Commissioner of Labor,Leslie Osborn,REP,320032,4,0,109,113,
Hughes,Commissioner of Labor,Fred Dorrell,DEM,320032,0,0,65,65,
Hughes,Commissioner of Labor,Brandt Dismukes,IND,320032,1,0,7,8,
Hughes,Insurance Commissioner,Glen Mulready,REP,320032,3,0,112,115,
Hughes,Insurance Commissioner,Kimberly Fobbs,DEM,320032,2,0,71,73,
Hughes,Corporation Commissioner,Bob Anthony,REP,320032,3,0,98,101,
Hughes,Corporation Commissioner,Ashley Nicole Mccray,DEM,320032,2,0,81,83,
Hughes,Corporation Commissioner,Jackie Short,IND,320032,0,0,5,5,
Hughes,U.S. House,Richard Castaldo,LIB,320032,0,0,4,4,2
Hughes,U.S. House,Markwayne Mullin,REP,320032,5,0,112,117,2
Hughes,U.S. House,Jason Nichols,DEM,320032,0,0,68,68,2
Hughes,U.S. House,John Foreman,IND,320032,0,0,5,5,2
Hughes,State House,David Smith,REP,320032,5,0,86,91,18
Hughes,State House,Donnie Condit,DEM,320032,0,0,104,104,18
Hughes,Governor,Chris Powell,LIB,320033,0,1,6,7,
Hughes,Governor,Kevin Stitt,REP,320033,0,6,162,168,
Hughes,Governor,Drew Edmondson,DEM,320033,2,1,37,40,
Hughes,Lieutenant Governor,Matt Pinnell,REP,320033,0,7,165,172,
Hughes,Lieutenant Governor,Anastasia Pittman,DEM,320033,2,1,30,33,
Hughes,Lieutenant Governor,Ivan Holmes,IND,320033,0,0,6,6,
Hughes,State Auditor,John Yeutter,LIB,320033,0,1,17,18,
Hughes,State Auditor,Cindy Byrd,REP,320033,0,7,184,191,
Hughes,Attorney General,Mike Hunter,REP,320033,2,6,165,173,
Hughes,Attorney General,Mark Myles,DEM,320033,0,2,36,38,
Hughes,State Treasurer,Randy Mcdaniel,REP,320033,0,7,169,176,
Hughes,State Treasurer,Charles De Coune,IND,320033,2,1,28,31,
Hughes,Superintendent of Public Instruction,Joy Hofmeister,REP,320033,0,5,150,155,
Hughes,Superintendent of Public Instruction,John Cox,DEM,320033,2,2,33,37,
Hughes,Superintendent of Public Instruction,Larry Huff,IND,320033,0,1,20,21,
Hughes,Commissioner of Labor,Leslie Osborn,REP,320033,0,5,163,168,
Hughes,Commissioner of Labor,Fred Dorrell,DEM,320033,2,1,32,35,
Hughes,Commissioner of Labor,Brandt Dismukes,IND,320033,0,1,8,9,
Hughes,Insurance Commissioner,Glen Mulready,REP,320033,0,5,157,162,
Hughes,Insurance Commissioner,Kimberly Fobbs,DEM,320033,2,3,44,49,
Hughes,Corporation Commissioner,Bob Anthony,REP,320033,2,3,152,157,
Hughes,Corporation Commissioner,Ashley Nicole Mccray,DEM,320033,0,4,37,41,
Hughes,Corporation Commissioner,Jackie Short,IND,320033,0,1,12,13,
Hughes,U.S. House,Richard Castaldo,LIB,320033,0,0,2,2,2
Hughes,U.S. House,Markwayne Mullin,REP,320033,0,6,158,164,2
Hughes,U.S. House,Jason Nichols,DEM,320033,2,2,32,36,2
Hughes,U.S. House,John Foreman,IND,320033,0,0,9,9,2
Hughes,State House,David Smith,REP,320033,0,3,146,149,18
Hughes,State House,Donnie Condit,DEM,320033,2,5,57,64,18
Hughes,Governor,Chris Powell,LIB,320034,0,0,4,4,
Hughes,Governor,Kevin Stitt,REP,320034,2,7,86,95,
Hughes,Governor,Drew Edmondson,DEM,320034,1,3,46,50,
Hughes,Lieutenant Governor,Matt Pinnell,REP,320034,2,4,100,106,
Hughes,Lieutenant Governor,Anastasia Pittman,DEM,320034,1,6,30,37,
Hughes,Lieutenant Governor,Ivan Holmes,IND,320034,0,0,5,5,
Hughes,State Auditor,John Yeutter,LIB,320034,0,2,16,18,
Hughes,State Auditor,Cindy Byrd,REP,320034,3,8,112,123,
Hughes,Attorney General,Mike Hunter,REP,320034,2,4,102,108,
Hughes,Attorney General,Mark Myles,DEM,320034,1,5,31,37,
Hughes,State Treasurer,Randy Mcdaniel,REP,320034,2,5,113,120,
Hughes,State Treasurer,Charles De Coune,IND,320034,1,4,15,20,
Hughes,Superintendent of Public Instruction,Joy Hofmeister,REP,320034,1,7,89,97,
Hughes,Superintendent of Public Instruction,John Cox,DEM,320034,1,2,37,40,
Hughes,Superintendent of Public Instruction,Larry Huff,IND,320034,1,0,7,8,
Hughes,Commissioner of Labor,Leslie Osborn,REP,320034,3,5,98,106,
Hughes,Commissioner of Labor,Fred Dorrell,DEM,320034,0,4,35,39,
Hughes,Commissioner of Labor,Brandt Dismukes,IND,320034,0,0,3,3,
Hughes,Insurance Commissioner,Glen Mulready,REP,320034,2,5,101,108,
Hughes,Insurance Commissioner,Kimberly Fobbs,DEM,320034,1,4,32,37,
Hughes,Corporation Commissioner,Bob Anthony,REP,320034,1,4,96,101,
Hughes,Corporation Commissioner,Ashley Nicole Mccray,DEM,320034,1,5,31,37,
Hughes,Corporation Commissioner,Jackie Short,IND,320034,1,0,7,8,
Hughes,U.S. House,Richard Castaldo,LIB,320034,0,0,1,1,2
Hughes,U.S. House,Markwayne Mullin,REP,320034,2,6,99,107,2
Hughes,U.S. House,Jason Nichols,DEM,320034,1,4,29,34,2
Hughes,U.S. House,John Foreman,IND,320034,0,0,4,4,2
Hughes,State House,David Smith,REP,320034,2,4,81,87,18
Hughes,State House,Donnie Condit,DEM,320034,1,5,53,59,18
Hughes,Governor,Chris Powell,LIB,320035,1,3,32,36,
Hughes,Governor,Kevin Stitt,REP,320035,7,38,230,275,
Hughes,Governor,Drew Edmondson,DEM,320035,2,26,175,203,
Hughes,Lieutenant Governor,Matt Pinnell,REP,320035,7,41,262,310,
Hughes,Lieutenant Governor,Anastasia Pittman,DEM,320035,2,20,142,164,
Hughes,Lieutenant Governor,Ivan Holmes,IND,320035,1,2,28,31,
Hughes,State Auditor,John Yeutter,LIB,320035,2,9,100,111,
Hughes,State Auditor,Cindy Byrd,REP,320035,7,50,308,365,
Hughes,Attorney General,Mike Hunter,REP,320035,7,46,289,342,
Hughes,Attorney General,Mark Myles,DEM,320035,3,18,140,161,
Hughes,State Treasurer,Randy Mcdaniel,REP,320035,6,48,323,377,
Hughes,State Treasurer,Charles De Coune,IND,320035,4,11,87,102,
Hughes,Superintendent of Public Instruction,Joy Hofmeister,REP,320035,6,38,233,277,
Hughes,Superintendent of Public Instruction,John Cox,DEM,320035,3,19,158,180,
Hughes,Superintendent of Public Instruction,Larry Huff,IND,320035,1,9,39,49,
Hughes,Commissioner of Labor,Leslie Osborn,REP,320035,7,41,252,300,
Hughes,Commissioner of Labor,Fred Dorrell,DEM,320035,2,21,146,169,
Hughes,Commissioner of Labor,Brandt Dismukes,IND,320035,1,2,29,32,
Hughes,Insurance Commissioner,Glen Mulready,REP,320035,7,37,267,311,
Hughes,Insurance Commissioner,Kimberly Fobbs,DEM,320035,2,28,161,191,
Hughes,Corporation Commissioner,Bob Anthony,REP,320035,6,34,257,297,
Hughes,Corporation Commissioner,Ashley Nicole Mccray,DEM,320035,3,26,143,172,
Hughes,Corporation Commissioner,Jackie Short,IND,320035,1,4,28,33,
Hughes,U.S. House,Richard Castaldo,LIB,320035,1,2,11,14,2
Hughes,U.S. House,Markwayne Mullin,REP,320035,7,38,249,294,2
Hughes,U.S. House,Jason Nichols,DEM,320035,2,23,149,174,2
Hughes,U.S. House,John Foreman,IND,320035,0,2,24,26,2
Hughes,State House,Logan Phillips,REP,320035,3,39,204,246,24
Hughes,State House,Steve Kouplen,DEM,320035,7,28,225,260,24
Jackson,Governor,Chris Powell,LIB,330001,2,6,24,32,
Jackson,Governor,Kevin Stitt,REP,330001,41,161,600,802,
Jackson,Governor,Drew Edmondson,DEM,330001,20,77,256,353,
Jackson,Lieutenant Governor,Matt Pinnell,REP,330001,48,184,680,912,
Jackson,Lieutenant Governor,Anastasia Pittman,DEM,330001,14,59,176,249,
Jackson,Lieutenant Governor,Ivan Holmes,IND,330001,0,1,16,17,
Jackson,State Auditor,John Yeutter,LIB,330001,8,31,137,176,
Jackson,State Auditor,Cindy Byrd,REP,330001,49,202,690,941,
Jackson,Attorney General,Mike Hunter,REP,330001,48,190,691,929,
Jackson,Attorney General,Mark Myles,DEM,330001,14,51,166,231,
Jackson,State Treasurer,Randy Mcdaniel,REP,330001,49,192,695,936,
Jackson,State Treasurer,Charles De Coune,IND,330001,9,43,132,184,
Jackson,Superintendent of Public Instruction,Joy Hofmeister,REP,330001,47,178,619,844,
Jackson,Superintendent of Public Instruction,John Cox,DEM,330001,14,52,179,245,
Jackson,Superintendent of Public Instruction,Larry Huff,IND,330001,1,9,62,72,
Jackson,Commissioner of Labor,Leslie Osborn,REP,330001,50,180,654,884,
Jackson,Commissioner of Labor,Fred Dorrell,DEM,330001,12,53,164,229,
Jackson,Commissioner of Labor,Brandt Dismukes,IND,330001,0,6,30,36,
Jackson,Insurance Commissioner,Glen Mulready,REP,330001,47,179,660,886,
Jackson,Insurance Commissioner,Kimberly Fobbs,DEM,330001,15,58,190,263,
Jackson,Corporation Commissioner,Bob Anthony,REP,330001,46,176,640,862,
Jackson,Corporation Commissioner,Ashley Nicole Mccray,DEM,330001,15,56,166,237,
Jackson,Corporation Commissioner,Jackie Short,IND,330001,1,7,47,55,
Jackson,U.S. House,Frank Lucas,REP,330001,49,195,702,946,3
Jackson,U.S. House,Frankie Robbins,DEM,330001,12,49,167,228,3
Jackson,State Senate,Brent Howard,REP,330001,45,182,675,902,38
Jackson,State Senate,Jeff Berrong,DEM,330001,17,62,204,283,38
Jackson,Governor,Chris Powell,LIB,330002,0,0,5,5,
Jackson,Governor,Kevin Stitt,REP,330002,24,71,205,300,
Jackson,Governor,Drew Edmondson,DEM,330002,12,30,80,122,
Jackson,Lieutenant Governor,Matt Pinnell,REP,330002,26,84,231,341,
Jackson,Lieutenant Governor,Anastasia Pittman,DEM,330002,8,15,45,68,
Jackson,Lieutenant Governor,Ivan Holmes,IND,330002,2,0,8,10,
Jackson,State Auditor,John Yeutter,LIB,330002,3,2,22,27,
Jackson,State Auditor,Cindy Byrd,REP,330002,31,93,248,372,
Jackson,Attorney General,Mike Hunter,REP,330002,29,86,238,353,
Jackson,Attorney General,Mark Myles,DEM,330002,7,15,47,69,
Jackson,State Treasurer,Randy Mcdaniel,REP,330002,30,89,239,358,
Jackson,State Treasurer,Charles De Coune,IND,330002,4,5,32,41,
Jackson,Superintendent of Public Instruction,Joy Hofmeister,REP,330002,29,84,216,329,
Jackson,Superintendent of Public Instruction,John Cox,DEM,330002,7,12,48,67,
Jackson,Superintendent of Public Instruction,Larry Huff,IND,330002,0,4,20,24,
Jackson,Commissioner of Labor,Leslie Osborn,REP,330002,28,85,227,340,
Jackson,Commissioner of Labor,Fred Dorrell,DEM,330002,8,13,43,64,
Jackson,Commissioner of Labor,Brandt Dismukes,IND,330002,0,1,9,10,
Jackson,Insurance Commissioner,Glen Mulready,REP,330002,27,80,217,324,
Jackson,Insurance Commissioner,Kimberly Fobbs,DEM,330002,9,20,60,89,
Jackson,Corporation Commissioner,Bob Anthony,REP,330002,28,88,236,352,
Jackson,Corporation Commissioner,Ashley Nicole Mccray,DEM,330002,8,11,36,55,
Jackson,Corporation Commissioner,Jackie Short,IND,330002,0,0,7,7,
Jackson,U.S. House,Frank Lucas,REP,330002,30,86,246,362,3
Jackson,U.S. House,Frankie Robbins,DEM,330002,6,15,42,63,3
Jackson,State Senate,Brent Howard,REP,330002,29,67,233,329,38
Jackson,State Senate,Jeff Berrong,DEM,330002,6,33,56,95,38
Jackson,Governor,Chris Powell,LIB,330003,1,1,14,16,
Jackson,Governor,Kevin Stitt,REP,330003,2,31,179,212,
Jackson,Governor,Drew Edmondson,DEM,330003,3,20,183,206,
Jackson,Lieutenant Governor,Matt Pinnell,REP,330003,4,36,185,225,
Jackson,Lieutenant Governor,Anastasia Pittman,DEM,330003,1,13,162,176,
Jackson,Lieutenant Governor,Ivan Holmes,IND,330003,1,3,24,28,
Jackson,State Auditor,John Yeutter,LIB,330003,2,9,116,127,
Jackson,State Auditor,Cindy Byrd,REP,330003,3,42,230,275,
Jackson,Attorney General,Mike Hunter,REP,330003,3,35,198,236,
Jackson,Attorney General,Mark Myles,DEM,330003,3,17,170,190,
Jackson,State Treasurer,Randy Mcdaniel,REP,330003,3,33,211,247,
Jackson,State Treasurer,Charles De Coune,IND,330003,2,18,130,150,
Jackson,Superintendent of Public Instruction,Joy Hofmeister,REP,330003,3,34,174,211,
Jackson,Superintendent of Public Instruction,John Cox,DEM,330003,2,14,159,175,
Jackson,Superintendent of Public Instruction,Larry Huff,IND,330003,1,4,40,45,
Jackson,Commissioner of Labor,Leslie Osborn,REP,330003,3,32,187,222,
Jackson,Commissioner of Labor,Fred Dorrell,DEM,330003,2,13,153,168,
Jackson,Commissioner of Labor,Brandt Dismukes,IND,330003,1,6,29,36,
Jackson,Insurance Commissioner,Glen Mulready,REP,330003,4,31,194,229,
Jackson,Insurance Commissioner,Kimberly Fobbs,DEM,330003,2,21,176,199,
Jackson,Corporation Commissioner,Bob Anthony,REP,330003,3,32,181,216,
Jackson,Corporation Commissioner,Ashley Nicole Mccray,DEM,330003,2,15,159,176,
Jackson,Corporation Commissioner,Jackie Short,IND,330003,1,4,27,32,
Jackson,U.S. House,Frank Lucas,REP,330003,4,38,211,253,3
Jackson,U.S. House,Frankie Robbins,DEM,330003,2,14,160,176,3
Jackson,State Senate,Brent Howard,REP,330003,4,38,213,255,38
Jackson,State Senate,Jeff Berrong,DEM,330003,2,14,159,175,38
Jackson,Governor,Chris Powell,LIB,330006,0,3,20,23,
Jackson,Governor,Kevin Stitt,REP,330006,21,103,442,566,
Jackson,Governor,Drew Edmondson,DEM,330006,15,56,211,282,
Jackson,Lieutenant Governor,Matt Pinnell,REP,330006,24,122,501,647,
Jackson,Lieutenant Governor,Anastasia Pittman,DEM,330006,11,37,147,195,
Jackson,Lieutenant Governor,Ivan Holmes,IND,330006,0,2,19,21,
Jackson,State Auditor,John Yeutter,LIB,330006,4,19,110,133,
Jackson,State Auditor,Cindy Byrd,REP,330006,28,133,535,696,
Jackson,Attorney General,Mike Hunter,REP,330006,28,127,526,681,
Jackson,Attorney General,Mark Myles,DEM,330006,8,31,137,176,
Jackson,State Treasurer,Randy Mcdaniel,REP,330006,27,124,520,671,
Jackson,State Treasurer,Charles De Coune,IND,330006,5,29,120,154,
Jackson,Superintendent of Public Instruction,Joy Hofmeister,REP,330006,24,118,479,621,
Jackson,Superintendent of Public Instruction,John Cox,DEM,330006,11,30,143,184,
Jackson,Superintendent of Public Instruction,Larry Huff,IND,330006,1,12,45,58,
Jackson,Commissioner of Labor,Leslie Osborn,REP,330006,25,119,504,648,
Jackson,Commissioner of Labor,Fred Dorrell,DEM,330006,10,32,137,179,
Jackson,Commissioner of Labor,Brandt Dismukes,IND,330006,0,6,22,28,
Jackson,Insurance Commissioner,Glen Mulready,REP,330006,21,117,501,639,
Jackson,Insurance Commissioner,Kimberly Fobbs,DEM,330006,13,37,164,214,
Jackson,Corporation Commissioner,Bob Anthony,REP,330006,25,125,483,633,
Jackson,Corporation Commissioner,Ashley Nicole Mccray,DEM,330006,11,26,145,182,
Jackson,Corporation Commissioner,Jackie Short,IND,330006,0,6,34,40,
Jackson,U.S. House,Frank Lucas,REP,330006,30,126,533,689,3
Jackson,U.S. House,Frankie Robbins,DEM,330006,7,35,138,180,3
Jackson,State Senate,Brent Howard,REP,330006,27,114,492,633,38
Jackson,State Senate,Jeff Berrong,DEM,330006,10,45,179,234,38
Jackson,Governor,Chris Powell,LIB,330007,0,1,15,16,
Jackson,Governor,Kevin Stitt,REP,330007,5,31,236,272,
Jackson,Governor,Drew Edmondson,DEM,330007,7,30,154,191,
Jackson,Lieutenant Governor,Matt Pinnell,REP,330007,6,42,255,303,
Jackson,Lieutenant Governor,Anastasia Pittman,DEM,330007,6,20,129,155,
Jackson,Lieutenant Governor,Ivan Holmes,IND,330007,0,0,18,18,
Jackson,State Auditor,John Yeutter,LIB,330007,3,13,103,119,
Jackson,State Auditor,Cindy Byrd,REP,330007,9,43,286,338,
Jackson,Attorney General,Mike Hunter,REP,330007,7,43,269,319,
Jackson,Attorney General,Mark Myles,DEM,330007,5,18,130,153,
Jackson,State Treasurer,Randy Mcdaniel,REP,330007,7,38,282,327,
Jackson,State Treasurer,Charles De Coune,IND,330007,4,19,105,128,
Jackson,Superintendent of Public Instruction,Joy Hofmeister,REP,330007,8,38,237,283,
Jackson,Superintendent of Public Instruction,John Cox,DEM,330007,4,21,128,153,
Jackson,Superintendent of Public Instruction,Larry Huff,IND,330007,0,3,42,45,
Jackson,Commissioner of Labor,Leslie Osborn,REP,330007,7,36,252,295,
Jackson,Commissioner of Labor,Fred Dorrell,DEM,330007,5,18,127,150,
Jackson,Commissioner of Labor,Brandt Dismukes,IND,330007,0,4,21,25,
Jackson,Insurance Commissioner,Glen Mulready,REP,330007,5,36,262,303,
Jackson,Insurance Commissioner,Kimberly Fobbs,DEM,330007,6,25,140,171,
Jackson,Corporation Commissioner,Bob Anthony,REP,330007,6,39,256,301,
Jackson,Corporation Commissioner,Ashley Nicole Mccray,DEM,330007,5,19,133,157,
Jackson,Corporation Commissioner,Jackie Short,IND,330007,0,3,14,17,
Jackson,U.S. House,Frank Lucas,REP,330007,6,41,277,324,3
Jackson,U.S. House,Frankie Robbins,DEM,330007,5,20,128,153,3
Jackson,State Senate,Brent Howard,REP,330007,8,39,271,318,38
Jackson,State Senate,Jeff Berrong,DEM,330007,4,23,135,162,38
Jackson,Governor,Chris Powell,LIB,330010,1,0,11,12,
Jackson,Governor,Kevin Stitt,REP,330010,5,40,141,186,
Jackson,Governor,Drew Edmondson,DEM,330010,6,12,126,144,
Jackson,Lieutenant Governor,Matt Pinnell,REP,330010,6,43,147,196,
Jackson,Lieutenant Governor,Anastasia Pittman,DEM,330010,5,7,117,129,
Jackson,Lieutenant Governor,Ivan Holmes,IND,330010,1,2,12,15,
Jackson,State Auditor,John Yeutter,LIB,330010,5,5,82,92,
Jackson,State Auditor,Cindy Byrd,REP,330010,7,45,172,224,
Jackson,Attorney General,Mike Hunter,REP,330010,8,41,153,202,
Jackson,Attorney General,Mark Myles,DEM,330010,4,11,117,132,
Jackson,State Treasurer,Randy Mcdaniel,REP,330010,9,43,163,215,
Jackson,State Treasurer,Charles De Coune,IND,330010,3,8,89,100,
Jackson,Superintendent of Public Instruction,Joy Hofmeister,REP,330010,5,41,137,183,
Jackson,Superintendent of Public Instruction,John Cox,DEM,330010,5,10,110,125,
Jackson,Superintendent of Public Instruction,Larry Huff,IND,330010,2,1,28,31,
Jackson,Commissioner of Labor,Leslie Osborn,REP,330010,7,41,143,191,
Jackson,Commissioner of Labor,Fred Dorrell,DEM,330010,5,8,111,124,
Jackson,Commissioner of Labor,Brandt Dismukes,IND,330010,0,2,18,20,
Jackson,Insurance Commissioner,Glen Mulready,REP,330010,6,44,151,201,
Jackson,Insurance Commissioner,Kimberly Fobbs,DEM,330010,6,7,121,134,
Jackson,Corporation Commissioner,Bob Anthony,REP,330010,8,42,142,192,
Jackson,Corporation Commissioner,Ashley Nicole Mccray,DEM,330010,4,7,110,121,
Jackson,Corporation Commissioner,Jackie Short,IND,330010,0,2,21,23,
Jackson,U.S. House,Frank Lucas,REP,330010,7,45,167,219,3
Jackson,U.S. House,Frankie Robbins,DEM,330010,4,7,108,119,3
Jackson,State Senate,Brent Howard,REP,330010,7,40,171,218,38
Jackson,State Senate,Jeff Berrong,DEM,330010,5,12,107,124,38
Jackson,Governor,Chris Powell,LIB,330014,6,6,20,32,
Jackson,Governor,Kevin Stitt,REP,330014,19,84,380,483,
Jackson,Governor,Drew Edmondson,DEM,330014,12,50,193,255,
Jackson,Lieutenant Governor,Matt Pinnell,REP,330014,25,97,414,536,
Jackson,Lieutenant Governor,Anastasia Pittman,DEM,330014,12,36,162,210,
Jackson,Lieutenant Governor,Ivan Holmes,IND,330014,0,7,14,21,
Jackson,State Auditor,John Yeutter,LIB,330014,5,19,119,143,
Jackson,State Auditor,Cindy Byrd,REP,330014,26,113,441,580,
Jackson,Attorney General,Mike Hunter,REP,330014,27,98,428,553,
Jackson,Attorney General,Mark Myles,DEM,330014,10,41,157,208,
Jackson,State Treasurer,Randy Mcdaniel,REP,330014,26,105,427,558,
Jackson,State Treasurer,Charles De Coune,IND,330014,5,29,132,166,
Jackson,Superintendent of Public Instruction,Joy Hofmeister,REP,330014,24,91,379,494,
Jackson,Superintendent of Public Instruction,John Cox,DEM,330014,11,38,160,209,
Jackson,Superintendent of Public Instruction,Larry Huff,IND,330014,2,10,44,56,
Jackson,Commissioner of Labor,Leslie Osborn,REP,330014,26,95,395,516,
Jackson,Commissioner of Labor,Fred Dorrell,DEM,330014,9,40,154,203,
Jackson,Commissioner of Labor,Brandt Dismukes,IND,330014,2,5,30,37,
Jackson,Insurance Commissioner,Glen Mulready,REP,330014,23,94,401,518,
Jackson,Insurance Commissioner,Kimberly Fobbs,DEM,330014,13,45,181,239,
Jackson,Corporation Commissioner,Bob Anthony,REP,330014,24,98,394,516,
Jackson,Corporation Commissioner,Ashley Nicole Mccray,DEM,330014,10,40,155,205,
Jackson,Corporation Commissioner,Jackie Short,IND,330014,2,2,34,38,
Jackson,U.S. House,Frank Lucas,REP,330014,27,98,437,562,3
Jackson,U.S. House,Frankie Robbins,DEM,330014,10,42,149,201,3
Jackson,State Senate,Brent Howard,REP,330014,23,87,431,541,38
Jackson,State Senate,Jeff Berrong,DEM,330014,14,53,160,227,38
Jackson,Governor,Chris Powell,LIB,330016,1,0,12,13,
Jackson,Governor,Kevin Stitt,REP,330016,8,22,266,296,
Jackson,Governor,Drew Edmondson,DEM,330016,4,6,77,87,
Jackson,Lieutenant Governor,Matt Pinnell,REP,330016,7,23,287,317,
Jackson,Lieutenant Governor,Anastasia Pittman,DEM,330016,4,5,45,54,
Jackson,Lieutenant Governor,Ivan Holmes,IND,330016,2,0,14,16,
Jackson,State Auditor,John Yeutter,LIB,330016,3,3,41,47,
Jackson,State Auditor,Cindy Byrd,REP,330016,10,25,295,330,
Jackson,Attorney General,Mike Hunter,REP,330016,9,24,291,324,
Jackson,Attorney General,Mark Myles,DEM,330016,4,4,50,58,
Jackson,State Treasurer,Randy Mcdaniel,REP,330016,8,26,301,335,
Jackson,State Treasurer,Charles De Coune,IND,330016,5,2,37,44,
Jackson,Superintendent of Public Instruction,Joy Hofmeister,REP,330016,7,24,266,297,
Jackson,Superintendent of Public Instruction,John Cox,DEM,330016,5,4,50,59,
Jackson,Superintendent of Public Instruction,Larry Huff,IND,330016,1,0,26,27,
Jackson,Commissioner of Labor,Leslie Osborn,REP,330016,7,24,277,308,
Jackson,Commissioner of Labor,Fred Dorrell,DEM,330016,5,4,47,56,
Jackson,Commissioner of Labor,Brandt Dismukes,IND,330016,1,0,15,16,
Jackson,Insurance Commissioner,Glen Mulready,REP,330016,9,21,282,312,
Jackson,Insurance Commissioner,Kimberly Fobbs,DEM,330016,4,7,56,67,
Jackson,Corporation Commissioner,Bob Anthony,REP,330016,8,25,280,313,
Jackson,Corporation Commissioner,Ashley Nicole Mccray,DEM,330016,4,3,42,49,
Jackson,Corporation Commissioner,Jackie Short,IND,330016,1,0,19,20,
Jackson,U.S. House,Frank Lucas,REP,330016,8,23,303,334,3
Jackson,U.S. House,Frankie Robbins,DEM,330016,4,5,43,52,3
Jackson,State Senate,Brent Howard,REP,330016,10,23,299,332,38
Jackson,State Senate,Jeff Berrong,DEM,330016,4,5,52,61,38
Jackson,Governor,Chris Powell,LIB,330017,0,1,6,7,
Jackson,Governor,Kevin Stitt,REP,330017,6,7,156,169,
Jackson,Governor,Drew Edmondson,DEM,330017,0,1,57,58,
Jackson,Lieutenant Governor,Matt Pinnell,REP,330017,6,7,178,191,
Jackson,Lieutenant Governor,Anastasia Pittman,DEM,330017,0,1,36,37,
Jackson,Lieutenant Governor,Ivan Holmes,IND,330017,0,1,3,4,
Jackson,State Auditor,John Yeutter,LIB,330017,1,2,21,24,
Jackson,State Auditor,Cindy Byrd,REP,330017,5,7,186,198,
Jackson,Attorney General,Mike Hunter,REP,330017,5,7,178,190,
Jackson,Attorney General,Mark Myles,DEM,330017,1,1,38,40,
Jackson,State Treasurer,Randy Mcdaniel,REP,330017,6,6,180,192,
Jackson,State Treasurer,Charles De Coune,IND,330017,0,3,25,28,
Jackson,Superintendent of Public Instruction,Joy Hofmeister,REP,330017,5,5,152,162,
Jackson,Superintendent of Public Instruction,John Cox,DEM,330017,1,2,37,40,
Jackson,Superintendent of Public Instruction,Larry Huff,IND,330017,0,2,27,29,
Jackson,Commissioner of Labor,Leslie Osborn,REP,330017,5,7,178,190,
Jackson,Commissioner of Labor,Fred Dorrell,DEM,330017,1,1,32,34,
Jackson,Commissioner of Labor,Brandt Dismukes,IND,330017,0,1,4,5,
Jackson,Insurance Commissioner,Glen Mulready,REP,330017,6,6,169,181,
Jackson,Insurance Commissioner,Kimberly Fobbs,DEM,330017,0,2,45,47,
Jackson,Corporation Commissioner,Bob Anthony,REP,330017,5,6,169,180,
Jackson,Corporation Commissioner,Ashley Nicole Mccray,DEM,330017,1,2,36,39,
Jackson,Corporation Commissioner,Jackie Short,IND,330017,0,1,9,10,
Jackson,U.S. House,Frank Lucas,REP,330017,6,8,183,197,3
Jackson,U.S. House,Frankie Robbins,DEM,330017,0,1,36,37,3
Jackson,State Senate,Brent Howard,REP,330017,6,9,179,194,38
Jackson,State Senate,Jeff Berrong,DEM,330017,0,0,40,40,38
Jackson,Governor,Chris Powell,LIB,330018,0,0,3,3,
Jackson,Governor,Kevin Stitt,REP,330018,1,5,94,100,
Jackson,Governor,Drew Edmondson,DEM,330018,2,0,33,35,
Jackson,Lieutenant Governor,Matt Pinnell,REP,330018,1,5,100,106,
Jackson,Lieutenant Governor,Anastasia Pittman,DEM,330018,2,0,24,26,
Jackson,Lieutenant Governor,Ivan Holmes,IND,330018,0,0,3,3,
Jackson,State Auditor,John Yeutter,LIB,330018,1,1,14,16,
Jackson,State Auditor,Cindy Byrd,REP,330018,2,4,106,112,
Jackson,Attorney General,Mike Hunter,REP,330018,2,5,105,112,
Jackson,Attorney General,Mark Myles,DEM,330018,1,0,20,21,
Jackson,State Treasurer,Randy Mcdaniel,REP,330018,2,5,106,113,
Jackson,State Treasurer,Charles De Coune,IND,330018,1,0,15,16,
Jackson,Superintendent of Public Instruction,Joy Hofmeister,REP,330018,1,5,91,97,
Jackson,Superintendent of Public Instruction,John Cox,DEM,330018,2,0,24,26,
Jackson,Superintendent of Public Instruction,Larry Huff,IND,330018,0,0,13,13,
Jackson,Commissioner of Labor,Leslie Osborn,REP,330018,1,5,103,109,
Jackson,Commissioner of Labor,Fred Dorrell,DEM,330018,2,0,19,21,
Jackson,Commissioner of Labor,Brandt Dismukes,IND,330018,0,0,3,3,
Jackson,Insurance Commissioner,Glen Mulready,REP,330018,2,5,99,106,
Jackson,Insurance Commissioner,Kimberly Fobbs,DEM,330018,1,0,25,26,
Jackson,Corporation Commissioner,Bob Anthony,REP,330018,1,5,100,106,
Jackson,Corporation Commissioner,Ashley Nicole Mccray,DEM,330018,1,0,20,21,
Jackson,Corporation Commissioner,Jackie Short,IND,330018,1,0,5,6,
Jackson,U.S. House,Frank Lucas,REP,330018,1,5,114,120,3
Jackson,U.S. House,Frankie Robbins,DEM,330018,2,0,15,17,3
Jackson,State Senate,Brent Howard,REP,330018,1,5,104,110,38
Jackson,State Senate,Jeff Berrong,DEM,330018,2,0,26,28,38
Jackson,Governor,Chris Powell,LIB,330019,0,2,6,8,
Jackson,Governor,Kevin Stitt,REP,330019,2,6,79,87,
Jackson,Governor,Drew Edmondson,DEM,330019,1,6,25,32,
Jackson,Lieutenant Governor,Matt Pinnell,REP,330019,3,8,91,102,
Jackson,Lieutenant Governor,Anastasia Pittman,DEM,330019,0,4,14,18,
Jackson,Lieutenant Governor,Ivan Holmes,IND,330019,0,0,2,2,
Jackson,State Auditor,John Yeutter,LIB,330019,0,3,15,18,
Jackson,State Auditor,Cindy Byrd,REP,330019,3,8,86,97,
Jackson,Attorney General,Mike Hunter,REP,330019,3,9,89,101,
Jackson,Attorney General,Mark Myles,DEM,330019,0,4,17,21,
Jackson,State Treasurer,Randy Mcdaniel,REP,330019,3,9,90,102,
Jackson,State Treasurer,Charles De Coune,IND,330019,0,2,15,17,
Jackson,Superintendent of Public Instruction,Joy Hofmeister,REP,330019,2,7,84,93,
Jackson,Superintendent of Public Instruction,John Cox,DEM,330019,1,5,15,21,
Jackson,Superintendent of Public Instruction,Larry Huff,IND,330019,0,0,7,7,
Jackson,Commissioner of Labor,Leslie Osborn,REP,330019,3,8,83,94,
Jackson,Commissioner of Labor,Fred Dorrell,DEM,330019,0,4,17,21,
Jackson,Commissioner of Labor,Brandt Dismukes,IND,330019,0,0,3,3,
Jackson,Insurance Commissioner,Glen Mulready,REP,330019,3,8,87,98,
Jackson,Insurance Commissioner,Kimberly Fobbs,DEM,330019,0,5,17,22,
Jackson,Corporation Commissioner,Bob Anthony,REP,330019,2,8,87,97,
Jackson,Corporation Commissioner,Ashley Nicole Mccray,DEM,330019,1,4,17,22,
Jackson,Corporation Commissioner,Jackie Short,IND,330019,0,0,1,1,
Jackson,U.S. House,Frank Lucas,REP,330019,3,8,95,106,3
Jackson,U.S. House,Frankie Robbins,DEM,330019,0,5,14,19,3
Jackson,State Senate,Brent Howard,REP,330019,2,9,91,102,38
Jackson,State Senate,Jeff Berrong,DEM,330019,1,4,19,24,38
Jackson,Governor,Chris Powell,LIB,330020,1,3,14,18,
Jackson,Governor,Kevin Stitt,REP,330020,11,71,353,435,
Jackson,Governor,Drew Edmondson,DEM,330020,2,11,86,99,
Jackson,Lieutenant Governor,Matt Pinnell,REP,330020,11,73,384,468,
Jackson,Lieutenant Governor,Anastasia Pittman,DEM,330020,1,5,54,60,
Jackson,Lieutenant Governor,Ivan Holmes,IND,330020,2,7,12,21,
Jackson,State Auditor,John Yeutter,LIB,330020,3,6,47,56,
Jackson,State Auditor,Cindy Byrd,REP,330020,10,78,392,480,
Jackson,Attorney General,Mike Hunter,REP,330020,13,80,392,485,
Jackson,Attorney General,Mark Myles,DEM,330020,1,6,56,63,
Jackson,State Treasurer,Randy Mcdaniel,REP,330020,10,76,393,479,
Jackson,State Treasurer,Charles De Coune,IND,330020,3,8,46,57,
Jackson,Superintendent of Public Instruction,Joy Hofmeister,REP,330020,8,71,347,426,
Jackson,Superintendent of Public Instruction,John Cox,DEM,330020,1,8,60,69,
Jackson,Superintendent of Public Instruction,Larry Huff,IND,330020,5,6,41,52,
Jackson,Commissioner of Labor,Leslie Osborn,REP,330020,10,76,374,460,
Jackson,Commissioner of Labor,Fred Dorrell,DEM,330020,1,9,56,66,
Jackson,Commissioner of Labor,Brandt Dismukes,IND,330020,3,1,16,20,
Jackson,Insurance Commissioner,Glen Mulready,REP,330020,13,73,379,465,
Jackson,Insurance Commissioner,Kimberly Fobbs,DEM,330020,1,10,65,76,
Jackson,Corporation Commissioner,Bob Anthony,REP,330020,11,67,376,454,
Jackson,Corporation Commissioner,Ashley Nicole Mccray,DEM,330020,1,10,51,62,
Jackson,Corporation Commissioner,Jackie Short,IND,330020,2,6,18,26,
Jackson,U.S. House,Frank Lucas,REP,330020,13,76,392,481,3
Jackson,U.S. House,Frankie Robbins,DEM,330020,1,8,56,65,3
Jackson,State Senate,Brent Howard,REP,330020,13,77,389,479,38
Jackson,State Senate,Jeff Berrong,DEM,330020,1,9,64,74,38
Jackson,Governor,Chris Powell,LIB,330021,0,0,1,1,
Jackson,Governor,Kevin Stitt,REP,330021,2,8,53,63,
Jackson,Governor,Drew Edmondson,DEM,330021,1,1,21,23,
Jackson,Lieutenant Governor,Matt Pinnell,REP,330021,3,8,55,66,
Jackson,Lieutenant Governor,Anastasia Pittman,DEM,330021,0,1,17,18,
Jackson,Lieutenant Governor,Ivan Holmes,IND,330021,0,0,2,2,
Jackson,State Auditor,John Yeutter,LIB,330021,0,0,13,13,
Jackson,State Auditor,Cindy Byrd,REP,330021,3,9,60,72,
Jackson,Attorney General,Mike Hunter,REP,330021,3,9,55,67,
Jackson,Attorney General,Mark Myles,DEM,330021,0,0,19,19,
Jackson,State Treasurer,Randy Mcdaniel,REP,330021,2,8,54,64,
Jackson,State Treasurer,Charles De Coune,IND,330021,1,1,17,19,
Jackson,Superintendent of Public Instruction,Joy Hofmeister,REP,330021,2,7,47,56,
Jackson,Superintendent of Public Instruction,John Cox,DEM,330021,1,1,18,20,
Jackson,Superintendent of Public Instruction,Larry Huff,IND,330021,0,1,10,11,
Jackson,Commissioner of Labor,Leslie Osborn,REP,330021,2,9,53,64,
Jackson,Commissioner of Labor,Fred Dorrell,DEM,330021,1,0,16,17,
Jackson,Commissioner of Labor,Brandt Dismukes,IND,330021,0,0,5,5,
Jackson,Insurance Commissioner,Glen Mulready,REP,330021,3,8,56,67,
Jackson,Insurance Commissioner,Kimberly Fobbs,DEM,330021,0,1,17,18,
Jackson,Corporation Commissioner,Bob Anthony,REP,330021,3,9,53,65,
Jackson,Corporation Commissioner,Ashley Nicole Mccray,DEM,330021,0,0,16,16,
Jackson,Corporation Commissioner,Jackie Short,IND,330021,0,0,4,4,
Jackson,U.S. House,Frank Lucas,REP,330021,3,9,59,71,3
Jackson,U.S. House,Frankie Robbins,DEM,330021,0,0,15,15,3
Jackson,State Senate,Brent Howard,REP,330021,3,8,65,76,38
Jackson,State Senate,Jeff Berrong,DEM,330021,0,1,10,11,38
Jackson,Governor,Chris Powell,LIB,330023,0,0,4,4,
Jackson,Governor,Kevin Stitt,REP,330023,5,32,187,224,
Jackson,Governor,Drew Edmondson,DEM,330023,0,13,48,61,
Jackson,Lieutenant Governor,Matt Pinnell,REP,330023,5,35,192,232,
Jackson,Lieutenant Governor,Anastasia Pittman,DEM,330023,0,8,38,46,
Jackson,Lieutenant Governor,Ivan Holmes,IND,330023,0,0,6,6,
Jackson,State Auditor,John Yeutter,LIB,330023,0,4,20,24,
Jackson,State Auditor,Cindy Byrd,REP,330023,5,37,209,251,
Jackson,Attorney General,Mike Hunter,REP,330023,5,36,206,247,
Jackson,Attorney General,Mark Myles,DEM,330023,0,6,30,36,
Jackson,State Treasurer,Randy Mcdaniel,REP,330023,5,37,204,246,
Jackson,State Treasurer,Charles De Coune,IND,330023,0,4,26,30,
Jackson,Superintendent of Public Instruction,Joy Hofmeister,REP,330023,5,28,172,205,
Jackson,Superintendent of Public Instruction,John Cox,DEM,330023,0,11,36,47,
Jackson,Superintendent of Public Instruction,Larry Huff,IND,330023,0,3,27,30,
Jackson,Commissioner of Labor,Leslie Osborn,REP,330023,5,33,194,232,
Jackson,Commissioner of Labor,Fred Dorrell,DEM,330023,0,8,32,40,
Jackson,Commissioner of Labor,Brandt Dismukes,IND,330023,0,0,11,11,
Jackson,Insurance Commissioner,Glen Mulready,REP,330023,5,36,202,243,
Jackson,Insurance Commissioner,Kimberly Fobbs,DEM,330023,0,5,32,37,
Jackson,Corporation Commissioner,Bob Anthony,REP,330023,5,35,200,240,
Jackson,Corporation Commissioner,Ashley Nicole Mccray,DEM,330023,0,6,27,33,
Jackson,Corporation Commissioner,Jackie Short,IND,330023,0,0,9,9,
Jackson,U.S. House,Frank Lucas,REP,330023,5,39,209,253,3
Jackson,U.S. House,Frankie Robbins,DEM,330023,0,6,29,35,3
Jackson,State Senate,Brent Howard,REP,330023,5,32,210,247,38
Jackson,State Senate,Jeff Berrong,DEM,330023,0,13,29,42,38
Jackson,Governor,Chris Powell,LIB,330024,0,1,5,6,
Jackson,Governor,Kevin Stitt,REP,330024,2,8,96,106,
Jackson,Governor,Drew Edmondson,DEM,330024,1,4,36,41,
Jackson,Lieutenant Governor,Matt Pinnell,REP,330024,2,9,100,111,
Jackson,Lieutenant Governor,Anastasia Pittman,DEM,330024,1,4,30,35,
Jackson,Lieutenant Governor,Ivan Holmes,IND,330024,0,0,5,5,
Jackson,State Auditor,John Yeutter,LIB,330024,1,4,17,22,
Jackson,State Auditor,Cindy Byrd,REP,330024,2,9,112,123,
Jackson,Attorney General,Mike Hunter,REP,330024,3,9,109,121,
Jackson,Attorney General,Mark Myles,DEM,330024,0,4,28,32,
Jackson,State Treasurer,Randy Mcdaniel,REP,330024,2,8,114,124,
Jackson,State Treasurer,Charles De Coune,IND,330024,1,4,15,20,
Jackson,Superintendent of Public Instruction,Joy Hofmeister,REP,330024,2,8,88,98,
Jackson,Superintendent of Public Instruction,John Cox,DEM,330024,1,4,36,41,
Jackson,Superintendent of Public Instruction,Larry Huff,IND,330024,0,1,12,13,
Jackson,Commissioner of Labor,Leslie Osborn,REP,330024,2,7,102,111,
Jackson,Commissioner of Labor,Fred Dorrell,DEM,330024,1,5,28,34,
Jackson,Commissioner of Labor,Brandt Dismukes,IND,330024,0,1,4,5,
Jackson,Insurance Commissioner,Glen Mulready,REP,330024,2,9,104,115,
Jackson,Insurance Commissioner,Kimberly Fobbs,DEM,330024,1,4,32,37,
Jackson,Corporation Commissioner,Bob Anthony,REP,330024,1,9,95,105,
Jackson,Corporation Commissioner,Ashley Nicole Mccray,DEM,330024,1,4,31,36,
Jackson,Corporation Commissioner,Jackie Short,IND,330024,1,0,7,8,
Jackson,U.S. House,Frank Lucas,REP,330024,2,11,108,121,3
Jackson,U.S. House,Frankie Robbins,DEM,330024,1,2,28,31,3
Jackson,State Senate,Brent Howard,REP,330024,2,10,102,114,38
Jackson,State Senate,Jeff Berrong,DEM,330024,1,3,33,37,38
Jefferson,Governor,Chris Powell,LIB,340001,0,0,9,9,
Jefferson,Governor,Kevin Stitt,REP,340001,3,28,125,156,
Jefferson,Governor,Drew Edmondson,DEM,340001,3,8,51,62,
Jefferson,Lieutenant Governor,Matt Pinnell,REP,340001,3,28,122,153,
Jefferson,Lieutenant Governor,Anastasia Pittman,DEM,340001,3,7,52,62,
Jefferson,Lieutenant Governor,Ivan Holmes,IND,340001,0,1,11,12,
Jefferson,State Auditor,John Yeutter,LIB,340001,1,3,27,31,
Jefferson,State Auditor,Cindy Byrd,REP,340001,4,29,143,176,
Jefferson,Attorney General,Mike Hunter,REP,340001,3,28,134,165,
Jefferson,Attorney General,Mark Myles,DEM,340001,3,8,49,60,
Jefferson,State Treasurer,Randy Mcdaniel,REP,340001,4,30,136,170,
Jefferson,State Treasurer,Charles De Coune,IND,340001,1,4,35,40,
Jefferson,Superintendent of Public Instruction,Joy Hofmeister,REP,340001,4,31,117,152,
Jefferson,Superintendent of Public Instruction,John Cox,DEM,340001,2,5,53,60,
Jefferson,Superintendent of Public Instruction,Larry Huff,IND,340001,0,1,14,15,
Jefferson,Commissioner of Labor,Leslie Osborn,REP,340001,2,26,121,149,
Jefferson,Commissioner of Labor,Fred Dorrell,DEM,340001,4,7,44,55,
Jefferson,Commissioner of Labor,Brandt Dismukes,IND,340001,0,2,17,19,
Jefferson,Insurance Commissioner,Glen Mulready,REP,340001,3,24,127,154,
Jefferson,Insurance Commissioner,Kimberly Fobbs,DEM,340001,3,11,57,71,
Jefferson,Corporation Commissioner,Bob Anthony,REP,340001,2,26,124,152,
Jefferson,Corporation Commissioner,Ashley Nicole Mccray,DEM,340001,3,7,49,59,
Jefferson,Corporation Commissioner,Jackie Short,IND,340001,1,2,12,15,
Jefferson,U.S. House,Tom Cole,REP,340001,4,28,136,168,4
Jefferson,U.S. House,Mary Brannon,DEM,340001,2,8,40,50,4
Jefferson,U.S. House,Ruby Peters,IND,340001,0,0,9,9,4
Jefferson,Governor,Chris Powell,LIB,340002,0,0,4,4,
Jefferson,Governor,Kevin Stitt,REP,340002,6,32,116,154,
Jefferson,Governor,Drew Edmondson,DEM,340002,1,7,47,55,
Jefferson,Lieutenant Governor,Matt Pinnell,REP,340002,6,34,138,178,
Jefferson,Lieutenant Governor,Anastasia Pittman,DEM,340002,1,5,26,32,
Jefferson,Lieutenant Governor,Ivan Holmes,IND,340002,0,0,3,3,
Jefferson,State Auditor,John Yeutter,LIB,340002,0,3,16,19,
Jefferson,State Auditor,Cindy Byrd,REP,340002,7,32,141,180,
Jefferson,Attorney General,Mike Hunter,REP,340002,6,30,133,169,
Jefferson,Attorney General,Mark Myles,DEM,340002,1,6,35,42,
Jefferson,State Treasurer,Randy Mcdaniel,REP,340002,7,33,143,183,
Jefferson,State Treasurer,Charles De Coune,IND,340002,0,2,16,18,
Jefferson,Superintendent of Public Instruction,Joy Hofmeister,REP,340002,5,31,124,160,
Jefferson,Superintendent of Public Instruction,John Cox,DEM,340002,1,5,34,40,
Jefferson,Superintendent of Public Instruction,Larry Huff,IND,340002,1,0,10,11,
Jefferson,Commissioner of Labor,Leslie Osborn,REP,340002,7,30,133,170,
Jefferson,Commissioner of Labor,Fred Dorrell,DEM,340002,0,6,29,35,
Jefferson,Commissioner of Labor,Brandt Dismukes,IND,340002,0,0,3,3,
Jefferson,Insurance Commissioner,Glen Mulready,REP,340002,6,30,132,168,
Jefferson,Insurance Commissioner,Kimberly Fobbs,DEM,340002,1,6,33,40,
Jefferson,Corporation Commissioner,Bob Anthony,REP,340002,6,33,131,170,
Jefferson,Corporation Commissioner,Ashley Nicole Mccray,DEM,340002,1,5,27,33,
Jefferson,Corporation Commissioner,Jackie Short,IND,340002,0,0,8,8,
Jefferson,U.S. House,Tom Cole,REP,340002,6,33,131,170,4
Jefferson,U.S. House,Mary Brannon,DEM,340002,1,4,28,33,4
Jefferson,U.S. House,Ruby Peters,IND,340002,0,0,6,6,4
Jefferson,Governor,Chris Powell,LIB,340003,0,0,4,4,
Jefferson,Governor,Kevin Stitt,REP,340003,7,13,59,79,
Jefferson,Governor,Drew Edmondson,DEM,340003,1,5,16,22,
Jefferson,Lieutenant Governor,Matt Pinnell,REP,340003,8,14,64,86,
Jefferson,Lieutenant Governor,Anastasia Pittman,DEM,340003,0,4,14,18,
Jefferson,Lieutenant Governor,Ivan Holmes,IND,340003,0,0,0,0,
Jefferson,State Auditor,John Yeutter,LIB,340003,0,2,8,10,
Jefferson,State Auditor,Cindy Byrd,REP,340003,8,15,66,89,
Jefferson,Attorney General,Mike Hunter,REP,340003,8,14,66,88,
Jefferson,Attorney General,Mark Myles,DEM,340003,0,4,12,16,
Jefferson,State Treasurer,Randy Mcdaniel,REP,340003,8,15,66,89,
Jefferson,State Treasurer,Charles De Coune,IND,340003,0,3,8,11,
Jefferson,Superintendent of Public Instruction,Joy Hofmeister,REP,340003,8,12,64,84,
Jefferson,Superintendent of Public Instruction,John Cox,DEM,340003,0,4,12,16,
Jefferson,Superintendent of Public Instruction,Larry Huff,IND,340003,0,2,2,4,
Jefferson,Commissioner of Labor,Leslie Osborn,REP,340003,7,13,63,83,
Jefferson,Commissioner of Labor,Fred Dorrell,DEM,340003,1,5,12,18,
Jefferson,Commissioner of Labor,Brandt Dismukes,IND,340003,0,0,1,1,
Jefferson,Insurance Commissioner,Glen Mulready,REP,340003,8,11,66,85,
Jefferson,Insurance Commissioner,Kimberly Fobbs,DEM,340003,0,7,12,19,
Jefferson,Corporation Commissioner,Bob Anthony,REP,340003,8,13,64,85,
Jefferson,Corporation Commissioner,Ashley Nicole Mccray,DEM,340003,0,4,12,16,
Jefferson,Corporation Commissioner,Jackie Short,IND,340003,0,1,2,3,
Jefferson,U.S. House,Tom Cole,REP,340003,8,14,67,89,4
Jefferson,U.S. House,Mary Brannon,DEM,340003,0,4,10,14,4
Jefferson,U.S. House,Ruby Peters,IND,340003,0,0,1,1,4
Jefferson,Governor,Chris Powell,LIB,340004,0,0,2,2,
Jefferson,Governor,Kevin Stitt,REP,340004,0,9,55,64,
Jefferson,Governor,Drew Edmondson,DEM,340004,0,4,15,19,
Jefferson,Lieutenant Governor,Matt Pinnell,REP,340004,0,10,56,66,
Jefferson,Lieutenant Governor,Anastasia Pittman,DEM,340004,0,3,14,17,
Jefferson,Lieutenant Governor,Ivan Holmes,IND,340004,0,0,2,2,
Jefferson,State Auditor,John Yeutter,LIB,340004,0,3,4,7,
Jefferson,State Auditor,Cindy Byrd,REP,340004,0,10,62,72,
Jefferson,Attorney General,Mike Hunter,REP,340004,0,10,59,69,
Jefferson,Attorney General,Mark Myles,DEM,340004,0,3,13,16,
Jefferson,State Treasurer,Randy Mcdaniel,REP,340004,0,12,62,74,
Jefferson,State Treasurer,Charles De Coune,IND,340004,0,1,4,5,
Jefferson,Superintendent of Public Instruction,Joy Hofmeister,REP,340004,0,9,52,61,
Jefferson,Superintendent of Public Instruction,John Cox,DEM,340004,0,2,14,16,
Jefferson,Superintendent of Public Instruction,Larry Huff,IND,340004,0,2,6,8,
Jefferson,Commissioner of Labor,Leslie Osborn,REP,340004,0,9,56,65,
Jefferson,Commissioner of Labor,Fred Dorrell,DEM,340004,0,3,14,17,
Jefferson,Commissioner of Labor,Brandt Dismukes,IND,340004,0,1,1,2,
Jefferson,Insurance Commissioner,Glen Mulready,REP,340004,0,10,55,65,
Jefferson,Insurance Commissioner,Kimberly Fobbs,DEM,340004,0,3,17,20,
Jefferson,Corporation Commissioner,Bob Anthony,REP,340004,0,10,54,64,
Jefferson,Corporation Commissioner,Ashley Nicole Mccray,DEM,340004,0,1,16,17,
Jefferson,Corporation Commissioner,Jackie Short,IND,340004,0,2,2,4,
Jefferson,U.S. House,Tom Cole,REP,340004,0,9,59,68,4
Jefferson,U.S. House,Mary Brannon,DEM,340004,0,3,11,14,4
Jefferson,U.S. House,Ruby Peters,IND,340004,0,1,2,3,4
Jefferson,Governor,Chris Powell,LIB,340005,0,0,3,3,
Jefferson,Governor,Kevin Stitt,REP,340005,1,7,22,30,
Jefferson,Governor,Drew Edmondson,DEM,340005,0,1,11,12,
Jefferson,Lieutenant Governor,Matt Pinnell,REP,340005,0,5,24,29,
Jefferson,Lieutenant Governor,Anastasia Pittman,DEM,340005,1,3,10,14,
Jefferson,Lieutenant Governor,Ivan Holmes,IND,340005,0,0,2,2,
Jefferson,State Auditor,John Yeutter,LIB,340005,1,0,4,5,
Jefferson,State Auditor,Cindy Byrd,REP,340005,0,7,29,36,
Jefferson,Attorney General,Mike Hunter,REP,340005,0,4,27,31,
Jefferson,Attorney General,Mark Myles,DEM,340005,1,4,9,14,
Jefferson,State Treasurer,Randy Mcdaniel,REP,340005,1,5,28,34,
Jefferson,State Treasurer,Charles De Coune,IND,340005,0,2,4,6,
Jefferson,Superintendent of Public Instruction,Joy Hofmeister,REP,340005,0,4,23,27,
Jefferson,Superintendent of Public Instruction,John Cox,DEM,340005,1,3,9,13,
Jefferson,Superintendent of Public Instruction,Larry Huff,IND,340005,0,1,3,4,
Jefferson,Commissioner of Labor,Leslie Osborn,REP,340005,0,4,24,28,
Jefferson,Commissioner of Labor,Fred Dorrell,DEM,340005,1,3,11,15,
Jefferson,Commissioner of Labor,Brandt Dismukes,IND,340005,0,1,1,2,
Jefferson,Insurance Commissioner,Glen Mulready,REP,340005,0,3,25,28,
Jefferson,Insurance Commissioner,Kimberly Fobbs,DEM,340005,1,5,11,17,
Jefferson,Corporation Commissioner,Bob Anthony,REP,340005,0,4,26,30,
Jefferson,Corporation Commissioner,Ashley Nicole Mccray,DEM,340005,1,2,9,12,
Jefferson,Corporation Commissioner,Jackie Short,IND,340005,0,2,1,3,
Jefferson,U.S. House,Tom Cole,REP,340005,1,4,27,32,4
Jefferson,U.S. House,Mary Brannon,DEM,340005,0,4,8,12,4
Jefferson,U.S. House,Ruby Peters,IND,340005,0,0,1,1,4
Jefferson,Governor,Chris Powell,LIB,340006,0,1,8,9,
Jefferson,Governor,Kevin Stitt,REP,340006,2,16,140,158,
Jefferson,Governor,Drew Edmondson,DEM,340006,3,4,69,76,
Jefferson,Lieutenant Governor,Matt Pinnell,REP,340006,2,15,152,169,
Jefferson,Lieutenant Governor,Anastasia Pittman,DEM,340006,3,4,57,64,
Jefferson,Lieutenant Governor,Ivan Holmes,IND,340006,0,0,5,5,
Jefferson,State Auditor,John Yeutter,LIB,340006,1,4,28,33,
Jefferson,State Auditor,Cindy Byrd,REP,340006,2,15,165,182,
Jefferson,Attorney General,Mike Hunter,REP,340006,2,16,157,175,
Jefferson,Attorney General,Mark Myles,DEM,340006,3,3,56,62,
Jefferson,State Treasurer,Randy Mcdaniel,REP,340006,2,15,164,181,
Jefferson,State Treasurer,Charles De Coune,IND,340006,1,3,28,32,
Jefferson,Superintendent of Public Instruction,Joy Hofmeister,REP,340006,2,11,153,166,
Jefferson,Superintendent of Public Instruction,John Cox,DEM,340006,3,7,52,62,
Jefferson,Superintendent of Public Instruction,Larry Huff,IND,340006,0,2,9,11,
Jefferson,Commissioner of Labor,Leslie Osborn,REP,340006,2,14,149,165,
Jefferson,Commissioner of Labor,Fred Dorrell,DEM,340006,3,4,53,60,
Jefferson,Commissioner of Labor,Brandt Dismukes,IND,340006,0,1,8,9,
Jefferson,Insurance Commissioner,Glen Mulready,REP,340006,2,16,153,171,
Jefferson,Insurance Commissioner,Kimberly Fobbs,DEM,340006,3,3,56,62,
Jefferson,Corporation Commissioner,Bob Anthony,REP,340006,2,16,157,175,
Jefferson,Corporation Commissioner,Ashley Nicole Mccray,DEM,340006,3,3,47,53,
Jefferson,Corporation Commissioner,Jackie Short,IND,340006,0,1,8,9,
Jefferson,U.S. House,Tom Cole,REP,340006,2,16,164,182,4
Jefferson,U.S. House,Mary Brannon,DEM,340006,3,3,47,53,4
Jefferson,U.S. House,Ruby Peters,IND,340006,0,1,4,5,4
Jefferson,Governor,Chris Powell,LIB,340007,0,0,2,2,
Jefferson,Governor,Kevin Stitt,REP,340007,0,4,66,70,
Jefferson,Governor,Drew Edmondson,DEM,340007,2,1,47,50,
Jefferson,Lieutenant Governor,Matt Pinnell,REP,340007,1,4,69,74,
Jefferson,Lieutenant Governor,Anastasia Pittman,DEM,340007,1,1,39,41,
Jefferson,Lieutenant Governor,Ivan Holmes,IND,340007,0,0,7,7,
Jefferson,State Auditor,John Yeutter,LIB,340007,0,1,16,17,
Jefferson,State Auditor,Cindy Byrd,REP,340007,2,4,87,93,
Jefferson,Attorney General,Mike Hunter,REP,340007,0,4,68,72,
Jefferson,Attorney General,Mark Myles,DEM,340007,2,1,45,48,
Jefferson,State Treasurer,Randy Mcdaniel,REP,340007,2,4,80,86,
Jefferson,State Treasurer,Charles De Coune,IND,340007,0,1,23,24,
Jefferson,Superintendent of Public Instruction,Joy Hofmeister,REP,340007,1,4,60,65,
Jefferson,Superintendent of Public Instruction,John Cox,DEM,340007,1,1,47,49,
Jefferson,Superintendent of Public Instruction,Larry Huff,IND,340007,0,0,7,7,
Jefferson,Commissioner of Labor,Leslie Osborn,REP,340007,1,5,68,74,
Jefferson,Commissioner of Labor,Fred Dorrell,DEM,340007,1,0,38,39,
Jefferson,Commissioner of Labor,Brandt Dismukes,IND,340007,0,0,6,6,
Jefferson,Insurance Commissioner,Glen Mulready,REP,340007,1,4,70,75,
Jefferson,Insurance Commissioner,Kimberly Fobbs,DEM,340007,1,1,42,44,
Jefferson,Corporation Commissioner,Bob Anthony,REP,340007,1,4,66,71,
Jefferson,Corporation Commissioner,Ashley Nicole Mccray,DEM,340007,1,1,41,43,
Jefferson,Corporation Commissioner,Jackie Short,IND,340007,0,0,6,6,
Jefferson,U.S. House,Tom Cole,REP,340007,1,4,76,81,4
Jefferson,U.S. House,Mary Brannon,DEM,340007,1,1,36,38,4
Jefferson,U.S. House,Ruby Peters,IND,340007,0,0,3,3,4
Jefferson,Governor,Chris Powell,LIB,340008,0,0,1,1,
Jefferson,Governor,Kevin Stitt,REP,340008,0,8,18,26,
Jefferson,Governor,Drew Edmondson,DEM,340008,0,1,4,5,
Jefferson,Lieutenant Governor,Matt Pinnell,REP,340008,0,8,20,28,
Jefferson,Lieutenant Governor,Anastasia Pittman,DEM,340008,0,1,2,3,
Jefferson,Lieutenant Governor,Ivan Holmes,IND,340008,0,0,1,1,
Jefferson,State Auditor,John Yeutter,LIB,340008,0,0,1,1,
Jefferson,State Auditor,Cindy Byrd,REP,340008,0,8,21,29,
Jefferson,Attorney General,Mike Hunter,REP,340008,0,8,21,29,
Jefferson,Attorney General,Mark Myles,DEM,340008,0,1,2,3,
Jefferson,State Treasurer,Randy Mcdaniel,REP,340008,0,8,21,29,
Jefferson,State Treasurer,Charles De Coune,IND,340008,0,0,1,1,
Jefferson,Superintendent of Public Instruction,Joy Hofmeister,REP,340008,0,7,20,27,
Jefferson,Superintendent of Public Instruction,John Cox,DEM,340008,0,2,3,5,
Jefferson,Superintendent of Public Instruction,Larry Huff,IND,340008,0,0,0,0,
Jefferson,Commissioner of Labor,Leslie Osborn,REP,340008,0,8,21,29,
Jefferson,Commissioner of Labor,Fred Dorrell,DEM,340008,0,1,1,2,
Jefferson,Commissioner of Labor,Brandt Dismukes,IND,340008,0,0,1,1,
Jefferson,Insurance Commissioner,Glen Mulready,REP,340008,0,8,21,29,
Jefferson,Insurance Commissioner,Kimberly Fobbs,DEM,340008,0,1,2,3,
Jefferson,Corporation Commissioner,Bob Anthony,REP,340008,0,8,19,27,
Jefferson,Corporation Commissioner,Ashley Nicole Mccray,DEM,340008,0,1,4,5,
Jefferson,Corporation Commissioner,Jackie Short,IND,340008,0,0,0,0,
Jefferson,U.S. House,Tom Cole,REP,340008,0,8,21,29,4
Jefferson,U.S. House,Mary Brannon,DEM,340008,0,1,2,3,4
Jefferson,U.S. House,Ruby Peters,IND,340008,0,0,0,0,4
Jefferson,Governor,Chris Powell,LIB,340009,0,0,12,12,
Jefferson,Governor,Kevin Stitt,REP,340009,6,14,316,336,
Jefferson,Governor,Drew Edmondson,DEM,340009,4,5,107,116,
Jefferson,Lieutenant Governor,Matt Pinnell,REP,340009,7,16,329,352,
Jefferson,Lieutenant Governor,Anastasia Pittman,DEM,340009,3,3,90,96,
Jefferson,Lieutenant Governor,Ivan Holmes,IND,340009,0,0,10,10,
Jefferson,State Auditor,John Yeutter,LIB,340009,3,0,52,55,
Jefferson,State Auditor,Cindy Byrd,REP,340009,7,19,349,375,
Jefferson,Attorney General,Mike Hunter,REP,340009,7,17,332,356,
Jefferson,Attorney General,Mark Myles,DEM,340009,3,2,98,103,
Jefferson,State Treasurer,Randy Mcdaniel,REP,340009,6,18,349,373,
Jefferson,State Treasurer,Charles De Coune,IND,340009,4,1,58,63,
Jefferson,Superintendent of Public Instruction,Joy Hofmeister,REP,340009,4,17,303,324,
Jefferson,Superintendent of Public Instruction,John Cox,DEM,340009,4,2,103,109,
Jefferson,Superintendent of Public Instruction,Larry Huff,IND,340009,2,0,25,27,
Jefferson,Commissioner of Labor,Leslie Osborn,REP,340009,6,18,322,346,
Jefferson,Commissioner of Labor,Fred Dorrell,DEM,340009,3,1,87,91,
Jefferson,Commissioner of Labor,Brandt Dismukes,IND,340009,1,0,18,19,
Jefferson,Insurance Commissioner,Glen Mulready,REP,340009,7,17,323,347,
Jefferson,Insurance Commissioner,Kimberly Fobbs,DEM,340009,3,2,105,110,
Jefferson,Corporation Commissioner,Bob Anthony,REP,340009,6,17,319,342,
Jefferson,Corporation Commissioner,Ashley Nicole Mccray,DEM,340009,3,2,92,97,
Jefferson,Corporation Commissioner,Jackie Short,IND,340009,1,0,20,21,
Jefferson,U.S. House,Tom Cole,REP,340009,5,18,348,371,4
Jefferson,U.S. House,Mary Brannon,DEM,340009,4,1,79,84,4
Jefferson,U.S. House,Ruby Peters,IND,340009,0,0,8,8,4
Jefferson,Governor,Chris Powell,LIB,340010,0,0,0,0,
Jefferson,Governor,Kevin Stitt,REP,340010,2,2,22,26,
Jefferson,Governor,Drew Edmondson,DEM,340010,0,0,7,7,
Jefferson,Lieutenant Governor,Matt Pinnell,REP,340010,2,2,24,28,
Jefferson,Lieutenant Governor,Anastasia Pittman,DEM,340010,0,0,5,5,
Jefferson,Lieutenant Governor,Ivan Holmes,IND,340010,0,0,0,0,
Jefferson,State Auditor,John Yeutter,LIB,340010,0,0,2,2,
Jefferson,State Auditor,Cindy Byrd,REP,340010,2,2,24,28,
Jefferson,Attorney General,Mike Hunter,REP,340010,2,2,23,27,
Jefferson,Attorney General,Mark Myles,DEM,340010,0,0,7,7,
Jefferson,State Treasurer,Randy Mcdaniel,REP,340010,2,2,25,29,
Jefferson,State Treasurer,Charles De Coune,IND,340010,0,0,2,2,
Jefferson,Superintendent of Public Instruction,Joy Hofmeister,REP,340010,2,2,19,23,
Jefferson,Superintendent of Public Instruction,John Cox,DEM,340010,0,0,6,6,
Jefferson,Superintendent of Public Instruction,Larry Huff,IND,340010,0,0,4,4,
Jefferson,Commissioner of Labor,Leslie Osborn,REP,340010,2,2,23,27,
Jefferson,Commissioner of Labor,Fred Dorrell,DEM,340010,0,0,4,4,
Jefferson,Commissioner of Labor,Brandt Dismukes,IND,340010,0,0,2,2,
Jefferson,Insurance Commissioner,Glen Mulready,REP,340010,2,2,24,28,
Jefferson,Insurance Commissioner,Kimberly Fobbs,DEM,340010,0,0,5,5,
Jefferson,Corporation Commissioner,Bob Anthony,REP,340010,2,2,24,28,
Jefferson,Corporation Commissioner,Ashley Nicole Mccray,DEM,340010,0,0,5,5,
Jefferson,Corporation Commissioner,Jackie Short,IND,340010,0,0,1,1,
Jefferson,U.S. House,Tom Cole,REP,340010,2,2,27,31,4
Jefferson,U.S. House,Mary Brannon,DEM,340010,0,0,2,2,4
Jefferson,U.S. House,Ruby Peters,IND,340010,0,0,1,1,4
Johnston,Governor,Chris Powell,LIB,350001,0,3,5,8,
Johnston,Governor,Kevin Stitt,REP,350001,6,45,136,187,
Johnston,Governor,Drew Edmondson,DEM,350001,1,18,73,92,
Johnston,Lieutenant Governor,Matt Pinnell,REP,350001,6,51,158,215,
Johnston,Lieutenant Governor,Anastasia Pittman,DEM,350001,1,14,46,61,
Johnston,Lieutenant Governor,Ivan Holmes,IND,350001,0,1,8,9,
Johnston,State Auditor,John Yeutter,LIB,350001,1,6,16,23,
Johnston,State Auditor,Cindy Byrd,REP,350001,6,56,176,238,
Johnston,Attorney General,Mike Hunter,REP,350001,6,52,155,213,
Johnston,Attorney General,Mark Myles,DEM,350001,1,14,56,71,
Johnston,State Treasurer,Randy Mcdaniel,REP,350001,6,55,168,229,
Johnston,State Treasurer,Charles De Coune,IND,350001,1,7,22,30,
Johnston,Superintendent of Public Instruction,Joy Hofmeister,REP,350001,5,46,152,203,
Johnston,Superintendent of Public Instruction,John Cox,DEM,350001,2,16,54,72,
Johnston,Superintendent of Public Instruction,Larry Huff,IND,350001,0,3,6,9,
Johnston,Commissioner of Labor,Leslie Osborn,REP,350001,5,49,151,205,
Johnston,Commissioner of Labor,Fred Dorrell,DEM,350001,1,15,49,65,
Johnston,Commissioner of Labor,Brandt Dismukes,IND,350001,1,1,9,11,
Johnston,Insurance Commissioner,Glen Mulready,REP,350001,6,48,152,206,
Johnston,Insurance Commissioner,Kimberly Fobbs,DEM,350001,1,16,58,75,
Johnston,Corporation Commissioner,Bob Anthony,REP,350001,6,40,151,197,
Johnston,Corporation Commissioner,Ashley Nicole Mccray,DEM,350001,1,18,54,73,
Johnston,Corporation Commissioner,Jackie Short,IND,350001,0,6,7,13,
Johnston,U.S. House,Richard Castaldo,LIB,350001,0,0,6,6,2
Johnston,U.S. House,Markwayne Mullin,REP,350001,6,47,152,205,2
Johnston,U.S. House,Jason Nichols,DEM,350001,1,16,51,68,2
Johnston,U.S. House,John Foreman,IND,350001,0,3,5,8,2
Johnston,State Senate,David Bullard,REP,350001,6,45,150,201,6
Johnston,State Senate,Arnold Bourne,DEM,350001,1,21,63,85,6
Johnston,State House,Charles Mccall,REP,350001,5,46,156,207,22
Johnston,State House,Wayne Eidson,DEM,350001,1,19,49,69,22
Johnston,State House,Renae Ward,IND,350001,1,1,7,9,22
Johnston,Governor,Chris Powell,LIB,350002,0,2,6,8,
Johnston,Governor,Kevin Stitt,REP,350002,4,10,78,92,
Johnston,Governor,Drew Edmondson,DEM,350002,1,15,54,70,
Johnston,Lieutenant Governor,Matt Pinnell,REP,350002,3,11,91,105,
Johnston,Lieutenant Governor,Anastasia Pittman,DEM,350002,1,13,38,52,
Johnston,Lieutenant Governor,Ivan Holmes,IND,350002,1,3,8,12,
Johnston,State Auditor,John Yeutter,LIB,350002,1,7,20,28,
Johnston,State Auditor,Cindy Byrd,REP,350002,3,15,101,119,
Johnston,Attorney General,Mike Hunter,REP,350002,4,13,93,110,
Johnston,Attorney General,Mark Myles,DEM,350002,1,14,44,59,
Johnston,State Treasurer,Randy Mcdaniel,REP,350002,4,13,95,112,
Johnston,State Treasurer,Charles De Coune,IND,350002,1,8,23,32,
Johnston,Superintendent of Public Instruction,Joy Hofmeister,REP,350002,3,14,86,103,
Johnston,Superintendent of Public Instruction,John Cox,DEM,350002,2,12,41,55,
Johnston,Superintendent of Public Instruction,Larry Huff,IND,350002,0,1,8,9,
Johnston,Commissioner of Labor,Leslie Osborn,REP,350002,3,12,87,102,
Johnston,Commissioner of Labor,Fred Dorrell,DEM,350002,1,12,43,56,
Johnston,Commissioner of Labor,Brandt Dismukes,IND,350002,1,1,5,7,
Johnston,Insurance Commissioner,Glen Mulready,REP,350002,4,11,79,94,
Johnston,Insurance Commissioner,Kimberly Fobbs,DEM,350002,1,15,56,72,
Johnston,Corporation Commissioner,Bob Anthony,REP,350002,3,12,81,96,
Johnston,Corporation Commissioner,Ashley Nicole Mccray,DEM,350002,1,13,46,60,
Johnston,Corporation Commissioner,Jackie Short,IND,350002,1,2,7,10,
Johnston,U.S. House,Richard Castaldo,LIB,350002,0,1,4,5,2
Johnston,U.S. House,Markwayne Mullin,REP,350002,4,13,85,102,2
Johnston,U.S. House,Jason Nichols,DEM,350002,1,12,43,56,2
Johnston,U.S. House,John Foreman,IND,350002,0,0,5,5,2
Johnston,State Senate,Frank Simpson,REP,350002,4,13,95,112,14
Johnston,State Senate,Justin Arledge,DEM,350002,1,14,41,56,14
Johnston,State House,Charles Mccall,REP,350002,3,13,83,99,22
Johnston,State House,Wayne Eidson,DEM,350002,2,12,44,58,22
Johnston,State House,Renae Ward,IND,350002,0,2,10,12,22
Johnston,Governor,Chris Powell,LIB,350003,0,0,2,2,
Johnston,Governor,Kevin Stitt,REP,350003,4,30,79,113,
Johnston,Governor,Drew Edmondson,DEM,350003,0,15,54,69,
Johnston,Lieutenant Governor,Matt Pinnell,REP,350003,3,26,78,107,
Johnston,Lieutenant Governor,Anastasia Pittman,DEM,350003,0,17,52,69,
Johnston,Lieutenant Governor,Ivan Holmes,IND,350003,1,2,4,7,
Johnston,State Auditor,John Yeutter,LIB,350003,0,6,25,31,
Johnston,State Auditor,Cindy Byrd,REP,350003,4,38,93,135,
Johnston,Attorney General,Mike Hunter,REP,350003,3,31,85,119,
Johnston,Attorney General,Mark Myles,DEM,350003,1,14,49,64,
Johnston,State Treasurer,Randy Mcdaniel,REP,350003,2,32,90,124,
Johnston,State Treasurer,Charles De Coune,IND,350003,1,12,27,40,
Johnston,Superintendent of Public Instruction,Joy Hofmeister,REP,350003,3,25,78,106,
Johnston,Superintendent of Public Instruction,John Cox,DEM,350003,1,16,51,68,
Johnston,Superintendent of Public Instruction,Larry Huff,IND,350003,0,4,4,8,
Johnston,Commissioner of Labor,Leslie Osborn,REP,350003,3,27,81,111,
Johnston,Commissioner of Labor,Fred Dorrell,DEM,350003,1,14,45,60,
Johnston,Commissioner of Labor,Brandt Dismukes,IND,350003,0,4,6,10,
Johnston,Insurance Commissioner,Glen Mulready,REP,350003,4,28,81,113,
Johnston,Insurance Commissioner,Kimberly Fobbs,DEM,350003,0,17,52,69,
Johnston,Corporation Commissioner,Bob Anthony,REP,350003,2,24,76,102,
Johnston,Corporation Commissioner,Ashley Nicole Mccray,DEM,350003,1,16,45,62,
Johnston,Corporation Commissioner,Jackie Short,IND,350003,0,5,12,17,
Johnston,U.S. House,Richard Castaldo,LIB,350003,0,0,6,6,2
Johnston,U.S. House,Markwayne Mullin,REP,350003,2,28,79,109,2
Johnston,U.S. House,Jason Nichols,DEM,350003,1,15,46,62,2
Johnston,U.S. House,John Foreman,IND,350003,1,2,4,7,2
Johnston,State Senate,Frank Simpson,REP,350003,3,34,89,126,14
Johnston,State Senate,Justin Arledge,DEM,350003,1,11,44,56,14
Johnston,State House,Charles Mccall,REP,350003,3,32,89,124,22
Johnston,State House,Wayne Eidson,DEM,350003,1,13,40,54,22
Johnston,State House,Renae Ward,IND,350003,0,0,5,5,22
Johnston,Governor,Chris Powell,LIB,350004,0,1,9,10,
Johnston,Governor,Kevin Stitt,REP,350004,2,77,240,319,
Johnston,Governor,Drew Edmondson,DEM,350004,8,42,163,213,
Johnston,Lieutenant Governor,Matt Pinnell,REP,350004,2,80,261,343,
Johnston,Lieutenant Governor,Anastasia Pittman,DEM,350004,8,35,136,179,
Johnston,Lieutenant Governor,Ivan Holmes,IND,350004,0,4,11,15,
Johnston,State Auditor,John Yeutter,LIB,350004,3,22,66,91,
Johnston,State Auditor,Cindy Byrd,REP,350004,5,91,316,412,
Johnston,Attorney General,Mike Hunter,REP,350004,3,80,270,353,
Johnston,Attorney General,Mark Myles,DEM,350004,7,38,136,181,
Johnston,State Treasurer,Randy Mcdaniel,REP,350004,5,92,293,390,
Johnston,State Treasurer,Charles De Coune,IND,350004,4,20,86,110,
Johnston,Superintendent of Public Instruction,Joy Hofmeister,REP,350004,3,79,248,330,
Johnston,Superintendent of Public Instruction,John Cox,DEM,350004,7,33,141,181,
Johnston,Superintendent of Public Instruction,Larry Huff,IND,350004,0,7,19,26,
Johnston,Commissioner of Labor,Leslie Osborn,REP,350004,3,83,255,341,
Johnston,Commissioner of Labor,Fred Dorrell,DEM,350004,7,33,139,179,
Johnston,Commissioner of Labor,Brandt Dismukes,IND,350004,0,3,13,16,
Johnston,Insurance Commissioner,Glen Mulready,REP,350004,3,84,254,341,
Johnston,Insurance Commissioner,Kimberly Fobbs,DEM,350004,7,35,153,195,
Johnston,Corporation Commissioner,Bob Anthony,REP,350004,2,89,252,343,
Johnston,Corporation Commissioner,Ashley Nicole Mccray,DEM,350004,8,27,139,174,
Johnston,Corporation Commissioner,Jackie Short,IND,350004,0,5,17,22,
Johnston,U.S. House,Richard Castaldo,LIB,350004,0,2,6,8,2
Johnston,U.S. House,Markwayne Mullin,REP,350004,2,83,265,350,2
Johnston,U.S. House,Jason Nichols,DEM,350004,8,34,128,170,2
Johnston,U.S. House,John Foreman,IND,350004,0,1,11,12,2
Johnston,State Senate,Frank Simpson,REP,350004,2,89,280,371,14
Johnston,State Senate,Justin Arledge,DEM,350004,8,32,128,168,14
Johnston,State House,Charles Mccall,REP,350004,3,93,264,360,22
Johnston,State House,Wayne Eidson,DEM,350004,6,26,132,164,22
Johnston,State House,Renae Ward,IND,350004,1,1,15,17,22
Johnston,Governor,Chris Powell,LIB,350005,0,0,7,7,
Johnston,Governor,Kevin Stitt,REP,350005,4,8,210,222,
Johnston,Governor,Drew Edmondson,DEM,350005,0,3,64,67,
Johnston,Lieutenant Governor,Matt Pinnell,REP,350005,4,9,211,224,
Johnston,Lieutenant Governor,Anastasia Pittman,DEM,350005,0,2,59,61,
Johnston,Lieutenant Governor,Ivan Holmes,IND,350005,0,0,9,9,
Johnston,State Auditor,John Yeutter,LIB,350005,0,2,41,43,
Johnston,State Auditor,Cindy Byrd,REP,350005,4,9,226,239,
Johnston,Attorney General,Mike Hunter,REP,350005,3,10,220,233,
Johnston,Attorney General,Mark Myles,DEM,350005,1,1,58,60,
Johnston,State Treasurer,Randy Mcdaniel,REP,350005,4,10,233,247,
Johnston,State Treasurer,Charles De Coune,IND,350005,0,0,34,34,
Johnston,Superintendent of Public Instruction,Joy Hofmeister,REP,350005,4,7,196,207,
Johnston,Superintendent of Public Instruction,John Cox,DEM,350005,0,4,58,62,
Johnston,Superintendent of Public Instruction,Larry Huff,IND,350005,0,0,22,22,
Johnston,Commissioner of Labor,Leslie Osborn,REP,350005,4,11,201,216,
Johnston,Commissioner of Labor,Fred Dorrell,DEM,350005,0,0,64,64,
Johnston,Commissioner of Labor,Brandt Dismukes,IND,350005,0,0,10,10,
Johnston,Insurance Commissioner,Glen Mulready,REP,350005,4,9,209,222,
Johnston,Insurance Commissioner,Kimberly Fobbs,DEM,350005,0,2,64,66,
Johnston,Corporation Commissioner,Bob Anthony,REP,350005,3,8,207,218,
Johnston,Corporation Commissioner,Ashley Nicole Mccray,DEM,350005,1,1,52,54,
Johnston,Corporation Commissioner,Jackie Short,IND,350005,0,2,15,17,
Johnston,U.S. House,Richard Castaldo,LIB,350005,0,0,5,5,2
Johnston,U.S. House,Markwayne Mullin,REP,350005,4,10,218,232,2
Johnston,U.S. House,Jason Nichols,DEM,350005,0,1,49,50,2
Johnston,U.S. House,John Foreman,IND,350005,0,0,6,6,2
Johnston,State Senate,Frank Simpson,REP,350005,4,10,227,241,14
Johnston,State Senate,Justin Arledge,DEM,350005,0,0,53,53,14
Johnston,State House,Charles Mccall,REP,350005,4,10,218,232,22
Johnston,State House,Wayne Eidson,DEM,350005,0,1,59,60,22
Johnston,State House,Renae Ward,IND,350005,0,0,3,3,22
Johnston,Governor,Chris Powell,LIB,350006,0,0,7,7,
Johnston,Governor,Kevin Stitt,REP,350006,2,18,123,143,
Johnston,Governor,Drew Edmondson,DEM,350006,1,8,75,84,
Johnston,Lieutenant Governor,Matt Pinnell,REP,350006,2,18,135,155,
Johnston,Lieutenant Governor,Anastasia Pittman,DEM,350006,1,7,57,65,
Johnston,Lieutenant Governor,Ivan Holmes,IND,350006,0,0,10,10,
Johnston,State Auditor,John Yeutter,LIB,350006,1,2,38,41,
Johnston,State Auditor,Cindy Byrd,REP,350006,2,19,154,175,
Johnston,Attorney General,Mike Hunter,REP,350006,2,18,137,157,
Johnston,Attorney General,Mark Myles,DEM,350006,1,7,66,74,
Johnston,State Treasurer,Randy Mcdaniel,REP,350006,2,17,146,165,
Johnston,State Treasurer,Charles De Coune,IND,350006,1,4,42,47,
Johnston,Superintendent of Public Instruction,Joy Hofmeister,REP,350006,2,16,119,137,
Johnston,Superintendent of Public Instruction,John Cox,DEM,350006,1,9,69,79,
Johnston,Superintendent of Public Instruction,Larry Huff,IND,350006,0,0,15,15,
Johnston,Commissioner of Labor,Leslie Osborn,REP,350006,2,17,133,152,
Johnston,Commissioner of Labor,Fred Dorrell,DEM,350006,1,8,60,69,
Johnston,Commissioner of Labor,Brandt Dismukes,IND,350006,0,0,9,9,
Johnston,Insurance Commissioner,Glen Mulready,REP,350006,2,19,128,149,
Johnston,Insurance Commissioner,Kimberly Fobbs,DEM,350006,1,6,72,79,
Johnston,Corporation Commissioner,Bob Anthony,REP,350006,2,16,125,143,
Johnston,Corporation Commissioner,Ashley Nicole Mccray,DEM,350006,1,6,62,69,
Johnston,Corporation Commissioner,Jackie Short,IND,350006,0,3,15,18,
Johnston,U.S. House,Richard Castaldo,LIB,350006,0,1,3,4,2
Johnston,U.S. House,Markwayne Mullin,REP,350006,2,18,143,163,2
Johnston,U.S. House,Jason Nichols,DEM,350006,1,6,48,55,2
Johnston,U.S. House,John Foreman,IND,350006,0,0,10,10,2
Johnston,State Senate,Frank Simpson,REP,350006,2,20,145,167,14
Johnston,State Senate,Justin Arledge,DEM,350006,1,6,59,66,14
Johnston,State House,Charles Mccall,REP,350006,2,20,140,162,22
Johnston,State House,Wayne Eidson,DEM,350006,1,6,56,63,22
Johnston,State House,Renae Ward,IND,350006,0,0,9,9,22
Johnston,Governor,Chris Powell,LIB,350007,0,0,0,0,
Johnston,Governor,Kevin Stitt,REP,350007,0,1,4,5,
Johnston,Governor,Drew Edmondson,DEM,350007,0,1,2,3,
Johnston,Lieutenant Governor,Matt Pinnell,REP,350007,0,2,4,6,
Johnston,Lieutenant Governor,Anastasia Pittman,DEM,350007,0,0,2,2,
Johnston,Lieutenant Governor,Ivan Holmes,IND,350007,0,0,0,0,
Johnston,State Auditor,John Yeutter,LIB,350007,0,0,0,0,
Johnston,State Auditor,Cindy Byrd,REP,350007,0,2,6,8,
Johnston,Attorney General,Mike Hunter,REP,350007,0,2,4,6,
Johnston,Attorney General,Mark Myles,DEM,350007,0,0,2,2,
Johnston,State Treasurer,Randy Mcdaniel,REP,350007,0,2,5,7,
Johnston,State Treasurer,Charles De Coune,IND,350007,0,0,1,1,
Johnston,Superintendent of Public Instruction,Joy Hofmeister,REP,350007,0,2,4,6,
Johnston,Superintendent of Public Instruction,John Cox,DEM,350007,0,0,1,1,
Johnston,Superintendent of Public Instruction,Larry Huff,IND,350007,0,0,1,1,
Johnston,Commissioner of Labor,Leslie Osborn,REP,350007,0,2,4,6,
Johnston,Commissioner of Labor,Fred Dorrell,DEM,350007,0,0,2,2,
Johnston,Commissioner of Labor,Brandt Dismukes,IND,350007,0,0,0,0,
Johnston,Insurance Commissioner,Glen Mulready,REP,350007,0,2,4,6,
Johnston,Insurance Commissioner,Kimberly Fobbs,DEM,350007,0,0,2,2,
Johnston,Corporation Commissioner,Bob Anthony,REP,350007,0,1,4,5,
Johnston,Corporation Commissioner,Ashley Nicole Mccray,DEM,350007,0,0,1,1,
Johnston,Corporation Commissioner,Jackie Short,IND,350007,0,1,1,2,
Johnston,U.S. House,Richard Castaldo,LIB,350007,0,0,0,0,2
Johnston,U.S. House,Markwayne Mullin,REP,350007,0,2,4,6,2
Johnston,U.S. House,Jason Nichols,DEM,350007,0,0,2,2,2
Johnston,U.S. House,John Foreman,IND,350007,0,0,0,0,2
Johnston,State Senate,David Bullard,REP,350007,0,2,4,6,6
Johnston,State Senate,Arnold Bourne,DEM,350007,0,0,2,2,6
Johnston,State House,Charles Mccall,REP,350007,0,1,4,5,22
Johnston,State House,Wayne Eidson,DEM,350007,0,0,2,2,22
Johnston,State House,Renae Ward,IND,350007,0,1,0,1,22
Johnston,Governor,Chris Powell,LIB,350008,0,0,3,3,
Johnston,Governor,Kevin Stitt,REP,350008,2,2,127,131,
Johnston,Governor,Drew Edmondson,DEM,350008,2,3,36,41,
Johnston,Lieutenant Governor,Matt Pinnell,REP,350008,2,2,131,135,
Johnston,Lieutenant Governor,Anastasia Pittman,DEM,350008,2,3,29,34,
Johnston,Lieutenant Governor,Ivan Holmes,IND,350008,0,0,6,6,
Johnston,State Auditor,John Yeutter,LIB,350008,1,0,22,23,
Johnston,State Auditor,Cindy Byrd,REP,350008,2,4,140,146,
Johnston,Attorney General,Mike Hunter,REP,350008,2,3,134,139,
Johnston,Attorney General,Mark Myles,DEM,350008,2,2,32,36,
Johnston,State Treasurer,Randy Mcdaniel,REP,350008,2,2,140,144,
Johnston,State Treasurer,Charles De Coune,IND,350008,1,3,20,24,
Johnston,Superintendent of Public Instruction,Joy Hofmeister,REP,350008,2,1,113,116,
Johnston,Superintendent of Public Instruction,John Cox,DEM,350008,2,3,39,44,
Johnston,Superintendent of Public Instruction,Larry Huff,IND,350008,0,1,11,12,
Johnston,Commissioner of Labor,Leslie Osborn,REP,350008,2,2,123,127,
Johnston,Commissioner of Labor,Fred Dorrell,DEM,350008,2,3,34,39,
Johnston,Commissioner of Labor,Brandt Dismukes,IND,350008,0,0,6,6,
Johnston,Insurance Commissioner,Glen Mulready,REP,350008,2,1,128,131,
Johnston,Insurance Commissioner,Kimberly Fobbs,DEM,350008,2,4,34,40,
Johnston,Corporation Commissioner,Bob Anthony,REP,350008,2,3,118,123,
Johnston,Corporation Commissioner,Ashley Nicole Mccray,DEM,350008,2,2,35,39,
Johnston,Corporation Commissioner,Jackie Short,IND,350008,0,0,9,9,
Johnston,U.S. House,Richard Castaldo,LIB,350008,0,0,1,1,2
Johnston,U.S. House,Markwayne Mullin,REP,350008,2,3,131,136,2
Johnston,U.S. House,Jason Nichols,DEM,350008,2,2,31,35,2
Johnston,U.S. House,John Foreman,IND,350008,0,0,3,3,2
Johnston,State Senate,Frank Simpson,REP,350008,2,3,140,145,14
Johnston,State Senate,Justin Arledge,DEM,350008,2,2,28,32,14
Johnston,State House,Charles Mccall,REP,350008,2,3,136,141,22
Johnston,State House,Wayne Eidson,DEM,350008,2,2,28,32,22
Johnston,State House,Renae Ward,IND,350008,0,0,5,5,22
Johnston,Governor,Chris Powell,LIB,350009,0,0,2,2,
Johnston,Governor,Kevin Stitt,REP,350009,1,6,65,72,
Johnston,Governor,Drew Edmondson,DEM,350009,0,1,39,40,
Johnston,Lieutenant Governor,Matt Pinnell,REP,350009,1,4,68,73,
Johnston,Lieutenant Governor,Anastasia Pittman,DEM,350009,0,1,30,31,
Johnston,Lieutenant Governor,Ivan Holmes,IND,350009,0,1,6,7,
Johnston,State Auditor,John Yeutter,LIB,350009,0,0,20,20,
Johnston,State Auditor,Cindy Byrd,REP,350009,1,7,77,85,
Johnston,Attorney General,Mike Hunter,REP,350009,1,4,71,76,
Johnston,Attorney General,Mark Myles,DEM,350009,0,1,33,34,
Johnston,State Treasurer,Randy Mcdaniel,REP,350009,1,5,73,79,
Johnston,State Treasurer,Charles De Coune,IND,350009,0,1,24,25,
Johnston,Superintendent of Public Instruction,Joy Hofmeister,REP,350009,1,5,59,65,
Johnston,Superintendent of Public Instruction,John Cox,DEM,350009,0,1,31,32,
Johnston,Superintendent of Public Instruction,Larry Huff,IND,350009,0,1,14,15,
Johnston,Commissioner of Labor,Leslie Osborn,REP,350009,1,3,63,67,
Johnston,Commissioner of Labor,Fred Dorrell,DEM,350009,0,0,33,33,
Johnston,Commissioner of Labor,Brandt Dismukes,IND,350009,0,2,7,9,
Johnston,Insurance Commissioner,Glen Mulready,REP,350009,1,4,60,65,
Johnston,Insurance Commissioner,Kimberly Fobbs,DEM,350009,0,1,43,44,
Johnston,Corporation Commissioner,Bob Anthony,REP,350009,0,5,59,64,
Johnston,Corporation Commissioner,Ashley Nicole Mccray,DEM,350009,0,1,34,35,
Johnston,Corporation Commissioner,Jackie Short,IND,350009,1,0,11,12,
Johnston,U.S. House,Richard Castaldo,LIB,350009,0,1,2,3,2
Johnston,U.S. House,Markwayne Mullin,REP,350009,1,6,77,84,2
Johnston,U.S. House,Jason Nichols,DEM,350009,0,0,24,24,2
Johnston,U.S. House,John Foreman,IND,350009,0,0,2,2,2
Johnston,State Senate,Frank Simpson,REP,350009,1,4,75,80,14
Johnston,State Senate,Justin Arledge,DEM,350009,0,3,29,32,14
Johnston,State House,Charles Mccall,REP,350009,1,4,67,72,22
Johnston,State House,Wayne Eidson,DEM,350009,0,3,33,36,22
Johnston,State House,Renae Ward,IND,350009,0,0,6,6,22
Johnston,Governor,Chris Powell,LIB,350010,0,0,2,2,
Johnston,Governor,Kevin Stitt,REP,350010,0,5,56,61,
Johnston,Governor,Drew Edmondson,DEM,350010,0,0,11,11,
Johnston,Lieutenant Governor,Matt Pinnell,REP,350010,0,5,59,64,
Johnston,Lieutenant Governor,Anastasia Pittman,DEM,350010,0,0,9,9,
Johnston,Lieutenant Governor,Ivan Holmes,IND,350010,0,0,0,0,
Johnston,State Auditor,John Yeutter,LIB,350010,0,0,3,3,
Johnston,State Auditor,Cindy Byrd,REP,350010,0,4,66,70,
Johnston,Attorney General,Mike Hunter,REP,350010,0,5,59,64,
Johnston,Attorney General,Mark Myles,DEM,350010,0,0,9,9,
Johnston,State Treasurer,Randy Mcdaniel,REP,350010,0,4,64,68,
Johnston,State Treasurer,Charles De Coune,IND,350010,0,0,3,3,
Johnston,Superintendent of Public Instruction,Joy Hofmeister,REP,350010,0,4,51,55,
Johnston,Superintendent of Public Instruction,John Cox,DEM,350010,0,0,14,14,
Johnston,Superintendent of Public Instruction,Larry Huff,IND,350010,0,0,3,3,
Johnston,Commissioner of Labor,Leslie Osborn,REP,350010,0,4,56,60,
Johnston,Commissioner of Labor,Fred Dorrell,DEM,350010,0,0,9,9,
Johnston,Commissioner of Labor,Brandt Dismukes,IND,350010,0,0,0,0,
Johnston,Insurance Commissioner,Glen Mulready,REP,350010,0,4,57,61,
Johnston,Insurance Commissioner,Kimberly Fobbs,DEM,350010,0,0,10,10,
Johnston,Corporation Commissioner,Bob Anthony,REP,350010,0,4,50,54,
Johnston,Corporation Commissioner,Ashley Nicole Mccray,DEM,350010,0,0,14,14,
Johnston,Corporation Commissioner,Jackie Short,IND,350010,0,0,3,3,
Johnston,U.S. House,Richard Castaldo,LIB,350010,0,0,1,1,2
Johnston,U.S. House,Markwayne Mullin,REP,350010,0,5,60,65,2
Johnston,U.S. House,Jason Nichols,DEM,350010,0,0,7,7,2
Johnston,U.S. House,John Foreman,IND,350010,0,0,1,1,2
Johnston,State Senate,Frank Simpson,REP,350010,0,4,58,62,14
Johnston,State Senate,Justin Arledge,DEM,350010,0,0,8,8,14
Johnston,State House,Charles Mccall,REP,350010,0,5,59,64,22
Johnston,State House,Wayne Eidson,DEM,350010,0,0,9,9,22
Johnston,State House,Renae Ward,IND,350010,0,0,0,0,22
Johnston,Governor,Chris Powell,LIB,350011,0,0,6,6,
Johnston,Governor,Kevin Stitt,REP,350011,0,1,84,85,
Johnston,Governor,Drew Edmondson,DEM,350011,0,3,36,39,
Johnston,Lieutenant Governor,Matt Pinnell,REP,350011,0,1,92,93,
Johnston,Lieutenant Governor,Anastasia Pittman,DEM,350011,0,3,28,31,
Johnston,Lieutenant Governor,Ivan Holmes,IND,350011,0,0,6,6,
Johnston,State Auditor,John Yeutter,LIB,350011,0,2,12,14,
Johnston,State Auditor,Cindy Byrd,REP,350011,0,2,103,105,
Johnston,Attorney General,Mike Hunter,REP,350011,0,1,94,95,
Johnston,Attorney General,Mark Myles,DEM,350011,0,3,28,31,
Johnston,State Treasurer,Randy Mcdaniel,REP,350011,0,1,106,107,
Johnston,State Treasurer,Charles De Coune,IND,350011,0,3,9,12,
Johnston,Superintendent of Public Instruction,Joy Hofmeister,REP,350011,0,1,85,86,
Johnston,Superintendent of Public Instruction,John Cox,DEM,350011,0,3,30,33,
Johnston,Superintendent of Public Instruction,Larry Huff,IND,350011,0,0,8,8,
Johnston,Commissioner of Labor,Leslie Osborn,REP,350011,0,0,93,93,
Johnston,Commissioner of Labor,Fred Dorrell,DEM,350011,0,3,29,32,
Johnston,Commissioner of Labor,Brandt Dismukes,IND,350011,0,0,1,1,
Johnston,Insurance Commissioner,Glen Mulready,REP,350011,0,1,86,87,
Johnston,Insurance Commissioner,Kimberly Fobbs,DEM,350011,0,3,36,39,
Johnston,Corporation Commissioner,Bob Anthony,REP,350011,0,2,91,93,
Johnston,Corporation Commissioner,Ashley Nicole Mccray,DEM,350011,0,2,26,28,
Johnston,Corporation Commissioner,Jackie Short,IND,350011,0,0,6,6,
Johnston,U.S. House,Richard Castaldo,LIB,350011,0,0,2,2,2
Johnston,U.S. House,Markwayne Mullin,REP,350011,0,0,95,95,2
Johnston,U.S. House,Jason Nichols,DEM,350011,0,4,25,29,2
Johnston,U.S. House,John Foreman,IND,350011,0,0,5,5,2
Johnston,State Senate,David Bullard,REP,350011,0,1,89,90,6
Johnston,State Senate,Arnold Bourne,DEM,350011,0,3,36,39,6
Johnston,State House,Charles Mccall,REP,350011,0,1,103,104,22
Johnston,State House,Wayne Eidson,DEM,350011,0,3,20,23,22
Johnston,State House,Renae Ward,IND,350011,0,0,4,4,22
Johnston,Governor,Chris Powell,LIB,350012,0,0,10,10,
Johnston,Governor,Kevin Stitt,REP,350012,5,15,207,227,
Johnston,Governor,Drew Edmondson,DEM,350012,2,3,87,92,
Johnston,Lieutenant Governor,Matt Pinnell,REP,350012,6,15,219,240,
Johnston,Lieutenant Governor,Anastasia Pittman,DEM,350012,1,3,76,80,
Johnston,Lieutenant Governor,Ivan Holmes,IND,350012,0,0,6,6,
Johnston,State Auditor,John Yeutter,LIB,350012,1,3,37,41,
Johnston,State Auditor,Cindy Byrd,REP,350012,6,15,245,266,
Johnston,Attorney General,Mike Hunter,REP,350012,6,16,222,244,
Johnston,Attorney General,Mark Myles,DEM,350012,1,2,76,79,
Johnston,State Treasurer,Randy Mcdaniel,REP,350012,6,16,247,269,
Johnston,State Treasurer,Charles De Coune,IND,350012,1,2,36,39,
Johnston,Superintendent of Public Instruction,Joy Hofmeister,REP,350012,6,13,196,215,
Johnston,Superintendent of Public Instruction,John Cox,DEM,350012,1,3,80,84,
Johnston,Superintendent of Public Instruction,Larry Huff,IND,350012,0,2,24,26,
Johnston,Commissioner of Labor,Leslie Osborn,REP,350012,5,13,212,230,
Johnston,Commissioner of Labor,Fred Dorrell,DEM,350012,1,3,71,75,
Johnston,Commissioner of Labor,Brandt Dismukes,IND,350012,1,2,12,15,
Johnston,Insurance Commissioner,Glen Mulready,REP,350012,5,16,213,234,
Johnston,Insurance Commissioner,Kimberly Fobbs,DEM,350012,2,2,84,88,
Johnston,Corporation Commissioner,Bob Anthony,REP,350012,4,14,208,226,
Johnston,Corporation Commissioner,Ashley Nicole Mccray,DEM,350012,1,4,67,72,
Johnston,Corporation Commissioner,Jackie Short,IND,350012,2,0,23,25,
Johnston,U.S. House,Richard Castaldo,LIB,350012,0,0,2,2,2
Johnston,U.S. House,Markwayne Mullin,REP,350012,6,15,220,241,2
Johnston,U.S. House,Jason Nichols,DEM,350012,1,3,67,71,2
Johnston,U.S. House,John Foreman,IND,350012,0,0,13,13,2
Johnston,State Senate,David Bullard,REP,350012,6,15,193,214,6
Johnston,State Senate,Arnold Bourne,DEM,350012,1,3,108,112,6
Johnston,State House,Charles Mccall,REP,350012,4,14,214,232,22
Johnston,State House,Wayne Eidson,DEM,350012,2,3,73,78,22
Johnston,State House,Renae Ward,IND,350012,1,1,11,13,22
Johnston,Governor,Chris Powell,LIB,350013,0,2,11,13,
Johnston,Governor,Kevin Stitt,REP,350013,9,39,223,271,
Johnston,Governor,Drew Edmondson,DEM,350013,0,14,100,114,
Johnston,Lieutenant Governor,Matt Pinnell,REP,350013,9,42,228,279,
Johnston,Lieutenant Governor,Anastasia Pittman,DEM,350013,0,13,92,105,
Johnston,Lieutenant Governor,Ivan Holmes,IND,350013,0,0,13,13,
Johnston,State Auditor,John Yeutter,LIB,350013,0,3,50,53,
Johnston,State Auditor,Cindy Byrd,REP,350013,9,47,257,313,
Johnston,Attorney General,Mike Hunter,REP,350013,8,43,241,292,
Johnston,Attorney General,Mark Myles,DEM,350013,0,12,90,102,
Johnston,State Treasurer,Randy Mcdaniel,REP,350013,9,43,251,303,
Johnston,State Treasurer,Charles De Coune,IND,350013,0,7,51,58,
Johnston,Superintendent of Public Instruction,Joy Hofmeister,REP,350013,9,40,216,265,
Johnston,Superintendent of Public Instruction,John Cox,DEM,350013,0,12,92,104,
Johnston,Superintendent of Public Instruction,Larry Huff,IND,350013,0,2,23,25,
Johnston,Commissioner of Labor,Leslie Osborn,REP,350013,9,39,219,267,
Johnston,Commissioner of Labor,Fred Dorrell,DEM,350013,0,13,94,107,
Johnston,Commissioner of Labor,Brandt Dismukes,IND,350013,0,2,15,17,
Johnston,Insurance Commissioner,Glen Mulready,REP,350013,9,40,232,281,
Johnston,Insurance Commissioner,Kimberly Fobbs,DEM,350013,0,14,96,110,
Johnston,Corporation Commissioner,Bob Anthony,REP,350013,9,41,226,276,
Johnston,Corporation Commissioner,Ashley Nicole Mccray,DEM,350013,0,13,87,100,
Johnston,Corporation Commissioner,Jackie Short,IND,350013,0,1,15,16,
Johnston,U.S. House,Richard Castaldo,LIB,350013,0,0,5,5,2
Johnston,U.S. House,Markwayne Mullin,REP,350013,8,42,238,288,2
Johnston,U.S. House,Jason Nichols,DEM,350013,1,12,82,95,2
Johnston,U.S. House,John Foreman,IND,350013,0,1,8,9,2
Johnston,State Senate,David Bullard,REP,350013,9,38,208,255,6
Johnston,State Senate,Arnold Bourne,DEM,350013,0,17,125,142,6
Johnston,State House,Charles Mccall,REP,350013,4,43,240,287,22
Johnston,State House,Wayne Eidson,DEM,350013,4,11,82,97,22
Johnston,State House,Renae Ward,IND,350013,0,1,12,13,22
Johnston,Governor,Chris Powell,LIB,350014,0,0,3,3,
Johnston,Governor,Kevin Stitt,REP,350014,2,4,42,48,
Johnston,Governor,Drew Edmondson,DEM,350014,1,2,24,27,
Johnston,Lieutenant Governor,Matt Pinnell,REP,350014,3,4,51,58,
Johnston,Lieutenant Governor,Anastasia Pittman,DEM,350014,0,2,13,15,
Johnston,Lieutenant Governor,Ivan Holmes,IND,350014,0,0,4,4,
Johnston,State Auditor,John Yeutter,LIB,350014,1,1,4,6,
Johnston,State Auditor,Cindy Byrd,REP,350014,2,5,63,70,
Johnston,Attorney General,Mike Hunter,REP,350014,2,3,55,60,
Johnston,Attorney General,Mark Myles,DEM,350014,1,3,13,17,
Johnston,State Treasurer,Randy Mcdaniel,REP,350014,3,5,60,68,
Johnston,State Treasurer,Charles De Coune,IND,350014,0,1,6,7,
Johnston,Superintendent of Public Instruction,Joy Hofmeister,REP,350014,2,3,50,55,
Johnston,Superintendent of Public Instruction,John Cox,DEM,350014,1,3,13,17,
Johnston,Superintendent of Public Instruction,Larry Huff,IND,350014,0,0,5,5,
Johnston,Commissioner of Labor,Leslie Osborn,REP,350014,2,4,51,57,
Johnston,Commissioner of Labor,Fred Dorrell,DEM,350014,1,2,16,19,
Johnston,Commissioner of Labor,Brandt Dismukes,IND,350014,0,0,1,1,
Johnston,Insurance Commissioner,Glen Mulready,REP,350014,2,3,53,58,
Johnston,Insurance Commissioner,Kimberly Fobbs,DEM,350014,1,3,14,18,
Johnston,Corporation Commissioner,Bob Anthony,REP,350014,2,3,53,58,
Johnston,Corporation Commissioner,Ashley Nicole Mccray,DEM,350014,0,3,14,17,
Johnston,Corporation Commissioner,Jackie Short,IND,350014,1,0,1,2,
Johnston,U.S. House,Richard Castaldo,LIB,350014,0,0,2,2,2
Johnston,U.S. House,Markwayne Mullin,REP,350014,2,3,46,51,2
Johnston,U.S. House,Jason Nichols,DEM,350014,1,3,18,22,2
Johnston,U.S. House,John Foreman,IND,350014,0,0,2,2,2
Johnston,State Senate,Frank Simpson,REP,350014,2,5,54,61,14
Johnston,State Senate,Justin Arledge,DEM,350014,1,1,15,17,14
Johnston,State House,Charles Mccall,REP,350014,3,5,52,60,22
Johnston,State House,Wayne Eidson,DEM,350014,0,1,15,16,22
Johnston,State House,Renae Ward,IND,350014,0,0,2,2,22
Kay,Governor,Chris Powell,LIB,360001,1,1,18,20,
Kay,Governor,Kevin Stitt,REP,360001,15,59,377,451,
Kay,Governor,Drew Edmondson,DEM,360001,7,31,160,198,
Kay,Lieutenant Governor,Matt Pinnell,REP,360001,15,62,401,478,
Kay,Lieutenant Governor,Anastasia Pittman,DEM,360001,8,24,128,160,
Kay,Lieutenant Governor,Ivan Holmes,IND,360001,0,4,24,28,
Kay,State Auditor,John Yeutter,LIB,360001,6,13,83,102,
Kay,State Auditor,Cindy Byrd,REP,360001,17,69,442,528,
Kay,Attorney General,Mike Hunter,REP,360001,16,66,423,505,
Kay,Attorney General,Mark Myles,DEM,360001,7,24,128,159,
Kay,State Treasurer,Randy Mcdaniel,REP,360001,17,65,432,514,
Kay,State Treasurer,Charles De Coune,IND,360001,6,17,96,119,
Kay,Superintendent of Public Instruction,Joy Hofmeister,REP,360001,15,63,388,466,
Kay,Superintendent of Public Instruction,John Cox,DEM,360001,6,24,122,152,
Kay,Superintendent of Public Instruction,Larry Huff,IND,360001,1,4,42,47,
Kay,Commissioner of Labor,Leslie Osborn,REP,360001,17,64,398,479,
Kay,Commissioner of Labor,Fred Dorrell,DEM,360001,6,23,118,147,
Kay,Commissioner of Labor,Brandt Dismukes,IND,360001,0,4,32,36,
Kay,Insurance Commissioner,Glen Mulready,REP,360001,15,65,405,485,
Kay,Insurance Commissioner,Kimberly Fobbs,DEM,360001,7,25,144,176,
Kay,Corporation Commissioner,Bob Anthony,REP,360001,16,62,383,461,
Kay,Corporation Commissioner,Ashley Nicole Mccray,DEM,360001,6,24,136,166,
Kay,Corporation Commissioner,Jackie Short,IND,360001,1,4,30,35,
Kay,U.S. House,Frank Lucas,REP,360001,17,67,416,500,3
Kay,U.S. House,Frankie Robbins,DEM,360001,6,24,134,164,3
Kay,Governor,Chris Powell,LIB,360101,0,0,24,24,
Kay,Governor,Kevin Stitt,REP,360101,6,15,268,289,
Kay,Governor,Drew Edmondson,DEM,360101,4,11,189,204,
Kay,Lieutenant Governor,Matt Pinnell,REP,360101,6,17,311,334,
Kay,Lieutenant Governor,Anastasia Pittman,DEM,360101,4,8,150,162,
Kay,Lieutenant Governor,Ivan Holmes,IND,360101,0,1,20,21,
Kay,State Auditor,John Yeutter,LIB,360101,2,6,106,114,
Kay,State Auditor,Cindy Byrd,REP,360101,8,21,344,373,
Kay,Attorney General,Mike Hunter,REP,360101,5,17,312,334,
Kay,Attorney General,Mark Myles,DEM,360101,5,9,167,181,
Kay,State Treasurer,Randy Mcdaniel,REP,360101,8,20,339,367,
Kay,State Treasurer,Charles De Coune,IND,360101,2,6,107,115,
Kay,Superintendent of Public Instruction,Joy Hofmeister,REP,360101,5,17,293,315,
Kay,Superintendent of Public Instruction,John Cox,DEM,360101,5,8,148,161,
Kay,Superintendent of Public Instruction,Larry Huff,IND,360101,0,2,38,40,
Kay,Commissioner of Labor,Leslie Osborn,REP,360101,6,16,309,331,
Kay,Commissioner of Labor,Fred Dorrell,DEM,360101,4,10,140,154,
Kay,Commissioner of Labor,Brandt Dismukes,IND,360101,0,1,27,28,
Kay,Insurance Commissioner,Glen Mulready,REP,360101,6,16,301,323,
Kay,Insurance Commissioner,Kimberly Fobbs,DEM,360101,4,11,176,191,
Kay,Corporation Commissioner,Bob Anthony,REP,360101,6,21,298,325,
Kay,Corporation Commissioner,Ashley Nicole Mccray,DEM,360101,4,6,151,161,
Kay,Corporation Commissioner,Jackie Short,IND,360101,0,0,31,31,
Kay,U.S. House,Frank Lucas,REP,360101,6,19,320,345,3
Kay,U.S. House,Frankie Robbins,DEM,360101,3,7,159,169,3
Kay,Governor,Chris Powell,LIB,360103,1,1,14,16,
Kay,Governor,Kevin Stitt,REP,360103,8,5,326,339,
Kay,Governor,Drew Edmondson,DEM,360103,7,7,173,187,
Kay,Lieutenant Governor,Matt Pinnell,REP,360103,10,7,379,396,
Kay,Lieutenant Governor,Anastasia Pittman,DEM,360103,4,6,111,121,
Kay,Lieutenant Governor,Ivan Holmes,IND,360103,2,0,19,21,
Kay,State Auditor,John Yeutter,LIB,360103,3,0,84,87,
Kay,State Auditor,Cindy Byrd,REP,360103,12,11,398,421,
Kay,Attorney General,Mike Hunter,REP,360103,9,10,379,398,
Kay,Attorney General,Mark Myles,DEM,360103,7,3,127,137,
Kay,State Treasurer,Randy Mcdaniel,REP,360103,12,9,390,411,
Kay,State Treasurer,Charles De Coune,IND,360103,3,2,95,100,
Kay,Superintendent of Public Instruction,Joy Hofmeister,REP,360103,8,10,357,375,
Kay,Superintendent of Public Instruction,John Cox,DEM,360103,7,3,116,126,
Kay,Superintendent of Public Instruction,Larry Huff,IND,360103,1,0,33,34,
Kay,Commissioner of Labor,Leslie Osborn,REP,360103,9,9,361,379,
Kay,Commissioner of Labor,Fred Dorrell,DEM,360103,7,4,114,125,
Kay,Commissioner of Labor,Brandt Dismukes,IND,360103,0,0,25,25,
Kay,Insurance Commissioner,Glen Mulready,REP,360103,9,6,355,370,
Kay,Insurance Commissioner,Kimberly Fobbs,DEM,360103,7,7,146,160,
Kay,Corporation Commissioner,Bob Anthony,REP,360103,9,6,346,361,
Kay,Corporation Commissioner,Ashley Nicole Mccray,DEM,360103,6,6,128,140,
Kay,Corporation Commissioner,Jackie Short,IND,360103,1,1,29,31,
Kay,U.S. House,Frank Lucas,REP,360103,12,10,387,409,3
Kay,U.S. House,Frankie Robbins,DEM,360103,4,3,121,128,3
Kay,Governor,Chris Powell,LIB,360202,0,1,27,28,
Kay,Governor,Kevin Stitt,REP,360202,9,8,311,328,
Kay,Governor,Drew Edmondson,DEM,360202,5,7,179,191,
Kay,Lieutenant Governor,Matt Pinnell,REP,360202,11,10,355,376,
Kay,Lieutenant Governor,Anastasia Pittman,DEM,360202,2,5,135,142,
Kay,Lieutenant Governor,Ivan Holmes,IND,360202,1,0,28,29,
Kay,State Auditor,John Yeutter,LIB,360202,3,5,100,108,
Kay,State Auditor,Cindy Byrd,REP,360202,11,9,394,414,
Kay,Attorney General,Mike Hunter,REP,360202,9,10,377,396,
Kay,Attorney General,Mark Myles,DEM,360202,5,5,138,148,
Kay,State Treasurer,Randy Mcdaniel,REP,360202,10,10,378,398,
Kay,State Treasurer,Charles De Coune,IND,360202,4,4,114,122,
Kay,Superintendent of Public Instruction,Joy Hofmeister,REP,360202,10,7,313,330,
Kay,Superintendent of Public Instruction,John Cox,DEM,360202,3,6,166,175,
Kay,Superintendent of Public Instruction,Larry Huff,IND,360202,1,2,39,42,
Kay,Commissioner of Labor,Leslie Osborn,REP,360202,10,10,352,372,
Kay,Commissioner of Labor,Fred Dorrell,DEM,360202,3,5,126,134,
Kay,Commissioner of Labor,Brandt Dismukes,IND,360202,1,0,36,37,
Kay,Insurance Commissioner,Glen Mulready,REP,360202,8,9,351,368,
Kay,Insurance Commissioner,Kimberly Fobbs,DEM,360202,5,6,158,169,
Kay,Corporation Commissioner,Bob Anthony,REP,360202,9,9,339,357,
Kay,Corporation Commissioner,Ashley Nicole Mccray,DEM,360202,4,6,133,143,
Kay,Corporation Commissioner,Jackie Short,IND,360202,1,0,40,41,
Kay,U.S. House,Frank Lucas,REP,360202,10,9,365,384,3
Kay,U.S. House,Frankie Robbins,DEM,360202,4,6,149,159,3
Kay,Governor,Chris Powell,LIB,360205,0,0,35,35,
Kay,Governor,Kevin Stitt,REP,360205,8,10,306,324,
Kay,Governor,Drew Edmondson,DEM,360205,4,3,170,177,
Kay,Lieutenant Governor,Matt Pinnell,REP,360205,9,10,332,351,
Kay,Lieutenant Governor,Anastasia Pittman,DEM,360205,2,3,145,150,
Kay,Lieutenant Governor,Ivan Holmes,IND,360205,0,0,30,30,
Kay,State Auditor,John Yeutter,LIB,360205,0,3,110,113,
Kay,State Auditor,Cindy Byrd,REP,360205,11,10,368,389,
Kay,Attorney General,Mike Hunter,REP,360205,9,10,340,359,
Kay,Attorney General,Mark Myles,DEM,360205,3,3,166,172,
Kay,State Treasurer,Randy Mcdaniel,REP,360205,10,10,355,375,
Kay,State Treasurer,Charles De Coune,IND,360205,1,3,124,128,
Kay,Superintendent of Public Instruction,Joy Hofmeister,REP,360205,7,10,279,296,
Kay,Superintendent of Public Instruction,John Cox,DEM,360205,2,3,167,172,
Kay,Superintendent of Public Instruction,Larry Huff,IND,360205,2,0,60,62,
Kay,Commissioner of Labor,Leslie Osborn,REP,360205,9,9,327,345,
Kay,Commissioner of Labor,Fred Dorrell,DEM,360205,2,3,147,152,
Kay,Commissioner of Labor,Brandt Dismukes,IND,360205,0,0,31,31,
Kay,Insurance Commissioner,Glen Mulready,REP,360205,9,10,330,349,
Kay,Insurance Commissioner,Kimberly Fobbs,DEM,360205,3,3,178,184,
Kay,Corporation Commissioner,Bob Anthony,REP,360205,10,8,321,339,
Kay,Corporation Commissioner,Ashley Nicole Mccray,DEM,360205,2,5,147,154,
Kay,Corporation Commissioner,Jackie Short,IND,360205,0,0,40,40,
Kay,U.S. House,Frank Lucas,REP,360205,10,10,346,366,3
Kay,U.S. House,Frankie Robbins,DEM,360205,2,3,161,166,3
Kay,Governor,Chris Powell,LIB,360206,4,1,43,48,
Kay,Governor,Kevin Stitt,REP,360206,20,22,501,543,
Kay,Governor,Drew Edmondson,DEM,360206,11,17,210,238,
Kay,Lieutenant Governor,Matt Pinnell,REP,360206,26,29,580,635,
Kay,Lieutenant Governor,Anastasia Pittman,DEM,360206,7,10,134,151,
Kay,Lieutenant Governor,Ivan Holmes,IND,360206,1,1,30,32,
Kay,State Auditor,John Yeutter,LIB,360206,7,11,113,131,
Kay,State Auditor,Cindy Byrd,REP,360206,26,29,614,669,
Kay,Attorney General,Mike Hunter,REP,360206,23,30,585,638,
Kay,Attorney General,Mark Myles,DEM,360206,10,10,157,177,
Kay,State Treasurer,Randy Mcdaniel,REP,360206,23,28,600,651,
Kay,State Treasurer,Charles De Coune,IND,360206,8,12,120,140,
Kay,Superintendent of Public Instruction,Joy Hofmeister,REP,360206,24,25,468,517,
Kay,Superintendent of Public Instruction,John Cox,DEM,360206,7,12,223,242,
Kay,Superintendent of Public Instruction,Larry Huff,IND,360206,3,3,58,64,
Kay,Commissioner of Labor,Leslie Osborn,REP,360206,24,28,552,604,
Kay,Commissioner of Labor,Fred Dorrell,DEM,360206,7,11,139,157,
Kay,Commissioner of Labor,Brandt Dismukes,IND,360206,2,1,49,52,
Kay,Insurance Commissioner,Glen Mulready,REP,360206,25,29,573,627,
Kay,Insurance Commissioner,Kimberly Fobbs,DEM,360206,7,11,163,181,
Kay,Corporation Commissioner,Bob Anthony,REP,360206,21,28,530,579,
Kay,Corporation Commissioner,Ashley Nicole Mccray,DEM,360206,8,11,152,171,
Kay,Corporation Commissioner,Jackie Short,IND,360206,3,1,61,65,
Kay,U.S. House,Frank Lucas,REP,360206,25,30,601,656,3
Kay,U.S. House,Frankie Robbins,DEM,360206,9,10,146,165,3
Kay,Governor,Chris Powell,LIB,360400,0,1,2,3,
Kay,Governor,Kevin Stitt,REP,360400,7,1,59,67,
Kay,Governor,Drew Edmondson,DEM,360400,1,1,20,22,
Kay,Lieutenant Governor,Matt Pinnell,REP,360400,7,2,63,72,
Kay,Lieutenant Governor,Anastasia Pittman,DEM,360400,1,0,13,14,
Kay,Lieutenant Governor,Ivan Holmes,IND,360400,0,1,4,5,
Kay,State Auditor,John Yeutter,LIB,360400,2,1,11,14,
Kay,State Auditor,Cindy Byrd,REP,360400,6,2,67,75,
Kay,Attorney General,Mike Hunter,REP,360400,7,3,68,78,
Kay,Attorney General,Mark Myles,DEM,360400,1,0,12,13,
Kay,State Treasurer,Randy Mcdaniel,REP,360400,7,2,66,75,
Kay,State Treasurer,Charles De Coune,IND,360400,1,1,12,14,
Kay,Superintendent of Public Instruction,Joy Hofmeister,REP,360400,6,3,64,73,
Kay,Superintendent of Public Instruction,John Cox,DEM,360400,1,0,12,13,
Kay,Superintendent of Public Instruction,Larry Huff,IND,360400,1,0,4,5,
Kay,Commissioner of Labor,Leslie Osborn,REP,360400,6,2,63,71,
Kay,Commissioner of Labor,Fred Dorrell,DEM,360400,1,0,13,14,
Kay,Commissioner of Labor,Brandt Dismukes,IND,360400,1,1,3,5,
Kay,Insurance Commissioner,Glen Mulready,REP,360400,7,3,62,72,
Kay,Insurance Commissioner,Kimberly Fobbs,DEM,360400,1,0,18,19,
Kay,Corporation Commissioner,Bob Anthony,REP,360400,6,2,64,72,
Kay,Corporation Commissioner,Ashley Nicole Mccray,DEM,360400,1,1,14,16,
Kay,Corporation Commissioner,Jackie Short,IND,360400,1,0,3,4,
Kay,U.S. House,Frank Lucas,REP,360400,8,3,63,74,3
Kay,U.S. House,Frankie Robbins,DEM,360400,0,0,17,17,3
Kay,Governor,Chris Powell,LIB,360401,0,0,1,1,
Kay,Governor,Kevin Stitt,REP,360401,0,7,38,45,
Kay,Governor,Drew Edmondson,DEM,360401,0,0,13,13,
Kay,Lieutenant Governor,Matt Pinnell,REP,360401,0,7,42,49,
Kay,Lieutenant Governor,Anastasia Pittman,DEM,360401,0,0,9,9,
Kay,Lieutenant Governor,Ivan Holmes,IND,360401,0,0,2,2,
Kay,State Auditor,John Yeutter,LIB,360401,0,0,9,9,
Kay,State Auditor,Cindy Byrd,REP,360401,0,7,40,47,
Kay,Attorney General,Mike Hunter,REP,360401,0,7,40,47,
Kay,Attorney General,Mark Myles,DEM,360401,0,0,13,13,
Kay,State Treasurer,Randy Mcdaniel,REP,360401,0,7,43,50,
Kay,State Treasurer,Charles De Coune,IND,360401,0,0,7,7,
Kay,Superintendent of Public Instruction,Joy Hofmeister,REP,360401,0,7,34,41,
Kay,Superintendent of Public Instruction,John Cox,DEM,360401,0,0,11,11,
Kay,Superintendent of Public Instruction,Larry Huff,IND,360401,0,0,8,8,
Kay,Commissioner of Labor,Leslie Osborn,REP,360401,0,7,38,45,
Kay,Commissioner of Labor,Fred Dorrell,DEM,360401,0,0,10,10,
Kay,Commissioner of Labor,Brandt Dismukes,IND,360401,0,0,5,5,
Kay,Insurance Commissioner,Glen Mulready,REP,360401,0,7,38,45,
Kay,Insurance Commissioner,Kimberly Fobbs,DEM,360401,0,0,14,14,
Kay,Corporation Commissioner,Bob Anthony,REP,360401,0,7,38,45,
Kay,Corporation Commissioner,Ashley Nicole Mccray,DEM,360401,0,0,13,13,
Kay,Corporation Commissioner,Jackie Short,IND,360401,0,0,1,1,
Kay,U.S. House,Frank Lucas,REP,360401,0,7,40,47,3
Kay,U.S. House,Frankie Robbins,DEM,360401,0,0,12,12,3
Kay,Governor,Chris Powell,LIB,360403,1,1,13,15,
Kay,Governor,Kevin Stitt,REP,360403,5,32,237,274,
Kay,Governor,Drew Edmondson,DEM,360403,3,13,62,78,
Kay,Lieutenant Governor,Matt Pinnell,REP,360403,6,34,247,287,
Kay,Lieutenant Governor,Anastasia Pittman,DEM,360403,3,11,49,63,
Kay,Lieutenant Governor,Ivan Holmes,IND,360403,0,2,15,17,
Kay,State Auditor,John Yeutter,LIB,360403,3,4,47,54,
Kay,State Auditor,Cindy Byrd,REP,360403,6,37,255,298,
Kay,Attorney General,Mike Hunter,REP,360403,6,34,249,289,
Kay,Attorney General,Mark Myles,DEM,360403,3,12,60,75,
Kay,State Treasurer,Randy Mcdaniel,REP,360403,6,36,257,299,
Kay,State Treasurer,Charles De Coune,IND,360403,3,5,46,54,
Kay,Superintendent of Public Instruction,Joy Hofmeister,REP,360403,4,34,223,261,
Kay,Superintendent of Public Instruction,John Cox,DEM,360403,3,10,53,66,
Kay,Superintendent of Public Instruction,Larry Huff,IND,360403,2,3,34,39,
Kay,Commissioner of Labor,Leslie Osborn,REP,360403,3,36,241,280,
Kay,Commissioner of Labor,Fred Dorrell,DEM,360403,3,10,53,66,
Kay,Commissioner of Labor,Brandt Dismukes,IND,360403,2,1,14,17,
Kay,Insurance Commissioner,Glen Mulready,REP,360403,6,35,244,285,
Kay,Insurance Commissioner,Kimberly Fobbs,DEM,360403,3,12,65,80,
Kay,Corporation Commissioner,Bob Anthony,REP,360403,6,32,235,273,
Kay,Corporation Commissioner,Ashley Nicole Mccray,DEM,360403,2,12,59,73,
Kay,Corporation Commissioner,Jackie Short,IND,360403,1,2,17,20,
Kay,U.S. House,Frank Lucas,REP,360403,6,34,258,298,3
Kay,U.S. House,Frankie Robbins,DEM,360403,3,12,54,69,3
Kay,Governor,Chris Powell,LIB,360404,0,0,8,8,
Kay,Governor,Kevin Stitt,REP,360404,3,5,90,98,
Kay,Governor,Drew Edmondson,DEM,360404,2,3,25,30,
Kay,Lieutenant Governor,Matt Pinnell,REP,360404,3,5,98,106,
Kay,Lieutenant Governor,Anastasia Pittman,DEM,360404,2,3,21,26,
Kay,Lieutenant Governor,Ivan Holmes,IND,360404,0,0,3,3,
Kay,State Auditor,John Yeutter,LIB,360404,2,1,21,24,
Kay,State Auditor,Cindy Byrd,REP,360404,3,7,98,108,
Kay,Attorney General,Mike Hunter,REP,360404,3,5,102,110,
Kay,Attorney General,Mark Myles,DEM,360404,2,3,20,25,
Kay,State Treasurer,Randy Mcdaniel,REP,360404,3,7,103,113,
Kay,State Treasurer,Charles De Coune,IND,360404,2,1,15,18,
Kay,Superintendent of Public Instruction,Joy Hofmeister,REP,360404,1,4,81,86,
Kay,Superintendent of Public Instruction,John Cox,DEM,360404,4,3,30,37,
Kay,Superintendent of Public Instruction,Larry Huff,IND,360404,0,1,11,12,
Kay,Commissioner of Labor,Leslie Osborn,REP,360404,3,5,98,106,
Kay,Commissioner of Labor,Fred Dorrell,DEM,360404,2,3,20,25,
Kay,Commissioner of Labor,Brandt Dismukes,IND,360404,0,0,4,4,
Kay,Insurance Commissioner,Glen Mulready,REP,360404,3,5,98,106,
Kay,Insurance Commissioner,Kimberly Fobbs,DEM,360404,2,3,23,28,
Kay,Corporation Commissioner,Bob Anthony,REP,360404,2,5,91,98,
Kay,Corporation Commissioner,Ashley Nicole Mccray,DEM,360404,3,3,24,30,
Kay,Corporation Commissioner,Jackie Short,IND,360404,0,0,7,7,
Kay,U.S. House,Frank Lucas,REP,360404,3,5,102,110,3
Kay,U.S. House,Frankie Robbins,DEM,360404,2,3,21,26,3
Kay,Governor,Chris Powell,LIB,360406,0,0,9,9,
Kay,Governor,Kevin Stitt,REP,360406,0,10,101,111,
Kay,Governor,Drew Edmondson,DEM,360406,2,3,50,55,
Kay,Lieutenant Governor,Matt Pinnell,REP,360406,0,13,119,132,
Kay,Lieutenant Governor,Anastasia Pittman,DEM,360406,2,0,33,35,
Kay,Lieutenant Governor,Ivan Holmes,IND,360406,0,0,7,7,
Kay,State Auditor,John Yeutter,LIB,360406,1,1,19,21,
Kay,State Auditor,Cindy Byrd,REP,360406,0,12,132,144,
Kay,Attorney General,Mike Hunter,REP,360406,0,12,123,135,
Kay,Attorney General,Mark Myles,DEM,360406,2,0,36,38,
Kay,State Treasurer,Randy Mcdaniel,REP,360406,0,12,123,135,
Kay,State Treasurer,Charles De Coune,IND,360406,1,1,27,29,
Kay,Superintendent of Public Instruction,Joy Hofmeister,REP,360406,0,9,106,115,
Kay,Superintendent of Public Instruction,John Cox,DEM,360406,2,2,41,45,
Kay,Superintendent of Public Instruction,Larry Huff,IND,360406,0,2,12,14,
Kay,Commissioner of Labor,Leslie Osborn,REP,360406,0,11,122,133,
Kay,Commissioner of Labor,Fred Dorrell,DEM,360406,2,2,25,29,
Kay,Commissioner of Labor,Brandt Dismukes,IND,360406,0,0,10,10,
Kay,Insurance Commissioner,Glen Mulready,REP,360406,0,11,121,132,
Kay,Insurance Commissioner,Kimberly Fobbs,DEM,360406,2,2,35,39,
Kay,Corporation Commissioner,Bob Anthony,REP,360406,0,13,113,126,
Kay,Corporation Commissioner,Ashley Nicole Mccray,DEM,360406,2,0,34,36,
Kay,Corporation Commissioner,Jackie Short,IND,360406,0,0,11,11,
Kay,U.S. House,Frank Lucas,REP,360406,0,12,122,134,3
Kay,U.S. House,Frankie Robbins,DEM,360406,2,1,38,41,3
Kay,Governor,Chris Powell,LIB,360407,0,0,0,0,
Kay,Governor,Kevin Stitt,REP,360407,0,1,23,24,
Kay,Governor,Drew Edmondson,DEM,360407,0,0,3,3,
Kay,Lieutenant Governor,Matt Pinnell,REP,360407,0,1,24,25,
Kay,Lieutenant Governor,Anastasia Pittman,DEM,360407,0,0,1,1,
Kay,Lieutenant Governor,Ivan Holmes,IND,360407,0,0,1,1,
Kay,State Auditor,John Yeutter,LIB,360407,0,0,2,2,
Kay,State Auditor,Cindy Byrd,REP,360407,0,1,24,25,
Kay,Attorney General,Mike Hunter,REP,360407,0,1,24,25,
Kay,Attorney General,Mark Myles,DEM,360407,0,0,1,1,
Kay,State Treasurer,Randy Mcdaniel,REP,360407,0,0,24,24,
Kay,State Treasurer,Charles De Coune,IND,360407,0,1,2,3,
Kay,Superintendent of Public Instruction,Joy Hofmeister,REP,360407,0,1,23,24,
Kay,Superintendent of Public Instruction,John Cox,DEM,360407,0,0,1,1,
Kay,Superintendent of Public Instruction,Larry Huff,IND,360407,0,0,2,2,
Kay,Commissioner of Labor,Leslie Osborn,REP,360407,0,0,24,24,
Kay,Commissioner of Labor,Fred Dorrell,DEM,360407,0,1,0,1,
Kay,Commissioner of Labor,Brandt Dismukes,IND,360407,0,0,2,2,
Kay,Insurance Commissioner,Glen Mulready,REP,360407,0,1,23,24,
Kay,Insurance Commissioner,Kimberly Fobbs,DEM,360407,0,0,3,3,
Kay,Corporation Commissioner,Bob Anthony,REP,360407,0,0,21,21,
Kay,Corporation Commissioner,Ashley Nicole Mccray,DEM,360407,0,1,3,4,
Kay,Corporation Commissioner,Jackie Short,IND,360407,0,0,2,2,
Kay,U.S. House,Frank Lucas,REP,360407,0,1,25,26,3
Kay,U.S. House,Frankie Robbins,DEM,360407,0,0,1,1,3
Kay,Governor,Chris Powell,LIB,360409,0,1,3,4,
Kay,Governor,Kevin Stitt,REP,360409,2,7,36,45,
Kay,Governor,Drew Edmondson,DEM,360409,0,0,11,11,
Kay,Lieutenant Governor,Matt Pinnell,REP,360409,2,6,38,46,
Kay,Lieutenant Governor,Anastasia Pittman,DEM,360409,0,0,10,10,
Kay,Lieutenant Governor,Ivan Holmes,IND,360409,0,1,2,3,
Kay,State Auditor,John Yeutter,LIB,360409,0,2,4,6,
Kay,State Auditor,Cindy Byrd,REP,360409,2,5,42,49,
Kay,Attorney General,Mike Hunter,REP,360409,2,7,40,49,
Kay,Attorney General,Mark Myles,DEM,360409,0,0,8,8,
Kay,State Treasurer,Randy Mcdaniel,REP,360409,2,5,41,48,
Kay,State Treasurer,Charles De Coune,IND,360409,0,2,4,6,
Kay,Superintendent of Public Instruction,Joy Hofmeister,REP,360409,2,5,30,37,
Kay,Superintendent of Public Instruction,John Cox,DEM,360409,0,1,14,15,
Kay,Superintendent of Public Instruction,Larry Huff,IND,360409,0,1,6,7,
Kay,Commissioner of Labor,Leslie Osborn,REP,360409,2,6,36,44,
Kay,Commissioner of Labor,Fred Dorrell,DEM,360409,0,0,9,9,
Kay,Commissioner of Labor,Brandt Dismukes,IND,360409,0,1,3,4,
Kay,Insurance Commissioner,Glen Mulready,REP,360409,1,6,37,44,
Kay,Insurance Commissioner,Kimberly Fobbs,DEM,360409,1,1,11,13,
Kay,Corporation Commissioner,Bob Anthony,REP,360409,1,5,35,41,
Kay,Corporation Commissioner,Ashley Nicole Mccray,DEM,360409,1,0,11,12,
Kay,Corporation Commissioner,Jackie Short,IND,360409,0,2,4,6,
Kay,U.S. House,Frank Lucas,REP,360409,2,6,39,47,3
Kay,U.S. House,Frankie Robbins,DEM,360409,0,2,11,13,3
Kay,Governor,Chris Powell,LIB,360411,0,1,8,9,
Kay,Governor,Kevin Stitt,REP,360411,2,2,85,89,
Kay,Governor,Drew Edmondson,DEM,360411,1,1,33,35,
Kay,Lieutenant Governor,Matt Pinnell,REP,360411,2,2,88,92,
Kay,Lieutenant Governor,Anastasia Pittman,DEM,360411,0,2,34,36,
Kay,Lieutenant Governor,Ivan Holmes,IND,360411,1,0,3,4,
Kay,State Auditor,John Yeutter,LIB,360411,1,1,19,21,
Kay,State Auditor,Cindy Byrd,REP,360411,2,3,98,103,
Kay,Attorney General,Mike Hunter,REP,360411,2,3,83,88,
Kay,Attorney General,Mark Myles,DEM,360411,1,1,39,41,
Kay,State Treasurer,Randy Mcdaniel,REP,360411,2,3,93,98,
Kay,State Treasurer,Charles De Coune,IND,360411,1,0,23,24,
Kay,Superintendent of Public Instruction,Joy Hofmeister,REP,360411,2,4,79,85,
Kay,Superintendent of Public Instruction,John Cox,DEM,360411,0,0,31,31,
Kay,Superintendent of Public Instruction,Larry Huff,IND,360411,1,0,14,15,
Kay,Commissioner of Labor,Leslie Osborn,REP,360411,2,4,85,91,
Kay,Commissioner of Labor,Fred Dorrell,DEM,360411,0,0,32,32,
Kay,Commissioner of Labor,Brandt Dismukes,IND,360411,1,0,5,6,
Kay,Insurance Commissioner,Glen Mulready,REP,360411,1,3,88,92,
Kay,Insurance Commissioner,Kimberly Fobbs,DEM,360411,2,1,35,38,
Kay,Corporation Commissioner,Bob Anthony,REP,360411,2,3,78,83,
Kay,Corporation Commissioner,Ashley Nicole Mccray,DEM,360411,0,0,38,38,
Kay,Corporation Commissioner,Jackie Short,IND,360411,1,1,7,9,
Kay,U.S. House,Frank Lucas,REP,360411,2,2,95,99,3
Kay,U.S. House,Frankie Robbins,DEM,360411,1,2,30,33,3
Kay,Governor,Chris Powell,LIB,360412,0,0,11,11,
Kay,Governor,Kevin Stitt,REP,360412,4,2,128,134,
Kay,Governor,Drew Edmondson,DEM,360412,3,0,72,75,
Kay,Lieutenant Governor,Matt Pinnell,REP,360412,4,2,137,143,
Kay,Lieutenant Governor,Anastasia Pittman,DEM,360412,3,0,59,62,
Kay,Lieutenant Governor,Ivan Holmes,IND,360412,0,0,11,11,
Kay,State Auditor,John Yeutter,LIB,360412,1,0,39,40,
Kay,State Auditor,Cindy Byrd,REP,360412,5,2,139,146,
Kay,Attorney General,Mike Hunter,REP,360412,4,1,141,146,
Kay,Attorney General,Mark Myles,DEM,360412,3,1,68,72,
Kay,State Treasurer,Randy Mcdaniel,REP,360412,5,2,147,154,
Kay,State Treasurer,Charles De Coune,IND,360412,1,0,32,33,
Kay,Superintendent of Public Instruction,Joy Hofmeister,REP,360412,4,2,126,132,
Kay,Superintendent of Public Instruction,John Cox,DEM,360412,3,0,61,64,
Kay,Superintendent of Public Instruction,Larry Huff,IND,360412,0,0,21,21,
Kay,Commissioner of Labor,Leslie Osborn,REP,360412,4,2,140,146,
Kay,Commissioner of Labor,Fred Dorrell,DEM,360412,3,0,62,65,
Kay,Commissioner of Labor,Brandt Dismukes,IND,360412,0,0,6,6,
Kay,Insurance Commissioner,Glen Mulready,REP,360412,4,2,139,145,
Kay,Insurance Commissioner,Kimberly Fobbs,DEM,360412,3,0,67,70,
Kay,Corporation Commissioner,Bob Anthony,REP,360412,4,1,123,128,
Kay,Corporation Commissioner,Ashley Nicole Mccray,DEM,360412,3,1,68,72,
Kay,Corporation Commissioner,Jackie Short,IND,360412,0,0,18,18,
Kay,U.S. House,Frank Lucas,REP,360412,4,2,140,146,3
Kay,U.S. House,Frankie Robbins,DEM,360412,3,0,68,71,3
Kay,Governor,Chris Powell,LIB,360413,4,0,16,20,
Kay,Governor,Kevin Stitt,REP,360413,18,34,488,540,
Kay,Governor,Drew Edmondson,DEM,360413,11,39,221,271,
Kay,Lieutenant Governor,Matt Pinnell,REP,360413,19,38,534,591,
Kay,Lieutenant Governor,Anastasia Pittman,DEM,360413,10,32,171,213,
Kay,Lieutenant Governor,Ivan Holmes,IND,360413,4,3,14,21,
Kay,State Auditor,John Yeutter,LIB,360413,8,16,110,134,
Kay,State Auditor,Cindy Byrd,REP,360413,19,49,568,636,
Kay,Attorney General,Mike Hunter,REP,360413,19,41,553,613,
Kay,Attorney General,Mark Myles,DEM,360413,14,30,167,211,
Kay,State Treasurer,Randy Mcdaniel,REP,360413,17,47,566,630,
Kay,State Treasurer,Charles De Coune,IND,360413,9,19,112,140,
Kay,Superintendent of Public Instruction,Joy Hofmeister,REP,360413,19,42,517,578,
Kay,Superintendent of Public Instruction,John Cox,DEM,360413,10,28,167,205,
Kay,Superintendent of Public Instruction,Larry Huff,IND,360413,5,3,35,43,
Kay,Commissioner of Labor,Leslie Osborn,REP,360413,19,38,535,592,
Kay,Commissioner of Labor,Fred Dorrell,DEM,360413,12,31,153,196,
Kay,Commissioner of Labor,Brandt Dismukes,IND,360413,2,1,26,29,
Kay,Insurance Commissioner,Glen Mulready,REP,360413,18,39,537,594,
Kay,Insurance Commissioner,Kimberly Fobbs,DEM,360413,15,31,176,222,
Kay,Corporation Commissioner,Bob Anthony,REP,360413,17,41,510,568,
Kay,Corporation Commissioner,Ashley Nicole Mccray,DEM,360413,13,27,173,213,
Kay,Corporation Commissioner,Jackie Short,IND,360413,3,3,34,40,
Kay,U.S. House,Frank Lucas,REP,360413,20,39,566,625,3
Kay,U.S. House,Frankie Robbins,DEM,360413,13,34,155,202,3
Kay,Governor,Chris Powell,LIB,360419,1,0,15,16,
Kay,Governor,Kevin Stitt,REP,360419,7,7,220,234,
Kay,Governor,Drew Edmondson,DEM,360419,8,3,156,167,
Kay,Lieutenant Governor,Matt Pinnell,REP,360419,9,9,240,258,
Kay,Lieutenant Governor,Anastasia Pittman,DEM,360419,7,1,129,137,
Kay,Lieutenant Governor,Ivan Holmes,IND,360419,0,0,17,17,
Kay,State Auditor,John Yeutter,LIB,360419,6,1,98,105,
Kay,State Auditor,Cindy Byrd,REP,360419,7,8,260,275,
Kay,Attorney General,Mike Hunter,REP,360419,9,9,241,259,
Kay,Attorney General,Mark Myles,DEM,360419,7,1,145,153,
Kay,State Treasurer,Randy Mcdaniel,REP,360419,10,9,256,275,
Kay,State Treasurer,Charles De Coune,IND,360419,4,1,106,111,
Kay,Superintendent of Public Instruction,Joy Hofmeister,REP,360419,7,7,222,236,
Kay,Superintendent of Public Instruction,John Cox,DEM,360419,8,1,122,131,
Kay,Superintendent of Public Instruction,Larry Huff,IND,360419,0,2,43,45,
Kay,Commissioner of Labor,Leslie Osborn,REP,360419,7,8,236,251,
Kay,Commissioner of Labor,Fred Dorrell,DEM,360419,7,1,122,130,
Kay,Commissioner of Labor,Brandt Dismukes,IND,360419,1,0,20,21,
Kay,Insurance Commissioner,Glen Mulready,REP,360419,9,9,243,261,
Kay,Insurance Commissioner,Kimberly Fobbs,DEM,360419,6,1,139,146,
Kay,Corporation Commissioner,Bob Anthony,REP,360419,10,7,224,241,
Kay,Corporation Commissioner,Ashley Nicole Mccray,DEM,360419,6,2,129,137,
Kay,Corporation Commissioner,Jackie Short,IND,360419,0,1,32,33,
Kay,U.S. House,Frank Lucas,REP,360419,10,9,252,271,3
Kay,U.S. House,Frankie Robbins,DEM,360419,7,1,136,144,3
Kay,Governor,Chris Powell,LIB,360420,0,0,16,16,
Kay,Governor,Kevin Stitt,REP,360420,4,2,142,148,
Kay,Governor,Drew Edmondson,DEM,360420,4,1,56,61,
Kay,Lieutenant Governor,Matt Pinnell,REP,360420,5,2,161,168,
Kay,Lieutenant Governor,Anastasia Pittman,DEM,360420,3,1,42,46,
Kay,Lieutenant Governor,Ivan Holmes,IND,360420,0,0,13,13,
Kay,State Auditor,John Yeutter,LIB,360420,0,0,35,35,
Kay,State Auditor,Cindy Byrd,REP,360420,7,3,173,183,
Kay,Attorney General,Mike Hunter,REP,360420,5,2,160,167,
Kay,Attorney General,Mark Myles,DEM,360420,3,1,54,58,
Kay,State Treasurer,Randy Mcdaniel,REP,360420,5,2,165,172,
Kay,State Treasurer,Charles De Coune,IND,360420,2,1,44,47,
Kay,Superintendent of Public Instruction,Joy Hofmeister,REP,360420,7,2,140,149,
Kay,Superintendent of Public Instruction,John Cox,DEM,360420,1,1,51,53,
Kay,Superintendent of Public Instruction,Larry Huff,IND,360420,0,0,24,24,
Kay,Commissioner of Labor,Leslie Osborn,REP,360420,6,2,153,161,
Kay,Commissioner of Labor,Fred Dorrell,DEM,360420,2,0,43,45,
Kay,Commissioner of Labor,Brandt Dismukes,IND,360420,0,1,14,15,
Kay,Insurance Commissioner,Glen Mulready,REP,360420,4,2,164,170,
Kay,Insurance Commissioner,Kimberly Fobbs,DEM,360420,4,1,49,54,
Kay,Corporation Commissioner,Bob Anthony,REP,360420,7,2,148,157,
Kay,Corporation Commissioner,Ashley Nicole Mccray,DEM,360420,1,1,46,48,
Kay,Corporation Commissioner,Jackie Short,IND,360420,0,0,21,21,
Kay,U.S. House,Frank Lucas,REP,360420,5,3,169,177,3
Kay,U.S. House,Frankie Robbins,DEM,360420,3,0,46,49,3
Kay,Governor,Chris Powell,LIB,360503,1,0,38,39,
Kay,Governor,Kevin Stitt,REP,360503,20,20,385,425,
Kay,Governor,Drew Edmondson,DEM,360503,16,23,285,324,
Kay,Lieutenant Governor,Matt Pinnell,REP,360503,20,23,436,479,
Kay,Lieutenant Governor,Anastasia Pittman,DEM,360503,17,20,230,267,
Kay,Lieutenant Governor,Ivan Holmes,IND,360503,0,0,39,39,
Kay,State Auditor,John Yeutter,LIB,360503,3,11,180,194,
Kay,State Auditor,Cindy Byrd,REP,360503,23,28,481,532,
Kay,Attorney General,Mike Hunter,REP,360503,21,22,447,490,
Kay,Attorney General,Mark Myles,DEM,360503,16,21,248,285,
Kay,State Treasurer,Randy Mcdaniel,REP,360503,22,27,461,510,
Kay,State Treasurer,Charles De Coune,IND,360503,4,13,193,210,
Kay,Superintendent of Public Instruction,Joy Hofmeister,REP,360503,18,18,406,442,
Kay,Superintendent of Public Instruction,John Cox,DEM,360503,16,22,223,261,
Kay,Superintendent of Public Instruction,Larry Huff,IND,360503,3,3,70,76,
Kay,Commissioner of Labor,Leslie Osborn,REP,360503,16,23,427,466,
Kay,Commissioner of Labor,Fred Dorrell,DEM,360503,16,20,219,255,
Kay,Commissioner of Labor,Brandt Dismukes,IND,360503,4,0,45,49,
Kay,Insurance Commissioner,Glen Mulready,REP,360503,20,20,437,477,
Kay,Insurance Commissioner,Kimberly Fobbs,DEM,360503,17,23,259,299,
Kay,Corporation Commissioner,Bob Anthony,REP,360503,19,20,411,450,
Kay,Corporation Commissioner,Ashley Nicole Mccray,DEM,360503,17,21,225,263,
Kay,Corporation Commissioner,Jackie Short,IND,360503,1,2,63,66,
Kay,U.S. House,Frank Lucas,REP,360503,21,23,454,498,3
Kay,U.S. House,Frankie Robbins,DEM,360503,16,20,249,285,3
Kay,Governor,Chris Powell,LIB,360507,0,1,33,34,
Kay,Governor,Kevin Stitt,REP,360507,12,12,217,241,
Kay,Governor,Drew Edmondson,DEM,360507,2,5,185,192,
Kay,Lieutenant Governor,Matt Pinnell,REP,360507,11,14,250,275,
Kay,Lieutenant Governor,Anastasia Pittman,DEM,360507,3,4,155,162,
Kay,Lieutenant Governor,Ivan Holmes,IND,360507,0,0,25,25,
Kay,State Auditor,John Yeutter,LIB,360507,2,1,133,136,
Kay,State Auditor,Cindy Byrd,REP,360507,11,14,269,294,
Kay,Attorney General,Mike Hunter,REP,360507,11,14,266,291,
Kay,Attorney General,Mark Myles,DEM,360507,3,4,166,173,
Kay,State Treasurer,Randy Mcdaniel,REP,360507,9,13,278,300,
Kay,State Treasurer,Charles De Coune,IND,360507,5,4,126,135,
Kay,Superintendent of Public Instruction,Joy Hofmeister,REP,360507,11,12,240,263,
Kay,Superintendent of Public Instruction,John Cox,DEM,360507,1,5,142,148,
Kay,Superintendent of Public Instruction,Larry Huff,IND,360507,1,1,51,53,
Kay,Commissioner of Labor,Leslie Osborn,REP,360507,8,13,254,275,
Kay,Commissioner of Labor,Fred Dorrell,DEM,360507,5,3,142,150,
Kay,Commissioner of Labor,Brandt Dismukes,IND,360507,1,2,33,36,
Kay,Insurance Commissioner,Glen Mulready,REP,360507,9,13,258,280,
Kay,Insurance Commissioner,Kimberly Fobbs,DEM,360507,5,5,172,182,
Kay,Corporation Commissioner,Bob Anthony,REP,360507,11,14,234,259,
Kay,Corporation Commissioner,Ashley Nicole Mccray,DEM,360507,3,3,164,170,
Kay,Corporation Commissioner,Jackie Short,IND,360507,0,1,34,35,
Kay,U.S. House,Frank Lucas,REP,360507,12,15,265,292,3
Kay,U.S. House,Frankie Robbins,DEM,360507,2,3,166,171,3
Kay,Governor,Chris Powell,LIB,360516,0,1,16,17,
Kay,Governor,Kevin Stitt,REP,360516,5,6,194,205,
Kay,Governor,Drew Edmondson,DEM,360516,1,3,175,179,
Kay,Lieutenant Governor,Matt Pinnell,REP,360516,5,8,199,212,
Kay,Lieutenant Governor,Anastasia Pittman,DEM,360516,1,2,162,165,
Kay,Lieutenant Governor,Ivan Holmes,IND,360516,0,0,22,22,
Kay,State Auditor,John Yeutter,LIB,360516,1,3,117,121,
Kay,State Auditor,Cindy Byrd,REP,360516,5,7,230,242,
Kay,Attorney General,Mike Hunter,REP,360516,5,8,215,228,
Kay,Attorney General,Mark Myles,DEM,360516,1,2,168,171,
Kay,State Treasurer,Randy Mcdaniel,REP,360516,5,8,216,229,
Kay,State Treasurer,Charles De Coune,IND,360516,1,2,131,134,
Kay,Superintendent of Public Instruction,Joy Hofmeister,REP,360516,5,7,194,206,
Kay,Superintendent of Public Instruction,John Cox,DEM,360516,1,2,150,153,
Kay,Superintendent of Public Instruction,Larry Huff,IND,360516,0,1,36,37,
Kay,Commissioner of Labor,Leslie Osborn,REP,360516,5,8,197,210,
Kay,Commissioner of Labor,Fred Dorrell,DEM,360516,1,2,155,158,
Kay,Commissioner of Labor,Brandt Dismukes,IND,360516,0,0,28,28,
Kay,Insurance Commissioner,Glen Mulready,REP,360516,5,8,196,209,
Kay,Insurance Commissioner,Kimberly Fobbs,DEM,360516,1,2,182,185,
Kay,Corporation Commissioner,Bob Anthony,REP,360516,6,7,191,204,
Kay,Corporation Commissioner,Ashley Nicole Mccray,DEM,360516,0,2,162,164,
Kay,Corporation Commissioner,Jackie Short,IND,360516,0,1,28,29,
Kay,U.S. House,Frank Lucas,REP,360516,5,7,212,224,3
Kay,U.S. House,Frankie Robbins,DEM,360516,1,3,170,174,3
Kay,Governor,Chris Powell,LIB,360517,0,0,27,27,
Kay,Governor,Kevin Stitt,REP,360517,4,10,209,223,
Kay,Governor,Drew Edmondson,DEM,360517,11,7,265,283,
Kay,Lieutenant Governor,Matt Pinnell,REP,360517,6,12,251,269,
Kay,Lieutenant Governor,Anastasia Pittman,DEM,360517,9,5,213,227,
Kay,Lieutenant Governor,Ivan Holmes,IND,360517,0,0,36,36,
Kay,State Auditor,John Yeutter,LIB,360517,5,2,162,169,
Kay,State Auditor,Cindy Byrd,REP,360517,5,14,301,320,
Kay,Attorney General,Mike Hunter,REP,360517,5,13,279,297,
Kay,Attorney General,Mark Myles,DEM,360517,10,4,220,234,
Kay,State Treasurer,Randy Mcdaniel,REP,360517,5,13,293,311,
Kay,State Treasurer,Charles De Coune,IND,360517,5,2,172,179,
Kay,Superintendent of Public Instruction,Joy Hofmeister,REP,360517,5,13,252,270,
Kay,Superintendent of Public Instruction,John Cox,DEM,360517,9,3,184,196,
Kay,Superintendent of Public Instruction,Larry Huff,IND,360517,1,0,62,63,
Kay,Commissioner of Labor,Leslie Osborn,REP,360517,6,11,253,270,
Kay,Commissioner of Labor,Fred Dorrell,DEM,360517,9,5,197,211,
Kay,Commissioner of Labor,Brandt Dismukes,IND,360517,0,0,46,46,
Kay,Insurance Commissioner,Glen Mulready,REP,360517,5,10,259,274,
Kay,Insurance Commissioner,Kimberly Fobbs,DEM,360517,10,5,234,249,
Kay,Corporation Commissioner,Bob Anthony,REP,360517,4,12,235,251,
Kay,Corporation Commissioner,Ashley Nicole Mccray,DEM,360517,10,4,208,222,
Kay,Corporation Commissioner,Jackie Short,IND,360517,1,0,51,52,
Kay,U.S. House,Frank Lucas,REP,360517,5,12,277,294,3
Kay,U.S. House,Frankie Robbins,DEM,360517,10,5,221,236,3
Kay,Governor,Chris Powell,LIB,360527,2,1,23,26,
Kay,Governor,Kevin Stitt,REP,360527,24,24,383,431,
Kay,Governor,Drew Edmondson,DEM,360527,12,18,248,278,
Kay,Lieutenant Governor,Matt Pinnell,REP,360527,30,24,455,509,
Kay,Lieutenant Governor,Anastasia Pittman,DEM,360527,8,18,182,208,
Kay,Lieutenant Governor,Ivan Holmes,IND,360527,0,1,21,22,
Kay,State Auditor,John Yeutter,LIB,360527,6,9,135,150,
Kay,State Auditor,Cindy Byrd,REP,360527,30,30,482,542,
Kay,Attorney General,Mike Hunter,REP,360527,32,29,462,523,
Kay,Attorney General,Mark Myles,DEM,360527,6,14,186,206,
Kay,State Treasurer,Randy Mcdaniel,REP,360527,30,29,482,541,
Kay,State Treasurer,Charles De Coune,IND,360527,5,9,135,149,
Kay,Superintendent of Public Instruction,Joy Hofmeister,REP,360527,25,27,422,474,
Kay,Superintendent of Public Instruction,John Cox,DEM,360527,10,12,184,206,
Kay,Superintendent of Public Instruction,Larry Huff,IND,360527,2,4,49,55,
Kay,Commissioner of Labor,Leslie Osborn,REP,360527,30,27,428,485,
Kay,Commissioner of Labor,Fred Dorrell,DEM,360527,7,16,182,205,
Kay,Commissioner of Labor,Brandt Dismukes,IND,360527,0,0,37,37,
Kay,Insurance Commissioner,Glen Mulready,REP,360527,28,28,439,495,
Kay,Insurance Commissioner,Kimberly Fobbs,DEM,360527,10,15,209,234,
Kay,Corporation Commissioner,Bob Anthony,REP,360527,28,27,424,479,
Kay,Corporation Commissioner,Ashley Nicole Mccray,DEM,360527,8,15,177,200,
Kay,Corporation Commissioner,Jackie Short,IND,360527,1,1,49,51,
Kay,U.S. House,Frank Lucas,REP,360527,30,29,471,530,3
Kay,U.S. House,Frankie Robbins,DEM,360527,8,14,180,202,3
Kay,Governor,Chris Powell,LIB,360530,0,0,19,19,
Kay,Governor,Kevin Stitt,REP,360530,11,23,314,348,
Kay,Governor,Drew Edmondson,DEM,360530,6,5,245,256,
Kay,Lieutenant Governor,Matt Pinnell,REP,360530,11,23,364,398,
Kay,Lieutenant Governor,Anastasia Pittman,DEM,360530,7,5,188,200,
Kay,Lieutenant Governor,Ivan Holmes,IND,360530,0,0,25,25,
Kay,State Auditor,John Yeutter,LIB,360530,3,2,135,140,
Kay,State Auditor,Cindy Byrd,REP,360530,12,25,410,447,
Kay,Attorney General,Mike Hunter,REP,360530,12,25,381,418,
Kay,Attorney General,Mark Myles,DEM,360530,6,3,194,203,
Kay,State Treasurer,Randy Mcdaniel,REP,360530,11,24,402,437,
Kay,State Treasurer,Charles De Coune,IND,360530,5,3,137,145,
Kay,Superintendent of Public Instruction,Joy Hofmeister,REP,360530,11,24,342,377,
Kay,Superintendent of Public Instruction,John Cox,DEM,360530,5,3,187,195,
Kay,Superintendent of Public Instruction,Larry Huff,IND,360530,1,1,46,48,
Kay,Commissioner of Labor,Leslie Osborn,REP,360530,12,24,357,393,
Kay,Commissioner of Labor,Fred Dorrell,DEM,360530,6,4,180,190,
Kay,Commissioner of Labor,Brandt Dismukes,IND,360530,0,0,36,36,
Kay,Insurance Commissioner,Glen Mulready,REP,360530,11,25,353,389,
Kay,Insurance Commissioner,Kimberly Fobbs,DEM,360530,7,3,216,226,
Kay,Corporation Commissioner,Bob Anthony,REP,360530,10,25,342,377,
Kay,Corporation Commissioner,Ashley Nicole Mccray,DEM,360530,8,3,196,207,
Kay,Corporation Commissioner,Jackie Short,IND,360530,0,0,34,34,
Kay,U.S. House,Frank Lucas,REP,360530,12,24,383,419,3
Kay,U.S. House,Frankie Robbins,DEM,360530,5,4,193,202,3
Kay,Governor,Chris Powell,LIB,360532,0,0,23,23,
Kay,Governor,Kevin Stitt,REP,360532,16,26,382,424,
Kay,Governor,Drew Edmondson,DEM,360532,8,18,215,241,
Kay,Lieutenant Governor,Matt Pinnell,REP,360532,18,28,439,485,
Kay,Lieutenant Governor,Anastasia Pittman,DEM,360532,6,15,154,175,
Kay,Lieutenant Governor,Ivan Holmes,IND,360532,0,1,19,20,
Kay,State Auditor,John Yeutter,LIB,360532,4,9,108,121,
Kay,State Auditor,Cindy Byrd,REP,360532,19,32,473,524,
Kay,Attorney General,Mike Hunter,REP,360532,17,32,453,502,
Kay,Attorney General,Mark Myles,DEM,360532,7,12,161,180,
Kay,State Treasurer,Randy Mcdaniel,REP,360532,17,33,477,527,
Kay,State Treasurer,Charles De Coune,IND,360532,5,8,102,115,
Kay,Superintendent of Public Instruction,Joy Hofmeister,REP,360532,16,28,417,461,
Kay,Superintendent of Public Instruction,John Cox,DEM,360532,7,16,150,173,
Kay,Superintendent of Public Instruction,Larry Huff,IND,360532,1,0,50,51,
Kay,Commissioner of Labor,Leslie Osborn,REP,360532,17,28,432,477,
Kay,Commissioner of Labor,Fred Dorrell,DEM,360532,3,16,141,160,
Kay,Commissioner of Labor,Brandt Dismukes,IND,360532,2,0,38,40,
Kay,Insurance Commissioner,Glen Mulready,REP,360532,18,31,416,465,
Kay,Insurance Commissioner,Kimberly Fobbs,DEM,360532,5,12,193,210,
Kay,Corporation Commissioner,Bob Anthony,REP,360532,17,28,413,458,
Kay,Corporation Commissioner,Ashley Nicole Mccray,DEM,360532,5,15,155,175,
Kay,Corporation Commissioner,Jackie Short,IND,360532,2,0,43,45,
Kay,U.S. House,Frank Lucas,REP,360532,16,31,455,502,3
Kay,U.S. House,Frankie Robbins,DEM,360532,8,13,162,183,3
Kay,Governor,Chris Powell,LIB,360533,1,2,35,38,
Kay,Governor,Kevin Stitt,REP,360533,16,21,346,383,
Kay,Governor,Drew Edmondson,DEM,360533,13,7,218,238,
Kay,Lieutenant Governor,Matt Pinnell,REP,360533,17,23,398,438,
Kay,Lieutenant Governor,Anastasia Pittman,DEM,360533,10,6,174,190,
Kay,Lieutenant Governor,Ivan Holmes,IND,360533,3,1,24,28,
Kay,State Auditor,John Yeutter,LIB,360533,6,7,124,137,
Kay,State Auditor,Cindy Byrd,REP,360533,23,21,433,477,
Kay,Attorney General,Mike Hunter,REP,360533,18,21,413,452,
Kay,Attorney General,Mark Myles,DEM,360533,12,9,182,203,
Kay,State Treasurer,Randy Mcdaniel,REP,360533,16,22,429,467,
Kay,State Treasurer,Charles De Coune,IND,360533,12,6,125,143,
Kay,Superintendent of Public Instruction,Joy Hofmeister,REP,360533,17,19,383,419,
Kay,Superintendent of Public Instruction,John Cox,DEM,360533,10,6,155,171,
Kay,Superintendent of Public Instruction,Larry Huff,IND,360533,3,4,54,61,
Kay,Commissioner of Labor,Leslie Osborn,REP,360533,15,21,397,433,
Kay,Commissioner of Labor,Fred Dorrell,DEM,360533,10,8,159,177,
Kay,Commissioner of Labor,Brandt Dismukes,IND,360533,3,1,28,32,
Kay,Insurance Commissioner,Glen Mulready,REP,360533,17,21,391,429,
Kay,Insurance Commissioner,Kimberly Fobbs,DEM,360533,11,9,195,215,
Kay,Corporation Commissioner,Bob Anthony,REP,360533,15,18,381,414,
Kay,Corporation Commissioner,Ashley Nicole Mccray,DEM,360533,9,11,172,192,
Kay,Corporation Commissioner,Jackie Short,IND,360533,4,1,38,43,
Kay,U.S. House,Frank Lucas,REP,360533,20,21,420,461,3
Kay,U.S. House,Frankie Robbins,DEM,360533,10,9,177,196,3
Kay,Governor,Chris Powell,LIB,360534,0,2,23,25,
Kay,Governor,Kevin Stitt,REP,360534,18,48,500,566,
Kay,Governor,Drew Edmondson,DEM,360534,19,19,263,301,
Kay,Lieutenant Governor,Matt Pinnell,REP,360534,20,51,567,638,
Kay,Lieutenant Governor,Anastasia Pittman,DEM,360534,17,17,193,227,
Kay,Lieutenant Governor,Ivan Holmes,IND,360534,0,0,24,24,
Kay,State Auditor,John Yeutter,LIB,360534,5,8,118,131,
Kay,State Auditor,Cindy Byrd,REP,360534,25,56,626,707,
Kay,Attorney General,Mike Hunter,REP,360534,20,54,596,670,
Kay,Attorney General,Mark Myles,DEM,360534,16,14,187,217,
Kay,State Treasurer,Randy Mcdaniel,REP,360534,22,53,603,678,
Kay,State Treasurer,Charles De Coune,IND,360534,7,9,144,160,
Kay,Superintendent of Public Instruction,Joy Hofmeister,REP,360534,18,50,557,625,
Kay,Superintendent of Public Instruction,John Cox,DEM,360534,17,15,168,200,
Kay,Superintendent of Public Instruction,Larry Huff,IND,360534,2,3,52,57,
Kay,Commissioner of Labor,Leslie Osborn,REP,360534,23,51,570,644,
Kay,Commissioner of Labor,Fred Dorrell,DEM,360534,13,15,172,200,
Kay,Commissioner of Labor,Brandt Dismukes,IND,360534,1,2,29,32,
Kay,Insurance Commissioner,Glen Mulready,REP,360534,20,54,578,652,
Kay,Insurance Commissioner,Kimberly Fobbs,DEM,360534,16,14,197,227,
Kay,Corporation Commissioner,Bob Anthony,REP,360534,20,48,540,608,
Kay,Corporation Commissioner,Ashley Nicole Mccray,DEM,360534,15,16,186,217,
Kay,Corporation Commissioner,Jackie Short,IND,360534,0,3,53,56,
Kay,U.S. House,Frank Lucas,REP,360534,21,55,600,676,3
Kay,U.S. House,Frankie Robbins,DEM,360534,15,13,181,209,3
Kay,Governor,Chris Powell,LIB,360535,1,1,15,17,
Kay,Governor,Kevin Stitt,REP,360535,33,44,453,530,
Kay,Governor,Drew Edmondson,DEM,360535,20,31,223,274,
Kay,Lieutenant Governor,Matt Pinnell,REP,360535,37,44,517,598,
Kay,Lieutenant Governor,Anastasia Pittman,DEM,360535,15,26,160,201,
Kay,Lieutenant Governor,Ivan Holmes,IND,360535,3,5,13,21,
Kay,State Auditor,John Yeutter,LIB,360535,8,15,102,125,
Kay,State Auditor,Cindy Byrd,REP,360535,42,54,562,658,
Kay,Attorney General,Mike Hunter,REP,360535,35,45,526,606,
Kay,Attorney General,Mark Myles,DEM,360535,19,29,163,211,
Kay,State Treasurer,Randy Mcdaniel,REP,360535,40,51,558,649,
Kay,State Treasurer,Charles De Coune,IND,360535,11,18,104,133,
Kay,Superintendent of Public Instruction,Joy Hofmeister,REP,360535,33,43,497,573,
Kay,Superintendent of Public Instruction,John Cox,DEM,360535,19,25,150,194,
Kay,Superintendent of Public Instruction,Larry Huff,IND,360535,2,7,43,52,
Kay,Commissioner of Labor,Leslie Osborn,REP,360535,37,45,523,605,
Kay,Commissioner of Labor,Fred Dorrell,DEM,360535,14,25,143,182,
Kay,Commissioner of Labor,Brandt Dismukes,IND,360535,3,4,21,28,
Kay,Insurance Commissioner,Glen Mulready,REP,360535,37,45,518,600,
Kay,Insurance Commissioner,Kimberly Fobbs,DEM,360535,17,29,166,212,
Kay,Corporation Commissioner,Bob Anthony,REP,360535,37,40,501,578,
Kay,Corporation Commissioner,Ashley Nicole Mccray,DEM,360535,16,28,157,201,
Kay,Corporation Commissioner,Jackie Short,IND,360535,1,6,28,35,
Kay,U.S. House,Frank Lucas,REP,360535,35,46,540,621,3
Kay,U.S. House,Frankie Robbins,DEM,360535,18,29,149,196,3
Kingfisher,Governor,Chris Powell,LIB,370101,2,4,32,38,
Kingfisher,Governor,Kevin Stitt,REP,370101,26,114,537,677,
Kingfisher,Governor,Drew Edmondson,DEM,370101,14,19,171,204,
Kingfisher,Lieutenant Governor,Matt Pinnell,REP,370101,28,117,608,753,
Kingfisher,Lieutenant Governor,Anastasia Pittman,DEM,370101,14,15,115,144,
Kingfisher,Lieutenant Governor,Ivan Holmes,IND,370101,1,4,17,22,
Kingfisher,State Auditor,John Yeutter,LIB,370101,2,12,73,87,
Kingfisher,State Auditor,Cindy Byrd,REP,370101,32,121,649,802,
Kingfisher,Attorney General,Mike Hunter,REP,370101,30,116,612,758,
Kingfisher,Attorney General,Mark Myles,DEM,370101,12,19,126,157,
Kingfisher,State Treasurer,Randy Mcdaniel,REP,370101,31,119,625,775,
Kingfisher,State Treasurer,Charles De Coune,IND,370101,5,12,91,108,
Kingfisher,Superintendent of Public Instruction,Joy Hofmeister,REP,370101,31,106,555,692,
Kingfisher,Superintendent of Public Instruction,John Cox,DEM,370101,10,15,134,159,
Kingfisher,Superintendent of Public Instruction,Larry Huff,IND,370101,2,15,50,67,
Kingfisher,Commissioner of Labor,Leslie Osborn,REP,370101,34,112,584,730,
Kingfisher,Commissioner of Labor,Fred Dorrell,DEM,370101,8,15,103,126,
Kingfisher,Commissioner of Labor,Brandt Dismukes,IND,370101,1,9,38,48,
Kingfisher,Insurance Commissioner,Glen Mulready,REP,370101,29,113,604,746,
Kingfisher,Insurance Commissioner,Kimberly Fobbs,DEM,370101,14,21,129,164,
Kingfisher,Corporation Commissioner,Bob Anthony,REP,370101,33,106,564,703,
Kingfisher,Corporation Commissioner,Ashley Nicole Mccray,DEM,370101,9,21,132,162,
Kingfisher,Corporation Commissioner,Jackie Short,IND,370101,1,8,44,53,
Kingfisher,U.S. House,Frank Lucas,REP,370101,35,119,636,790,3
Kingfisher,U.S. House,Frankie Robbins,DEM,370101,8,17,102,127,3
Kingfisher,Governor,Chris Powell,LIB,370102,0,0,6,6,
Kingfisher,Governor,Kevin Stitt,REP,370102,9,18,150,177,
Kingfisher,Governor,Drew Edmondson,DEM,370102,1,3,33,37,
Kingfisher,Lieutenant Governor,Matt Pinnell,REP,370102,8,19,170,197,
Kingfisher,Lieutenant Governor,Anastasia Pittman,DEM,370102,1,2,12,15,
Kingfisher,Lieutenant Governor,Ivan Holmes,IND,370102,0,0,2,2,
Kingfisher,State Auditor,John Yeutter,LIB,370102,0,2,14,16,
Kingfisher,State Auditor,Cindy Byrd,REP,370102,9,19,160,188,
Kingfisher,Attorney General,Mike Hunter,REP,370102,9,19,162,190,
Kingfisher,Attorney General,Mark Myles,DEM,370102,0,2,18,20,
Kingfisher,State Treasurer,Randy Mcdaniel,REP,370102,9,19,165,193,
Kingfisher,State Treasurer,Charles De Coune,IND,370102,0,2,9,11,
Kingfisher,Superintendent of Public Instruction,Joy Hofmeister,REP,370102,7,18,145,170,
Kingfisher,Superintendent of Public Instruction,John Cox,DEM,370102,1,1,26,28,
Kingfisher,Superintendent of Public Instruction,Larry Huff,IND,370102,2,2,9,13,
Kingfisher,Commissioner of Labor,Leslie Osborn,REP,370102,9,17,148,174,
Kingfisher,Commissioner of Labor,Fred Dorrell,DEM,370102,1,2,15,18,
Kingfisher,Commissioner of Labor,Brandt Dismukes,IND,370102,0,2,13,15,
Kingfisher,Insurance Commissioner,Glen Mulready,REP,370102,10,19,154,183,
Kingfisher,Insurance Commissioner,Kimberly Fobbs,DEM,370102,0,2,23,25,
Kingfisher,Corporation Commissioner,Bob Anthony,REP,370102,7,18,146,171,
Kingfisher,Corporation Commissioner,Ashley Nicole Mccray,DEM,370102,1,3,25,29,
Kingfisher,Corporation Commissioner,Jackie Short,IND,370102,2,0,10,12,
Kingfisher,U.S. House,Frank Lucas,REP,370102,8,19,168,195,3
Kingfisher,U.S. House,Frankie Robbins,DEM,370102,0,2,16,18,3
Kingfisher,State Senate,Chuck Hall,REP,370102,8,19,162,189,20
Kingfisher,State Senate,Heady Coleman,DEM,370102,0,2,16,18,20
Kingfisher,Governor,Chris Powell,LIB,370103,2,1,16,19,
Kingfisher,Governor,Kevin Stitt,REP,370103,10,38,197,245,
Kingfisher,Governor,Drew Edmondson,DEM,370103,2,10,28,40,
Kingfisher,Lieutenant Governor,Matt Pinnell,REP,370103,11,41,214,266,
Kingfisher,Lieutenant Governor,Anastasia Pittman,DEM,370103,0,7,17,24,
Kingfisher,Lieutenant Governor,Ivan Holmes,IND,370103,3,1,7,11,
Kingfisher,State Auditor,John Yeutter,LIB,370103,2,4,27,33,
Kingfisher,State Auditor,Cindy Byrd,REP,370103,12,44,211,267,
Kingfisher,Attorney General,Mike Hunter,REP,370103,13,42,204,259,
Kingfisher,Attorney General,Mark Myles,DEM,370103,1,7,30,38,
Kingfisher,State Treasurer,Randy Mcdaniel,REP,370103,11,42,216,269,
Kingfisher,State Treasurer,Charles De Coune,IND,370103,3,6,16,25,
Kingfisher,Superintendent of Public Instruction,Joy Hofmeister,REP,370103,9,37,192,238,
Kingfisher,Superintendent of Public Instruction,John Cox,DEM,370103,4,8,26,38,
Kingfisher,Superintendent of Public Instruction,Larry Huff,IND,370103,1,4,20,25,
Kingfisher,Commissioner of Labor,Leslie Osborn,REP,370103,9,42,195,246,
Kingfisher,Commissioner of Labor,Fred Dorrell,DEM,370103,2,6,25,33,
Kingfisher,Commissioner of Labor,Brandt Dismukes,IND,370103,2,1,16,19,
Kingfisher,Insurance Commissioner,Glen Mulready,REP,370103,12,41,211,264,
Kingfisher,Insurance Commissioner,Kimberly Fobbs,DEM,370103,2,8,26,36,
Kingfisher,Corporation Commissioner,Bob Anthony,REP,370103,8,33,185,226,
Kingfisher,Corporation Commissioner,Ashley Nicole Mccray,DEM,370103,2,13,32,47,
Kingfisher,Corporation Commissioner,Jackie Short,IND,370103,4,3,18,25,
Kingfisher,U.S. House,Frank Lucas,REP,370103,11,45,221,277,3
Kingfisher,U.S. House,Frankie Robbins,DEM,370103,3,4,20,27,3
Kingfisher,State Senate,Chuck Hall,REP,370103,14,39,212,265,20
Kingfisher,State Senate,Heady Coleman,DEM,370103,0,10,23,33,20
Kingfisher,Governor,Chris Powell,LIB,370105,1,0,23,24,
Kingfisher,Governor,Kevin Stitt,REP,370105,21,28,374,423,
Kingfisher,Governor,Drew Edmondson,DEM,370105,10,12,146,168,
Kingfisher,Lieutenant Governor,Matt Pinnell,REP,370105,23,35,418,476,
Kingfisher,Lieutenant Governor,Anastasia Pittman,DEM,370105,7,3,102,112,
Kingfisher,Lieutenant Governor,Ivan Holmes,IND,370105,1,2,25,28,
Kingfisher,State Auditor,John Yeutter,LIB,370105,5,7,74,86,
Kingfisher,State Auditor,Cindy Byrd,REP,370105,25,32,447,504,
Kingfisher,Attorney General,Mike Hunter,REP,370105,25,31,430,486,
Kingfisher,Attorney General,Mark Myles,DEM,370105,5,8,109,122,
Kingfisher,State Treasurer,Randy Mcdaniel,REP,370105,22,36,434,492,
Kingfisher,State Treasurer,Charles De Coune,IND,370105,7,4,83,94,
Kingfisher,Superintendent of Public Instruction,Joy Hofmeister,REP,370105,21,30,397,448,
Kingfisher,Superintendent of Public Instruction,John Cox,DEM,370105,7,4,87,98,
Kingfisher,Superintendent of Public Instruction,Larry Huff,IND,370105,4,5,54,63,
Kingfisher,Commissioner of Labor,Leslie Osborn,REP,370105,24,29,408,461,
Kingfisher,Commissioner of Labor,Fred Dorrell,DEM,370105,5,8,83,96,
Kingfisher,Commissioner of Labor,Brandt Dismukes,IND,370105,1,1,38,40,
Kingfisher,Insurance Commissioner,Glen Mulready,REP,370105,23,33,419,475,
Kingfisher,Insurance Commissioner,Kimberly Fobbs,DEM,370105,7,5,110,122,
Kingfisher,Corporation Commissioner,Bob Anthony,REP,370105,21,31,380,432,
Kingfisher,Corporation Commissioner,Ashley Nicole Mccray,DEM,370105,5,6,101,112,
Kingfisher,Corporation Commissioner,Jackie Short,IND,370105,4,2,52,58,
Kingfisher,U.S. House,Frank Lucas,REP,370105,23,37,442,502,3
Kingfisher,U.S. House,Frankie Robbins,DEM,370105,7,3,97,107,3
Kingfisher,State Senate,Chuck Hall,REP,370105,24,33,413,470,20
Kingfisher,State Senate,Heady Coleman,DEM,370105,7,6,121,134,20
Kingfisher,State House,Denise Crosswhite Hader,REP,370105,24,30,424,478,41
Kingfisher,State House,Jennie Scott,DEM,370105,7,10,113,130,41
Kingfisher,Governor,Chris Powell,LIB,370106,0,0,3,3,
Kingfisher,Governor,Kevin Stitt,REP,370106,2,10,56,68,
Kingfisher,Governor,Drew Edmondson,DEM,370106,1,1,6,8,
Kingfisher,Lieutenant Governor,Matt Pinnell,REP,370106,2,11,60,73,
Kingfisher,Lieutenant Governor,Anastasia Pittman,DEM,370106,1,0,4,5,
Kingfisher,Lieutenant Governor,Ivan Holmes,IND,370106,0,0,1,1,
Kingfisher,State Auditor,John Yeutter,LIB,370106,1,0,5,6,
Kingfisher,State Auditor,Cindy Byrd,REP,370106,2,11,60,73,
Kingfisher,Attorney General,Mike Hunter,REP,370106,2,10,59,71,
Kingfisher,Attorney General,Mark Myles,DEM,370106,1,1,6,8,
Kingfisher,State Treasurer,Randy Mcdaniel,REP,370106,2,11,62,75,
Kingfisher,State Treasurer,Charles De Coune,IND,370106,1,0,3,4,
Kingfisher,Superintendent of Public Instruction,Joy Hofmeister,REP,370106,2,9,54,65,
Kingfisher,Superintendent of Public Instruction,John Cox,DEM,370106,1,0,6,7,
Kingfisher,Superintendent of Public Instruction,Larry Huff,IND,370106,0,2,5,7,
Kingfisher,Commissioner of Labor,Leslie Osborn,REP,370106,2,8,59,69,
Kingfisher,Commissioner of Labor,Fred Dorrell,DEM,370106,1,0,5,6,
Kingfisher,Commissioner of Labor,Brandt Dismukes,IND,370106,0,3,1,4,
Kingfisher,Insurance Commissioner,Glen Mulready,REP,370106,2,11,59,72,
Kingfisher,Insurance Commissioner,Kimberly Fobbs,DEM,370106,1,0,6,7,
Kingfisher,Corporation Commissioner,Bob Anthony,REP,370106,2,9,58,69,
Kingfisher,Corporation Commissioner,Ashley Nicole Mccray,DEM,370106,1,2,2,5,
Kingfisher,Corporation Commissioner,Jackie Short,IND,370106,0,0,5,5,
Kingfisher,U.S. House,Frank Lucas,REP,370106,2,11,59,72,3
Kingfisher,U.S. House,Frankie Robbins,DEM,370106,1,0,6,7,3
Kingfisher,State Senate,Chuck Hall,REP,370106,2,11,56,69,20
Kingfisher,State Senate,Heady Coleman,DEM,370106,1,0,9,10,20
Kingfisher,State House,Denise Crosswhite Hader,REP,370106,2,11,57,70,41
Kingfisher,State House,Jennie Scott,DEM,370106,1,0,8,9,41
Kingfisher,Governor,Chris Powell,LIB,370201,0,0,27,27,
Kingfisher,Governor,Kevin Stitt,REP,370201,18,21,620,659,
Kingfisher,Governor,Drew Edmondson,DEM,370201,7,12,158,177,
Kingfisher,Lieutenant Governor,Matt Pinnell,REP,370201,19,21,674,714,
Kingfisher,Lieutenant Governor,Anastasia Pittman,DEM,370201,6,12,105,123,
Kingfisher,Lieutenant Governor,Ivan Holmes,IND,370201,0,0,20,20,
Kingfisher,State Auditor,John Yeutter,LIB,370201,3,5,84,92,
Kingfisher,State Auditor,Cindy Byrd,REP,370201,20,26,700,746,
Kingfisher,Attorney General,Mike Hunter,REP,370201,19,26,681,726,
Kingfisher,Attorney General,Mark Myles,DEM,370201,6,7,112,125,
Kingfisher,State Treasurer,Randy Mcdaniel,REP,370201,20,27,684,731,
Kingfisher,State Treasurer,Charles De Coune,IND,370201,1,6,97,104,
Kingfisher,Superintendent of Public Instruction,Joy Hofmeister,REP,370201,18,25,631,674,
Kingfisher,Superintendent of Public Instruction,John Cox,DEM,370201,5,8,104,117,
Kingfisher,Superintendent of Public Instruction,Larry Huff,IND,370201,1,0,62,63,
Kingfisher,Commissioner of Labor,Leslie Osborn,REP,370201,17,25,644,686,
Kingfisher,Commissioner of Labor,Fred Dorrell,DEM,370201,6,6,103,115,
Kingfisher,Commissioner of Labor,Brandt Dismukes,IND,370201,0,2,38,40,
Kingfisher,Insurance Commissioner,Glen Mulready,REP,370201,17,24,662,703,
Kingfisher,Insurance Commissioner,Kimberly Fobbs,DEM,370201,6,8,124,138,
Kingfisher,Corporation Commissioner,Bob Anthony,REP,370201,19,26,591,636,
Kingfisher,Corporation Commissioner,Ashley Nicole Mccray,DEM,370201,5,6,123,134,
Kingfisher,Corporation Commissioner,Jackie Short,IND,370201,0,0,80,80,
Kingfisher,U.S. House,Frank Lucas,REP,370201,20,28,687,735,3
Kingfisher,U.S. House,Frankie Robbins,DEM,370201,4,5,109,118,3
Kingfisher,State Senate,Chuck Hall,REP,370201,19,24,679,722,20
Kingfisher,State Senate,Heady Coleman,DEM,370201,5,8,112,125,20
Kingfisher,Governor,Chris Powell,LIB,370203,1,1,3,5,
Kingfisher,Governor,Kevin Stitt,REP,370203,10,1,81,92,
Kingfisher,Governor,Drew Edmondson,DEM,370203,5,0,12,17,
Kingfisher,Lieutenant Governor,Matt Pinnell,REP,370203,12,2,80,94,
Kingfisher,Lieutenant Governor,Anastasia Pittman,DEM,370203,4,0,13,17,
Kingfisher,Lieutenant Governor,Ivan Holmes,IND,370203,0,0,4,4,
Kingfisher,State Auditor,John Yeutter,LIB,370203,0,0,9,9,
Kingfisher,State Auditor,Cindy Byrd,REP,370203,16,2,88,106,
Kingfisher,Attorney General,Mike Hunter,REP,370203,13,2,84,99,
Kingfisher,Attorney General,Mark Myles,DEM,370203,3,0,13,16,
Kingfisher,State Treasurer,Randy Mcdaniel,REP,370203,15,2,81,98,
Kingfisher,State Treasurer,Charles De Coune,IND,370203,1,0,16,17,
Kingfisher,Superintendent of Public Instruction,Joy Hofmeister,REP,370203,12,2,76,90,
Kingfisher,Superintendent of Public Instruction,John Cox,DEM,370203,4,0,13,17,
Kingfisher,Superintendent of Public Instruction,Larry Huff,IND,370203,0,0,8,8,
Kingfisher,Commissioner of Labor,Leslie Osborn,REP,370203,15,2,75,92,
Kingfisher,Commissioner of Labor,Fred Dorrell,DEM,370203,0,0,15,15,
Kingfisher,Commissioner of Labor,Brandt Dismukes,IND,370203,1,0,7,8,
Kingfisher,Insurance Commissioner,Glen Mulready,REP,370203,12,2,80,94,
Kingfisher,Insurance Commissioner,Kimberly Fobbs,DEM,370203,4,0,15,19,
Kingfisher,Corporation Commissioner,Bob Anthony,REP,370203,12,2,76,90,
Kingfisher,Corporation Commissioner,Ashley Nicole Mccray,DEM,370203,4,0,16,20,
Kingfisher,Corporation Commissioner,Jackie Short,IND,370203,0,0,5,5,
Kingfisher,U.S. House,Frank Lucas,REP,370203,13,2,85,100,3
Kingfisher,U.S. House,Frankie Robbins,DEM,370203,3,0,12,15,3
Kingfisher,State Senate,Chuck Hall,REP,370203,12,2,81,95,20
Kingfisher,State Senate,Heady Coleman,DEM,370203,4,0,16,20,20
Kingfisher,State House,Denise Crosswhite Hader,REP,370203,13,2,79,94,41
Kingfisher,State House,Jennie Scott,DEM,370203,3,0,18,21,41
Kingfisher,Governor,Chris Powell,LIB,370204,0,0,12,12,
Kingfisher,Governor,Kevin Stitt,REP,370204,2,17,163,182,
Kingfisher,Governor,Drew Edmondson,DEM,370204,0,11,27,38,
Kingfisher,Lieutenant Governor,Matt Pinnell,REP,370204,2,19,170,191,
Kingfisher,Lieutenant Governor,Anastasia Pittman,DEM,370204,0,9,24,33,
Kingfisher,Lieutenant Governor,Ivan Holmes,IND,370204,0,0,6,6,
Kingfisher,State Auditor,John Yeutter,LIB,370204,0,3,24,27,
Kingfisher,State Auditor,Cindy Byrd,REP,370204,2,24,170,196,
Kingfisher,Attorney General,Mike Hunter,REP,370204,2,19,162,183,
Kingfisher,Attorney General,Mark Myles,DEM,370204,0,9,36,45,
Kingfisher,State Treasurer,Randy Mcdaniel,REP,370204,2,22,169,193,
Kingfisher,State Treasurer,Charles De Coune,IND,370204,0,4,26,30,
Kingfisher,Superintendent of Public Instruction,Joy Hofmeister,REP,370204,0,20,144,164,
Kingfisher,Superintendent of Public Instruction,John Cox,DEM,370204,1,6,31,38,
Kingfisher,Superintendent of Public Instruction,Larry Huff,IND,370204,1,1,22,24,
Kingfisher,Commissioner of Labor,Leslie Osborn,REP,370204,0,19,161,180,
Kingfisher,Commissioner of Labor,Fred Dorrell,DEM,370204,1,7,23,31,
Kingfisher,Commissioner of Labor,Brandt Dismukes,IND,370204,1,2,14,17,
Kingfisher,Insurance Commissioner,Glen Mulready,REP,370204,2,18,164,184,
Kingfisher,Insurance Commissioner,Kimberly Fobbs,DEM,370204,0,9,34,43,
Kingfisher,Corporation Commissioner,Bob Anthony,REP,370204,0,19,138,157,
Kingfisher,Corporation Commissioner,Ashley Nicole Mccray,DEM,370204,1,9,37,47,
Kingfisher,Corporation Commissioner,Jackie Short,IND,370204,1,0,22,23,
Kingfisher,U.S. House,Frank Lucas,REP,370204,1,19,181,201,3
Kingfisher,U.S. House,Frankie Robbins,DEM,370204,1,9,22,32,3
Kingfisher,State Senate,Chuck Hall,REP,370204,2,18,170,190,20
Kingfisher,State Senate,Heady Coleman,DEM,370204,0,10,28,38,20
Kingfisher,Governor,Chris Powell,LIB,370301,0,4,34,38,
Kingfisher,Governor,Kevin Stitt,REP,370301,15,99,546,660,
Kingfisher,Governor,Drew Edmondson,DEM,370301,9,31,175,215,
Kingfisher,Lieutenant Governor,Matt Pinnell,REP,370301,16,110,604,730,
Kingfisher,Lieutenant Governor,Anastasia Pittman,DEM,370301,8,23,124,155,
Kingfisher,Lieutenant Governor,Ivan Holmes,IND,370301,0,0,23,23,
Kingfisher,State Auditor,John Yeutter,LIB,370301,2,17,112,131,
Kingfisher,State Auditor,Cindy Byrd,REP,370301,21,108,625,754,
Kingfisher,Attorney General,Mike Hunter,REP,370301,15,106,601,722,
Kingfisher,Attorney General,Mark Myles,DEM,370301,9,24,143,176,
Kingfisher,State Treasurer,Randy Mcdaniel,REP,370301,17,109,625,751,
Kingfisher,State Treasurer,Charles De Coune,IND,370301,3,17,109,129,
Kingfisher,Superintendent of Public Instruction,Joy Hofmeister,REP,370301,19,102,569,690,
Kingfisher,Superintendent of Public Instruction,John Cox,DEM,370301,5,20,124,149,
Kingfisher,Superintendent of Public Instruction,Larry Huff,IND,370301,0,9,53,62,
Kingfisher,Commissioner of Labor,Leslie Osborn,REP,370301,19,110,586,715,
Kingfisher,Commissioner of Labor,Fred Dorrell,DEM,370301,5,21,130,156,
Kingfisher,Commissioner of Labor,Brandt Dismukes,IND,370301,0,0,27,27,
Kingfisher,Insurance Commissioner,Glen Mulready,REP,370301,17,108,577,702,
Kingfisher,Insurance Commissioner,Kimberly Fobbs,DEM,370301,7,19,163,189,
Kingfisher,Corporation Commissioner,Bob Anthony,REP,370301,16,94,535,645,
Kingfisher,Corporation Commissioner,Ashley Nicole Mccray,DEM,370301,8,26,167,201,
Kingfisher,Corporation Commissioner,Jackie Short,IND,370301,0,10,44,54,
Kingfisher,U.S. House,Frank Lucas,REP,370301,18,118,623,759,3
Kingfisher,U.S. House,Frankie Robbins,DEM,370301,6,15,128,149,3
Kingfisher,Governor,Chris Powell,LIB,370302,0,0,15,15,
Kingfisher,Governor,Kevin Stitt,REP,370302,5,11,289,305,
Kingfisher,Governor,Drew Edmondson,DEM,370302,2,2,93,97,
Kingfisher,Lieutenant Governor,Matt Pinnell,REP,370302,6,12,322,340,
Kingfisher,Lieutenant Governor,Anastasia Pittman,DEM,370302,1,1,54,56,
Kingfisher,Lieutenant Governor,Ivan Holmes,IND,370302,0,0,18,18,
Kingfisher,State Auditor,John Yeutter,LIB,370302,1,0,46,47,
Kingfisher,State Auditor,Cindy Byrd,REP,370302,6,13,339,358,
Kingfisher,Attorney General,Mike Hunter,REP,370302,5,12,333,350,
Kingfisher,Attorney General,Mark Myles,DEM,370302,2,1,60,63,
Kingfisher,State Treasurer,Randy Mcdaniel,REP,370302,7,11,327,345,
Kingfisher,State Treasurer,Charles De Coune,IND,370302,0,2,56,58,
Kingfisher,Superintendent of Public Instruction,Joy Hofmeister,REP,370302,6,12,289,307,
Kingfisher,Superintendent of Public Instruction,John Cox,DEM,370302,1,0,73,74,
Kingfisher,Superintendent of Public Instruction,Larry Huff,IND,370302,0,1,32,33,
Kingfisher,Commissioner of Labor,Leslie Osborn,REP,370302,7,13,309,329,
Kingfisher,Commissioner of Labor,Fred Dorrell,DEM,370302,0,0,59,59,
Kingfisher,Commissioner of Labor,Brandt Dismukes,IND,370302,0,0,21,21,
Kingfisher,Insurance Commissioner,Glen Mulready,REP,370302,7,13,309,329,
Kingfisher,Insurance Commissioner,Kimberly Fobbs,DEM,370302,0,0,82,82,
Kingfisher,Corporation Commissioner,Bob Anthony,REP,370302,6,12,303,321,
Kingfisher,Corporation Commissioner,Ashley Nicole Mccray,DEM,370302,0,1,67,68,
Kingfisher,Corporation Commissioner,Jackie Short,IND,370302,1,0,22,23,
Kingfisher,U.S. House,Frank Lucas,REP,370302,7,13,335,355,3
Kingfisher,U.S. House,Frankie Robbins,DEM,370302,0,0,60,60,3
Kingfisher,Governor,Chris Powell,LIB,370303,0,0,1,1,
Kingfisher,Governor,Kevin Stitt,REP,370303,4,8,80,92,
Kingfisher,Governor,Drew Edmondson,DEM,370303,0,0,17,17,
Kingfisher,Lieutenant Governor,Matt Pinnell,REP,370303,4,8,88,100,
Kingfisher,Lieutenant Governor,Anastasia Pittman,DEM,370303,0,0,6,6,
Kingfisher,Lieutenant Governor,Ivan Holmes,IND,370303,0,0,4,4,
Kingfisher,State Auditor,John Yeutter,LIB,370303,0,1,6,7,
Kingfisher,State Auditor,Cindy Byrd,REP,370303,4,7,91,102,
Kingfisher,Attorney General,Mike Hunter,REP,370303,4,8,87,99,
Kingfisher,Attorney General,Mark Myles,DEM,370303,0,0,11,11,
Kingfisher,State Treasurer,Randy Mcdaniel,REP,370303,4,8,89,101,
Kingfisher,State Treasurer,Charles De Coune,IND,370303,0,0,7,7,
Kingfisher,Superintendent of Public Instruction,Joy Hofmeister,REP,370303,4,7,80,91,
Kingfisher,Superintendent of Public Instruction,John Cox,DEM,370303,0,0,8,8,
Kingfisher,Superintendent of Public Instruction,Larry Huff,IND,370303,0,1,10,11,
Kingfisher,Commissioner of Labor,Leslie Osborn,REP,370303,4,8,83,95,
Kingfisher,Commissioner of Labor,Fred Dorrell,DEM,370303,0,0,10,10,
Kingfisher,Commissioner of Labor,Brandt Dismukes,IND,370303,0,0,3,3,
Kingfisher,Insurance Commissioner,Glen Mulready,REP,370303,4,8,88,100,
Kingfisher,Insurance Commissioner,Kimberly Fobbs,DEM,370303,0,0,8,8,
Kingfisher,Corporation Commissioner,Bob Anthony,REP,370303,4,4,84,92,
Kingfisher,Corporation Commissioner,Ashley Nicole Mccray,DEM,370303,0,3,11,14,
Kingfisher,Corporation Commissioner,Jackie Short,IND,370303,0,1,2,3,
Kingfisher,U.S. House,Frank Lucas,REP,370303,4,8,91,103,3
Kingfisher,U.S. House,Frankie Robbins,DEM,370303,0,0,7,7,3
Kingfisher,Governor,Chris Powell,LIB,370304,0,0,8,8,
Kingfisher,Governor,Kevin Stitt,REP,370304,2,10,104,116,
Kingfisher,Governor,Drew Edmondson,DEM,370304,1,1,20,22,
Kingfisher,Lieutenant Governor,Matt Pinnell,REP,370304,3,10,114,127,
Kingfisher,Lieutenant Governor,Anastasia Pittman,DEM,370304,0,1,12,13,
Kingfisher,Lieutenant Governor,Ivan Holmes,IND,370304,0,0,5,5,
Kingfisher,State Auditor,John Yeutter,LIB,370304,0,1,18,19,
Kingfisher,State Auditor,Cindy Byrd,REP,370304,3,10,110,123,
Kingfisher,Attorney General,Mike Hunter,REP,370304,3,10,115,128,
Kingfisher,Attorney General,Mark Myles,DEM,370304,0,1,15,16,
Kingfisher,State Treasurer,Randy Mcdaniel,REP,370304,3,10,120,133,
Kingfisher,State Treasurer,Charles De Coune,IND,370304,0,1,8,9,
Kingfisher,Superintendent of Public Instruction,Joy Hofmeister,REP,370304,3,7,98,108,
Kingfisher,Superintendent of Public Instruction,John Cox,DEM,370304,0,3,22,25,
Kingfisher,Superintendent of Public Instruction,Larry Huff,IND,370304,0,1,9,10,
Kingfisher,Commissioner of Labor,Leslie Osborn,REP,370304,2,9,109,120,
Kingfisher,Commissioner of Labor,Fred Dorrell,DEM,370304,0,1,16,17,
Kingfisher,Commissioner of Labor,Brandt Dismukes,IND,370304,1,1,4,6,
Kingfisher,Insurance Commissioner,Glen Mulready,REP,370304,2,9,109,120,
Kingfisher,Insurance Commissioner,Kimberly Fobbs,DEM,370304,1,2,19,22,
Kingfisher,Corporation Commissioner,Bob Anthony,REP,370304,3,9,97,109,
Kingfisher,Corporation Commissioner,Ashley Nicole Mccray,DEM,370304,0,1,28,29,
Kingfisher,Corporation Commissioner,Jackie Short,IND,370304,0,1,5,6,
Kingfisher,U.S. House,Frank Lucas,REP,370304,3,11,122,136,3
Kingfisher,U.S. House,Frankie Robbins,DEM,370304,0,0,10,10,3
Kingfisher,State Senate,Chuck Hall,REP,370304,3,10,113,126,20
Kingfisher,State Senate,Heady Coleman,DEM,370304,0,1,15,16,20
Kingfisher,Governor,Chris Powell,LIB,370305,1,2,3,6,
Kingfisher,Governor,Kevin Stitt,REP,370305,3,16,113,132,
Kingfisher,Governor,Drew Edmondson,DEM,370305,0,4,17,21,
Kingfisher,Lieutenant Governor,Matt Pinnell,REP,370305,3,20,117,140,
Kingfisher,Lieutenant Governor,Anastasia Pittman,DEM,370305,0,2,15,17,
Kingfisher,Lieutenant Governor,Ivan Holmes,IND,370305,1,0,1,2,
Kingfisher,State Auditor,John Yeutter,LIB,370305,1,2,12,15,
Kingfisher,State Auditor,Cindy Byrd,REP,370305,3,20,120,143,
Kingfisher,Attorney General,Mike Hunter,REP,370305,3,16,119,138,
Kingfisher,Attorney General,Mark Myles,DEM,370305,1,6,13,20,
Kingfisher,State Treasurer,Randy Mcdaniel,REP,370305,3,21,124,148,
Kingfisher,State Treasurer,Charles De Coune,IND,370305,1,1,8,10,
Kingfisher,Superintendent of Public Instruction,Joy Hofmeister,REP,370305,3,15,111,129,
Kingfisher,Superintendent of Public Instruction,John Cox,DEM,370305,1,4,16,21,
Kingfisher,Superintendent of Public Instruction,Larry Huff,IND,370305,0,3,6,9,
Kingfisher,Commissioner of Labor,Leslie Osborn,REP,370305,2,19,111,132,
Kingfisher,Commissioner of Labor,Fred Dorrell,DEM,370305,1,2,16,19,
Kingfisher,Commissioner of Labor,Brandt Dismukes,IND,370305,1,1,4,6,
Kingfisher,Insurance Commissioner,Glen Mulready,REP,370305,2,20,118,140,
Kingfisher,Insurance Commissioner,Kimberly Fobbs,DEM,370305,2,2,15,19,
Kingfisher,Corporation Commissioner,Bob Anthony,REP,370305,2,19,110,131,
Kingfisher,Corporation Commissioner,Ashley Nicole Mccray,DEM,370305,1,3,15,19,
Kingfisher,Corporation Commissioner,Jackie Short,IND,370305,1,0,7,8,
Kingfisher,U.S. House,Frank Lucas,REP,370305,4,21,126,151,3
Kingfisher,U.S. House,Frankie Robbins,DEM,370305,0,1,7,8,3
Kingfisher,State Senate,Chuck Hall,REP,370305,4,20,121,145,20
Kingfisher,State Senate,Heady Coleman,DEM,370305,0,2,11,13,20
Kingfisher,Governor,Chris Powell,LIB,370306,0,0,0,0,
Kingfisher,Governor,Kevin Stitt,REP,370306,0,0,18,18,
Kingfisher,Governor,Drew Edmondson,DEM,370306,0,0,3,3,
Kingfisher,Lieutenant Governor,Matt Pinnell,REP,370306,0,0,18,18,
Kingfisher,Lieutenant Governor,Anastasia Pittman,DEM,370306,0,0,3,3,
Kingfisher,Lieutenant Governor,Ivan Holmes,IND,370306,0,0,0,0,
Kingfisher,State Auditor,John Yeutter,LIB,370306,0,0,2,2,
Kingfisher,State Auditor,Cindy Byrd,REP,370306,0,0,19,19,
Kingfisher,Attorney General,Mike Hunter,REP,370306,0,0,19,19,
Kingfisher,Attorney General,Mark Myles,DEM,370306,0,0,2,2,
Kingfisher,State Treasurer,Randy Mcdaniel,REP,370306,0,0,19,19,
Kingfisher,State Treasurer,Charles De Coune,IND,370306,0,0,2,2,
Kingfisher,Superintendent of Public Instruction,Joy Hofmeister,REP,370306,0,0,16,16,
Kingfisher,Superintendent of Public Instruction,John Cox,DEM,370306,0,0,3,3,
Kingfisher,Superintendent of Public Instruction,Larry Huff,IND,370306,0,0,2,2,
Kingfisher,Commissioner of Labor,Leslie Osborn,REP,370306,0,0,15,15,
Kingfisher,Commissioner of Labor,Fred Dorrell,DEM,370306,0,0,4,4,
Kingfisher,Commissioner of Labor,Brandt Dismukes,IND,370306,0,0,2,2,
Kingfisher,Insurance Commissioner,Glen Mulready,REP,370306,0,0,18,18,
Kingfisher,Insurance Commissioner,Kimberly Fobbs,DEM,370306,0,0,3,3,
Kingfisher,Corporation Commissioner,Bob Anthony,REP,370306,0,0,19,19,
Kingfisher,Corporation Commissioner,Ashley Nicole Mccray,DEM,370306,0,0,1,1,
Kingfisher,Corporation Commissioner,Jackie Short,IND,370306,0,0,1,1,
Kingfisher,U.S. House,Frank Lucas,REP,370306,0,0,19,19,3
Kingfisher,U.S. House,Frankie Robbins,DEM,370306,0,0,2,2,3
Kingfisher,State Senate,Chuck Hall,REP,370306,0,0,20,20,20
Kingfisher,State Senate,Heady Coleman,DEM,370306,0,0,1,1,20
Kiowa,Governor,Chris Powell,LIB,380001,2,3,19,24,
Kiowa,Governor,Kevin Stitt,REP,380001,12,72,264,348,
Kiowa,Governor,Drew Edmondson,DEM,380001,6,30,134,170,
Kiowa,Lieutenant Governor,Matt Pinnell,REP,380001,11,79,302,392,
Kiowa,Lieutenant Governor,Anastasia Pittman,DEM,380001,10,24,95,129,
Kiowa,Lieutenant Governor,Ivan Holmes,IND,380001,0,2,16,18,
Kiowa,State Auditor,John Yeutter,LIB,380001,3,15,53,71,
Kiowa,State Auditor,Cindy Byrd,REP,380001,18,84,340,442,
Kiowa,Attorney General,Mike Hunter,REP,380001,16,83,324,423,
Kiowa,Attorney General,Mark Myles,DEM,380001,5,21,89,115,
Kiowa,State Treasurer,Randy Mcdaniel,REP,380001,19,85,331,435,
Kiowa,State Treasurer,Charles De Coune,IND,380001,2,14,61,77,
Kiowa,Superintendent of Public Instruction,Joy Hofmeister,REP,380001,13,75,300,388,
Kiowa,Superintendent of Public Instruction,John Cox,DEM,380001,6,22,79,107,
Kiowa,Superintendent of Public Instruction,Larry Huff,IND,380001,2,8,37,47,
Kiowa,Commissioner of Labor,Leslie Osborn,REP,380001,15,79,300,394,
Kiowa,Commissioner of Labor,Fred Dorrell,DEM,380001,6,23,94,123,
Kiowa,Commissioner of Labor,Brandt Dismukes,IND,380001,0,3,12,15,
Kiowa,Insurance Commissioner,Glen Mulready,REP,380001,13,80,299,392,
Kiowa,Insurance Commissioner,Kimberly Fobbs,DEM,380001,8,23,110,141,
Kiowa,Corporation Commissioner,Bob Anthony,REP,380001,15,73,288,376,
Kiowa,Corporation Commissioner,Ashley Nicole Mccray,DEM,380001,6,23,104,133,
Kiowa,Corporation Commissioner,Jackie Short,IND,380001,0,9,19,28,
Kiowa,U.S. House,Frank Lucas,REP,380001,15,87,336,438,3
Kiowa,U.S. House,Frankie Robbins,DEM,380001,6,17,80,103,3
Kiowa,State Senate,Brent Howard,REP,380001,11,71,267,349,38
Kiowa,State Senate,Jeff Berrong,DEM,380001,10,33,146,189,38
Kiowa,State House,Todd Russ,REP,380001,11,63,230,304,55
Kiowa,State House,Dennis Dugger,DEM,380001,10,41,186,237,55
Kiowa,Governor,Chris Powell,LIB,380002,0,1,4,5,
Kiowa,Governor,Kevin Stitt,REP,380002,2,12,66,80,
Kiowa,Governor,Drew Edmondson,DEM,380002,1,11,28,40,
Kiowa,Lieutenant Governor,Matt Pinnell,REP,380002,1,17,74,92,
Kiowa,Lieutenant Governor,Anastasia Pittman,DEM,380002,2,7,21,30,
Kiowa,Lieutenant Governor,Ivan Holmes,IND,380002,0,0,3,3,
Kiowa,State Auditor,John Yeutter,LIB,380002,1,4,20,25,
Kiowa,State Auditor,Cindy Byrd,REP,380002,1,19,76,96,
Kiowa,Attorney General,Mike Hunter,REP,380002,1,18,78,97,
Kiowa,Attorney General,Mark Myles,DEM,380002,2,6,20,28,
Kiowa,State Treasurer,Randy Mcdaniel,REP,380002,1,18,76,95,
Kiowa,State Treasurer,Charles De Coune,IND,380002,1,5,21,27,
Kiowa,Superintendent of Public Instruction,Joy Hofmeister,REP,380002,1,17,68,86,
Kiowa,Superintendent of Public Instruction,John Cox,DEM,380002,2,6,18,26,
Kiowa,Superintendent of Public Instruction,Larry Huff,IND,380002,0,0,12,12,
Kiowa,Commissioner of Labor,Leslie Osborn,REP,380002,1,19,74,94,
Kiowa,Commissioner of Labor,Fred Dorrell,DEM,380002,2,4,20,26,
Kiowa,Commissioner of Labor,Brandt Dismukes,IND,380002,0,0,3,3,
Kiowa,Insurance Commissioner,Glen Mulready,REP,380002,1,18,71,90,
Kiowa,Insurance Commissioner,Kimberly Fobbs,DEM,380002,2,5,27,34,
Kiowa,Corporation Commissioner,Bob Anthony,REP,380002,1,16,67,84,
Kiowa,Corporation Commissioner,Ashley Nicole Mccray,DEM,380002,2,8,21,31,
Kiowa,Corporation Commissioner,Jackie Short,IND,380002,0,0,10,10,
Kiowa,U.S. House,Frank Lucas,REP,380002,1,19,82,102,3
Kiowa,U.S. House,Frankie Robbins,DEM,380002,2,5,16,23,3
Kiowa,State Senate,Brent Howard,REP,380002,1,17,72,90,38
Kiowa,State Senate,Jeff Berrong,DEM,380002,2,7,26,35,38
Kiowa,State House,Todd Russ,REP,380002,1,12,50,63,55
Kiowa,State House,Dennis Dugger,DEM,380002,2,12,48,62,55
Kiowa,Governor,Chris Powell,LIB,380004,0,1,11,12,
Kiowa,Governor,Kevin Stitt,REP,380004,7,54,179,240,
Kiowa,Governor,Drew Edmondson,DEM,380004,3,36,106,145,
Kiowa,Lieutenant Governor,Matt Pinnell,REP,380004,6,54,209,269,
Kiowa,Lieutenant Governor,Anastasia Pittman,DEM,380004,3,32,80,115,
Kiowa,Lieutenant Governor,Ivan Holmes,IND,380004,0,3,7,10,
Kiowa,State Auditor,John Yeutter,LIB,380004,2,17,59,78,
Kiowa,State Auditor,Cindy Byrd,REP,380004,6,66,224,296,
Kiowa,Attorney General,Mike Hunter,REP,380004,5,60,215,280,
Kiowa,Attorney General,Mark Myles,DEM,380004,4,30,79,113,
Kiowa,State Treasurer,Randy Mcdaniel,REP,380004,6,68,225,299,
Kiowa,State Treasurer,Charles De Coune,IND,380004,2,16,55,73,
Kiowa,Superintendent of Public Instruction,Joy Hofmeister,REP,380004,6,63,192,261,
Kiowa,Superintendent of Public Instruction,John Cox,DEM,380004,3,19,72,94,
Kiowa,Superintendent of Public Instruction,Larry Huff,IND,380004,1,9,32,42,
Kiowa,Commissioner of Labor,Leslie Osborn,REP,380004,6,61,210,277,
Kiowa,Commissioner of Labor,Fred Dorrell,DEM,380004,3,26,71,100,
Kiowa,Commissioner of Labor,Brandt Dismukes,IND,380004,0,2,12,14,
Kiowa,Insurance Commissioner,Glen Mulready,REP,380004,4,55,202,261,
Kiowa,Insurance Commissioner,Kimberly Fobbs,DEM,380004,4,34,90,128,
Kiowa,Corporation Commissioner,Bob Anthony,REP,380004,6,61,212,279,
Kiowa,Corporation Commissioner,Ashley Nicole Mccray,DEM,380004,4,28,69,101,
Kiowa,Corporation Commissioner,Jackie Short,IND,380004,0,2,12,14,
Kiowa,U.S. House,Frank Lucas,REP,380004,8,66,231,305,3
Kiowa,U.S. House,Frankie Robbins,DEM,380004,3,24,65,92,3
Kiowa,State Senate,Brent Howard,REP,380004,6,48,174,228,38
Kiowa,State Senate,Jeff Berrong,DEM,380004,4,43,122,169,38
Kiowa,State House,Todd Russ,REP,380004,8,48,148,204,55
Kiowa,State House,Dennis Dugger,DEM,380004,3,43,148,194,55
Kiowa,Governor,Chris Powell,LIB,380005,0,0,1,1,
Kiowa,Governor,Kevin Stitt,REP,380005,0,1,16,17,
Kiowa,Governor,Drew Edmondson,DEM,380005,1,4,15,20,
Kiowa,Lieutenant Governor,Matt Pinnell,REP,380005,0,1,16,17,
Kiowa,Lieutenant Governor,Anastasia Pittman,DEM,380005,1,4,15,20,
Kiowa,Lieutenant Governor,Ivan Holmes,IND,380005,0,0,1,1,
Kiowa,State Auditor,John Yeutter,LIB,380005,1,1,8,10,
Kiowa,State Auditor,Cindy Byrd,REP,380005,0,1,21,22,
Kiowa,Attorney General,Mike Hunter,REP,380005,0,1,17,18,
Kiowa,Attorney General,Mark Myles,DEM,380005,1,4,15,20,
Kiowa,State Treasurer,Randy Mcdaniel,REP,380005,0,1,18,19,
Kiowa,State Treasurer,Charles De Coune,IND,380005,1,3,11,15,
Kiowa,Superintendent of Public Instruction,Joy Hofmeister,REP,380005,1,1,17,19,
Kiowa,Superintendent of Public Instruction,John Cox,DEM,380005,0,4,12,16,
Kiowa,Superintendent of Public Instruction,Larry Huff,IND,380005,0,0,3,3,
Kiowa,Commissioner of Labor,Leslie Osborn,REP,380005,0,1,15,16,
Kiowa,Commissioner of Labor,Fred Dorrell,DEM,380005,0,4,15,19,
Kiowa,Commissioner of Labor,Brandt Dismukes,IND,380005,1,0,2,3,
Kiowa,Insurance Commissioner,Glen Mulready,REP,380005,0,1,16,17,
Kiowa,Insurance Commissioner,Kimberly Fobbs,DEM,380005,1,4,16,21,
Kiowa,Corporation Commissioner,Bob Anthony,REP,380005,0,1,16,17,
Kiowa,Corporation Commissioner,Ashley Nicole Mccray,DEM,380005,1,4,13,18,
Kiowa,Corporation Commissioner,Jackie Short,IND,380005,0,0,2,2,
Kiowa,U.S. House,Frank Lucas,REP,380005,0,1,18,19,3
Kiowa,U.S. House,Frankie Robbins,DEM,380005,1,4,14,19,3
Kiowa,State Senate,Brent Howard,REP,380005,0,0,16,16,38
Kiowa,State Senate,Jeff Berrong,DEM,380005,1,5,16,22,38
Kiowa,State House,Todd Russ,REP,380005,0,0,13,13,55
Kiowa,State House,Dennis Dugger,DEM,380005,1,5,19,25,55
Kiowa,Governor,Chris Powell,LIB,380006,0,0,5,5,
Kiowa,Governor,Kevin Stitt,REP,380006,3,9,78,90,
Kiowa,Governor,Drew Edmondson,DEM,380006,2,5,44,51,
Kiowa,Lieutenant Governor,Matt Pinnell,REP,380006,3,8,83,94,
Kiowa,Lieutenant Governor,Anastasia Pittman,DEM,380006,2,5,41,48,
Kiowa,Lieutenant Governor,Ivan Holmes,IND,380006,0,0,2,2,
Kiowa,State Auditor,John Yeutter,LIB,380006,0,2,20,22,
Kiowa,State Auditor,Cindy Byrd,REP,380006,5,11,95,111,
Kiowa,Attorney General,Mike Hunter,REP,380006,5,9,93,107,
Kiowa,Attorney General,Mark Myles,DEM,380006,0,4,34,38,
Kiowa,State Treasurer,Randy Mcdaniel,REP,380006,4,10,93,107,
Kiowa,State Treasurer,Charles De Coune,IND,380006,1,3,22,26,
Kiowa,Superintendent of Public Instruction,Joy Hofmeister,REP,380006,2,10,79,91,
Kiowa,Superintendent of Public Instruction,John Cox,DEM,380006,2,4,34,40,
Kiowa,Superintendent of Public Instruction,Larry Huff,IND,380006,1,0,12,13,
Kiowa,Commissioner of Labor,Leslie Osborn,REP,380006,2,9,82,93,
Kiowa,Commissioner of Labor,Fred Dorrell,DEM,380006,2,4,42,48,
Kiowa,Commissioner of Labor,Brandt Dismukes,IND,380006,1,0,2,3,
Kiowa,Insurance Commissioner,Glen Mulready,REP,380006,3,8,84,95,
Kiowa,Insurance Commissioner,Kimberly Fobbs,DEM,380006,2,5,40,47,
Kiowa,Corporation Commissioner,Bob Anthony,REP,380006,2,9,81,92,
Kiowa,Corporation Commissioner,Ashley Nicole Mccray,DEM,380006,2,3,37,42,
Kiowa,Corporation Commissioner,Jackie Short,IND,380006,1,1,5,7,
Kiowa,U.S. House,Frank Lucas,REP,380006,3,10,95,108,3
Kiowa,U.S. House,Frankie Robbins,DEM,380006,2,4,33,39,3
Kiowa,State Senate,Brent Howard,REP,380006,3,9,74,86,38
Kiowa,State Senate,Jeff Berrong,DEM,380006,2,5,53,60,38
Kiowa,State House,Charles Wells,REP,380006,2,8,48,58,56
Kiowa,State House,David Perryman,DEM,380006,3,6,80,89,56
Kiowa,Governor,Chris Powell,LIB,380007,0,0,0,0,
Kiowa,Governor,Kevin Stitt,REP,380007,0,0,8,8,
Kiowa,Governor,Drew Edmondson,DEM,380007,0,0,1,1,
Kiowa,Lieutenant Governor,Matt Pinnell,REP,380007,0,0,9,9,
Kiowa,Lieutenant Governor,Anastasia Pittman,DEM,380007,0,0,0,0,
Kiowa,Lieutenant Governor,Ivan Holmes,IND,380007,0,0,0,0,
Kiowa,State Auditor,John Yeutter,LIB,380007,0,0,0,0,
Kiowa,State Auditor,Cindy Byrd,REP,380007,0,0,9,9,
Kiowa,Attorney General,Mike Hunter,REP,380007,0,0,8,8,
Kiowa,Attorney General,Mark Myles,DEM,380007,0,0,1,1,
Kiowa,State Treasurer,Randy Mcdaniel,REP,380007,0,0,9,9,
Kiowa,State Treasurer,Charles De Coune,IND,380007,0,0,0,0,
Kiowa,Superintendent of Public Instruction,Joy Hofmeister,REP,380007,0,0,8,8,
Kiowa,Superintendent of Public Instruction,John Cox,DEM,380007,0,0,1,1,
Kiowa,Superintendent of Public Instruction,Larry Huff,IND,380007,0,0,0,0,
Kiowa,Commissioner of Labor,Leslie Osborn,REP,380007,0,0,9,9,
Kiowa,Commissioner of Labor,Fred Dorrell,DEM,380007,0,0,0,0,
Kiowa,Commissioner of Labor,Brandt Dismukes,IND,380007,0,0,0,0,
Kiowa,Insurance Commissioner,Glen Mulready,REP,380007,0,0,8,8,
Kiowa,Insurance Commissioner,Kimberly Fobbs,DEM,380007,0,0,1,1,
Kiowa,Corporation Commissioner,Bob Anthony,REP,380007,0,0,8,8,
Kiowa,Corporation Commissioner,Ashley Nicole Mccray,DEM,380007,0,0,0,0,
Kiowa,Corporation Commissioner,Jackie Short,IND,380007,0,0,1,1,
Kiowa,U.S. House,Frank Lucas,REP,380007,0,0,9,9,3
Kiowa,U.S. House,Frankie Robbins,DEM,380007,0,0,0,0,3
Kiowa,State Senate,Brent Howard,REP,380007,0,0,8,8,38
Kiowa,State Senate,Jeff Berrong,DEM,380007,0,0,1,1,38
Kiowa,State House,Charles Wells,REP,380007,0,0,7,7,56
Kiowa,State House,David Perryman,DEM,380007,0,0,2,2,56
Kiowa,Governor,Chris Powell,LIB,380008,0,0,5,5,
Kiowa,Governor,Kevin Stitt,REP,380008,3,9,110,122,
Kiowa,Governor,Drew Edmondson,DEM,380008,4,2,50,56,
Kiowa,Lieutenant Governor,Matt Pinnell,REP,380008,2,9,121,132,
Kiowa,Lieutenant Governor,Anastasia Pittman,DEM,380008,4,2,38,44,
Kiowa,Lieutenant Governor,Ivan Holmes,IND,380008,1,0,5,6,
Kiowa,State Auditor,John Yeutter,LIB,380008,5,2,19,26,
Kiowa,State Auditor,Cindy Byrd,REP,380008,2,8,135,145,
Kiowa,Attorney General,Mike Hunter,REP,380008,3,9,130,142,
Kiowa,Attorney General,Mark Myles,DEM,380008,4,2,35,41,
Kiowa,State Treasurer,Randy Mcdaniel,REP,380008,3,8,135,146,
Kiowa,State Treasurer,Charles De Coune,IND,380008,4,3,17,24,
Kiowa,Superintendent of Public Instruction,Joy Hofmeister,REP,380008,1,6,117,124,
Kiowa,Superintendent of Public Instruction,John Cox,DEM,380008,5,2,31,38,
Kiowa,Superintendent of Public Instruction,Larry Huff,IND,380008,1,3,16,20,
Kiowa,Commissioner of Labor,Leslie Osborn,REP,380008,3,9,123,135,
Kiowa,Commissioner of Labor,Fred Dorrell,DEM,380008,4,2,39,45,
Kiowa,Commissioner of Labor,Brandt Dismukes,IND,380008,0,0,3,3,
Kiowa,Insurance Commissioner,Glen Mulready,REP,380008,2,9,114,125,
Kiowa,Insurance Commissioner,Kimberly Fobbs,DEM,380008,5,2,50,57,
Kiowa,Corporation Commissioner,Bob Anthony,REP,380008,2,9,117,128,
Kiowa,Corporation Commissioner,Ashley Nicole Mccray,DEM,380008,4,2,40,46,
Kiowa,Corporation Commissioner,Jackie Short,IND,380008,1,0,7,8,
Kiowa,U.S. House,Frank Lucas,REP,380008,3,9,133,145,3
Kiowa,U.S. House,Frankie Robbins,DEM,380008,4,2,32,38,3
Kiowa,State Senate,Brent Howard,REP,380008,2,7,106,115,38
Kiowa,State Senate,Jeff Berrong,DEM,380008,5,4,57,66,38
Kiowa,State House,Todd Russ,REP,380008,3,6,86,95,55
Kiowa,State House,Dennis Dugger,DEM,380008,4,5,78,87,55
Kiowa,Governor,Chris Powell,LIB,380009,0,0,0,0,
Kiowa,Governor,Kevin Stitt,REP,380009,0,1,16,17,
Kiowa,Governor,Drew Edmondson,DEM,380009,1,1,3,5,
Kiowa,Lieutenant Governor,Matt Pinnell,REP,380009,0,1,17,18,
Kiowa,Lieutenant Governor,Anastasia Pittman,DEM,380009,1,1,2,4,
Kiowa,Lieutenant Governor,Ivan Holmes,IND,380009,0,0,0,0,
Kiowa,State Auditor,John Yeutter,LIB,380009,0,1,1,2,
Kiowa,State Auditor,Cindy Byrd,REP,380009,0,1,18,19,
Kiowa,Attorney General,Mike Hunter,REP,380009,0,1,17,18,
Kiowa,Attorney General,Mark Myles,DEM,380009,1,1,2,4,
Kiowa,State Treasurer,Randy Mcdaniel,REP,380009,0,1,17,18,
Kiowa,State Treasurer,Charles De Coune,IND,380009,0,1,2,3,
Kiowa,Superintendent of Public Instruction,Joy Hofmeister,REP,380009,0,1,16,17,
Kiowa,Superintendent of Public Instruction,John Cox,DEM,380009,1,1,3,5,
Kiowa,Superintendent of Public Instruction,Larry Huff,IND,380009,0,0,0,0,
Kiowa,Commissioner of Labor,Leslie Osborn,REP,380009,0,1,18,19,
Kiowa,Commissioner of Labor,Fred Dorrell,DEM,380009,1,1,1,3,
Kiowa,Commissioner of Labor,Brandt Dismukes,IND,380009,0,0,0,0,
Kiowa,Insurance Commissioner,Glen Mulready,REP,380009,0,1,16,17,
Kiowa,Insurance Commissioner,Kimberly Fobbs,DEM,380009,1,1,3,5,
Kiowa,Corporation Commissioner,Bob Anthony,REP,380009,0,1,16,17,
Kiowa,Corporation Commissioner,Ashley Nicole Mccray,DEM,380009,1,1,3,5,
Kiowa,Corporation Commissioner,Jackie Short,IND,380009,0,0,0,0,
Kiowa,U.S. House,Frank Lucas,REP,380009,0,2,18,20,3
Kiowa,U.S. House,Frankie Robbins,DEM,380009,1,0,1,2,3
Kiowa,State Senate,Brent Howard,REP,380009,0,1,16,17,38
Kiowa,State Senate,Jeff Berrong,DEM,380009,1,1,3,5,38
Kiowa,State House,Charles Wells,REP,380009,0,0,12,12,56
Kiowa,State House,David Perryman,DEM,380009,1,2,7,10,56
Kiowa,Governor,Chris Powell,LIB,380010,0,0,8,8,
Kiowa,Governor,Kevin Stitt,REP,380010,8,3,205,216,
Kiowa,Governor,Drew Edmondson,DEM,380010,7,7,131,145,
Kiowa,Lieutenant Governor,Matt Pinnell,REP,380010,9,2,225,236,
Kiowa,Lieutenant Governor,Anastasia Pittman,DEM,380010,4,8,104,116,
Kiowa,Lieutenant Governor,Ivan Holmes,IND,380010,0,0,10,10,
Kiowa,State Auditor,John Yeutter,LIB,380010,3,3,49,55,
Kiowa,State Auditor,Cindy Byrd,REP,380010,10,4,259,273,
Kiowa,Attorney General,Mike Hunter,REP,380010,10,2,240,252,
Kiowa,Attorney General,Mark Myles,DEM,380010,3,8,101,112,
Kiowa,State Treasurer,Randy Mcdaniel,REP,380010,10,4,248,262,
Kiowa,State Treasurer,Charles De Coune,IND,380010,4,4,59,67,
Kiowa,Superintendent of Public Instruction,Joy Hofmeister,REP,380010,10,5,210,225,
Kiowa,Superintendent of Public Instruction,John Cox,DEM,380010,4,5,103,112,
Kiowa,Superintendent of Public Instruction,Larry Huff,IND,380010,0,0,30,30,
Kiowa,Commissioner of Labor,Leslie Osborn,REP,380010,9,2,210,221,
Kiowa,Commissioner of Labor,Fred Dorrell,DEM,380010,6,7,108,121,
Kiowa,Commissioner of Labor,Brandt Dismukes,IND,380010,0,1,18,19,
Kiowa,Insurance Commissioner,Glen Mulready,REP,380010,10,2,217,229,
Kiowa,Insurance Commissioner,Kimberly Fobbs,DEM,380010,3,8,122,133,
Kiowa,Corporation Commissioner,Bob Anthony,REP,380010,10,2,222,234,
Kiowa,Corporation Commissioner,Ashley Nicole Mccray,DEM,380010,4,8,101,113,
Kiowa,Corporation Commissioner,Jackie Short,IND,380010,0,0,17,17,
Kiowa,U.S. House,Frank Lucas,REP,380010,9,3,249,261,3
Kiowa,U.S. House,Frankie Robbins,DEM,380010,5,7,94,106,3
Kiowa,State Senate,Brent Howard,REP,380010,7,2,204,213,38
Kiowa,State Senate,Jeff Berrong,DEM,380010,8,8,139,155,38
Kiowa,State House,Charles Wells,REP,380010,8,3,125,136,56
Kiowa,State House,David Perryman,DEM,380010,6,7,218,231,56
Kiowa,Governor,Chris Powell,LIB,380011,0,0,8,8,
Kiowa,Governor,Kevin Stitt,REP,380011,6,5,65,76,
Kiowa,Governor,Drew Edmondson,DEM,380011,0,2,15,17,
Kiowa,Lieutenant Governor,Matt Pinnell,REP,380011,5,5,77,87,
Kiowa,Lieutenant Governor,Anastasia Pittman,DEM,380011,1,2,9,12,
Kiowa,Lieutenant Governor,Ivan Holmes,IND,380011,0,0,2,2,
Kiowa,State Auditor,John Yeutter,LIB,380011,1,1,9,11,
Kiowa,State Auditor,Cindy Byrd,REP,380011,5,5,79,89,
Kiowa,Attorney General,Mike Hunter,REP,380011,5,5,76,86,
Kiowa,Attorney General,Mark Myles,DEM,380011,1,2,12,15,
Kiowa,State Treasurer,Randy Mcdaniel,REP,380011,6,5,72,83,
Kiowa,State Treasurer,Charles De Coune,IND,380011,0,1,14,15,
Kiowa,Superintendent of Public Instruction,Joy Hofmeister,REP,380011,5,5,73,83,
Kiowa,Superintendent of Public Instruction,John Cox,DEM,380011,1,2,6,9,
Kiowa,Superintendent of Public Instruction,Larry Huff,IND,380011,0,0,9,9,
Kiowa,Commissioner of Labor,Leslie Osborn,REP,380011,6,4,73,83,
Kiowa,Commissioner of Labor,Fred Dorrell,DEM,380011,0,3,12,15,
Kiowa,Commissioner of Labor,Brandt Dismukes,IND,380011,0,0,3,3,
Kiowa,Insurance Commissioner,Glen Mulready,REP,380011,6,4,74,84,
Kiowa,Insurance Commissioner,Kimberly Fobbs,DEM,380011,0,3,13,16,
Kiowa,Corporation Commissioner,Bob Anthony,REP,380011,5,5,72,82,
Kiowa,Corporation Commissioner,Ashley Nicole Mccray,DEM,380011,1,2,14,17,
Kiowa,Corporation Commissioner,Jackie Short,IND,380011,0,0,2,2,
Kiowa,U.S. House,Frank Lucas,REP,380011,6,5,78,89,3
Kiowa,U.S. House,Frankie Robbins,DEM,380011,0,2,10,12,3
Kiowa,State Senate,Brent Howard,REP,380011,6,3,66,75,38
Kiowa,State Senate,Jeff Berrong,DEM,380011,0,4,21,25,38
Kiowa,Governor,Chris Powell,LIB,380014,1,0,13,14,
Kiowa,Governor,Kevin Stitt,REP,380014,7,0,218,225,
Kiowa,Governor,Drew Edmondson,DEM,380014,6,2,193,201,
Kiowa,Lieutenant Governor,Matt Pinnell,REP,380014,6,1,260,267,
Kiowa,Lieutenant Governor,Anastasia Pittman,DEM,380014,8,1,150,159,
Kiowa,Lieutenant Governor,Ivan Holmes,IND,380014,0,0,12,12,
Kiowa,State Auditor,John Yeutter,LIB,380014,3,1,93,97,
Kiowa,State Auditor,Cindy Byrd,REP,380014,10,1,304,315,
Kiowa,Attorney General,Mike Hunter,REP,380014,8,1,258,267,
Kiowa,Attorney General,Mark Myles,DEM,380014,6,1,165,172,
Kiowa,State Treasurer,Randy Mcdaniel,REP,380014,9,1,307,317,
Kiowa,State Treasurer,Charles De Coune,IND,380014,4,1,89,94,
Kiowa,Superintendent of Public Instruction,Joy Hofmeister,REP,380014,9,1,247,257,
Kiowa,Superintendent of Public Instruction,John Cox,DEM,380014,4,1,139,144,
Kiowa,Superintendent of Public Instruction,Larry Huff,IND,380014,1,0,36,37,
Kiowa,Commissioner of Labor,Leslie Osborn,REP,380014,8,1,252,261,
Kiowa,Commissioner of Labor,Fred Dorrell,DEM,380014,6,1,154,161,
Kiowa,Commissioner of Labor,Brandt Dismukes,IND,380014,0,0,12,12,
Kiowa,Insurance Commissioner,Glen Mulready,REP,380014,6,0,257,263,
Kiowa,Insurance Commissioner,Kimberly Fobbs,DEM,380014,8,2,163,173,
Kiowa,Corporation Commissioner,Bob Anthony,REP,380014,8,1,264,273,
Kiowa,Corporation Commissioner,Ashley Nicole Mccray,DEM,380014,4,1,143,148,
Kiowa,Corporation Commissioner,Jackie Short,IND,380014,2,0,14,16,
Kiowa,U.S. House,Frank Lucas,REP,380014,9,1,292,302,3
Kiowa,U.S. House,Frankie Robbins,DEM,380014,4,1,132,137,3
Kiowa,State Senate,Brent Howard,REP,380014,8,0,255,263,38
Kiowa,State Senate,Jeff Berrong,DEM,380014,5,2,167,174,38
Kiowa,Governor,Chris Powell,LIB,380015,0,0,5,5,
Kiowa,Governor,Kevin Stitt,REP,380015,0,5,61,66,
Kiowa,Governor,Drew Edmondson,DEM,380015,3,8,35,46,
Kiowa,Lieutenant Governor,Matt Pinnell,REP,380015,0,8,70,78,
Kiowa,Lieutenant Governor,Anastasia Pittman,DEM,380015,3,4,25,32,
Kiowa,Lieutenant Governor,Ivan Holmes,IND,380015,0,0,6,6,
Kiowa,State Auditor,John Yeutter,LIB,380015,2,3,24,29,
Kiowa,State Auditor,Cindy Byrd,REP,380015,0,9,73,82,
Kiowa,Attorney General,Mike Hunter,REP,380015,0,11,68,79,
Kiowa,Attorney General,Mark Myles,DEM,380015,3,2,31,36,
Kiowa,State Treasurer,Randy Mcdaniel,REP,380015,0,9,75,84,
Kiowa,State Treasurer,Charles De Coune,IND,380015,2,4,23,29,
Kiowa,Superintendent of Public Instruction,Joy Hofmeister,REP,380015,0,9,62,71,
Kiowa,Superintendent of Public Instruction,John Cox,DEM,380015,3,4,29,36,
Kiowa,Superintendent of Public Instruction,Larry Huff,IND,380015,0,0,9,9,
Kiowa,Commissioner of Labor,Leslie Osborn,REP,380015,0,7,68,75,
Kiowa,Commissioner of Labor,Fred Dorrell,DEM,380015,3,4,29,36,
Kiowa,Commissioner of Labor,Brandt Dismukes,IND,380015,0,1,3,4,
Kiowa,Insurance Commissioner,Glen Mulready,REP,380015,0,8,71,79,
Kiowa,Insurance Commissioner,Kimberly Fobbs,DEM,380015,3,4,29,36,
Kiowa,Corporation Commissioner,Bob Anthony,REP,380015,0,9,70,79,
Kiowa,Corporation Commissioner,Ashley Nicole Mccray,DEM,380015,3,3,28,34,
Kiowa,Corporation Commissioner,Jackie Short,IND,380015,0,0,3,3,
Kiowa,U.S. House,Frank Lucas,REP,380015,0,11,79,90,3
Kiowa,U.S. House,Frankie Robbins,DEM,380015,3,2,22,27,3
Kiowa,State Senate,Brent Howard,REP,380015,0,9,71,80,38
Kiowa,State Senate,Jeff Berrong,DEM,380015,3,3,30,36,38
Kiowa,State House,Charles Wells,REP,380015,0,3,50,53,56
Kiowa,State House,David Perryman,DEM,380015,3,9,50,62,56
Kiowa,Governor,Chris Powell,LIB,380016,0,1,4,5,
Kiowa,Governor,Kevin Stitt,REP,380016,2,8,37,47,
Kiowa,Governor,Drew Edmondson,DEM,380016,0,9,17,26,
Kiowa,Lieutenant Governor,Matt Pinnell,REP,380016,2,7,44,53,
Kiowa,Lieutenant Governor,Anastasia Pittman,DEM,380016,0,10,11,21,
Kiowa,Lieutenant Governor,Ivan Holmes,IND,380016,0,0,1,1,
Kiowa,State Auditor,John Yeutter,LIB,380016,0,7,6,13,
Kiowa,State Auditor,Cindy Byrd,REP,380016,2,7,45,54,
Kiowa,Attorney General,Mike Hunter,REP,380016,2,9,41,52,
Kiowa,Attorney General,Mark Myles,DEM,380016,0,9,15,24,
Kiowa,State Treasurer,Randy Mcdaniel,REP,380016,2,8,47,57,
Kiowa,State Treasurer,Charles De Coune,IND,380016,0,6,3,9,
Kiowa,Superintendent of Public Instruction,Joy Hofmeister,REP,380016,2,11,40,53,
Kiowa,Superintendent of Public Instruction,John Cox,DEM,380016,0,7,15,22,
Kiowa,Superintendent of Public Instruction,Larry Huff,IND,380016,0,0,2,2,
Kiowa,Commissioner of Labor,Leslie Osborn,REP,380016,2,10,40,52,
Kiowa,Commissioner of Labor,Fred Dorrell,DEM,380016,0,6,14,20,
Kiowa,Commissioner of Labor,Brandt Dismukes,IND,380016,0,1,1,2,
Kiowa,Insurance Commissioner,Glen Mulready,REP,380016,2,8,43,53,
Kiowa,Insurance Commissioner,Kimberly Fobbs,DEM,380016,0,10,13,23,
Kiowa,Corporation Commissioner,Bob Anthony,REP,380016,2,8,44,54,
Kiowa,Corporation Commissioner,Ashley Nicole Mccray,DEM,380016,0,9,11,20,
Kiowa,Corporation Commissioner,Jackie Short,IND,380016,0,0,1,1,
Kiowa,U.S. House,Frank Lucas,REP,380016,2,8,48,58,3
Kiowa,U.S. House,Frankie Robbins,DEM,380016,0,10,9,19,3
Kiowa,State Senate,Brent Howard,REP,380016,2,7,37,46,38
Kiowa,State Senate,Jeff Berrong,DEM,380016,0,11,21,32,38
Kiowa,Governor,Chris Powell,LIB,380022,0,0,5,5,
Kiowa,Governor,Kevin Stitt,REP,380022,6,4,83,93,
Kiowa,Governor,Drew Edmondson,DEM,380022,2,4,43,49,
Kiowa,Lieutenant Governor,Matt Pinnell,REP,380022,6,5,89,100,
Kiowa,Lieutenant Governor,Anastasia Pittman,DEM,380022,2,4,36,42,
Kiowa,Lieutenant Governor,Ivan Holmes,IND,380022,0,0,6,6,
Kiowa,State Auditor,John Yeutter,LIB,380022,2,1,24,27,
Kiowa,State Auditor,Cindy Byrd,REP,380022,5,8,96,109,
Kiowa,Attorney General,Mike Hunter,REP,380022,6,5,90,101,
Kiowa,Attorney General,Mark Myles,DEM,380022,2,4,41,47,
Kiowa,State Treasurer,Randy Mcdaniel,REP,380022,5,7,95,107,
Kiowa,State Treasurer,Charles De Coune,IND,380022,2,2,24,28,
Kiowa,Superintendent of Public Instruction,Joy Hofmeister,REP,380022,4,5,78,87,
Kiowa,Superintendent of Public Instruction,John Cox,DEM,380022,2,4,35,41,
Kiowa,Superintendent of Public Instruction,Larry Huff,IND,380022,2,0,17,19,
Kiowa,Commissioner of Labor,Leslie Osborn,REP,380022,4,5,86,95,
Kiowa,Commissioner of Labor,Fred Dorrell,DEM,380022,3,4,32,39,
Kiowa,Commissioner of Labor,Brandt Dismukes,IND,380022,1,0,11,12,
Kiowa,Insurance Commissioner,Glen Mulready,REP,380022,6,6,85,97,
Kiowa,Insurance Commissioner,Kimberly Fobbs,DEM,380022,2,3,45,50,
Kiowa,Corporation Commissioner,Bob Anthony,REP,380022,4,6,90,100,
Kiowa,Corporation Commissioner,Ashley Nicole Mccray,DEM,380022,2,3,31,36,
Kiowa,Corporation Commissioner,Jackie Short,IND,380022,2,0,10,12,
Kiowa,U.S. House,Frank Lucas,REP,380022,7,6,96,109,3
Kiowa,U.S. House,Frankie Robbins,DEM,380022,1,3,35,39,3
Kiowa,State Senate,Brent Howard,REP,380022,5,6,84,95,38
Kiowa,State Senate,Jeff Berrong,DEM,380022,2,3,47,52,38
Latimer,Governor,Chris Powell,LIB,390001,0,0,9,9,
Latimer,Governor,Kevin Stitt,REP,390001,2,18,123,143,
Latimer,Governor,Drew Edmondson,DEM,390001,4,25,107,136,
Latimer,Lieutenant Governor,Matt Pinnell,REP,390001,2,24,134,160,
Latimer,Lieutenant Governor,Anastasia Pittman,DEM,390001,4,15,90,109,
Latimer,Lieutenant Governor,Ivan Holmes,IND,390001,0,4,12,16,
Latimer,State Auditor,John Yeutter,LIB,390001,1,12,51,64,
Latimer,State Auditor,Cindy Byrd,REP,390001,2,29,164,195,
Latimer,Attorney General,Mike Hunter,REP,390001,2,22,145,169,
Latimer,Attorney General,Mark Myles,DEM,390001,4,21,93,118,
Latimer,State Treasurer,Randy Mcdaniel,REP,390001,2,27,157,186,
Latimer,State Treasurer,Charles De Coune,IND,390001,2,14,60,76,
Latimer,Superintendent of Public Instruction,Joy Hofmeister,REP,390001,2,19,117,138,
Latimer,Superintendent of Public Instruction,John Cox,DEM,390001,4,19,98,121,
Latimer,Superintendent of Public Instruction,Larry Huff,IND,390001,0,5,22,27,
Latimer,Commissioner of Labor,Leslie Osborn,REP,390001,2,22,132,156,
Latimer,Commissioner of Labor,Fred Dorrell,DEM,390001,4,17,92,113,
Latimer,Commissioner of Labor,Brandt Dismukes,IND,390001,0,2,12,14,
Latimer,Insurance Commissioner,Glen Mulready,REP,390001,2,24,136,162,
Latimer,Insurance Commissioner,Kimberly Fobbs,DEM,390001,4,17,98,119,
Latimer,Corporation Commissioner,Bob Anthony,REP,390001,2,24,129,155,
Latimer,Corporation Commissioner,Ashley Nicole Mccray,DEM,390001,4,16,91,111,
Latimer,Corporation Commissioner,Jackie Short,IND,390001,0,3,15,18,
Latimer,U.S. House,Richard Castaldo,LIB,390001,1,1,9,11,2
Latimer,U.S. House,Markwayne Mullin,REP,390001,1,24,134,159,2
Latimer,U.S. House,Jason Nichols,DEM,390001,4,17,90,111,2
Latimer,U.S. House,John Foreman,IND,390001,0,1,5,6,2
Latimer,State House,Jim Grego,REP,390001,2,29,162,193,17
Latimer,State House,Peggy Defrange,DEM,390001,4,14,77,95,17
Latimer,Governor,Chris Powell,LIB,390002,0,1,16,17,
Latimer,Governor,Kevin Stitt,REP,390002,4,13,152,169,
Latimer,Governor,Drew Edmondson,DEM,390002,13,22,109,144,
Latimer,Lieutenant Governor,Matt Pinnell,REP,390002,7,18,171,196,
Latimer,Lieutenant Governor,Anastasia Pittman,DEM,390002,9,18,96,123,
Latimer,Lieutenant Governor,Ivan Holmes,IND,390002,1,1,6,8,
Latimer,State Auditor,John Yeutter,LIB,390002,8,12,68,88,
Latimer,State Auditor,Cindy Byrd,REP,390002,8,19,192,219,
Latimer,Attorney General,Mike Hunter,REP,390002,8,18,170,196,
Latimer,Attorney General,Mark Myles,DEM,390002,9,19,97,125,
Latimer,State Treasurer,Randy Mcdaniel,REP,390002,8,15,185,208,
Latimer,State Treasurer,Charles De Coune,IND,390002,8,16,69,93,
Latimer,Superintendent of Public Instruction,Joy Hofmeister,REP,390002,6,15,134,155,
Latimer,Superintendent of Public Instruction,John Cox,DEM,390002,9,19,114,142,
Latimer,Superintendent of Public Instruction,Larry Huff,IND,390002,1,2,21,24,
Latimer,Commissioner of Labor,Leslie Osborn,REP,390002,8,14,154,176,
Latimer,Commissioner of Labor,Fred Dorrell,DEM,390002,7,18,103,128,
Latimer,Commissioner of Labor,Brandt Dismukes,IND,390002,1,4,12,17,
Latimer,Insurance Commissioner,Glen Mulready,REP,390002,8,17,162,187,
Latimer,Insurance Commissioner,Kimberly Fobbs,DEM,390002,9,20,106,135,
Latimer,Corporation Commissioner,Bob Anthony,REP,390002,8,16,161,185,
Latimer,Corporation Commissioner,Ashley Nicole Mccray,DEM,390002,7,17,86,110,
Latimer,Corporation Commissioner,Jackie Short,IND,390002,2,4,22,28,
Latimer,U.S. House,Richard Castaldo,LIB,390002,1,1,10,12,2
Latimer,U.S. House,Markwayne Mullin,REP,390002,9,18,171,198,2
Latimer,U.S. House,Jason Nichols,DEM,390002,7,18,84,109,2
Latimer,U.S. House,John Foreman,IND,390002,0,0,9,9,2
Latimer,State House,Jim Grego,REP,390002,6,24,196,226,17
Latimer,State House,Peggy Defrange,DEM,390002,11,13,78,102,17
Latimer,Governor,Chris Powell,LIB,390003,0,0,4,4,
Latimer,Governor,Kevin Stitt,REP,390003,1,30,124,155,
Latimer,Governor,Drew Edmondson,DEM,390003,2,13,39,54,
Latimer,Lieutenant Governor,Matt Pinnell,REP,390003,3,35,131,169,
Latimer,Lieutenant Governor,Anastasia Pittman,DEM,390003,0,5,31,36,
Latimer,Lieutenant Governor,Ivan Holmes,IND,390003,0,2,4,6,
Latimer,State Auditor,John Yeutter,LIB,390003,0,2,19,21,
Latimer,State Auditor,Cindy Byrd,REP,390003,3,38,135,176,
Latimer,Attorney General,Mike Hunter,REP,390003,0,32,140,172,
Latimer,Attorney General,Mark Myles,DEM,390003,3,10,26,39,
Latimer,State Treasurer,Randy Mcdaniel,REP,390003,2,34,139,175,
Latimer,State Treasurer,Charles De Coune,IND,390003,1,5,18,24,
Latimer,Superintendent of Public Instruction,Joy Hofmeister,REP,390003,2,21,109,132,
Latimer,Superintendent of Public Instruction,John Cox,DEM,390003,0,18,45,63,
Latimer,Superintendent of Public Instruction,Larry Huff,IND,390003,1,4,11,16,
Latimer,Commissioner of Labor,Leslie Osborn,REP,390003,1,30,116,147,
Latimer,Commissioner of Labor,Fred Dorrell,DEM,390003,2,10,38,50,
Latimer,Commissioner of Labor,Brandt Dismukes,IND,390003,0,1,7,8,
Latimer,Insurance Commissioner,Glen Mulready,REP,390003,0,31,128,159,
Latimer,Insurance Commissioner,Kimberly Fobbs,DEM,390003,3,10,34,47,
Latimer,Corporation Commissioner,Bob Anthony,REP,390003,1,34,129,164,
Latimer,Corporation Commissioner,Ashley Nicole Mccray,DEM,390003,2,8,29,39,
Latimer,Corporation Commissioner,Jackie Short,IND,390003,0,0,5,5,
Latimer,U.S. House,Richard Castaldo,LIB,390003,0,1,1,2,2
Latimer,U.S. House,Markwayne Mullin,REP,390003,3,30,133,166,2
Latimer,U.S. House,Jason Nichols,DEM,390003,0,12,29,41,2
Latimer,U.S. House,John Foreman,IND,390003,0,0,4,4,2
Latimer,State House,Jim Grego,REP,390003,1,36,143,180,17
Latimer,State House,Peggy Defrange,DEM,390003,2,7,25,34,17
Latimer,Governor,Chris Powell,LIB,390004,1,2,8,11,
Latimer,Governor,Kevin Stitt,REP,390004,0,13,66,79,
Latimer,Governor,Drew Edmondson,DEM,390004,4,10,61,75,
Latimer,Lieutenant Governor,Matt Pinnell,REP,390004,0,17,79,96,
Latimer,Lieutenant Governor,Anastasia Pittman,DEM,390004,5,6,50,61,
Latimer,Lieutenant Governor,Ivan Holmes,IND,390004,0,1,5,6,
Latimer,State Auditor,John Yeutter,LIB,390004,3,4,24,31,
Latimer,State Auditor,Cindy Byrd,REP,390004,1,21,95,117,
Latimer,Attorney General,Mike Hunter,REP,390004,0,19,87,106,
Latimer,Attorney General,Mark Myles,DEM,390004,4,6,45,55,
Latimer,State Treasurer,Randy Mcdaniel,REP,390004,2,20,89,111,
Latimer,State Treasurer,Charles De Coune,IND,390004,2,3,32,37,
Latimer,Superintendent of Public Instruction,Joy Hofmeister,REP,390004,0,12,69,81,
Latimer,Superintendent of Public Instruction,John Cox,DEM,390004,5,11,49,65,
Latimer,Superintendent of Public Instruction,Larry Huff,IND,390004,0,2,15,17,
Latimer,Commissioner of Labor,Leslie Osborn,REP,390004,0,13,74,87,
Latimer,Commissioner of Labor,Fred Dorrell,DEM,390004,4,8,51,63,
Latimer,Commissioner of Labor,Brandt Dismukes,IND,390004,1,4,6,11,
Latimer,Insurance Commissioner,Glen Mulready,REP,390004,0,14,77,91,
Latimer,Insurance Commissioner,Kimberly Fobbs,DEM,390004,5,10,51,66,
Latimer,Corporation Commissioner,Bob Anthony,REP,390004,0,14,82,96,
Latimer,Corporation Commissioner,Ashley Nicole Mccray,DEM,390004,5,6,43,54,
Latimer,Corporation Commissioner,Jackie Short,IND,390004,0,4,7,11,
Latimer,U.S. House,Richard Castaldo,LIB,390004,1,1,0,2,2
Latimer,U.S. House,Markwayne Mullin,REP,390004,1,14,85,100,2
Latimer,U.S. House,Jason Nichols,DEM,390004,3,8,41,52,2
Latimer,U.S. House,John Foreman,IND,390004,0,2,7,9,2
Latimer,State House,Jim Grego,REP,390004,1,21,96,118,17
Latimer,State House,Peggy Defrange,DEM,390004,4,4,40,48,17
Latimer,Governor,Chris Powell,LIB,390005,0,1,12,13,
Latimer,Governor,Kevin Stitt,REP,390005,8,25,190,223,
Latimer,Governor,Drew Edmondson,DEM,390005,0,11,103,114,
Latimer,Lieutenant Governor,Matt Pinnell,REP,390005,7,28,206,241,
Latimer,Lieutenant Governor,Anastasia Pittman,DEM,390005,0,9,87,96,
Latimer,Lieutenant Governor,Ivan Holmes,IND,390005,1,0,10,11,
Latimer,State Auditor,John Yeutter,LIB,390005,0,6,43,49,
Latimer,State Auditor,Cindy Byrd,REP,390005,8,26,223,257,
Latimer,Attorney General,Mike Hunter,REP,390005,8,26,210,244,
Latimer,Attorney General,Mark Myles,DEM,390005,0,12,92,104,
Latimer,State Treasurer,Randy Mcdaniel,REP,390005,7,25,223,255,
Latimer,State Treasurer,Charles De Coune,IND,390005,1,7,52,60,
Latimer,Superintendent of Public Instruction,Joy Hofmeister,REP,390005,7,22,160,189,
Latimer,Superintendent of Public Instruction,John Cox,DEM,390005,0,14,119,133,
Latimer,Superintendent of Public Instruction,Larry Huff,IND,390005,1,0,22,23,
Latimer,Commissioner of Labor,Leslie Osborn,REP,390005,7,22,193,222,
Latimer,Commissioner of Labor,Fred Dorrell,DEM,390005,0,14,99,113,
Latimer,Commissioner of Labor,Brandt Dismukes,IND,390005,1,0,8,9,
Latimer,Insurance Commissioner,Glen Mulready,REP,390005,8,26,202,236,
Latimer,Insurance Commissioner,Kimberly Fobbs,DEM,390005,0,10,97,107,
Latimer,Corporation Commissioner,Bob Anthony,REP,390005,8,25,200,233,
Latimer,Corporation Commissioner,Ashley Nicole Mccray,DEM,390005,0,11,89,100,
Latimer,Corporation Commissioner,Jackie Short,IND,390005,0,0,10,10,
Latimer,U.S. House,Richard Castaldo,LIB,390005,0,0,5,5,2
Latimer,U.S. House,Markwayne Mullin,REP,390005,5,23,208,236,2
Latimer,U.S. House,Jason Nichols,DEM,390005,0,14,84,98,2
Latimer,U.S. House,John Foreman,IND,390005,3,0,5,8,2
Latimer,State House,Jim Grego,REP,390005,8,27,221,256,17
Latimer,State House,Peggy Defrange,DEM,390005,0,11,83,94,17
Latimer,Governor,Chris Powell,LIB,390006,0,0,3,3,
Latimer,Governor,Kevin Stitt,REP,390006,3,7,71,81,
Latimer,Governor,Drew Edmondson,DEM,390006,1,0,32,33,
Latimer,Lieutenant Governor,Matt Pinnell,REP,390006,3,7,73,83,
Latimer,Lieutenant Governor,Anastasia Pittman,DEM,390006,1,0,30,31,
Latimer,Lieutenant Governor,Ivan Holmes,IND,390006,0,0,3,3,
Latimer,State Auditor,John Yeutter,LIB,390006,1,0,18,19,
Latimer,State Auditor,Cindy Byrd,REP,390006,3,7,83,93,
Latimer,Attorney General,Mike Hunter,REP,390006,3,7,76,86,
Latimer,Attorney General,Mark Myles,DEM,390006,1,0,30,31,
Latimer,State Treasurer,Randy Mcdaniel,REP,390006,2,7,81,90,
Latimer,State Treasurer,Charles De Coune,IND,390006,2,0,19,21,
Latimer,Superintendent of Public Instruction,Joy Hofmeister,REP,390006,3,7,60,70,
Latimer,Superintendent of Public Instruction,John Cox,DEM,390006,1,0,38,39,
Latimer,Superintendent of Public Instruction,Larry Huff,IND,390006,0,0,8,8,
Latimer,Commissioner of Labor,Leslie Osborn,REP,390006,3,7,67,77,
Latimer,Commissioner of Labor,Fred Dorrell,DEM,390006,1,0,30,31,
Latimer,Commissioner of Labor,Brandt Dismukes,IND,390006,0,0,9,9,
Latimer,Insurance Commissioner,Glen Mulready,REP,390006,3,7,70,80,
Latimer,Insurance Commissioner,Kimberly Fobbs,DEM,390006,1,0,35,36,
Latimer,Corporation Commissioner,Bob Anthony,REP,390006,3,7,69,79,
Latimer,Corporation Commissioner,Ashley Nicole Mccray,DEM,390006,1,0,30,31,
Latimer,Corporation Commissioner,Jackie Short,IND,390006,0,0,6,6,
Latimer,U.S. House,Richard Castaldo,LIB,390006,0,0,3,3,2
Latimer,U.S. House,Markwayne Mullin,REP,390006,3,7,70,80,2
Latimer,U.S. House,Jason Nichols,DEM,390006,1,0,29,30,2
Latimer,U.S. House,John Foreman,IND,390006,0,0,4,4,2
Latimer,State House,Jim Grego,REP,390006,3,7,76,86,17
Latimer,State House,Peggy Defrange,DEM,390006,1,0,29,30,17
Latimer,Governor,Chris Powell,LIB,390007,0,0,7,7,
Latimer,Governor,Kevin Stitt,REP,390007,2,9,74,85,
Latimer,Governor,Drew Edmondson,DEM,390007,5,3,31,39,
Latimer,Lieutenant Governor,Matt Pinnell,REP,390007,2,9,79,90,
Latimer,Lieutenant Governor,Anastasia Pittman,DEM,390007,5,2,23,30,
Latimer,Lieutenant Governor,Ivan Holmes,IND,390007,0,1,8,9,
Latimer,State Auditor,John Yeutter,LIB,390007,1,3,24,28,
Latimer,State Auditor,Cindy Byrd,REP,390007,4,9,80,93,
Latimer,Attorney General,Mike Hunter,REP,390007,2,8,81,91,
Latimer,Attorney General,Mark Myles,DEM,390007,5,3,29,37,
Latimer,State Treasurer,Randy Mcdaniel,REP,390007,3,10,81,94,
Latimer,State Treasurer,Charles De Coune,IND,390007,2,2,24,28,
Latimer,Superintendent of Public Instruction,Joy Hofmeister,REP,390007,2,8,72,82,
Latimer,Superintendent of Public Instruction,John Cox,DEM,390007,5,3,28,36,
Latimer,Superintendent of Public Instruction,Larry Huff,IND,390007,0,1,10,11,
Latimer,Commissioner of Labor,Leslie Osborn,REP,390007,2,9,71,82,
Latimer,Commissioner of Labor,Fred Dorrell,DEM,390007,5,2,27,34,
Latimer,Commissioner of Labor,Brandt Dismukes,IND,390007,0,1,11,12,
Latimer,Insurance Commissioner,Glen Mulready,REP,390007,2,10,80,92,
Latimer,Insurance Commissioner,Kimberly Fobbs,DEM,390007,5,2,29,36,
Latimer,Corporation Commissioner,Bob Anthony,REP,390007,2,7,72,81,
Latimer,Corporation Commissioner,Ashley Nicole Mccray,DEM,390007,5,3,30,38,
Latimer,Corporation Commissioner,Jackie Short,IND,390007,0,2,8,10,
Latimer,U.S. House,Richard Castaldo,LIB,390007,0,0,0,0,2
Latimer,U.S. House,Markwayne Mullin,REP,390007,2,9,78,89,2
Latimer,U.S. House,Jason Nichols,DEM,390007,5,3,27,35,2
Latimer,U.S. House,John Foreman,IND,390007,0,0,5,5,2
Latimer,State House,Jim Grego,REP,390007,4,10,83,97,17
Latimer,State House,Peggy Defrange,DEM,390007,3,2,29,34,17
Latimer,Governor,Chris Powell,LIB,390008,0,0,6,6,
Latimer,Governor,Kevin Stitt,REP,390008,1,8,177,186,
Latimer,Governor,Drew Edmondson,DEM,390008,4,6,87,97,
Latimer,Lieutenant Governor,Matt Pinnell,REP,390008,1,9,198,208,
Latimer,Lieutenant Governor,Anastasia Pittman,DEM,390008,4,5,59,68,
Latimer,Lieutenant Governor,Ivan Holmes,IND,390008,0,0,7,7,
Latimer,State Auditor,John Yeutter,LIB,390008,1,2,35,38,
Latimer,State Auditor,Cindy Byrd,REP,390008,2,9,205,216,
Latimer,Attorney General,Mike Hunter,REP,390008,1,8,200,209,
Latimer,Attorney General,Mark Myles,DEM,390008,4,6,64,74,
Latimer,State Treasurer,Randy Mcdaniel,REP,390008,1,9,204,214,
Latimer,State Treasurer,Charles De Coune,IND,390008,2,3,37,42,
Latimer,Superintendent of Public Instruction,Joy Hofmeister,REP,390008,0,9,180,189,
Latimer,Superintendent of Public Instruction,John Cox,DEM,390008,5,5,67,77,
Latimer,Superintendent of Public Instruction,Larry Huff,IND,390008,0,0,18,18,
Latimer,Commissioner of Labor,Leslie Osborn,REP,390008,0,8,189,197,
Latimer,Commissioner of Labor,Fred Dorrell,DEM,390008,5,6,65,76,
Latimer,Commissioner of Labor,Brandt Dismukes,IND,390008,0,0,8,8,
Latimer,Insurance Commissioner,Glen Mulready,REP,390008,0,9,197,206,
Latimer,Insurance Commissioner,Kimberly Fobbs,DEM,390008,5,5,64,74,
Latimer,Corporation Commissioner,Bob Anthony,REP,390008,1,9,194,204,
Latimer,Corporation Commissioner,Ashley Nicole Mccray,DEM,390008,4,5,58,67,
Latimer,Corporation Commissioner,Jackie Short,IND,390008,0,0,11,11,
Latimer,U.S. House,Richard Castaldo,LIB,390008,0,0,3,3,2
Latimer,U.S. House,Markwayne Mullin,REP,390008,1,8,194,203,2
Latimer,U.S. House,Jason Nichols,DEM,390008,4,6,61,71,2
Latimer,U.S. House,John Foreman,IND,390008,0,0,7,7,2
Latimer,State House,Jim Grego,REP,390008,1,9,204,214,17
Latimer,State House,Peggy Defrange,DEM,390008,4,5,64,73,17
Latimer,Governor,Chris Powell,LIB,390009,0,0,5,5,
Latimer,Governor,Kevin Stitt,REP,390009,3,4,118,125,
Latimer,Governor,Drew Edmondson,DEM,390009,6,4,102,112,
Latimer,Lieutenant Governor,Matt Pinnell,REP,390009,3,4,148,155,
Latimer,Lieutenant Governor,Anastasia Pittman,DEM,390009,6,4,71,81,
Latimer,Lieutenant Governor,Ivan Holmes,IND,390009,0,0,6,6,
Latimer,State Auditor,John Yeutter,LIB,390009,1,1,36,38,
Latimer,State Auditor,Cindy Byrd,REP,390009,6,6,169,181,
Latimer,Attorney General,Mike Hunter,REP,390009,3,4,151,158,
Latimer,Attorney General,Mark Myles,DEM,390009,5,4,75,84,
Latimer,State Treasurer,Randy Mcdaniel,REP,390009,4,3,157,164,
Latimer,State Treasurer,Charles De Coune,IND,390009,3,2,45,50,
Latimer,Superintendent of Public Instruction,Joy Hofmeister,REP,390009,4,3,127,134,
Latimer,Superintendent of Public Instruction,John Cox,DEM,390009,5,4,79,88,
Latimer,Superintendent of Public Instruction,Larry Huff,IND,390009,0,1,18,19,
Latimer,Commissioner of Labor,Leslie Osborn,REP,390009,4,3,136,143,
Latimer,Commissioner of Labor,Fred Dorrell,DEM,390009,5,5,77,87,
Latimer,Commissioner of Labor,Brandt Dismukes,IND,390009,0,0,12,12,
Latimer,Insurance Commissioner,Glen Mulready,REP,390009,3,4,144,151,
Latimer,Insurance Commissioner,Kimberly Fobbs,DEM,390009,5,4,80,89,
Latimer,Corporation Commissioner,Bob Anthony,REP,390009,1,4,134,139,
Latimer,Corporation Commissioner,Ashley Nicole Mccray,DEM,390009,6,4,77,87,
Latimer,Corporation Commissioner,Jackie Short,IND,390009,2,0,13,15,
Latimer,U.S. House,Richard Castaldo,LIB,390009,0,0,2,2,2
Latimer,U.S. House,Markwayne Mullin,REP,390009,3,3,152,158,2
Latimer,U.S. House,Jason Nichols,DEM,390009,5,5,64,74,2
Latimer,U.S. House,John Foreman,IND,390009,0,0,8,8,2
Latimer,State House,Jim Grego,REP,390009,4,5,159,168,17
Latimer,State House,Peggy Defrange,DEM,390009,5,3,67,75,17
Latimer,Governor,Chris Powell,LIB,390010,0,1,8,9,
Latimer,Governor,Kevin Stitt,REP,390010,9,24,112,145,
Latimer,Governor,Drew Edmondson,DEM,390010,2,9,47,58,
Latimer,Lieutenant Governor,Matt Pinnell,REP,390010,10,26,131,167,
Latimer,Lieutenant Governor,Anastasia Pittman,DEM,390010,1,6,34,41,
Latimer,Lieutenant Governor,Ivan Holmes,IND,390010,0,1,3,4,
Latimer,State Auditor,John Yeutter,LIB,390010,1,6,25,32,
Latimer,State Auditor,Cindy Byrd,REP,390010,10,26,134,170,
Latimer,Attorney General,Mike Hunter,REP,390010,10,27,125,162,
Latimer,Attorney General,Mark Myles,DEM,390010,1,5,42,48,
Latimer,State Treasurer,Randy Mcdaniel,REP,390010,10,26,133,169,
Latimer,State Treasurer,Charles De Coune,IND,390010,1,6,26,33,
Latimer,Superintendent of Public Instruction,Joy Hofmeister,REP,390010,5,23,101,129,
Latimer,Superintendent of Public Instruction,John Cox,DEM,390010,4,9,51,64,
Latimer,Superintendent of Public Instruction,Larry Huff,IND,390010,2,2,15,19,
Latimer,Commissioner of Labor,Leslie Osborn,REP,390010,7,24,110,141,
Latimer,Commissioner of Labor,Fred Dorrell,DEM,390010,4,7,48,59,
Latimer,Commissioner of Labor,Brandt Dismukes,IND,390010,0,2,7,9,
Latimer,Insurance Commissioner,Glen Mulready,REP,390010,10,25,114,149,
Latimer,Insurance Commissioner,Kimberly Fobbs,DEM,390010,1,7,49,57,
Latimer,Corporation Commissioner,Bob Anthony,REP,390010,10,24,117,151,
Latimer,Corporation Commissioner,Ashley Nicole Mccray,DEM,390010,1,9,40,50,
Latimer,Corporation Commissioner,Jackie Short,IND,390010,0,0,7,7,
Latimer,U.S. House,Richard Castaldo,LIB,390010,0,0,6,6,2
Latimer,U.S. House,Markwayne Mullin,REP,390010,8,26,120,154,2
Latimer,U.S. House,Jason Nichols,DEM,390010,1,7,40,48,2
Latimer,U.S. House,John Foreman,IND,390010,2,1,2,5,2
Latimer,State House,Jim Grego,REP,390010,10,30,135,175,17
Latimer,State House,Peggy Defrange,DEM,390010,1,4,34,39,17
Latimer,Governor,Chris Powell,LIB,390011,1,3,16,20,
Latimer,Governor,Kevin Stitt,REP,390011,7,11,265,283,
Latimer,Governor,Drew Edmondson,DEM,390011,10,10,194,214,
Latimer,Lieutenant Governor,Matt Pinnell,REP,390011,8,14,291,313,
Latimer,Lieutenant Governor,Anastasia Pittman,DEM,390011,10,8,153,171,
Latimer,Lieutenant Governor,Ivan Holmes,IND,390011,0,2,21,23,
Latimer,State Auditor,John Yeutter,LIB,390011,4,2,93,99,
Latimer,State Auditor,Cindy Byrd,REP,390011,12,17,322,351,
Latimer,Attorney General,Mike Hunter,REP,390011,7,12,298,317,
Latimer,Attorney General,Mark Myles,DEM,390011,11,11,167,189,
Latimer,State Treasurer,Randy Mcdaniel,REP,390011,11,13,324,348,
Latimer,State Treasurer,Charles De Coune,IND,390011,4,6,95,105,
Latimer,Superintendent of Public Instruction,Joy Hofmeister,REP,390011,4,11,235,250,
Latimer,Superintendent of Public Instruction,John Cox,DEM,390011,13,11,209,233,
Latimer,Superintendent of Public Instruction,Larry Huff,IND,390011,1,2,22,25,
Latimer,Commissioner of Labor,Leslie Osborn,REP,390011,7,12,264,283,
Latimer,Commissioner of Labor,Fred Dorrell,DEM,390011,10,11,173,194,
Latimer,Commissioner of Labor,Brandt Dismukes,IND,390011,1,1,23,25,
Latimer,Insurance Commissioner,Glen Mulready,REP,390011,8,12,273,293,
Latimer,Insurance Commissioner,Kimberly Fobbs,DEM,390011,10,12,183,205,
Latimer,Corporation Commissioner,Bob Anthony,REP,390011,6,11,271,288,
Latimer,Corporation Commissioner,Ashley Nicole Mccray,DEM,390011,9,12,158,179,
Latimer,Corporation Commissioner,Jackie Short,IND,390011,3,1,28,32,
Latimer,U.S. House,Richard Castaldo,LIB,390011,0,1,8,9,2
Latimer,U.S. House,Markwayne Mullin,REP,390011,9,11,309,329,2
Latimer,U.S. House,Jason Nichols,DEM,390011,9,11,144,164,2
Latimer,U.S. House,John Foreman,IND,390011,0,1,9,10,2
Latimer,State House,Jim Grego,REP,390011,9,18,319,346,17
Latimer,State House,Peggy Defrange,DEM,390011,9,6,152,167,17
Latimer,Governor,Chris Powell,LIB,390012,1,0,13,14,
Latimer,Governor,Kevin Stitt,REP,390012,6,7,87,100,
Latimer,Governor,Drew Edmondson,DEM,390012,2,5,42,49,
Latimer,Lieutenant Governor,Matt Pinnell,REP,390012,7,7,97,111,
Latimer,Lieutenant Governor,Anastasia Pittman,DEM,390012,1,3,34,38,
Latimer,Lieutenant Governor,Ivan Holmes,IND,390012,1,2,8,11,
Latimer,State Auditor,John Yeutter,LIB,390012,3,2,22,27,
Latimer,State Auditor,Cindy Byrd,REP,390012,6,9,102,117,
Latimer,Attorney General,Mike Hunter,REP,390012,4,7,92,103,
Latimer,Attorney General,Mark Myles,DEM,390012,4,5,44,53,
Latimer,State Treasurer,Randy Mcdaniel,REP,390012,4,8,105,117,
Latimer,State Treasurer,Charles De Coune,IND,390012,5,3,23,31,
Latimer,Superintendent of Public Instruction,Joy Hofmeister,REP,390012,5,4,74,83,
Latimer,Superintendent of Public Instruction,John Cox,DEM,390012,2,6,49,57,
Latimer,Superintendent of Public Instruction,Larry Huff,IND,390012,2,2,15,19,
Latimer,Commissioner of Labor,Leslie Osborn,REP,390012,5,7,85,97,
Latimer,Commissioner of Labor,Fred Dorrell,DEM,390012,3,4,43,50,
Latimer,Commissioner of Labor,Brandt Dismukes,IND,390012,0,1,11,12,
Latimer,Insurance Commissioner,Glen Mulready,REP,390012,5,7,91,103,
Latimer,Insurance Commissioner,Kimberly Fobbs,DEM,390012,4,5,46,55,
Latimer,Corporation Commissioner,Bob Anthony,REP,390012,4,4,83,91,
Latimer,Corporation Commissioner,Ashley Nicole Mccray,DEM,390012,4,5,41,50,
Latimer,Corporation Commissioner,Jackie Short,IND,390012,1,3,13,17,
Latimer,U.S. House,Richard Castaldo,LIB,390012,0,0,4,4,2
Latimer,U.S. House,Markwayne Mullin,REP,390012,5,8,100,113,2
Latimer,U.S. House,Jason Nichols,DEM,390012,3,3,30,36,2
Latimer,U.S. House,John Foreman,IND,390012,1,1,6,8,2
Latimer,State House,Jim Grego,REP,390012,8,9,105,122,17
Latimer,State House,Peggy Defrange,DEM,390012,1,3,33,37,17
Leflore,Governor,Chris Powell,LIB,400101,0,1,8,9,
Leflore,Governor,Kevin Stitt,REP,400101,8,10,176,194,
Leflore,Governor,Drew Edmondson,DEM,400101,2,4,78,84,
Leflore,Lieutenant Governor,Matt Pinnell,REP,400101,7,10,182,199,
Leflore,Lieutenant Governor,Anastasia Pittman,DEM,400101,1,4,72,77,
Leflore,Lieutenant Governor,Ivan Holmes,IND,400101,1,0,8,9,
Leflore,State Auditor,John Yeutter,LIB,400101,2,1,35,38,
Leflore,State Auditor,Cindy Byrd,REP,400101,8,12,200,220,
Leflore,Attorney General,Mike Hunter,REP,400101,8,12,188,208,
Leflore,Attorney General,Mark Myles,DEM,400101,2,3,75,80,
Leflore,State Treasurer,Randy Mcdaniel,REP,400101,8,11,198,217,
Leflore,State Treasurer,Charles De Coune,IND,400101,2,1,37,40,
Leflore,Superintendent of Public Instruction,Joy Hofmeister,REP,400101,8,9,149,166,
Leflore,Superintendent of Public Instruction,John Cox,DEM,400101,2,3,82,87,
Leflore,Superintendent of Public Instruction,Larry Huff,IND,400101,0,4,33,37,
Leflore,Commissioner of Labor,Leslie Osborn,REP,400101,8,11,177,196,
Leflore,Commissioner of Labor,Fred Dorrell,DEM,400101,2,3,70,75,
Leflore,Commissioner of Labor,Brandt Dismukes,IND,400101,0,0,10,10,
Leflore,Insurance Commissioner,Glen Mulready,REP,400101,8,10,175,193,
Leflore,Insurance Commissioner,Kimberly Fobbs,DEM,400101,2,4,82,88,
Leflore,Corporation Commissioner,Bob Anthony,REP,400101,8,11,172,191,
Leflore,Corporation Commissioner,Ashley Nicole Mccray,DEM,400101,2,4,70,76,
Leflore,Corporation Commissioner,Jackie Short,IND,400101,0,0,16,16,
Leflore,U.S. House,Richard Castaldo,LIB,400101,0,0,2,2,2
Leflore,U.S. House,Markwayne Mullin,REP,400101,8,11,183,202,2
Leflore,U.S. House,Jason Nichols,DEM,400101,2,3,69,74,2
Leflore,U.S. House,John Foreman,IND,400101,0,0,8,8,2
Leflore,State Senate,Mark Dean Allen,REP,400101,8,10,177,195,4
Leflore,State Senate,Eddie Martin,DEM,400101,2,5,86,93,4
Leflore,State House,Randy Randleman,REP,400101,8,11,170,189,15
Leflore,State House,Judy Ross Moore,DEM,400101,2,3,94,99,15
Leflore,Governor,Chris Powell,LIB,400102,0,0,9,9,
Leflore,Governor,Kevin Stitt,REP,400102,12,14,202,228,
Leflore,Governor,Drew Edmondson,DEM,400102,1,1,99,101,
Leflore,Lieutenant Governor,Matt Pinnell,REP,400102,11,14,222,247,
Leflore,Lieutenant Governor,Anastasia Pittman,DEM,400102,3,1,79,83,
Leflore,Lieutenant Governor,Ivan Holmes,IND,400102,0,0,6,6,
Leflore,State Auditor,John Yeutter,LIB,400102,1,1,38,40,
Leflore,State Auditor,Cindy Byrd,REP,400102,13,14,248,275,
Leflore,Attorney General,Mike Hunter,REP,400102,12,14,234,260,
Leflore,Attorney General,Mark Myles,DEM,400102,2,1,75,78,
Leflore,State Treasurer,Randy Mcdaniel,REP,400102,11,14,242,267,
Leflore,State Treasurer,Charles De Coune,IND,400102,3,1,45,49,
Leflore,Superintendent of Public Instruction,Joy Hofmeister,REP,400102,9,14,196,219,
Leflore,Superintendent of Public Instruction,John Cox,DEM,400102,4,1,90,95,
Leflore,Superintendent of Public Instruction,Larry Huff,IND,400102,1,0,22,23,
Leflore,Commissioner of Labor,Leslie Osborn,REP,400102,11,13,219,243,
Leflore,Commissioner of Labor,Fred Dorrell,DEM,400102,3,1,77,81,
Leflore,Commissioner of Labor,Brandt Dismukes,IND,400102,0,1,10,11,
Leflore,Insurance Commissioner,Glen Mulready,REP,400102,13,14,225,252,
Leflore,Insurance Commissioner,Kimberly Fobbs,DEM,400102,1,1,79,81,
Leflore,Corporation Commissioner,Bob Anthony,REP,400102,9,14,210,233,
Leflore,Corporation Commissioner,Ashley Nicole Mccray,DEM,400102,4,1,76,81,
Leflore,Corporation Commissioner,Jackie Short,IND,400102,0,0,20,20,
Leflore,U.S. House,Richard Castaldo,LIB,400102,0,0,4,4,2
Leflore,U.S. House,Markwayne Mullin,REP,400102,13,14,225,252,2
Leflore,U.S. House,Jason Nichols,DEM,400102,1,1,72,74,2
Leflore,U.S. House,John Foreman,IND,400102,0,0,7,7,2
Leflore,State Senate,Mark Dean Allen,REP,400102,12,14,214,240,4
Leflore,State Senate,Eddie Martin,DEM,400102,2,1,96,99,4
Leflore,State House,Lundy Kiger,REP,400102,5,11,188,204,3
Leflore,State House,Troy Dyer,DEM,400102,9,4,120,133,3
Leflore,Governor,Chris Powell,LIB,400103,0,1,19,20,
Leflore,Governor,Kevin Stitt,REP,400103,5,17,288,310,
Leflore,Governor,Drew Edmondson,DEM,400103,14,11,162,187,
Leflore,Lieutenant Governor,Matt Pinnell,REP,400103,7,22,328,357,
Leflore,Lieutenant Governor,Anastasia Pittman,DEM,400103,11,7,130,148,
Leflore,Lieutenant Governor,Ivan Holmes,IND,400103,0,0,8,8,
Leflore,State Auditor,John Yeutter,LIB,400103,3,2,79,84,
Leflore,State Auditor,Cindy Byrd,REP,400103,7,23,364,394,
Leflore,Attorney General,Mike Hunter,REP,400103,6,22,344,372,
Leflore,Attorney General,Mark Myles,DEM,400103,12,7,122,141,
Leflore,State Treasurer,Randy Mcdaniel,REP,400103,7,22,362,391,
Leflore,State Treasurer,Charles De Coune,IND,400103,3,4,84,91,
Leflore,Superintendent of Public Instruction,Joy Hofmeister,REP,400103,5,19,307,331,
Leflore,Superintendent of Public Instruction,John Cox,DEM,400103,13,6,140,159,
Leflore,Superintendent of Public Instruction,Larry Huff,IND,400103,1,3,21,25,
Leflore,Commissioner of Labor,Leslie Osborn,REP,400103,7,20,322,349,
Leflore,Commissioner of Labor,Fred Dorrell,DEM,400103,12,8,123,143,
Leflore,Commissioner of Labor,Brandt Dismukes,IND,400103,0,0,20,20,
Leflore,Insurance Commissioner,Glen Mulready,REP,400103,6,24,338,368,
Leflore,Insurance Commissioner,Kimberly Fobbs,DEM,400103,13,6,127,146,
Leflore,Corporation Commissioner,Bob Anthony,REP,400103,8,21,332,361,
Leflore,Corporation Commissioner,Ashley Nicole Mccray,DEM,400103,11,9,119,139,
Leflore,Corporation Commissioner,Jackie Short,IND,400103,0,0,15,15,
Leflore,U.S. House,Richard Castaldo,LIB,400103,0,0,10,10,2
Leflore,U.S. House,Markwayne Mullin,REP,400103,8,23,325,356,2
Leflore,U.S. House,Jason Nichols,DEM,400103,11,6,123,140,2
Leflore,U.S. House,John Foreman,IND,400103,0,0,11,11,2
Leflore,State Senate,Mark Dean Allen,REP,400103,8,19,307,334,4
Leflore,State Senate,Eddie Martin,DEM,400103,11,11,166,188,4
Leflore,State House,Lundy Kiger,REP,400103,6,15,277,298,3
Leflore,State House,Troy Dyer,DEM,400103,13,14,193,220,3
Leflore,Governor,Chris Powell,LIB,400104,0,0,0,0,
Leflore,Governor,Kevin Stitt,REP,400104,0,5,29,34,
Leflore,Governor,Drew Edmondson,DEM,400104,7,6,95,108,
Leflore,Lieutenant Governor,Matt Pinnell,REP,400104,0,6,29,35,
Leflore,Lieutenant Governor,Anastasia Pittman,DEM,400104,7,5,93,105,
Leflore,Lieutenant Governor,Ivan Holmes,IND,400104,0,0,2,2,
Leflore,State Auditor,John Yeutter,LIB,400104,3,1,55,59,
Leflore,State Auditor,Cindy Byrd,REP,400104,0,7,46,53,
Leflore,Attorney General,Mike Hunter,REP,400104,0,6,28,34,
Leflore,Attorney General,Mark Myles,DEM,400104,7,5,95,107,
Leflore,State Treasurer,Randy Mcdaniel,REP,400104,0,7,41,48,
Leflore,State Treasurer,Charles De Coune,IND,400104,3,1,60,64,
Leflore,Superintendent of Public Instruction,Joy Hofmeister,REP,400104,2,6,25,33,
Leflore,Superintendent of Public Instruction,John Cox,DEM,400104,5,5,91,101,
Leflore,Superintendent of Public Instruction,Larry Huff,IND,400104,0,0,7,7,
Leflore,Commissioner of Labor,Leslie Osborn,REP,400104,0,6,29,35,
Leflore,Commissioner of Labor,Fred Dorrell,DEM,400104,7,5,91,103,
Leflore,Commissioner of Labor,Brandt Dismukes,IND,400104,0,0,2,2,
Leflore,Insurance Commissioner,Glen Mulready,REP,400104,0,6,34,40,
Leflore,Insurance Commissioner,Kimberly Fobbs,DEM,400104,7,5,89,101,
Leflore,Corporation Commissioner,Bob Anthony,REP,400104,0,6,32,38,
Leflore,Corporation Commissioner,Ashley Nicole Mccray,DEM,400104,7,5,86,98,
Leflore,Corporation Commissioner,Jackie Short,IND,400104,0,0,4,4,
Leflore,U.S. House,Richard Castaldo,LIB,400104,0,0,0,0,2
Leflore,U.S. House,Markwayne Mullin,REP,400104,0,6,31,37,2
Leflore,U.S. House,Jason Nichols,DEM,400104,7,5,90,102,2
Leflore,U.S. House,John Foreman,IND,400104,0,0,3,3,2
Leflore,State Senate,Mark Dean Allen,REP,400104,0,6,30,36,4
Leflore,State Senate,Eddie Martin,DEM,400104,7,5,94,106,4
Leflore,State House,Lundy Kiger,REP,400104,0,4,30,34,3
Leflore,State House,Troy Dyer,DEM,400104,7,5,94,106,3
Leflore,Governor,Chris Powell,LIB,400105,0,1,6,7,
Leflore,Governor,Kevin Stitt,REP,400105,3,9,359,371,
Leflore,Governor,Drew Edmondson,DEM,400105,5,13,127,145,
Leflore,Lieutenant Governor,Matt Pinnell,REP,400105,4,9,370,383,
Leflore,Lieutenant Governor,Anastasia Pittman,DEM,400105,4,14,105,123,
Leflore,Lieutenant Governor,Ivan Holmes,IND,400105,0,0,16,16,
Leflore,State Auditor,John Yeutter,LIB,400105,0,2,83,85,
Leflore,State Auditor,Cindy Byrd,REP,400105,5,15,384,404,
Leflore,Attorney General,Mike Hunter,REP,400105,4,12,379,395,
Leflore,Attorney General,Mark Myles,DEM,400105,4,11,110,125,
Leflore,State Treasurer,Randy Mcdaniel,REP,400105,5,13,383,401,
Leflore,State Treasurer,Charles De Coune,IND,400105,0,5,81,86,
Leflore,Superintendent of Public Instruction,Joy Hofmeister,REP,400105,5,9,332,346,
Leflore,Superintendent of Public Instruction,John Cox,DEM,400105,3,13,140,156,
Leflore,Superintendent of Public Instruction,Larry Huff,IND,400105,0,0,20,20,
Leflore,Commissioner of Labor,Leslie Osborn,REP,400105,4,11,359,374,
Leflore,Commissioner of Labor,Fred Dorrell,DEM,400105,4,11,113,128,
Leflore,Commissioner of Labor,Brandt Dismukes,IND,400105,0,0,15,15,
Leflore,Insurance Commissioner,Glen Mulready,REP,400105,4,10,367,381,
Leflore,Insurance Commissioner,Kimberly Fobbs,DEM,400105,4,12,119,135,
Leflore,Corporation Commissioner,Bob Anthony,REP,400105,4,11,356,371,
Leflore,Corporation Commissioner,Ashley Nicole Mccray,DEM,400105,4,11,113,128,
Leflore,Corporation Commissioner,Jackie Short,IND,400105,0,0,17,17,
Leflore,U.S. House,Richard Castaldo,LIB,400105,0,0,9,9,2
Leflore,U.S. House,Markwayne Mullin,REP,400105,4,11,364,379,2
Leflore,U.S. House,Jason Nichols,DEM,400105,4,12,102,118,2
Leflore,U.S. House,John Foreman,IND,400105,0,0,14,14,2
Leflore,State Senate,Mark Dean Allen,REP,400105,4,12,363,379,4
Leflore,State Senate,Eddie Martin,DEM,400105,4,11,130,145,4
Leflore,State House,Lundy Kiger,REP,400105,5,11,347,363,3
Leflore,State House,Troy Dyer,DEM,400105,3,12,145,160,3
Leflore,Governor,Chris Powell,LIB,400106,1,1,9,11,
Leflore,Governor,Kevin Stitt,REP,400106,8,6,318,332,
Leflore,Governor,Drew Edmondson,DEM,400106,3,9,118,130,
Leflore,Lieutenant Governor,Matt Pinnell,REP,400106,7,7,329,343,
Leflore,Lieutenant Governor,Anastasia Pittman,DEM,400106,4,8,107,119,
Leflore,Lieutenant Governor,Ivan Holmes,IND,400106,1,1,5,7,
Leflore,State Auditor,John Yeutter,LIB,400106,1,3,75,79,
Leflore,State Auditor,Cindy Byrd,REP,400106,9,8,339,356,
Leflore,Attorney General,Mike Hunter,REP,400106,8,8,332,348,
Leflore,Attorney General,Mark Myles,DEM,400106,4,8,108,120,
Leflore,State Treasurer,Randy Mcdaniel,REP,400106,8,7,347,362,
Leflore,State Treasurer,Charles De Coune,IND,400106,1,5,72,78,
Leflore,Superintendent of Public Instruction,Joy Hofmeister,REP,400106,7,7,309,323,
Leflore,Superintendent of Public Instruction,John Cox,DEM,400106,4,8,114,126,
Leflore,Superintendent of Public Instruction,Larry Huff,IND,400106,1,1,16,18,
Leflore,Commissioner of Labor,Leslie Osborn,REP,400106,8,8,327,343,
Leflore,Commissioner of Labor,Fred Dorrell,DEM,400106,3,8,100,111,
Leflore,Commissioner of Labor,Brandt Dismukes,IND,400106,1,0,10,11,
Leflore,Insurance Commissioner,Glen Mulready,REP,400106,8,7,316,331,
Leflore,Insurance Commissioner,Kimberly Fobbs,DEM,400106,4,9,123,136,
Leflore,Corporation Commissioner,Bob Anthony,REP,400106,8,7,321,336,
Leflore,Corporation Commissioner,Ashley Nicole Mccray,DEM,400106,4,9,99,112,
Leflore,Corporation Commissioner,Jackie Short,IND,400106,0,0,17,17,
Leflore,U.S. House,Richard Castaldo,LIB,400106,0,0,7,7,2
Leflore,U.S. House,Markwayne Mullin,REP,400106,7,8,326,341,2
Leflore,U.S. House,Jason Nichols,DEM,400106,3,8,99,110,2
Leflore,U.S. House,John Foreman,IND,400106,2,0,12,14,2
Leflore,State Senate,Mark Dean Allen,REP,400106,8,7,320,335,4
Leflore,State Senate,Eddie Martin,DEM,400106,4,9,122,135,4
Leflore,State House,Lundy Kiger,REP,400106,8,8,308,324,3
Leflore,State House,Troy Dyer,DEM,400106,4,8,131,143,3
Leflore,Governor,Chris Powell,LIB,400107,0,0,16,16,
Leflore,Governor,Kevin Stitt,REP,400107,8,33,457,498,
Leflore,Governor,Drew Edmondson,DEM,400107,3,6,170,179,
Leflore,Lieutenant Governor,Matt Pinnell,REP,400107,8,33,473,514,
Leflore,Lieutenant Governor,Anastasia Pittman,DEM,400107,3,6,147,156,
Leflore,Lieutenant Governor,Ivan Holmes,IND,400107,0,0,19,19,
Leflore,State Auditor,John Yeutter,LIB,400107,5,5,91,101,
Leflore,State Auditor,Cindy Byrd,REP,400107,6,32,519,557,
Leflore,Attorney General,Mike Hunter,REP,400107,8,35,496,539,
Leflore,Attorney General,Mark Myles,DEM,400107,3,4,145,152,
Leflore,State Treasurer,Randy Mcdaniel,REP,400107,7,35,506,548,
Leflore,State Treasurer,Charles De Coune,IND,400107,4,2,101,107,
Leflore,Superintendent of Public Instruction,Joy Hofmeister,REP,400107,3,29,451,483,
Leflore,Superintendent of Public Instruction,John Cox,DEM,400107,8,6,158,172,
Leflore,Superintendent of Public Instruction,Larry Huff,IND,400107,0,3,30,33,
Leflore,Commissioner of Labor,Leslie Osborn,REP,400107,6,29,483,518,
Leflore,Commissioner of Labor,Fred Dorrell,DEM,400107,5,6,138,149,
Leflore,Commissioner of Labor,Brandt Dismukes,IND,400107,0,3,17,20,
Leflore,Insurance Commissioner,Glen Mulready,REP,400107,8,33,478,519,
Leflore,Insurance Commissioner,Kimberly Fobbs,DEM,400107,3,5,156,164,
Leflore,Corporation Commissioner,Bob Anthony,REP,400107,7,33,464,504,
Leflore,Corporation Commissioner,Ashley Nicole Mccray,DEM,400107,4,4,144,152,
Leflore,Corporation Commissioner,Jackie Short,IND,400107,0,1,24,25,
Leflore,U.S. House,Richard Castaldo,LIB,400107,1,1,14,16,2
Leflore,U.S. House,Markwayne Mullin,REP,400107,6,31,480,517,2
Leflore,U.S. House,Jason Nichols,DEM,400107,4,6,132,142,2
Leflore,U.S. House,John Foreman,IND,400107,0,1,16,17,2
Leflore,State Senate,Mark Dean Allen,REP,400107,6,33,473,512,4
Leflore,State Senate,Eddie Martin,DEM,400107,5,5,164,174,4
Leflore,State House,Lundy Kiger,REP,400107,5,29,457,491,3
Leflore,State House,Troy Dyer,DEM,400107,6,10,178,194,3
Leflore,Governor,Chris Powell,LIB,400108,0,0,12,12,
Leflore,Governor,Kevin Stitt,REP,400108,1,12,224,237,
Leflore,Governor,Drew Edmondson,DEM,400108,1,2,73,76,
Leflore,Lieutenant Governor,Matt Pinnell,REP,400108,1,12,230,243,
Leflore,Lieutenant Governor,Anastasia Pittman,DEM,400108,1,2,69,72,
Leflore,Lieutenant Governor,Ivan Holmes,IND,400108,0,0,9,9,
Leflore,State Auditor,John Yeutter,LIB,400108,1,0,44,45,
Leflore,State Auditor,Cindy Byrd,REP,400108,1,12,253,266,
Leflore,Attorney General,Mike Hunter,REP,400108,1,12,241,254,
Leflore,Attorney General,Mark Myles,DEM,400108,1,2,67,70,
Leflore,State Treasurer,Randy Mcdaniel,REP,400108,1,12,248,261,
Leflore,State Treasurer,Charles De Coune,IND,400108,1,0,47,48,
Leflore,Superintendent of Public Instruction,Joy Hofmeister,REP,400108,1,11,216,228,
Leflore,Superintendent of Public Instruction,John Cox,DEM,400108,1,2,73,76,
Leflore,Superintendent of Public Instruction,Larry Huff,IND,400108,0,1,18,19,
Leflore,Commissioner of Labor,Leslie Osborn,REP,400108,1,12,233,246,
Leflore,Commissioner of Labor,Fred Dorrell,DEM,400108,1,2,63,66,
Leflore,Commissioner of Labor,Brandt Dismukes,IND,400108,0,0,10,10,
Leflore,Insurance Commissioner,Glen Mulready,REP,400108,1,12,238,251,
Leflore,Insurance Commissioner,Kimberly Fobbs,DEM,400108,1,2,69,72,
Leflore,Corporation Commissioner,Bob Anthony,REP,400108,1,10,232,243,
Leflore,Corporation Commissioner,Ashley Nicole Mccray,DEM,400108,1,2,59,62,
Leflore,Corporation Commissioner,Jackie Short,IND,400108,0,2,16,18,
Leflore,U.S. House,Richard Castaldo,LIB,400108,0,0,9,9,2
Leflore,U.S. House,Markwayne Mullin,REP,400108,1,12,231,244,2
Leflore,U.S. House,Jason Nichols,DEM,400108,1,2,57,60,2
Leflore,U.S. House,John Foreman,IND,400108,0,0,10,10,2
Leflore,State Senate,Mark Dean Allen,REP,400108,1,12,231,244,4
Leflore,State Senate,Eddie Martin,DEM,400108,1,2,79,82,4
Leflore,State House,Lundy Kiger,REP,400108,1,12,221,234,3
Leflore,State House,Troy Dyer,DEM,400108,1,2,86,89,3
Leflore,Governor,Chris Powell,LIB,400109,0,1,16,17,
Leflore,Governor,Kevin Stitt,REP,400109,8,49,309,366,
Leflore,Governor,Drew Edmondson,DEM,400109,4,15,157,176,
Leflore,Lieutenant Governor,Matt Pinnell,REP,400109,8,52,345,405,
Leflore,Lieutenant Governor,Anastasia Pittman,DEM,400109,2,14,121,137,
Leflore,Lieutenant Governor,Ivan Holmes,IND,400109,2,0,11,13,
Leflore,State Auditor,John Yeutter,LIB,400109,2,7,68,77,
Leflore,State Auditor,Cindy Byrd,REP,400109,10,57,388,455,
Leflore,Attorney General,Mike Hunter,REP,400109,8,54,350,412,
Leflore,Attorney General,Mark Myles,DEM,400109,4,11,128,143,
Leflore,State Treasurer,Randy Mcdaniel,REP,400109,8,54,375,437,
Leflore,State Treasurer,Charles De Coune,IND,400109,4,9,79,92,
Leflore,Superintendent of Public Instruction,Joy Hofmeister,REP,400109,8,49,305,362,
Leflore,Superintendent of Public Instruction,John Cox,DEM,400109,2,13,151,166,
Leflore,Superintendent of Public Instruction,Larry Huff,IND,400109,2,3,22,27,
Leflore,Commissioner of Labor,Leslie Osborn,REP,400109,8,48,338,394,
Leflore,Commissioner of Labor,Fred Dorrell,DEM,400109,2,16,120,138,
Leflore,Commissioner of Labor,Brandt Dismukes,IND,400109,2,0,15,17,
Leflore,Insurance Commissioner,Glen Mulready,REP,400109,8,50,341,399,
Leflore,Insurance Commissioner,Kimberly Fobbs,DEM,400109,4,13,132,149,
Leflore,Corporation Commissioner,Bob Anthony,REP,400109,8,51,336,395,
Leflore,Corporation Commissioner,Ashley Nicole Mccray,DEM,400109,4,11,115,130,
Leflore,Corporation Commissioner,Jackie Short,IND,400109,0,2,21,23,
Leflore,U.S. House,Richard Castaldo,LIB,400109,0,0,10,10,2
Leflore,U.S. House,Markwayne Mullin,REP,400109,8,48,349,405,2
Leflore,U.S. House,Jason Nichols,DEM,400109,4,13,110,127,2
Leflore,U.S. House,John Foreman,IND,400109,0,4,10,14,2
Leflore,State Senate,Mark Dean Allen,REP,400109,8,50,332,390,4
Leflore,State Senate,Eddie Martin,DEM,400109,4,15,148,167,4
Leflore,State House,Lundy Kiger,REP,400109,6,41,285,332,3
Leflore,State House,Troy Dyer,DEM,400109,6,24,193,223,3
Leflore,Governor,Chris Powell,LIB,400110,0,2,10,12,
Leflore,Governor,Kevin Stitt,REP,400110,4,24,210,238,
Leflore,Governor,Drew Edmondson,DEM,400110,0,10,139,149,
Leflore,Lieutenant Governor,Matt Pinnell,REP,400110,4,25,248,277,
Leflore,Lieutenant Governor,Anastasia Pittman,DEM,400110,0,10,99,109,
Leflore,Lieutenant Governor,Ivan Holmes,IND,400110,0,0,9,9,
Leflore,State Auditor,John Yeutter,LIB,400110,0,7,64,71,
Leflore,State Auditor,Cindy Byrd,REP,400110,4,27,268,299,
Leflore,Attorney General,Mike Hunter,REP,400110,4,25,242,271,
Leflore,Attorney General,Mark Myles,DEM,400110,0,10,115,125,
Leflore,State Treasurer,Randy Mcdaniel,REP,400110,4,27,263,294,
Leflore,State Treasurer,Charles De Coune,IND,400110,0,7,68,75,
Leflore,Superintendent of Public Instruction,Joy Hofmeister,REP,400110,4,23,225,252,
Leflore,Superintendent of Public Instruction,John Cox,DEM,400110,0,9,116,125,
Leflore,Superintendent of Public Instruction,Larry Huff,IND,400110,0,3,16,19,
Leflore,Commissioner of Labor,Leslie Osborn,REP,400110,4,24,239,267,
Leflore,Commissioner of Labor,Fred Dorrell,DEM,400110,0,9,100,109,
Leflore,Commissioner of Labor,Brandt Dismukes,IND,400110,0,2,12,14,
Leflore,Insurance Commissioner,Glen Mulready,REP,400110,4,25,231,260,
Leflore,Insurance Commissioner,Kimberly Fobbs,DEM,400110,0,10,124,134,
Leflore,Corporation Commissioner,Bob Anthony,REP,400110,4,26,233,263,
Leflore,Corporation Commissioner,Ashley Nicole Mccray,DEM,400110,0,9,108,117,
Leflore,Corporation Commissioner,Jackie Short,IND,400110,0,0,14,14,
Leflore,U.S. House,Richard Castaldo,LIB,400110,0,0,3,3,2
Leflore,U.S. House,Markwayne Mullin,REP,400110,4,25,242,271,2
Leflore,U.S. House,Jason Nichols,DEM,400110,0,10,100,110,2
Leflore,U.S. House,John Foreman,IND,400110,0,0,10,10,2
Leflore,State Senate,Mark Dean Allen,REP,400110,4,24,238,266,4
Leflore,State Senate,Eddie Martin,DEM,400110,0,11,120,131,4
Leflore,State House,Randy Randleman,REP,400110,4,24,246,274,15
Leflore,State House,Judy Ross Moore,DEM,400110,0,10,114,124,15
Leflore,Governor,Chris Powell,LIB,400111,0,0,11,11,
Leflore,Governor,Kevin Stitt,REP,400111,1,47,290,338,
Leflore,Governor,Drew Edmondson,DEM,400111,0,13,130,143,
Leflore,Lieutenant Governor,Matt Pinnell,REP,400111,1,49,311,361,
Leflore,Lieutenant Governor,Anastasia Pittman,DEM,400111,0,10,101,111,
Leflore,Lieutenant Governor,Ivan Holmes,IND,400111,0,0,16,16,
Leflore,State Auditor,John Yeutter,LIB,400111,0,4,58,62,
Leflore,State Auditor,Cindy Byrd,REP,400111,1,51,342,394,
Leflore,Attorney General,Mike Hunter,REP,400111,1,51,322,374,
Leflore,Attorney General,Mark Myles,DEM,400111,0,8,101,109,
Leflore,State Treasurer,Randy Mcdaniel,REP,400111,1,51,333,385,
Leflore,State Treasurer,Charles De Coune,IND,400111,0,5,69,74,
Leflore,Superintendent of Public Instruction,Joy Hofmeister,REP,400111,1,46,281,328,
Leflore,Superintendent of Public Instruction,John Cox,DEM,400111,0,13,118,131,
Leflore,Superintendent of Public Instruction,Larry Huff,IND,400111,0,0,28,28,
Leflore,Commissioner of Labor,Leslie Osborn,REP,400111,1,46,300,347,
Leflore,Commissioner of Labor,Fred Dorrell,DEM,400111,0,13,98,111,
Leflore,Commissioner of Labor,Brandt Dismukes,IND,400111,0,1,22,23,
Leflore,Insurance Commissioner,Glen Mulready,REP,400111,1,51,307,359,
Leflore,Insurance Commissioner,Kimberly Fobbs,DEM,400111,0,9,114,123,
Leflore,Corporation Commissioner,Bob Anthony,REP,400111,1,48,296,345,
Leflore,Corporation Commissioner,Ashley Nicole Mccray,DEM,400111,0,9,100,109,
Leflore,Corporation Commissioner,Jackie Short,IND,400111,0,3,25,28,
Leflore,U.S. House,Richard Castaldo,LIB,400111,0,0,7,7,2
Leflore,U.S. House,Markwayne Mullin,REP,400111,1,51,316,368,2
Leflore,U.S. House,Jason Nichols,DEM,400111,0,8,98,106,2
Leflore,U.S. House,John Foreman,IND,400111,0,1,10,11,2
Leflore,State Senate,Mark Dean Allen,REP,400111,1,48,298,347,4
Leflore,State Senate,Eddie Martin,DEM,400111,0,12,134,146,4
Leflore,State House,Randy Randleman,REP,400111,1,50,332,383,15
Leflore,State House,Judy Ross Moore,DEM,400111,0,10,97,107,15
Leflore,Governor,Chris Powell,LIB,400112,0,0,1,1,
Leflore,Governor,Kevin Stitt,REP,400112,3,3,68,74,
Leflore,Governor,Drew Edmondson,DEM,400112,0,1,41,42,
Leflore,Lieutenant Governor,Matt Pinnell,REP,400112,1,3,80,84,
Leflore,Lieutenant Governor,Anastasia Pittman,DEM,400112,0,1,26,27,
Leflore,Lieutenant Governor,Ivan Holmes,IND,400112,0,0,4,4,
Leflore,State Auditor,John Yeutter,LIB,400112,0,0,18,18,
Leflore,State Auditor,Cindy Byrd,REP,400112,1,3,83,87,
Leflore,Attorney General,Mike Hunter,REP,400112,1,3,75,79,
Leflore,Attorney General,Mark Myles,DEM,400112,0,1,34,35,
Leflore,State Treasurer,Randy Mcdaniel,REP,400112,1,3,80,84,
Leflore,State Treasurer,Charles De Coune,IND,400112,0,0,18,18,
Leflore,Superintendent of Public Instruction,Joy Hofmeister,REP,400112,1,3,62,66,
Leflore,Superintendent of Public Instruction,John Cox,DEM,400112,0,1,34,35,
Leflore,Superintendent of Public Instruction,Larry Huff,IND,400112,0,0,11,11,
Leflore,Commissioner of Labor,Leslie Osborn,REP,400112,1,3,71,75,
Leflore,Commissioner of Labor,Fred Dorrell,DEM,400112,0,1,32,33,
Leflore,Commissioner of Labor,Brandt Dismukes,IND,400112,0,0,4,4,
Leflore,Insurance Commissioner,Glen Mulready,REP,400112,1,3,69,73,
Leflore,Insurance Commissioner,Kimberly Fobbs,DEM,400112,0,1,37,38,
Leflore,Corporation Commissioner,Bob Anthony,REP,400112,1,3,71,75,
Leflore,Corporation Commissioner,Ashley Nicole Mccray,DEM,400112,0,1,30,31,
Leflore,Corporation Commissioner,Jackie Short,IND,400112,0,0,5,5,
Leflore,U.S. House,Richard Castaldo,LIB,400112,0,0,2,2,2
Leflore,U.S. House,Markwayne Mullin,REP,400112,1,3,76,80,2
Leflore,U.S. House,Jason Nichols,DEM,400112,0,1,25,26,2
Leflore,U.S. House,John Foreman,IND,400112,0,0,4,4,2
Leflore,State Senate,Mark Dean Allen,REP,400112,3,3,75,81,4
Leflore,State Senate,Eddie Martin,DEM,400112,0,1,34,35,4
Leflore,State House,Randy Randleman,REP,400112,1,3,72,76,15
Leflore,State House,Judy Ross Moore,DEM,400112,0,1,36,37,15
Leflore,Governor,Chris Powell,LIB,400113,0,0,11,11,
Leflore,Governor,Kevin Stitt,REP,400113,5,12,138,155,
Leflore,Governor,Drew Edmondson,DEM,400113,2,9,75,86,
Leflore,Lieutenant Governor,Matt Pinnell,REP,400113,5,14,154,173,
Leflore,Lieutenant Governor,Anastasia Pittman,DEM,400113,1,7,62,70,
Leflore,Lieutenant Governor,Ivan Holmes,IND,400113,0,0,7,7,
Leflore,State Auditor,John Yeutter,LIB,400113,2,4,36,42,
Leflore,State Auditor,Cindy Byrd,REP,400113,4,15,175,194,
Leflore,Attorney General,Mike Hunter,REP,400113,5,14,166,185,
Leflore,Attorney General,Mark Myles,DEM,400113,1,7,55,63,
Leflore,State Treasurer,Randy Mcdaniel,REP,400113,5,14,175,194,
Leflore,State Treasurer,Charles De Coune,IND,400113,1,5,36,42,
Leflore,Superintendent of Public Instruction,Joy Hofmeister,REP,400113,4,12,139,155,
Leflore,Superintendent of Public Instruction,John Cox,DEM,400113,1,8,68,77,
Leflore,Superintendent of Public Instruction,Larry Huff,IND,400113,1,1,16,18,
Leflore,Commissioner of Labor,Leslie Osborn,REP,400113,4,13,147,164,
Leflore,Commissioner of Labor,Fred Dorrell,DEM,400113,2,6,65,73,
Leflore,Commissioner of Labor,Brandt Dismukes,IND,400113,0,2,10,12,
Leflore,Insurance Commissioner,Glen Mulready,REP,400113,5,12,157,174,
Leflore,Insurance Commissioner,Kimberly Fobbs,DEM,400113,1,9,64,74,
Leflore,Corporation Commissioner,Bob Anthony,REP,400113,4,13,151,168,
Leflore,Corporation Commissioner,Ashley Nicole Mccray,DEM,400113,1,7,65,73,
Leflore,Corporation Commissioner,Jackie Short,IND,400113,1,0,6,7,
Leflore,U.S. House,Richard Castaldo,LIB,400113,1,0,5,6,2
Leflore,U.S. House,Markwayne Mullin,REP,400113,5,12,151,168,2
Leflore,U.S. House,Jason Nichols,DEM,400113,1,8,60,69,2
Leflore,U.S. House,John Foreman,IND,400113,0,1,6,7,2
Leflore,State Senate,Mark Dean Allen,REP,400113,5,12,144,161,4
Leflore,State Senate,Eddie Martin,DEM,400113,2,9,81,92,4
Leflore,State House,Randy Randleman,REP,400113,5,12,153,170,15
Leflore,State House,Judy Ross Moore,DEM,400113,1,9,72,82,15
Leflore,Governor,Chris Powell,LIB,400114,0,0,9,9,
Leflore,Governor,Kevin Stitt,REP,400114,1,3,70,74,
Leflore,Governor,Drew Edmondson,DEM,400114,0,4,35,39,
Leflore,Lieutenant Governor,Matt Pinnell,REP,400114,1,4,74,79,
Leflore,Lieutenant Governor,Anastasia Pittman,DEM,400114,0,2,34,36,
Leflore,Lieutenant Governor,Ivan Holmes,IND,400114,0,0,5,5,
Leflore,State Auditor,John Yeutter,LIB,400114,0,2,26,28,
Leflore,State Auditor,Cindy Byrd,REP,400114,1,4,80,85,
Leflore,Attorney General,Mike Hunter,REP,400114,1,4,77,82,
Leflore,Attorney General,Mark Myles,DEM,400114,0,2,36,38,
Leflore,State Treasurer,Randy Mcdaniel,REP,400114,1,4,77,82,
Leflore,State Treasurer,Charles De Coune,IND,400114,0,2,27,29,
Leflore,Superintendent of Public Instruction,Joy Hofmeister,REP,400114,1,4,64,69,
Leflore,Superintendent of Public Instruction,John Cox,DEM,400114,0,2,34,36,
Leflore,Superintendent of Public Instruction,Larry Huff,IND,400114,0,0,14,14,
Leflore,Commissioner of Labor,Leslie Osborn,REP,400114,1,3,71,75,
Leflore,Commissioner of Labor,Fred Dorrell,DEM,400114,0,2,33,35,
Leflore,Commissioner of Labor,Brandt Dismukes,IND,400114,0,1,6,7,
Leflore,Insurance Commissioner,Glen Mulready,REP,400114,1,4,73,78,
Leflore,Insurance Commissioner,Kimberly Fobbs,DEM,400114,0,2,36,38,
Leflore,Corporation Commissioner,Bob Anthony,REP,400114,1,4,70,75,
Leflore,Corporation Commissioner,Ashley Nicole Mccray,DEM,400114,0,2,32,34,
Leflore,Corporation Commissioner,Jackie Short,IND,400114,0,0,9,9,
Leflore,U.S. House,Richard Castaldo,LIB,400114,0,0,1,1,2
Leflore,U.S. House,Markwayne Mullin,REP,400114,1,5,77,83,2
Leflore,U.S. House,Jason Nichols,DEM,400114,0,2,35,37,2
Leflore,U.S. House,John Foreman,IND,400114,0,0,1,1,2
Leflore,State Senate,Mark Dean Allen,REP,400114,1,5,73,79,4
Leflore,State Senate,Eddie Martin,DEM,400114,0,2,41,43,4
Leflore,State House,Randy Randleman,REP,400114,0,3,77,80,15
Leflore,State House,Judy Ross Moore,DEM,400114,0,4,37,41,15
Leflore,Governor,Chris Powell,LIB,400201,0,0,3,3,
Leflore,Governor,Kevin Stitt,REP,400201,2,5,49,56,
Leflore,Governor,Drew Edmondson,DEM,400201,2,1,17,20,
Leflore,Lieutenant Governor,Matt Pinnell,REP,400201,2,5,50,57,
Leflore,Lieutenant Governor,Anastasia Pittman,DEM,400201,1,1,17,19,
Leflore,Lieutenant Governor,Ivan Holmes,IND,400201,1,0,1,2,
Leflore,State Auditor,John Yeutter,LIB,400201,2,0,10,12,
Leflore,State Auditor,Cindy Byrd,REP,400201,2,6,53,61,
Leflore,Attorney General,Mike Hunter,REP,400201,3,5,51,59,
Leflore,Attorney General,Mark Myles,DEM,400201,1,1,16,18,
Leflore,State Treasurer,Randy Mcdaniel,REP,400201,2,6,57,65,
Leflore,State Treasurer,Charles De Coune,IND,400201,2,0,6,8,
Leflore,Superintendent of Public Instruction,Joy Hofmeister,REP,400201,2,5,44,51,
Leflore,Superintendent of Public Instruction,John Cox,DEM,400201,1,1,16,18,
Leflore,Superintendent of Public Instruction,Larry Huff,IND,400201,1,0,8,9,
Leflore,Commissioner of Labor,Leslie Osborn,REP,400201,2,5,48,55,
Leflore,Commissioner of Labor,Fred Dorrell,DEM,400201,0,1,16,17,
Leflore,Commissioner of Labor,Brandt Dismukes,IND,400201,2,0,3,5,
Leflore,Insurance Commissioner,Glen Mulready,REP,400201,2,5,49,56,
Leflore,Insurance Commissioner,Kimberly Fobbs,DEM,400201,2,1,18,21,
Leflore,Corporation Commissioner,Bob Anthony,REP,400201,2,5,49,56,
Leflore,Corporation Commissioner,Ashley Nicole Mccray,DEM,400201,0,1,15,16,
Leflore,Corporation Commissioner,Jackie Short,IND,400201,2,0,3,5,
Leflore,U.S. House,Richard Castaldo,LIB,400201,0,0,1,1,2
Leflore,U.S. House,Markwayne Mullin,REP,400201,2,5,54,61,2
Leflore,U.S. House,Jason Nichols,DEM,400201,2,1,12,15,2
Leflore,U.S. House,John Foreman,IND,400201,0,0,1,1,2
Leflore,State Senate,Mark Dean Allen,REP,400201,2,5,50,57,4
Leflore,State Senate,Eddie Martin,DEM,400201,2,1,18,21,4
Leflore,State House,Randy Randleman,REP,400201,4,5,53,62,15
Leflore,State House,Judy Ross Moore,DEM,400201,0,1,15,16,15
Leflore,Governor,Chris Powell,LIB,400202,0,0,3,3,
Leflore,Governor,Kevin Stitt,REP,400202,0,5,72,77,
Leflore,Governor,Drew Edmondson,DEM,400202,4,2,53,59,
Leflore,Lieutenant Governor,Matt Pinnell,REP,400202,0,4,78,82,
Leflore,Lieutenant Governor,Anastasia Pittman,DEM,400202,4,2,44,50,
Leflore,Lieutenant Governor,Ivan Holmes,IND,400202,0,1,6,7,
Leflore,State Auditor,John Yeutter,LIB,400202,2,1,31,34,
Leflore,State Auditor,Cindy Byrd,REP,400202,2,6,87,95,
Leflore,Attorney General,Mike Hunter,REP,400202,0,5,82,87,
Leflore,Attorney General,Mark Myles,DEM,400202,4,2,46,52,
Leflore,State Treasurer,Randy Mcdaniel,REP,400202,0,4,87,91,
Leflore,State Treasurer,Charles De Coune,IND,400202,4,3,30,37,
Leflore,Superintendent of Public Instruction,Joy Hofmeister,REP,400202,0,2,62,64,
Leflore,Superintendent of Public Instruction,John Cox,DEM,400202,4,4,50,58,
Leflore,Superintendent of Public Instruction,Larry Huff,IND,400202,0,1,12,13,
Leflore,Commissioner of Labor,Leslie Osborn,REP,400202,0,5,72,77,
Leflore,Commissioner of Labor,Fred Dorrell,DEM,400202,4,2,44,50,
Leflore,Commissioner of Labor,Brandt Dismukes,IND,400202,0,0,9,9,
Leflore,Insurance Commissioner,Glen Mulready,REP,400202,0,5,76,81,
Leflore,Insurance Commissioner,Kimberly Fobbs,DEM,400202,4,2,48,54,
Leflore,Corporation Commissioner,Bob Anthony,REP,400202,0,4,75,79,
Leflore,Corporation Commissioner,Ashley Nicole Mccray,DEM,400202,4,3,39,46,
Leflore,Corporation Commissioner,Jackie Short,IND,400202,0,0,13,13,
Leflore,U.S. House,Richard Castaldo,LIB,400202,0,0,3,3,2
Leflore,U.S. House,Markwayne Mullin,REP,400202,0,5,78,83,2
Leflore,U.S. House,Jason Nichols,DEM,400202,4,2,44,50,2
Leflore,U.S. House,John Foreman,IND,400202,0,0,3,3,2
Leflore,State House,Lundy Kiger,REP,400202,0,3,58,61,3
Leflore,State House,Troy Dyer,DEM,400202,4,4,67,75,3
Leflore,Governor,Chris Powell,LIB,400203,0,7,13,20,
Leflore,Governor,Kevin Stitt,REP,400203,11,142,448,601,
Leflore,Governor,Drew Edmondson,DEM,400203,20,92,304,416,
Leflore,Lieutenant Governor,Matt Pinnell,REP,400203,14,146,501,661,
Leflore,Lieutenant Governor,Anastasia Pittman,DEM,400203,17,88,239,344,
Leflore,Lieutenant Governor,Ivan Holmes,IND,400203,0,6,14,20,
Leflore,State Auditor,John Yeutter,LIB,400203,8,51,134,193,
Leflore,State Auditor,Cindy Byrd,REP,400203,19,168,564,751,
Leflore,Attorney General,Mike Hunter,REP,400203,16,153,525,694,
Leflore,Attorney General,Mark Myles,DEM,400203,15,87,224,326,
Leflore,State Treasurer,Randy Mcdaniel,REP,400203,19,157,542,718,
Leflore,State Treasurer,Charles De Coune,IND,400203,6,59,154,219,
Leflore,Superintendent of Public Instruction,Joy Hofmeister,REP,400203,14,139,464,617,
Leflore,Superintendent of Public Instruction,John Cox,DEM,400203,15,88,250,353,
Leflore,Superintendent of Public Instruction,Larry Huff,IND,400203,2,11,39,52,
Leflore,Commissioner of Labor,Leslie Osborn,REP,400203,15,140,489,644,
Leflore,Commissioner of Labor,Fred Dorrell,DEM,400203,13,84,229,326,
Leflore,Commissioner of Labor,Brandt Dismukes,IND,400203,2,12,27,41,
Leflore,Insurance Commissioner,Glen Mulready,REP,400203,11,145,486,642,
Leflore,Insurance Commissioner,Kimberly Fobbs,DEM,400203,18,91,255,364,
Leflore,Corporation Commissioner,Bob Anthony,REP,400203,14,143,492,649,
Leflore,Corporation Commissioner,Ashley Nicole Mccray,DEM,400203,14,82,223,319,
Leflore,Corporation Commissioner,Jackie Short,IND,400203,3,11,28,42,
Leflore,U.S. House,Richard Castaldo,LIB,400203,0,3,7,10,2
Leflore,U.S. House,Markwayne Mullin,REP,400203,15,144,502,661,2
Leflore,U.S. House,Jason Nichols,DEM,400203,15,87,234,336,2
Leflore,U.S. House,John Foreman,IND,400203,1,7,17,25,2
Leflore,State Senate,Mark Dean Allen,REP,400203,16,139,463,618,4
Leflore,State Senate,Eddie Martin,DEM,400203,15,100,297,412,4
Leflore,State House,Lundy Kiger,REP,400203,18,124,369,511,3
Leflore,State House,Troy Dyer,DEM,400203,13,115,390,518,3
Leflore,Governor,Chris Powell,LIB,400204,3,3,12,18,
Leflore,Governor,Kevin Stitt,REP,400204,6,55,279,340,
Leflore,Governor,Drew Edmondson,DEM,400204,5,41,180,226,
Leflore,Lieutenant Governor,Matt Pinnell,REP,400204,7,60,307,374,
Leflore,Lieutenant Governor,Anastasia Pittman,DEM,400204,6,36,147,189,
Leflore,Lieutenant Governor,Ivan Holmes,IND,400204,1,3,9,13,
Leflore,State Auditor,John Yeutter,LIB,400204,6,26,83,115,
Leflore,State Auditor,Cindy Byrd,REP,400204,8,61,346,415,
Leflore,Attorney General,Mike Hunter,REP,400204,8,60,315,383,
Leflore,Attorney General,Mark Myles,DEM,400204,6,38,145,189,
Leflore,State Treasurer,Randy Mcdaniel,REP,400204,8,63,344,415,
Leflore,State Treasurer,Charles De Coune,IND,400204,6,24,80,110,
Leflore,Superintendent of Public Instruction,Joy Hofmeister,REP,400204,7,52,268,327,
Leflore,Superintendent of Public Instruction,John Cox,DEM,400204,5,39,167,211,
Leflore,Superintendent of Public Instruction,Larry Huff,IND,400204,2,8,28,38,
Leflore,Commissioner of Labor,Leslie Osborn,REP,400204,8,57,315,380,
Leflore,Commissioner of Labor,Fred Dorrell,DEM,400204,5,35,128,168,
Leflore,Commissioner of Labor,Brandt Dismukes,IND,400204,1,6,14,21,
Leflore,Insurance Commissioner,Glen Mulready,REP,400204,7,58,302,367,
Leflore,Insurance Commissioner,Kimberly Fobbs,DEM,400204,7,41,154,202,
Leflore,Corporation Commissioner,Bob Anthony,REP,400204,8,63,295,366,
Leflore,Corporation Commissioner,Ashley Nicole Mccray,DEM,400204,6,32,138,176,
Leflore,Corporation Commissioner,Jackie Short,IND,400204,0,4,22,26,
Leflore,U.S. House,Richard Castaldo,LIB,400204,1,1,9,11,2
Leflore,U.S. House,Markwayne Mullin,REP,400204,7,56,311,374,2
Leflore,U.S. House,Jason Nichols,DEM,400204,6,40,134,180,2
Leflore,U.S. House,John Foreman,IND,400204,0,2,14,16,2
Leflore,State Senate,Mark Dean Allen,REP,400204,7,54,292,353,4
Leflore,State Senate,Eddie Martin,DEM,400204,7,44,176,227,4
Leflore,State House,Lundy Kiger,REP,400204,8,44,237,289,3
Leflore,State House,Troy Dyer,DEM,400204,6,55,227,288,3
Leflore,Governor,Chris Powell,LIB,400205,0,0,4,4,
Leflore,Governor,Kevin Stitt,REP,400205,6,26,116,148,
Leflore,Governor,Drew Edmondson,DEM,400205,1,18,82,101,
Leflore,Lieutenant Governor,Matt Pinnell,REP,400205,6,25,128,159,
Leflore,Lieutenant Governor,Anastasia Pittman,DEM,400205,1,17,70,88,
Leflore,Lieutenant Governor,Ivan Holmes,IND,400205,0,2,3,5,
Leflore,State Auditor,John Yeutter,LIB,400205,0,13,41,54,
Leflore,State Auditor,Cindy Byrd,REP,400205,7,26,149,182,
Leflore,Attorney General,Mike Hunter,REP,400205,7,27,126,160,
Leflore,Attorney General,Mark Myles,DEM,400205,0,16,74,90,
Leflore,State Treasurer,Randy Mcdaniel,REP,400205,7,28,142,177,
Leflore,State Treasurer,Charles De Coune,IND,400205,0,12,47,59,
Leflore,Superintendent of Public Instruction,Joy Hofmeister,REP,400205,7,24,112,143,
Leflore,Superintendent of Public Instruction,John Cox,DEM,400205,0,15,78,93,
Leflore,Superintendent of Public Instruction,Larry Huff,IND,400205,0,5,10,15,
Leflore,Commissioner of Labor,Leslie Osborn,REP,400205,6,26,126,158,
Leflore,Commissioner of Labor,Fred Dorrell,DEM,400205,0,14,64,78,
Leflore,Commissioner of Labor,Brandt Dismukes,IND,400205,1,4,9,14,
Leflore,Insurance Commissioner,Glen Mulready,REP,400205,6,26,125,157,
Leflore,Insurance Commissioner,Kimberly Fobbs,DEM,400205,1,18,76,95,
Leflore,Corporation Commissioner,Bob Anthony,REP,400205,4,25,125,154,
Leflore,Corporation Commissioner,Ashley Nicole Mccray,DEM,400205,1,15,68,84,
Leflore,Corporation Commissioner,Jackie Short,IND,400205,2,4,9,15,
Leflore,U.S. House,Richard Castaldo,LIB,400205,0,1,2,3,2
Leflore,U.S. House,Markwayne Mullin,REP,400205,7,27,130,164,2
Leflore,U.S. House,Jason Nichols,DEM,400205,0,15,64,79,2
Leflore,U.S. House,John Foreman,IND,400205,0,1,4,5,2
Leflore,State Senate,Mark Dean Allen,REP,400205,7,21,120,148,4
Leflore,State Senate,Eddie Martin,DEM,400205,0,23,81,104,4
Leflore,State House,Lundy Kiger,REP,400205,6,19,103,128,3
Leflore,State House,Troy Dyer,DEM,400205,1,23,97,121,3
Leflore,Governor,Chris Powell,LIB,400207,0,1,9,10,
Leflore,Governor,Kevin Stitt,REP,400207,5,64,275,344,
Leflore,Governor,Drew Edmondson,DEM,400207,4,28,170,202,
Leflore,Lieutenant Governor,Matt Pinnell,REP,400207,5,68,300,373,
Leflore,Lieutenant Governor,Anastasia Pittman,DEM,400207,4,23,135,162,
Leflore,Lieutenant Governor,Ivan Holmes,IND,400207,0,0,18,18,
Leflore,State Auditor,John Yeutter,LIB,400207,2,11,85,98,
Leflore,State Auditor,Cindy Byrd,REP,400207,6,76,350,432,
Leflore,Attorney General,Mike Hunter,REP,400207,5,72,310,387,
Leflore,Attorney General,Mark Myles,DEM,400207,4,18,139,161,
Leflore,State Treasurer,Randy Mcdaniel,REP,400207,5,74,338,417,
Leflore,State Treasurer,Charles De Coune,IND,400207,3,13,95,111,
Leflore,Superintendent of Public Instruction,Joy Hofmeister,REP,400207,5,62,263,330,
Leflore,Superintendent of Public Instruction,John Cox,DEM,400207,4,24,153,181,
Leflore,Superintendent of Public Instruction,Larry Huff,IND,400207,0,5,37,42,
Leflore,Commissioner of Labor,Leslie Osborn,REP,400207,5,67,295,367,
Leflore,Commissioner of Labor,Fred Dorrell,DEM,400207,4,18,128,150,
Leflore,Commissioner of Labor,Brandt Dismukes,IND,400207,0,6,22,28,
Leflore,Insurance Commissioner,Glen Mulready,REP,400207,5,66,287,358,
Leflore,Insurance Commissioner,Kimberly Fobbs,DEM,400207,4,25,153,182,
Leflore,Corporation Commissioner,Bob Anthony,REP,400207,4,73,284,361,
Leflore,Corporation Commissioner,Ashley Nicole Mccray,DEM,400207,5,17,132,154,
Leflore,Corporation Commissioner,Jackie Short,IND,400207,0,2,27,29,
Leflore,U.S. House,Richard Castaldo,LIB,400207,0,1,8,9,2
Leflore,U.S. House,Markwayne Mullin,REP,400207,5,70,291,366,2
Leflore,U.S. House,Jason Nichols,DEM,400207,4,19,138,161,2
Leflore,U.S. House,John Foreman,IND,400207,0,2,17,19,2
Leflore,State Senate,Mark Dean Allen,REP,400207,5,66,282,353,4
Leflore,State Senate,Eddie Martin,DEM,400207,4,27,172,203,4
Leflore,State House,Lundy Kiger,REP,400207,3,55,227,285,3
Leflore,State House,Troy Dyer,DEM,400207,6,37,222,265,3
Leflore,Governor,Chris Powell,LIB,400208,0,1,13,14,
Leflore,Governor,Kevin Stitt,REP,400208,6,40,215,261,
Leflore,Governor,Drew Edmondson,DEM,400208,5,34,135,174,
Leflore,Lieutenant Governor,Matt Pinnell,REP,400208,6,40,230,276,
Leflore,Lieutenant Governor,Anastasia Pittman,DEM,400208,5,34,115,154,
Leflore,Lieutenant Governor,Ivan Holmes,IND,400208,0,1,15,16,
Leflore,State Auditor,John Yeutter,LIB,400208,1,17,90,108,
Leflore,State Auditor,Cindy Byrd,REP,400208,7,48,247,302,
Leflore,Attorney General,Mike Hunter,REP,400208,7,42,242,291,
Leflore,Attorney General,Mark Myles,DEM,400208,4,33,118,155,
Leflore,State Treasurer,Randy Mcdaniel,REP,400208,7,47,245,299,
Leflore,State Treasurer,Charles De Coune,IND,400208,2,18,93,113,
Leflore,Superintendent of Public Instruction,Joy Hofmeister,REP,400208,7,37,205,249,
Leflore,Superintendent of Public Instruction,John Cox,DEM,400208,4,35,126,165,
Leflore,Superintendent of Public Instruction,Larry Huff,IND,400208,0,3,27,30,
Leflore,Commissioner of Labor,Leslie Osborn,REP,400208,7,40,225,272,
Leflore,Commissioner of Labor,Fred Dorrell,DEM,400208,4,34,110,148,
Leflore,Commissioner of Labor,Brandt Dismukes,IND,400208,0,1,24,25,
Leflore,Insurance Commissioner,Glen Mulready,REP,400208,7,40,230,277,
Leflore,Insurance Commissioner,Kimberly Fobbs,DEM,400208,4,35,128,167,
Leflore,Corporation Commissioner,Bob Anthony,REP,400208,7,35,214,256,
Leflore,Corporation Commissioner,Ashley Nicole Mccray,DEM,400208,4,38,112,154,
Leflore,Corporation Commissioner,Jackie Short,IND,400208,0,2,32,34,
Leflore,U.S. House,Richard Castaldo,LIB,400208,0,1,10,11,2
Leflore,U.S. House,Markwayne Mullin,REP,400208,7,43,229,279,2
Leflore,U.S. House,Jason Nichols,DEM,400208,4,31,113,148,2
Leflore,U.S. House,John Foreman,IND,400208,0,0,11,11,2
Leflore,State Senate,Mark Dean Allen,REP,400208,7,38,226,271,4
Leflore,State Senate,Eddie Martin,DEM,400208,4,37,137,178,4
Leflore,State House,Lundy Kiger,REP,400208,6,32,190,228,3
Leflore,State House,Troy Dyer,DEM,400208,5,40,171,216,3
Leflore,Governor,Chris Powell,LIB,400210,0,0,5,5,
Leflore,Governor,Kevin Stitt,REP,400210,7,53,335,395,
Leflore,Governor,Drew Edmondson,DEM,400210,7,25,122,154,
Leflore,Lieutenant Governor,Matt Pinnell,REP,400210,7,56,362,425,
Leflore,Lieutenant Governor,Anastasia Pittman,DEM,400210,7,21,87,115,
Leflore,Lieutenant Governor,Ivan Holmes,IND,400210,0,1,6,7,
Leflore,State Auditor,John Yeutter,LIB,400210,3,15,46,64,
Leflore,State Auditor,Cindy Byrd,REP,400210,9,61,391,461,
Leflore,Attorney General,Mike Hunter,REP,400210,5,53,365,423,
Leflore,Attorney General,Mark Myles,DEM,400210,8,25,92,125,
Leflore,State Treasurer,Randy Mcdaniel,REP,400210,8,61,372,441,
Leflore,State Treasurer,Charles De Coune,IND,400210,4,15,64,83,
Leflore,Superintendent of Public Instruction,Joy Hofmeister,REP,400210,7,43,294,344,
Leflore,Superintendent of Public Instruction,John Cox,DEM,400210,6,28,142,176,
Leflore,Superintendent of Public Instruction,Larry Huff,IND,400210,1,7,24,32,
Leflore,Commissioner of Labor,Leslie Osborn,REP,400210,4,54,349,407,
Leflore,Commissioner of Labor,Fred Dorrell,DEM,400210,9,21,98,128,
Leflore,Commissioner of Labor,Brandt Dismukes,IND,400210,1,3,9,13,
Leflore,Insurance Commissioner,Glen Mulready,REP,400210,7,54,351,412,
Leflore,Insurance Commissioner,Kimberly Fobbs,DEM,400210,7,24,104,135,
Leflore,Corporation Commissioner,Bob Anthony,REP,400210,7,55,349,411,
Leflore,Corporation Commissioner,Ashley Nicole Mccray,DEM,400210,6,19,90,115,
Leflore,Corporation Commissioner,Jackie Short,IND,400210,0,4,18,22,
Leflore,U.S. House,Richard Castaldo,LIB,400210,1,1,3,5,2
Leflore,U.S. House,Markwayne Mullin,REP,400210,9,54,354,417,2
Leflore,U.S. House,Jason Nichols,DEM,400210,4,22,93,119,2
Leflore,U.S. House,John Foreman,IND,400210,0,1,8,9,2
Leflore,State Senate,Mark Dean Allen,REP,400210,7,48,338,393,4
Leflore,State Senate,Eddie Martin,DEM,400210,7,30,122,159,4
Leflore,State House,Lundy Kiger,REP,400210,5,41,282,328,3
Leflore,State House,Troy Dyer,DEM,400210,9,37,178,224,3
Leflore,Governor,Chris Powell,LIB,400211,0,0,13,13,
Leflore,Governor,Kevin Stitt,REP,400211,4,40,251,295,
Leflore,Governor,Drew Edmondson,DEM,400211,0,12,155,167,
Leflore,Lieutenant Governor,Matt Pinnell,REP,400211,4,42,289,335,
Leflore,Lieutenant Governor,Anastasia Pittman,DEM,400211,0,10,112,122,
Leflore,Lieutenant Governor,Ivan Holmes,IND,400211,0,0,11,11,
Leflore,State Auditor,John Yeutter,LIB,400211,0,4,78,82,
Leflore,State Auditor,Cindy Byrd,REP,400211,4,46,307,357,
Leflore,Attorney General,Mike Hunter,REP,400211,4,42,285,331,
Leflore,Attorney General,Mark Myles,DEM,400211,0,9,129,138,
Leflore,State Treasurer,Randy Mcdaniel,REP,400211,3,46,306,355,
Leflore,State Treasurer,Charles De Coune,IND,400211,1,4,80,85,
Leflore,Superintendent of Public Instruction,Joy Hofmeister,REP,400211,3,37,245,285,
Leflore,Superintendent of Public Instruction,John Cox,DEM,400211,1,13,150,164,
Leflore,Superintendent of Public Instruction,Larry Huff,IND,400211,0,1,20,21,
Leflore,Commissioner of Labor,Leslie Osborn,REP,400211,3,40,278,321,
Leflore,Commissioner of Labor,Fred Dorrell,DEM,400211,0,11,115,126,
Leflore,Commissioner of Labor,Brandt Dismukes,IND,400211,1,1,19,21,
Leflore,Insurance Commissioner,Glen Mulready,REP,400211,4,39,278,321,
Leflore,Insurance Commissioner,Kimberly Fobbs,DEM,400211,0,12,130,142,
Leflore,Corporation Commissioner,Bob Anthony,REP,400211,3,42,276,321,
Leflore,Corporation Commissioner,Ashley Nicole Mccray,DEM,400211,0,6,115,121,
Leflore,Corporation Commissioner,Jackie Short,IND,400211,1,3,21,25,
Leflore,U.S. House,Richard Castaldo,LIB,400211,1,0,8,9,2
Leflore,U.S. House,Markwayne Mullin,REP,400211,3,42,291,336,2
Leflore,U.S. House,Jason Nichols,DEM,400211,0,10,110,120,2
Leflore,U.S. House,John Foreman,IND,400211,0,0,10,10,2
Leflore,State House,Lundy Kiger,REP,400211,2,35,184,221,3
Leflore,State House,Troy Dyer,DEM,400211,2,17,231,250,3
Leflore,Governor,Chris Powell,LIB,400212,0,1,13,14,
Leflore,Governor,Kevin Stitt,REP,400212,17,61,355,433,
Leflore,Governor,Drew Edmondson,DEM,400212,11,45,210,266,
Leflore,Lieutenant Governor,Matt Pinnell,REP,400212,19,68,391,478,
Leflore,Lieutenant Governor,Anastasia Pittman,DEM,400212,9,36,162,207,
Leflore,Lieutenant Governor,Ivan Holmes,IND,400212,0,3,22,25,
Leflore,State Auditor,John Yeutter,LIB,400212,0,19,98,117,
Leflore,State Auditor,Cindy Byrd,REP,400212,26,83,436,545,
Leflore,Attorney General,Mike Hunter,REP,400212,20,69,405,494,
Leflore,Attorney General,Mark Myles,DEM,400212,8,36,168,212,
Leflore,State Treasurer,Randy Mcdaniel,REP,400212,22,78,434,534,
Leflore,State Treasurer,Charles De Coune,IND,400212,2,22,96,120,
Leflore,Superintendent of Public Instruction,Joy Hofmeister,REP,400212,17,64,335,416,
Leflore,Superintendent of Public Instruction,John Cox,DEM,400212,11,40,199,250,
Leflore,Superintendent of Public Instruction,Larry Huff,IND,400212,0,3,41,44,
Leflore,Commissioner of Labor,Leslie Osborn,REP,400212,18,72,367,457,
Leflore,Commissioner of Labor,Fred Dorrell,DEM,400212,10,33,174,217,
Leflore,Commissioner of Labor,Brandt Dismukes,IND,400212,0,1,27,28,
Leflore,Insurance Commissioner,Glen Mulready,REP,400212,19,70,384,473,
Leflore,Insurance Commissioner,Kimberly Fobbs,DEM,400212,9,36,181,226,
Leflore,Corporation Commissioner,Bob Anthony,REP,400212,19,70,375,464,
Leflore,Corporation Commissioner,Ashley Nicole Mccray,DEM,400212,9,34,163,206,
Leflore,Corporation Commissioner,Jackie Short,IND,400212,0,2,30,32,
Leflore,U.S. House,Richard Castaldo,LIB,400212,0,0,11,11,2
Leflore,U.S. House,Markwayne Mullin,REP,400212,19,70,400,489,2
Leflore,U.S. House,Jason Nichols,DEM,400212,9,36,151,196,2
Leflore,U.S. House,John Foreman,IND,400212,0,1,15,16,2
Leflore,State Senate,Mark Dean Allen,REP,400212,18,65,352,435,4
Leflore,State Senate,Eddie Martin,DEM,400212,10,41,225,276,4
Leflore,State House,Lundy Kiger,REP,400212,14,52,294,360,3
Leflore,State House,Troy Dyer,DEM,400212,14,53,282,349,3
Leflore,Governor,Chris Powell,LIB,400213,0,0,2,2,
Leflore,Governor,Kevin Stitt,REP,400213,0,3,38,41,
Leflore,Governor,Drew Edmondson,DEM,400213,1,1,16,18,
Leflore,Lieutenant Governor,Matt Pinnell,REP,400213,0,4,39,43,
Leflore,Lieutenant Governor,Anastasia Pittman,DEM,400213,1,0,15,16,
Leflore,Lieutenant Governor,Ivan Holmes,IND,400213,0,0,2,2,
Leflore,State Auditor,John Yeutter,LIB,400213,1,0,6,7,
Leflore,State Auditor,Cindy Byrd,REP,400213,0,4,47,51,
Leflore,Attorney General,Mike Hunter,REP,400213,0,4,41,45,
Leflore,Attorney General,Mark Myles,DEM,400213,1,0,15,16,
Leflore,State Treasurer,Randy Mcdaniel,REP,400213,0,4,41,45,
Leflore,State Treasurer,Charles De Coune,IND,400213,1,0,11,12,
Leflore,Superintendent of Public Instruction,Joy Hofmeister,REP,400213,0,4,34,38,
Leflore,Superintendent of Public Instruction,John Cox,DEM,400213,1,0,14,15,
Leflore,Superintendent of Public Instruction,Larry Huff,IND,400213,0,0,8,8,
Leflore,Commissioner of Labor,Leslie Osborn,REP,400213,0,4,40,44,
Leflore,Commissioner of Labor,Fred Dorrell,DEM,400213,1,0,13,14,
Leflore,Commissioner of Labor,Brandt Dismukes,IND,400213,0,0,3,3,
Leflore,Insurance Commissioner,Glen Mulready,REP,400213,0,4,37,41,
Leflore,Insurance Commissioner,Kimberly Fobbs,DEM,400213,1,0,19,20,
Leflore,Corporation Commissioner,Bob Anthony,REP,400213,0,4,39,43,
Leflore,Corporation Commissioner,Ashley Nicole Mccray,DEM,400213,1,0,14,15,
Leflore,Corporation Commissioner,Jackie Short,IND,400213,0,0,3,3,
Leflore,U.S. House,Richard Castaldo,LIB,400213,0,0,1,1,2
Leflore,U.S. House,Markwayne Mullin,REP,400213,1,4,38,43,2
Leflore,U.S. House,Jason Nichols,DEM,400213,0,0,12,12,2
Leflore,U.S. House,John Foreman,IND,400213,0,0,5,5,2
Leflore,State House,Jim Grego,REP,400213,0,4,37,41,17
Leflore,State House,Peggy Defrange,DEM,400213,1,0,19,20,17
Leflore,Governor,Chris Powell,LIB,400214,0,0,4,4,
Leflore,Governor,Kevin Stitt,REP,400214,6,6,49,61,
Leflore,Governor,Drew Edmondson,DEM,400214,1,1,33,35,
Leflore,Lieutenant Governor,Matt Pinnell,REP,400214,6,6,60,72,
Leflore,Lieutenant Governor,Anastasia Pittman,DEM,400214,1,1,21,23,
Leflore,Lieutenant Governor,Ivan Holmes,IND,400214,0,0,2,2,
Leflore,State Auditor,John Yeutter,LIB,400214,0,0,18,18,
Leflore,State Auditor,Cindy Byrd,REP,400214,6,7,63,76,
Leflore,Attorney General,Mike Hunter,REP,400214,6,6,65,77,
Leflore,Attorney General,Mark Myles,DEM,400214,1,1,20,22,
Leflore,State Treasurer,Randy Mcdaniel,REP,400214,6,6,61,73,
Leflore,State Treasurer,Charles De Coune,IND,400214,0,1,18,19,
Leflore,Superintendent of Public Instruction,Joy Hofmeister,REP,400214,6,6,48,60,
Leflore,Superintendent of Public Instruction,John Cox,DEM,400214,1,1,27,29,
Leflore,Superintendent of Public Instruction,Larry Huff,IND,400214,0,0,9,9,
Leflore,Commissioner of Labor,Leslie Osborn,REP,400214,6,6,56,68,
Leflore,Commissioner of Labor,Fred Dorrell,DEM,400214,1,1,21,23,
Leflore,Commissioner of Labor,Brandt Dismukes,IND,400214,0,0,7,7,
Leflore,Insurance Commissioner,Glen Mulready,REP,400214,6,6,63,75,
Leflore,Insurance Commissioner,Kimberly Fobbs,DEM,400214,1,1,21,23,
Leflore,Corporation Commissioner,Bob Anthony,REP,400214,6,6,63,75,
Leflore,Corporation Commissioner,Ashley Nicole Mccray,DEM,400214,1,1,17,19,
Leflore,Corporation Commissioner,Jackie Short,IND,400214,0,0,4,4,
Leflore,U.S. House,Richard Castaldo,LIB,400214,0,0,4,4,2
Leflore,U.S. House,Markwayne Mullin,REP,400214,6,6,60,72,2
Leflore,U.S. House,Jason Nichols,DEM,400214,1,1,20,22,2
Leflore,U.S. House,John Foreman,IND,400214,0,0,3,3,2
Leflore,State House,Jim Grego,REP,400214,6,6,65,77,17
Leflore,State House,Peggy Defrange,DEM,400214,1,1,21,23,17
Leflore,Governor,Chris Powell,LIB,400215,0,0,5,5,
Leflore,Governor,Kevin Stitt,REP,400215,4,10,105,119,
Leflore,Governor,Drew Edmondson,DEM,400215,3,6,62,71,
Leflore,Lieutenant Governor,Matt Pinnell,REP,400215,6,11,119,136,
Leflore,Lieutenant Governor,Anastasia Pittman,DEM,400215,0,4,50,54,
Leflore,Lieutenant Governor,Ivan Holmes,IND,400215,1,0,5,6,
Leflore,State Auditor,John Yeutter,LIB,400215,0,3,25,28,
Leflore,State Auditor,Cindy Byrd,REP,400215,7,10,136,153,
Leflore,Attorney General,Mike Hunter,REP,400215,6,11,123,140,
Leflore,Attorney General,Mark Myles,DEM,400215,1,4,50,55,
Leflore,State Treasurer,Randy Mcdaniel,REP,400215,5,11,136,152,
Leflore,State Treasurer,Charles De Coune,IND,400215,1,2,26,29,
Leflore,Superintendent of Public Instruction,Joy Hofmeister,REP,400215,4,8,95,107,
Leflore,Superintendent of Public Instruction,John Cox,DEM,400215,1,7,65,73,
Leflore,Superintendent of Public Instruction,Larry Huff,IND,400215,2,0,11,13,
Leflore,Commissioner of Labor,Leslie Osborn,REP,400215,3,12,117,132,
Leflore,Commissioner of Labor,Fred Dorrell,DEM,400215,3,4,50,57,
Leflore,Commissioner of Labor,Brandt Dismukes,IND,400215,1,0,6,7,
Leflore,Insurance Commissioner,Glen Mulready,REP,400215,6,10,119,135,
Leflore,Insurance Commissioner,Kimberly Fobbs,DEM,400215,1,4,52,57,
Leflore,Corporation Commissioner,Bob Anthony,REP,400215,5,9,121,135,
Leflore,Corporation Commissioner,Ashley Nicole Mccray,DEM,400215,1,4,43,48,
Leflore,Corporation Commissioner,Jackie Short,IND,400215,1,0,8,9,
Leflore,U.S. House,Richard Castaldo,LIB,400215,0,1,2,3,2
Leflore,U.S. House,Markwayne Mullin,REP,400215,5,9,123,137,2
Leflore,U.S. House,Jason Nichols,DEM,400215,2,5,44,51,2
Leflore,U.S. House,John Foreman,IND,400215,0,0,4,4,2
Leflore,State House,Jim Grego,REP,400215,6,12,124,142,17
Leflore,State House,Peggy Defrange,DEM,400215,1,4,48,53,17
Leflore,Governor,Chris Powell,LIB,400301,1,0,7,8,
Leflore,Governor,Kevin Stitt,REP,400301,5,1,110,116,
Leflore,Governor,Drew Edmondson,DEM,400301,4,1,136,141,
Leflore,Lieutenant Governor,Matt Pinnell,REP,400301,8,1,130,139,
Leflore,Lieutenant Governor,Anastasia Pittman,DEM,400301,2,1,110,113,
Leflore,Lieutenant Governor,Ivan Holmes,IND,400301,0,0,11,11,
Leflore,State Auditor,John Yeutter,LIB,400301,1,0,51,52,
Leflore,State Auditor,Cindy Byrd,REP,400301,8,1,169,178,
Leflore,Attorney General,Mike Hunter,REP,400301,8,1,141,150,
Leflore,Attorney General,Mark Myles,DEM,400301,2,1,104,107,
Leflore,State Treasurer,Randy Mcdaniel,REP,400301,8,1,163,172,
Leflore,State Treasurer,Charles De Coune,IND,400301,1,0,55,56,
Leflore,Superintendent of Public Instruction,Joy Hofmeister,REP,400301,6,1,126,133,
Leflore,Superintendent of Public Instruction,John Cox,DEM,400301,3,1,104,108,
Leflore,Superintendent of Public Instruction,Larry Huff,IND,400301,1,0,20,21,
Leflore,Commissioner of Labor,Leslie Osborn,REP,400301,7,1,133,141,
Leflore,Commissioner of Labor,Fred Dorrell,DEM,400301,2,1,102,105,
Leflore,Commissioner of Labor,Brandt Dismukes,IND,400301,1,0,12,13,
Leflore,Insurance Commissioner,Glen Mulready,REP,400301,8,1,134,143,
Leflore,Insurance Commissioner,Kimberly Fobbs,DEM,400301,2,1,112,115,
Leflore,Corporation Commissioner,Bob Anthony,REP,400301,8,1,122,131,
Leflore,Corporation Commissioner,Ashley Nicole Mccray,DEM,400301,2,1,112,115,
Leflore,Corporation Commissioner,Jackie Short,IND,400301,0,0,15,15,
Leflore,U.S. House,Richard Castaldo,LIB,400301,0,0,2,2,2
Leflore,U.S. House,Markwayne Mullin,REP,400301,8,1,146,155,2
Leflore,U.S. House,Jason Nichols,DEM,400301,2,1,97,100,2
Leflore,U.S. House,John Foreman,IND,400301,0,0,8,8,2
Leflore,State House,Jim Grego,REP,400301,9,1,151,161,17
Leflore,State House,Peggy Defrange,DEM,400301,1,1,102,104,17
Leflore,Governor,Chris Powell,LIB,400302,1,0,17,18,
Leflore,Governor,Kevin Stitt,REP,400302,5,4,225,234,
Leflore,Governor,Drew Edmondson,DEM,400302,8,2,133,143,
Leflore,Lieutenant Governor,Matt Pinnell,REP,400302,7,4,269,280,
Leflore,Lieutenant Governor,Anastasia Pittman,DEM,400302,7,2,89,98,
Leflore,Lieutenant Governor,Ivan Holmes,IND,400302,0,0,10,10,
Leflore,State Auditor,John Yeutter,LIB,400302,4,1,69,74,
Leflore,State Auditor,Cindy Byrd,REP,400302,10,4,270,284,
Leflore,Attorney General,Mike Hunter,REP,400302,8,4,276,288,
Leflore,Attorney General,Mark Myles,DEM,400302,6,2,97,105,
Leflore,State Treasurer,Randy Mcdaniel,REP,400302,10,4,281,295,
Leflore,State Treasurer,Charles De Coune,IND,400302,4,1,56,61,
Leflore,Superintendent of Public Instruction,Joy Hofmeister,REP,400302,7,4,210,221,
Leflore,Superintendent of Public Instruction,John Cox,DEM,400302,6,2,135,143,
Leflore,Superintendent of Public Instruction,Larry Huff,IND,400302,1,0,22,23,
Leflore,Commissioner of Labor,Leslie Osborn,REP,400302,7,4,243,254,
Leflore,Commissioner of Labor,Fred Dorrell,DEM,400302,7,2,106,115,
Leflore,Commissioner of Labor,Brandt Dismukes,IND,400302,0,0,16,16,
Leflore,Insurance Commissioner,Glen Mulready,REP,400302,8,4,254,266,
Leflore,Insurance Commissioner,Kimberly Fobbs,DEM,400302,6,2,113,121,
Leflore,Corporation Commissioner,Bob Anthony,REP,400302,10,4,254,268,
Leflore,Corporation Commissioner,Ashley Nicole Mccray,DEM,400302,4,2,100,106,
Leflore,Corporation Commissioner,Jackie Short,IND,400302,0,0,15,15,
Leflore,U.S. House,Richard Castaldo,LIB,400302,1,0,11,12,2
Leflore,U.S. House,Markwayne Mullin,REP,400302,7,4,276,287,2
Leflore,U.S. House,Jason Nichols,DEM,400302,5,2,76,83,2
Leflore,U.S. House,John Foreman,IND,400302,0,0,8,8,2
Leflore,Governor,Chris Powell,LIB,400303,0,0,3,3,
Leflore,Governor,Kevin Stitt,REP,400303,6,1,104,111,
Leflore,Governor,Drew Edmondson,DEM,400303,0,0,37,37,
Leflore,Lieutenant Governor,Matt Pinnell,REP,400303,6,1,110,117,
Leflore,Lieutenant Governor,Anastasia Pittman,DEM,400303,0,0,29,29,
Leflore,Lieutenant Governor,Ivan Holmes,IND,400303,0,0,2,2,
Leflore,State Auditor,John Yeutter,LIB,400303,0,0,24,24,
Leflore,State Auditor,Cindy Byrd,REP,400303,6,1,105,112,
Leflore,Attorney General,Mike Hunter,REP,400303,6,1,107,114,
Leflore,Attorney General,Mark Myles,DEM,400303,0,0,31,31,
Leflore,State Treasurer,Randy Mcdaniel,REP,400303,6,1,111,118,
Leflore,State Treasurer,Charles De Coune,IND,400303,0,0,19,19,
Leflore,Superintendent of Public Instruction,Joy Hofmeister,REP,400303,6,1,91,98,
Leflore,Superintendent of Public Instruction,John Cox,DEM,400303,0,0,39,39,
Leflore,Superintendent of Public Instruction,Larry Huff,IND,400303,0,0,12,12,
Leflore,Commissioner of Labor,Leslie Osborn,REP,400303,6,1,98,105,
Leflore,Commissioner of Labor,Fred Dorrell,DEM,400303,0,0,31,31,
Leflore,Commissioner of Labor,Brandt Dismukes,IND,400303,0,0,9,9,
Leflore,Insurance Commissioner,Glen Mulready,REP,400303,6,1,105,112,
Leflore,Insurance Commissioner,Kimberly Fobbs,DEM,400303,0,0,32,32,
Leflore,Corporation Commissioner,Bob Anthony,REP,400303,6,1,105,112,
Leflore,Corporation Commissioner,Ashley Nicole Mccray,DEM,400303,0,0,25,25,
Leflore,Corporation Commissioner,Jackie Short,IND,400303,0,0,7,7,
Leflore,U.S. House,Richard Castaldo,LIB,400303,0,0,1,1,2
Leflore,U.S. House,Markwayne Mullin,REP,400303,6,1,110,117,2
Leflore,U.S. House,Jason Nichols,DEM,400303,0,0,27,27,2
Leflore,U.S. House,John Foreman,IND,400303,0,0,1,1,2
Leflore,Governor,Chris Powell,LIB,400304,0,0,0,0,
Leflore,Governor,Kevin Stitt,REP,400304,9,0,125,134,
Leflore,Governor,Drew Edmondson,DEM,400304,0,0,32,32,
Leflore,Lieutenant Governor,Matt Pinnell,REP,400304,9,0,130,139,
Leflore,Lieutenant Governor,Anastasia Pittman,DEM,400304,0,0,26,26,
Leflore,Lieutenant Governor,Ivan Holmes,IND,400304,0,0,1,1,
Leflore,State Auditor,John Yeutter,LIB,400304,0,0,17,17,
Leflore,State Auditor,Cindy Byrd,REP,400304,9,0,134,143,
Leflore,Attorney General,Mike Hunter,REP,400304,8,0,129,137,
Leflore,Attorney General,Mark Myles,DEM,400304,0,0,27,27,
Leflore,State Treasurer,Randy Mcdaniel,REP,400304,8,0,133,141,
Leflore,State Treasurer,Charles De Coune,IND,400304,1,0,17,18,
Leflore,Superintendent of Public Instruction,Joy Hofmeister,REP,400304,7,0,107,114,
Leflore,Superintendent of Public Instruction,John Cox,DEM,400304,1,0,41,42,
Leflore,Superintendent of Public Instruction,Larry Huff,IND,400304,1,0,8,9,
Leflore,Commissioner of Labor,Leslie Osborn,REP,400304,8,0,122,130,
Leflore,Commissioner of Labor,Fred Dorrell,DEM,400304,1,0,26,27,
Leflore,Commissioner of Labor,Brandt Dismukes,IND,400304,0,0,7,7,
Leflore,Insurance Commissioner,Glen Mulready,REP,400304,9,0,126,135,
Leflore,Insurance Commissioner,Kimberly Fobbs,DEM,400304,0,0,28,28,
Leflore,Corporation Commissioner,Bob Anthony,REP,400304,7,0,125,132,
Leflore,Corporation Commissioner,Ashley Nicole Mccray,DEM,400304,2,0,27,29,
Leflore,Corporation Commissioner,Jackie Short,IND,400304,0,0,2,2,
Leflore,U.S. House,Richard Castaldo,LIB,400304,0,0,1,1,2
Leflore,U.S. House,Markwayne Mullin,REP,400304,9,0,129,138,2
Leflore,U.S. House,Jason Nichols,DEM,400304,0,0,26,26,2
Leflore,U.S. House,John Foreman,IND,400304,0,0,0,0,2
Leflore,Governor,Chris Powell,LIB,400305,0,0,2,2,
Leflore,Governor,Kevin Stitt,REP,400305,2,3,74,79,
Leflore,Governor,Drew Edmondson,DEM,400305,0,4,39,43,
Leflore,Lieutenant Governor,Matt Pinnell,REP,400305,2,4,80,86,
Leflore,Lieutenant Governor,Anastasia Pittman,DEM,400305,0,3,32,35,
Leflore,Lieutenant Governor,Ivan Holmes,IND,400305,0,0,2,2,
Leflore,State Auditor,John Yeutter,LIB,400305,0,5,23,28,
Leflore,State Auditor,Cindy Byrd,REP,400305,2,2,81,85,
Leflore,Attorney General,Mike Hunter,REP,400305,2,1,78,81,
Leflore,Attorney General,Mark Myles,DEM,400305,0,6,36,42,
Leflore,State Treasurer,Randy Mcdaniel,REP,400305,2,3,85,90,
Leflore,State Treasurer,Charles De Coune,IND,400305,0,4,20,24,
Leflore,Superintendent of Public Instruction,Joy Hofmeister,REP,400305,2,3,69,74,
Leflore,Superintendent of Public Instruction,John Cox,DEM,400305,0,3,42,45,
Leflore,Superintendent of Public Instruction,Larry Huff,IND,400305,0,1,3,4,
Leflore,Commissioner of Labor,Leslie Osborn,REP,400305,2,2,71,75,
Leflore,Commissioner of Labor,Fred Dorrell,DEM,400305,0,4,39,43,
Leflore,Commissioner of Labor,Brandt Dismukes,IND,400305,0,1,4,5,
Leflore,Insurance Commissioner,Glen Mulready,REP,400305,2,3,76,81,
Leflore,Insurance Commissioner,Kimberly Fobbs,DEM,400305,0,4,37,41,
Leflore,Corporation Commissioner,Bob Anthony,REP,400305,2,2,75,79,
Leflore,Corporation Commissioner,Ashley Nicole Mccray,DEM,400305,0,3,36,39,
Leflore,Corporation Commissioner,Jackie Short,IND,400305,0,2,3,5,
Leflore,U.S. House,Richard Castaldo,LIB,400305,0,0,1,1,2
Leflore,U.S. House,Markwayne Mullin,REP,400305,2,3,82,87,2
Leflore,U.S. House,Jason Nichols,DEM,400305,0,3,29,32,2
Leflore,U.S. House,John Foreman,IND,400305,0,1,1,2,2
Leflore,Governor,Chris Powell,LIB,400306,0,0,0,0,
Leflore,Governor,Kevin Stitt,REP,400306,1,4,54,59,
Leflore,Governor,Drew Edmondson,DEM,400306,1,3,14,18,
Leflore,Lieutenant Governor,Matt Pinnell,REP,400306,2,4,56,62,
Leflore,Lieutenant Governor,Anastasia Pittman,DEM,400306,0,3,10,13,
Leflore,Lieutenant Governor,Ivan Holmes,IND,400306,0,0,0,0,
Leflore,State Auditor,John Yeutter,LIB,400306,0,1,3,4,
Leflore,State Auditor,Cindy Byrd,REP,400306,2,4,56,62,
Leflore,Attorney General,Mike Hunter,REP,400306,2,4,52,58,
Leflore,Attorney General,Mark Myles,DEM,400306,0,3,14,17,
Leflore,State Treasurer,Randy Mcdaniel,REP,400306,1,3,59,63,
Leflore,State Treasurer,Charles De Coune,IND,400306,1,2,3,6,
Leflore,Superintendent of Public Instruction,Joy Hofmeister,REP,400306,0,2,39,41,
Leflore,Superintendent of Public Instruction,John Cox,DEM,400306,0,3,18,21,
Leflore,Superintendent of Public Instruction,Larry Huff,IND,400306,2,2,9,13,
Leflore,Commissioner of Labor,Leslie Osborn,REP,400306,1,3,47,51,
Leflore,Commissioner of Labor,Fred Dorrell,DEM,400306,0,3,13,16,
Leflore,Commissioner of Labor,Brandt Dismukes,IND,400306,1,1,4,6,
Leflore,Insurance Commissioner,Glen Mulready,REP,400306,1,4,53,58,
Leflore,Insurance Commissioner,Kimberly Fobbs,DEM,400306,1,3,11,15,
Leflore,Corporation Commissioner,Bob Anthony,REP,400306,1,3,54,58,
Leflore,Corporation Commissioner,Ashley Nicole Mccray,DEM,400306,1,3,9,13,
Leflore,Corporation Commissioner,Jackie Short,IND,400306,0,1,1,2,
Leflore,U.S. House,Richard Castaldo,LIB,400306,0,0,0,0,2
Leflore,U.S. House,Markwayne Mullin,REP,400306,2,3,54,59,2
Leflore,U.S. House,Jason Nichols,DEM,400306,0,3,10,13,2
Leflore,U.S. House,John Foreman,IND,400306,0,1,2,3,2
Leflore,Governor,Chris Powell,LIB,400309,0,0,0,0,
Leflore,Governor,Kevin Stitt,REP,400309,2,1,50,53,
Leflore,Governor,Drew Edmondson,DEM,400309,1,3,19,23,
Leflore,Lieutenant Governor,Matt Pinnell,REP,400309,2,1,49,52,
Leflore,Lieutenant Governor,Anastasia Pittman,DEM,400309,1,3,13,17,
Leflore,Lieutenant Governor,Ivan Holmes,IND,400309,0,0,5,5,
Leflore,State Auditor,John Yeutter,LIB,400309,1,1,12,14,
Leflore,State Auditor,Cindy Byrd,REP,400309,2,1,51,54,
Leflore,Attorney General,Mike Hunter,REP,400309,2,1,52,55,
Leflore,Attorney General,Mark Myles,DEM,400309,1,2,14,17,
Leflore,State Treasurer,Randy Mcdaniel,REP,400309,2,1,50,53,
Leflore,State Treasurer,Charles De Coune,IND,400309,1,1,13,15,
Leflore,Superintendent of Public Instruction,Joy Hofmeister,REP,400309,2,1,42,45,
Leflore,Superintendent of Public Instruction,John Cox,DEM,400309,1,2,18,21,
Leflore,Superintendent of Public Instruction,Larry Huff,IND,400309,0,0,6,6,
Leflore,Commissioner of Labor,Leslie Osborn,REP,400309,2,1,45,48,
Leflore,Commissioner of Labor,Fred Dorrell,DEM,400309,1,2,18,21,
Leflore,Commissioner of Labor,Brandt Dismukes,IND,400309,0,0,3,3,
Leflore,Insurance Commissioner,Glen Mulready,REP,400309,2,1,46,49,
Leflore,Insurance Commissioner,Kimberly Fobbs,DEM,400309,1,1,20,22,
Leflore,Corporation Commissioner,Bob Anthony,REP,400309,2,1,49,52,
Leflore,Corporation Commissioner,Ashley Nicole Mccray,DEM,400309,1,2,13,16,
Leflore,Corporation Commissioner,Jackie Short,IND,400309,0,0,4,4,
Leflore,U.S. House,Richard Castaldo,LIB,400309,0,0,0,0,2
Leflore,U.S. House,Markwayne Mullin,REP,400309,2,1,51,54,2
Leflore,U.S. House,Jason Nichols,DEM,400309,1,2,15,18,2
Leflore,U.S. House,John Foreman,IND,400309,0,0,2,2,2
Leflore,State House,Lundy Kiger,REP,400309,2,1,38,41,3
Leflore,State House,Troy Dyer,DEM,400309,1,3,32,36,3
Leflore,Governor,Chris Powell,LIB,400310,0,4,14,18,
Leflore,Governor,Kevin Stitt,REP,400310,6,26,250,282,
Leflore,Governor,Drew Edmondson,DEM,400310,6,17,186,209,
Leflore,Lieutenant Governor,Matt Pinnell,REP,400310,8,32,301,341,
Leflore,Lieutenant Governor,Anastasia Pittman,DEM,400310,4,16,133,153,
Leflore,Lieutenant Governor,Ivan Holmes,IND,400310,0,0,8,8,
Leflore,State Auditor,John Yeutter,LIB,400310,5,10,83,98,
Leflore,State Auditor,Cindy Byrd,REP,400310,7,36,342,385,
Leflore,Attorney General,Mike Hunter,REP,400310,8,32,304,344,
Leflore,Attorney General,Mark Myles,DEM,400310,4,16,138,158,
Leflore,State Treasurer,Randy Mcdaniel,REP,400310,6,33,336,375,
Leflore,State Treasurer,Charles De Coune,IND,400310,6,12,90,108,
Leflore,Superintendent of Public Instruction,Joy Hofmeister,REP,400310,5,29,239,273,
Leflore,Superintendent of Public Instruction,John Cox,DEM,400310,5,17,177,199,
Leflore,Superintendent of Public Instruction,Larry Huff,IND,400310,2,2,29,33,
Leflore,Commissioner of Labor,Leslie Osborn,REP,400310,7,31,270,308,
Leflore,Commissioner of Labor,Fred Dorrell,DEM,400310,3,17,144,164,
Leflore,Commissioner of Labor,Brandt Dismukes,IND,400310,2,0,21,23,
Leflore,Insurance Commissioner,Glen Mulready,REP,400310,8,32,291,331,
Leflore,Insurance Commissioner,Kimberly Fobbs,DEM,400310,4,16,143,163,
Leflore,Corporation Commissioner,Bob Anthony,REP,400310,6,33,296,335,
Leflore,Corporation Commissioner,Ashley Nicole Mccray,DEM,400310,4,14,122,140,
Leflore,Corporation Commissioner,Jackie Short,IND,400310,2,1,20,23,
Leflore,U.S. House,Richard Castaldo,LIB,400310,0,0,5,5,2
Leflore,U.S. House,Markwayne Mullin,REP,400310,9,31,304,344,2
Leflore,U.S. House,Jason Nichols,DEM,400310,2,17,124,143,2
Leflore,U.S. House,John Foreman,IND,400310,0,0,11,11,2
Leflore,State House,Lundy Kiger,REP,400310,7,30,159,196,3
Leflore,State House,Troy Dyer,DEM,400310,5,18,285,308,3
Leflore,Governor,Chris Powell,LIB,400311,0,0,5,5,
Leflore,Governor,Kevin Stitt,REP,400311,8,12,166,186,
Leflore,Governor,Drew Edmondson,DEM,400311,5,10,150,165,
Leflore,Lieutenant Governor,Matt Pinnell,REP,400311,8,13,208,229,
Leflore,Lieutenant Governor,Anastasia Pittman,DEM,400311,5,8,105,118,
Leflore,Lieutenant Governor,Ivan Holmes,IND,400311,0,0,9,9,
Leflore,State Auditor,John Yeutter,LIB,400311,3,4,62,69,
Leflore,State Auditor,Cindy Byrd,REP,400311,9,14,231,254,
Leflore,Attorney General,Mike Hunter,REP,400311,9,10,210,229,
Leflore,Attorney General,Mark Myles,DEM,400311,4,10,107,121,
Leflore,State Treasurer,Randy Mcdaniel,REP,400311,9,14,226,249,
Leflore,State Treasurer,Charles De Coune,IND,400311,3,4,65,72,
Leflore,Superintendent of Public Instruction,Joy Hofmeister,REP,400311,7,9,161,177,
Leflore,Superintendent of Public Instruction,John Cox,DEM,400311,6,13,145,164,
Leflore,Superintendent of Public Instruction,Larry Huff,IND,400311,0,0,14,14,
Leflore,Commissioner of Labor,Leslie Osborn,REP,400311,7,10,194,211,
Leflore,Commissioner of Labor,Fred Dorrell,DEM,400311,6,11,108,125,
Leflore,Commissioner of Labor,Brandt Dismukes,IND,400311,0,0,13,13,
Leflore,Insurance Commissioner,Glen Mulready,REP,400311,8,9,200,217,
Leflore,Insurance Commissioner,Kimberly Fobbs,DEM,400311,4,11,113,128,
Leflore,Corporation Commissioner,Bob Anthony,REP,400311,9,9,204,222,
Leflore,Corporation Commissioner,Ashley Nicole Mccray,DEM,400311,3,12,99,114,
Leflore,Corporation Commissioner,Jackie Short,IND,400311,1,0,12,13,
Leflore,U.S. House,Richard Castaldo,LIB,400311,0,0,5,5,2
Leflore,U.S. House,Markwayne Mullin,REP,400311,9,12,209,230,2
Leflore,U.S. House,Jason Nichols,DEM,400311,4,10,99,113,2
Leflore,U.S. House,John Foreman,IND,400311,0,0,10,10,2
Leflore,State House,Lundy Kiger,REP,400311,7,9,118,134,3
Leflore,State House,Troy Dyer,DEM,400311,6,13,197,216,3
Leflore,Governor,Chris Powell,LIB,400312,1,0,12,13,
Leflore,Governor,Kevin Stitt,REP,400312,1,10,124,135,
Leflore,Governor,Drew Edmondson,DEM,400312,4,8,90,102,
Leflore,Lieutenant Governor,Matt Pinnell,REP,400312,1,10,136,147,
Leflore,Lieutenant Governor,Anastasia Pittman,DEM,400312,4,7,79,90,
Leflore,Lieutenant Governor,Ivan Holmes,IND,400312,1,0,8,9,
Leflore,State Auditor,John Yeutter,LIB,400312,2,3,43,48,
Leflore,State Auditor,Cindy Byrd,REP,400312,2,10,161,173,
Leflore,Attorney General,Mike Hunter,REP,400312,2,8,131,141,
Leflore,Attorney General,Mark Myles,DEM,400312,4,9,87,100,
Leflore,State Treasurer,Randy Mcdaniel,REP,400312,1,11,155,167,
Leflore,State Treasurer,Charles De Coune,IND,400312,3,3,50,56,
Leflore,Superintendent of Public Instruction,Joy Hofmeister,REP,400312,2,8,108,118,
Leflore,Superintendent of Public Instruction,John Cox,DEM,400312,3,11,99,113,
Leflore,Superintendent of Public Instruction,Larry Huff,IND,400312,1,0,16,17,
Leflore,Commissioner of Labor,Leslie Osborn,REP,400312,1,9,124,134,
Leflore,Commissioner of Labor,Fred Dorrell,DEM,400312,3,6,88,97,
Leflore,Commissioner of Labor,Brandt Dismukes,IND,400312,2,2,11,15,
Leflore,Insurance Commissioner,Glen Mulready,REP,400312,2,10,136,148,
Leflore,Insurance Commissioner,Kimberly Fobbs,DEM,400312,4,7,84,95,
Leflore,Corporation Commissioner,Bob Anthony,REP,400312,2,10,129,141,
Leflore,Corporation Commissioner,Ashley Nicole Mccray,DEM,400312,2,7,81,90,
Leflore,Corporation Commissioner,Jackie Short,IND,400312,2,0,11,13,
Leflore,U.S. House,Richard Castaldo,LIB,400312,0,0,1,1,2
Leflore,U.S. House,Markwayne Mullin,REP,400312,2,9,146,157,2
Leflore,U.S. House,Jason Nichols,DEM,400312,3,7,68,78,2
Leflore,U.S. House,John Foreman,IND,400312,1,0,7,8,2
Leflore,State House,Lundy Kiger,REP,400312,2,7,85,94,3
Leflore,State House,Troy Dyer,DEM,400312,4,12,136,152,3
Lincoln,Governor,Chris Powell,LIB,410001,2,1,22,25,
Lincoln,Governor,Kevin Stitt,REP,410001,17,17,266,300,
Lincoln,Governor,Drew Edmondson,DEM,410001,6,9,148,163,
Lincoln,Lieutenant Governor,Matt Pinnell,REP,410001,19,17,306,342,
Lincoln,Lieutenant Governor,Anastasia Pittman,DEM,410001,5,9,115,129,
Lincoln,Lieutenant Governor,Ivan Holmes,IND,410001,1,1,10,12,
Lincoln,State Auditor,John Yeutter,LIB,410001,3,9,68,80,
Lincoln,State Auditor,Cindy Byrd,REP,410001,19,17,337,373,
Lincoln,Attorney General,Mike Hunter,REP,410001,19,19,314,352,
Lincoln,Attorney General,Mark Myles,DEM,410001,6,8,118,132,
Lincoln,State Treasurer,Randy Mcdaniel,REP,410001,18,17,338,373,
Lincoln,State Treasurer,Charles De Coune,IND,410001,4,9,62,75,
Lincoln,Superintendent of Public Instruction,Joy Hofmeister,REP,410001,17,15,280,312,
Lincoln,Superintendent of Public Instruction,John Cox,DEM,410001,7,9,115,131,
Lincoln,Superintendent of Public Instruction,Larry Huff,IND,410001,0,3,36,39,
Lincoln,Commissioner of Labor,Leslie Osborn,REP,410001,17,16,293,326,
Lincoln,Commissioner of Labor,Fred Dorrell,DEM,410001,7,8,114,129,
Lincoln,Commissioner of Labor,Brandt Dismukes,IND,410001,0,3,16,19,
Lincoln,Insurance Commissioner,Glen Mulready,REP,410001,16,18,296,330,
Lincoln,Insurance Commissioner,Kimberly Fobbs,DEM,410001,9,9,130,148,
Lincoln,Corporation Commissioner,Bob Anthony,REP,410001,18,18,291,327,
Lincoln,Corporation Commissioner,Ashley Nicole Mccray,DEM,410001,6,7,105,118,
Lincoln,Corporation Commissioner,Jackie Short,IND,410001,1,2,30,33,
Lincoln,U.S. House,Frank Lucas,REP,410001,19,19,311,349,3
Lincoln,U.S. House,Frankie Robbins,DEM,410001,6,8,119,133,3
Lincoln,State Senate,Jason Smalley,REP,410001,20,16,313,349,28
Lincoln,State Senate,Stephanie Sanders,IND,410001,2,11,105,118,28
Lincoln,State House,Kevin Wallace,REP,410001,19,16,287,322,32
Lincoln,State House,Christi Wolff,DEM,410001,6,11,143,160,32
Lincoln,Governor,Chris Powell,LIB,410002,0,2,20,22,
Lincoln,Governor,Kevin Stitt,REP,410002,10,20,408,438,
Lincoln,Governor,Drew Edmondson,DEM,410002,8,6,170,184,
Lincoln,Lieutenant Governor,Matt Pinnell,REP,410002,10,24,438,472,
Lincoln,Lieutenant Governor,Anastasia Pittman,DEM,410002,5,1,134,140,
Lincoln,Lieutenant Governor,Ivan Holmes,IND,410002,2,3,24,29,
Lincoln,State Auditor,John Yeutter,LIB,410002,1,4,92,97,
Lincoln,State Auditor,Cindy Byrd,REP,410002,16,23,480,519,
Lincoln,Attorney General,Mike Hunter,REP,410002,11,23,443,477,
Lincoln,Attorney General,Mark Myles,DEM,410002,7,4,148,159,
Lincoln,State Treasurer,Randy Mcdaniel,REP,410002,13,22,472,507,
Lincoln,State Treasurer,Charles De Coune,IND,410002,3,4,98,105,
Lincoln,Superintendent of Public Instruction,Joy Hofmeister,REP,410002,14,17,388,419,
Lincoln,Superintendent of Public Instruction,John Cox,DEM,410002,3,7,143,153,
Lincoln,Superintendent of Public Instruction,Larry Huff,IND,410002,1,3,61,65,
Lincoln,Commissioner of Labor,Leslie Osborn,REP,410002,12,21,427,460,
Lincoln,Commissioner of Labor,Fred Dorrell,DEM,410002,5,6,127,138,
Lincoln,Commissioner of Labor,Brandt Dismukes,IND,410002,0,1,34,35,
Lincoln,Insurance Commissioner,Glen Mulready,REP,410002,8,23,431,462,
Lincoln,Insurance Commissioner,Kimberly Fobbs,DEM,410002,9,5,160,174,
Lincoln,Corporation Commissioner,Bob Anthony,REP,410002,9,18,415,442,
Lincoln,Corporation Commissioner,Ashley Nicole Mccray,DEM,410002,5,5,139,149,
Lincoln,Corporation Commissioner,Jackie Short,IND,410002,4,5,40,49,
Lincoln,U.S. House,Frank Lucas,REP,410002,10,25,449,484,3
Lincoln,U.S. House,Frankie Robbins,DEM,410002,8,3,147,158,3
Lincoln,State Senate,Jason Smalley,REP,410002,11,22,447,480,28
Lincoln,State Senate,Stephanie Sanders,IND,410002,6,5,134,145,28
Lincoln,State House,Kevin Wallace,REP,410002,10,21,431,462,32
Lincoln,State House,Christi Wolff,DEM,410002,8,7,163,178,32
Lincoln,Governor,Chris Powell,LIB,410003,1,2,36,39,
Lincoln,Governor,Kevin Stitt,REP,410003,18,57,415,490,
Lincoln,Governor,Drew Edmondson,DEM,410003,8,14,188,210,
Lincoln,Lieutenant Governor,Matt Pinnell,REP,410003,18,58,471,547,
Lincoln,Lieutenant Governor,Anastasia Pittman,DEM,410003,7,10,131,148,
Lincoln,Lieutenant Governor,Ivan Holmes,IND,410003,0,5,34,39,
Lincoln,State Auditor,John Yeutter,LIB,410003,5,12,109,126,
Lincoln,State Auditor,Cindy Byrd,REP,410003,19,56,504,579,
Lincoln,Attorney General,Mike Hunter,REP,410003,17,59,467,543,
Lincoln,Attorney General,Mark Myles,DEM,410003,9,12,169,190,
Lincoln,State Treasurer,Randy Mcdaniel,REP,410003,18,58,485,561,
Lincoln,State Treasurer,Charles De Coune,IND,410003,7,12,131,150,
Lincoln,Superintendent of Public Instruction,Joy Hofmeister,REP,410003,16,51,387,454,
Lincoln,Superintendent of Public Instruction,John Cox,DEM,410003,7,13,174,194,
Lincoln,Superintendent of Public Instruction,Larry Huff,IND,410003,3,7,75,85,
Lincoln,Commissioner of Labor,Leslie Osborn,REP,410003,16,50,452,518,
Lincoln,Commissioner of Labor,Fred Dorrell,DEM,410003,9,12,139,160,
Lincoln,Commissioner of Labor,Brandt Dismukes,IND,410003,0,6,40,46,
Lincoln,Insurance Commissioner,Glen Mulready,REP,410003,16,54,454,524,
Lincoln,Insurance Commissioner,Kimberly Fobbs,DEM,410003,10,15,180,205,
Lincoln,Corporation Commissioner,Bob Anthony,REP,410003,16,50,431,497,
Lincoln,Corporation Commissioner,Ashley Nicole Mccray,DEM,410003,8,13,162,183,
Lincoln,Corporation Commissioner,Jackie Short,IND,410003,3,8,47,58,
Lincoln,U.S. House,Frank Lucas,REP,410003,19,59,471,549,3
Lincoln,U.S. House,Frankie Robbins,DEM,410003,8,14,166,188,3
Lincoln,State Senate,Jason Smalley,REP,410003,20,58,461,539,28
Lincoln,State Senate,Stephanie Sanders,IND,410003,5,14,170,189,28
Lincoln,State House,Kevin Wallace,REP,410003,18,58,439,515,32
Lincoln,State House,Christi Wolff,DEM,410003,8,15,197,220,32
Lincoln,Governor,Chris Powell,LIB,410004,0,0,11,11,
Lincoln,Governor,Kevin Stitt,REP,410004,10,7,226,243,
Lincoln,Governor,Drew Edmondson,DEM,410004,4,1,67,72,
Lincoln,Lieutenant Governor,Matt Pinnell,REP,410004,12,7,251,270,
Lincoln,Lieutenant Governor,Anastasia Pittman,DEM,410004,2,1,50,53,
Lincoln,Lieutenant Governor,Ivan Holmes,IND,410004,0,0,3,3,
Lincoln,State Auditor,John Yeutter,LIB,410004,1,2,43,46,
Lincoln,State Auditor,Cindy Byrd,REP,410004,13,5,251,269,
Lincoln,Attorney General,Mike Hunter,REP,410004,12,6,241,259,
Lincoln,Attorney General,Mark Myles,DEM,410004,2,2,61,65,
Lincoln,State Treasurer,Randy Mcdaniel,REP,410004,14,7,247,268,
Lincoln,State Treasurer,Charles De Coune,IND,410004,0,0,49,49,
Lincoln,Superintendent of Public Instruction,Joy Hofmeister,REP,410004,12,5,212,229,
Lincoln,Superintendent of Public Instruction,John Cox,DEM,410004,2,3,61,66,
Lincoln,Superintendent of Public Instruction,Larry Huff,IND,410004,0,0,31,31,
Lincoln,Commissioner of Labor,Leslie Osborn,REP,410004,12,8,244,264,
Lincoln,Commissioner of Labor,Fred Dorrell,DEM,410004,2,0,50,52,
Lincoln,Commissioner of Labor,Brandt Dismukes,IND,410004,0,0,7,7,
Lincoln,Insurance Commissioner,Glen Mulready,REP,410004,12,6,238,256,
Lincoln,Insurance Commissioner,Kimberly Fobbs,DEM,410004,2,2,64,68,
Lincoln,Corporation Commissioner,Bob Anthony,REP,410004,12,6,237,255,
Lincoln,Corporation Commissioner,Ashley Nicole Mccray,DEM,410004,2,1,48,51,
Lincoln,Corporation Commissioner,Jackie Short,IND,410004,0,1,17,18,
Lincoln,U.S. House,Frank Lucas,REP,410004,12,7,251,270,3
Lincoln,U.S. House,Frankie Robbins,DEM,410004,2,1,53,56,3
Lincoln,State Senate,Jason Smalley,REP,410004,13,5,246,264,28
Lincoln,State Senate,Stephanie Sanders,IND,410004,1,2,52,55,28
Lincoln,State House,Kevin Wallace,REP,410004,10,6,221,237,32
Lincoln,State House,Christi Wolff,DEM,410004,4,2,82,88,32
Lincoln,Governor,Chris Powell,LIB,410005,0,2,19,21,
Lincoln,Governor,Kevin Stitt,REP,410005,8,21,321,350,
Lincoln,Governor,Drew Edmondson,DEM,410005,3,9,126,138,
Lincoln,Lieutenant Governor,Matt Pinnell,REP,410005,9,24,342,375,
Lincoln,Lieutenant Governor,Anastasia Pittman,DEM,410005,2,7,99,108,
Lincoln,Lieutenant Governor,Ivan Holmes,IND,410005,0,0,19,19,
Lincoln,State Auditor,John Yeutter,LIB,410005,1,4,79,84,
Lincoln,State Auditor,Cindy Byrd,REP,410005,10,26,367,403,
Lincoln,Attorney General,Mike Hunter,REP,410005,8,26,347,381,
Lincoln,Attorney General,Mark Myles,DEM,410005,2,6,113,121,
Lincoln,State Treasurer,Randy Mcdaniel,REP,410005,10,27,362,399,
Lincoln,State Treasurer,Charles De Coune,IND,410005,1,4,86,91,
Lincoln,Superintendent of Public Instruction,Joy Hofmeister,REP,410005,8,22,298,328,
Lincoln,Superintendent of Public Instruction,John Cox,DEM,410005,2,6,117,125,
Lincoln,Superintendent of Public Instruction,Larry Huff,IND,410005,1,3,49,53,
Lincoln,Commissioner of Labor,Leslie Osborn,REP,410005,9,26,327,362,
Lincoln,Commissioner of Labor,Fred Dorrell,DEM,410005,2,5,112,119,
Lincoln,Commissioner of Labor,Brandt Dismukes,IND,410005,0,1,20,21,
Lincoln,Insurance Commissioner,Glen Mulready,REP,410005,10,25,342,377,
Lincoln,Insurance Commissioner,Kimberly Fobbs,DEM,410005,1,7,117,125,
Lincoln,Corporation Commissioner,Bob Anthony,REP,410005,10,23,327,360,
Lincoln,Corporation Commissioner,Ashley Nicole Mccray,DEM,410005,0,7,111,118,
Lincoln,Corporation Commissioner,Jackie Short,IND,410005,1,2,24,27,
Lincoln,U.S. House,Frank Lucas,REP,410005,9,26,360,395,3
Lincoln,U.S. House,Frankie Robbins,DEM,410005,2,6,103,111,3
Lincoln,State Senate,Jason Smalley,REP,410005,9,24,357,390,28
Lincoln,State Senate,Stephanie Sanders,IND,410005,2,7,91,100,28
Lincoln,State House,Kevin Wallace,REP,410005,9,23,326,358,32
Lincoln,State House,Christi Wolff,DEM,410005,2,9,136,147,32
Lincoln,Governor,Chris Powell,LIB,410006,0,0,6,6,
Lincoln,Governor,Kevin Stitt,REP,410006,5,8,144,157,
Lincoln,Governor,Drew Edmondson,DEM,410006,1,1,65,67,
Lincoln,Lieutenant Governor,Matt Pinnell,REP,410006,5,9,156,170,
Lincoln,Lieutenant Governor,Anastasia Pittman,DEM,410006,1,0,53,54,
Lincoln,Lieutenant Governor,Ivan Holmes,IND,410006,0,0,5,5,
Lincoln,State Auditor,John Yeutter,LIB,410006,0,1,37,38,
Lincoln,State Auditor,Cindy Byrd,REP,410006,5,8,164,177,
Lincoln,Attorney General,Mike Hunter,REP,410006,3,8,151,162,
Lincoln,Attorney General,Mark Myles,DEM,410006,3,1,62,66,
Lincoln,State Treasurer,Randy Mcdaniel,REP,410006,5,8,157,170,
Lincoln,State Treasurer,Charles De Coune,IND,410006,1,1,41,43,
Lincoln,Superintendent of Public Instruction,Joy Hofmeister,REP,410006,5,8,134,147,
Lincoln,Superintendent of Public Instruction,John Cox,DEM,410006,1,1,60,62,
Lincoln,Superintendent of Public Instruction,Larry Huff,IND,410006,0,0,19,19,
Lincoln,Commissioner of Labor,Leslie Osborn,REP,410006,5,9,139,153,
Lincoln,Commissioner of Labor,Fred Dorrell,DEM,410006,1,0,59,60,
Lincoln,Commissioner of Labor,Brandt Dismukes,IND,410006,0,0,15,15,
Lincoln,Insurance Commissioner,Glen Mulready,REP,410006,5,8,147,160,
Lincoln,Insurance Commissioner,Kimberly Fobbs,DEM,410006,1,1,65,67,
Lincoln,Corporation Commissioner,Bob Anthony,REP,410006,4,8,140,152,
Lincoln,Corporation Commissioner,Ashley Nicole Mccray,DEM,410006,0,1,58,59,
Lincoln,Corporation Commissioner,Jackie Short,IND,410006,2,0,16,18,
Lincoln,U.S. House,Frank Lucas,REP,410006,5,8,159,172,3
Lincoln,U.S. House,Frankie Robbins,DEM,410006,1,1,54,56,3
Lincoln,State Senate,Jason Smalley,REP,410006,4,8,156,168,28
Lincoln,State Senate,Stephanie Sanders,IND,410006,2,1,47,50,28
Lincoln,State House,Kevin Wallace,REP,410006,5,9,152,166,32
Lincoln,State House,Christi Wolff,DEM,410006,1,0,60,61,32
Lincoln,Governor,Chris Powell,LIB,410007,0,0,17,17,
Lincoln,Governor,Kevin Stitt,REP,410007,6,11,172,189,
Lincoln,Governor,Drew Edmondson,DEM,410007,6,1,85,92,
Lincoln,Lieutenant Governor,Matt Pinnell,REP,410007,6,11,188,205,
Lincoln,Lieutenant Governor,Anastasia Pittman,DEM,410007,5,1,71,77,
Lincoln,Lieutenant Governor,Ivan Holmes,IND,410007,0,0,9,9,
Lincoln,State Auditor,John Yeutter,LIB,410007,4,0,43,47,
Lincoln,State Auditor,Cindy Byrd,REP,410007,7,12,202,221,
Lincoln,Attorney General,Mike Hunter,REP,410007,6,12,191,209,
Lincoln,Attorney General,Mark Myles,DEM,410007,6,0,80,86,
Lincoln,State Treasurer,Randy Mcdaniel,REP,410007,6,11,196,213,
Lincoln,State Treasurer,Charles De Coune,IND,410007,6,1,56,63,
Lincoln,Superintendent of Public Instruction,Joy Hofmeister,REP,410007,5,11,171,187,
Lincoln,Superintendent of Public Instruction,John Cox,DEM,410007,7,0,73,80,
Lincoln,Superintendent of Public Instruction,Larry Huff,IND,410007,0,1,25,26,
Lincoln,Commissioner of Labor,Leslie Osborn,REP,410007,6,10,172,188,
Lincoln,Commissioner of Labor,Fred Dorrell,DEM,410007,6,1,82,89,
Lincoln,Commissioner of Labor,Brandt Dismukes,IND,410007,0,0,13,13,
Lincoln,Insurance Commissioner,Glen Mulready,REP,410007,5,11,191,207,
Lincoln,Insurance Commissioner,Kimberly Fobbs,DEM,410007,7,1,79,87,
Lincoln,Corporation Commissioner,Bob Anthony,REP,410007,5,11,195,211,
Lincoln,Corporation Commissioner,Ashley Nicole Mccray,DEM,410007,7,1,63,71,
Lincoln,Corporation Commissioner,Jackie Short,IND,410007,0,0,12,12,
Lincoln,U.S. House,Frank Lucas,REP,410007,6,11,203,220,3
Lincoln,U.S. House,Frankie Robbins,DEM,410007,6,1,64,71,3
Lincoln,State Senate,Jason Smalley,REP,410007,7,11,189,207,28
Lincoln,State Senate,Stephanie Sanders,IND,410007,4,1,63,68,28
Lincoln,State House,Kevin Wallace,REP,410007,6,11,188,205,32
Lincoln,State House,Christi Wolff,DEM,410007,5,1,83,89,32
Lincoln,Governor,Chris Powell,LIB,410008,4,1,51,56,
Lincoln,Governor,Kevin Stitt,REP,410008,23,25,481,529,
Lincoln,Governor,Drew Edmondson,DEM,410008,10,20,229,259,
Lincoln,Lieutenant Governor,Matt Pinnell,REP,410008,25,31,564,620,
Lincoln,Lieutenant Governor,Anastasia Pittman,DEM,410008,10,15,163,188,
Lincoln,Lieutenant Governor,Ivan Holmes,IND,410008,2,0,30,32,
Lincoln,State Auditor,John Yeutter,LIB,410008,12,9,138,159,
Lincoln,State Auditor,Cindy Byrd,REP,410008,24,32,588,644,
Lincoln,Attorney General,Mike Hunter,REP,410008,25,30,573,628,
Lincoln,Attorney General,Mark Myles,DEM,410008,12,16,185,213,
Lincoln,State Treasurer,Randy Mcdaniel,REP,410008,24,29,588,641,
Lincoln,State Treasurer,Charles De Coune,IND,410008,12,13,136,161,
Lincoln,Superintendent of Public Instruction,Joy Hofmeister,REP,410008,25,28,480,533,
Lincoln,Superintendent of Public Instruction,John Cox,DEM,410008,9,17,177,203,
Lincoln,Superintendent of Public Instruction,Larry Huff,IND,410008,3,0,97,100,
Lincoln,Commissioner of Labor,Leslie Osborn,REP,410008,25,30,542,597,
Lincoln,Commissioner of Labor,Fred Dorrell,DEM,410008,7,14,169,190,
Lincoln,Commissioner of Labor,Brandt Dismukes,IND,410008,5,1,41,47,
Lincoln,Insurance Commissioner,Glen Mulready,REP,410008,25,28,550,603,
Lincoln,Insurance Commissioner,Kimberly Fobbs,DEM,410008,12,18,201,231,
Lincoln,Corporation Commissioner,Bob Anthony,REP,410008,24,27,520,571,
Lincoln,Corporation Commissioner,Ashley Nicole Mccray,DEM,410008,11,19,180,210,
Lincoln,Corporation Commissioner,Jackie Short,IND,410008,2,0,56,58,
Lincoln,U.S. House,Frank Lucas,REP,410008,25,25,592,642,3
Lincoln,U.S. House,Frankie Robbins,DEM,410008,11,21,168,200,3
Lincoln,State Senate,Jason Smalley,REP,410008,23,27,551,601,28
Lincoln,State Senate,Stephanie Sanders,IND,410008,12,16,185,213,28
Lincoln,State House,Kevin Wallace,REP,410008,24,27,561,612,32
Lincoln,State House,Christi Wolff,DEM,410008,13,19,197,229,32
Lincoln,Governor,Chris Powell,LIB,410009,1,3,31,35,
Lincoln,Governor,Kevin Stitt,REP,410009,18,36,264,318,
Lincoln,Governor,Drew Edmondson,DEM,410009,2,15,116,133,
Lincoln,Lieutenant Governor,Matt Pinnell,REP,410009,19,40,306,365,
Lincoln,Lieutenant Governor,Anastasia Pittman,DEM,410009,2,13,87,102,
Lincoln,Lieutenant Governor,Ivan Holmes,IND,410009,1,1,17,19,
Lincoln,State Auditor,John Yeutter,LIB,410009,3,5,77,85,
Lincoln,State Auditor,Cindy Byrd,REP,410009,19,45,309,373,
Lincoln,Attorney General,Mike Hunter,REP,410009,20,39,298,357,
Lincoln,Attorney General,Mark Myles,DEM,410009,2,14,111,127,
Lincoln,State Treasurer,Randy Mcdaniel,REP,410009,19,43,293,355,
Lincoln,State Treasurer,Charles De Coune,IND,410009,3,8,92,103,
Lincoln,Superintendent of Public Instruction,Joy Hofmeister,REP,410009,18,40,263,321,
Lincoln,Superintendent of Public Instruction,John Cox,DEM,410009,3,9,101,113,
Lincoln,Superintendent of Public Instruction,Larry Huff,IND,410009,1,5,44,50,
Lincoln,Commissioner of Labor,Leslie Osborn,REP,410009,19,40,284,343,
Lincoln,Commissioner of Labor,Fred Dorrell,DEM,410009,2,9,94,105,
Lincoln,Commissioner of Labor,Brandt Dismukes,IND,410009,1,4,24,29,
Lincoln,Insurance Commissioner,Glen Mulready,REP,410009,19,46,294,359,
Lincoln,Insurance Commissioner,Kimberly Fobbs,DEM,410009,2,7,107,116,
Lincoln,Corporation Commissioner,Bob Anthony,REP,410009,19,39,281,339,
Lincoln,Corporation Commissioner,Ashley Nicole Mccray,DEM,410009,2,13,96,111,
Lincoln,Corporation Commissioner,Jackie Short,IND,410009,1,1,28,30,
Lincoln,U.S. House,Frank Lucas,REP,410009,20,45,310,375,3
Lincoln,U.S. House,Frankie Robbins,DEM,410009,2,9,94,105,3
Lincoln,State Senate,Jason Smalley,REP,410009,19,43,296,358,28
Lincoln,State Senate,Stephanie Sanders,IND,410009,3,10,94,107,28
Lincoln,State House,Kevin Wallace,REP,410009,20,42,299,361,32
Lincoln,State House,Christi Wolff,DEM,410009,2,12,105,119,32
Lincoln,Governor,Chris Powell,LIB,410010,2,6,20,28,
Lincoln,Governor,Kevin Stitt,REP,410010,9,118,355,482,
Lincoln,Governor,Drew Edmondson,DEM,410010,10,35,160,205,
Lincoln,Lieutenant Governor,Matt Pinnell,REP,410010,12,131,400,543,
Lincoln,Lieutenant Governor,Anastasia Pittman,DEM,410010,7,23,127,157,
Lincoln,Lieutenant Governor,Ivan Holmes,IND,410010,2,4,6,12,
Lincoln,State Auditor,John Yeutter,LIB,410010,8,22,72,102,
Lincoln,State Auditor,Cindy Byrd,REP,410010,11,133,429,573,
Lincoln,Attorney General,Mike Hunter,REP,410010,10,131,398,539,
Lincoln,Attorney General,Mark Myles,DEM,410010,10,28,130,168,
Lincoln,State Treasurer,Randy Mcdaniel,REP,410010,11,128,420,559,
Lincoln,State Treasurer,Charles De Coune,IND,410010,7,26,73,106,
Lincoln,Superintendent of Public Instruction,Joy Hofmeister,REP,410010,15,112,363,490,
Lincoln,Superintendent of Public Instruction,John Cox,DEM,410010,5,28,125,158,
Lincoln,Superintendent of Public Instruction,Larry Huff,IND,410010,1,18,43,62,
Lincoln,Commissioner of Labor,Leslie Osborn,REP,410010,11,127,390,528,
Lincoln,Commissioner of Labor,Fred Dorrell,DEM,410010,7,19,120,146,
Lincoln,Commissioner of Labor,Brandt Dismukes,IND,410010,1,7,17,25,
Lincoln,Insurance Commissioner,Glen Mulready,REP,410010,10,130,394,534,
Lincoln,Insurance Commissioner,Kimberly Fobbs,DEM,410010,10,28,136,174,
Lincoln,Corporation Commissioner,Bob Anthony,REP,410010,9,120,377,506,
Lincoln,Corporation Commissioner,Ashley Nicole Mccray,DEM,410010,10,24,115,149,
Lincoln,Corporation Commissioner,Jackie Short,IND,410010,1,12,37,50,
Lincoln,U.S. House,Frank Lucas,REP,410010,10,129,412,551,3
Lincoln,U.S. House,Frankie Robbins,DEM,410010,10,29,118,157,3
Lincoln,State Senate,Jason Smalley,REP,410010,12,128,387,527,28
Lincoln,State Senate,Stephanie Sanders,IND,410010,7,28,114,149,28
Lincoln,State House,Kevin Wallace,REP,410010,11,129,376,516,32
Lincoln,State House,Christi Wolff,DEM,410010,9,28,153,190,32
Lincoln,Governor,Chris Powell,LIB,410011,0,4,22,26,
Lincoln,Governor,Kevin Stitt,REP,410011,15,55,295,365,
Lincoln,Governor,Drew Edmondson,DEM,410011,9,57,157,223,
Lincoln,Lieutenant Governor,Matt Pinnell,REP,410011,14,69,340,423,
Lincoln,Lieutenant Governor,Anastasia Pittman,DEM,410011,7,45,117,169,
Lincoln,Lieutenant Governor,Ivan Holmes,IND,410011,2,2,15,19,
Lincoln,State Auditor,John Yeutter,LIB,410011,3,31,68,102,
Lincoln,State Auditor,Cindy Byrd,REP,410011,18,74,377,469,
Lincoln,Attorney General,Mike Hunter,REP,410011,17,61,345,423,
Lincoln,Attorney General,Mark Myles,DEM,410011,7,55,124,186,
Lincoln,State Treasurer,Randy Mcdaniel,REP,410011,15,71,357,443,
Lincoln,State Treasurer,Charles De Coune,IND,410011,6,32,83,121,
Lincoln,Superintendent of Public Instruction,Joy Hofmeister,REP,410011,15,59,302,376,
Lincoln,Superintendent of Public Instruction,John Cox,DEM,410011,7,43,130,180,
Lincoln,Superintendent of Public Instruction,Larry Huff,IND,410011,2,14,36,52,
Lincoln,Commissioner of Labor,Leslie Osborn,REP,410011,15,64,322,401,
Lincoln,Commissioner of Labor,Fred Dorrell,DEM,410011,6,44,112,162,
Lincoln,Commissioner of Labor,Brandt Dismukes,IND,410011,2,8,32,42,
Lincoln,Insurance Commissioner,Glen Mulready,REP,410011,17,67,337,421,
Lincoln,Insurance Commissioner,Kimberly Fobbs,DEM,410011,7,48,124,179,
Lincoln,Corporation Commissioner,Bob Anthony,REP,410011,14,63,328,405,
Lincoln,Corporation Commissioner,Ashley Nicole Mccray,DEM,410011,7,45,115,167,
Lincoln,Corporation Commissioner,Jackie Short,IND,410011,3,6,29,38,
Lincoln,U.S. House,Frank Lucas,REP,410011,17,74,362,453,3
Lincoln,U.S. House,Frankie Robbins,DEM,410011,7,41,111,159,3
Lincoln,State Senate,Jason Smalley,REP,410011,17,78,341,436,28
Lincoln,State Senate,Stephanie Sanders,IND,410011,6,29,115,150,28
Lincoln,State House,Kevin Wallace,REP,410011,17,74,336,427,32
Lincoln,State House,Christi Wolff,DEM,410011,7,41,133,181,32
Lincoln,Governor,Chris Powell,LIB,410012,0,0,30,30,
Lincoln,Governor,Kevin Stitt,REP,410012,8,63,243,314,
Lincoln,Governor,Drew Edmondson,DEM,410012,4,36,172,212,
Lincoln,Lieutenant Governor,Matt Pinnell,REP,410012,8,73,279,360,
Lincoln,Lieutenant Governor,Anastasia Pittman,DEM,410012,4,25,144,173,
Lincoln,Lieutenant Governor,Ivan Holmes,IND,410012,0,3,22,25,
Lincoln,State Auditor,John Yeutter,LIB,410012,3,11,91,105,
Lincoln,State Auditor,Cindy Byrd,REP,410012,8,85,331,424,
Lincoln,Attorney General,Mike Hunter,REP,410012,8,76,291,375,
Lincoln,Attorney General,Mark Myles,DEM,410012,4,25,152,181,
Lincoln,State Treasurer,Randy Mcdaniel,REP,410012,8,82,308,398,
Lincoln,State Treasurer,Charles De Coune,IND,410012,3,15,111,129,
Lincoln,Superintendent of Public Instruction,Joy Hofmeister,REP,410012,7,65,260,332,
Lincoln,Superintendent of Public Instruction,John Cox,DEM,410012,4,29,129,162,
Lincoln,Superintendent of Public Instruction,Larry Huff,IND,410012,1,6,52,59,
Lincoln,Commissioner of Labor,Leslie Osborn,REP,410012,8,70,293,371,
Lincoln,Commissioner of Labor,Fred Dorrell,DEM,410012,4,25,119,148,
Lincoln,Commissioner of Labor,Brandt Dismukes,IND,410012,0,4,32,36,
Lincoln,Insurance Commissioner,Glen Mulready,REP,410012,8,71,285,364,
Lincoln,Insurance Commissioner,Kimberly Fobbs,DEM,410012,4,29,158,191,
Lincoln,Corporation Commissioner,Bob Anthony,REP,410012,6,68,266,340,
Lincoln,Corporation Commissioner,Ashley Nicole Mccray,DEM,410012,5,28,148,181,
Lincoln,Corporation Commissioner,Jackie Short,IND,410012,1,4,31,36,
Lincoln,U.S. House,Frank Lucas,REP,410012,8,80,302,390,3
Lincoln,U.S. House,Frankie Robbins,DEM,410012,4,21,145,170,3
Lincoln,State Senate,Jason Smalley,REP,410012,8,76,297,381,28
Lincoln,State Senate,Stephanie Sanders,IND,410012,3,23,131,157,28
Lincoln,State House,Kevin Wallace,REP,410012,8,72,294,374,32
Lincoln,State House,Christi Wolff,DEM,410012,4,29,156,189,32
Lincoln,Governor,Chris Powell,LIB,410013,1,0,12,13,
Lincoln,Governor,Kevin Stitt,REP,410013,9,4,134,147,
Lincoln,Governor,Drew Edmondson,DEM,410013,0,2,49,51,
Lincoln,Lieutenant Governor,Matt Pinnell,REP,410013,8,4,142,154,
Lincoln,Lieutenant Governor,Anastasia Pittman,DEM,410013,2,2,43,47,
Lincoln,Lieutenant Governor,Ivan Holmes,IND,410013,0,0,8,8,
Lincoln,State Auditor,John Yeutter,LIB,410013,0,2,38,40,
Lincoln,State Auditor,Cindy Byrd,REP,410013,10,3,149,162,
Lincoln,Attorney General,Mike Hunter,REP,410013,9,4,150,163,
Lincoln,Attorney General,Mark Myles,DEM,410013,1,2,42,45,
Lincoln,State Treasurer,Randy Mcdaniel,REP,410013,9,4,147,160,
Lincoln,State Treasurer,Charles De Coune,IND,410013,1,1,40,42,
Lincoln,Superintendent of Public Instruction,Joy Hofmeister,REP,410013,7,3,126,136,
Lincoln,Superintendent of Public Instruction,John Cox,DEM,410013,1,3,42,46,
Lincoln,Superintendent of Public Instruction,Larry Huff,IND,410013,2,0,24,26,
Lincoln,Commissioner of Labor,Leslie Osborn,REP,410013,9,4,138,151,
Lincoln,Commissioner of Labor,Fred Dorrell,DEM,410013,1,2,40,43,
Lincoln,Commissioner of Labor,Brandt Dismukes,IND,410013,0,0,14,14,
Lincoln,Insurance Commissioner,Glen Mulready,REP,410013,9,4,141,154,
Lincoln,Insurance Commissioner,Kimberly Fobbs,DEM,410013,1,2,51,54,
Lincoln,Corporation Commissioner,Bob Anthony,REP,410013,8,3,137,148,
Lincoln,Corporation Commissioner,Ashley Nicole Mccray,DEM,410013,1,3,41,45,
Lincoln,Corporation Commissioner,Jackie Short,IND,410013,1,0,14,15,
Lincoln,U.S. House,Frank Lucas,REP,410013,8,4,150,162,3
Lincoln,U.S. House,Frankie Robbins,DEM,410013,2,2,43,47,3
Lincoln,State Senate,Jason Smalley,REP,410013,7,4,142,153,28
Lincoln,State Senate,Stephanie Sanders,IND,410013,3,2,43,48,28
Lincoln,State House,Kevin Wallace,REP,410013,7,4,147,158,32
Lincoln,State House,Christi Wolff,DEM,410013,2,2,43,47,32
Lincoln,Governor,Chris Powell,LIB,410015,1,0,47,48,
Lincoln,Governor,Kevin Stitt,REP,410015,17,19,543,579,
Lincoln,Governor,Drew Edmondson,DEM,410015,14,5,238,257,
Lincoln,Lieutenant Governor,Matt Pinnell,REP,410015,21,21,593,635,
Lincoln,Lieutenant Governor,Anastasia Pittman,DEM,410015,11,3,184,198,
Lincoln,Lieutenant Governor,Ivan Holmes,IND,410015,0,0,47,47,
Lincoln,State Auditor,John Yeutter,LIB,410015,5,1,163,169,
Lincoln,State Auditor,Cindy Byrd,REP,410015,25,21,635,681,
Lincoln,Attorney General,Mike Hunter,REP,410015,21,20,613,654,
Lincoln,Attorney General,Mark Myles,DEM,410015,11,4,210,225,
Lincoln,State Treasurer,Randy Mcdaniel,REP,410015,23,20,626,669,
Lincoln,State Treasurer,Charles De Coune,IND,410015,6,1,172,179,
Lincoln,Superintendent of Public Instruction,Joy Hofmeister,REP,410015,18,19,546,583,
Lincoln,Superintendent of Public Instruction,John Cox,DEM,410015,11,4,166,181,
Lincoln,Superintendent of Public Instruction,Larry Huff,IND,410015,3,1,112,116,
Lincoln,Commissioner of Labor,Leslie Osborn,REP,410015,23,21,586,630,
Lincoln,Commissioner of Labor,Fred Dorrell,DEM,410015,9,3,182,194,
Lincoln,Commissioner of Labor,Brandt Dismukes,IND,410015,1,0,51,52,
Lincoln,Insurance Commissioner,Glen Mulready,REP,410015,20,20,596,636,
Lincoln,Insurance Commissioner,Kimberly Fobbs,DEM,410015,13,4,224,241,
Lincoln,Corporation Commissioner,Bob Anthony,REP,410015,22,20,564,606,
Lincoln,Corporation Commissioner,Ashley Nicole Mccray,DEM,410015,11,4,190,205,
Lincoln,Corporation Commissioner,Jackie Short,IND,410015,0,0,68,68,
Lincoln,U.S. House,Frank Lucas,REP,410015,21,20,621,662,3
Lincoln,U.S. House,Frankie Robbins,DEM,410015,12,4,198,214,3
Lincoln,State Senate,Jason Smalley,REP,410015,17,20,568,605,28
Lincoln,State Senate,Stephanie Sanders,IND,410015,10,2,233,245,28
Lincoln,State House,Kevin Wallace,REP,410015,19,20,599,638,32
Lincoln,State House,Christi Wolff,DEM,410015,13,4,220,237,32
Lincoln,Governor,Chris Powell,LIB,410016,1,4,19,24,
Lincoln,Governor,Kevin Stitt,REP,410016,14,26,404,444,
Lincoln,Governor,Drew Edmondson,DEM,410016,10,7,138,155,
Lincoln,Lieutenant Governor,Matt Pinnell,REP,410016,17,31,447,495,
Lincoln,Lieutenant Governor,Anastasia Pittman,DEM,410016,7,3,97,107,
Lincoln,Lieutenant Governor,Ivan Holmes,IND,410016,1,3,18,22,
Lincoln,State Auditor,John Yeutter,LIB,410016,7,4,66,77,
Lincoln,State Auditor,Cindy Byrd,REP,410016,16,32,464,512,
Lincoln,Attorney General,Mike Hunter,REP,410016,15,32,455,502,
Lincoln,Attorney General,Mark Myles,DEM,410016,10,5,103,118,
Lincoln,State Treasurer,Randy Mcdaniel,REP,410016,18,31,458,507,
Lincoln,State Treasurer,Charles De Coune,IND,410016,5,5,74,84,
Lincoln,Superintendent of Public Instruction,Joy Hofmeister,REP,410016,14,25,385,424,
Lincoln,Superintendent of Public Instruction,John Cox,DEM,410016,8,7,112,127,
Lincoln,Superintendent of Public Instruction,Larry Huff,IND,410016,3,4,61,68,
Lincoln,Commissioner of Labor,Leslie Osborn,REP,410016,16,27,426,469,
Lincoln,Commissioner of Labor,Fred Dorrell,DEM,410016,7,7,93,107,
Lincoln,Commissioner of Labor,Brandt Dismukes,IND,410016,2,1,29,32,
Lincoln,Insurance Commissioner,Glen Mulready,REP,410016,16,27,446,489,
Lincoln,Insurance Commissioner,Kimberly Fobbs,DEM,410016,9,10,105,124,
Lincoln,Corporation Commissioner,Bob Anthony,REP,410016,16,27,428,471,
Lincoln,Corporation Commissioner,Ashley Nicole Mccray,DEM,410016,8,9,94,111,
Lincoln,Corporation Commissioner,Jackie Short,IND,410016,1,1,34,36,
Lincoln,U.S. House,Frank Lucas,REP,410016,17,31,461,509,3
Lincoln,U.S. House,Frankie Robbins,DEM,410016,8,6,98,112,3
Lincoln,State Senate,Jason Smalley,REP,410016,17,27,453,497,28
Lincoln,State Senate,Stephanie Sanders,IND,410016,6,9,80,95,28
Lincoln,State House,Kevin Wallace,REP,410016,17,30,441,488,32
Lincoln,State House,Christi Wolff,DEM,410016,8,7,114,129,32
Lincoln,Governor,Chris Powell,LIB,410017,0,0,9,9,
Lincoln,Governor,Kevin Stitt,REP,410017,8,12,105,125,
Lincoln,Governor,Drew Edmondson,DEM,410017,6,8,48,62,
Lincoln,Lieutenant Governor,Matt Pinnell,REP,410017,9,12,101,122,
Lincoln,Lieutenant Governor,Anastasia Pittman,DEM,410017,3,7,44,54,
Lincoln,Lieutenant Governor,Ivan Holmes,IND,410017,1,1,17,19,
Lincoln,State Auditor,John Yeutter,LIB,410017,1,2,27,30,
Lincoln,State Auditor,Cindy Byrd,REP,410017,9,18,122,149,
Lincoln,Attorney General,Mike Hunter,REP,410017,8,17,107,132,
Lincoln,Attorney General,Mark Myles,DEM,410017,5,3,52,60,
Lincoln,State Treasurer,Randy Mcdaniel,REP,410017,9,15,113,137,
Lincoln,State Treasurer,Charles De Coune,IND,410017,2,5,38,45,
Lincoln,Superintendent of Public Instruction,Joy Hofmeister,REP,410017,7,12,103,122,
Lincoln,Superintendent of Public Instruction,John Cox,DEM,410017,5,6,45,56,
Lincoln,Superintendent of Public Instruction,Larry Huff,IND,410017,2,2,13,17,
Lincoln,Commissioner of Labor,Leslie Osborn,REP,410017,7,14,96,117,
Lincoln,Commissioner of Labor,Fred Dorrell,DEM,410017,5,6,49,60,
Lincoln,Commissioner of Labor,Brandt Dismukes,IND,410017,1,0,14,15,
Lincoln,Insurance Commissioner,Glen Mulready,REP,410017,9,13,107,129,
Lincoln,Insurance Commissioner,Kimberly Fobbs,DEM,410017,4,7,53,64,
Lincoln,Corporation Commissioner,Bob Anthony,REP,410017,9,11,98,118,
Lincoln,Corporation Commissioner,Ashley Nicole Mccray,DEM,410017,5,7,51,63,
Lincoln,Corporation Commissioner,Jackie Short,IND,410017,0,2,11,13,
Lincoln,U.S. House,Frank Lucas,REP,410017,9,15,104,128,3
Lincoln,U.S. House,Frankie Robbins,DEM,410017,5,5,56,66,3
Lincoln,State Senate,Jason Smalley,REP,410017,9,16,111,136,28
Lincoln,State Senate,Stephanie Sanders,IND,410017,2,4,41,47,28
Lincoln,State House,Kevin Wallace,REP,410017,9,18,105,132,32
Lincoln,State House,Christi Wolff,DEM,410017,4,2,57,63,32
Lincoln,Governor,Chris Powell,LIB,410018,0,1,21,22,
Lincoln,Governor,Kevin Stitt,REP,410018,9,21,201,231,
Lincoln,Governor,Drew Edmondson,DEM,410018,9,8,130,147,
Lincoln,Lieutenant Governor,Matt Pinnell,REP,410018,9,24,235,268,
Lincoln,Lieutenant Governor,Anastasia Pittman,DEM,410018,8,6,96,110,
Lincoln,Lieutenant Governor,Ivan Holmes,IND,410018,1,1,15,17,
Lincoln,State Auditor,John Yeutter,LIB,410018,3,3,72,78,
Lincoln,State Auditor,Cindy Byrd,REP,410018,13,25,254,292,
Lincoln,Attorney General,Mike Hunter,REP,410018,11,21,243,275,
Lincoln,Attorney General,Mark Myles,DEM,410018,7,9,104,120,
Lincoln,State Treasurer,Randy Mcdaniel,REP,410018,15,25,247,287,
Lincoln,State Treasurer,Charles De Coune,IND,410018,1,4,75,80,
Lincoln,Superintendent of Public Instruction,Joy Hofmeister,REP,410018,10,22,206,238,
Lincoln,Superintendent of Public Instruction,John Cox,DEM,410018,8,7,109,124,
Lincoln,Superintendent of Public Instruction,Larry Huff,IND,410018,0,1,33,34,
Lincoln,Commissioner of Labor,Leslie Osborn,REP,410018,10,24,222,256,
Lincoln,Commissioner of Labor,Fred Dorrell,DEM,410018,8,5,101,114,
Lincoln,Commissioner of Labor,Brandt Dismukes,IND,410018,0,1,19,20,
Lincoln,Insurance Commissioner,Glen Mulready,REP,410018,13,23,234,270,
Lincoln,Insurance Commissioner,Kimberly Fobbs,DEM,410018,5,7,109,121,
Lincoln,Corporation Commissioner,Bob Anthony,REP,410018,15,24,218,257,
Lincoln,Corporation Commissioner,Ashley Nicole Mccray,DEM,410018,3,5,98,106,
Lincoln,Corporation Commissioner,Jackie Short,IND,410018,0,2,29,31,
Lincoln,U.S. House,Frank Lucas,REP,410018,13,24,254,291,3
Lincoln,U.S. House,Frankie Robbins,DEM,410018,5,7,96,108,3
Lincoln,State Senate,Jason Smalley,REP,410018,12,24,241,277,28
Lincoln,State Senate,Stephanie Sanders,IND,410018,4,6,88,98,28
Lincoln,State House,Kevin Wallace,REP,410018,12,23,230,265,32
Lincoln,State House,Christi Wolff,DEM,410018,6,8,116,130,32
Lincoln,Governor,Chris Powell,LIB,410019,0,0,21,21,
Lincoln,Governor,Kevin Stitt,REP,410019,8,15,358,381,
Lincoln,Governor,Drew Edmondson,DEM,410019,9,3,153,165,
Lincoln,Lieutenant Governor,Matt Pinnell,REP,410019,12,16,418,446,
Lincoln,Lieutenant Governor,Anastasia Pittman,DEM,410019,5,2,93,100,
Lincoln,Lieutenant Governor,Ivan Holmes,IND,410019,0,0,17,17,
Lincoln,State Auditor,John Yeutter,LIB,410019,5,1,74,80,
Lincoln,State Auditor,Cindy Byrd,REP,410019,12,16,439,467,
Lincoln,Attorney General,Mike Hunter,REP,410019,12,15,420,447,
Lincoln,Attorney General,Mark Myles,DEM,410019,5,3,111,119,
Lincoln,State Treasurer,Randy Mcdaniel,REP,410019,13,15,429,457,
Lincoln,State Treasurer,Charles De Coune,IND,410019,4,2,82,88,
Lincoln,Superintendent of Public Instruction,Joy Hofmeister,REP,410019,11,13,366,390,
Lincoln,Superintendent of Public Instruction,John Cox,DEM,410019,6,5,103,114,
Lincoln,Superintendent of Public Instruction,Larry Huff,IND,410019,0,0,59,59,
Lincoln,Commissioner of Labor,Leslie Osborn,REP,410019,11,15,390,416,
Lincoln,Commissioner of Labor,Fred Dorrell,DEM,410019,6,3,112,121,
Lincoln,Commissioner of Labor,Brandt Dismukes,IND,410019,0,0,22,22,
Lincoln,Insurance Commissioner,Glen Mulready,REP,410019,11,15,394,420,
Lincoln,Insurance Commissioner,Kimberly Fobbs,DEM,410019,5,3,127,135,
Lincoln,Corporation Commissioner,Bob Anthony,REP,410019,11,14,381,406,
Lincoln,Corporation Commissioner,Ashley Nicole Mccray,DEM,410019,5,3,103,111,
Lincoln,Corporation Commissioner,Jackie Short,IND,410019,1,1,41,43,
Lincoln,U.S. House,Frank Lucas,REP,410019,11,15,422,448,3
Lincoln,U.S. House,Frankie Robbins,DEM,410019,6,3,105,114,3
Lincoln,State Senate,Jason Smalley,REP,410019,12,14,408,434,28
Lincoln,State Senate,Stephanie Sanders,IND,410019,5,4,109,118,28
Lincoln,State House,Kevin Wallace,REP,410019,11,14,400,425,32
Lincoln,State House,Christi Wolff,DEM,410019,6,4,126,136,32
Lincoln,Governor,Chris Powell,LIB,410020,0,1,23,24,
Lincoln,Governor,Kevin Stitt,REP,410020,4,9,253,266,
Lincoln,Governor,Drew Edmondson,DEM,410020,4,5,144,153,
Lincoln,Lieutenant Governor,Matt Pinnell,REP,410020,6,9,284,299,
Lincoln,Lieutenant Governor,Anastasia Pittman,DEM,410020,2,4,106,112,
Lincoln,Lieutenant Governor,Ivan Holmes,IND,410020,0,2,30,32,
Lincoln,State Auditor,John Yeutter,LIB,410020,1,4,87,92,
Lincoln,State Auditor,Cindy Byrd,REP,410020,7,11,304,322,
Lincoln,Attorney General,Mike Hunter,REP,410020,6,9,292,307,
Lincoln,Attorney General,Mark Myles,DEM,410020,2,5,124,131,
Lincoln,State Treasurer,Randy Mcdaniel,REP,410020,7,9,296,312,
Lincoln,State Treasurer,Charles De Coune,IND,410020,1,6,93,100,
Lincoln,Superintendent of Public Instruction,Joy Hofmeister,REP,410020,2,8,266,276,
Lincoln,Superintendent of Public Instruction,John Cox,DEM,410020,4,4,105,113,
Lincoln,Superintendent of Public Instruction,Larry Huff,IND,410020,2,3,47,52,
Lincoln,Commissioner of Labor,Leslie Osborn,REP,410020,6,9,282,297,
Lincoln,Commissioner of Labor,Fred Dorrell,DEM,410020,2,4,104,110,
Lincoln,Commissioner of Labor,Brandt Dismukes,IND,410020,0,2,29,31,
Lincoln,Insurance Commissioner,Glen Mulready,REP,410020,6,10,290,306,
Lincoln,Insurance Commissioner,Kimberly Fobbs,DEM,410020,2,5,126,133,
Lincoln,Corporation Commissioner,Bob Anthony,REP,410020,5,9,263,277,
Lincoln,Corporation Commissioner,Ashley Nicole Mccray,DEM,410020,3,5,114,122,
Lincoln,Corporation Commissioner,Jackie Short,IND,410020,0,1,41,42,
Lincoln,U.S. House,Frank Lucas,REP,410020,7,8,299,314,3
Lincoln,U.S. House,Frankie Robbins,DEM,410020,1,5,116,122,3
Lincoln,State Senate,Jason Smalley,REP,410020,5,10,282,297,28
Lincoln,State Senate,Stephanie Sanders,IND,410020,3,4,107,114,28
Lincoln,State House,Kevin Wallace,REP,410020,5,7,289,301,32
Lincoln,State House,Christi Wolff,DEM,410020,3,7,130,140,32
Lincoln,Governor,Chris Powell,LIB,410021,0,0,35,35,
Lincoln,Governor,Kevin Stitt,REP,410021,20,12,469,501,
Lincoln,Governor,Drew Edmondson,DEM,410021,15,6,200,221,
Lincoln,Lieutenant Governor,Matt Pinnell,REP,410021,24,11,526,561,
Lincoln,Lieutenant Governor,Anastasia Pittman,DEM,410021,10,6,149,165,
Lincoln,Lieutenant Governor,Ivan Holmes,IND,410021,1,1,28,30,
Lincoln,State Auditor,John Yeutter,LIB,410021,11,3,114,128,
Lincoln,State Auditor,Cindy Byrd,REP,410021,20,15,558,593,
Lincoln,Attorney General,Mike Hunter,REP,410021,19,11,536,566,
Lincoln,Attorney General,Mark Myles,DEM,410021,16,7,159,182,
Lincoln,State Treasurer,Randy Mcdaniel,REP,410021,21,15,556,592,
Lincoln,State Treasurer,Charles De Coune,IND,410021,12,3,116,131,
Lincoln,Superintendent of Public Instruction,Joy Hofmeister,REP,410021,18,11,470,499,
Lincoln,Superintendent of Public Instruction,John Cox,DEM,410021,10,7,152,169,
Lincoln,Superintendent of Public Instruction,Larry Huff,IND,410021,7,0,74,81,
Lincoln,Commissioner of Labor,Leslie Osborn,REP,410021,23,13,498,534,
Lincoln,Commissioner of Labor,Fred Dorrell,DEM,410021,9,5,147,161,
Lincoln,Commissioner of Labor,Brandt Dismukes,IND,410021,3,0,49,52,
Lincoln,Insurance Commissioner,Glen Mulready,REP,410021,16,13,521,550,
Lincoln,Insurance Commissioner,Kimberly Fobbs,DEM,410021,18,5,171,194,
Lincoln,Corporation Commissioner,Bob Anthony,REP,410021,18,14,493,525,
Lincoln,Corporation Commissioner,Ashley Nicole Mccray,DEM,410021,14,3,150,167,
Lincoln,Corporation Commissioner,Jackie Short,IND,410021,3,1,53,57,
Lincoln,U.S. House,Frank Lucas,REP,410021,22,15,552,589,3
Lincoln,U.S. House,Frankie Robbins,DEM,410021,13,3,150,166,3
Lincoln,State Senate,Jason Smalley,REP,410021,21,14,521,556,28
Lincoln,State Senate,Stephanie Sanders,IND,410021,12,4,162,178,28
Lincoln,State House,Kevin Wallace,REP,410021,22,14,509,545,32
Lincoln,State House,Christi Wolff,DEM,410021,13,4,191,208,32
Lincoln,Governor,Chris Powell,LIB,410022,0,0,23,23,
Lincoln,Governor,Kevin Stitt,REP,410022,11,11,452,474,
Lincoln,Governor,Drew Edmondson,DEM,410022,4,4,241,249,
Lincoln,Lieutenant Governor,Matt Pinnell,REP,410022,11,11,519,541,
Lincoln,Lieutenant Governor,Anastasia Pittman,DEM,410022,4,2,168,174,
Lincoln,Lieutenant Governor,Ivan Holmes,IND,410022,0,2,29,31,
Lincoln,State Auditor,John Yeutter,LIB,410022,4,2,120,126,
Lincoln,State Auditor,Cindy Byrd,REP,410022,10,11,553,574,
Lincoln,Attorney General,Mike Hunter,REP,410022,11,12,524,547,
Lincoln,Attorney General,Mark Myles,DEM,410022,4,3,188,195,
Lincoln,State Treasurer,Randy Mcdaniel,REP,410022,10,10,553,573,
Lincoln,State Treasurer,Charles De Coune,IND,410022,4,3,119,126,
Lincoln,Superintendent of Public Instruction,Joy Hofmeister,REP,410022,7,9,478,494,
Lincoln,Superintendent of Public Instruction,John Cox,DEM,410022,5,4,188,197,
Lincoln,Superintendent of Public Instruction,Larry Huff,IND,410022,2,2,45,49,
Lincoln,Commissioner of Labor,Leslie Osborn,REP,410022,10,11,514,535,
Lincoln,Commissioner of Labor,Fred Dorrell,DEM,410022,4,3,170,177,
Lincoln,Commissioner of Labor,Brandt Dismukes,IND,410022,1,1,23,25,
Lincoln,Insurance Commissioner,Glen Mulready,REP,410022,11,11,515,537,
Lincoln,Insurance Commissioner,Kimberly Fobbs,DEM,410022,4,4,191,199,
Lincoln,Corporation Commissioner,Bob Anthony,REP,410022,10,10,507,527,
Lincoln,Corporation Commissioner,Ashley Nicole Mccray,DEM,410022,4,4,171,179,
Lincoln,Corporation Commissioner,Jackie Short,IND,410022,1,1,33,35,
Lincoln,U.S. House,Frank Lucas,REP,410022,11,12,544,567,3
Lincoln,U.S. House,Frankie Robbins,DEM,410022,4,3,167,174,3
Lincoln,State Senate,Jason Smalley,REP,410022,10,10,559,579,28
Lincoln,State Senate,Stephanie Sanders,IND,410022,4,3,122,129,28
Lincoln,State House,Kevin Wallace,REP,410022,11,10,491,512,32
Lincoln,State House,Christi Wolff,DEM,410022,4,4,216,224,32
Logan,Governor,Chris Powell,LIB,420101,1,1,21,23,
Logan,Governor,Kevin Stitt,REP,420101,41,33,390,464,
Logan,Governor,Drew Edmondson,DEM,420101,17,9,101,127,
Logan,Lieutenant Governor,Matt Pinnell,REP,420101,48,36,425,509,
Logan,Lieutenant Governor,Anastasia Pittman,DEM,420101,10,6,65,81,
Logan,Lieutenant Governor,Ivan Holmes,IND,420101,0,1,16,17,
Logan,State Auditor,John Yeutter,LIB,420101,3,5,57,65,
Logan,State Auditor,Cindy Byrd,REP,420101,55,37,433,525,
Logan,Attorney General,Mike Hunter,REP,420101,47,35,429,511,
Logan,Attorney General,Mark Myles,DEM,420101,11,8,80,99,
Logan,State Treasurer,Randy Mcdaniel,REP,420101,49,37,417,503,
Logan,State Treasurer,Charles De Coune,IND,420101,9,4,74,87,
Logan,Superintendent of Public Instruction,Joy Hofmeister,REP,420101,50,32,367,449,
Logan,Superintendent of Public Instruction,John Cox,DEM,420101,6,5,75,86,
Logan,Superintendent of Public Instruction,Larry Huff,IND,420101,1,6,64,71,
Logan,Commissioner of Labor,Leslie Osborn,REP,420101,52,37,410,499,
Logan,Commissioner of Labor,Fred Dorrell,DEM,420101,6,6,65,77,
Logan,Commissioner of Labor,Brandt Dismukes,IND,420101,0,0,24,24,
Logan,Insurance Commissioner,Glen Mulready,REP,420101,49,33,409,491,
Logan,Insurance Commissioner,Kimberly Fobbs,DEM,420101,9,10,87,106,
Logan,Corporation Commissioner,Bob Anthony,REP,420101,45,36,385,466,
Logan,Corporation Commissioner,Ashley Nicole Mccray,DEM,420101,9,6,82,97,
Logan,Corporation Commissioner,Jackie Short,IND,420101,4,1,35,40,
Logan,U.S. House,Frank Lucas,REP,420101,50,34,436,520,3
Logan,U.S. House,Frankie Robbins,DEM,420101,8,9,71,88,3
Logan,State Senate,Chuck Hall,REP,420101,43,34,415,492,20
Logan,State Senate,Heady Coleman,DEM,420101,15,9,87,111,20
Logan,State House,Garry Mize,REP,420101,50,33,417,500,31
Logan,State House,Kara Sawyer,DEM,420101,8,10,86,104,31
Logan,Governor,Chris Powell,LIB,420102,0,0,19,19,
Logan,Governor,Kevin Stitt,REP,420102,33,66,385,484,
Logan,Governor,Drew Edmondson,DEM,420102,13,28,170,211,
Logan,Lieutenant Governor,Matt Pinnell,REP,420102,40,66,423,529,
Logan,Lieutenant Governor,Anastasia Pittman,DEM,420102,6,20,133,159,
Logan,Lieutenant Governor,Ivan Holmes,IND,420102,0,4,14,18,
Logan,State Auditor,John Yeutter,LIB,420102,2,16,94,112,
Logan,State Auditor,Cindy Byrd,REP,420102,43,68,456,567,
Logan,Attorney General,Mike Hunter,REP,420102,36,69,428,533,
Logan,Attorney General,Mark Myles,DEM,420102,10,23,138,171,
Logan,State Treasurer,Randy Mcdaniel,REP,420102,40,67,434,541,
Logan,State Treasurer,Charles De Coune,IND,420102,5,15,113,133,
Logan,Superintendent of Public Instruction,Joy Hofmeister,REP,420102,36,63,393,492,
Logan,Superintendent of Public Instruction,John Cox,DEM,420102,8,22,124,154,
Logan,Superintendent of Public Instruction,Larry Huff,IND,420102,2,8,51,61,
Logan,Commissioner of Labor,Leslie Osborn,REP,420102,36,68,406,510,
Logan,Commissioner of Labor,Fred Dorrell,DEM,420102,8,19,115,142,
Logan,Commissioner of Labor,Brandt Dismukes,IND,420102,2,4,40,46,
Logan,Insurance Commissioner,Glen Mulready,REP,420102,33,70,413,516,
Logan,Insurance Commissioner,Kimberly Fobbs,DEM,420102,11,21,148,180,
Logan,Corporation Commissioner,Bob Anthony,REP,420102,32,66,410,508,
Logan,Corporation Commissioner,Ashley Nicole Mccray,DEM,420102,13,20,126,159,
Logan,Corporation Commissioner,Jackie Short,IND,420102,1,6,34,41,
Logan,U.S. House,Frank Lucas,REP,420102,35,69,432,536,3
Logan,U.S. House,Frankie Robbins,DEM,420102,11,23,140,174,3
Logan,State Senate,Chuck Hall,REP,420102,33,63,368,464,20
Logan,State Senate,Heady Coleman,DEM,420102,13,27,198,238,20
Logan,State House,Garry Mize,REP,420102,37,68,420,525,31
Logan,State House,Kara Sawyer,DEM,420102,9,24,149,182,31
Logan,Governor,Chris Powell,LIB,420103,2,1,33,36,
Logan,Governor,Kevin Stitt,REP,420103,95,118,976,1189,
Logan,Governor,Drew Edmondson,DEM,420103,86,62,510,658,
Logan,Lieutenant Governor,Matt Pinnell,REP,420103,119,129,1152,1400,
Logan,Lieutenant Governor,Anastasia Pittman,DEM,420103,61,48,323,432,
Logan,Lieutenant Governor,Ivan Holmes,IND,420103,6,4,34,44,
Logan,State Auditor,John Yeutter,LIB,420103,48,29,240,317,
Logan,State Auditor,Cindy Byrd,REP,420103,121,145,1199,1465,
Logan,Attorney General,Mike Hunter,REP,420103,114,130,1137,1381,
Logan,Attorney General,Mark Myles,DEM,420103,70,49,362,481,
Logan,State Treasurer,Randy Mcdaniel,REP,420103,119,133,1156,1408,
Logan,State Treasurer,Charles De Coune,IND,420103,52,38,285,375,
Logan,Superintendent of Public Instruction,Joy Hofmeister,REP,420103,109,113,1044,1266,
Logan,Superintendent of Public Instruction,John Cox,DEM,420103,56,51,333,440,
Logan,Superintendent of Public Instruction,Larry Huff,IND,420103,21,16,123,160,
Logan,Commissioner of Labor,Leslie Osborn,REP,420103,113,129,1115,1357,
Logan,Commissioner of Labor,Fred Dorrell,DEM,420103,58,46,317,421,
Logan,Commissioner of Labor,Brandt Dismukes,IND,420103,11,5,59,75,
Logan,Insurance Commissioner,Glen Mulready,REP,420103,114,123,1129,1366,
Logan,Insurance Commissioner,Kimberly Fobbs,DEM,420103,68,56,363,487,
Logan,Corporation Commissioner,Bob Anthony,REP,420103,117,129,1058,1304,
Logan,Corporation Commissioner,Ashley Nicole Mccray,DEM,420103,60,42,346,448,
Logan,Corporation Commissioner,Jackie Short,IND,420103,8,8,89,105,
Logan,U.S. House,Frank Lucas,REP,420103,119,127,1157,1403,3
Logan,U.S. House,Frankie Robbins,DEM,420103,67,53,350,470,3
Logan,State Senate,Chuck Hall,REP,420103,109,127,1110,1346,20
Logan,State Senate,Heady Coleman,DEM,420103,75,52,385,512,20
Logan,State House,Garry Mize,REP,420103,114,123,1120,1357,31
Logan,State House,Kara Sawyer,DEM,420103,71,56,374,501,31
Logan,Governor,Chris Powell,LIB,420104,4,1,34,39,
Logan,Governor,Kevin Stitt,REP,420104,77,110,624,811,
Logan,Governor,Drew Edmondson,DEM,420104,50,43,224,317,
Logan,Lieutenant Governor,Matt Pinnell,REP,420104,93,115,685,893,
Logan,Lieutenant Governor,Anastasia Pittman,DEM,420104,37,33,165,235,
Logan,Lieutenant Governor,Ivan Holmes,IND,420104,2,6,27,35,
Logan,State Auditor,John Yeutter,LIB,420104,23,19,155,197,
Logan,State Auditor,Cindy Byrd,REP,420104,98,129,695,922,
Logan,Attorney General,Mike Hunter,REP,420104,87,120,697,904,
Logan,Attorney General,Mark Myles,DEM,420104,44,34,177,255,
Logan,State Treasurer,Randy Mcdaniel,REP,420104,91,119,689,899,
Logan,State Treasurer,Charles De Coune,IND,420104,34,29,158,221,
Logan,Superintendent of Public Instruction,Joy Hofmeister,REP,420104,88,108,620,816,
Logan,Superintendent of Public Instruction,John Cox,DEM,420104,29,31,155,215,
Logan,Superintendent of Public Instruction,Larry Huff,IND,420104,14,14,95,123,
Logan,Commissioner of Labor,Leslie Osborn,REP,420104,94,117,663,874,
Logan,Commissioner of Labor,Fred Dorrell,DEM,420104,30,32,146,208,
Logan,Commissioner of Labor,Brandt Dismukes,IND,420104,7,3,58,68,
Logan,Insurance Commissioner,Glen Mulready,REP,420104,89,119,687,895,
Logan,Insurance Commissioner,Kimberly Fobbs,DEM,420104,40,35,181,256,
Logan,Corporation Commissioner,Bob Anthony,REP,420104,81,114,643,838,
Logan,Corporation Commissioner,Ashley Nicole Mccray,DEM,420104,40,29,166,235,
Logan,Corporation Commissioner,Jackie Short,IND,420104,8,10,61,79,
Logan,U.S. House,Frank Lucas,REP,420104,92,121,710,923,3
Logan,U.S. House,Frankie Robbins,DEM,420104,39,31,164,234,3
Logan,State Senate,Chuck Hall,REP,420104,90,116,693,899,20
Logan,State Senate,Heady Coleman,DEM,420104,39,37,173,249,20
Logan,State House,Garry Mize,REP,420104,92,118,682,892,31
Logan,State House,Kara Sawyer,DEM,420104,38,35,186,259,31
Logan,Governor,Chris Powell,LIB,420105,2,1,31,34,
Logan,Governor,Kevin Stitt,REP,420105,27,48,329,404,
Logan,Governor,Drew Edmondson,DEM,420105,15,25,175,215,
Logan,Lieutenant Governor,Matt Pinnell,REP,420105,31,51,371,453,
Logan,Lieutenant Governor,Anastasia Pittman,DEM,420105,13,17,137,167,
Logan,Lieutenant Governor,Ivan Holmes,IND,420105,2,5,22,29,
Logan,State Auditor,John Yeutter,LIB,420105,6,11,107,124,
Logan,State Auditor,Cindy Byrd,REP,420105,32,55,397,484,
Logan,Attorney General,Mike Hunter,REP,420105,32,55,390,477,
Logan,Attorney General,Mark Myles,DEM,420105,14,18,139,171,
Logan,State Treasurer,Randy Mcdaniel,REP,420105,31,52,392,475,
Logan,State Treasurer,Charles De Coune,IND,420105,7,15,111,133,
Logan,Superintendent of Public Instruction,Joy Hofmeister,REP,420105,30,54,337,421,
Logan,Superintendent of Public Instruction,John Cox,DEM,420105,11,16,139,166,
Logan,Superintendent of Public Instruction,Larry Huff,IND,420105,5,4,51,60,
Logan,Commissioner of Labor,Leslie Osborn,REP,420105,31,51,361,443,
Logan,Commissioner of Labor,Fred Dorrell,DEM,420105,13,14,130,157,
Logan,Commissioner of Labor,Brandt Dismukes,IND,420105,2,6,32,40,
Logan,Insurance Commissioner,Glen Mulready,REP,420105,32,51,373,456,
Logan,Insurance Commissioner,Kimberly Fobbs,DEM,420105,14,23,152,189,
Logan,Corporation Commissioner,Bob Anthony,REP,420105,31,55,359,445,
Logan,Corporation Commissioner,Ashley Nicole Mccray,DEM,420105,13,15,129,157,
Logan,Corporation Commissioner,Jackie Short,IND,420105,2,3,40,45,
Logan,U.S. House,Frank Lucas,REP,420105,34,53,384,471,3
Logan,U.S. House,Frankie Robbins,DEM,420105,12,20,144,176,3
Logan,State Senate,Chuck Hall,REP,420105,29,51,350,430,20
Logan,State Senate,Heady Coleman,DEM,420105,16,22,171,209,20
Logan,State House,Garry Mize,REP,420105,31,51,364,446,31
Logan,State House,Kara Sawyer,DEM,420105,15,22,159,196,31
Logan,Governor,Chris Powell,LIB,420106,2,3,35,40,
Logan,Governor,Kevin Stitt,REP,420106,57,94,643,794,
Logan,Governor,Drew Edmondson,DEM,420106,57,50,320,427,
Logan,Lieutenant Governor,Matt Pinnell,REP,420106,63,104,754,921,
Logan,Lieutenant Governor,Anastasia Pittman,DEM,420106,51,42,208,301,
Logan,Lieutenant Governor,Ivan Holmes,IND,420106,4,1,24,29,
Logan,State Auditor,John Yeutter,LIB,420106,23,26,154,203,
Logan,State Auditor,Cindy Byrd,REP,420106,78,109,793,980,
Logan,Attorney General,Mike Hunter,REP,420106,67,105,764,936,
Logan,Attorney General,Mark Myles,DEM,420106,49,42,221,312,
Logan,State Treasurer,Randy Mcdaniel,REP,420106,73,113,762,948,
Logan,State Treasurer,Charles De Coune,IND,420106,28,23,181,232,
Logan,Superintendent of Public Instruction,Joy Hofmeister,REP,420106,64,102,691,857,
Logan,Superintendent of Public Instruction,John Cox,DEM,420106,42,36,202,280,
Logan,Superintendent of Public Instruction,Larry Huff,IND,420106,11,8,93,112,
Logan,Commissioner of Labor,Leslie Osborn,REP,420106,71,101,749,921,
Logan,Commissioner of Labor,Fred Dorrell,DEM,420106,43,36,179,258,
Logan,Commissioner of Labor,Brandt Dismukes,IND,420106,2,5,38,45,
Logan,Insurance Commissioner,Glen Mulready,REP,420106,63,106,745,914,
Logan,Insurance Commissioner,Kimberly Fobbs,DEM,420106,52,39,223,314,
Logan,Corporation Commissioner,Bob Anthony,REP,420106,69,103,706,878,
Logan,Corporation Commissioner,Ashley Nicole Mccray,DEM,420106,41,30,208,279,
Logan,Corporation Commissioner,Jackie Short,IND,420106,5,11,54,70,
Logan,U.S. House,Frank Lucas,REP,420106,70,104,764,938,3
Logan,U.S. House,Frankie Robbins,DEM,420106,46,43,218,307,3
Logan,State Senate,Chuck Hall,REP,420106,64,100,746,910,20
Logan,State Senate,Heady Coleman,DEM,420106,52,45,228,325,20
Logan,State House,Garry Mize,REP,420106,67,101,737,905,31
Logan,State House,Kara Sawyer,DEM,420106,49,43,239,331,31
Logan,Governor,Chris Powell,LIB,420201,0,0,4,4,
Logan,Governor,Kevin Stitt,REP,420201,0,0,69,69,
Logan,Governor,Drew Edmondson,DEM,420201,1,1,46,48,
Logan,Lieutenant Governor,Matt Pinnell,REP,420201,1,0,77,78,
Logan,Lieutenant Governor,Anastasia Pittman,DEM,420201,0,1,38,39,
Logan,Lieutenant Governor,Ivan Holmes,IND,420201,0,0,2,2,
Logan,State Auditor,John Yeutter,LIB,420201,0,1,28,29,
Logan,State Auditor,Cindy Byrd,REP,420201,1,0,84,85,
Logan,Attorney General,Mike Hunter,REP,420201,0,0,80,80,
Logan,Attorney General,Mark Myles,DEM,420201,1,1,37,39,
Logan,State Treasurer,Randy Mcdaniel,REP,420201,1,0,84,85,
Logan,State Treasurer,Charles De Coune,IND,420201,0,1,29,30,
Logan,Superintendent of Public Instruction,Joy Hofmeister,REP,420201,0,0,68,68,
Logan,Superintendent of Public Instruction,John Cox,DEM,420201,1,1,34,36,
Logan,Superintendent of Public Instruction,Larry Huff,IND,420201,0,0,16,16,
Logan,Commissioner of Labor,Leslie Osborn,REP,420201,1,0,77,78,
Logan,Commissioner of Labor,Fred Dorrell,DEM,420201,0,1,29,30,
Logan,Commissioner of Labor,Brandt Dismukes,IND,420201,0,0,11,11,
Logan,Insurance Commissioner,Glen Mulready,REP,420201,1,0,79,80,
Logan,Insurance Commissioner,Kimberly Fobbs,DEM,420201,0,1,35,36,
Logan,Corporation Commissioner,Bob Anthony,REP,420201,1,0,72,73,
Logan,Corporation Commissioner,Ashley Nicole Mccray,DEM,420201,0,1,33,34,
Logan,Corporation Commissioner,Jackie Short,IND,420201,0,0,11,11,
Logan,U.S. House,Frank Lucas,REP,420201,1,0,83,84,3
Logan,U.S. House,Frankie Robbins,DEM,420201,0,1,33,34,3
Logan,State Senate,Chuck Hall,REP,420201,1,0,71,72,20
Logan,State Senate,Heady Coleman,DEM,420201,0,1,44,45,20
Logan,Governor,Chris Powell,LIB,420203,1,0,14,15,
Logan,Governor,Kevin Stitt,REP,420203,15,16,172,203,
Logan,Governor,Drew Edmondson,DEM,420203,12,10,95,117,
Logan,Lieutenant Governor,Matt Pinnell,REP,420203,16,16,189,221,
Logan,Lieutenant Governor,Anastasia Pittman,DEM,420203,9,10,77,96,
Logan,Lieutenant Governor,Ivan Holmes,IND,420203,2,0,14,16,
Logan,State Auditor,John Yeutter,LIB,420203,7,9,55,71,
Logan,State Auditor,Cindy Byrd,REP,420203,19,14,200,233,
Logan,Attorney General,Mike Hunter,REP,420203,16,16,196,228,
Logan,Attorney General,Mark Myles,DEM,420203,11,10,82,103,
Logan,State Treasurer,Randy Mcdaniel,REP,420203,21,15,189,225,
Logan,State Treasurer,Charles De Coune,IND,420203,6,10,64,80,
Logan,Superintendent of Public Instruction,Joy Hofmeister,REP,420203,13,15,172,200,
Logan,Superintendent of Public Instruction,John Cox,DEM,420203,13,10,67,90,
Logan,Superintendent of Public Instruction,Larry Huff,IND,420203,2,1,39,42,
Logan,Commissioner of Labor,Leslie Osborn,REP,420203,17,18,185,220,
Logan,Commissioner of Labor,Fred Dorrell,DEM,420203,10,7,70,87,
Logan,Commissioner of Labor,Brandt Dismukes,IND,420203,1,1,24,26,
Logan,Insurance Commissioner,Glen Mulready,REP,420203,16,13,190,219,
Logan,Insurance Commissioner,Kimberly Fobbs,DEM,420203,10,12,83,105,
Logan,Corporation Commissioner,Bob Anthony,REP,420203,17,14,176,207,
Logan,Corporation Commissioner,Ashley Nicole Mccray,DEM,420203,8,10,76,94,
Logan,Corporation Commissioner,Jackie Short,IND,420203,2,2,26,30,
Logan,U.S. House,Frank Lucas,REP,420203,19,18,202,239,3
Logan,U.S. House,Frankie Robbins,DEM,420203,9,8,73,90,3
Logan,State Senate,Chuck Hall,REP,420203,14,14,175,203,20
Logan,State Senate,Heady Coleman,DEM,420203,14,12,98,124,20
Logan,State House,Kevin Wallace,REP,420203,16,15,195,226,32
Logan,State House,Christi Wolff,DEM,420203,11,11,77,99,32
Logan,Governor,Chris Powell,LIB,420204,2,6,39,47,
Logan,Governor,Kevin Stitt,REP,420204,18,114,483,615,
Logan,Governor,Drew Edmondson,DEM,420204,17,73,286,376,
Logan,Lieutenant Governor,Matt Pinnell,REP,420204,20,123,536,679,
Logan,Lieutenant Governor,Anastasia Pittman,DEM,420204,15,66,224,305,
Logan,Lieutenant Governor,Ivan Holmes,IND,420204,2,4,40,46,
Logan,State Auditor,John Yeutter,LIB,420204,7,33,191,231,
Logan,State Auditor,Cindy Byrd,REP,420204,25,145,565,735,
Logan,Attorney General,Mike Hunter,REP,420204,22,132,545,699,
Logan,Attorney General,Mark Myles,DEM,420204,15,61,254,330,
Logan,State Treasurer,Randy Mcdaniel,REP,420204,25,124,546,695,
Logan,State Treasurer,Charles De Coune,IND,420204,9,55,207,271,
Logan,Superintendent of Public Instruction,Joy Hofmeister,REP,420204,22,127,493,642,
Logan,Superintendent of Public Instruction,John Cox,DEM,420204,12,54,218,284,
Logan,Superintendent of Public Instruction,Larry Huff,IND,420204,3,13,85,101,
Logan,Commissioner of Labor,Leslie Osborn,REP,420204,20,113,517,650,
Logan,Commissioner of Labor,Fred Dorrell,DEM,420204,13,70,222,305,
Logan,Commissioner of Labor,Brandt Dismukes,IND,420204,3,9,47,59,
Logan,Insurance Commissioner,Glen Mulready,REP,420204,23,131,535,689,
Logan,Insurance Commissioner,Kimberly Fobbs,DEM,420204,14,62,248,324,
Logan,Corporation Commissioner,Bob Anthony,REP,420204,21,124,506,651,
Logan,Corporation Commissioner,Ashley Nicole Mccray,DEM,420204,14,59,227,300,
Logan,Corporation Commissioner,Jackie Short,IND,420204,2,11,60,73,
Logan,U.S. House,Frank Lucas,REP,420204,22,133,564,719,3
Logan,U.S. House,Frankie Robbins,DEM,420204,14,61,229,304,3
Logan,State Senate,Chuck Hall,REP,420204,21,119,458,598,20
Logan,State Senate,Heady Coleman,DEM,420204,16,75,337,428,20
Logan,State House,Garry Mize,REP,420204,24,124,545,693,31
Logan,State House,Kara Sawyer,DEM,420204,13,72,249,334,31
Logan,Governor,Chris Powell,LIB,420205,8,9,63,80,
Logan,Governor,Kevin Stitt,REP,420205,26,111,692,829,
Logan,Governor,Drew Edmondson,DEM,420205,32,73,307,412,
Logan,Lieutenant Governor,Matt Pinnell,REP,420205,38,130,774,942,
Logan,Lieutenant Governor,Anastasia Pittman,DEM,420205,23,53,240,316,
Logan,Lieutenant Governor,Ivan Holmes,IND,420205,2,10,41,53,
Logan,State Auditor,John Yeutter,LIB,420205,15,30,190,235,
Logan,State Auditor,Cindy Byrd,REP,420205,41,148,815,1004,
Logan,Attorney General,Mike Hunter,REP,420205,41,134,810,985,
Logan,Attorney General,Mark Myles,DEM,420205,25,58,241,324,
Logan,State Treasurer,Randy Mcdaniel,REP,420205,39,135,811,985,
Logan,State Treasurer,Charles De Coune,IND,420205,20,44,187,251,
Logan,Superintendent of Public Instruction,Joy Hofmeister,REP,420205,33,114,703,850,
Logan,Superintendent of Public Instruction,John Cox,DEM,420205,23,58,240,321,
Logan,Superintendent of Public Instruction,Larry Huff,IND,420205,9,21,111,141,
Logan,Commissioner of Labor,Leslie Osborn,REP,420205,34,130,745,909,
Logan,Commissioner of Labor,Fred Dorrell,DEM,420205,24,51,237,312,
Logan,Commissioner of Labor,Brandt Dismukes,IND,420205,5,10,66,81,
Logan,Insurance Commissioner,Glen Mulready,REP,420205,40,137,778,955,
Logan,Insurance Commissioner,Kimberly Fobbs,DEM,420205,23,56,266,345,
Logan,Corporation Commissioner,Bob Anthony,REP,420205,35,127,718,880,
Logan,Corporation Commissioner,Ashley Nicole Mccray,DEM,420205,23,55,242,320,
Logan,Corporation Commissioner,Jackie Short,IND,420205,8,12,89,109,
Logan,U.S. House,Frank Lucas,REP,420205,44,142,803,989,3
Logan,U.S. House,Frankie Robbins,DEM,420205,22,53,251,326,3
Logan,State Senate,Chuck Hall,REP,420205,34,119,711,864,20
Logan,State Senate,Heady Coleman,DEM,420205,28,73,338,439,20
Logan,State House,Garry Mize,REP,420205,36,134,769,939,31
Logan,State House,Kara Sawyer,DEM,420205,26,60,280,366,31
Logan,Governor,Chris Powell,LIB,420206,1,2,56,59,
Logan,Governor,Kevin Stitt,REP,420206,42,67,552,661,
Logan,Governor,Drew Edmondson,DEM,420206,26,47,316,389,
Logan,Lieutenant Governor,Matt Pinnell,REP,420206,46,72,623,741,
Logan,Lieutenant Governor,Anastasia Pittman,DEM,420206,20,41,238,299,
Logan,Lieutenant Governor,Ivan Holmes,IND,420206,2,2,48,52,
Logan,State Auditor,John Yeutter,LIB,420206,14,29,207,250,
Logan,State Auditor,Cindy Byrd,REP,420206,46,76,639,761,
Logan,Attorney General,Mike Hunter,REP,420206,41,70,627,738,
Logan,Attorney General,Mark Myles,DEM,420206,27,45,269,341,
Logan,State Treasurer,Randy Mcdaniel,REP,420206,43,78,624,745,
Logan,State Treasurer,Charles De Coune,IND,420206,16,26,215,257,
Logan,Superintendent of Public Instruction,Joy Hofmeister,REP,420206,36,75,561,672,
Logan,Superintendent of Public Instruction,John Cox,DEM,420206,27,33,236,296,
Logan,Superintendent of Public Instruction,Larry Huff,IND,420206,4,8,108,120,
Logan,Commissioner of Labor,Leslie Osborn,REP,420206,43,70,605,718,
Logan,Commissioner of Labor,Fred Dorrell,DEM,420206,21,41,235,297,
Logan,Commissioner of Labor,Brandt Dismukes,IND,420206,5,4,59,68,
Logan,Insurance Commissioner,Glen Mulready,REP,420206,47,77,628,752,
Logan,Insurance Commissioner,Kimberly Fobbs,DEM,420206,21,35,263,319,
Logan,Corporation Commissioner,Bob Anthony,REP,420206,46,74,588,708,
Logan,Corporation Commissioner,Ashley Nicole Mccray,DEM,420206,20,35,228,283,
Logan,Corporation Commissioner,Jackie Short,IND,420206,2,5,75,82,
Logan,U.S. House,Frank Lucas,REP,420206,45,76,650,771,3
Logan,U.S. House,Frankie Robbins,DEM,420206,22,38,255,315,3
Logan,State Senate,Chuck Hall,REP,420206,39,76,610,725,20
Logan,State Senate,Heady Coleman,DEM,420206,25,37,284,346,20
Logan,State House,Garry Mize,REP,420206,44,73,621,738,31
Logan,State House,Kara Sawyer,DEM,420206,23,39,276,338,31
Logan,Governor,Chris Powell,LIB,420207,1,2,60,63,
Logan,Governor,Kevin Stitt,REP,420207,66,97,765,928,
Logan,Governor,Drew Edmondson,DEM,420207,53,27,331,411,
Logan,Lieutenant Governor,Matt Pinnell,REP,420207,73,101,813,987,
Logan,Lieutenant Governor,Anastasia Pittman,DEM,420207,42,25,291,358,
Logan,Lieutenant Governor,Ivan Holmes,IND,420207,3,1,43,47,
Logan,State Auditor,John Yeutter,LIB,420207,29,22,216,267,
Logan,State Auditor,Cindy Byrd,REP,420207,83,100,872,1055,
Logan,Attorney General,Mike Hunter,REP,420207,74,97,847,1018,
Logan,Attorney General,Mark Myles,DEM,420207,45,30,297,372,
Logan,State Treasurer,Randy Mcdaniel,REP,420207,72,96,842,1010,
Logan,State Treasurer,Charles De Coune,IND,420207,42,26,239,307,
Logan,Superintendent of Public Instruction,Joy Hofmeister,REP,420207,74,90,768,932,
Logan,Superintendent of Public Instruction,John Cox,DEM,420207,37,26,251,314,
Logan,Superintendent of Public Instruction,Larry Huff,IND,420207,8,10,121,139,
Logan,Commissioner of Labor,Leslie Osborn,REP,420207,74,92,799,965,
Logan,Commissioner of Labor,Fred Dorrell,DEM,420207,34,27,275,336,
Logan,Commissioner of Labor,Brandt Dismukes,IND,420207,10,7,59,76,
Logan,Insurance Commissioner,Glen Mulready,REP,420207,70,95,821,986,
Logan,Insurance Commissioner,Kimberly Fobbs,DEM,420207,49,31,309,389,
Logan,Corporation Commissioner,Bob Anthony,REP,420207,74,96,786,956,
Logan,Corporation Commissioner,Ashley Nicole Mccray,DEM,420207,32,25,273,330,
Logan,Corporation Commissioner,Jackie Short,IND,420207,13,5,76,94,
Logan,U.S. House,Frank Lucas,REP,420207,70,98,855,1023,3
Logan,U.S. House,Frankie Robbins,DEM,420207,48,29,283,360,3
Logan,State Senate,Chuck Hall,REP,420207,68,95,805,968,20
Logan,State Senate,Heady Coleman,DEM,420207,50,30,326,406,20
Logan,State House,Garry Mize,REP,420207,64,97,811,972,31
Logan,State House,Kara Sawyer,DEM,420207,54,30,319,403,31
Logan,Governor,Chris Powell,LIB,420301,1,0,4,5,
Logan,Governor,Kevin Stitt,REP,420301,4,4,115,123,
Logan,Governor,Drew Edmondson,DEM,420301,0,1,32,33,
Logan,Lieutenant Governor,Matt Pinnell,REP,420301,4,4,129,137,
Logan,Lieutenant Governor,Anastasia Pittman,DEM,420301,0,1,18,19,
Logan,Lieutenant Governor,Ivan Holmes,IND,420301,1,0,3,4,
Logan,State Auditor,John Yeutter,LIB,420301,1,1,12,14,
Logan,State Auditor,Cindy Byrd,REP,420301,4,4,132,140,
Logan,Attorney General,Mike Hunter,REP,420301,3,3,132,138,
Logan,Attorney General,Mark Myles,DEM,420301,2,2,18,22,
Logan,State Treasurer,Randy Mcdaniel,REP,420301,3,4,134,141,
Logan,State Treasurer,Charles De Coune,IND,420301,1,1,10,12,
Logan,Superintendent of Public Instruction,Joy Hofmeister,REP,420301,3,4,117,124,
Logan,Superintendent of Public Instruction,John Cox,DEM,420301,1,1,18,20,
Logan,Superintendent of Public Instruction,Larry Huff,IND,420301,0,0,15,15,
Logan,Commissioner of Labor,Leslie Osborn,REP,420301,3,4,128,135,
Logan,Commissioner of Labor,Fred Dorrell,DEM,420301,1,1,20,22,
Logan,Commissioner of Labor,Brandt Dismukes,IND,420301,0,0,2,2,
Logan,Insurance Commissioner,Glen Mulready,REP,420301,4,4,126,134,
Logan,Insurance Commissioner,Kimberly Fobbs,DEM,420301,0,1,24,25,
Logan,Corporation Commissioner,Bob Anthony,REP,420301,4,3,121,128,
Logan,Corporation Commissioner,Ashley Nicole Mccray,DEM,420301,0,1,23,24,
Logan,Corporation Commissioner,Jackie Short,IND,420301,0,1,6,7,
Logan,U.S. House,Frank Lucas,REP,420301,4,4,129,137,3
Logan,U.S. House,Frankie Robbins,DEM,420301,1,1,21,23,3
Logan,State Senate,Chuck Hall,REP,420301,4,2,129,135,20
Logan,State Senate,Heady Coleman,DEM,420301,0,3,20,23,20
Logan,Governor,Chris Powell,LIB,420302,0,0,5,5,
Logan,Governor,Kevin Stitt,REP,420302,1,3,77,81,
Logan,Governor,Drew Edmondson,DEM,420302,0,0,17,17,
Logan,Lieutenant Governor,Matt Pinnell,REP,420302,1,3,86,90,
Logan,Lieutenant Governor,Anastasia Pittman,DEM,420302,0,0,11,11,
Logan,Lieutenant Governor,Ivan Holmes,IND,420302,0,0,2,2,
Logan,State Auditor,John Yeutter,LIB,420302,0,0,8,8,
Logan,State Auditor,Cindy Byrd,REP,420302,1,3,87,91,
Logan,Attorney General,Mike Hunter,REP,420302,1,3,85,89,
Logan,Attorney General,Mark Myles,DEM,420302,0,0,14,14,
Logan,State Treasurer,Randy Mcdaniel,REP,420302,1,3,84,88,
Logan,State Treasurer,Charles De Coune,IND,420302,0,0,11,11,
Logan,Superintendent of Public Instruction,Joy Hofmeister,REP,420302,0,3,71,74,
Logan,Superintendent of Public Instruction,John Cox,DEM,420302,1,0,12,13,
Logan,Superintendent of Public Instruction,Larry Huff,IND,420302,0,0,16,16,
Logan,Commissioner of Labor,Leslie Osborn,REP,420302,1,3,84,88,
Logan,Commissioner of Labor,Fred Dorrell,DEM,420302,0,0,12,12,
Logan,Commissioner of Labor,Brandt Dismukes,IND,420302,0,0,3,3,
Logan,Insurance Commissioner,Glen Mulready,REP,420302,1,3,82,86,
Logan,Insurance Commissioner,Kimberly Fobbs,DEM,420302,0,0,16,16,
Logan,Corporation Commissioner,Bob Anthony,REP,420302,1,3,80,84,
Logan,Corporation Commissioner,Ashley Nicole Mccray,DEM,420302,0,0,15,15,
Logan,Corporation Commissioner,Jackie Short,IND,420302,0,0,3,3,
Logan,U.S. House,Frank Lucas,REP,420302,1,3,90,94,3
Logan,U.S. House,Frankie Robbins,DEM,420302,0,0,9,9,3
Logan,State Senate,Chuck Hall,REP,420302,1,3,85,89,20
Logan,State Senate,Heady Coleman,DEM,420302,0,0,14,14,20
Logan,Governor,Chris Powell,LIB,420303,0,0,43,43,
Logan,Governor,Kevin Stitt,REP,420303,20,18,631,669,
Logan,Governor,Drew Edmondson,DEM,420303,11,8,256,275,
Logan,Lieutenant Governor,Matt Pinnell,REP,420303,21,19,728,768,
Logan,Lieutenant Governor,Anastasia Pittman,DEM,420303,10,7,168,185,
Logan,Lieutenant Governor,Ivan Holmes,IND,420303,0,0,30,30,
Logan,State Auditor,John Yeutter,LIB,420303,5,5,127,137,
Logan,State Auditor,Cindy Byrd,REP,420303,19,19,768,806,
Logan,Attorney General,Mike Hunter,REP,420303,19,18,729,766,
Logan,Attorney General,Mark Myles,DEM,420303,12,8,197,217,
Logan,State Treasurer,Randy Mcdaniel,REP,420303,20,19,771,810,
Logan,State Treasurer,Charles De Coune,IND,420303,5,5,119,129,
Logan,Superintendent of Public Instruction,Joy Hofmeister,REP,420303,20,19,671,710,
Logan,Superintendent of Public Instruction,John Cox,DEM,420303,11,6,170,187,
Logan,Superintendent of Public Instruction,Larry Huff,IND,420303,0,1,85,86,
Logan,Commissioner of Labor,Leslie Osborn,REP,420303,20,17,697,734,
Logan,Commissioner of Labor,Fred Dorrell,DEM,420303,10,8,179,197,
Logan,Commissioner of Labor,Brandt Dismukes,IND,420303,1,1,41,43,
Logan,Insurance Commissioner,Glen Mulready,REP,420303,19,18,719,756,
Logan,Insurance Commissioner,Kimberly Fobbs,DEM,420303,11,8,199,218,
Logan,Corporation Commissioner,Bob Anthony,REP,420303,22,18,679,719,
Logan,Corporation Commissioner,Ashley Nicole Mccray,DEM,420303,9,8,177,194,
Logan,Corporation Commissioner,Jackie Short,IND,420303,0,0,68,68,
Logan,U.S. House,Frank Lucas,REP,420303,20,18,750,788,3
Logan,U.S. House,Frankie Robbins,DEM,420303,11,8,175,194,3
Logan,State Senate,Chuck Hall,REP,420303,18,18,688,724,20
Logan,State Senate,Heady Coleman,DEM,420303,12,8,236,256,20
Logan,Governor,Chris Powell,LIB,420304,1,1,10,12,
Logan,Governor,Kevin Stitt,REP,420304,7,11,185,203,
Logan,Governor,Drew Edmondson,DEM,420304,0,0,44,44,
Logan,Lieutenant Governor,Matt Pinnell,REP,420304,6,11,202,219,
Logan,Lieutenant Governor,Anastasia Pittman,DEM,420304,1,0,27,28,
Logan,Lieutenant Governor,Ivan Holmes,IND,420304,0,1,8,9,
Logan,State Auditor,John Yeutter,LIB,420304,0,0,30,30,
Logan,State Auditor,Cindy Byrd,REP,420304,7,12,201,220,
Logan,Attorney General,Mike Hunter,REP,420304,7,9,204,220,
Logan,Attorney General,Mark Myles,DEM,420304,0,3,35,38,
Logan,State Treasurer,Randy Mcdaniel,REP,420304,7,12,202,221,
Logan,State Treasurer,Charles De Coune,IND,420304,0,0,27,27,
Logan,Superintendent of Public Instruction,Joy Hofmeister,REP,420304,4,8,185,197,
Logan,Superintendent of Public Instruction,John Cox,DEM,420304,3,1,38,42,
Logan,Superintendent of Public Instruction,Larry Huff,IND,420304,0,3,15,18,
Logan,Commissioner of Labor,Leslie Osborn,REP,420304,7,9,192,208,
Logan,Commissioner of Labor,Fred Dorrell,DEM,420304,0,1,35,36,
Logan,Commissioner of Labor,Brandt Dismukes,IND,420304,0,2,6,8,
Logan,Insurance Commissioner,Glen Mulready,REP,420304,7,11,195,213,
Logan,Insurance Commissioner,Kimberly Fobbs,DEM,420304,0,1,39,40,
Logan,Corporation Commissioner,Bob Anthony,REP,420304,6,11,193,210,
Logan,Corporation Commissioner,Ashley Nicole Mccray,DEM,420304,1,1,30,32,
Logan,Corporation Commissioner,Jackie Short,IND,420304,0,0,11,11,
Logan,U.S. House,Frank Lucas,REP,420304,7,11,210,228,3
Logan,U.S. House,Frankie Robbins,DEM,420304,0,1,30,31,3
Logan,State Senate,Chuck Hall,REP,420304,7,12,188,207,20
Logan,State Senate,Heady Coleman,DEM,420304,0,0,51,51,20
Logan,Governor,Chris Powell,LIB,420305,0,2,25,27,
Logan,Governor,Kevin Stitt,REP,420305,15,45,296,356,
Logan,Governor,Drew Edmondson,DEM,420305,12,41,183,236,
Logan,Lieutenant Governor,Matt Pinnell,REP,420305,16,57,345,418,
Logan,Lieutenant Governor,Anastasia Pittman,DEM,420305,11,29,134,174,
Logan,Lieutenant Governor,Ivan Holmes,IND,420305,0,3,22,25,
Logan,State Auditor,John Yeutter,LIB,420305,7,18,110,135,
Logan,State Auditor,Cindy Byrd,REP,420305,18,62,358,438,
Logan,Attorney General,Mike Hunter,REP,420305,17,57,350,424,
Logan,Attorney General,Mark Myles,DEM,420305,9,31,149,189,
Logan,State Treasurer,Randy Mcdaniel,REP,420305,17,63,357,437,
Logan,State Treasurer,Charles De Coune,IND,420305,7,14,109,130,
Logan,Superintendent of Public Instruction,Joy Hofmeister,REP,420305,13,53,307,373,
Logan,Superintendent of Public Instruction,John Cox,DEM,420305,9,25,138,172,
Logan,Superintendent of Public Instruction,Larry Huff,IND,420305,4,8,52,64,
Logan,Commissioner of Labor,Leslie Osborn,REP,420305,12,52,320,384,
Logan,Commissioner of Labor,Fred Dorrell,DEM,420305,10,26,138,174,
Logan,Commissioner of Labor,Brandt Dismukes,IND,420305,3,7,36,46,
Logan,Insurance Commissioner,Glen Mulready,REP,420305,14,58,343,415,
Logan,Insurance Commissioner,Kimberly Fobbs,DEM,420305,10,30,152,192,
Logan,Corporation Commissioner,Bob Anthony,REP,420305,13,60,331,404,
Logan,Corporation Commissioner,Ashley Nicole Mccray,DEM,420305,11,25,143,179,
Logan,Corporation Commissioner,Jackie Short,IND,420305,2,4,26,32,
Logan,U.S. House,Frank Lucas,REP,420305,18,57,351,426,3
Logan,U.S. House,Frankie Robbins,DEM,420305,9,32,149,190,3
Logan,State Senate,Chuck Hall,REP,420305,13,43,295,351,20
Logan,State Senate,Heady Coleman,DEM,420305,14,47,206,267,20
Logan,Governor,Chris Powell,LIB,420306,0,1,13,14,
Logan,Governor,Kevin Stitt,REP,420306,6,16,119,141,
Logan,Governor,Drew Edmondson,DEM,420306,9,12,74,95,
Logan,Lieutenant Governor,Matt Pinnell,REP,420306,7,18,125,150,
Logan,Lieutenant Governor,Anastasia Pittman,DEM,420306,7,8,65,80,
Logan,Lieutenant Governor,Ivan Holmes,IND,420306,0,3,17,20,
Logan,State Auditor,John Yeutter,LIB,420306,4,6,53,63,
Logan,State Auditor,Cindy Byrd,REP,420306,6,20,138,164,
Logan,Attorney General,Mike Hunter,REP,420306,7,17,136,160,
Logan,Attorney General,Mark Myles,DEM,420306,8,11,66,85,
Logan,State Treasurer,Randy Mcdaniel,REP,420306,7,17,139,163,
Logan,State Treasurer,Charles De Coune,IND,420306,3,10,54,67,
Logan,Superintendent of Public Instruction,Joy Hofmeister,REP,420306,5,15,122,142,
Logan,Superintendent of Public Instruction,John Cox,DEM,420306,8,9,68,85,
Logan,Superintendent of Public Instruction,Larry Huff,IND,420306,2,5,16,23,
Logan,Commissioner of Labor,Leslie Osborn,REP,420306,7,16,127,150,
Logan,Commissioner of Labor,Fred Dorrell,DEM,420306,6,10,64,80,
Logan,Commissioner of Labor,Brandt Dismukes,IND,420306,0,3,11,14,
Logan,Insurance Commissioner,Glen Mulready,REP,420306,6,17,131,154,
Logan,Insurance Commissioner,Kimberly Fobbs,DEM,420306,9,10,70,89,
Logan,Corporation Commissioner,Bob Anthony,REP,420306,6,19,125,150,
Logan,Corporation Commissioner,Ashley Nicole Mccray,DEM,420306,5,8,67,80,
Logan,Corporation Commissioner,Jackie Short,IND,420306,3,2,10,15,
Logan,U.S. House,Frank Lucas,REP,420306,7,19,146,172,3
Logan,U.S. House,Frankie Robbins,DEM,420306,8,10,55,73,3
Logan,State Senate,Chuck Hall,REP,420306,6,11,111,128,20
Logan,State Senate,Heady Coleman,DEM,420306,9,18,94,121,20
Logan,State House,Garry Mize,REP,420306,7,17,132,156,31
Logan,State House,Kara Sawyer,DEM,420306,8,12,69,89,31
Logan,Governor,Chris Powell,LIB,420307,0,4,33,37,
Logan,Governor,Kevin Stitt,REP,420307,34,45,328,407,
Logan,Governor,Drew Edmondson,DEM,420307,21,56,298,375,
Logan,Lieutenant Governor,Matt Pinnell,REP,420307,36,57,391,484,
Logan,Lieutenant Governor,Anastasia Pittman,DEM,420307,18,45,236,299,
Logan,Lieutenant Governor,Ivan Holmes,IND,420307,2,2,30,34,
Logan,State Auditor,John Yeutter,LIB,420307,12,28,170,210,
Logan,State Auditor,Cindy Byrd,REP,420307,38,66,453,557,
Logan,Attorney General,Mike Hunter,REP,420307,38,59,408,505,
Logan,Attorney General,Mark Myles,DEM,420307,18,46,247,311,
Logan,State Treasurer,Randy Mcdaniel,REP,420307,40,60,428,528,
Logan,State Treasurer,Charles De Coune,IND,420307,12,33,193,238,
Logan,Superintendent of Public Instruction,Joy Hofmeister,REP,420307,36,57,366,459,
Logan,Superintendent of Public Instruction,John Cox,DEM,420307,17,43,228,288,
Logan,Superintendent of Public Instruction,Larry Huff,IND,420307,4,4,60,68,
Logan,Commissioner of Labor,Leslie Osborn,REP,420307,35,57,390,482,
Logan,Commissioner of Labor,Fred Dorrell,DEM,420307,17,44,222,283,
Logan,Commissioner of Labor,Brandt Dismukes,IND,420307,4,1,38,43,
Logan,Insurance Commissioner,Glen Mulready,REP,420307,37,54,401,492,
Logan,Insurance Commissioner,Kimberly Fobbs,DEM,420307,18,50,247,315,
Logan,Corporation Commissioner,Bob Anthony,REP,420307,39,57,386,482,
Logan,Corporation Commissioner,Ashley Nicole Mccray,DEM,420307,16,46,211,273,
Logan,Corporation Commissioner,Jackie Short,IND,420307,0,1,54,55,
Logan,U.S. House,Frank Lucas,REP,420307,40,53,411,504,3
Logan,U.S. House,Frankie Robbins,DEM,420307,17,48,242,307,3
Logan,State Senate,Chuck Hall,REP,420307,32,53,296,381,20
Logan,State Senate,Heady Coleman,DEM,420307,25,53,363,441,20
Logan,State House,Garry Mize,REP,420307,35,57,391,483,31
Logan,State House,Kara Sawyer,DEM,420307,22,49,263,334,31
Logan,Governor,Chris Powell,LIB,420308,1,5,26,32,
Logan,Governor,Kevin Stitt,REP,420308,11,53,320,384,
Logan,Governor,Drew Edmondson,DEM,420308,11,76,301,388,
Logan,Lieutenant Governor,Matt Pinnell,REP,420308,14,56,356,426,
Logan,Lieutenant Governor,Anastasia Pittman,DEM,420308,8,74,264,346,
Logan,Lieutenant Governor,Ivan Holmes,IND,420308,1,4,21,26,
Logan,State Auditor,John Yeutter,LIB,420308,7,48,171,226,
Logan,State Auditor,Cindy Byrd,REP,420308,14,69,407,490,
Logan,Attorney General,Mike Hunter,REP,420308,14,59,374,447,
Logan,Attorney General,Mark Myles,DEM,420308,9,73,267,349,
Logan,State Treasurer,Randy Mcdaniel,REP,420308,12,59,379,450,
Logan,State Treasurer,Charles De Coune,IND,420308,10,54,196,260,
Logan,Superintendent of Public Instruction,Joy Hofmeister,REP,420308,11,61,348,420,
Logan,Superintendent of Public Instruction,John Cox,DEM,420308,11,64,248,323,
Logan,Superintendent of Public Instruction,Larry Huff,IND,420308,1,9,41,51,
Logan,Commissioner of Labor,Leslie Osborn,REP,420308,13,56,353,422,
Logan,Commissioner of Labor,Fred Dorrell,DEM,420308,8,67,252,327,
Logan,Commissioner of Labor,Brandt Dismukes,IND,420308,2,9,30,41,
Logan,Insurance Commissioner,Glen Mulready,REP,420308,15,61,360,436,
Logan,Insurance Commissioner,Kimberly Fobbs,DEM,420308,8,72,274,354,
Logan,Corporation Commissioner,Bob Anthony,REP,420308,13,54,345,412,
Logan,Corporation Commissioner,Ashley Nicole Mccray,DEM,420308,9,70,257,336,
Logan,Corporation Commissioner,Jackie Short,IND,420308,1,10,35,46,
Logan,U.S. House,Frank Lucas,REP,420308,15,62,377,454,3
Logan,U.S. House,Frankie Robbins,DEM,420308,8,72,260,340,3
Logan,State Senate,Chuck Hall,REP,420308,15,56,293,364,20
Logan,State Senate,Heady Coleman,DEM,420308,8,78,348,434,20
Logan,State House,Garry Mize,REP,420308,13,59,359,431,31
Logan,State House,Kara Sawyer,DEM,420308,10,75,281,366,31
Logan,Governor,Chris Powell,LIB,420309,0,0,2,2,
Logan,Governor,Kevin Stitt,REP,420309,3,5,19,27,
Logan,Governor,Drew Edmondson,DEM,420309,0,5,22,27,
Logan,Lieutenant Governor,Matt Pinnell,REP,420309,3,4,19,26,
Logan,Lieutenant Governor,Anastasia Pittman,DEM,420309,0,5,24,29,
Logan,Lieutenant Governor,Ivan Holmes,IND,420309,0,1,0,1,
Logan,State Auditor,John Yeutter,LIB,420309,2,4,15,21,
Logan,State Auditor,Cindy Byrd,REP,420309,1,5,24,30,
Logan,Attorney General,Mike Hunter,REP,420309,3,6,24,33,
Logan,Attorney General,Mark Myles,DEM,420309,0,4,19,23,
Logan,State Treasurer,Randy Mcdaniel,REP,420309,0,4,24,28,
Logan,State Treasurer,Charles De Coune,IND,420309,3,4,14,21,
Logan,Superintendent of Public Instruction,Joy Hofmeister,REP,420309,0,4,27,31,
Logan,Superintendent of Public Instruction,John Cox,DEM,420309,0,5,14,19,
Logan,Superintendent of Public Instruction,Larry Huff,IND,420309,3,1,2,6,
Logan,Commissioner of Labor,Leslie Osborn,REP,420309,1,5,24,30,
Logan,Commissioner of Labor,Fred Dorrell,DEM,420309,2,4,17,23,
Logan,Commissioner of Labor,Brandt Dismukes,IND,420309,0,1,1,2,
Logan,Insurance Commissioner,Glen Mulready,REP,420309,3,3,20,26,
Logan,Insurance Commissioner,Kimberly Fobbs,DEM,420309,0,7,23,30,
Logan,Corporation Commissioner,Bob Anthony,REP,420309,3,3,22,28,
Logan,Corporation Commissioner,Ashley Nicole Mccray,DEM,420309,0,6,19,25,
Logan,Corporation Commissioner,Jackie Short,IND,420309,0,1,2,3,
Logan,U.S. House,Frank Lucas,REP,420309,3,5,20,28,3
Logan,U.S. House,Frankie Robbins,DEM,420309,0,5,23,28,3
Logan,State Senate,Chuck Hall,REP,420309,2,6,18,26,20
Logan,State Senate,Heady Coleman,DEM,420309,1,4,25,30,20
Logan,Governor,Chris Powell,LIB,420310,0,0,5,5,
Logan,Governor,Kevin Stitt,REP,420310,0,0,5,5,
Logan,Governor,Drew Edmondson,DEM,420310,6,6,161,173,
Logan,Lieutenant Governor,Matt Pinnell,REP,420310,0,0,1,1,
Logan,Lieutenant Governor,Anastasia Pittman,DEM,420310,6,6,165,177,
Logan,Lieutenant Governor,Ivan Holmes,IND,420310,0,0,5,5,
Logan,State Auditor,John Yeutter,LIB,420310,3,3,108,114,
Logan,State Auditor,Cindy Byrd,REP,420310,2,1,30,33,
Logan,Attorney General,Mike Hunter,REP,420310,0,0,4,4,
Logan,Attorney General,Mark Myles,DEM,420310,6,6,169,181,
Logan,State Treasurer,Randy Mcdaniel,REP,420310,0,0,13,13,
Logan,State Treasurer,Charles De Coune,IND,420310,6,4,126,136,
Logan,Superintendent of Public Instruction,Joy Hofmeister,REP,420310,0,0,8,8,
Logan,Superintendent of Public Instruction,John Cox,DEM,420310,6,6,154,166,
Logan,Superintendent of Public Instruction,Larry Huff,IND,420310,0,0,10,10,
Logan,Commissioner of Labor,Leslie Osborn,REP,420310,0,0,8,8,
Logan,Commissioner of Labor,Fred Dorrell,DEM,420310,6,6,156,168,
Logan,Commissioner of Labor,Brandt Dismukes,IND,420310,0,0,8,8,
Logan,Insurance Commissioner,Glen Mulready,REP,420310,0,0,6,6,
Logan,Insurance Commissioner,Kimberly Fobbs,DEM,420310,6,6,166,178,
Logan,Corporation Commissioner,Bob Anthony,REP,420310,0,0,3,3,
Logan,Corporation Commissioner,Ashley Nicole Mccray,DEM,420310,6,6,158,170,
Logan,Corporation Commissioner,Jackie Short,IND,420310,0,0,10,10,
Logan,U.S. House,Frank Lucas,REP,420310,0,0,9,9,3
Logan,U.S. House,Frankie Robbins,DEM,420310,6,6,161,173,3
Logan,State Senate,Chuck Hall,REP,420310,0,0,3,3,20
Logan,State Senate,Heady Coleman,DEM,420310,6,6,168,180,20
Logan,State House,Kevin Wallace,REP,420310,1,0,8,9,32
Logan,State House,Christi Wolff,DEM,420310,5,6,163,174,32
Love,Governor,Chris Powell,LIB,430101,0,0,8,8,
Love,Governor,Kevin Stitt,REP,430101,4,18,143,165,
Love,Governor,Drew Edmondson,DEM,430101,3,5,67,75,
Love,Lieutenant Governor,Matt Pinnell,REP,430101,5,17,146,168,
Love,Lieutenant Governor,Anastasia Pittman,DEM,430101,2,6,63,71,
Love,Lieutenant Governor,Ivan Holmes,IND,430101,0,0,7,7,
Love,State Auditor,John Yeutter,LIB,430101,2,3,45,50,
Love,State Auditor,Cindy Byrd,REP,430101,5,20,163,188,
Love,Attorney General,Mike Hunter,REP,430101,4,18,149,171,
Love,Attorney General,Mark Myles,DEM,430101,3,5,67,75,
Love,State Treasurer,Randy Mcdaniel,REP,430101,5,19,162,186,
Love,State Treasurer,Charles De Coune,IND,430101,2,4,45,51,
Love,Superintendent of Public Instruction,Joy Hofmeister,REP,430101,5,18,133,156,
Love,Superintendent of Public Instruction,John Cox,DEM,430101,2,5,67,74,
Love,Superintendent of Public Instruction,Larry Huff,IND,430101,0,0,14,14,
Love,Commissioner of Labor,Leslie Osborn,REP,430101,5,18,142,165,
Love,Commissioner of Labor,Fred Dorrell,DEM,430101,1,5,61,67,
Love,Commissioner of Labor,Brandt Dismukes,IND,430101,1,0,12,13,
Love,Insurance Commissioner,Glen Mulready,REP,430101,5,18,144,167,
Love,Insurance Commissioner,Kimberly Fobbs,DEM,430101,2,5,72,79,
Love,Corporation Commissioner,Bob Anthony,REP,430101,5,18,132,155,
Love,Corporation Commissioner,Ashley Nicole Mccray,DEM,430101,2,5,67,74,
Love,Corporation Commissioner,Jackie Short,IND,430101,0,0,16,16,
Love,U.S. House,Tom Cole,REP,430101,5,19,151,175,4
Love,U.S. House,Mary Brannon,DEM,430101,2,4,62,68,4
Love,U.S. House,Ruby Peters,IND,430101,0,0,6,6,4
Love,State Senate,Frank Simpson,REP,430101,4,18,148,170,14
Love,State Senate,Justin Arledge,DEM,430101,2,5,71,78,14
Love,State House,Tommy Hardin,REP,430101,5,18,135,158,49
Love,State House,Miranda Shelton,DEM,430101,0,5,84,89,49
Love,Governor,Chris Powell,LIB,430102,0,0,1,1,
Love,Governor,Kevin Stitt,REP,430102,2,27,158,187,
Love,Governor,Drew Edmondson,DEM,430102,2,3,52,57,
Love,Lieutenant Governor,Matt Pinnell,REP,430102,2,26,166,194,
Love,Lieutenant Governor,Anastasia Pittman,DEM,430102,2,4,43,49,
Love,Lieutenant Governor,Ivan Holmes,IND,430102,0,0,3,3,
Love,State Auditor,John Yeutter,LIB,430102,0,1,19,20,
Love,State Auditor,Cindy Byrd,REP,430102,4,29,179,212,
Love,Attorney General,Mike Hunter,REP,430102,2,25,169,196,
Love,Attorney General,Mark Myles,DEM,430102,2,5,43,50,
Love,State Treasurer,Randy Mcdaniel,REP,430102,4,29,174,207,
Love,State Treasurer,Charles De Coune,IND,430102,0,1,24,25,
Love,Superintendent of Public Instruction,Joy Hofmeister,REP,430102,2,26,158,186,
Love,Superintendent of Public Instruction,John Cox,DEM,430102,2,3,45,50,
Love,Superintendent of Public Instruction,Larry Huff,IND,430102,0,0,8,8,
Love,Commissioner of Labor,Leslie Osborn,REP,430102,2,23,166,191,
Love,Commissioner of Labor,Fred Dorrell,DEM,430102,2,5,41,48,
Love,Commissioner of Labor,Brandt Dismukes,IND,430102,0,2,4,6,
Love,Insurance Commissioner,Glen Mulready,REP,430102,2,26,161,189,
Love,Insurance Commissioner,Kimberly Fobbs,DEM,430102,2,3,50,55,
Love,Corporation Commissioner,Bob Anthony,REP,430102,3,23,160,186,
Love,Corporation Commissioner,Ashley Nicole Mccray,DEM,430102,1,4,45,50,
Love,Corporation Commissioner,Jackie Short,IND,430102,0,3,7,10,
Love,U.S. House,Tom Cole,REP,430102,2,25,160,187,4
Love,U.S. House,Mary Brannon,DEM,430102,2,3,48,53,4
Love,U.S. House,Ruby Peters,IND,430102,0,2,4,6,4
Love,State Senate,Frank Simpson,REP,430102,2,25,161,188,14
Love,State Senate,Justin Arledge,DEM,430102,2,5,51,58,14
Love,State House,Tommy Hardin,REP,430102,2,25,152,179,49
Love,State House,Miranda Shelton,DEM,430102,2,5,60,67,49
Love,Governor,Chris Powell,LIB,430103,0,2,8,10,
Love,Governor,Kevin Stitt,REP,430103,8,28,319,355,
Love,Governor,Drew Edmondson,DEM,430103,3,4,85,92,
Love,Lieutenant Governor,Matt Pinnell,REP,430103,7,25,320,352,
Love,Lieutenant Governor,Anastasia Pittman,DEM,430103,3,8,78,89,
Love,Lieutenant Governor,Ivan Holmes,IND,430103,0,1,11,12,
Love,State Auditor,John Yeutter,LIB,430103,0,3,54,57,
Love,State Auditor,Cindy Byrd,REP,430103,7,29,333,369,
Love,Attorney General,Mike Hunter,REP,430103,8,26,326,360,
Love,Attorney General,Mark Myles,DEM,430103,2,8,81,91,
Love,State Treasurer,Randy Mcdaniel,REP,430103,8,29,341,378,
Love,State Treasurer,Charles De Coune,IND,430103,0,3,46,49,
Love,Superintendent of Public Instruction,Joy Hofmeister,REP,430103,7,23,312,342,
Love,Superintendent of Public Instruction,John Cox,DEM,430103,3,8,77,88,
Love,Superintendent of Public Instruction,Larry Huff,IND,430103,0,1,18,19,
Love,Commissioner of Labor,Leslie Osborn,REP,430103,7,26,314,347,
Love,Commissioner of Labor,Fred Dorrell,DEM,430103,3,6,80,89,
Love,Commissioner of Labor,Brandt Dismukes,IND,430103,1,1,12,14,
Love,Insurance Commissioner,Glen Mulready,REP,430103,8,26,312,346,
Love,Insurance Commissioner,Kimberly Fobbs,DEM,430103,3,7,96,106,
Love,Corporation Commissioner,Bob Anthony,REP,430103,8,26,311,345,
Love,Corporation Commissioner,Ashley Nicole Mccray,DEM,430103,3,6,83,92,
Love,Corporation Commissioner,Jackie Short,IND,430103,0,2,14,16,
Love,U.S. House,Tom Cole,REP,430103,9,27,339,375,4
Love,U.S. House,Mary Brannon,DEM,430103,2,4,64,70,4
Love,U.S. House,Ruby Peters,IND,430103,0,2,9,11,4
Love,State Senate,Frank Simpson,REP,430103,9,29,329,367,14
Love,State Senate,Justin Arledge,DEM,430103,2,5,82,89,14
Love,State House,Tommy Hardin,REP,430103,9,26,302,337,49
Love,State House,Miranda Shelton,DEM,430103,2,8,110,120,49
Love,Governor,Chris Powell,LIB,430204,0,0,4,4,
Love,Governor,Kevin Stitt,REP,430204,1,12,103,116,
Love,Governor,Drew Edmondson,DEM,430204,2,9,89,100,
Love,Lieutenant Governor,Matt Pinnell,REP,430204,2,11,104,117,
Love,Lieutenant Governor,Anastasia Pittman,DEM,430204,1,8,83,92,
Love,Lieutenant Governor,Ivan Holmes,IND,430204,0,1,7,8,
Love,State Auditor,John Yeutter,LIB,430204,0,3,44,47,
Love,State Auditor,Cindy Byrd,REP,430204,2,16,124,142,
Love,Attorney General,Mike Hunter,REP,430204,2,14,110,126,
Love,Attorney General,Mark Myles,DEM,430204,1,7,83,91,
Love,State Treasurer,Randy Mcdaniel,REP,430204,2,15,121,138,
Love,State Treasurer,Charles De Coune,IND,430204,0,4,48,52,
Love,Superintendent of Public Instruction,Joy Hofmeister,REP,430204,2,13,97,112,
Love,Superintendent of Public Instruction,John Cox,DEM,430204,1,7,83,91,
Love,Superintendent of Public Instruction,Larry Huff,IND,430204,0,1,13,14,
Love,Commissioner of Labor,Leslie Osborn,REP,430204,2,12,104,118,
Love,Commissioner of Labor,Fred Dorrell,DEM,430204,1,8,76,85,
Love,Commissioner of Labor,Brandt Dismukes,IND,430204,0,1,11,12,
Love,Insurance Commissioner,Glen Mulready,REP,430204,2,13,99,114,
Love,Insurance Commissioner,Kimberly Fobbs,DEM,430204,1,8,93,102,
Love,Corporation Commissioner,Bob Anthony,REP,430204,1,11,103,115,
Love,Corporation Commissioner,Ashley Nicole Mccray,DEM,430204,2,8,76,86,
Love,Corporation Commissioner,Jackie Short,IND,430204,0,1,13,14,
Love,U.S. House,Tom Cole,REP,430204,2,12,106,120,4
Love,U.S. House,Mary Brannon,DEM,430204,1,7,82,90,4
Love,U.S. House,Ruby Peters,IND,430204,0,2,8,10,4
Love,State Senate,Frank Simpson,REP,430204,2,12,109,123,14
Love,State Senate,Justin Arledge,DEM,430204,1,9,86,96,14
Love,State House,Tommy Hardin,REP,430204,2,12,94,108,49
Love,State House,Miranda Shelton,DEM,430204,1,9,102,112,49
Love,Governor,Chris Powell,LIB,430205,0,0,10,10,
Love,Governor,Kevin Stitt,REP,430205,8,42,250,300,
Love,Governor,Drew Edmondson,DEM,430205,0,8,82,90,
Love,Lieutenant Governor,Matt Pinnell,REP,430205,8,42,257,307,
Love,Lieutenant Governor,Anastasia Pittman,DEM,430205,0,7,74,81,
Love,Lieutenant Governor,Ivan Holmes,IND,430205,0,1,6,7,
Love,State Auditor,John Yeutter,LIB,430205,0,7,43,50,
Love,State Auditor,Cindy Byrd,REP,430205,8,42,270,320,
Love,Attorney General,Mike Hunter,REP,430205,8,42,263,313,
Love,Attorney General,Mark Myles,DEM,430205,0,8,74,82,
Love,State Treasurer,Randy Mcdaniel,REP,430205,8,43,270,321,
Love,State Treasurer,Charles De Coune,IND,430205,0,6,44,50,
Love,Superintendent of Public Instruction,Joy Hofmeister,REP,430205,8,40,241,289,
Love,Superintendent of Public Instruction,John Cox,DEM,430205,0,8,77,85,
Love,Superintendent of Public Instruction,Larry Huff,IND,430205,0,2,21,23,
Love,Commissioner of Labor,Leslie Osborn,REP,430205,8,41,258,307,
Love,Commissioner of Labor,Fred Dorrell,DEM,430205,0,8,70,78,
Love,Commissioner of Labor,Brandt Dismukes,IND,430205,0,1,12,13,
Love,Insurance Commissioner,Glen Mulready,REP,430205,8,42,251,301,
Love,Insurance Commissioner,Kimberly Fobbs,DEM,430205,0,8,90,98,
Love,Corporation Commissioner,Bob Anthony,REP,430205,8,41,252,301,
Love,Corporation Commissioner,Ashley Nicole Mccray,DEM,430205,0,8,74,82,
Love,Corporation Commissioner,Jackie Short,IND,430205,0,1,14,15,
Love,U.S. House,Tom Cole,REP,430205,8,43,253,304,4
Love,U.S. House,Mary Brannon,DEM,430205,0,7,79,86,4
Love,U.S. House,Ruby Peters,IND,430205,0,0,10,10,4
Love,State Senate,Frank Simpson,REP,430205,8,42,256,306,14
Love,State Senate,Justin Arledge,DEM,430205,0,8,87,95,14
Love,State House,Tommy Hardin,REP,430205,8,41,243,292,49
Love,State House,Miranda Shelton,DEM,430205,0,9,98,107,49
Love,Governor,Chris Powell,LIB,430206,0,1,0,1,
Love,Governor,Kevin Stitt,REP,430206,2,4,90,96,
Love,Governor,Drew Edmondson,DEM,430206,0,5,42,47,
Love,Lieutenant Governor,Matt Pinnell,REP,430206,2,7,91,100,
Love,Lieutenant Governor,Anastasia Pittman,DEM,430206,1,3,39,43,
Love,Lieutenant Governor,Ivan Holmes,IND,430206,0,0,0,0,
Love,State Auditor,John Yeutter,LIB,430206,0,1,22,23,
Love,State Auditor,Cindy Byrd,REP,430206,2,9,98,109,
Love,Attorney General,Mike Hunter,REP,430206,2,6,94,102,
Love,Attorney General,Mark Myles,DEM,430206,1,4,38,43,
Love,State Treasurer,Randy Mcdaniel,REP,430206,3,10,103,116,
Love,State Treasurer,Charles De Coune,IND,430206,0,0,16,16,
Love,Superintendent of Public Instruction,Joy Hofmeister,REP,430206,3,8,81,92,
Love,Superintendent of Public Instruction,John Cox,DEM,430206,0,2,43,45,
Love,Superintendent of Public Instruction,Larry Huff,IND,430206,0,0,6,6,
Love,Commissioner of Labor,Leslie Osborn,REP,430206,2,7,81,90,
Love,Commissioner of Labor,Fred Dorrell,DEM,430206,1,3,42,46,
Love,Commissioner of Labor,Brandt Dismukes,IND,430206,0,0,6,6,
Love,Insurance Commissioner,Glen Mulready,REP,430206,2,6,89,97,
Love,Insurance Commissioner,Kimberly Fobbs,DEM,430206,1,4,40,45,
Love,Corporation Commissioner,Bob Anthony,REP,430206,2,5,88,95,
Love,Corporation Commissioner,Ashley Nicole Mccray,DEM,430206,1,4,38,43,
Love,Corporation Commissioner,Jackie Short,IND,430206,0,1,3,4,
Love,U.S. House,Tom Cole,REP,430206,2,8,96,106,4
Love,U.S. House,Mary Brannon,DEM,430206,1,2,32,35,4
Love,U.S. House,Ruby Peters,IND,430206,0,0,3,3,4
Love,State Senate,Frank Simpson,REP,430206,2,7,84,93,14
Love,State Senate,Justin Arledge,DEM,430206,1,3,48,52,14
Love,State House,Tommy Hardin,REP,430206,2,7,84,93,49
Love,State House,Miranda Shelton,DEM,430206,1,3,48,52,49
Love,Governor,Chris Powell,LIB,430207,0,0,2,2,
Love,Governor,Kevin Stitt,REP,430207,0,5,20,25,
Love,Governor,Drew Edmondson,DEM,430207,3,3,17,23,
Love,Lieutenant Governor,Matt Pinnell,REP,430207,0,2,20,22,
Love,Lieutenant Governor,Anastasia Pittman,DEM,430207,3,5,17,25,
Love,Lieutenant Governor,Ivan Holmes,IND,430207,0,1,2,3,
Love,State Auditor,John Yeutter,LIB,430207,0,3,4,7,
Love,State Auditor,Cindy Byrd,REP,430207,1,5,25,31,
Love,Attorney General,Mike Hunter,REP,430207,0,2,17,19,
Love,Attorney General,Mark Myles,DEM,430207,3,6,23,32,
Love,State Treasurer,Randy Mcdaniel,REP,430207,1,7,26,34,
Love,State Treasurer,Charles De Coune,IND,430207,0,0,4,4,
Love,Superintendent of Public Instruction,Joy Hofmeister,REP,430207,0,3,20,23,
Love,Superintendent of Public Instruction,John Cox,DEM,430207,3,3,18,24,
Love,Superintendent of Public Instruction,Larry Huff,IND,430207,0,2,2,4,
Love,Commissioner of Labor,Leslie Osborn,REP,430207,1,2,23,26,
Love,Commissioner of Labor,Fred Dorrell,DEM,430207,2,5,15,22,
Love,Commissioner of Labor,Brandt Dismukes,IND,430207,0,1,1,2,
Love,Insurance Commissioner,Glen Mulready,REP,430207,1,2,17,20,
Love,Insurance Commissioner,Kimberly Fobbs,DEM,430207,2,6,22,30,
Love,Corporation Commissioner,Bob Anthony,REP,430207,0,2,16,18,
Love,Corporation Commissioner,Ashley Nicole Mccray,DEM,430207,3,5,22,30,
Love,Corporation Commissioner,Jackie Short,IND,430207,0,1,1,2,
Love,U.S. House,Tom Cole,REP,430207,0,3,21,24,4
Love,U.S. House,Mary Brannon,DEM,430207,3,5,18,26,4
Love,U.S. House,Ruby Peters,IND,430207,0,0,1,1,4
Love,State Senate,Frank Simpson,REP,430207,0,6,22,28,14
Love,State Senate,Justin Arledge,DEM,430207,3,2,18,23,14
Love,State House,Tommy Hardin,REP,430207,0,6,21,27,49
Love,State House,Miranda Shelton,DEM,430207,3,2,19,24,49
Love,Governor,Chris Powell,LIB,430208,0,0,0,0,
Love,Governor,Kevin Stitt,REP,430208,0,1,23,24,
Love,Governor,Drew Edmondson,DEM,430208,0,0,19,19,
Love,Lieutenant Governor,Matt Pinnell,REP,430208,0,1,27,28,
Love,Lieutenant Governor,Anastasia Pittman,DEM,430208,0,0,14,14,
Love,Lieutenant Governor,Ivan Holmes,IND,430208,0,0,1,1,
Love,State Auditor,John Yeutter,LIB,430208,0,0,5,5,
Love,State Auditor,Cindy Byrd,REP,430208,0,1,31,32,
Love,Attorney General,Mike Hunter,REP,430208,0,0,28,28,
Love,Attorney General,Mark Myles,DEM,430208,0,1,14,15,
Love,State Treasurer,Randy Mcdaniel,REP,430208,0,1,31,32,
Love,State Treasurer,Charles De Coune,IND,430208,0,0,6,6,
Love,Superintendent of Public Instruction,Joy Hofmeister,REP,430208,0,0,23,23,
Love,Superintendent of Public Instruction,John Cox,DEM,430208,0,1,16,17,
Love,Superintendent of Public Instruction,Larry Huff,IND,430208,0,0,3,3,
Love,Commissioner of Labor,Leslie Osborn,REP,430208,0,1,27,28,
Love,Commissioner of Labor,Fred Dorrell,DEM,430208,0,0,10,10,
Love,Commissioner of Labor,Brandt Dismukes,IND,430208,0,0,4,4,
Love,Insurance Commissioner,Glen Mulready,REP,430208,0,1,28,29,
Love,Insurance Commissioner,Kimberly Fobbs,DEM,430208,0,0,14,14,
Love,Corporation Commissioner,Bob Anthony,REP,430208,0,1,27,28,
Love,Corporation Commissioner,Ashley Nicole Mccray,DEM,430208,0,0,12,12,
Love,Corporation Commissioner,Jackie Short,IND,430208,0,0,3,3,
Love,U.S. House,Tom Cole,REP,430208,0,1,30,31,4
Love,U.S. House,Mary Brannon,DEM,430208,0,0,11,11,4
Love,U.S. House,Ruby Peters,IND,430208,0,0,1,1,4
Love,State Senate,Frank Simpson,REP,430208,0,0,27,27,14
Love,State Senate,Justin Arledge,DEM,430208,0,1,15,16,14
Love,State House,Tommy Hardin,REP,430208,0,1,32,33,49
Love,State House,Miranda Shelton,DEM,430208,0,0,10,10,49
Love,Governor,Chris Powell,LIB,430310,0,0,8,8,
Love,Governor,Kevin Stitt,REP,430310,2,18,132,152,
Love,Governor,Drew Edmondson,DEM,430310,0,3,106,109,
Love,Lieutenant Governor,Matt Pinnell,REP,430310,2,18,139,159,
Love,Lieutenant Governor,Anastasia Pittman,DEM,430310,0,2,97,99,
Love,Lieutenant Governor,Ivan Holmes,IND,430310,0,1,7,8,
Love,State Auditor,John Yeutter,LIB,430310,0,2,53,55,
Love,State Auditor,Cindy Byrd,REP,430310,2,18,162,182,
Love,Attorney General,Mike Hunter,REP,430310,2,19,144,165,
Love,Attorney General,Mark Myles,DEM,430310,0,2,100,102,
Love,State Treasurer,Randy Mcdaniel,REP,430310,2,18,163,183,
Love,State Treasurer,Charles De Coune,IND,430310,0,2,54,56,
Love,Superintendent of Public Instruction,Joy Hofmeister,REP,430310,2,17,130,149,
Love,Superintendent of Public Instruction,John Cox,DEM,430310,0,3,94,97,
Love,Superintendent of Public Instruction,Larry Huff,IND,430310,0,1,18,19,
Love,Commissioner of Labor,Leslie Osborn,REP,430310,2,15,140,157,
Love,Commissioner of Labor,Fred Dorrell,DEM,430310,0,5,94,99,
Love,Commissioner of Labor,Brandt Dismukes,IND,430310,0,1,4,5,
Love,Insurance Commissioner,Glen Mulready,REP,430310,2,19,133,154,
Love,Insurance Commissioner,Kimberly Fobbs,DEM,430310,0,2,110,112,
Love,Corporation Commissioner,Bob Anthony,REP,430310,2,18,132,152,
Love,Corporation Commissioner,Ashley Nicole Mccray,DEM,430310,0,2,101,103,
Love,Corporation Commissioner,Jackie Short,IND,430310,0,1,10,11,
Love,U.S. House,Tom Cole,REP,430310,2,17,151,170,4
Love,U.S. House,Mary Brannon,DEM,430310,0,2,94,96,4
Love,U.S. House,Ruby Peters,IND,430310,0,2,1,3,4
Love,State Senate,Frank Simpson,REP,430310,2,18,145,165,14
Love,State Senate,Justin Arledge,DEM,430310,0,3,99,102,14
Love,State House,Tommy Hardin,REP,430310,2,16,134,152,49
Love,State House,Miranda Shelton,DEM,430310,0,5,112,117,49
Love,Governor,Chris Powell,LIB,430311,0,0,7,7,
Love,Governor,Kevin Stitt,REP,430311,5,38,181,224,
Love,Governor,Drew Edmondson,DEM,430311,3,10,70,83,
Love,Lieutenant Governor,Matt Pinnell,REP,430311,5,41,187,233,
Love,Lieutenant Governor,Anastasia Pittman,DEM,430311,3,6,63,72,
Love,Lieutenant Governor,Ivan Holmes,IND,430311,0,0,6,6,
Love,State Auditor,John Yeutter,LIB,430311,0,3,39,42,
Love,State Auditor,Cindy Byrd,REP,430311,7,43,193,243,
Love,Attorney General,Mike Hunter,REP,430311,5,42,184,231,
Love,Attorney General,Mark Myles,DEM,430311,3,5,66,74,
Love,State Treasurer,Randy Mcdaniel,REP,430311,5,42,195,242,
Love,State Treasurer,Charles De Coune,IND,430311,2,5,44,51,
Love,Superintendent of Public Instruction,Joy Hofmeister,REP,430311,5,38,175,218,
Love,Superintendent of Public Instruction,John Cox,DEM,430311,1,7,61,69,
Love,Superintendent of Public Instruction,Larry Huff,IND,430311,2,2,15,19,
Love,Commissioner of Labor,Leslie Osborn,REP,430311,5,41,179,225,
Love,Commissioner of Labor,Fred Dorrell,DEM,430311,3,5,58,66,
Love,Commissioner of Labor,Brandt Dismukes,IND,430311,0,1,12,13,
Love,Insurance Commissioner,Glen Mulready,REP,430311,5,41,185,231,
Love,Insurance Commissioner,Kimberly Fobbs,DEM,430311,3,6,62,71,
Love,Corporation Commissioner,Bob Anthony,REP,430311,5,42,184,231,
Love,Corporation Commissioner,Ashley Nicole Mccray,DEM,430311,3,5,60,68,
Love,Corporation Commissioner,Jackie Short,IND,430311,0,0,10,10,
Love,U.S. House,Tom Cole,REP,430311,5,44,192,241,4
Love,U.S. House,Mary Brannon,DEM,430311,3,3,57,63,4
Love,U.S. House,Ruby Peters,IND,430311,0,0,10,10,4
Love,State Senate,Frank Simpson,REP,430311,5,42,185,232,14
Love,State Senate,Justin Arledge,DEM,430311,3,6,70,79,14
Love,State House,Tommy Hardin,REP,430311,5,41,183,229,49
Love,State House,Miranda Shelton,DEM,430311,3,6,74,83,49
Love,Governor,Chris Powell,LIB,430312,0,0,5,5,
Love,Governor,Kevin Stitt,REP,430312,0,9,167,176,
Love,Governor,Drew Edmondson,DEM,430312,4,3,71,78,
Love,Lieutenant Governor,Matt Pinnell,REP,430312,0,9,176,185,
Love,Lieutenant Governor,Anastasia Pittman,DEM,430312,4,3,58,65,
Love,Lieutenant Governor,Ivan Holmes,IND,430312,0,0,6,6,
Love,State Auditor,John Yeutter,LIB,430312,1,0,40,41,
Love,State Auditor,Cindy Byrd,REP,430312,1,11,187,199,
Love,Attorney General,Mike Hunter,REP,430312,0,11,181,192,
Love,Attorney General,Mark Myles,DEM,430312,4,1,59,64,
Love,State Treasurer,Randy Mcdaniel,REP,430312,0,9,185,194,
Love,State Treasurer,Charles De Coune,IND,430312,2,2,42,46,
Love,Superintendent of Public Instruction,Joy Hofmeister,REP,430312,0,9,161,170,
Love,Superintendent of Public Instruction,John Cox,DEM,430312,4,3,64,71,
Love,Superintendent of Public Instruction,Larry Huff,IND,430312,0,0,14,14,
Love,Commissioner of Labor,Leslie Osborn,REP,430312,0,11,168,179,
Love,Commissioner of Labor,Fred Dorrell,DEM,430312,3,1,61,65,
Love,Commissioner of Labor,Brandt Dismukes,IND,430312,1,0,6,7,
Love,Insurance Commissioner,Glen Mulready,REP,430312,0,9,169,178,
Love,Insurance Commissioner,Kimberly Fobbs,DEM,430312,4,3,69,76,
Love,Corporation Commissioner,Bob Anthony,REP,430312,0,8,163,171,
Love,Corporation Commissioner,Ashley Nicole Mccray,DEM,430312,4,3,64,71,
Love,Corporation Commissioner,Jackie Short,IND,430312,0,1,9,10,
Love,U.S. House,Tom Cole,REP,430312,0,10,182,192,4
Love,U.S. House,Mary Brannon,DEM,430312,4,2,56,62,4
Love,U.S. House,Ruby Peters,IND,430312,0,0,5,5,4
Love,State Senate,Frank Simpson,REP,430312,0,10,167,177,14
Love,State Senate,Justin Arledge,DEM,430312,4,2,76,82,14
Love,State House,Tommy Hardin,REP,430312,0,10,157,167,49
Love,State House,Miranda Shelton,DEM,430312,4,2,85,91,49
Love,Governor,Chris Powell,LIB,430313,0,0,3,3,
Love,Governor,Kevin Stitt,REP,430313,1,5,76,82,
Love,Governor,Drew Edmondson,DEM,430313,0,3,32,35,
Love,Lieutenant Governor,Matt Pinnell,REP,430313,1,5,81,87,
Love,Lieutenant Governor,Anastasia Pittman,DEM,430313,0,3,27,30,
Love,Lieutenant Governor,Ivan Holmes,IND,430313,0,0,3,3,
Love,State Auditor,John Yeutter,LIB,430313,1,1,14,16,
Love,State Auditor,Cindy Byrd,REP,430313,0,5,87,92,
Love,Attorney General,Mike Hunter,REP,430313,1,6,83,90,
Love,Attorney General,Mark Myles,DEM,430313,0,2,27,29,
Love,State Treasurer,Randy Mcdaniel,REP,430313,1,6,84,91,
Love,State Treasurer,Charles De Coune,IND,430313,0,0,17,17,
Love,Superintendent of Public Instruction,Joy Hofmeister,REP,430313,1,6,75,82,
Love,Superintendent of Public Instruction,John Cox,DEM,430313,0,2,29,31,
Love,Superintendent of Public Instruction,Larry Huff,IND,430313,0,0,6,6,
Love,Commissioner of Labor,Leslie Osborn,REP,430313,1,6,78,85,
Love,Commissioner of Labor,Fred Dorrell,DEM,430313,0,2,27,29,
Love,Commissioner of Labor,Brandt Dismukes,IND,430313,0,0,3,3,
Love,Insurance Commissioner,Glen Mulready,REP,430313,1,6,79,86,
Love,Insurance Commissioner,Kimberly Fobbs,DEM,430313,0,2,30,32,
Love,Corporation Commissioner,Bob Anthony,REP,430313,1,5,77,83,
Love,Corporation Commissioner,Ashley Nicole Mccray,DEM,430313,0,2,28,30,
Love,Corporation Commissioner,Jackie Short,IND,430313,0,1,4,5,
Love,U.S. House,Tom Cole,REP,430313,1,6,82,89,4
Love,U.S. House,Mary Brannon,DEM,430313,0,2,30,32,4
Love,U.S. House,Ruby Peters,IND,430313,0,0,0,0,4
Love,State Senate,Frank Simpson,REP,430313,1,6,78,85,14
Love,State Senate,Justin Arledge,DEM,430313,0,2,34,36,14
Love,State House,Tommy Hardin,REP,430313,1,6,81,88,49
Love,State House,Miranda Shelton,DEM,430313,0,2,31,33,49
Mcclain,Governor,Chris Powell,LIB,440001,0,0,7,7,
Mcclain,Governor,Kevin Stitt,REP,440001,4,3,140,147,
Mcclain,Governor,Drew Edmondson,DEM,440001,2,0,48,50,
Mcclain,Lieutenant Governor,Matt Pinnell,REP,440001,4,3,155,162,
Mcclain,Lieutenant Governor,Anastasia Pittman,DEM,440001,2,0,37,39,
Mcclain,Lieutenant Governor,Ivan Holmes,IND,440001,0,0,1,1,
Mcclain,State Auditor,John Yeutter,LIB,440001,0,0,25,25,
Mcclain,State Auditor,Cindy Byrd,REP,440001,5,3,159,167,
Mcclain,Attorney General,Mike Hunter,REP,440001,4,3,153,160,
Mcclain,Attorney General,Mark Myles,DEM,440001,2,0,35,37,
Mcclain,State Treasurer,Randy Mcdaniel,REP,440001,5,3,159,167,
Mcclain,State Treasurer,Charles De Coune,IND,440001,0,0,25,25,
Mcclain,Superintendent of Public Instruction,Joy Hofmeister,REP,440001,4,3,134,141,
Mcclain,Superintendent of Public Instruction,John Cox,DEM,440001,1,0,41,42,
Mcclain,Superintendent of Public Instruction,Larry Huff,IND,440001,0,0,18,18,
Mcclain,Commissioner of Labor,Leslie Osborn,REP,440001,4,2,150,156,
Mcclain,Commissioner of Labor,Fred Dorrell,DEM,440001,2,0,29,31,
Mcclain,Commissioner of Labor,Brandt Dismukes,IND,440001,0,1,6,7,
Mcclain,Insurance Commissioner,Glen Mulready,REP,440001,4,2,143,149,
Mcclain,Insurance Commissioner,Kimberly Fobbs,DEM,440001,2,1,44,47,
Mcclain,Corporation Commissioner,Bob Anthony,REP,440001,4,0,143,147,
Mcclain,Corporation Commissioner,Ashley Nicole Mccray,DEM,440001,2,3,37,42,
Mcclain,Corporation Commissioner,Jackie Short,IND,440001,0,0,9,9,
Mcclain,U.S. House,Tom Cole,REP,440001,4,1,154,159,4
Mcclain,U.S. House,Mary Brannon,DEM,440001,2,2,35,39,4
Mcclain,U.S. House,Ruby Peters,IND,440001,0,0,4,4,4
Mcclain,State House,Sherrie Conley,REP,440001,4,2,134,140,20
Mcclain,State House,Steve Jarman,DEM,440001,2,1,57,60,20
Mcclain,Governor,Chris Powell,LIB,440002,0,0,12,12,
Mcclain,Governor,Kevin Stitt,REP,440002,4,3,130,137,
Mcclain,Governor,Drew Edmondson,DEM,440002,6,1,46,53,
Mcclain,Lieutenant Governor,Matt Pinnell,REP,440002,4,3,136,143,
Mcclain,Lieutenant Governor,Anastasia Pittman,DEM,440002,6,1,41,48,
Mcclain,Lieutenant Governor,Ivan Holmes,IND,440002,0,0,11,11,
Mcclain,State Auditor,John Yeutter,LIB,440002,2,0,30,32,
Mcclain,State Auditor,Cindy Byrd,REP,440002,8,4,151,163,
Mcclain,Attorney General,Mike Hunter,REP,440002,6,3,145,154,
Mcclain,Attorney General,Mark Myles,DEM,440002,4,1,41,46,
Mcclain,State Treasurer,Randy Mcdaniel,REP,440002,6,4,148,158,
Mcclain,State Treasurer,Charles De Coune,IND,440002,4,0,30,34,
Mcclain,Superintendent of Public Instruction,Joy Hofmeister,REP,440002,5,3,134,142,
Mcclain,Superintendent of Public Instruction,John Cox,DEM,440002,5,1,37,43,
Mcclain,Superintendent of Public Instruction,Larry Huff,IND,440002,0,0,17,17,
Mcclain,Commissioner of Labor,Leslie Osborn,REP,440002,6,3,147,156,
Mcclain,Commissioner of Labor,Fred Dorrell,DEM,440002,4,1,32,37,
Mcclain,Commissioner of Labor,Brandt Dismukes,IND,440002,0,0,9,9,
Mcclain,Insurance Commissioner,Glen Mulready,REP,440002,6,3,145,154,
Mcclain,Insurance Commissioner,Kimberly Fobbs,DEM,440002,4,1,41,46,
Mcclain,Corporation Commissioner,Bob Anthony,REP,440002,5,3,133,141,
Mcclain,Corporation Commissioner,Ashley Nicole Mccray,DEM,440002,5,1,47,53,
Mcclain,Corporation Commissioner,Jackie Short,IND,440002,0,0,8,8,
Mcclain,U.S. House,Tom Cole,REP,440002,5,3,146,154,4
Mcclain,U.S. House,Mary Brannon,DEM,440002,5,1,34,40,4
Mcclain,U.S. House,Ruby Peters,IND,440002,0,0,7,7,4
Mcclain,State House,Sherrie Conley,REP,440002,4,1,134,139,20
Mcclain,State House,Steve Jarman,DEM,440002,6,3,53,62,20
Mcclain,Governor,Chris Powell,LIB,440003,0,1,11,12,
Mcclain,Governor,Kevin Stitt,REP,440003,7,20,112,139,
Mcclain,Governor,Drew Edmondson,DEM,440003,1,5,44,50,
Mcclain,Lieutenant Governor,Matt Pinnell,REP,440003,4,22,129,155,
Mcclain,Lieutenant Governor,Anastasia Pittman,DEM,440003,2,4,30,36,
Mcclain,Lieutenant Governor,Ivan Holmes,IND,440003,2,0,5,7,
Mcclain,State Auditor,John Yeutter,LIB,440003,3,0,26,29,
Mcclain,State Auditor,Cindy Byrd,REP,440003,5,26,133,164,
Mcclain,Attorney General,Mike Hunter,REP,440003,4,21,124,149,
Mcclain,Attorney General,Mark Myles,DEM,440003,4,5,38,47,
Mcclain,State Treasurer,Randy Mcdaniel,REP,440003,4,25,128,157,
Mcclain,State Treasurer,Charles De Coune,IND,440003,4,1,32,37,
Mcclain,Superintendent of Public Instruction,Joy Hofmeister,REP,440003,4,21,115,140,
Mcclain,Superintendent of Public Instruction,John Cox,DEM,440003,4,5,29,38,
Mcclain,Superintendent of Public Instruction,Larry Huff,IND,440003,0,0,20,20,
Mcclain,Commissioner of Labor,Leslie Osborn,REP,440003,4,23,122,149,
Mcclain,Commissioner of Labor,Fred Dorrell,DEM,440003,4,3,31,38,
Mcclain,Commissioner of Labor,Brandt Dismukes,IND,440003,0,0,8,8,
Mcclain,Insurance Commissioner,Glen Mulready,REP,440003,6,23,123,152,
Mcclain,Insurance Commissioner,Kimberly Fobbs,DEM,440003,2,3,39,44,
Mcclain,Corporation Commissioner,Bob Anthony,REP,440003,4,21,108,133,
Mcclain,Corporation Commissioner,Ashley Nicole Mccray,DEM,440003,4,5,42,51,
Mcclain,Corporation Commissioner,Jackie Short,IND,440003,0,0,9,9,
Mcclain,U.S. House,Tom Cole,REP,440003,4,21,121,146,4
Mcclain,U.S. House,Mary Brannon,DEM,440003,4,5,37,46,4
Mcclain,U.S. House,Ruby Peters,IND,440003,0,0,7,7,4
Mcclain,State House,Sherrie Conley,REP,440003,6,18,117,141,20
Mcclain,State House,Steve Jarman,DEM,440003,2,8,48,58,20
Mcclain,Governor,Chris Powell,LIB,440004,0,0,7,7,
Mcclain,Governor,Kevin Stitt,REP,440004,7,6,158,171,
Mcclain,Governor,Drew Edmondson,DEM,440004,4,6,96,106,
Mcclain,Lieutenant Governor,Matt Pinnell,REP,440004,7,5,172,184,
Mcclain,Lieutenant Governor,Anastasia Pittman,DEM,440004,4,7,79,90,
Mcclain,Lieutenant Governor,Ivan Holmes,IND,440004,0,0,9,9,
Mcclain,State Auditor,John Yeutter,LIB,440004,1,4,49,54,
Mcclain,State Auditor,Cindy Byrd,REP,440004,8,7,195,210,
Mcclain,Attorney General,Mike Hunter,REP,440004,6,6,185,197,
Mcclain,Attorney General,Mark Myles,DEM,440004,4,6,74,84,
Mcclain,State Treasurer,Randy Mcdaniel,REP,440004,7,8,188,203,
Mcclain,State Treasurer,Charles De Coune,IND,440004,3,3,58,64,
Mcclain,Superintendent of Public Instruction,Joy Hofmeister,REP,440004,9,7,162,178,
Mcclain,Superintendent of Public Instruction,John Cox,DEM,440004,2,5,70,77,
Mcclain,Superintendent of Public Instruction,Larry Huff,IND,440004,0,0,26,26,
Mcclain,Commissioner of Labor,Leslie Osborn,REP,440004,6,8,180,194,
Mcclain,Commissioner of Labor,Fred Dorrell,DEM,440004,5,4,66,75,
Mcclain,Commissioner of Labor,Brandt Dismukes,IND,440004,0,0,11,11,
Mcclain,Insurance Commissioner,Glen Mulready,REP,440004,7,5,174,186,
Mcclain,Insurance Commissioner,Kimberly Fobbs,DEM,440004,4,6,81,91,
Mcclain,Corporation Commissioner,Bob Anthony,REP,440004,6,5,166,177,
Mcclain,Corporation Commissioner,Ashley Nicole Mccray,DEM,440004,4,7,74,85,
Mcclain,Corporation Commissioner,Jackie Short,IND,440004,1,0,16,17,
Mcclain,U.S. House,Tom Cole,REP,440004,6,5,183,194,4
Mcclain,U.S. House,Mary Brannon,DEM,440004,4,7,69,80,4
Mcclain,U.S. House,Ruby Peters,IND,440004,1,0,8,9,4
Mcclain,State House,Cynthia Roe,REP,440004,8,5,168,181,42
Mcclain,State House,Liz George,DEM,440004,3,7,91,101,42
Mcclain,Governor,Chris Powell,LIB,440005,2,1,19,22,
Mcclain,Governor,Kevin Stitt,REP,440005,25,19,351,395,
Mcclain,Governor,Drew Edmondson,DEM,440005,9,8,101,118,
Mcclain,Lieutenant Governor,Matt Pinnell,REP,440005,27,19,373,419,
Mcclain,Lieutenant Governor,Anastasia Pittman,DEM,440005,6,8,72,86,
Mcclain,Lieutenant Governor,Ivan Holmes,IND,440005,2,1,20,23,
Mcclain,State Auditor,John Yeutter,LIB,440005,4,6,66,76,
Mcclain,State Auditor,Cindy Byrd,REP,440005,30,22,385,437,
Mcclain,Attorney General,Mike Hunter,REP,440005,28,19,381,428,
Mcclain,Attorney General,Mark Myles,DEM,440005,5,9,84,98,
Mcclain,State Treasurer,Randy Mcdaniel,REP,440005,30,21,386,437,
Mcclain,State Treasurer,Charles De Coune,IND,440005,4,7,65,76,
Mcclain,Superintendent of Public Instruction,Joy Hofmeister,REP,440005,29,20,341,390,
Mcclain,Superintendent of Public Instruction,John Cox,DEM,440005,3,5,86,94,
Mcclain,Superintendent of Public Instruction,Larry Huff,IND,440005,3,3,43,49,
Mcclain,Commissioner of Labor,Leslie Osborn,REP,440005,27,21,372,420,
Mcclain,Commissioner of Labor,Fred Dorrell,DEM,440005,6,7,69,82,
Mcclain,Commissioner of Labor,Brandt Dismukes,IND,440005,2,0,23,25,
Mcclain,Insurance Commissioner,Glen Mulready,REP,440005,27,21,373,421,
Mcclain,Insurance Commissioner,Kimberly Fobbs,DEM,440005,5,7,93,105,
Mcclain,Corporation Commissioner,Bob Anthony,REP,440005,26,19,361,406,
Mcclain,Corporation Commissioner,Ashley Nicole Mccray,DEM,440005,8,8,74,90,
Mcclain,Corporation Commissioner,Jackie Short,IND,440005,2,1,32,35,
Mcclain,U.S. House,Tom Cole,REP,440005,28,22,380,430,4
Mcclain,U.S. House,Mary Brannon,DEM,440005,6,6,74,86,4
Mcclain,U.S. House,Ruby Peters,IND,440005,2,0,16,18,4
Mcclain,State House,Cynthia Roe,REP,440005,24,20,361,405,42
Mcclain,State House,Liz George,DEM,440005,10,8,105,123,42
Mcclain,Governor,Chris Powell,LIB,440006,0,3,15,18,
Mcclain,Governor,Kevin Stitt,REP,440006,22,112,422,556,
Mcclain,Governor,Drew Edmondson,DEM,440006,6,43,190,239,
Mcclain,Lieutenant Governor,Matt Pinnell,REP,440006,24,122,467,613,
Mcclain,Lieutenant Governor,Anastasia Pittman,DEM,440006,3,34,143,180,
Mcclain,Lieutenant Governor,Ivan Holmes,IND,440006,1,2,12,15,
Mcclain,State Auditor,John Yeutter,LIB,440006,5,22,68,95,
Mcclain,State Auditor,Cindy Byrd,REP,440006,23,129,520,672,
Mcclain,Attorney General,Mike Hunter,REP,440006,20,126,495,641,
Mcclain,Attorney General,Mark Myles,DEM,440006,8,31,127,166,
Mcclain,State Treasurer,Randy Mcdaniel,REP,440006,23,132,495,650,
Mcclain,State Treasurer,Charles De Coune,IND,440006,5,19,92,116,
Mcclain,Superintendent of Public Instruction,Joy Hofmeister,REP,440006,20,115,460,595,
Mcclain,Superintendent of Public Instruction,John Cox,DEM,440006,6,30,120,156,
Mcclain,Superintendent of Public Instruction,Larry Huff,IND,440006,2,11,42,55,
Mcclain,Commissioner of Labor,Leslie Osborn,REP,440006,22,123,475,620,
Mcclain,Commissioner of Labor,Fred Dorrell,DEM,440006,5,28,110,143,
Mcclain,Commissioner of Labor,Brandt Dismukes,IND,440006,1,5,30,36,
Mcclain,Insurance Commissioner,Glen Mulready,REP,440006,22,122,464,608,
Mcclain,Insurance Commissioner,Kimberly Fobbs,DEM,440006,6,34,153,193,
Mcclain,Corporation Commissioner,Bob Anthony,REP,440006,24,108,440,572,
Mcclain,Corporation Commissioner,Ashley Nicole Mccray,DEM,440006,2,37,142,181,
Mcclain,Corporation Commissioner,Jackie Short,IND,440006,2,12,36,50,
Mcclain,U.S. House,Tom Cole,REP,440006,25,116,459,600,4
Mcclain,U.S. House,Mary Brannon,DEM,440006,2,38,142,182,4
Mcclain,U.S. House,Ruby Peters,IND,440006,1,3,26,30,4
Mcclain,State House,Cynthia Roe,REP,440006,21,109,398,528,42
Mcclain,State House,Liz George,DEM,440006,7,49,220,276,42
Mcclain,Governor,Chris Powell,LIB,440007,0,1,4,5,
Mcclain,Governor,Kevin Stitt,REP,440007,3,20,188,211,
Mcclain,Governor,Drew Edmondson,DEM,440007,5,18,73,96,
Mcclain,Lieutenant Governor,Matt Pinnell,REP,440007,4,24,198,226,
Mcclain,Lieutenant Governor,Anastasia Pittman,DEM,440007,4,14,54,72,
Mcclain,Lieutenant Governor,Ivan Holmes,IND,440007,0,1,10,11,
Mcclain,State Auditor,John Yeutter,LIB,440007,2,12,31,45,
Mcclain,State Auditor,Cindy Byrd,REP,440007,5,25,224,254,
Mcclain,Attorney General,Mike Hunter,REP,440007,3,25,213,241,
Mcclain,Attorney General,Mark Myles,DEM,440007,5,14,52,71,
Mcclain,State Treasurer,Randy Mcdaniel,REP,440007,4,28,211,243,
Mcclain,State Treasurer,Charles De Coune,IND,440007,3,9,37,49,
Mcclain,Superintendent of Public Instruction,Joy Hofmeister,REP,440007,3,22,184,209,
Mcclain,Superintendent of Public Instruction,John Cox,DEM,440007,5,16,54,75,
Mcclain,Superintendent of Public Instruction,Larry Huff,IND,440007,0,1,24,25,
Mcclain,Commissioner of Labor,Leslie Osborn,REP,440007,3,24,197,224,
Mcclain,Commissioner of Labor,Fred Dorrell,DEM,440007,5,15,55,75,
Mcclain,Commissioner of Labor,Brandt Dismukes,IND,440007,0,0,10,10,
Mcclain,Insurance Commissioner,Glen Mulready,REP,440007,4,22,195,221,
Mcclain,Insurance Commissioner,Kimberly Fobbs,DEM,440007,4,17,66,87,
Mcclain,Corporation Commissioner,Bob Anthony,REP,440007,3,20,187,210,
Mcclain,Corporation Commissioner,Ashley Nicole Mccray,DEM,440007,4,16,54,74,
Mcclain,Corporation Commissioner,Jackie Short,IND,440007,1,3,19,23,
Mcclain,U.S. House,Tom Cole,REP,440007,4,24,198,226,4
Mcclain,U.S. House,Mary Brannon,DEM,440007,4,14,58,76,4
Mcclain,U.S. House,Ruby Peters,IND,440007,0,1,9,10,4
Mcclain,State House,Cynthia Roe,REP,440007,3,15,183,201,42
Mcclain,State House,Liz George,DEM,440007,4,23,79,106,42
Mcclain,Governor,Chris Powell,LIB,440008,0,0,17,17,
Mcclain,Governor,Kevin Stitt,REP,440008,18,36,397,451,
Mcclain,Governor,Drew Edmondson,DEM,440008,12,3,178,193,
Mcclain,Lieutenant Governor,Matt Pinnell,REP,440008,18,34,441,493,
Mcclain,Lieutenant Governor,Anastasia Pittman,DEM,440008,9,4,134,147,
Mcclain,Lieutenant Governor,Ivan Holmes,IND,440008,2,1,16,19,
Mcclain,State Auditor,John Yeutter,LIB,440008,6,3,75,84,
Mcclain,State Auditor,Cindy Byrd,REP,440008,23,35,489,547,
Mcclain,Attorney General,Mike Hunter,REP,440008,17,34,451,502,
Mcclain,Attorney General,Mark Myles,DEM,440008,12,4,134,150,
Mcclain,State Treasurer,Randy Mcdaniel,REP,440008,21,35,462,518,
Mcclain,State Treasurer,Charles De Coune,IND,440008,8,3,101,112,
Mcclain,Superintendent of Public Instruction,Joy Hofmeister,REP,440008,17,34,425,476,
Mcclain,Superintendent of Public Instruction,John Cox,DEM,440008,7,4,127,138,
Mcclain,Superintendent of Public Instruction,Larry Huff,IND,440008,5,1,38,44,
Mcclain,Commissioner of Labor,Leslie Osborn,REP,440008,19,35,436,490,
Mcclain,Commissioner of Labor,Fred Dorrell,DEM,440008,7,3,126,136,
Mcclain,Commissioner of Labor,Brandt Dismukes,IND,440008,3,0,22,25,
Mcclain,Insurance Commissioner,Glen Mulready,REP,440008,16,35,437,488,
Mcclain,Insurance Commissioner,Kimberly Fobbs,DEM,440008,12,3,144,159,
Mcclain,Corporation Commissioner,Bob Anthony,REP,440008,17,35,425,477,
Mcclain,Corporation Commissioner,Ashley Nicole Mccray,DEM,440008,9,3,135,147,
Mcclain,Corporation Commissioner,Jackie Short,IND,440008,3,0,25,28,
Mcclain,U.S. House,Tom Cole,REP,440008,20,34,458,512,4
Mcclain,U.S. House,Mary Brannon,DEM,440008,8,4,117,129,4
Mcclain,U.S. House,Ruby Peters,IND,440008,1,1,13,15,4
Mcclain,State House,Cynthia Roe,REP,440008,18,32,397,447,42
Mcclain,State House,Liz George,DEM,440008,11,6,192,209,42
Mcclain,Governor,Chris Powell,LIB,440009,2,1,21,24,
Mcclain,Governor,Kevin Stitt,REP,440009,40,31,411,482,
Mcclain,Governor,Drew Edmondson,DEM,440009,26,15,295,336,
Mcclain,Lieutenant Governor,Matt Pinnell,REP,440009,41,32,464,537,
Mcclain,Lieutenant Governor,Anastasia Pittman,DEM,440009,23,15,240,278,
Mcclain,Lieutenant Governor,Ivan Holmes,IND,440009,4,0,18,22,
Mcclain,State Auditor,John Yeutter,LIB,440009,15,7,137,159,
Mcclain,State Auditor,Cindy Byrd,REP,440009,47,37,553,637,
Mcclain,Attorney General,Mike Hunter,REP,440009,40,31,491,562,
Mcclain,Attorney General,Mark Myles,DEM,440009,27,16,229,272,
Mcclain,State Treasurer,Randy Mcdaniel,REP,440009,44,35,500,579,
Mcclain,State Treasurer,Charles De Coune,IND,440009,18,10,178,206,
Mcclain,Superintendent of Public Instruction,Joy Hofmeister,REP,440009,44,32,474,550,
Mcclain,Superintendent of Public Instruction,John Cox,DEM,440009,22,12,201,235,
Mcclain,Superintendent of Public Instruction,Larry Huff,IND,440009,1,3,48,52,
Mcclain,Commissioner of Labor,Leslie Osborn,REP,440009,43,33,473,549,
Mcclain,Commissioner of Labor,Fred Dorrell,DEM,440009,22,13,202,237,
Mcclain,Commissioner of Labor,Brandt Dismukes,IND,440009,0,1,32,33,
Mcclain,Insurance Commissioner,Glen Mulready,REP,440009,39,32,459,530,
Mcclain,Insurance Commissioner,Kimberly Fobbs,DEM,440009,26,15,251,292,
Mcclain,Corporation Commissioner,Bob Anthony,REP,440009,40,34,471,545,
Mcclain,Corporation Commissioner,Ashley Nicole Mccray,DEM,440009,25,11,204,240,
Mcclain,Corporation Commissioner,Jackie Short,IND,440009,1,2,41,44,
Mcclain,U.S. House,Tom Cole,REP,440009,44,30,481,555,4
Mcclain,U.S. House,Mary Brannon,DEM,440009,24,16,225,265,4
Mcclain,U.S. House,Ruby Peters,IND,440009,0,1,19,20,4
Mcclain,State House,Sherrie Conley,REP,440009,44,33,480,557,20
Mcclain,State House,Steve Jarman,DEM,440009,22,14,241,277,20
Mcclain,Governor,Chris Powell,LIB,440010,0,0,2,2,
Mcclain,Governor,Kevin Stitt,REP,440010,8,13,122,143,
Mcclain,Governor,Drew Edmondson,DEM,440010,0,0,41,41,
Mcclain,Lieutenant Governor,Matt Pinnell,REP,440010,7,13,123,143,
Mcclain,Lieutenant Governor,Anastasia Pittman,DEM,440010,1,0,32,33,
Mcclain,Lieutenant Governor,Ivan Holmes,IND,440010,0,0,5,5,
Mcclain,State Auditor,John Yeutter,LIB,440010,1,0,22,23,
Mcclain,State Auditor,Cindy Byrd,REP,440010,7,13,135,155,
Mcclain,Attorney General,Mike Hunter,REP,440010,7,12,125,144,
Mcclain,Attorney General,Mark Myles,DEM,440010,1,1,32,34,
Mcclain,State Treasurer,Randy Mcdaniel,REP,440010,7,13,129,149,
Mcclain,State Treasurer,Charles De Coune,IND,440010,1,0,29,30,
Mcclain,Superintendent of Public Instruction,Joy Hofmeister,REP,440010,7,10,108,125,
Mcclain,Superintendent of Public Instruction,John Cox,DEM,440010,1,2,35,38,
Mcclain,Superintendent of Public Instruction,Larry Huff,IND,440010,0,1,17,18,
Mcclain,Commissioner of Labor,Leslie Osborn,REP,440010,7,11,124,142,
Mcclain,Commissioner of Labor,Fred Dorrell,DEM,440010,1,1,28,30,
Mcclain,Commissioner of Labor,Brandt Dismukes,IND,440010,0,1,8,9,
Mcclain,Insurance Commissioner,Glen Mulready,REP,440010,6,13,123,142,
Mcclain,Insurance Commissioner,Kimberly Fobbs,DEM,440010,1,0,35,36,
Mcclain,Corporation Commissioner,Bob Anthony,REP,440010,6,12,118,136,
Mcclain,Corporation Commissioner,Ashley Nicole Mccray,DEM,440010,1,0,29,30,
Mcclain,Corporation Commissioner,Jackie Short,IND,440010,1,1,12,14,
Mcclain,U.S. House,Tom Cole,REP,440010,7,13,124,144,4
Mcclain,U.S. House,Mary Brannon,DEM,440010,1,0,30,31,4
Mcclain,U.S. House,Ruby Peters,IND,440010,0,0,6,6,4
Mcclain,State House,Cynthia Roe,REP,440010,6,13,116,135,42
Mcclain,State House,Liz George,DEM,440010,2,0,45,47,42
Mcclain,Governor,Chris Powell,LIB,440011,0,0,14,14,
Mcclain,Governor,Kevin Stitt,REP,440011,11,14,210,235,
Mcclain,Governor,Drew Edmondson,DEM,440011,1,3,74,78,
Mcclain,Lieutenant Governor,Matt Pinnell,REP,440011,11,14,230,255,
Mcclain,Lieutenant Governor,Anastasia Pittman,DEM,440011,1,3,60,64,
Mcclain,Lieutenant Governor,Ivan Holmes,IND,440011,0,0,5,5,
Mcclain,State Auditor,John Yeutter,LIB,440011,2,1,36,39,
Mcclain,State Auditor,Cindy Byrd,REP,440011,10,14,247,271,
Mcclain,Attorney General,Mike Hunter,REP,440011,11,13,234,258,
Mcclain,Attorney General,Mark Myles,DEM,440011,1,4,61,66,
Mcclain,State Treasurer,Randy Mcdaniel,REP,440011,10,14,239,263,
Mcclain,State Treasurer,Charles De Coune,IND,440011,2,1,40,43,
Mcclain,Superintendent of Public Instruction,Joy Hofmeister,REP,440011,10,9,212,231,
Mcclain,Superintendent of Public Instruction,John Cox,DEM,440011,2,2,59,63,
Mcclain,Superintendent of Public Instruction,Larry Huff,IND,440011,0,6,26,32,
Mcclain,Commissioner of Labor,Leslie Osborn,REP,440011,10,13,229,252,
Mcclain,Commissioner of Labor,Fred Dorrell,DEM,440011,2,4,52,58,
Mcclain,Commissioner of Labor,Brandt Dismukes,IND,440011,0,0,11,11,
Mcclain,Insurance Commissioner,Glen Mulready,REP,440011,11,14,224,249,
Mcclain,Insurance Commissioner,Kimberly Fobbs,DEM,440011,1,3,70,74,
Mcclain,Corporation Commissioner,Bob Anthony,REP,440011,10,14,218,242,
Mcclain,Corporation Commissioner,Ashley Nicole Mccray,DEM,440011,2,3,57,62,
Mcclain,Corporation Commissioner,Jackie Short,IND,440011,0,0,20,20,
Mcclain,U.S. House,Tom Cole,REP,440011,10,14,230,254,4
Mcclain,U.S. House,Mary Brannon,DEM,440011,1,3,55,59,4
Mcclain,U.S. House,Ruby Peters,IND,440011,1,0,13,14,4
Mcclain,State House,Cynthia Roe,REP,440011,10,14,223,247,42
Mcclain,State House,Liz George,DEM,440011,2,3,74,79,42
Mcclain,Governor,Chris Powell,LIB,440012,4,0,37,41,
Mcclain,Governor,Kevin Stitt,REP,440012,25,20,591,636,
Mcclain,Governor,Drew Edmondson,DEM,440012,27,4,293,324,
Mcclain,Lieutenant Governor,Matt Pinnell,REP,440012,28,20,680,728,
Mcclain,Lieutenant Governor,Anastasia Pittman,DEM,440012,27,4,210,241,
Mcclain,Lieutenant Governor,Ivan Holmes,IND,440012,1,0,29,30,
Mcclain,State Auditor,John Yeutter,LIB,440012,14,3,147,164,
Mcclain,State Auditor,Cindy Byrd,REP,440012,34,21,731,786,
Mcclain,Attorney General,Mike Hunter,REP,440012,31,20,708,759,
Mcclain,Attorney General,Mark Myles,DEM,440012,25,4,208,237,
Mcclain,State Treasurer,Randy Mcdaniel,REP,440012,31,20,705,756,
Mcclain,State Treasurer,Charles De Coune,IND,440012,19,4,177,200,
Mcclain,Superintendent of Public Instruction,Joy Hofmeister,REP,440012,26,18,615,659,
Mcclain,Superintendent of Public Instruction,John Cox,DEM,440012,24,5,213,242,
Mcclain,Superintendent of Public Instruction,Larry Huff,IND,440012,3,1,87,91,
Mcclain,Commissioner of Labor,Leslie Osborn,REP,440012,32,21,691,744,
Mcclain,Commissioner of Labor,Fred Dorrell,DEM,440012,22,3,174,199,
Mcclain,Commissioner of Labor,Brandt Dismukes,IND,440012,1,0,42,43,
Mcclain,Insurance Commissioner,Glen Mulready,REP,440012,28,20,673,721,
Mcclain,Insurance Commissioner,Kimberly Fobbs,DEM,440012,27,4,235,266,
Mcclain,Corporation Commissioner,Bob Anthony,REP,440012,29,19,624,672,
Mcclain,Corporation Commissioner,Ashley Nicole Mccray,DEM,440012,23,5,232,260,
Mcclain,Corporation Commissioner,Jackie Short,IND,440012,3,0,55,58,
Mcclain,U.S. House,Tom Cole,REP,440012,33,20,684,737,4
Mcclain,U.S. House,Mary Brannon,DEM,440012,21,4,190,215,4
Mcclain,U.S. House,Ruby Peters,IND,440012,2,0,43,45,4
Mcclain,State House,Cynthia Roe,REP,440012,18,18,539,575,42
Mcclain,State House,Liz George,DEM,440012,38,6,381,425,42
Mcclain,Governor,Chris Powell,LIB,440013,2,2,71,75,
Mcclain,Governor,Kevin Stitt,REP,440013,87,30,975,1092,
Mcclain,Governor,Drew Edmondson,DEM,440013,33,19,440,492,
Mcclain,Lieutenant Governor,Matt Pinnell,REP,440013,94,31,1076,1201,
Mcclain,Lieutenant Governor,Anastasia Pittman,DEM,440013,21,15,342,378,
Mcclain,Lieutenant Governor,Ivan Holmes,IND,440013,7,5,61,73,
Mcclain,State Auditor,John Yeutter,LIB,440013,14,11,236,261,
Mcclain,State Auditor,Cindy Byrd,REP,440013,101,34,1166,1301,
Mcclain,Attorney General,Mike Hunter,REP,440013,95,32,1109,1236,
Mcclain,Attorney General,Mark Myles,DEM,440013,26,19,365,410,
Mcclain,State Treasurer,Randy Mcdaniel,REP,440013,96,32,1139,1267,
Mcclain,State Treasurer,Charles De Coune,IND,440013,19,12,257,288,
Mcclain,Superintendent of Public Instruction,Joy Hofmeister,REP,440013,92,31,1027,1150,
Mcclain,Superintendent of Public Instruction,John Cox,DEM,440013,21,14,317,352,
Mcclain,Superintendent of Public Instruction,Larry Huff,IND,440013,8,6,134,148,
Mcclain,Commissioner of Labor,Leslie Osborn,REP,440013,94,33,1086,1213,
Mcclain,Commissioner of Labor,Fred Dorrell,DEM,440013,25,14,300,339,
Mcclain,Commissioner of Labor,Brandt Dismukes,IND,440013,3,4,76,83,
Mcclain,Insurance Commissioner,Glen Mulready,REP,440013,91,31,1073,1195,
Mcclain,Insurance Commissioner,Kimberly Fobbs,DEM,440013,31,20,385,436,
Mcclain,Corporation Commissioner,Bob Anthony,REP,440013,93,28,1036,1157,
Mcclain,Corporation Commissioner,Ashley Nicole Mccray,DEM,440013,25,18,345,388,
Mcclain,Corporation Commissioner,Jackie Short,IND,440013,4,5,88,97,
Mcclain,U.S. House,Tom Cole,REP,440013,93,29,1087,1209,4
Mcclain,U.S. House,Mary Brannon,DEM,440013,27,20,329,376,4
Mcclain,U.S. House,Ruby Peters,IND,440013,2,1,62,65,4
Mcclain,State House,Sherrie Conley,REP,440013,90,35,1145,1270,20
Mcclain,State House,Steve Jarman,DEM,440013,32,16,324,372,20
Mcclain,Governor,Chris Powell,LIB,440014,0,0,10,10,
Mcclain,Governor,Kevin Stitt,REP,440014,25,7,351,383,
Mcclain,Governor,Drew Edmondson,DEM,440014,9,3,123,135,
Mcclain,Lieutenant Governor,Matt Pinnell,REP,440014,24,8,377,409,
Mcclain,Lieutenant Governor,Anastasia Pittman,DEM,440014,10,2,94,106,
Mcclain,Lieutenant Governor,Ivan Holmes,IND,440014,0,0,11,11,
Mcclain,State Auditor,John Yeutter,LIB,440014,5,2,66,73,
Mcclain,State Auditor,Cindy Byrd,REP,440014,26,8,395,429,
Mcclain,Attorney General,Mike Hunter,REP,440014,24,8,397,429,
Mcclain,Attorney General,Mark Myles,DEM,440014,10,2,79,91,
Mcclain,State Treasurer,Randy Mcdaniel,REP,440014,26,8,380,414,
Mcclain,State Treasurer,Charles De Coune,IND,440014,7,2,82,91,
Mcclain,Superintendent of Public Instruction,Joy Hofmeister,REP,440014,22,9,355,386,
Mcclain,Superintendent of Public Instruction,John Cox,DEM,440014,11,1,87,99,
Mcclain,Superintendent of Public Instruction,Larry Huff,IND,440014,0,0,38,38,
Mcclain,Commissioner of Labor,Leslie Osborn,REP,440014,25,8,375,408,
Mcclain,Commissioner of Labor,Fred Dorrell,DEM,440014,6,2,82,90,
Mcclain,Commissioner of Labor,Brandt Dismukes,IND,440014,1,0,19,20,
Mcclain,Insurance Commissioner,Glen Mulready,REP,440014,25,7,371,403,
Mcclain,Insurance Commissioner,Kimberly Fobbs,DEM,440014,9,3,102,114,
Mcclain,Corporation Commissioner,Bob Anthony,REP,440014,24,8,362,394,
Mcclain,Corporation Commissioner,Ashley Nicole Mccray,DEM,440014,10,2,95,107,
Mcclain,Corporation Commissioner,Jackie Short,IND,440014,0,0,19,19,
Mcclain,U.S. House,Tom Cole,REP,440014,24,8,379,411,4
Mcclain,U.S. House,Mary Brannon,DEM,440014,8,2,89,99,4
Mcclain,U.S. House,Ruby Peters,IND,440014,1,0,16,17,4
Mcclain,State House,Sherrie Conley,REP,440014,27,9,384,420,20
Mcclain,State House,Steve Jarman,DEM,440014,7,1,92,100,20
Mcclain,Governor,Chris Powell,LIB,440015,4,0,31,35,
Mcclain,Governor,Kevin Stitt,REP,440015,20,13,518,551,
Mcclain,Governor,Drew Edmondson,DEM,440015,24,8,206,238,
Mcclain,Lieutenant Governor,Matt Pinnell,REP,440015,28,14,583,625,
Mcclain,Lieutenant Governor,Anastasia Pittman,DEM,440015,18,5,137,160,
Mcclain,Lieutenant Governor,Ivan Holmes,IND,440015,2,2,35,39,
Mcclain,State Auditor,John Yeutter,LIB,440015,11,3,124,138,
Mcclain,State Auditor,Cindy Byrd,REP,440015,34,14,596,644,
Mcclain,Attorney General,Mike Hunter,REP,440015,30,15,594,639,
Mcclain,Attorney General,Mark Myles,DEM,440015,18,5,153,176,
Mcclain,State Treasurer,Randy Mcdaniel,REP,440015,31,16,592,639,
Mcclain,State Treasurer,Charles De Coune,IND,440015,14,2,130,146,
Mcclain,Superintendent of Public Instruction,Joy Hofmeister,REP,440015,32,12,533,577,
Mcclain,Superintendent of Public Instruction,John Cox,DEM,440015,13,8,142,163,
Mcclain,Superintendent of Public Instruction,Larry Huff,IND,440015,3,1,79,83,
Mcclain,Commissioner of Labor,Leslie Osborn,REP,440015,31,10,574,615,
Mcclain,Commissioner of Labor,Fred Dorrell,DEM,440015,13,5,129,147,
Mcclain,Commissioner of Labor,Brandt Dismukes,IND,440015,4,4,40,48,
Mcclain,Insurance Commissioner,Glen Mulready,REP,440015,30,15,575,620,
Mcclain,Insurance Commissioner,Kimberly Fobbs,DEM,440015,18,5,169,192,
Mcclain,Corporation Commissioner,Bob Anthony,REP,440015,27,11,524,562,
Mcclain,Corporation Commissioner,Ashley Nicole Mccray,DEM,440015,19,6,156,181,
Mcclain,Corporation Commissioner,Jackie Short,IND,440015,2,4,66,72,
Mcclain,U.S. House,Tom Cole,REP,440015,29,13,576,618,4
Mcclain,U.S. House,Mary Brannon,DEM,440015,17,5,130,152,4
Mcclain,U.S. House,Ruby Peters,IND,440015,2,2,45,49,4
Mcclain,Governor,Chris Powell,LIB,440016,0,3,32,35,
Mcclain,Governor,Kevin Stitt,REP,440016,29,22,493,544,
Mcclain,Governor,Drew Edmondson,DEM,440016,25,4,268,297,
Mcclain,Lieutenant Governor,Matt Pinnell,REP,440016,34,25,573,632,
Mcclain,Lieutenant Governor,Anastasia Pittman,DEM,440016,20,3,190,213,
Mcclain,Lieutenant Governor,Ivan Holmes,IND,440016,1,1,26,28,
Mcclain,State Auditor,John Yeutter,LIB,440016,7,3,127,137,
Mcclain,State Auditor,Cindy Byrd,REP,440016,40,25,627,692,
Mcclain,Attorney General,Mike Hunter,REP,440016,36,26,590,652,
Mcclain,Attorney General,Mark Myles,DEM,440016,18,3,197,218,
Mcclain,State Treasurer,Randy Mcdaniel,REP,440016,40,26,608,674,
Mcclain,State Treasurer,Charles De Coune,IND,440016,7,2,143,152,
Mcclain,Superintendent of Public Instruction,Joy Hofmeister,REP,440016,30,19,514,563,
Mcclain,Superintendent of Public Instruction,John Cox,DEM,440016,23,7,222,252,
Mcclain,Superintendent of Public Instruction,Larry Huff,IND,440016,2,3,52,57,
Mcclain,Commissioner of Labor,Leslie Osborn,REP,440016,37,24,564,625,
Mcclain,Commissioner of Labor,Fred Dorrell,DEM,440016,14,5,185,204,
Mcclain,Commissioner of Labor,Brandt Dismukes,IND,440016,4,0,31,35,
Mcclain,Insurance Commissioner,Glen Mulready,REP,440016,32,26,556,614,
Mcclain,Insurance Commissioner,Kimberly Fobbs,DEM,440016,21,3,225,249,
Mcclain,Corporation Commissioner,Bob Anthony,REP,440016,32,25,534,591,
Mcclain,Corporation Commissioner,Ashley Nicole Mccray,DEM,440016,19,3,210,232,
Mcclain,Corporation Commissioner,Jackie Short,IND,440016,3,1,39,43,
Mcclain,U.S. House,Tom Cole,REP,440016,36,26,586,648,4
Mcclain,U.S. House,Mary Brannon,DEM,440016,17,3,181,201,4
Mcclain,U.S. House,Ruby Peters,IND,440016,1,0,23,24,4
Mcclain,State House,Cynthia Roe,REP,440016,22,18,433,473,42
Mcclain,State House,Liz George,DEM,440016,34,11,359,404,42
Mcclain,Governor,Chris Powell,LIB,440017,0,1,5,6,
Mcclain,Governor,Kevin Stitt,REP,440017,9,6,106,121,
Mcclain,Governor,Drew Edmondson,DEM,440017,1,2,47,50,
Mcclain,Lieutenant Governor,Matt Pinnell,REP,440017,10,7,116,133,
Mcclain,Lieutenant Governor,Anastasia Pittman,DEM,440017,0,2,33,35,
Mcclain,Lieutenant Governor,Ivan Holmes,IND,440017,0,0,9,9,
Mcclain,State Auditor,John Yeutter,LIB,440017,0,2,29,31,
Mcclain,State Auditor,Cindy Byrd,REP,440017,10,7,124,141,
Mcclain,Attorney General,Mike Hunter,REP,440017,10,8,118,136,
Mcclain,Attorney General,Mark Myles,DEM,440017,0,1,39,40,
Mcclain,State Treasurer,Randy Mcdaniel,REP,440017,10,5,118,133,
Mcclain,State Treasurer,Charles De Coune,IND,440017,0,4,37,41,
Mcclain,Superintendent of Public Instruction,Joy Hofmeister,REP,440017,10,8,109,127,
Mcclain,Superintendent of Public Instruction,John Cox,DEM,440017,0,1,28,29,
Mcclain,Superintendent of Public Instruction,Larry Huff,IND,440017,0,0,21,21,
Mcclain,Commissioner of Labor,Leslie Osborn,REP,440017,10,6,116,132,
Mcclain,Commissioner of Labor,Fred Dorrell,DEM,440017,0,3,27,30,
Mcclain,Commissioner of Labor,Brandt Dismukes,IND,440017,0,0,14,14,
Mcclain,Insurance Commissioner,Glen Mulready,REP,440017,10,6,112,128,
Mcclain,Insurance Commissioner,Kimberly Fobbs,DEM,440017,0,3,45,48,
Mcclain,Corporation Commissioner,Bob Anthony,REP,440017,10,8,110,128,
Mcclain,Corporation Commissioner,Ashley Nicole Mccray,DEM,440017,0,1,35,36,
Mcclain,Corporation Commissioner,Jackie Short,IND,440017,0,0,11,11,
Mcclain,U.S. House,Tom Cole,REP,440017,6,8,113,127,4
Mcclain,U.S. House,Mary Brannon,DEM,440017,0,1,35,36,4
Mcclain,U.S. House,Ruby Peters,IND,440017,4,0,8,12,4
Mcclain,State House,Sherrie Conley,REP,440017,8,6,119,133,20
Mcclain,State House,Steve Jarman,DEM,440017,2,3,39,44,20
Mcclain,Governor,Chris Powell,LIB,440018,0,3,6,9,
Mcclain,Governor,Kevin Stitt,REP,440018,19,4,313,336,
Mcclain,Governor,Drew Edmondson,DEM,440018,13,3,131,147,
Mcclain,Lieutenant Governor,Matt Pinnell,REP,440018,20,6,340,366,
Mcclain,Lieutenant Governor,Anastasia Pittman,DEM,440018,10,3,99,112,
Mcclain,Lieutenant Governor,Ivan Holmes,IND,440018,2,1,11,14,
Mcclain,State Auditor,John Yeutter,LIB,440018,3,3,59,65,
Mcclain,State Auditor,Cindy Byrd,REP,440018,29,7,377,413,
Mcclain,Attorney General,Mike Hunter,REP,440018,22,9,344,375,
Mcclain,Attorney General,Mark Myles,DEM,440018,10,1,102,113,
Mcclain,State Treasurer,Randy Mcdaniel,REP,440018,26,8,372,406,
Mcclain,State Treasurer,Charles De Coune,IND,440018,5,2,64,71,
Mcclain,Superintendent of Public Instruction,Joy Hofmeister,REP,440018,24,7,311,342,
Mcclain,Superintendent of Public Instruction,John Cox,DEM,440018,8,2,95,105,
Mcclain,Superintendent of Public Instruction,Larry Huff,IND,440018,0,1,40,41,
Mcclain,Commissioner of Labor,Leslie Osborn,REP,440018,22,7,353,382,
Mcclain,Commissioner of Labor,Fred Dorrell,DEM,440018,9,2,82,93,
Mcclain,Commissioner of Labor,Brandt Dismukes,IND,440018,0,1,10,11,
Mcclain,Insurance Commissioner,Glen Mulready,REP,440018,22,8,341,371,
Mcclain,Insurance Commissioner,Kimberly Fobbs,DEM,440018,7,2,105,114,
Mcclain,Corporation Commissioner,Bob Anthony,REP,440018,24,6,313,343,
Mcclain,Corporation Commissioner,Ashley Nicole Mccray,DEM,440018,7,2,106,115,
Mcclain,Corporation Commissioner,Jackie Short,IND,440018,1,2,27,30,
Mcclain,U.S. House,Tom Cole,REP,440018,23,7,346,376,4
Mcclain,U.S. House,Mary Brannon,DEM,440018,9,2,87,98,4
Mcclain,U.S. House,Ruby Peters,IND,440018,0,1,14,15,4
Mcclain,State House,Sherrie Conley,REP,440018,24,8,353,385,20
Mcclain,State House,Steve Jarman,DEM,440018,7,2,88,97,20
Mcclain,Governor,Chris Powell,LIB,440019,0,1,19,20,
Mcclain,Governor,Kevin Stitt,REP,440019,28,11,383,422,
Mcclain,Governor,Drew Edmondson,DEM,440019,10,7,146,163,
Mcclain,Lieutenant Governor,Matt Pinnell,REP,440019,28,14,413,455,
Mcclain,Lieutenant Governor,Anastasia Pittman,DEM,440019,9,4,114,127,
Mcclain,Lieutenant Governor,Ivan Holmes,IND,440019,1,1,18,20,
Mcclain,State Auditor,John Yeutter,LIB,440019,1,3,102,106,
Mcclain,State Auditor,Cindy Byrd,REP,440019,34,15,426,475,
Mcclain,Attorney General,Mike Hunter,REP,440019,27,14,405,446,
Mcclain,Attorney General,Mark Myles,DEM,440019,10,5,136,151,
Mcclain,State Treasurer,Randy Mcdaniel,REP,440019,31,14,415,460,
Mcclain,State Treasurer,Charles De Coune,IND,440019,6,4,113,123,
Mcclain,Superintendent of Public Instruction,Joy Hofmeister,REP,440019,28,11,373,412,
Mcclain,Superintendent of Public Instruction,John Cox,DEM,440019,7,6,123,136,
Mcclain,Superintendent of Public Instruction,Larry Huff,IND,440019,3,2,45,50,
Mcclain,Commissioner of Labor,Leslie Osborn,REP,440019,31,14,391,436,
Mcclain,Commissioner of Labor,Fred Dorrell,DEM,440019,7,4,118,129,
Mcclain,Commissioner of Labor,Brandt Dismukes,IND,440019,0,1,29,30,
Mcclain,Insurance Commissioner,Glen Mulready,REP,440019,28,12,406,446,
Mcclain,Insurance Commissioner,Kimberly Fobbs,DEM,440019,10,7,132,149,
Mcclain,Corporation Commissioner,Bob Anthony,REP,440019,28,13,380,421,
Mcclain,Corporation Commissioner,Ashley Nicole Mccray,DEM,440019,7,5,132,144,
Mcclain,Corporation Commissioner,Jackie Short,IND,440019,3,1,32,36,
Mcclain,U.S. House,Tom Cole,REP,440019,31,17,412,460,4
Mcclain,U.S. House,Mary Brannon,DEM,440019,6,2,116,124,4
Mcclain,U.S. House,Ruby Peters,IND,440019,1,0,18,19,4
Mcclain,State House,Cynthia Roe,REP,440019,23,12,369,404,42
Mcclain,State House,Liz George,DEM,440019,15,7,175,197,42
Mcclain,Governor,Chris Powell,LIB,440020,2,2,14,18,
Mcclain,Governor,Kevin Stitt,REP,440020,18,13,315,346,
Mcclain,Governor,Drew Edmondson,DEM,440020,3,6,107,116,
Mcclain,Lieutenant Governor,Matt Pinnell,REP,440020,21,14,348,383,
Mcclain,Lieutenant Governor,Anastasia Pittman,DEM,440020,1,7,73,81,
Mcclain,Lieutenant Governor,Ivan Holmes,IND,440020,1,0,14,15,
Mcclain,State Auditor,John Yeutter,LIB,440020,3,1,49,53,
Mcclain,State Auditor,Cindy Byrd,REP,440020,20,16,365,401,
Mcclain,Attorney General,Mike Hunter,REP,440020,19,18,353,390,
Mcclain,Attorney General,Mark Myles,DEM,440020,3,3,83,89,
Mcclain,State Treasurer,Randy Mcdaniel,REP,440020,20,17,361,398,
Mcclain,State Treasurer,Charles De Coune,IND,440020,2,1,47,50,
Mcclain,Superintendent of Public Instruction,Joy Hofmeister,REP,440020,19,14,319,352,
Mcclain,Superintendent of Public Instruction,John Cox,DEM,440020,1,6,85,92,
Mcclain,Superintendent of Public Instruction,Larry Huff,IND,440020,3,1,32,36,
Mcclain,Commissioner of Labor,Leslie Osborn,REP,440020,21,16,345,382,
Mcclain,Commissioner of Labor,Fred Dorrell,DEM,440020,1,4,73,78,
Mcclain,Commissioner of Labor,Brandt Dismukes,IND,440020,1,1,16,18,
Mcclain,Insurance Commissioner,Glen Mulready,REP,440020,20,14,338,372,
Mcclain,Insurance Commissioner,Kimberly Fobbs,DEM,440020,2,7,92,101,
Mcclain,Corporation Commissioner,Bob Anthony,REP,440020,18,12,338,368,
Mcclain,Corporation Commissioner,Ashley Nicole Mccray,DEM,440020,2,8,80,90,
Mcclain,Corporation Commissioner,Jackie Short,IND,440020,3,1,17,21,
Mcclain,U.S. House,Tom Cole,REP,440020,19,14,349,382,4
Mcclain,U.S. House,Mary Brannon,DEM,440020,1,6,73,80,4
Mcclain,U.S. House,Ruby Peters,IND,440020,3,1,14,18,4
Mcclain,State House,Sherrie Conley,REP,440020,16,14,348,378,20
Mcclain,State House,Steve Jarman,DEM,440020,4,7,84,95,20
Mcclain,Governor,Chris Powell,LIB,440021,1,3,25,29,
Mcclain,Governor,Kevin Stitt,REP,440021,4,24,185,213,
Mcclain,Governor,Drew Edmondson,DEM,440021,8,35,184,227,
Mcclain,Lieutenant Governor,Matt Pinnell,REP,440021,6,29,215,250,
Mcclain,Lieutenant Governor,Anastasia Pittman,DEM,440021,7,31,153,191,
Mcclain,Lieutenant Governor,Ivan Holmes,IND,440021,0,2,26,28,
Mcclain,State Auditor,John Yeutter,LIB,440021,4,14,107,125,
Mcclain,State Auditor,Cindy Byrd,REP,440021,8,40,256,304,
Mcclain,Attorney General,Mike Hunter,REP,440021,4,37,230,271,
Mcclain,Attorney General,Mark Myles,DEM,440021,9,25,161,195,
Mcclain,State Treasurer,Randy Mcdaniel,REP,440021,7,36,233,276,
Mcclain,State Treasurer,Charles De Coune,IND,440021,5,20,128,153,
Mcclain,Superintendent of Public Instruction,Joy Hofmeister,REP,440021,4,30,213,247,
Mcclain,Superintendent of Public Instruction,John Cox,DEM,440021,8,28,132,168,
Mcclain,Superintendent of Public Instruction,Larry Huff,IND,440021,1,3,47,51,
Mcclain,Commissioner of Labor,Leslie Osborn,REP,440021,6,34,219,259,
Mcclain,Commissioner of Labor,Fred Dorrell,DEM,440021,7,26,133,166,
Mcclain,Commissioner of Labor,Brandt Dismukes,IND,440021,0,2,37,39,
Mcclain,Insurance Commissioner,Glen Mulready,REP,440021,5,33,217,255,
Mcclain,Insurance Commissioner,Kimberly Fobbs,DEM,440021,8,27,172,207,
Mcclain,Corporation Commissioner,Bob Anthony,REP,440021,6,34,199,239,
Mcclain,Corporation Commissioner,Ashley Nicole Mccray,DEM,440021,6,25,155,186,
Mcclain,Corporation Commissioner,Jackie Short,IND,440021,1,3,37,41,
Mcclain,U.S. House,Tom Cole,REP,440021,6,32,218,256,4
Mcclain,U.S. House,Mary Brannon,DEM,440021,7,29,154,190,4
Mcclain,U.S. House,Ruby Peters,IND,440021,0,1,22,23,4
Mcclain,State House,Cynthia Roe,REP,440021,3,23,192,218,42
Mcclain,State House,Liz George,DEM,440021,10,39,202,251,42
Mcclain,Governor,Chris Powell,LIB,440023,1,0,15,16,
Mcclain,Governor,Kevin Stitt,REP,440023,12,43,295,350,
Mcclain,Governor,Drew Edmondson,DEM,440023,12,27,162,201,
Mcclain,Lieutenant Governor,Matt Pinnell,REP,440023,14,47,352,413,
Mcclain,Lieutenant Governor,Anastasia Pittman,DEM,440023,10,22,104,136,
Mcclain,Lieutenant Governor,Ivan Holmes,IND,440023,1,0,14,15,
Mcclain,State Auditor,John Yeutter,LIB,440023,4,9,65,78,
Mcclain,State Auditor,Cindy Byrd,REP,440023,19,54,388,461,
Mcclain,Attorney General,Mike Hunter,REP,440023,16,44,344,404,
Mcclain,Attorney General,Mark Myles,DEM,440023,8,24,122,154,
Mcclain,State Treasurer,Randy Mcdaniel,REP,440023,16,51,372,439,
Mcclain,State Treasurer,Charles De Coune,IND,440023,5,13,83,101,
Mcclain,Superintendent of Public Instruction,Joy Hofmeister,REP,440023,17,47,341,405,
Mcclain,Superintendent of Public Instruction,John Cox,DEM,440023,8,17,102,127,
Mcclain,Superintendent of Public Instruction,Larry Huff,IND,440023,0,5,29,34,
Mcclain,Commissioner of Labor,Leslie Osborn,REP,440023,17,48,334,399,
Mcclain,Commissioner of Labor,Fred Dorrell,DEM,440023,7,21,115,143,
Mcclain,Commissioner of Labor,Brandt Dismukes,IND,440023,1,0,15,16,
Mcclain,Insurance Commissioner,Glen Mulready,REP,440023,15,41,348,404,
Mcclain,Insurance Commissioner,Kimberly Fobbs,DEM,440023,9,27,118,154,
Mcclain,Corporation Commissioner,Bob Anthony,REP,440023,15,42,334,391,
Mcclain,Corporation Commissioner,Ashley Nicole Mccray,DEM,440023,9,25,115,149,
Mcclain,Corporation Commissioner,Jackie Short,IND,440023,1,2,18,21,
Mcclain,U.S. House,Tom Cole,REP,440023,17,44,349,410,4
Mcclain,U.S. House,Mary Brannon,DEM,440023,8,27,107,142,4
Mcclain,U.S. House,Ruby Peters,IND,440023,0,0,14,14,4
Mcclain,State House,Sherrie Conley,REP,440023,16,43,366,425,20
Mcclain,State House,Steve Jarman,DEM,440023,9,24,99,132,20
Mcclain,Governor,Chris Powell,LIB,440024,1,5,24,30,
Mcclain,Governor,Kevin Stitt,REP,440024,15,40,297,352,
Mcclain,Governor,Drew Edmondson,DEM,440024,17,27,198,242,
Mcclain,Lieutenant Governor,Matt Pinnell,REP,440024,17,49,344,410,
Mcclain,Lieutenant Governor,Anastasia Pittman,DEM,440024,16,20,162,198,
Mcclain,Lieutenant Governor,Ivan Holmes,IND,440024,1,3,11,15,
Mcclain,State Auditor,John Yeutter,LIB,440024,7,12,96,115,
Mcclain,State Auditor,Cindy Byrd,REP,440024,22,57,395,474,
Mcclain,Attorney General,Mike Hunter,REP,440024,19,47,353,419,
Mcclain,Attorney General,Mark Myles,DEM,440024,15,24,162,201,
Mcclain,State Treasurer,Randy Mcdaniel,REP,440024,19,55,386,460,
Mcclain,State Treasurer,Charles De Coune,IND,440024,10,14,105,129,
Mcclain,Superintendent of Public Instruction,Joy Hofmeister,REP,440024,19,43,335,397,
Mcclain,Superintendent of Public Instruction,John Cox,DEM,440024,14,19,145,178,
Mcclain,Superintendent of Public Instruction,Larry Huff,IND,440024,1,9,35,45,
Mcclain,Commissioner of Labor,Leslie Osborn,REP,440024,19,48,345,412,
Mcclain,Commissioner of Labor,Fred Dorrell,DEM,440024,15,18,140,173,
Mcclain,Commissioner of Labor,Brandt Dismukes,IND,440024,0,5,25,30,
Mcclain,Insurance Commissioner,Glen Mulready,REP,440024,17,48,343,408,
Mcclain,Insurance Commissioner,Kimberly Fobbs,DEM,440024,16,22,168,206,
Mcclain,Corporation Commissioner,Bob Anthony,REP,440024,18,49,332,399,
Mcclain,Corporation Commissioner,Ashley Nicole Mccray,DEM,440024,15,21,153,189,
Mcclain,Corporation Commissioner,Jackie Short,IND,440024,0,1,29,30,
Mcclain,U.S. House,Tom Cole,REP,440024,17,47,344,408,4
Mcclain,U.S. House,Mary Brannon,DEM,440024,16,24,157,197,4
Mcclain,U.S. House,Ruby Peters,IND,440024,1,0,18,19,4
Mcclain,State House,Cynthia Roe,REP,440024,15,33,297,345,42
Mcclain,State House,Liz George,DEM,440024,19,39,220,278,42
Mcclain,Governor,Chris Powell,LIB,440026,0,2,3,5,
Mcclain,Governor,Kevin Stitt,REP,440026,2,11,109,122,
Mcclain,Governor,Drew Edmondson,DEM,440026,1,11,43,55,
Mcclain,Lieutenant Governor,Matt Pinnell,REP,440026,2,18,119,139,
Mcclain,Lieutenant Governor,Anastasia Pittman,DEM,440026,0,6,34,40,
Mcclain,Lieutenant Governor,Ivan Holmes,IND,440026,0,0,3,3,
Mcclain,State Auditor,John Yeutter,LIB,440026,0,4,12,16,
Mcclain,State Auditor,Cindy Byrd,REP,440026,3,20,138,161,
Mcclain,Attorney General,Mike Hunter,REP,440026,3,15,123,141,
Mcclain,Attorney General,Mark Myles,DEM,440026,0,9,32,41,
Mcclain,State Treasurer,Randy Mcdaniel,REP,440026,3,18,123,144,
Mcclain,State Treasurer,Charles De Coune,IND,440026,0,6,25,31,
Mcclain,Superintendent of Public Instruction,Joy Hofmeister,REP,440026,3,18,114,135,
Mcclain,Superintendent of Public Instruction,John Cox,DEM,440026,0,3,26,29,
Mcclain,Superintendent of Public Instruction,Larry Huff,IND,440026,0,3,15,18,
Mcclain,Commissioner of Labor,Leslie Osborn,REP,440026,3,19,120,142,
Mcclain,Commissioner of Labor,Fred Dorrell,DEM,440026,0,4,27,31,
Mcclain,Commissioner of Labor,Brandt Dismukes,IND,440026,0,2,5,7,
Mcclain,Insurance Commissioner,Glen Mulready,REP,440026,3,15,110,128,
Mcclain,Insurance Commissioner,Kimberly Fobbs,DEM,440026,0,9,42,51,
Mcclain,Corporation Commissioner,Bob Anthony,REP,440026,2,15,111,128,
Mcclain,Corporation Commissioner,Ashley Nicole Mccray,DEM,440026,1,6,36,43,
Mcclain,Corporation Commissioner,Jackie Short,IND,440026,0,3,6,9,
Mcclain,U.S. House,Tom Cole,REP,440026,2,16,122,140,4
Mcclain,U.S. House,Mary Brannon,DEM,440026,1,8,30,39,4
Mcclain,U.S. House,Ruby Peters,IND,440026,0,0,4,4,4
Mcclain,State House,Cynthia Roe,REP,440026,3,14,105,122,42
Mcclain,State House,Liz George,DEM,440026,0,10,50,60,42
Mcclain,Governor,Chris Powell,LIB,440027,1,0,14,15,
Mcclain,Governor,Kevin Stitt,REP,440027,17,4,207,228,
Mcclain,Governor,Drew Edmondson,DEM,440027,2,0,96,98,
Mcclain,Lieutenant Governor,Matt Pinnell,REP,440027,16,4,237,257,
Mcclain,Lieutenant Governor,Anastasia Pittman,DEM,440027,3,0,64,67,
Mcclain,Lieutenant Governor,Ivan Holmes,IND,440027,0,0,14,14,
Mcclain,State Auditor,John Yeutter,LIB,440027,0,0,46,46,
Mcclain,State Auditor,Cindy Byrd,REP,440027,17,4,258,279,
Mcclain,Attorney General,Mike Hunter,REP,440027,16,4,243,263,
Mcclain,Attorney General,Mark Myles,DEM,440027,3,0,70,73,
Mcclain,State Treasurer,Randy Mcdaniel,REP,440027,17,4,240,261,
Mcclain,State Treasurer,Charles De Coune,IND,440027,1,0,62,63,
Mcclain,Superintendent of Public Instruction,Joy Hofmeister,REP,440027,18,4,229,251,
Mcclain,Superintendent of Public Instruction,John Cox,DEM,440027,1,0,56,57,
Mcclain,Superintendent of Public Instruction,Larry Huff,IND,440027,0,0,31,31,
Mcclain,Commissioner of Labor,Leslie Osborn,REP,440027,17,4,237,258,
Mcclain,Commissioner of Labor,Fred Dorrell,DEM,440027,1,0,60,61,
Mcclain,Commissioner of Labor,Brandt Dismukes,IND,440027,1,0,16,17,
Mcclain,Insurance Commissioner,Glen Mulready,REP,440027,17,4,230,251,
Mcclain,Insurance Commissioner,Kimberly Fobbs,DEM,440027,2,0,84,86,
Mcclain,Corporation Commissioner,Bob Anthony,REP,440027,17,4,229,250,
Mcclain,Corporation Commissioner,Ashley Nicole Mccray,DEM,440027,2,0,62,64,
Mcclain,Corporation Commissioner,Jackie Short,IND,440027,0,0,22,22,
Mcclain,U.S. House,Tom Cole,REP,440027,17,4,233,254,4
Mcclain,U.S. House,Mary Brannon,DEM,440027,1,0,70,71,4
Mcclain,U.S. House,Ruby Peters,IND,440027,1,0,14,15,4
Mcclain,State House,Sherrie Conley,REP,440027,17,2,251,270,20
Mcclain,State House,Steve Jarman,DEM,440027,2,1,62,65,20
Mcclain,Governor,Chris Powell,LIB,440028,3,0,10,13,
Mcclain,Governor,Kevin Stitt,REP,440028,24,13,221,258,
Mcclain,Governor,Drew Edmondson,DEM,440028,9,15,117,141,
Mcclain,Lieutenant Governor,Matt Pinnell,REP,440028,25,15,249,289,
Mcclain,Lieutenant Governor,Anastasia Pittman,DEM,440028,8,13,84,105,
Mcclain,Lieutenant Governor,Ivan Holmes,IND,440028,1,0,15,16,
Mcclain,State Auditor,John Yeutter,LIB,440028,6,4,80,90,
Mcclain,State Auditor,Cindy Byrd,REP,440028,27,19,259,305,
Mcclain,Attorney General,Mike Hunter,REP,440028,26,16,241,283,
Mcclain,Attorney General,Mark Myles,DEM,440028,8,12,105,125,
Mcclain,State Treasurer,Randy Mcdaniel,REP,440028,23,18,253,294,
Mcclain,State Treasurer,Charles De Coune,IND,440028,11,5,83,99,
Mcclain,Superintendent of Public Instruction,Joy Hofmeister,REP,440028,26,15,227,268,
Mcclain,Superintendent of Public Instruction,John Cox,DEM,440028,7,12,92,111,
Mcclain,Superintendent of Public Instruction,Larry Huff,IND,440028,1,1,25,27,
Mcclain,Commissioner of Labor,Leslie Osborn,REP,440028,27,18,251,296,
Mcclain,Commissioner of Labor,Fred Dorrell,DEM,440028,5,10,80,95,
Mcclain,Commissioner of Labor,Brandt Dismukes,IND,440028,2,0,15,17,
Mcclain,Insurance Commissioner,Glen Mulready,REP,440028,25,17,236,278,
Mcclain,Insurance Commissioner,Kimberly Fobbs,DEM,440028,10,11,105,126,
Mcclain,Corporation Commissioner,Bob Anthony,REP,440028,27,17,228,272,
Mcclain,Corporation Commissioner,Ashley Nicole Mccray,DEM,440028,7,11,89,107,
Mcclain,Corporation Commissioner,Jackie Short,IND,440028,0,0,26,26,
Mcclain,U.S. House,Tom Cole,REP,440028,28,15,247,290,4
Mcclain,U.S. House,Mary Brannon,DEM,440028,6,13,89,108,4
Mcclain,U.S. House,Ruby Peters,IND,440028,0,0,11,11,4
Mcclain,State House,Sherrie Conley,REP,440028,28,14,248,290,20
Mcclain,State House,Steve Jarman,DEM,440028,7,14,95,116,20
Mccurtain,Governor,Chris Powell,LIB,450002,0,0,3,3,
Mccurtain,Governor,Kevin Stitt,REP,450002,2,4,64,70,
Mccurtain,Governor,Drew Edmondson,DEM,450002,2,6,55,63,
Mccurtain,Lieutenant Governor,Matt Pinnell,REP,450002,4,4,58,66,
Mccurtain,Lieutenant Governor,Anastasia Pittman,DEM,450002,0,6,58,64,
Mccurtain,Lieutenant Governor,Ivan Holmes,IND,450002,0,0,4,4,
Mccurtain,State Auditor,John Yeutter,LIB,450002,0,6,29,35,
Mccurtain,State Auditor,Cindy Byrd,REP,450002,4,4,76,84,
Mccurtain,Attorney General,Mike Hunter,REP,450002,4,4,64,72,
Mccurtain,Attorney General,Mark Myles,DEM,450002,0,6,57,63,
Mccurtain,State Treasurer,Randy Mcdaniel,REP,450002,4,3,69,76,
Mccurtain,State Treasurer,Charles De Coune,IND,450002,0,6,35,41,
Mccurtain,Superintendent of Public Instruction,Joy Hofmeister,REP,450002,4,4,60,68,
Mccurtain,Superintendent of Public Instruction,John Cox,DEM,450002,0,6,54,60,
Mccurtain,Superintendent of Public Instruction,Larry Huff,IND,450002,0,0,6,6,
Mccurtain,Commissioner of Labor,Leslie Osborn,REP,450002,3,4,64,71,
Mccurtain,Commissioner of Labor,Fred Dorrell,DEM,450002,1,6,53,60,
Mccurtain,Commissioner of Labor,Brandt Dismukes,IND,450002,0,0,2,2,
Mccurtain,Insurance Commissioner,Glen Mulready,REP,450002,3,4,62,69,
Mccurtain,Insurance Commissioner,Kimberly Fobbs,DEM,450002,1,6,56,63,
Mccurtain,Corporation Commissioner,Bob Anthony,REP,450002,2,4,62,68,
Mccurtain,Corporation Commissioner,Ashley Nicole Mccray,DEM,450002,1,6,54,61,
Mccurtain,Corporation Commissioner,Jackie Short,IND,450002,1,0,5,6,
Mccurtain,U.S. House,Richard Castaldo,LIB,450002,0,0,0,0,2
Mccurtain,U.S. House,Markwayne Mullin,REP,450002,4,4,62,70,2
Mccurtain,U.S. House,Jason Nichols,DEM,450002,0,6,54,60,2
Mccurtain,U.S. House,John Foreman,IND,450002,0,0,7,7,2
Mccurtain,Governor,Chris Powell,LIB,450004,0,2,2,4,
Mccurtain,Governor,Kevin Stitt,REP,450004,10,54,193,257,
Mccurtain,Governor,Drew Edmondson,DEM,450004,6,30,119,155,
Mccurtain,Lieutenant Governor,Matt Pinnell,REP,450004,10,56,214,280,
Mccurtain,Lieutenant Governor,Anastasia Pittman,DEM,450004,5,29,91,125,
Mccurtain,Lieutenant Governor,Ivan Holmes,IND,450004,0,0,7,7,
Mccurtain,State Auditor,John Yeutter,LIB,450004,3,14,46,63,
Mccurtain,State Auditor,Cindy Byrd,REP,450004,12,60,242,314,
Mccurtain,Attorney General,Mike Hunter,REP,450004,10,57,222,289,
Mccurtain,Attorney General,Mark Myles,DEM,450004,6,28,90,124,
Mccurtain,State Treasurer,Randy Mcdaniel,REP,450004,10,61,237,308,
Mccurtain,State Treasurer,Charles De Coune,IND,450004,5,14,55,74,
Mccurtain,Superintendent of Public Instruction,Joy Hofmeister,REP,450004,10,46,187,243,
Mccurtain,Superintendent of Public Instruction,John Cox,DEM,450004,5,32,105,142,
Mccurtain,Superintendent of Public Instruction,Larry Huff,IND,450004,1,6,17,24,
Mccurtain,Commissioner of Labor,Leslie Osborn,REP,450004,11,55,204,270,
Mccurtain,Commissioner of Labor,Fred Dorrell,DEM,450004,4,28,96,128,
Mccurtain,Commissioner of Labor,Brandt Dismukes,IND,450004,1,1,10,12,
Mccurtain,Insurance Commissioner,Glen Mulready,REP,450004,10,53,216,279,
Mccurtain,Insurance Commissioner,Kimberly Fobbs,DEM,450004,4,32,94,130,
Mccurtain,Corporation Commissioner,Bob Anthony,REP,450004,11,53,203,267,
Mccurtain,Corporation Commissioner,Ashley Nicole Mccray,DEM,450004,4,29,94,127,
Mccurtain,Corporation Commissioner,Jackie Short,IND,450004,1,3,13,17,
Mccurtain,U.S. House,Richard Castaldo,LIB,450004,0,1,1,2,2
Mccurtain,U.S. House,Markwayne Mullin,REP,450004,10,56,214,280,2
Mccurtain,U.S. House,Jason Nichols,DEM,450004,5,28,95,128,2
Mccurtain,U.S. House,John Foreman,IND,450004,1,1,4,6,2
Mccurtain,Governor,Chris Powell,LIB,450005,0,0,2,2,
Mccurtain,Governor,Kevin Stitt,REP,450005,0,2,17,19,
Mccurtain,Governor,Drew Edmondson,DEM,450005,3,1,104,108,
Mccurtain,Lieutenant Governor,Matt Pinnell,REP,450005,0,2,19,21,
Mccurtain,Lieutenant Governor,Anastasia Pittman,DEM,450005,3,1,102,106,
Mccurtain,Lieutenant Governor,Ivan Holmes,IND,450005,0,0,2,2,
Mccurtain,State Auditor,John Yeutter,LIB,450005,0,1,61,62,
Mccurtain,State Auditor,Cindy Byrd,REP,450005,3,1,38,42,
Mccurtain,Attorney General,Mike Hunter,REP,450005,0,1,19,20,
Mccurtain,Attorney General,Mark Myles,DEM,450005,3,2,104,109,
Mccurtain,State Treasurer,Randy Mcdaniel,REP,450005,1,1,34,36,
Mccurtain,State Treasurer,Charles De Coune,IND,450005,2,1,64,67,
Mccurtain,Superintendent of Public Instruction,Joy Hofmeister,REP,450005,0,1,19,20,
Mccurtain,Superintendent of Public Instruction,John Cox,DEM,450005,3,1,103,107,
Mccurtain,Superintendent of Public Instruction,Larry Huff,IND,450005,0,1,1,2,
Mccurtain,Commissioner of Labor,Leslie Osborn,REP,450005,0,1,17,18,
Mccurtain,Commissioner of Labor,Fred Dorrell,DEM,450005,1,2,105,108,
Mccurtain,Commissioner of Labor,Brandt Dismukes,IND,450005,2,0,1,3,
Mccurtain,Insurance Commissioner,Glen Mulready,REP,450005,0,2,20,22,
Mccurtain,Insurance Commissioner,Kimberly Fobbs,DEM,450005,3,1,103,107,
Mccurtain,Corporation Commissioner,Bob Anthony,REP,450005,0,1,19,20,
Mccurtain,Corporation Commissioner,Ashley Nicole Mccray,DEM,450005,3,2,100,105,
Mccurtain,Corporation Commissioner,Jackie Short,IND,450005,0,0,4,4,
Mccurtain,U.S. House,Richard Castaldo,LIB,450005,0,1,2,3,2
Mccurtain,U.S. House,Markwayne Mullin,REP,450005,0,1,21,22,2
Mccurtain,U.S. House,Jason Nichols,DEM,450005,3,1,98,102,2
Mccurtain,U.S. House,John Foreman,IND,450005,0,0,1,1,2
Mccurtain,Governor,Chris Powell,LIB,450006,0,1,11,12,
Mccurtain,Governor,Kevin Stitt,REP,450006,2,43,193,238,
Mccurtain,Governor,Drew Edmondson,DEM,450006,10,17,113,140,
Mccurtain,Lieutenant Governor,Matt Pinnell,REP,450006,3,44,206,253,
Mccurtain,Lieutenant Governor,Anastasia Pittman,DEM,450006,9,17,101,127,
Mccurtain,Lieutenant Governor,Ivan Holmes,IND,450006,0,0,9,9,
Mccurtain,State Auditor,John Yeutter,LIB,450006,4,12,57,73,
Mccurtain,State Auditor,Cindy Byrd,REP,450006,4,44,229,277,
Mccurtain,Attorney General,Mike Hunter,REP,450006,3,44,212,259,
Mccurtain,Attorney General,Mark Myles,DEM,450006,9,17,104,130,
Mccurtain,State Treasurer,Randy Mcdaniel,REP,450006,5,42,230,277,
Mccurtain,State Treasurer,Charles De Coune,IND,450006,4,13,53,70,
Mccurtain,Superintendent of Public Instruction,Joy Hofmeister,REP,450006,3,43,188,234,
Mccurtain,Superintendent of Public Instruction,John Cox,DEM,450006,9,15,113,137,
Mccurtain,Superintendent of Public Instruction,Larry Huff,IND,450006,0,3,15,18,
Mccurtain,Commissioner of Labor,Leslie Osborn,REP,450006,3,45,201,249,
Mccurtain,Commissioner of Labor,Fred Dorrell,DEM,450006,8,15,104,127,
Mccurtain,Commissioner of Labor,Brandt Dismukes,IND,450006,1,1,9,11,
Mccurtain,Insurance Commissioner,Glen Mulready,REP,450006,4,43,205,252,
Mccurtain,Insurance Commissioner,Kimberly Fobbs,DEM,450006,8,18,108,134,
Mccurtain,Corporation Commissioner,Bob Anthony,REP,450006,3,43,197,243,
Mccurtain,Corporation Commissioner,Ashley Nicole Mccray,DEM,450006,9,16,104,129,
Mccurtain,Corporation Commissioner,Jackie Short,IND,450006,0,2,14,16,
Mccurtain,U.S. House,Richard Castaldo,LIB,450006,0,1,1,2,2
Mccurtain,U.S. House,Markwayne Mullin,REP,450006,3,44,211,258,2
Mccurtain,U.S. House,Jason Nichols,DEM,450006,9,15,95,119,2
Mccurtain,U.S. House,John Foreman,IND,450006,0,1,8,9,2
Mccurtain,Governor,Chris Powell,LIB,450008,0,0,9,9,
Mccurtain,Governor,Kevin Stitt,REP,450008,8,36,247,291,
Mccurtain,Governor,Drew Edmondson,DEM,450008,2,15,91,108,
Mccurtain,Lieutenant Governor,Matt Pinnell,REP,450008,6,38,272,316,
Mccurtain,Lieutenant Governor,Anastasia Pittman,DEM,450008,3,11,67,81,
Mccurtain,Lieutenant Governor,Ivan Holmes,IND,450008,1,1,5,7,
Mccurtain,State Auditor,John Yeutter,LIB,450008,0,3,39,42,
Mccurtain,State Auditor,Cindy Byrd,REP,450008,10,41,289,340,
Mccurtain,Attorney General,Mike Hunter,REP,450008,7,37,268,312,
Mccurtain,Attorney General,Mark Myles,DEM,450008,3,12,70,85,
Mccurtain,State Treasurer,Randy Mcdaniel,REP,450008,8,40,293,341,
Mccurtain,State Treasurer,Charles De Coune,IND,450008,2,4,36,42,
Mccurtain,Superintendent of Public Instruction,Joy Hofmeister,REP,450008,6,38,239,283,
Mccurtain,Superintendent of Public Instruction,John Cox,DEM,450008,4,12,86,102,
Mccurtain,Superintendent of Public Instruction,Larry Huff,IND,450008,0,0,17,17,
Mccurtain,Commissioner of Labor,Leslie Osborn,REP,450008,7,39,271,317,
Mccurtain,Commissioner of Labor,Fred Dorrell,DEM,450008,3,10,64,77,
Mccurtain,Commissioner of Labor,Brandt Dismukes,IND,450008,0,1,6,7,
Mccurtain,Insurance Commissioner,Glen Mulready,REP,450008,7,38,269,314,
Mccurtain,Insurance Commissioner,Kimberly Fobbs,DEM,450008,3,12,72,87,
Mccurtain,Corporation Commissioner,Bob Anthony,REP,450008,7,35,267,309,
Mccurtain,Corporation Commissioner,Ashley Nicole Mccray,DEM,450008,3,14,67,84,
Mccurtain,Corporation Commissioner,Jackie Short,IND,450008,0,1,10,11,
Mccurtain,U.S. House,Richard Castaldo,LIB,450008,1,2,5,8,2
Mccurtain,U.S. House,Markwayne Mullin,REP,450008,7,38,271,316,2
Mccurtain,U.S. House,Jason Nichols,DEM,450008,2,11,62,75,2
Mccurtain,U.S. House,John Foreman,IND,450008,0,0,9,9,2
Mccurtain,Governor,Chris Powell,LIB,450009,0,0,7,7,
Mccurtain,Governor,Kevin Stitt,REP,450009,4,20,191,215,
Mccurtain,Governor,Drew Edmondson,DEM,450009,6,11,134,151,
Mccurtain,Lieutenant Governor,Matt Pinnell,REP,450009,4,23,212,239,
Mccurtain,Lieutenant Governor,Anastasia Pittman,DEM,450009,6,8,108,122,
Mccurtain,Lieutenant Governor,Ivan Holmes,IND,450009,0,0,8,8,
Mccurtain,State Auditor,John Yeutter,LIB,450009,3,4,73,80,
Mccurtain,State Auditor,Cindy Byrd,REP,450009,6,24,226,256,
Mccurtain,Attorney General,Mike Hunter,REP,450009,5,23,215,243,
Mccurtain,Attorney General,Mark Myles,DEM,450009,5,8,115,128,
Mccurtain,State Treasurer,Randy Mcdaniel,REP,450009,6,25,228,259,
Mccurtain,State Treasurer,Charles De Coune,IND,450009,3,2,74,79,
Mccurtain,Superintendent of Public Instruction,Joy Hofmeister,REP,450009,6,20,180,206,
Mccurtain,Superintendent of Public Instruction,John Cox,DEM,450009,4,11,134,149,
Mccurtain,Superintendent of Public Instruction,Larry Huff,IND,450009,0,0,14,14,
Mccurtain,Commissioner of Labor,Leslie Osborn,REP,450009,6,22,210,238,
Mccurtain,Commissioner of Labor,Fred Dorrell,DEM,450009,4,9,109,122,
Mccurtain,Commissioner of Labor,Brandt Dismukes,IND,450009,0,0,6,6,
Mccurtain,Insurance Commissioner,Glen Mulready,REP,450009,4,22,209,235,
Mccurtain,Insurance Commissioner,Kimberly Fobbs,DEM,450009,6,9,117,132,
Mccurtain,Corporation Commissioner,Bob Anthony,REP,450009,4,22,204,230,
Mccurtain,Corporation Commissioner,Ashley Nicole Mccray,DEM,450009,6,9,110,125,
Mccurtain,Corporation Commissioner,Jackie Short,IND,450009,0,0,13,13,
Mccurtain,U.S. House,Richard Castaldo,LIB,450009,0,0,1,1,2
Mccurtain,U.S. House,Markwayne Mullin,REP,450009,6,22,219,247,2
Mccurtain,U.S. House,Jason Nichols,DEM,450009,4,9,105,118,2
Mccurtain,U.S. House,John Foreman,IND,450009,0,0,6,6,2
Mccurtain,Governor,Chris Powell,LIB,450011,0,1,2,3,
Mccurtain,Governor,Kevin Stitt,REP,450011,4,9,66,79,
Mccurtain,Governor,Drew Edmondson,DEM,450011,2,9,21,32,
Mccurtain,Lieutenant Governor,Matt Pinnell,REP,450011,4,12,73,89,
Mccurtain,Lieutenant Governor,Anastasia Pittman,DEM,450011,2,7,15,24,
Mccurtain,Lieutenant Governor,Ivan Holmes,IND,450011,0,1,0,1,
Mccurtain,State Auditor,John Yeutter,LIB,450011,2,6,9,17,
Mccurtain,State Auditor,Cindy Byrd,REP,450011,4,10,73,87,
Mccurtain,Attorney General,Mike Hunter,REP,450011,4,11,69,84,
Mccurtain,Attorney General,Mark Myles,DEM,450011,2,9,19,30,
Mccurtain,State Treasurer,Randy Mcdaniel,REP,450011,3,14,73,90,
Mccurtain,State Treasurer,Charles De Coune,IND,450011,3,4,9,16,
Mccurtain,Superintendent of Public Instruction,Joy Hofmeister,REP,450011,4,7,62,73,
Mccurtain,Superintendent of Public Instruction,John Cox,DEM,450011,2,11,26,39,
Mccurtain,Superintendent of Public Instruction,Larry Huff,IND,450011,0,2,0,2,
Mccurtain,Commissioner of Labor,Leslie Osborn,REP,450011,4,10,67,81,
Mccurtain,Commissioner of Labor,Fred Dorrell,DEM,450011,2,9,20,31,
Mccurtain,Commissioner of Labor,Brandt Dismukes,IND,450011,0,1,1,2,
Mccurtain,Insurance Commissioner,Glen Mulready,REP,450011,4,12,67,83,
Mccurtain,Insurance Commissioner,Kimberly Fobbs,DEM,450011,2,8,20,30,
Mccurtain,Corporation Commissioner,Bob Anthony,REP,450011,4,11,69,84,
Mccurtain,Corporation Commissioner,Ashley Nicole Mccray,DEM,450011,2,9,16,27,
Mccurtain,Corporation Commissioner,Jackie Short,IND,450011,0,0,2,2,
Mccurtain,U.S. House,Richard Castaldo,LIB,450011,0,0,1,1,2
Mccurtain,U.S. House,Markwayne Mullin,REP,450011,4,13,71,88,2
Mccurtain,U.S. House,Jason Nichols,DEM,450011,0,7,17,24,2
Mccurtain,U.S. House,John Foreman,IND,450011,0,0,0,0,2
Mccurtain,Governor,Chris Powell,LIB,450012,0,0,3,3,
Mccurtain,Governor,Kevin Stitt,REP,450012,0,1,33,34,
Mccurtain,Governor,Drew Edmondson,DEM,450012,1,2,49,52,
Mccurtain,Lieutenant Governor,Matt Pinnell,REP,450012,0,2,36,38,
Mccurtain,Lieutenant Governor,Anastasia Pittman,DEM,450012,1,1,46,48,
Mccurtain,Lieutenant Governor,Ivan Holmes,IND,450012,0,0,2,2,
Mccurtain,State Auditor,John Yeutter,LIB,450012,1,0,14,15,
Mccurtain,State Auditor,Cindy Byrd,REP,450012,0,2,39,41,
Mccurtain,Attorney General,Mike Hunter,REP,450012,0,2,35,37,
Mccurtain,Attorney General,Mark Myles,DEM,450012,1,1,50,52,
Mccurtain,State Treasurer,Randy Mcdaniel,REP,450012,0,2,42,44,
Mccurtain,State Treasurer,Charles De Coune,IND,450012,1,0,12,13,
Mccurtain,Superintendent of Public Instruction,Joy Hofmeister,REP,450012,0,1,33,34,
Mccurtain,Superintendent of Public Instruction,John Cox,DEM,450012,0,2,50,52,
Mccurtain,Superintendent of Public Instruction,Larry Huff,IND,450012,1,0,2,3,
Mccurtain,Commissioner of Labor,Leslie Osborn,REP,450012,0,2,34,36,
Mccurtain,Commissioner of Labor,Fred Dorrell,DEM,450012,0,1,48,49,
Mccurtain,Commissioner of Labor,Brandt Dismukes,IND,450012,1,0,3,4,
Mccurtain,Insurance Commissioner,Glen Mulready,REP,450012,0,2,38,40,
Mccurtain,Insurance Commissioner,Kimberly Fobbs,DEM,450012,1,1,46,48,
Mccurtain,Corporation Commissioner,Bob Anthony,REP,450012,0,2,35,37,
Mccurtain,Corporation Commissioner,Ashley Nicole Mccray,DEM,450012,1,1,47,49,
Mccurtain,Corporation Commissioner,Jackie Short,IND,450012,0,0,2,2,
Mccurtain,U.S. House,Richard Castaldo,LIB,450012,0,0,2,2,2
Mccurtain,U.S. House,Markwayne Mullin,REP,450012,0,2,36,38,2
Mccurtain,U.S. House,Jason Nichols,DEM,450012,0,1,44,45,2
Mccurtain,U.S. House,John Foreman,IND,450012,1,0,3,4,2
Mccurtain,Governor,Chris Powell,LIB,450013,0,0,4,4,
Mccurtain,Governor,Kevin Stitt,REP,450013,5,18,159,182,
Mccurtain,Governor,Drew Edmondson,DEM,450013,5,5,67,77,
Mccurtain,Lieutenant Governor,Matt Pinnell,REP,450013,5,21,167,193,
Mccurtain,Lieutenant Governor,Anastasia Pittman,DEM,450013,5,2,56,63,
Mccurtain,Lieutenant Governor,Ivan Holmes,IND,450013,0,0,6,6,
Mccurtain,State Auditor,John Yeutter,LIB,450013,2,1,33,36,
Mccurtain,State Auditor,Cindy Byrd,REP,450013,6,21,177,204,
Mccurtain,Attorney General,Mike Hunter,REP,450013,5,21,174,200,
Mccurtain,Attorney General,Mark Myles,DEM,450013,5,2,55,62,
Mccurtain,State Treasurer,Randy Mcdaniel,REP,450013,6,20,181,207,
Mccurtain,State Treasurer,Charles De Coune,IND,450013,2,2,30,34,
Mccurtain,Superintendent of Public Instruction,Joy Hofmeister,REP,450013,4,18,147,169,
Mccurtain,Superintendent of Public Instruction,John Cox,DEM,450013,6,5,73,84,
Mccurtain,Superintendent of Public Instruction,Larry Huff,IND,450013,0,0,10,10,
Mccurtain,Commissioner of Labor,Leslie Osborn,REP,450013,5,20,163,188,
Mccurtain,Commissioner of Labor,Fred Dorrell,DEM,450013,5,3,57,65,
Mccurtain,Commissioner of Labor,Brandt Dismukes,IND,450013,0,0,8,8,
Mccurtain,Insurance Commissioner,Glen Mulready,REP,450013,6,20,172,198,
Mccurtain,Insurance Commissioner,Kimberly Fobbs,DEM,450013,4,3,56,63,
Mccurtain,Corporation Commissioner,Bob Anthony,REP,450013,6,20,171,197,
Mccurtain,Corporation Commissioner,Ashley Nicole Mccray,DEM,450013,4,3,52,59,
Mccurtain,Corporation Commissioner,Jackie Short,IND,450013,0,0,7,7,
Mccurtain,U.S. House,Richard Castaldo,LIB,450013,0,0,0,0,2
Mccurtain,U.S. House,Markwayne Mullin,REP,450013,5,20,168,193,2
Mccurtain,U.S. House,Jason Nichols,DEM,450013,5,3,51,59,2
Mccurtain,U.S. House,John Foreman,IND,450013,0,0,11,11,2
Mccurtain,Governor,Chris Powell,LIB,450014,0,0,3,3,
Mccurtain,Governor,Kevin Stitt,REP,450014,1,6,88,95,
Mccurtain,Governor,Drew Edmondson,DEM,450014,0,0,32,32,
Mccurtain,Lieutenant Governor,Matt Pinnell,REP,450014,0,6,93,99,
Mccurtain,Lieutenant Governor,Anastasia Pittman,DEM,450014,0,0,23,23,
Mccurtain,Lieutenant Governor,Ivan Holmes,IND,450014,1,0,5,6,
Mccurtain,State Auditor,John Yeutter,LIB,450014,0,0,13,13,
Mccurtain,State Auditor,Cindy Byrd,REP,450014,1,6,98,105,
Mccurtain,Attorney General,Mike Hunter,REP,450014,1,6,96,103,
Mccurtain,Attorney General,Mark Myles,DEM,450014,0,0,25,25,
Mccurtain,State Treasurer,Randy Mcdaniel,REP,450014,0,6,103,109,
Mccurtain,State Treasurer,Charles De Coune,IND,450014,1,0,9,10,
Mccurtain,Superintendent of Public Instruction,Joy Hofmeister,REP,450014,0,5,84,89,
Mccurtain,Superintendent of Public Instruction,John Cox,DEM,450014,0,1,35,36,
Mccurtain,Superintendent of Public Instruction,Larry Huff,IND,450014,1,0,3,4,
Mccurtain,Commissioner of Labor,Leslie Osborn,REP,450014,1,6,92,99,
Mccurtain,Commissioner of Labor,Fred Dorrell,DEM,450014,0,0,24,24,
Mccurtain,Commissioner of Labor,Brandt Dismukes,IND,450014,0,0,3,3,
Mccurtain,Insurance Commissioner,Glen Mulready,REP,450014,1,6,90,97,
Mccurtain,Insurance Commissioner,Kimberly Fobbs,DEM,450014,0,0,31,31,
Mccurtain,Corporation Commissioner,Bob Anthony,REP,450014,0,6,91,97,
Mccurtain,Corporation Commissioner,Ashley Nicole Mccray,DEM,450014,0,0,27,27,
Mccurtain,Corporation Commissioner,Jackie Short,IND,450014,1,0,4,5,
Mccurtain,U.S. House,Richard Castaldo,LIB,450014,0,0,2,2,2
Mccurtain,U.S. House,Markwayne Mullin,REP,450014,1,6,92,99,2
Mccurtain,U.S. House,Jason Nichols,DEM,450014,0,0,26,26,2
Mccurtain,U.S. House,John Foreman,IND,450014,0,0,1,1,2
Mccurtain,Governor,Chris Powell,LIB,450015,0,0,1,1,
Mccurtain,Governor,Kevin Stitt,REP,450015,1,14,86,101,
Mccurtain,Governor,Drew Edmondson,DEM,450015,1,0,23,24,
Mccurtain,Lieutenant Governor,Matt Pinnell,REP,450015,1,14,88,103,
Mccurtain,Lieutenant Governor,Anastasia Pittman,DEM,450015,1,0,17,18,
Mccurtain,Lieutenant Governor,Ivan Holmes,IND,450015,0,0,2,2,
Mccurtain,State Auditor,John Yeutter,LIB,450015,0,1,4,5,
Mccurtain,State Auditor,Cindy Byrd,REP,450015,1,13,97,111,
Mccurtain,Attorney General,Mike Hunter,REP,450015,1,14,93,108,
Mccurtain,Attorney General,Mark Myles,DEM,450015,1,0,14,15,
Mccurtain,State Treasurer,Randy Mcdaniel,REP,450015,1,14,97,112,
Mccurtain,State Treasurer,Charles De Coune,IND,450015,0,0,4,4,
Mccurtain,Superintendent of Public Instruction,Joy Hofmeister,REP,450015,1,14,81,96,
Mccurtain,Superintendent of Public Instruction,John Cox,DEM,450015,1,0,22,23,
Mccurtain,Superintendent of Public Instruction,Larry Huff,IND,450015,0,0,7,7,
Mccurtain,Commissioner of Labor,Leslie Osborn,REP,450015,1,14,92,107,
Mccurtain,Commissioner of Labor,Fred Dorrell,DEM,450015,1,0,14,15,
Mccurtain,Commissioner of Labor,Brandt Dismukes,IND,450015,0,0,1,1,
Mccurtain,Insurance Commissioner,Glen Mulready,REP,450015,1,14,88,103,
Mccurtain,Insurance Commissioner,Kimberly Fobbs,DEM,450015,1,0,19,20,
Mccurtain,Corporation Commissioner,Bob Anthony,REP,450015,1,14,88,103,
Mccurtain,Corporation Commissioner,Ashley Nicole Mccray,DEM,450015,1,0,16,17,
Mccurtain,Corporation Commissioner,Jackie Short,IND,450015,0,0,4,4,
Mccurtain,U.S. House,Richard Castaldo,LIB,450015,0,0,1,1,2
Mccurtain,U.S. House,Markwayne Mullin,REP,450015,1,14,88,103,2
Mccurtain,U.S. House,Jason Nichols,DEM,450015,1,0,18,19,2
Mccurtain,U.S. House,John Foreman,IND,450015,0,0,1,1,2
Mccurtain,Governor,Chris Powell,LIB,450017,1,0,5,6,
Mccurtain,Governor,Kevin Stitt,REP,450017,1,10,162,173,
Mccurtain,Governor,Drew Edmondson,DEM,450017,0,7,88,95,
Mccurtain,Lieutenant Governor,Matt Pinnell,REP,450017,1,10,165,176,
Mccurtain,Lieutenant Governor,Anastasia Pittman,DEM,450017,1,7,81,89,
Mccurtain,Lieutenant Governor,Ivan Holmes,IND,450017,0,0,8,8,
Mccurtain,State Auditor,John Yeutter,LIB,450017,1,4,46,51,
Mccurtain,State Auditor,Cindy Byrd,REP,450017,1,10,193,204,
Mccurtain,Attorney General,Mike Hunter,REP,450017,1,10,173,184,
Mccurtain,Attorney General,Mark Myles,DEM,450017,1,7,80,88,
Mccurtain,State Treasurer,Randy Mcdaniel,REP,450017,1,10,183,194,
Mccurtain,State Treasurer,Charles De Coune,IND,450017,1,4,55,60,
Mccurtain,Superintendent of Public Instruction,Joy Hofmeister,REP,450017,1,10,153,164,
Mccurtain,Superintendent of Public Instruction,John Cox,DEM,450017,1,7,84,92,
Mccurtain,Superintendent of Public Instruction,Larry Huff,IND,450017,0,0,13,13,
Mccurtain,Commissioner of Labor,Leslie Osborn,REP,450017,1,10,170,181,
Mccurtain,Commissioner of Labor,Fred Dorrell,DEM,450017,0,7,75,82,
Mccurtain,Commissioner of Labor,Brandt Dismukes,IND,450017,1,0,6,7,
Mccurtain,Insurance Commissioner,Glen Mulready,REP,450017,1,10,168,179,
Mccurtain,Insurance Commissioner,Kimberly Fobbs,DEM,450017,1,7,82,90,
Mccurtain,Corporation Commissioner,Bob Anthony,REP,450017,1,10,162,173,
Mccurtain,Corporation Commissioner,Ashley Nicole Mccray,DEM,450017,1,7,85,93,
Mccurtain,Corporation Commissioner,Jackie Short,IND,450017,0,0,6,6,
Mccurtain,U.S. House,Richard Castaldo,LIB,450017,0,0,2,2,2
Mccurtain,U.S. House,Markwayne Mullin,REP,450017,1,10,172,183,2
Mccurtain,U.S. House,Jason Nichols,DEM,450017,0,7,76,83,2
Mccurtain,U.S. House,John Foreman,IND,450017,1,0,5,6,2
Mccurtain,Governor,Chris Powell,LIB,450018,0,1,14,15,
Mccurtain,Governor,Kevin Stitt,REP,450018,13,12,314,339,
Mccurtain,Governor,Drew Edmondson,DEM,450018,3,15,118,136,
Mccurtain,Lieutenant Governor,Matt Pinnell,REP,450018,13,14,342,369,
Mccurtain,Lieutenant Governor,Anastasia Pittman,DEM,450018,3,14,89,106,
Mccurtain,Lieutenant Governor,Ivan Holmes,IND,450018,0,0,8,8,
Mccurtain,State Auditor,John Yeutter,LIB,450018,0,7,52,59,
Mccurtain,State Auditor,Cindy Byrd,REP,450018,15,19,369,403,
Mccurtain,Attorney General,Mike Hunter,REP,450018,13,14,351,378,
Mccurtain,Attorney General,Mark Myles,DEM,450018,3,14,92,109,
Mccurtain,State Treasurer,Randy Mcdaniel,REP,450018,14,16,355,385,
Mccurtain,State Treasurer,Charles De Coune,IND,450018,1,10,66,77,
Mccurtain,Superintendent of Public Instruction,Joy Hofmeister,REP,450018,13,13,285,311,
Mccurtain,Superintendent of Public Instruction,John Cox,DEM,450018,3,15,132,150,
Mccurtain,Superintendent of Public Instruction,Larry Huff,IND,450018,0,0,25,25,
Mccurtain,Commissioner of Labor,Leslie Osborn,REP,450018,13,16,324,353,
Mccurtain,Commissioner of Labor,Fred Dorrell,DEM,450018,3,12,104,119,
Mccurtain,Commissioner of Labor,Brandt Dismukes,IND,450018,0,0,12,12,
Mccurtain,Insurance Commissioner,Glen Mulready,REP,450018,13,13,345,371,
Mccurtain,Insurance Commissioner,Kimberly Fobbs,DEM,450018,3,15,96,114,
Mccurtain,Corporation Commissioner,Bob Anthony,REP,450018,13,12,324,349,
Mccurtain,Corporation Commissioner,Ashley Nicole Mccray,DEM,450018,4,14,103,121,
Mccurtain,Corporation Commissioner,Jackie Short,IND,450018,0,1,15,16,
Mccurtain,U.S. House,Richard Castaldo,LIB,450018,0,0,8,8,2
Mccurtain,U.S. House,Markwayne Mullin,REP,450018,14,14,342,370,2
Mccurtain,U.S. House,Jason Nichols,DEM,450018,3,14,83,100,2
Mccurtain,U.S. House,John Foreman,IND,450018,0,0,10,10,2
Mccurtain,Governor,Chris Powell,LIB,450019,0,0,13,13,
Mccurtain,Governor,Kevin Stitt,REP,450019,5,15,259,279,
Mccurtain,Governor,Drew Edmondson,DEM,450019,1,1,95,97,
Mccurtain,Lieutenant Governor,Matt Pinnell,REP,450019,5,15,293,313,
Mccurtain,Lieutenant Governor,Anastasia Pittman,DEM,450019,1,1,61,63,
Mccurtain,Lieutenant Governor,Ivan Holmes,IND,450019,0,0,13,13,
Mccurtain,State Auditor,John Yeutter,LIB,450019,0,1,34,35,
Mccurtain,State Auditor,Cindy Byrd,REP,450019,6,15,313,334,
Mccurtain,Attorney General,Mike Hunter,REP,450019,5,14,298,317,
Mccurtain,Attorney General,Mark Myles,DEM,450019,1,2,66,69,
Mccurtain,State Treasurer,Randy Mcdaniel,REP,450019,6,15,311,332,
Mccurtain,State Treasurer,Charles De Coune,IND,450019,0,1,38,39,
Mccurtain,Superintendent of Public Instruction,Joy Hofmeister,REP,450019,5,13,243,261,
Mccurtain,Superintendent of Public Instruction,John Cox,DEM,450019,1,2,103,106,
Mccurtain,Superintendent of Public Instruction,Larry Huff,IND,450019,0,0,20,20,
Mccurtain,Commissioner of Labor,Leslie Osborn,REP,450019,5,13,276,294,
Mccurtain,Commissioner of Labor,Fred Dorrell,DEM,450019,1,2,74,77,
Mccurtain,Commissioner of Labor,Brandt Dismukes,IND,450019,0,0,12,12,
Mccurtain,Insurance Commissioner,Glen Mulready,REP,450019,5,14,277,296,
Mccurtain,Insurance Commissioner,Kimberly Fobbs,DEM,450019,1,2,77,80,
Mccurtain,Corporation Commissioner,Bob Anthony,REP,450019,4,15,287,306,
Mccurtain,Corporation Commissioner,Ashley Nicole Mccray,DEM,450019,1,1,58,60,
Mccurtain,Corporation Commissioner,Jackie Short,IND,450019,1,0,14,15,
Mccurtain,U.S. House,Richard Castaldo,LIB,450019,0,0,9,9,2
Mccurtain,U.S. House,Markwayne Mullin,REP,450019,5,14,292,311,2
Mccurtain,U.S. House,Jason Nichols,DEM,450019,1,2,57,60,2
Mccurtain,U.S. House,John Foreman,IND,450019,0,0,7,7,2
Mccurtain,Governor,Chris Powell,LIB,450020,0,0,4,4,
Mccurtain,Governor,Kevin Stitt,REP,450020,0,24,224,248,
Mccurtain,Governor,Drew Edmondson,DEM,450020,1,7,75,83,
Mccurtain,Lieutenant Governor,Matt Pinnell,REP,450020,0,25,235,260,
Mccurtain,Lieutenant Governor,Anastasia Pittman,DEM,450020,1,6,59,66,
Mccurtain,Lieutenant Governor,Ivan Holmes,IND,450020,0,0,7,7,
Mccurtain,State Auditor,John Yeutter,LIB,450020,0,3,35,38,
Mccurtain,State Auditor,Cindy Byrd,REP,450020,0,26,251,277,
Mccurtain,Attorney General,Mike Hunter,REP,450020,0,24,243,267,
Mccurtain,Attorney General,Mark Myles,DEM,450020,1,7,55,63,
Mccurtain,State Treasurer,Randy Mcdaniel,REP,450020,0,25,243,268,
Mccurtain,State Treasurer,Charles De Coune,IND,450020,0,4,42,46,
Mccurtain,Superintendent of Public Instruction,Joy Hofmeister,REP,450020,0,24,207,231,
Mccurtain,Superintendent of Public Instruction,John Cox,DEM,450020,1,7,74,82,
Mccurtain,Superintendent of Public Instruction,Larry Huff,IND,450020,0,0,19,19,
Mccurtain,Commissioner of Labor,Leslie Osborn,REP,450020,0,24,231,255,
Mccurtain,Commissioner of Labor,Fred Dorrell,DEM,450020,1,6,54,61,
Mccurtain,Commissioner of Labor,Brandt Dismukes,IND,450020,0,1,14,15,
Mccurtain,Insurance Commissioner,Glen Mulready,REP,450020,0,25,237,262,
Mccurtain,Insurance Commissioner,Kimberly Fobbs,DEM,450020,1,6,63,70,
Mccurtain,Corporation Commissioner,Bob Anthony,REP,450020,0,24,230,254,
Mccurtain,Corporation Commissioner,Ashley Nicole Mccray,DEM,450020,1,6,58,65,
Mccurtain,Corporation Commissioner,Jackie Short,IND,450020,0,1,11,12,
Mccurtain,U.S. House,Richard Castaldo,LIB,450020,0,0,9,9,2
Mccurtain,U.S. House,Markwayne Mullin,REP,450020,0,24,243,267,2
Mccurtain,U.S. House,Jason Nichols,DEM,450020,1,7,50,58,2
Mccurtain,U.S. House,John Foreman,IND,450020,0,0,3,3,2
Mccurtain,Governor,Chris Powell,LIB,450022,0,0,10,10,
Mccurtain,Governor,Kevin Stitt,REP,450022,2,8,185,195,
Mccurtain,Governor,Drew Edmondson,DEM,450022,3,1,39,43,
Mccurtain,Lieutenant Governor,Matt Pinnell,REP,450022,2,8,193,203,
Mccurtain,Lieutenant Governor,Anastasia Pittman,DEM,450022,3,0,30,33,
Mccurtain,Lieutenant Governor,Ivan Holmes,IND,450022,0,1,4,5,
Mccurtain,State Auditor,John Yeutter,LIB,450022,0,1,24,25,
Mccurtain,State Auditor,Cindy Byrd,REP,450022,3,8,198,209,
Mccurtain,Attorney General,Mike Hunter,REP,450022,2,7,194,203,
Mccurtain,Attorney General,Mark Myles,DEM,450022,3,1,33,37,
Mccurtain,State Treasurer,Randy Mcdaniel,REP,450022,2,9,203,214,
Mccurtain,State Treasurer,Charles De Coune,IND,450022,2,0,17,19,
Mccurtain,Superintendent of Public Instruction,Joy Hofmeister,REP,450022,2,7,166,175,
Mccurtain,Superintendent of Public Instruction,John Cox,DEM,450022,3,2,48,53,
Mccurtain,Superintendent of Public Instruction,Larry Huff,IND,450022,0,0,13,13,
Mccurtain,Commissioner of Labor,Leslie Osborn,REP,450022,2,9,184,195,
Mccurtain,Commissioner of Labor,Fred Dorrell,DEM,450022,3,0,32,35,
Mccurtain,Commissioner of Labor,Brandt Dismukes,IND,450022,0,0,6,6,
Mccurtain,Insurance Commissioner,Glen Mulready,REP,450022,2,9,189,200,
Mccurtain,Insurance Commissioner,Kimberly Fobbs,DEM,450022,3,0,34,37,
Mccurtain,Corporation Commissioner,Bob Anthony,REP,450022,2,8,184,194,
Mccurtain,Corporation Commissioner,Ashley Nicole Mccray,DEM,450022,3,1,30,34,
Mccurtain,Corporation Commissioner,Jackie Short,IND,450022,0,0,6,6,
Mccurtain,U.S. House,Richard Castaldo,LIB,450022,0,0,1,1,2
Mccurtain,U.S. House,Markwayne Mullin,REP,450022,2,9,202,213,2
Mccurtain,U.S. House,Jason Nichols,DEM,450022,3,0,24,27,2
Mccurtain,U.S. House,John Foreman,IND,450022,0,0,3,3,2
Mccurtain,Governor,Chris Powell,LIB,450023,0,0,7,7,
Mccurtain,Governor,Kevin Stitt,REP,450023,4,10,127,141,
Mccurtain,Governor,Drew Edmondson,DEM,450023,1,1,59,61,
Mccurtain,Lieutenant Governor,Matt Pinnell,REP,450023,4,11,125,140,
Mccurtain,Lieutenant Governor,Anastasia Pittman,DEM,450023,1,0,52,53,
Mccurtain,Lieutenant Governor,Ivan Holmes,IND,450023,0,0,7,7,
Mccurtain,State Auditor,John Yeutter,LIB,450023,1,0,30,31,
Mccurtain,State Auditor,Cindy Byrd,REP,450023,4,11,142,157,
Mccurtain,Attorney General,Mike Hunter,REP,450023,4,11,133,148,
Mccurtain,Attorney General,Mark Myles,DEM,450023,1,0,54,55,
Mccurtain,State Treasurer,Randy Mcdaniel,REP,450023,4,11,148,163,
Mccurtain,State Treasurer,Charles De Coune,IND,450023,1,0,28,29,
Mccurtain,Superintendent of Public Instruction,Joy Hofmeister,REP,450023,4,10,121,135,
Mccurtain,Superintendent of Public Instruction,John Cox,DEM,450023,1,1,61,63,
Mccurtain,Superintendent of Public Instruction,Larry Huff,IND,450023,0,0,8,8,
Mccurtain,Commissioner of Labor,Leslie Osborn,REP,450023,4,10,122,136,
Mccurtain,Commissioner of Labor,Fred Dorrell,DEM,450023,1,1,59,61,
Mccurtain,Commissioner of Labor,Brandt Dismukes,IND,450023,0,0,5,5,
Mccurtain,Insurance Commissioner,Glen Mulready,REP,450023,4,10,124,138,
Mccurtain,Insurance Commissioner,Kimberly Fobbs,DEM,450023,1,1,61,63,
Mccurtain,Corporation Commissioner,Bob Anthony,REP,450023,4,10,117,131,
Mccurtain,Corporation Commissioner,Ashley Nicole Mccray,DEM,450023,1,1,58,60,
Mccurtain,Corporation Commissioner,Jackie Short,IND,450023,0,0,10,10,
Mccurtain,U.S. House,Richard Castaldo,LIB,450023,0,0,1,1,2
Mccurtain,U.S. House,Markwayne Mullin,REP,450023,4,11,133,148,2
Mccurtain,U.S. House,Jason Nichols,DEM,450023,1,0,48,49,2
Mccurtain,U.S. House,John Foreman,IND,450023,0,0,6,6,2
Mccurtain,Governor,Chris Powell,LIB,450024,0,0,3,3,
Mccurtain,Governor,Kevin Stitt,REP,450024,3,4,74,81,
Mccurtain,Governor,Drew Edmondson,DEM,450024,1,1,43,45,
Mccurtain,Lieutenant Governor,Matt Pinnell,REP,450024,1,4,76,81,
Mccurtain,Lieutenant Governor,Anastasia Pittman,DEM,450024,1,1,39,41,
Mccurtain,Lieutenant Governor,Ivan Holmes,IND,450024,0,0,5,5,
Mccurtain,State Auditor,John Yeutter,LIB,450024,1,1,24,26,
Mccurtain,State Auditor,Cindy Byrd,REP,450024,1,2,88,91,
Mccurtain,Attorney General,Mike Hunter,REP,450024,1,3,90,94,
Mccurtain,Attorney General,Mark Myles,DEM,450024,1,1,31,33,
Mccurtain,State Treasurer,Randy Mcdaniel,REP,450024,1,3,93,97,
Mccurtain,State Treasurer,Charles De Coune,IND,450024,1,0,24,25,
Mccurtain,Superintendent of Public Instruction,Joy Hofmeister,REP,450024,1,3,61,65,
Mccurtain,Superintendent of Public Instruction,John Cox,DEM,450024,1,1,40,42,
Mccurtain,Superintendent of Public Instruction,Larry Huff,IND,450024,0,0,19,19,
Mccurtain,Commissioner of Labor,Leslie Osborn,REP,450024,1,3,75,79,
Mccurtain,Commissioner of Labor,Fred Dorrell,DEM,450024,1,1,31,33,
Mccurtain,Commissioner of Labor,Brandt Dismukes,IND,450024,0,0,12,12,
Mccurtain,Insurance Commissioner,Glen Mulready,REP,450024,1,2,81,84,
Mccurtain,Insurance Commissioner,Kimberly Fobbs,DEM,450024,1,2,36,39,
Mccurtain,Corporation Commissioner,Bob Anthony,REP,450024,1,3,74,78,
Mccurtain,Corporation Commissioner,Ashley Nicole Mccray,DEM,450024,1,1,34,36,
Mccurtain,Corporation Commissioner,Jackie Short,IND,450024,0,0,9,9,
Mccurtain,U.S. House,Richard Castaldo,LIB,450024,0,0,5,5,2
Mccurtain,U.S. House,Markwayne Mullin,REP,450024,3,1,85,89,2
Mccurtain,U.S. House,Jason Nichols,DEM,450024,1,3,27,31,2
Mccurtain,U.S. House,John Foreman,IND,450024,0,1,6,7,2
Mccurtain,Governor,Chris Powell,LIB,450025,0,0,3,3,
Mccurtain,Governor,Kevin Stitt,REP,450025,1,3,140,144,
Mccurtain,Governor,Drew Edmondson,DEM,450025,2,1,34,37,
Mccurtain,Lieutenant Governor,Matt Pinnell,REP,450025,1,4,138,143,
Mccurtain,Lieutenant Governor,Anastasia Pittman,DEM,450025,2,0,32,34,
Mccurtain,Lieutenant Governor,Ivan Holmes,IND,450025,0,0,4,4,
Mccurtain,State Auditor,John Yeutter,LIB,450025,1,1,19,21,
Mccurtain,State Auditor,Cindy Byrd,REP,450025,2,3,146,151,
Mccurtain,Attorney General,Mike Hunter,REP,450025,1,3,144,148,
Mccurtain,Attorney General,Mark Myles,DEM,450025,1,1,31,33,
Mccurtain,State Treasurer,Randy Mcdaniel,REP,450025,1,4,153,158,
Mccurtain,State Treasurer,Charles De Coune,IND,450025,1,0,12,13,
Mccurtain,Superintendent of Public Instruction,Joy Hofmeister,REP,450025,1,3,127,131,
Mccurtain,Superintendent of Public Instruction,John Cox,DEM,450025,1,0,37,38,
Mccurtain,Superintendent of Public Instruction,Larry Huff,IND,450025,0,0,9,9,
Mccurtain,Commissioner of Labor,Leslie Osborn,REP,450025,1,4,137,142,
Mccurtain,Commissioner of Labor,Fred Dorrell,DEM,450025,1,0,30,31,
Mccurtain,Commissioner of Labor,Brandt Dismukes,IND,450025,0,0,7,7,
Mccurtain,Insurance Commissioner,Glen Mulready,REP,450025,1,4,141,146,
Mccurtain,Insurance Commissioner,Kimberly Fobbs,DEM,450025,1,0,33,34,
Mccurtain,Corporation Commissioner,Bob Anthony,REP,450025,1,4,139,144,
Mccurtain,Corporation Commissioner,Ashley Nicole Mccray,DEM,450025,1,0,30,31,
Mccurtain,Corporation Commissioner,Jackie Short,IND,450025,0,0,6,6,
Mccurtain,U.S. House,Richard Castaldo,LIB,450025,0,0,5,5,2
Mccurtain,U.S. House,Markwayne Mullin,REP,450025,1,4,138,143,2
Mccurtain,U.S. House,Jason Nichols,DEM,450025,2,0,29,31,2
Mccurtain,U.S. House,John Foreman,IND,450025,0,0,5,5,2
Mccurtain,Governor,Chris Powell,LIB,450026,0,0,4,4,
Mccurtain,Governor,Kevin Stitt,REP,450026,8,0,123,131,
Mccurtain,Governor,Drew Edmondson,DEM,450026,1,4,9,14,
Mccurtain,Lieutenant Governor,Matt Pinnell,REP,450026,8,1,115,124,
Mccurtain,Lieutenant Governor,Anastasia Pittman,DEM,450026,1,3,15,19,
Mccurtain,Lieutenant Governor,Ivan Holmes,IND,450026,0,0,5,5,
Mccurtain,State Auditor,John Yeutter,LIB,450026,1,2,6,9,
Mccurtain,State Auditor,Cindy Byrd,REP,450026,8,2,126,136,
Mccurtain,Attorney General,Mike Hunter,REP,450026,8,1,125,134,
Mccurtain,Attorney General,Mark Myles,DEM,450026,1,3,9,13,
Mccurtain,State Treasurer,Randy Mcdaniel,REP,450026,8,1,123,132,
Mccurtain,State Treasurer,Charles De Coune,IND,450026,1,3,10,14,
Mccurtain,Superintendent of Public Instruction,Joy Hofmeister,REP,450026,6,1,113,120,
Mccurtain,Superintendent of Public Instruction,John Cox,DEM,450026,3,3,12,18,
Mccurtain,Superintendent of Public Instruction,Larry Huff,IND,450026,0,0,10,10,
Mccurtain,Commissioner of Labor,Leslie Osborn,REP,450026,8,1,114,123,
Mccurtain,Commissioner of Labor,Fred Dorrell,DEM,450026,1,3,14,18,
Mccurtain,Commissioner of Labor,Brandt Dismukes,IND,450026,0,0,6,6,
Mccurtain,Insurance Commissioner,Glen Mulready,REP,450026,8,1,123,132,
Mccurtain,Insurance Commissioner,Kimberly Fobbs,DEM,450026,1,3,8,12,
Mccurtain,Corporation Commissioner,Bob Anthony,REP,450026,8,1,124,133,
Mccurtain,Corporation Commissioner,Ashley Nicole Mccray,DEM,450026,1,3,7,11,
Mccurtain,Corporation Commissioner,Jackie Short,IND,450026,0,0,2,2,
Mccurtain,U.S. House,Richard Castaldo,LIB,450026,1,0,7,8,2
Mccurtain,U.S. House,Markwayne Mullin,REP,450026,7,0,120,127,2
Mccurtain,U.S. House,Jason Nichols,DEM,450026,1,4,8,13,2
Mccurtain,U.S. House,John Foreman,IND,450026,0,0,1,1,2
Mccurtain,Governor,Chris Powell,LIB,450027,0,0,2,2,
Mccurtain,Governor,Kevin Stitt,REP,450027,1,1,52,54,
Mccurtain,Governor,Drew Edmondson,DEM,450027,0,0,25,25,
Mccurtain,Lieutenant Governor,Matt Pinnell,REP,450027,1,1,61,63,
Mccurtain,Lieutenant Governor,Anastasia Pittman,DEM,450027,0,0,17,17,
Mccurtain,Lieutenant Governor,Ivan Holmes,IND,450027,0,0,1,1,
Mccurtain,State Auditor,John Yeutter,LIB,450027,0,0,6,6,
Mccurtain,State Auditor,Cindy Byrd,REP,450027,1,1,68,70,
Mccurtain,Attorney General,Mike Hunter,REP,450027,1,1,61,63,
Mccurtain,Attorney General,Mark Myles,DEM,450027,0,0,16,16,
Mccurtain,State Treasurer,Randy Mcdaniel,REP,450027,1,1,67,69,
Mccurtain,State Treasurer,Charles De Coune,IND,450027,0,0,7,7,
Mccurtain,Superintendent of Public Instruction,Joy Hofmeister,REP,450027,1,1,49,51,
Mccurtain,Superintendent of Public Instruction,John Cox,DEM,450027,0,0,25,25,
Mccurtain,Superintendent of Public Instruction,Larry Huff,IND,450027,0,0,2,2,
Mccurtain,Commissioner of Labor,Leslie Osborn,REP,450027,1,0,59,60,
Mccurtain,Commissioner of Labor,Fred Dorrell,DEM,450027,0,0,16,16,
Mccurtain,Commissioner of Labor,Brandt Dismukes,IND,450027,0,0,1,1,
Mccurtain,Insurance Commissioner,Glen Mulready,REP,450027,1,1,56,58,
Mccurtain,Insurance Commissioner,Kimberly Fobbs,DEM,450027,0,0,21,21,
Mccurtain,Corporation Commissioner,Bob Anthony,REP,450027,1,1,59,61,
Mccurtain,Corporation Commissioner,Ashley Nicole Mccray,DEM,450027,0,0,15,15,
Mccurtain,Corporation Commissioner,Jackie Short,IND,450027,0,0,4,4,
Mccurtain,U.S. House,Richard Castaldo,LIB,450027,0,0,0,0,2
Mccurtain,U.S. House,Markwayne Mullin,REP,450027,1,1,63,65,2
Mccurtain,U.S. House,Jason Nichols,DEM,450027,0,0,16,16,2
Mccurtain,U.S. House,John Foreman,IND,450027,0,0,0,0,2
Mccurtain,Governor,Chris Powell,LIB,450028,0,0,4,4,
Mccurtain,Governor,Kevin Stitt,REP,450028,0,3,55,58,
Mccurtain,Governor,Drew Edmondson,DEM,450028,0,2,13,15,
Mccurtain,Lieutenant Governor,Matt Pinnell,REP,450028,0,5,63,68,
Mccurtain,Lieutenant Governor,Anastasia Pittman,DEM,450028,0,0,6,6,
Mccurtain,Lieutenant Governor,Ivan Holmes,IND,450028,0,0,1,1,
Mccurtain,State Auditor,John Yeutter,LIB,450028,0,0,4,4,
Mccurtain,State Auditor,Cindy Byrd,REP,450028,0,5,66,71,
Mccurtain,Attorney General,Mike Hunter,REP,450028,0,5,64,69,
Mccurtain,Attorney General,Mark Myles,DEM,450028,0,0,6,6,
Mccurtain,State Treasurer,Randy Mcdaniel,REP,450028,0,5,66,71,
Mccurtain,State Treasurer,Charles De Coune,IND,450028,0,0,4,4,
Mccurtain,Superintendent of Public Instruction,Joy Hofmeister,REP,450028,0,5,58,63,
Mccurtain,Superintendent of Public Instruction,John Cox,DEM,450028,0,0,7,7,
Mccurtain,Superintendent of Public Instruction,Larry Huff,IND,450028,0,0,5,5,
Mccurtain,Commissioner of Labor,Leslie Osborn,REP,450028,0,5,65,70,
Mccurtain,Commissioner of Labor,Fred Dorrell,DEM,450028,0,0,1,1,
Mccurtain,Commissioner of Labor,Brandt Dismukes,IND,450028,0,0,3,3,
Mccurtain,Insurance Commissioner,Glen Mulready,REP,450028,0,5,65,70,
Mccurtain,Insurance Commissioner,Kimberly Fobbs,DEM,450028,0,0,5,5,
Mccurtain,Corporation Commissioner,Bob Anthony,REP,450028,0,5,60,65,
Mccurtain,Corporation Commissioner,Ashley Nicole Mccray,DEM,450028,0,0,2,2,
Mccurtain,Corporation Commissioner,Jackie Short,IND,450028,0,0,7,7,
Mccurtain,U.S. House,Richard Castaldo,LIB,450028,0,0,2,2,2
Mccurtain,U.S. House,Markwayne Mullin,REP,450028,0,5,65,70,2
Mccurtain,U.S. House,Jason Nichols,DEM,450028,0,0,1,1,2
Mccurtain,U.S. House,John Foreman,IND,450028,0,0,3,3,2
Mccurtain,Governor,Chris Powell,LIB,450029,0,0,5,5,
Mccurtain,Governor,Kevin Stitt,REP,450029,4,5,162,171,
Mccurtain,Governor,Drew Edmondson,DEM,450029,0,1,43,44,
Mccurtain,Lieutenant Governor,Matt Pinnell,REP,450029,4,6,168,178,
Mccurtain,Lieutenant Governor,Anastasia Pittman,DEM,450029,0,0,34,34,
Mccurtain,Lieutenant Governor,Ivan Holmes,IND,450029,0,0,7,7,
Mccurtain,State Auditor,John Yeutter,LIB,450029,0,0,23,23,
Mccurtain,State Auditor,Cindy Byrd,REP,450029,4,6,178,188,
Mccurtain,Attorney General,Mike Hunter,REP,450029,4,5,172,181,
Mccurtain,Attorney General,Mark Myles,DEM,450029,0,1,35,36,
Mccurtain,State Treasurer,Randy Mcdaniel,REP,450029,4,6,181,191,
Mccurtain,State Treasurer,Charles De Coune,IND,450029,0,0,20,20,
Mccurtain,Superintendent of Public Instruction,Joy Hofmeister,REP,450029,3,4,147,154,
Mccurtain,Superintendent of Public Instruction,John Cox,DEM,450029,1,1,47,49,
Mccurtain,Superintendent of Public Instruction,Larry Huff,IND,450029,0,0,16,16,
Mccurtain,Commissioner of Labor,Leslie Osborn,REP,450029,4,5,161,170,
Mccurtain,Commissioner of Labor,Fred Dorrell,DEM,450029,0,1,34,35,
Mccurtain,Commissioner of Labor,Brandt Dismukes,IND,450029,0,0,11,11,
Mccurtain,Insurance Commissioner,Glen Mulready,REP,450029,4,5,165,174,
Mccurtain,Insurance Commissioner,Kimberly Fobbs,DEM,450029,0,1,39,40,
Mccurtain,Corporation Commissioner,Bob Anthony,REP,450029,4,4,164,172,
Mccurtain,Corporation Commissioner,Ashley Nicole Mccray,DEM,450029,0,1,28,29,
Mccurtain,Corporation Commissioner,Jackie Short,IND,450029,0,1,13,14,
Mccurtain,U.S. House,Richard Castaldo,LIB,450029,0,1,2,3,2
Mccurtain,U.S. House,Markwayne Mullin,REP,450029,4,4,168,176,2
Mccurtain,U.S. House,Jason Nichols,DEM,450029,0,1,28,29,2
Mccurtain,U.S. House,John Foreman,IND,450029,0,0,9,9,2
Mccurtain,Governor,Chris Powell,LIB,450031,0,0,17,17,
Mccurtain,Governor,Kevin Stitt,REP,450031,9,29,263,301,
Mccurtain,Governor,Drew Edmondson,DEM,450031,7,5,109,121,
Mccurtain,Lieutenant Governor,Matt Pinnell,REP,450031,13,27,318,358,
Mccurtain,Lieutenant Governor,Anastasia Pittman,DEM,450031,1,6,65,72,
Mccurtain,Lieutenant Governor,Ivan Holmes,IND,450031,2,1,6,9,
Mccurtain,State Auditor,John Yeutter,LIB,450031,3,3,42,48,
Mccurtain,State Auditor,Cindy Byrd,REP,450031,13,30,331,374,
Mccurtain,Attorney General,Mike Hunter,REP,450031,13,29,325,367,
Mccurtain,Attorney General,Mark Myles,DEM,450031,3,5,62,70,
Mccurtain,State Treasurer,Randy Mcdaniel,REP,450031,11,29,333,373,
Mccurtain,State Treasurer,Charles De Coune,IND,450031,5,4,43,52,
Mccurtain,Superintendent of Public Instruction,Joy Hofmeister,REP,450031,10,26,248,284,
Mccurtain,Superintendent of Public Instruction,John Cox,DEM,450031,4,7,123,134,
Mccurtain,Superintendent of Public Instruction,Larry Huff,IND,450031,2,1,17,20,
Mccurtain,Commissioner of Labor,Leslie Osborn,REP,450031,11,28,306,345,
Mccurtain,Commissioner of Labor,Fred Dorrell,DEM,450031,2,6,71,79,
Mccurtain,Commissioner of Labor,Brandt Dismukes,IND,450031,3,0,10,13,
Mccurtain,Insurance Commissioner,Glen Mulready,REP,450031,13,29,309,351,
Mccurtain,Insurance Commissioner,Kimberly Fobbs,DEM,450031,3,5,76,84,
Mccurtain,Corporation Commissioner,Bob Anthony,REP,450031,12,28,303,343,
Mccurtain,Corporation Commissioner,Ashley Nicole Mccray,DEM,450031,2,5,67,74,
Mccurtain,Corporation Commissioner,Jackie Short,IND,450031,2,1,15,18,
Mccurtain,U.S. House,Richard Castaldo,LIB,450031,0,0,5,5,2
Mccurtain,U.S. House,Markwayne Mullin,REP,450031,13,27,309,349,2
Mccurtain,U.S. House,Jason Nichols,DEM,450031,2,6,61,69,2
Mccurtain,U.S. House,John Foreman,IND,450031,1,1,13,15,2
Mccurtain,Governor,Chris Powell,LIB,450033,0,0,5,5,
Mccurtain,Governor,Kevin Stitt,REP,450033,3,13,147,163,
Mccurtain,Governor,Drew Edmondson,DEM,450033,3,6,50,59,
Mccurtain,Lieutenant Governor,Matt Pinnell,REP,450033,4,13,155,172,
Mccurtain,Lieutenant Governor,Anastasia Pittman,DEM,450033,1,5,39,45,
Mccurtain,Lieutenant Governor,Ivan Holmes,IND,450033,1,0,7,8,
Mccurtain,State Auditor,John Yeutter,LIB,450033,1,3,18,22,
Mccurtain,State Auditor,Cindy Byrd,REP,450033,5,12,174,191,
Mccurtain,Attorney General,Mike Hunter,REP,450033,3,12,164,179,
Mccurtain,Attorney General,Mark Myles,DEM,450033,3,5,38,46,
Mccurtain,State Treasurer,Randy Mcdaniel,REP,450033,4,14,170,188,
Mccurtain,State Treasurer,Charles De Coune,IND,450033,1,1,24,26,
Mccurtain,Superintendent of Public Instruction,Joy Hofmeister,REP,450033,5,10,134,149,
Mccurtain,Superintendent of Public Instruction,John Cox,DEM,450033,1,7,56,64,
Mccurtain,Superintendent of Public Instruction,Larry Huff,IND,450033,0,0,10,10,
Mccurtain,Commissioner of Labor,Leslie Osborn,REP,450033,5,13,156,174,
Mccurtain,Commissioner of Labor,Fred Dorrell,DEM,450033,1,4,41,46,
Mccurtain,Commissioner of Labor,Brandt Dismukes,IND,450033,0,0,4,4,
Mccurtain,Insurance Commissioner,Glen Mulready,REP,450033,3,11,162,176,
Mccurtain,Insurance Commissioner,Kimberly Fobbs,DEM,450033,3,5,40,48,
Mccurtain,Corporation Commissioner,Bob Anthony,REP,450033,3,10,158,171,
Mccurtain,Corporation Commissioner,Ashley Nicole Mccray,DEM,450033,2,6,37,45,
Mccurtain,Corporation Commissioner,Jackie Short,IND,450033,1,0,7,8,
Mccurtain,U.S. House,Richard Castaldo,LIB,450033,0,0,1,1,2
Mccurtain,U.S. House,Markwayne Mullin,REP,450033,3,15,169,187,2
Mccurtain,U.S. House,Jason Nichols,DEM,450033,3,4,31,38,2
Mccurtain,U.S. House,John Foreman,IND,450033,0,0,1,1,2
Mccurtain,Governor,Chris Powell,LIB,450034,0,0,5,5,
Mccurtain,Governor,Kevin Stitt,REP,450034,1,14,182,197,
Mccurtain,Governor,Drew Edmondson,DEM,450034,1,4,53,58,
Mccurtain,Lieutenant Governor,Matt Pinnell,REP,450034,1,13,193,207,
Mccurtain,Lieutenant Governor,Anastasia Pittman,DEM,450034,0,5,39,44,
Mccurtain,Lieutenant Governor,Ivan Holmes,IND,450034,1,0,5,6,
Mccurtain,State Auditor,John Yeutter,LIB,450034,0,2,22,24,
Mccurtain,State Auditor,Cindy Byrd,REP,450034,2,13,212,227,
Mccurtain,Attorney General,Mike Hunter,REP,450034,1,13,194,208,
Mccurtain,Attorney General,Mark Myles,DEM,450034,1,5,42,48,
Mccurtain,State Treasurer,Randy Mcdaniel,REP,450034,1,14,215,230,
Mccurtain,State Treasurer,Charles De Coune,IND,450034,1,1,17,19,
Mccurtain,Superintendent of Public Instruction,Joy Hofmeister,REP,450034,1,13,184,198,
Mccurtain,Superintendent of Public Instruction,John Cox,DEM,450034,1,5,44,50,
Mccurtain,Superintendent of Public Instruction,Larry Huff,IND,450034,0,0,10,10,
Mccurtain,Commissioner of Labor,Leslie Osborn,REP,450034,1,14,189,204,
Mccurtain,Commissioner of Labor,Fred Dorrell,DEM,450034,1,4,41,46,
Mccurtain,Commissioner of Labor,Brandt Dismukes,IND,450034,0,0,8,8,
Mccurtain,Insurance Commissioner,Glen Mulready,REP,450034,1,13,193,207,
Mccurtain,Insurance Commissioner,Kimberly Fobbs,DEM,450034,1,5,45,51,
Mccurtain,Corporation Commissioner,Bob Anthony,REP,450034,1,13,187,201,
Mccurtain,Corporation Commissioner,Ashley Nicole Mccray,DEM,450034,1,5,43,49,
Mccurtain,Corporation Commissioner,Jackie Short,IND,450034,0,0,9,9,
Mccurtain,U.S. House,Richard Castaldo,LIB,450034,0,1,2,3,2
Mccurtain,U.S. House,Markwayne Mullin,REP,450034,1,13,199,213,2
Mccurtain,U.S. House,Jason Nichols,DEM,450034,1,4,31,36,2
Mccurtain,U.S. House,John Foreman,IND,450034,0,0,7,7,2
Mccurtain,Governor,Chris Powell,LIB,450035,0,1,8,9,
Mccurtain,Governor,Kevin Stitt,REP,450035,7,11,309,327,
Mccurtain,Governor,Drew Edmondson,DEM,450035,1,6,123,130,
Mccurtain,Lieutenant Governor,Matt Pinnell,REP,450035,7,12,328,347,
Mccurtain,Lieutenant Governor,Anastasia Pittman,DEM,450035,1,6,103,110,
Mccurtain,Lieutenant Governor,Ivan Holmes,IND,450035,0,0,9,9,
Mccurtain,State Auditor,John Yeutter,LIB,450035,1,1,51,53,
Mccurtain,State Auditor,Cindy Byrd,REP,450035,7,16,361,384,
Mccurtain,Attorney General,Mike Hunter,REP,450035,7,13,331,351,
Mccurtain,Attorney General,Mark Myles,DEM,450035,1,5,105,111,
Mccurtain,State Treasurer,Randy Mcdaniel,REP,450035,7,14,359,380,
Mccurtain,State Treasurer,Charles De Coune,IND,450035,1,3,52,56,
Mccurtain,Superintendent of Public Instruction,Joy Hofmeister,REP,450035,7,10,295,312,
Mccurtain,Superintendent of Public Instruction,John Cox,DEM,450035,0,7,119,126,
Mccurtain,Superintendent of Public Instruction,Larry Huff,IND,450035,1,1,22,24,
Mccurtain,Commissioner of Labor,Leslie Osborn,REP,450035,6,13,336,355,
Mccurtain,Commissioner of Labor,Fred Dorrell,DEM,450035,2,5,88,95,
Mccurtain,Commissioner of Labor,Brandt Dismukes,IND,450035,0,0,10,10,
Mccurtain,Insurance Commissioner,Glen Mulready,REP,450035,7,12,326,345,
Mccurtain,Insurance Commissioner,Kimberly Fobbs,DEM,450035,1,6,105,112,
Mccurtain,Corporation Commissioner,Bob Anthony,REP,450035,7,12,325,344,
Mccurtain,Corporation Commissioner,Ashley Nicole Mccray,DEM,450035,1,6,94,101,
Mccurtain,Corporation Commissioner,Jackie Short,IND,450035,0,0,13,13,
Mccurtain,U.S. House,Richard Castaldo,LIB,450035,1,1,5,7,2
Mccurtain,U.S. House,Markwayne Mullin,REP,450035,6,12,340,358,2
Mccurtain,U.S. House,Jason Nichols,DEM,450035,1,5,88,94,2
Mccurtain,U.S. House,John Foreman,IND,450035,0,0,9,9,2
Mccurtain,Governor,Chris Powell,LIB,450036,0,0,7,7,
Mccurtain,Governor,Kevin Stitt,REP,450036,3,11,256,270,
Mccurtain,Governor,Drew Edmondson,DEM,450036,1,3,72,76,
Mccurtain,Lieutenant Governor,Matt Pinnell,REP,450036,4,11,272,287,
Mccurtain,Lieutenant Governor,Anastasia Pittman,DEM,450036,0,3,60,63,
Mccurtain,Lieutenant Governor,Ivan Holmes,IND,450036,0,0,1,1,
Mccurtain,State Auditor,John Yeutter,LIB,450036,0,2,32,34,
Mccurtain,State Auditor,Cindy Byrd,REP,450036,4,12,285,301,
Mccurtain,Attorney General,Mike Hunter,REP,450036,4,9,273,286,
Mccurtain,Attorney General,Mark Myles,DEM,450036,0,5,56,61,
Mccurtain,State Treasurer,Randy Mcdaniel,REP,450036,4,11,285,300,
Mccurtain,State Treasurer,Charles De Coune,IND,450036,0,3,31,34,
Mccurtain,Superintendent of Public Instruction,Joy Hofmeister,REP,450036,3,8,246,257,
Mccurtain,Superintendent of Public Instruction,John Cox,DEM,450036,1,6,71,78,
Mccurtain,Superintendent of Public Instruction,Larry Huff,IND,450036,0,0,13,13,
Mccurtain,Commissioner of Labor,Leslie Osborn,REP,450036,3,10,277,290,
Mccurtain,Commissioner of Labor,Fred Dorrell,DEM,450036,1,4,48,53,
Mccurtain,Commissioner of Labor,Brandt Dismukes,IND,450036,0,0,6,6,
Mccurtain,Insurance Commissioner,Glen Mulready,REP,450036,3,11,272,286,
Mccurtain,Insurance Commissioner,Kimberly Fobbs,DEM,450036,1,3,58,62,
Mccurtain,Corporation Commissioner,Bob Anthony,REP,450036,4,11,266,281,
Mccurtain,Corporation Commissioner,Ashley Nicole Mccray,DEM,450036,0,3,57,60,
Mccurtain,Corporation Commissioner,Jackie Short,IND,450036,0,0,7,7,
Mccurtain,U.S. House,Richard Castaldo,LIB,450036,0,0,2,2,2
Mccurtain,U.S. House,Markwayne Mullin,REP,450036,4,10,278,292,2
Mccurtain,U.S. House,Jason Nichols,DEM,450036,0,3,52,55,2
Mccurtain,U.S. House,John Foreman,IND,450036,0,1,3,4,2
Mccurtain,Governor,Chris Powell,LIB,450037,0,0,1,1,
Mccurtain,Governor,Kevin Stitt,REP,450037,1,0,58,59,
Mccurtain,Governor,Drew Edmondson,DEM,450037,0,4,19,23,
Mccurtain,Lieutenant Governor,Matt Pinnell,REP,450037,1,0,58,59,
Mccurtain,Lieutenant Governor,Anastasia Pittman,DEM,450037,0,4,18,22,
Mccurtain,Lieutenant Governor,Ivan Holmes,IND,450037,0,0,2,2,
Mccurtain,State Auditor,John Yeutter,LIB,450037,0,2,13,15,
Mccurtain,State Auditor,Cindy Byrd,REP,450037,1,0,62,63,
Mccurtain,Attorney General,Mike Hunter,REP,450037,1,0,57,58,
Mccurtain,Attorney General,Mark Myles,DEM,450037,0,4,20,24,
Mccurtain,State Treasurer,Randy Mcdaniel,REP,450037,1,0,61,62,
Mccurtain,State Treasurer,Charles De Coune,IND,450037,0,2,15,17,
Mccurtain,Superintendent of Public Instruction,Joy Hofmeister,REP,450037,1,1,50,52,
Mccurtain,Superintendent of Public Instruction,John Cox,DEM,450037,0,3,20,23,
Mccurtain,Superintendent of Public Instruction,Larry Huff,IND,450037,0,0,8,8,
Mccurtain,Commissioner of Labor,Leslie Osborn,REP,450037,1,0,57,58,
Mccurtain,Commissioner of Labor,Fred Dorrell,DEM,450037,0,4,17,21,
Mccurtain,Commissioner of Labor,Brandt Dismukes,IND,450037,0,0,3,3,
Mccurtain,Insurance Commissioner,Glen Mulready,REP,450037,1,0,56,57,
Mccurtain,Insurance Commissioner,Kimberly Fobbs,DEM,450037,0,4,22,26,
Mccurtain,Corporation Commissioner,Bob Anthony,REP,450037,1,0,57,58,
Mccurtain,Corporation Commissioner,Ashley Nicole Mccray,DEM,450037,0,4,20,24,
Mccurtain,Corporation Commissioner,Jackie Short,IND,450037,0,0,1,1,
Mccurtain,U.S. House,Richard Castaldo,LIB,450037,0,0,1,1,2
Mccurtain,U.S. House,Markwayne Mullin,REP,450037,1,0,58,59,2
Mccurtain,U.S. House,Jason Nichols,DEM,450037,0,4,17,21,2
Mccurtain,U.S. House,John Foreman,IND,450037,0,0,2,2,2
Mccurtain,Governor,Chris Powell,LIB,450038,0,0,7,7,
Mccurtain,Governor,Kevin Stitt,REP,450038,2,11,253,266,
Mccurtain,Governor,Drew Edmondson,DEM,450038,1,0,106,107,
Mccurtain,Lieutenant Governor,Matt Pinnell,REP,450038,2,11,269,282,
Mccurtain,Lieutenant Governor,Anastasia Pittman,DEM,450038,1,0,84,85,
Mccurtain,Lieutenant Governor,Ivan Holmes,IND,450038,0,0,10,10,
Mccurtain,State Auditor,John Yeutter,LIB,450038,1,0,45,46,
Mccurtain,State Auditor,Cindy Byrd,REP,450038,2,11,297,310,
Mccurtain,Attorney General,Mike Hunter,REP,450038,2,11,267,280,
Mccurtain,Attorney General,Mark Myles,DEM,450038,1,0,88,89,
Mccurtain,State Treasurer,Randy Mcdaniel,REP,450038,2,11,281,294,
Mccurtain,State Treasurer,Charles De Coune,IND,450038,1,0,64,65,
Mccurtain,Superintendent of Public Instruction,Joy Hofmeister,REP,450038,2,10,234,246,
Mccurtain,Superintendent of Public Instruction,John Cox,DEM,450038,1,0,110,111,
Mccurtain,Superintendent of Public Instruction,Larry Huff,IND,450038,0,1,20,21,
Mccurtain,Commissioner of Labor,Leslie Osborn,REP,450038,2,11,271,284,
Mccurtain,Commissioner of Labor,Fred Dorrell,DEM,450038,1,0,73,74,
Mccurtain,Commissioner of Labor,Brandt Dismukes,IND,450038,0,0,13,13,
Mccurtain,Insurance Commissioner,Glen Mulready,REP,450038,2,11,251,264,
Mccurtain,Insurance Commissioner,Kimberly Fobbs,DEM,450038,1,0,102,103,
Mccurtain,Corporation Commissioner,Bob Anthony,REP,450038,2,10,251,263,
Mccurtain,Corporation Commissioner,Ashley Nicole Mccray,DEM,450038,1,0,83,84,
Mccurtain,Corporation Commissioner,Jackie Short,IND,450038,0,1,19,20,
Mccurtain,U.S. House,Richard Castaldo,LIB,450038,0,0,2,2,2
Mccurtain,U.S. House,Markwayne Mullin,REP,450038,2,11,276,289,2
Mccurtain,U.S. House,Jason Nichols,DEM,450038,1,0,74,75,2
Mccurtain,U.S. House,John Foreman,IND,450038,0,0,11,11,2
Mcintosh,Governor,Chris Powell,LIB,460102,0,0,22,22,
Mcintosh,Governor,Kevin Stitt,REP,460102,2,14,298,314,
Mcintosh,Governor,Drew Edmondson,DEM,460102,13,11,255,279,
Mcintosh,Lieutenant Governor,Matt Pinnell,REP,460102,4,18,326,348,
Mcintosh,Lieutenant Governor,Anastasia Pittman,DEM,460102,11,7,221,239,
Mcintosh,Lieutenant Governor,Ivan Holmes,IND,460102,0,0,19,19,
Mcintosh,State Auditor,John Yeutter,LIB,460102,2,4,135,141,
Mcintosh,State Auditor,Cindy Byrd,REP,460102,9,19,383,411,
Mcintosh,Attorney General,Mike Hunter,REP,460102,5,16,335,356,
Mcintosh,Attorney General,Mark Myles,DEM,460102,10,9,230,249,
Mcintosh,State Treasurer,Randy Mcdaniel,REP,460102,6,19,368,393,
Mcintosh,State Treasurer,Charles De Coune,IND,460102,5,4,153,162,
Mcintosh,Superintendent of Public Instruction,Joy Hofmeister,REP,460102,2,13,289,304,
Mcintosh,Superintendent of Public Instruction,John Cox,DEM,460102,12,12,225,249,
Mcintosh,Superintendent of Public Instruction,Larry Huff,IND,460102,1,0,55,56,
Mcintosh,Commissioner of Labor,Leslie Osborn,REP,460102,4,12,295,311,
Mcintosh,Commissioner of Labor,Fred Dorrell,DEM,460102,10,12,215,237,
Mcintosh,Commissioner of Labor,Brandt Dismukes,IND,460102,1,0,50,51,
Mcintosh,Insurance Commissioner,Glen Mulready,REP,460102,4,15,316,335,
Mcintosh,Insurance Commissioner,Kimberly Fobbs,DEM,460102,11,10,245,266,
Mcintosh,Corporation Commissioner,Bob Anthony,REP,460102,4,15,304,323,
Mcintosh,Corporation Commissioner,Ashley Nicole Mccray,DEM,460102,10,10,226,246,
Mcintosh,Corporation Commissioner,Jackie Short,IND,460102,1,0,31,32,
Mcintosh,U.S. House,Richard Castaldo,LIB,460102,0,0,11,11,2
Mcintosh,U.S. House,Markwayne Mullin,REP,460102,3,17,322,342,2
Mcintosh,U.S. House,Jason Nichols,DEM,460102,12,8,219,239,2
Mcintosh,U.S. House,John Foreman,IND,460102,0,0,18,18,2
Mcintosh,State Senate,Roger Thompson,REP,460102,5,19,334,358,8
Mcintosh,State Senate,Shannan Tucker,DEM,460102,10,6,206,222,8
Mcintosh,State Senate,Marlena Nobles,IND,460102,0,0,20,20,8
Mcintosh,State House,Avery Carl Frix,REP,460102,9,20,414,443,13
Mcintosh,State House,Jolene Armstrong,DEM,460102,6,5,158,169,13
Mcintosh,Governor,Chris Powell,LIB,460103,0,1,32,33,
Mcintosh,Governor,Kevin Stitt,REP,460103,10,35,461,506,
Mcintosh,Governor,Drew Edmondson,DEM,460103,13,32,404,449,
Mcintosh,Lieutenant Governor,Matt Pinnell,REP,460103,10,41,547,598,
Mcintosh,Lieutenant Governor,Anastasia Pittman,DEM,460103,13,26,321,360,
Mcintosh,Lieutenant Governor,Ivan Holmes,IND,460103,0,1,26,27,
Mcintosh,State Auditor,John Yeutter,LIB,460103,5,12,208,225,
Mcintosh,State Auditor,Cindy Byrd,REP,460103,14,47,632,693,
Mcintosh,Attorney General,Mike Hunter,REP,460103,10,41,542,593,
Mcintosh,Attorney General,Mark Myles,DEM,460103,13,27,347,387,
Mcintosh,State Treasurer,Randy Mcdaniel,REP,460103,14,47,627,688,
Mcintosh,State Treasurer,Charles De Coune,IND,460103,6,12,210,228,
Mcintosh,Superintendent of Public Instruction,Joy Hofmeister,REP,460103,14,39,499,552,
Mcintosh,Superintendent of Public Instruction,John Cox,DEM,460103,9,26,342,377,
Mcintosh,Superintendent of Public Instruction,Larry Huff,IND,460103,0,3,50,53,
Mcintosh,Commissioner of Labor,Leslie Osborn,REP,460103,8,36,494,538,
Mcintosh,Commissioner of Labor,Fred Dorrell,DEM,460103,11,29,340,380,
Mcintosh,Commissioner of Labor,Brandt Dismukes,IND,460103,4,1,53,58,
Mcintosh,Insurance Commissioner,Glen Mulready,REP,460103,10,41,531,582,
Mcintosh,Insurance Commissioner,Kimberly Fobbs,DEM,460103,13,25,349,387,
Mcintosh,Corporation Commissioner,Bob Anthony,REP,460103,11,42,523,576,
Mcintosh,Corporation Commissioner,Ashley Nicole Mccray,DEM,460103,11,20,321,352,
Mcintosh,Corporation Commissioner,Jackie Short,IND,460103,0,5,43,48,
Mcintosh,U.S. House,Richard Castaldo,LIB,460103,0,2,17,19,2
Mcintosh,U.S. House,Markwayne Mullin,REP,460103,13,40,499,552,2
Mcintosh,U.S. House,Jason Nichols,DEM,460103,10,26,365,401,2
Mcintosh,U.S. House,John Foreman,IND,460103,0,0,14,14,2
Mcintosh,State Senate,Roger Thompson,REP,460103,11,39,557,607,8
Mcintosh,State Senate,Shannan Tucker,DEM,460103,12,29,312,353,8
Mcintosh,State Senate,Marlena Nobles,IND,460103,0,0,20,20,8
Mcintosh,State House,Avery Carl Frix,REP,460103,14,48,692,754,13
Mcintosh,State House,Jolene Armstrong,DEM,460103,9,19,205,233,13
Mcintosh,Governor,Chris Powell,LIB,460104,1,3,10,14,
Mcintosh,Governor,Kevin Stitt,REP,460104,7,20,234,261,
Mcintosh,Governor,Drew Edmondson,DEM,460104,4,13,201,218,
Mcintosh,Lieutenant Governor,Matt Pinnell,REP,460104,7,21,282,310,
Mcintosh,Lieutenant Governor,Anastasia Pittman,DEM,460104,5,12,148,165,
Mcintosh,Lieutenant Governor,Ivan Holmes,IND,460104,0,2,12,14,
Mcintosh,State Auditor,John Yeutter,LIB,460104,3,5,106,114,
Mcintosh,State Auditor,Cindy Byrd,REP,460104,7,25,314,346,
Mcintosh,Attorney General,Mike Hunter,REP,460104,6,23,291,320,
Mcintosh,Attorney General,Mark Myles,DEM,460104,5,13,148,166,
Mcintosh,State Treasurer,Randy Mcdaniel,REP,460104,7,23,330,360,
Mcintosh,State Treasurer,Charles De Coune,IND,460104,3,7,92,102,
Mcintosh,Superintendent of Public Instruction,Joy Hofmeister,REP,460104,2,21,250,273,
Mcintosh,Superintendent of Public Instruction,John Cox,DEM,460104,9,13,157,179,
Mcintosh,Superintendent of Public Instruction,Larry Huff,IND,460104,1,1,37,39,
Mcintosh,Commissioner of Labor,Leslie Osborn,REP,460104,6,19,244,269,
Mcintosh,Commissioner of Labor,Fred Dorrell,DEM,460104,6,14,161,181,
Mcintosh,Commissioner of Labor,Brandt Dismukes,IND,460104,0,1,34,35,
Mcintosh,Insurance Commissioner,Glen Mulready,REP,460104,5,21,273,299,
Mcintosh,Insurance Commissioner,Kimberly Fobbs,DEM,460104,7,14,167,188,
Mcintosh,Corporation Commissioner,Bob Anthony,REP,460104,7,20,273,300,
Mcintosh,Corporation Commissioner,Ashley Nicole Mccray,DEM,460104,5,14,151,170,
Mcintosh,Corporation Commissioner,Jackie Short,IND,460104,0,1,16,17,
Mcintosh,U.S. House,Richard Castaldo,LIB,460104,1,0,2,3,2
Mcintosh,U.S. House,Markwayne Mullin,REP,460104,5,23,279,307,2
Mcintosh,U.S. House,Jason Nichols,DEM,460104,5,13,152,170,2
Mcintosh,U.S. House,John Foreman,IND,460104,0,0,12,12,2
Mcintosh,State Senate,Roger Thompson,REP,460104,7,24,283,314,8
Mcintosh,State Senate,Shannan Tucker,DEM,460104,5,10,150,165,8
Mcintosh,State Senate,Marlena Nobles,IND,460104,0,1,10,11,8
Mcintosh,State House,Randy Randleman,REP,460104,7,26,279,312,15
Mcintosh,State House,Judy Ross Moore,DEM,460104,5,9,162,176,15
Mcintosh,Governor,Chris Powell,LIB,460201,0,3,18,21,
Mcintosh,Governor,Kevin Stitt,REP,460201,13,71,391,475,
Mcintosh,Governor,Drew Edmondson,DEM,460201,16,80,348,444,
Mcintosh,Lieutenant Governor,Matt Pinnell,REP,460201,12,83,445,540,
Mcintosh,Lieutenant Governor,Anastasia Pittman,DEM,460201,15,67,280,362,
Mcintosh,Lieutenant Governor,Ivan Holmes,IND,460201,2,2,29,33,
Mcintosh,State Auditor,John Yeutter,LIB,460201,6,36,190,232,
Mcintosh,State Auditor,Cindy Byrd,REP,460201,14,99,527,640,
Mcintosh,Attorney General,Mike Hunter,REP,460201,12,88,469,569,
Mcintosh,Attorney General,Mark Myles,DEM,460201,14,66,283,363,
Mcintosh,State Treasurer,Randy Mcdaniel,REP,460201,13,95,505,613,
Mcintosh,State Treasurer,Charles De Coune,IND,460201,8,43,203,254,
Mcintosh,Superintendent of Public Instruction,Joy Hofmeister,REP,460201,12,87,395,494,
Mcintosh,Superintendent of Public Instruction,John Cox,DEM,460201,13,55,285,353,
Mcintosh,Superintendent of Public Instruction,Larry Huff,IND,460201,3,10,71,84,
Mcintosh,Commissioner of Labor,Leslie Osborn,REP,460201,12,75,412,499,
Mcintosh,Commissioner of Labor,Fred Dorrell,DEM,460201,13,70,291,374,
Mcintosh,Commissioner of Labor,Brandt Dismukes,IND,460201,2,4,48,54,
Mcintosh,Insurance Commissioner,Glen Mulready,REP,460201,13,76,450,539,
Mcintosh,Insurance Commissioner,Kimberly Fobbs,DEM,460201,15,71,304,390,
Mcintosh,Corporation Commissioner,Bob Anthony,REP,460201,13,78,424,515,
Mcintosh,Corporation Commissioner,Ashley Nicole Mccray,DEM,460201,13,67,281,361,
Mcintosh,Corporation Commissioner,Jackie Short,IND,460201,2,6,47,55,
Mcintosh,U.S. House,Richard Castaldo,LIB,460201,0,2,14,16,2
Mcintosh,U.S. House,Markwayne Mullin,REP,460201,15,73,436,524,2
Mcintosh,U.S. House,Jason Nichols,DEM,460201,12,73,283,368,2
Mcintosh,U.S. House,John Foreman,IND,460201,1,4,22,27,2
Mcintosh,State Senate,Roger Thompson,REP,460201,13,74,412,499,8
Mcintosh,State Senate,Shannan Tucker,DEM,460201,14,72,309,395,8
Mcintosh,State Senate,Marlena Nobles,IND,460201,1,5,34,40,8
Mcintosh,State House,David Smith,REP,460201,11,67,365,443,18
Mcintosh,State House,Donnie Condit,DEM,460201,16,85,386,487,18
Mcintosh,Governor,Chris Powell,LIB,460203,0,1,12,13,
Mcintosh,Governor,Kevin Stitt,REP,460203,4,35,113,152,
Mcintosh,Governor,Drew Edmondson,DEM,460203,3,30,177,210,
Mcintosh,Lieutenant Governor,Matt Pinnell,REP,460203,4,39,137,180,
Mcintosh,Lieutenant Governor,Anastasia Pittman,DEM,460203,3,26,142,171,
Mcintosh,Lieutenant Governor,Ivan Holmes,IND,460203,0,1,18,19,
Mcintosh,State Auditor,John Yeutter,LIB,460203,1,15,82,98,
Mcintosh,State Auditor,Cindy Byrd,REP,460203,5,45,184,234,
Mcintosh,Attorney General,Mike Hunter,REP,460203,4,44,155,203,
Mcintosh,Attorney General,Mark Myles,DEM,460203,3,22,143,168,
Mcintosh,State Treasurer,Randy Mcdaniel,REP,460203,4,44,173,221,
Mcintosh,State Treasurer,Charles De Coune,IND,460203,2,16,96,114,
Mcintosh,Superintendent of Public Instruction,Joy Hofmeister,REP,460203,4,36,135,175,
Mcintosh,Superintendent of Public Instruction,John Cox,DEM,460203,2,23,139,164,
Mcintosh,Superintendent of Public Instruction,Larry Huff,IND,460203,1,8,25,34,
Mcintosh,Commissioner of Labor,Leslie Osborn,REP,460203,4,36,131,171,
Mcintosh,Commissioner of Labor,Fred Dorrell,DEM,460203,3,28,146,177,
Mcintosh,Commissioner of Labor,Brandt Dismukes,IND,460203,0,2,16,18,
Mcintosh,Insurance Commissioner,Glen Mulready,REP,460203,4,41,142,187,
Mcintosh,Insurance Commissioner,Kimberly Fobbs,DEM,460203,3,25,153,181,
Mcintosh,Corporation Commissioner,Bob Anthony,REP,460203,4,34,145,183,
Mcintosh,Corporation Commissioner,Ashley Nicole Mccray,DEM,460203,3,31,140,174,
Mcintosh,Corporation Commissioner,Jackie Short,IND,460203,0,2,13,15,
Mcintosh,U.S. House,Richard Castaldo,LIB,460203,0,1,4,5,2
Mcintosh,U.S. House,Markwayne Mullin,REP,460203,5,34,140,179,2
Mcintosh,U.S. House,Jason Nichols,DEM,460203,2,31,151,184,2
Mcintosh,U.S. House,John Foreman,IND,460203,0,0,6,6,2
Mcintosh,State Senate,Roger Thompson,REP,460203,4,35,144,183,8
Mcintosh,State Senate,Shannan Tucker,DEM,460203,3,28,142,173,8
Mcintosh,State Senate,Marlena Nobles,IND,460203,0,2,13,15,8
Mcintosh,State House,Randy Randleman,REP,460203,4,36,149,189,15
Mcintosh,State House,Judy Ross Moore,DEM,460203,3,29,151,183,15
Mcintosh,Governor,Chris Powell,LIB,460205,1,6,28,35,
Mcintosh,Governor,Kevin Stitt,REP,460205,42,98,575,715,
Mcintosh,Governor,Drew Edmondson,DEM,460205,18,38,273,329,
Mcintosh,Lieutenant Governor,Matt Pinnell,REP,460205,43,108,626,777,
Mcintosh,Lieutenant Governor,Anastasia Pittman,DEM,460205,15,30,221,266,
Mcintosh,Lieutenant Governor,Ivan Holmes,IND,460205,2,3,27,32,
Mcintosh,State Auditor,John Yeutter,LIB,460205,14,20,157,191,
Mcintosh,State Auditor,Cindy Byrd,REP,460205,44,112,661,817,
Mcintosh,Attorney General,Mike Hunter,REP,460205,46,110,647,803,
Mcintosh,Attorney General,Mark Myles,DEM,460205,15,31,220,266,
Mcintosh,State Treasurer,Randy Mcdaniel,REP,460205,48,111,667,826,
Mcintosh,State Treasurer,Charles De Coune,IND,460205,10,19,148,177,
Mcintosh,Superintendent of Public Instruction,Joy Hofmeister,REP,460205,36,93,585,714,
Mcintosh,Superintendent of Public Instruction,John Cox,DEM,460205,17,42,204,263,
Mcintosh,Superintendent of Public Instruction,Larry Huff,IND,460205,8,7,80,95,
Mcintosh,Commissioner of Labor,Leslie Osborn,REP,460205,40,108,593,741,
Mcintosh,Commissioner of Labor,Fred Dorrell,DEM,460205,14,31,209,254,
Mcintosh,Commissioner of Labor,Brandt Dismukes,IND,460205,7,2,61,70,
Mcintosh,Insurance Commissioner,Glen Mulready,REP,460205,43,103,626,772,
Mcintosh,Insurance Commissioner,Kimberly Fobbs,DEM,460205,16,37,237,290,
Mcintosh,Corporation Commissioner,Bob Anthony,REP,460205,43,101,577,721,
Mcintosh,Corporation Commissioner,Ashley Nicole Mccray,DEM,460205,15,34,237,286,
Mcintosh,Corporation Commissioner,Jackie Short,IND,460205,2,6,53,61,
Mcintosh,U.S. House,Richard Castaldo,LIB,460205,0,3,17,20,2
Mcintosh,U.S. House,Markwayne Mullin,REP,460205,43,102,630,775,2
Mcintosh,U.S. House,Jason Nichols,DEM,460205,14,32,201,247,2
Mcintosh,U.S. House,John Foreman,IND,460205,3,5,25,33,2
Mcintosh,State Senate,Roger Thompson,REP,460205,43,106,616,765,8
Mcintosh,State Senate,Shannan Tucker,DEM,460205,14,34,216,264,8
Mcintosh,State Senate,Marlena Nobles,IND,460205,3,1,33,37,8
Mcintosh,State House,Randy Randleman,REP,460205,45,102,636,783,15
Mcintosh,State House,Judy Ross Moore,DEM,460205,15,37,231,283,15
Mcintosh,Governor,Chris Powell,LIB,460307,0,1,13,14,
Mcintosh,Governor,Kevin Stitt,REP,460307,3,25,187,215,
Mcintosh,Governor,Drew Edmondson,DEM,460307,1,19,161,181,
Mcintosh,Lieutenant Governor,Matt Pinnell,REP,460307,3,27,209,239,
Mcintosh,Lieutenant Governor,Anastasia Pittman,DEM,460307,1,14,136,151,
Mcintosh,Lieutenant Governor,Ivan Holmes,IND,460307,0,1,14,15,
Mcintosh,State Auditor,John Yeutter,LIB,460307,1,9,73,83,
Mcintosh,State Auditor,Cindy Byrd,REP,460307,3,28,252,283,
Mcintosh,Attorney General,Mike Hunter,REP,460307,3,27,218,248,
Mcintosh,Attorney General,Mark Myles,DEM,460307,1,15,136,152,
Mcintosh,State Treasurer,Randy Mcdaniel,REP,460307,3,28,253,284,
Mcintosh,State Treasurer,Charles De Coune,IND,460307,1,11,75,87,
Mcintosh,Superintendent of Public Instruction,Joy Hofmeister,REP,460307,3,25,173,201,
Mcintosh,Superintendent of Public Instruction,John Cox,DEM,460307,1,17,153,171,
Mcintosh,Superintendent of Public Instruction,Larry Huff,IND,460307,0,2,32,34,
Mcintosh,Commissioner of Labor,Leslie Osborn,REP,460307,3,25,196,224,
Mcintosh,Commissioner of Labor,Fred Dorrell,DEM,460307,1,15,128,144,
Mcintosh,Commissioner of Labor,Brandt Dismukes,IND,460307,0,1,27,28,
Mcintosh,Insurance Commissioner,Glen Mulready,REP,460307,3,26,206,235,
Mcintosh,Insurance Commissioner,Kimberly Fobbs,DEM,460307,1,16,147,164,
Mcintosh,Corporation Commissioner,Bob Anthony,REP,460307,3,23,202,228,
Mcintosh,Corporation Commissioner,Ashley Nicole Mccray,DEM,460307,1,18,136,155,
Mcintosh,Corporation Commissioner,Jackie Short,IND,460307,0,2,12,14,
Mcintosh,U.S. House,Richard Castaldo,LIB,460307,0,1,6,7,2
Mcintosh,U.S. House,Markwayne Mullin,REP,460307,3,27,223,253,2
Mcintosh,U.S. House,Jason Nichols,DEM,460307,1,14,124,139,2
Mcintosh,U.S. House,John Foreman,IND,460307,0,0,7,7,2
Mcintosh,State Senate,Roger Thompson,REP,460307,3,27,203,233,8
Mcintosh,State Senate,Shannan Tucker,DEM,460307,1,14,143,158,8
Mcintosh,State Senate,Marlena Nobles,IND,460307,0,1,11,12,8
Mcintosh,State House,David Smith,REP,460307,3,19,177,199,18
Mcintosh,State House,Donnie Condit,DEM,460307,1,24,180,205,18
Mcintosh,Governor,Chris Powell,LIB,460310,0,0,7,7,
Mcintosh,Governor,Kevin Stitt,REP,460310,2,2,87,91,
Mcintosh,Governor,Drew Edmondson,DEM,460310,2,4,59,65,
Mcintosh,Lieutenant Governor,Matt Pinnell,REP,460310,3,2,89,94,
Mcintosh,Lieutenant Governor,Anastasia Pittman,DEM,460310,1,2,52,55,
Mcintosh,Lieutenant Governor,Ivan Holmes,IND,460310,0,2,9,11,
Mcintosh,State Auditor,John Yeutter,LIB,460310,1,2,34,37,
Mcintosh,State Auditor,Cindy Byrd,REP,460310,2,4,107,113,
Mcintosh,Attorney General,Mike Hunter,REP,460310,2,2,97,101,
Mcintosh,Attorney General,Mark Myles,DEM,460310,2,4,53,59,
Mcintosh,State Treasurer,Randy Mcdaniel,REP,460310,3,4,105,112,
Mcintosh,State Treasurer,Charles De Coune,IND,460310,1,2,35,38,
Mcintosh,Superintendent of Public Instruction,Joy Hofmeister,REP,460310,3,2,75,80,
Mcintosh,Superintendent of Public Instruction,John Cox,DEM,460310,1,3,65,69,
Mcintosh,Superintendent of Public Instruction,Larry Huff,IND,460310,0,1,13,14,
Mcintosh,Commissioner of Labor,Leslie Osborn,REP,460310,3,2,86,91,
Mcintosh,Commissioner of Labor,Fred Dorrell,DEM,460310,1,4,57,62,
Mcintosh,Commissioner of Labor,Brandt Dismukes,IND,460310,0,0,8,8,
Mcintosh,Insurance Commissioner,Glen Mulready,REP,460310,3,2,95,100,
Mcintosh,Insurance Commissioner,Kimberly Fobbs,DEM,460310,1,4,55,60,
Mcintosh,Corporation Commissioner,Bob Anthony,REP,460310,3,3,92,98,
Mcintosh,Corporation Commissioner,Ashley Nicole Mccray,DEM,460310,1,3,52,56,
Mcintosh,Corporation Commissioner,Jackie Short,IND,460310,0,0,7,7,
Mcintosh,U.S. House,Richard Castaldo,LIB,460310,0,1,0,1,2
Mcintosh,U.S. House,Markwayne Mullin,REP,460310,3,2,96,101,2
Mcintosh,U.S. House,Jason Nichols,DEM,460310,1,3,52,56,2
Mcintosh,U.S. House,John Foreman,IND,460310,0,0,5,5,2
Mcintosh,State Senate,Roger Thompson,REP,460310,2,2,91,95,8
Mcintosh,State Senate,Shannan Tucker,DEM,460310,2,4,56,62,8
Mcintosh,State Senate,Marlena Nobles,IND,460310,0,0,6,6,8
Mcintosh,State House,David Smith,REP,460310,2,2,74,78,18
Mcintosh,State House,Donnie Condit,DEM,460310,2,4,78,84,18
Mcintosh,Governor,Chris Powell,LIB,460311,0,2,10,12,
Mcintosh,Governor,Kevin Stitt,REP,460311,1,8,99,108,
Mcintosh,Governor,Drew Edmondson,DEM,460311,4,9,84,97,
Mcintosh,Lieutenant Governor,Matt Pinnell,REP,460311,2,9,115,126,
Mcintosh,Lieutenant Governor,Anastasia Pittman,DEM,460311,3,9,68,80,
Mcintosh,Lieutenant Governor,Ivan Holmes,IND,460311,0,1,6,7,
Mcintosh,State Auditor,John Yeutter,LIB,460311,1,5,28,34,
Mcintosh,State Auditor,Cindy Byrd,REP,460311,4,13,138,155,
Mcintosh,Attorney General,Mike Hunter,REP,460311,1,9,120,130,
Mcintosh,Attorney General,Mark Myles,DEM,460311,4,9,66,79,
Mcintosh,State Treasurer,Randy Mcdaniel,REP,460311,3,13,140,156,
Mcintosh,State Treasurer,Charles De Coune,IND,460311,2,4,29,35,
Mcintosh,Superintendent of Public Instruction,Joy Hofmeister,REP,460311,3,10,81,94,
Mcintosh,Superintendent of Public Instruction,John Cox,DEM,460311,2,9,89,100,
Mcintosh,Superintendent of Public Instruction,Larry Huff,IND,460311,0,0,20,20,
Mcintosh,Commissioner of Labor,Leslie Osborn,REP,460311,2,12,100,114,
Mcintosh,Commissioner of Labor,Fred Dorrell,DEM,460311,3,6,78,87,
Mcintosh,Commissioner of Labor,Brandt Dismukes,IND,460311,0,0,11,11,
Mcintosh,Insurance Commissioner,Glen Mulready,REP,460311,1,9,114,124,
Mcintosh,Insurance Commissioner,Kimberly Fobbs,DEM,460311,4,9,77,90,
Mcintosh,Corporation Commissioner,Bob Anthony,REP,460311,0,10,104,114,
Mcintosh,Corporation Commissioner,Ashley Nicole Mccray,DEM,460311,4,8,78,90,
Mcintosh,Corporation Commissioner,Jackie Short,IND,460311,1,0,8,9,
Mcintosh,U.S. House,Richard Castaldo,LIB,460311,0,0,4,4,2
Mcintosh,U.S. House,Markwayne Mullin,REP,460311,0,10,115,125,2
Mcintosh,U.S. House,Jason Nichols,DEM,460311,4,8,65,77,2
Mcintosh,U.S. House,John Foreman,IND,460311,1,1,6,8,2
Mcintosh,State Senate,Roger Thompson,REP,460311,3,11,112,126,8
Mcintosh,State Senate,Shannan Tucker,DEM,460311,2,8,71,81,8
Mcintosh,State Senate,Marlena Nobles,IND,460311,0,0,5,5,8
Mcintosh,State House,David Smith,REP,460311,1,6,87,94,18
Mcintosh,State House,Donnie Condit,DEM,460311,4,13,103,120,18
Mcintosh,Governor,Chris Powell,LIB,460312,0,0,6,6,
Mcintosh,Governor,Kevin Stitt,REP,460312,0,0,36,36,
Mcintosh,Governor,Drew Edmondson,DEM,460312,0,0,33,33,
Mcintosh,Lieutenant Governor,Matt Pinnell,REP,460312,0,0,44,44,
Mcintosh,Lieutenant Governor,Anastasia Pittman,DEM,460312,0,0,26,26,
Mcintosh,Lieutenant Governor,Ivan Holmes,IND,460312,0,0,5,5,
Mcintosh,State Auditor,John Yeutter,LIB,460312,0,0,20,20,
Mcintosh,State Auditor,Cindy Byrd,REP,460312,0,0,51,51,
Mcintosh,Attorney General,Mike Hunter,REP,460312,0,0,49,49,
Mcintosh,Attorney General,Mark Myles,DEM,460312,0,0,26,26,
Mcintosh,State Treasurer,Randy Mcdaniel,REP,460312,0,0,47,47,
Mcintosh,State Treasurer,Charles De Coune,IND,460312,0,0,25,25,
Mcintosh,Superintendent of Public Instruction,Joy Hofmeister,REP,460312,0,0,33,33,
Mcintosh,Superintendent of Public Instruction,John Cox,DEM,460312,0,0,29,29,
Mcintosh,Superintendent of Public Instruction,Larry Huff,IND,460312,0,0,13,13,
Mcintosh,Commissioner of Labor,Leslie Osborn,REP,460312,0,0,41,41,
Mcintosh,Commissioner of Labor,Fred Dorrell,DEM,460312,0,0,28,28,
Mcintosh,Commissioner of Labor,Brandt Dismukes,IND,460312,0,0,6,6,
Mcintosh,Insurance Commissioner,Glen Mulready,REP,460312,0,0,45,45,
Mcintosh,Insurance Commissioner,Kimberly Fobbs,DEM,460312,0,0,30,30,
Mcintosh,Corporation Commissioner,Bob Anthony,REP,460312,0,0,37,37,
Mcintosh,Corporation Commissioner,Ashley Nicole Mccray,DEM,460312,0,0,30,30,
Mcintosh,Corporation Commissioner,Jackie Short,IND,460312,0,0,7,7,
Mcintosh,U.S. House,Richard Castaldo,LIB,460312,0,0,4,4,2
Mcintosh,U.S. House,Markwayne Mullin,REP,460312,0,0,42,42,2
Mcintosh,U.S. House,Jason Nichols,DEM,460312,0,0,28,28,2
Mcintosh,U.S. House,John Foreman,IND,460312,0,0,1,1,2
Mcintosh,State Senate,Roger Thompson,REP,460312,0,0,41,41,8
Mcintosh,State Senate,Shannan Tucker,DEM,460312,0,0,27,27,8
Mcintosh,State Senate,Marlena Nobles,IND,460312,0,0,7,7,8
Mcintosh,State House,David Smith,REP,460312,0,0,39,39,18
Mcintosh,State House,Donnie Condit,DEM,460312,0,0,36,36,18
Mcintosh,Governor,Chris Powell,LIB,460313,0,0,3,3,
Mcintosh,Governor,Kevin Stitt,REP,460313,3,0,56,59,
Mcintosh,Governor,Drew Edmondson,DEM,460313,1,1,30,32,
Mcintosh,Lieutenant Governor,Matt Pinnell,REP,460313,3,0,59,62,
Mcintosh,Lieutenant Governor,Anastasia Pittman,DEM,460313,1,1,29,31,
Mcintosh,Lieutenant Governor,Ivan Holmes,IND,460313,0,0,1,1,
Mcintosh,State Auditor,John Yeutter,LIB,460313,0,1,12,13,
Mcintosh,State Auditor,Cindy Byrd,REP,460313,4,0,64,68,
Mcintosh,Attorney General,Mike Hunter,REP,460313,3,0,60,63,
Mcintosh,Attorney General,Mark Myles,DEM,460313,1,1,29,31,
Mcintosh,State Treasurer,Randy Mcdaniel,REP,460313,4,0,60,64,
Mcintosh,State Treasurer,Charles De Coune,IND,460313,0,1,15,16,
Mcintosh,Superintendent of Public Instruction,Joy Hofmeister,REP,460313,3,0,54,57,
Mcintosh,Superintendent of Public Instruction,John Cox,DEM,460313,1,1,29,31,
Mcintosh,Superintendent of Public Instruction,Larry Huff,IND,460313,0,0,5,5,
Mcintosh,Commissioner of Labor,Leslie Osborn,REP,460313,3,0,56,59,
Mcintosh,Commissioner of Labor,Fred Dorrell,DEM,460313,1,1,29,31,
Mcintosh,Commissioner of Labor,Brandt Dismukes,IND,460313,0,0,3,3,
Mcintosh,Insurance Commissioner,Glen Mulready,REP,460313,3,0,62,65,
Mcintosh,Insurance Commissioner,Kimberly Fobbs,DEM,460313,1,1,26,28,
Mcintosh,Corporation Commissioner,Bob Anthony,REP,460313,3,0,59,62,
Mcintosh,Corporation Commissioner,Ashley Nicole Mccray,DEM,460313,1,1,26,28,
Mcintosh,Corporation Commissioner,Jackie Short,IND,460313,0,0,3,3,
Mcintosh,U.S. House,Richard Castaldo,LIB,460313,0,0,0,0,2
Mcintosh,U.S. House,Markwayne Mullin,REP,460313,4,0,59,63,2
Mcintosh,U.S. House,Jason Nichols,DEM,460313,0,1,27,28,2
Mcintosh,U.S. House,John Foreman,IND,460313,0,0,3,3,2
Mcintosh,State Senate,Roger Thompson,REP,460313,4,0,60,64,8
Mcintosh,State Senate,Shannan Tucker,DEM,460313,0,1,27,28,8
Mcintosh,State Senate,Marlena Nobles,IND,460313,0,0,1,1,8
Mcintosh,State House,David Smith,REP,460313,4,0,54,58,18
Mcintosh,State House,Donnie Condit,DEM,460313,0,1,34,35,18
Mcintosh,Governor,Chris Powell,LIB,460314,0,4,19,23,
Mcintosh,Governor,Kevin Stitt,REP,460314,17,40,313,370,
Mcintosh,Governor,Drew Edmondson,DEM,460314,12,20,222,254,
Mcintosh,Lieutenant Governor,Matt Pinnell,REP,460314,18,39,357,414,
Mcintosh,Lieutenant Governor,Anastasia Pittman,DEM,460314,11,20,184,215,
Mcintosh,Lieutenant Governor,Ivan Holmes,IND,460314,0,5,11,16,
Mcintosh,State Auditor,John Yeutter,LIB,460314,7,13,125,145,
Mcintosh,State Auditor,Cindy Byrd,REP,460314,22,47,379,448,
Mcintosh,Attorney General,Mike Hunter,REP,460314,17,42,350,409,
Mcintosh,Attorney General,Mark Myles,DEM,460314,12,22,199,233,
Mcintosh,State Treasurer,Randy Mcdaniel,REP,460314,19,44,372,435,
Mcintosh,State Treasurer,Charles De Coune,IND,460314,10,16,130,156,
Mcintosh,Superintendent of Public Instruction,Joy Hofmeister,REP,460314,21,37,307,365,
Mcintosh,Superintendent of Public Instruction,John Cox,DEM,460314,8,19,194,221,
Mcintosh,Superintendent of Public Instruction,Larry Huff,IND,460314,0,8,50,58,
Mcintosh,Commissioner of Labor,Leslie Osborn,REP,460314,17,39,326,382,
Mcintosh,Commissioner of Labor,Fred Dorrell,DEM,460314,10,21,184,215,
Mcintosh,Commissioner of Labor,Brandt Dismukes,IND,460314,1,4,41,46,
Mcintosh,Insurance Commissioner,Glen Mulready,REP,460314,18,43,340,401,
Mcintosh,Insurance Commissioner,Kimberly Fobbs,DEM,460314,11,21,207,239,
Mcintosh,Corporation Commissioner,Bob Anthony,REP,460314,19,39,332,390,
Mcintosh,Corporation Commissioner,Ashley Nicole Mccray,DEM,460314,8,20,186,214,
Mcintosh,Corporation Commissioner,Jackie Short,IND,460314,2,5,32,39,
Mcintosh,U.S. House,Richard Castaldo,LIB,460314,0,0,4,4,2
Mcintosh,U.S. House,Markwayne Mullin,REP,460314,18,45,350,413,2
Mcintosh,U.S. House,Jason Nichols,DEM,460314,11,18,183,212,2
Mcintosh,U.S. House,John Foreman,IND,460314,0,1,15,16,2
Mcintosh,State Senate,Roger Thompson,REP,460314,17,46,344,407,8
Mcintosh,State Senate,Shannan Tucker,DEM,460314,9,16,184,209,8
Mcintosh,State Senate,Marlena Nobles,IND,460314,3,2,19,24,8
Mcintosh,State House,David Smith,REP,460314,17,37,310,364,18
Mcintosh,State House,Donnie Condit,DEM,460314,12,27,236,275,18
Mcintosh,Governor,Chris Powell,LIB,460315,0,0,7,7,
Mcintosh,Governor,Kevin Stitt,REP,460315,1,3,103,107,
Mcintosh,Governor,Drew Edmondson,DEM,460315,4,0,73,77,
Mcintosh,Lieutenant Governor,Matt Pinnell,REP,460315,1,3,108,112,
Mcintosh,Lieutenant Governor,Anastasia Pittman,DEM,460315,4,0,64,68,
Mcintosh,Lieutenant Governor,Ivan Holmes,IND,460315,0,0,6,6,
Mcintosh,State Auditor,John Yeutter,LIB,460315,2,0,35,37,
Mcintosh,State Auditor,Cindy Byrd,REP,460315,3,3,127,133,
Mcintosh,Attorney General,Mike Hunter,REP,460315,1,3,117,121,
Mcintosh,Attorney General,Mark Myles,DEM,460315,4,0,62,66,
Mcintosh,State Treasurer,Randy Mcdaniel,REP,460315,2,3,123,128,
Mcintosh,State Treasurer,Charles De Coune,IND,460315,2,0,39,41,
Mcintosh,Superintendent of Public Instruction,Joy Hofmeister,REP,460315,4,3,95,102,
Mcintosh,Superintendent of Public Instruction,John Cox,DEM,460315,0,0,74,74,
Mcintosh,Superintendent of Public Instruction,Larry Huff,IND,460315,1,0,12,13,
Mcintosh,Commissioner of Labor,Leslie Osborn,REP,460315,1,3,101,105,
Mcintosh,Commissioner of Labor,Fred Dorrell,DEM,460315,4,0,68,72,
Mcintosh,Commissioner of Labor,Brandt Dismukes,IND,460315,0,0,7,7,
Mcintosh,Insurance Commissioner,Glen Mulready,REP,460315,1,3,111,115,
Mcintosh,Insurance Commissioner,Kimberly Fobbs,DEM,460315,4,0,67,71,
Mcintosh,Corporation Commissioner,Bob Anthony,REP,460315,1,3,106,110,
Mcintosh,Corporation Commissioner,Ashley Nicole Mccray,DEM,460315,4,0,64,68,
Mcintosh,Corporation Commissioner,Jackie Short,IND,460315,0,0,7,7,
Mcintosh,U.S. House,Richard Castaldo,LIB,460315,0,0,0,0,2
Mcintosh,U.S. House,Markwayne Mullin,REP,460315,3,3,119,125,2
Mcintosh,U.S. House,Jason Nichols,DEM,460315,2,0,56,58,2
Mcintosh,U.S. House,John Foreman,IND,460315,0,0,5,5,2
Mcintosh,State Senate,Roger Thompson,REP,460315,3,3,113,119,8
Mcintosh,State Senate,Shannan Tucker,DEM,460315,2,0,63,65,8
Mcintosh,State Senate,Marlena Nobles,IND,460315,0,0,5,5,8
Mcintosh,State House,David Smith,REP,460315,0,3,97,100,18
Mcintosh,State House,Donnie Condit,DEM,460315,5,0,81,86,18
Mcintosh,Governor,Chris Powell,LIB,460316,1,2,10,13,
Mcintosh,Governor,Kevin Stitt,REP,460316,8,15,180,203,
Mcintosh,Governor,Drew Edmondson,DEM,460316,3,1,113,117,
Mcintosh,Lieutenant Governor,Matt Pinnell,REP,460316,9,17,198,224,
Mcintosh,Lieutenant Governor,Anastasia Pittman,DEM,460316,2,1,95,98,
Mcintosh,Lieutenant Governor,Ivan Holmes,IND,460316,1,0,8,9,
Mcintosh,State Auditor,John Yeutter,LIB,460316,3,2,61,66,
Mcintosh,State Auditor,Cindy Byrd,REP,460316,9,16,211,236,
Mcintosh,Attorney General,Mike Hunter,REP,460316,6,17,202,225,
Mcintosh,Attorney General,Mark Myles,DEM,460316,6,1,94,101,
Mcintosh,State Treasurer,Randy Mcdaniel,REP,460316,7,16,215,238,
Mcintosh,State Treasurer,Charles De Coune,IND,460316,4,2,59,65,
Mcintosh,Superintendent of Public Instruction,Joy Hofmeister,REP,460316,7,11,162,180,
Mcintosh,Superintendent of Public Instruction,John Cox,DEM,460316,3,4,116,123,
Mcintosh,Superintendent of Public Instruction,Larry Huff,IND,460316,2,2,23,27,
Mcintosh,Commissioner of Labor,Leslie Osborn,REP,460316,6,15,184,205,
Mcintosh,Commissioner of Labor,Fred Dorrell,DEM,460316,5,1,91,97,
Mcintosh,Commissioner of Labor,Brandt Dismukes,IND,460316,1,1,21,23,
Mcintosh,Insurance Commissioner,Glen Mulready,REP,460316,6,16,197,219,
Mcintosh,Insurance Commissioner,Kimberly Fobbs,DEM,460316,6,2,97,105,
Mcintosh,Corporation Commissioner,Bob Anthony,REP,460316,7,15,192,214,
Mcintosh,Corporation Commissioner,Ashley Nicole Mccray,DEM,460316,3,1,92,96,
Mcintosh,Corporation Commissioner,Jackie Short,IND,460316,2,2,11,15,
Mcintosh,U.S. House,Richard Castaldo,LIB,460316,0,1,6,7,2
Mcintosh,U.S. House,Markwayne Mullin,REP,460316,8,14,194,216,2
Mcintosh,U.S. House,Jason Nichols,DEM,460316,4,2,93,99,2
Mcintosh,U.S. House,John Foreman,IND,460316,0,1,5,6,2
Mcintosh,State Senate,Roger Thompson,REP,460316,8,16,194,218,8
Mcintosh,State Senate,Shannan Tucker,DEM,460316,3,2,99,104,8
Mcintosh,State Senate,Marlena Nobles,IND,460316,1,0,6,7,8
Mcintosh,State House,Avery Carl Frix,REP,460316,8,15,222,245,13
Mcintosh,State House,Jolene Armstrong,DEM,460316,4,3,77,84,13
Major,Governor,Chris Powell,LIB,470002,0,0,14,14,
Major,Governor,Kevin Stitt,REP,470002,17,31,494,542,
Major,Governor,Drew Edmondson,DEM,470002,4,11,76,91,
Major,Lieutenant Governor,Matt Pinnell,REP,470002,19,31,517,567,
Major,Lieutenant Governor,Anastasia Pittman,DEM,470002,2,10,53,65,
Major,Lieutenant Governor,Ivan Holmes,IND,470002,0,2,12,14,
Major,State Auditor,John Yeutter,LIB,470002,1,4,47,52,
Major,State Auditor,Cindy Byrd,REP,470002,19,35,530,584,
Major,Attorney General,Mike Hunter,REP,470002,18,29,516,563,
Major,Attorney General,Mark Myles,DEM,470002,3,13,64,80,
Major,State Treasurer,Randy Mcdaniel,REP,470002,20,33,520,573,
Major,State Treasurer,Charles De Coune,IND,470002,0,6,52,58,
Major,Superintendent of Public Instruction,Joy Hofmeister,REP,470002,18,30,484,532,
Major,Superintendent of Public Instruction,John Cox,DEM,470002,3,11,58,72,
Major,Superintendent of Public Instruction,Larry Huff,IND,470002,0,2,35,37,
Major,Commissioner of Labor,Leslie Osborn,REP,470002,20,28,496,544,
Major,Commissioner of Labor,Fred Dorrell,DEM,470002,1,13,62,76,
Major,Commissioner of Labor,Brandt Dismukes,IND,470002,0,2,22,24,
Major,Insurance Commissioner,Glen Mulready,REP,470002,19,32,496,547,
Major,Insurance Commissioner,Kimberly Fobbs,DEM,470002,2,10,82,94,
Major,Corporation Commissioner,Bob Anthony,REP,470002,19,32,473,524,
Major,Corporation Commissioner,Ashley Nicole Mccray,DEM,470002,2,10,72,84,
Major,Corporation Commissioner,Jackie Short,IND,470002,0,1,37,38,
Major,U.S. House,Frank Lucas,REP,470002,18,30,518,566,3
Major,U.S. House,Frankie Robbins,DEM,470002,3,12,66,81,3
Major,Governor,Chris Powell,LIB,470004,0,0,4,4,
Major,Governor,Kevin Stitt,REP,470004,2,8,104,114,
Major,Governor,Drew Edmondson,DEM,470004,0,2,23,25,
Major,Lieutenant Governor,Matt Pinnell,REP,470004,2,8,104,114,
Major,Lieutenant Governor,Anastasia Pittman,DEM,470004,0,2,19,21,
Major,Lieutenant Governor,Ivan Holmes,IND,470004,0,0,6,6,
Major,State Auditor,John Yeutter,LIB,470004,0,1,19,20,
Major,State Auditor,Cindy Byrd,REP,470004,2,9,107,118,
Major,Attorney General,Mike Hunter,REP,470004,2,7,108,117,
Major,Attorney General,Mark Myles,DEM,470004,0,3,21,24,
Major,State Treasurer,Randy Mcdaniel,REP,470004,2,9,113,124,
Major,State Treasurer,Charles De Coune,IND,470004,0,1,14,15,
Major,Superintendent of Public Instruction,Joy Hofmeister,REP,470004,2,8,95,105,
Major,Superintendent of Public Instruction,John Cox,DEM,470004,0,2,18,20,
Major,Superintendent of Public Instruction,Larry Huff,IND,470004,0,0,15,15,
Major,Commissioner of Labor,Leslie Osborn,REP,470004,2,8,108,118,
Major,Commissioner of Labor,Fred Dorrell,DEM,470004,0,2,14,16,
Major,Commissioner of Labor,Brandt Dismukes,IND,470004,0,0,7,7,
Major,Insurance Commissioner,Glen Mulready,REP,470004,2,8,106,116,
Major,Insurance Commissioner,Kimberly Fobbs,DEM,470004,0,2,22,24,
Major,Corporation Commissioner,Bob Anthony,REP,470004,2,7,103,112,
Major,Corporation Commissioner,Ashley Nicole Mccray,DEM,470004,0,3,18,21,
Major,Corporation Commissioner,Jackie Short,IND,470004,0,0,7,7,
Major,U.S. House,Frank Lucas,REP,470004,2,8,116,126,3
Major,U.S. House,Frankie Robbins,DEM,470004,0,2,14,16,3
Major,Governor,Chris Powell,LIB,470009,0,0,2,2,
Major,Governor,Kevin Stitt,REP,470009,2,2,39,43,
Major,Governor,Drew Edmondson,DEM,470009,0,2,4,6,
Major,Lieutenant Governor,Matt Pinnell,REP,470009,3,3,40,46,
Major,Lieutenant Governor,Anastasia Pittman,DEM,470009,0,1,3,4,
Major,Lieutenant Governor,Ivan Holmes,IND,470009,0,0,2,2,
Major,State Auditor,John Yeutter,LIB,470009,0,1,3,4,
Major,State Auditor,Cindy Byrd,REP,470009,3,3,41,47,
Major,Attorney General,Mike Hunter,REP,470009,3,3,41,47,
Major,Attorney General,Mark Myles,DEM,470009,0,1,4,5,
Major,State Treasurer,Randy Mcdaniel,REP,470009,3,2,42,47,
Major,State Treasurer,Charles De Coune,IND,470009,0,2,2,4,
Major,Superintendent of Public Instruction,Joy Hofmeister,REP,470009,3,3,36,42,
Major,Superintendent of Public Instruction,John Cox,DEM,470009,0,1,7,8,
Major,Superintendent of Public Instruction,Larry Huff,IND,470009,0,0,2,2,
Major,Commissioner of Labor,Leslie Osborn,REP,470009,3,3,36,42,
Major,Commissioner of Labor,Fred Dorrell,DEM,470009,0,1,5,6,
Major,Commissioner of Labor,Brandt Dismukes,IND,470009,0,0,4,4,
Major,Insurance Commissioner,Glen Mulready,REP,470009,2,3,42,47,
Major,Insurance Commissioner,Kimberly Fobbs,DEM,470009,0,1,3,4,
Major,Corporation Commissioner,Bob Anthony,REP,470009,3,3,39,45,
Major,Corporation Commissioner,Ashley Nicole Mccray,DEM,470009,0,1,5,6,
Major,Corporation Commissioner,Jackie Short,IND,470009,0,0,1,1,
Major,U.S. House,Frank Lucas,REP,470009,3,3,42,48,3
Major,U.S. House,Frankie Robbins,DEM,470009,0,1,3,4,3
Major,Governor,Chris Powell,LIB,470010,1,0,6,7,
Major,Governor,Kevin Stitt,REP,470010,6,6,165,177,
Major,Governor,Drew Edmondson,DEM,470010,0,1,15,16,
Major,Lieutenant Governor,Matt Pinnell,REP,470010,7,7,172,186,
Major,Lieutenant Governor,Anastasia Pittman,DEM,470010,0,0,10,10,
Major,Lieutenant Governor,Ivan Holmes,IND,470010,0,0,4,4,
Major,State Auditor,John Yeutter,LIB,470010,0,0,18,18,
Major,State Auditor,Cindy Byrd,REP,470010,7,7,167,181,
Major,Attorney General,Mike Hunter,REP,470010,7,7,172,186,
Major,Attorney General,Mark Myles,DEM,470010,0,0,12,12,
Major,State Treasurer,Randy Mcdaniel,REP,470010,7,7,178,192,
Major,State Treasurer,Charles De Coune,IND,470010,0,0,8,8,
Major,Superintendent of Public Instruction,Joy Hofmeister,REP,470010,6,7,124,137,
Major,Superintendent of Public Instruction,John Cox,DEM,470010,0,0,42,42,
Major,Superintendent of Public Instruction,Larry Huff,IND,470010,1,0,16,17,
Major,Commissioner of Labor,Leslie Osborn,REP,470010,7,7,168,182,
Major,Commissioner of Labor,Fred Dorrell,DEM,470010,0,0,9,9,
Major,Commissioner of Labor,Brandt Dismukes,IND,470010,0,0,7,7,
Major,Insurance Commissioner,Glen Mulready,REP,470010,7,6,173,186,
Major,Insurance Commissioner,Kimberly Fobbs,DEM,470010,0,1,12,13,
Major,Corporation Commissioner,Bob Anthony,REP,470010,6,7,149,162,
Major,Corporation Commissioner,Ashley Nicole Mccray,DEM,470010,0,0,20,20,
Major,Corporation Commissioner,Jackie Short,IND,470010,1,0,16,17,
Major,U.S. House,Frank Lucas,REP,470010,7,7,169,183,3
Major,U.S. House,Frankie Robbins,DEM,470010,0,0,14,14,3
Major,Governor,Chris Powell,LIB,470015,0,0,6,6,
Major,Governor,Kevin Stitt,REP,470015,0,8,147,155,
Major,Governor,Drew Edmondson,DEM,470015,0,2,31,33,
Major,Lieutenant Governor,Matt Pinnell,REP,470015,0,10,168,178,
Major,Lieutenant Governor,Anastasia Pittman,DEM,470015,0,0,14,14,
Major,Lieutenant Governor,Ivan Holmes,IND,470015,0,0,3,3,
Major,State Auditor,John Yeutter,LIB,470015,0,1,11,12,
Major,State Auditor,Cindy Byrd,REP,470015,0,9,167,176,
Major,Attorney General,Mike Hunter,REP,470015,0,10,162,172,
Major,Attorney General,Mark Myles,DEM,470015,0,0,22,22,
Major,State Treasurer,Randy Mcdaniel,REP,470015,0,9,164,173,
Major,State Treasurer,Charles De Coune,IND,470015,0,1,18,19,
Major,Superintendent of Public Instruction,Joy Hofmeister,REP,470015,0,8,156,164,
Major,Superintendent of Public Instruction,John Cox,DEM,470015,0,2,19,21,
Major,Superintendent of Public Instruction,Larry Huff,IND,470015,0,0,10,10,
Major,Commissioner of Labor,Leslie Osborn,REP,470015,0,9,162,171,
Major,Commissioner of Labor,Fred Dorrell,DEM,470015,0,0,19,19,
Major,Commissioner of Labor,Brandt Dismukes,IND,470015,0,0,3,3,
Major,Insurance Commissioner,Glen Mulready,REP,470015,0,10,163,173,
Major,Insurance Commissioner,Kimberly Fobbs,DEM,470015,0,0,19,19,
Major,Corporation Commissioner,Bob Anthony,REP,470015,0,10,152,162,
Major,Corporation Commissioner,Ashley Nicole Mccray,DEM,470015,0,0,22,22,
Major,Corporation Commissioner,Jackie Short,IND,470015,0,0,10,10,
Major,U.S. House,Frank Lucas,REP,470015,0,10,166,176,3
Major,U.S. House,Frankie Robbins,DEM,470015,0,0,16,16,3
Major,Governor,Chris Powell,LIB,470016,0,0,1,1,
Major,Governor,Kevin Stitt,REP,470016,3,2,61,66,
Major,Governor,Drew Edmondson,DEM,470016,0,0,8,8,
Major,Lieutenant Governor,Matt Pinnell,REP,470016,3,2,60,65,
Major,Lieutenant Governor,Anastasia Pittman,DEM,470016,0,0,9,9,
Major,Lieutenant Governor,Ivan Holmes,IND,470016,0,0,1,1,
Major,State Auditor,John Yeutter,LIB,470016,0,0,4,4,
Major,State Auditor,Cindy Byrd,REP,470016,3,2,65,70,
Major,Attorney General,Mike Hunter,REP,470016,3,2,60,65,
Major,Attorney General,Mark Myles,DEM,470016,0,0,9,9,
Major,State Treasurer,Randy Mcdaniel,REP,470016,3,2,64,69,
Major,State Treasurer,Charles De Coune,IND,470016,0,0,5,5,
Major,Superintendent of Public Instruction,Joy Hofmeister,REP,470016,3,1,57,61,
Major,Superintendent of Public Instruction,John Cox,DEM,470016,0,1,8,9,
Major,Superintendent of Public Instruction,Larry Huff,IND,470016,0,0,5,5,
Major,Commissioner of Labor,Leslie Osborn,REP,470016,3,1,60,64,
Major,Commissioner of Labor,Fred Dorrell,DEM,470016,0,1,8,9,
Major,Commissioner of Labor,Brandt Dismukes,IND,470016,0,0,2,2,
Major,Insurance Commissioner,Glen Mulready,REP,470016,3,1,62,66,
Major,Insurance Commissioner,Kimberly Fobbs,DEM,470016,0,1,8,9,
Major,Corporation Commissioner,Bob Anthony,REP,470016,3,1,55,59,
Major,Corporation Commissioner,Ashley Nicole Mccray,DEM,470016,0,1,12,13,
Major,Corporation Commissioner,Jackie Short,IND,470016,0,0,3,3,
Major,U.S. House,Frank Lucas,REP,470016,3,1,59,63,3
Major,U.S. House,Frankie Robbins,DEM,470016,0,0,11,11,3
Major,Governor,Chris Powell,LIB,470020,3,1,28,32,
Major,Governor,Kevin Stitt,REP,470020,21,69,506,596,
Major,Governor,Drew Edmondson,DEM,470020,19,25,126,170,
Major,Lieutenant Governor,Matt Pinnell,REP,470020,33,75,559,667,
Major,Lieutenant Governor,Anastasia Pittman,DEM,470020,9,20,74,103,
Major,Lieutenant Governor,Ivan Holmes,IND,470020,2,0,19,21,
Major,State Auditor,John Yeutter,LIB,470020,11,8,77,96,
Major,State Auditor,Cindy Byrd,REP,470020,32,83,562,677,
Major,Attorney General,Mike Hunter,REP,470020,31,75,561,667,
Major,Attorney General,Mark Myles,DEM,470020,12,19,95,126,
Major,State Treasurer,Randy Mcdaniel,REP,470020,35,78,569,682,
Major,State Treasurer,Charles De Coune,IND,470020,8,13,69,90,
Major,Superintendent of Public Instruction,Joy Hofmeister,REP,470020,26,73,524,623,
Major,Superintendent of Public Instruction,John Cox,DEM,470020,15,14,83,112,
Major,Superintendent of Public Instruction,Larry Huff,IND,470020,3,6,44,53,
Major,Commissioner of Labor,Leslie Osborn,REP,470020,32,74,540,646,
Major,Commissioner of Labor,Fred Dorrell,DEM,470020,9,17,75,101,
Major,Commissioner of Labor,Brandt Dismukes,IND,470020,1,3,34,38,
Major,Insurance Commissioner,Glen Mulready,REP,470020,26,72,540,638,
Major,Insurance Commissioner,Kimberly Fobbs,DEM,470020,16,22,105,143,
Major,Corporation Commissioner,Bob Anthony,REP,470020,26,70,518,614,
Major,Corporation Commissioner,Ashley Nicole Mccray,DEM,470020,15,20,95,130,
Major,Corporation Commissioner,Jackie Short,IND,470020,2,4,38,44,
Major,U.S. House,Frank Lucas,REP,470020,32,80,564,676,3
Major,U.S. House,Frankie Robbins,DEM,470020,11,14,93,118,3
Major,Governor,Chris Powell,LIB,470022,0,7,26,33,
Major,Governor,Kevin Stitt,REP,470022,19,90,375,484,
Major,Governor,Drew Edmondson,DEM,470022,7,36,78,121,
Major,Lieutenant Governor,Matt Pinnell,REP,470022,20,99,396,515,
Major,Lieutenant Governor,Anastasia Pittman,DEM,470022,6,25,61,92,
Major,Lieutenant Governor,Ivan Holmes,IND,470022,0,8,18,26,
Major,State Auditor,John Yeutter,LIB,470022,3,19,53,75,
Major,State Auditor,Cindy Byrd,REP,470022,23,106,415,544,
Major,Attorney General,Mike Hunter,REP,470022,21,109,417,547,
Major,Attorney General,Mark Myles,DEM,470022,5,23,56,84,
Major,State Treasurer,Randy Mcdaniel,REP,470022,23,106,406,535,
Major,State Treasurer,Charles De Coune,IND,470022,3,19,60,82,
Major,Superintendent of Public Instruction,Joy Hofmeister,REP,470022,20,103,370,493,
Major,Superintendent of Public Instruction,John Cox,DEM,470022,5,17,61,83,
Major,Superintendent of Public Instruction,Larry Huff,IND,470022,1,11,46,58,
Major,Commissioner of Labor,Leslie Osborn,REP,470022,21,98,388,507,
Major,Commissioner of Labor,Fred Dorrell,DEM,470022,3,25,55,83,
Major,Commissioner of Labor,Brandt Dismukes,IND,470022,2,9,28,39,
Major,Insurance Commissioner,Glen Mulready,REP,470022,20,107,397,524,
Major,Insurance Commissioner,Kimberly Fobbs,DEM,470022,6,25,74,105,
Major,Corporation Commissioner,Bob Anthony,REP,470022,19,105,383,507,
Major,Corporation Commissioner,Ashley Nicole Mccray,DEM,470022,4,22,53,79,
Major,Corporation Commissioner,Jackie Short,IND,470022,3,5,33,41,
Major,U.S. House,Frank Lucas,REP,470022,23,112,417,552,3
Major,U.S. House,Frankie Robbins,DEM,470022,3,20,56,79,3
Marshall,Governor,Chris Powell,LIB,480101,1,3,13,17,
Marshall,Governor,Kevin Stitt,REP,480101,5,54,297,356,
Marshall,Governor,Drew Edmondson,DEM,480101,9,28,150,187,
Marshall,Lieutenant Governor,Matt Pinnell,REP,480101,6,64,329,399,
Marshall,Lieutenant Governor,Anastasia Pittman,DEM,480101,8,20,108,136,
Marshall,Lieutenant Governor,Ivan Holmes,IND,480101,1,0,19,20,
Marshall,State Auditor,John Yeutter,LIB,480101,3,6,79,88,
Marshall,State Auditor,Cindy Byrd,REP,480101,10,72,355,437,
Marshall,Attorney General,Mike Hunter,REP,480101,7,60,326,393,
Marshall,Attorney General,Mark Myles,DEM,480101,8,23,127,158,
Marshall,State Treasurer,Randy Mcdaniel,REP,480101,6,66,363,435,
Marshall,State Treasurer,Charles De Coune,IND,480101,7,12,75,94,
Marshall,Superintendent of Public Instruction,Joy Hofmeister,REP,480101,6,58,307,371,
Marshall,Superintendent of Public Instruction,John Cox,DEM,480101,8,24,124,156,
Marshall,Superintendent of Public Instruction,Larry Huff,IND,480101,1,1,29,31,
Marshall,Commissioner of Labor,Leslie Osborn,REP,480101,6,62,323,391,
Marshall,Commissioner of Labor,Fred Dorrell,DEM,480101,8,21,113,142,
Marshall,Commissioner of Labor,Brandt Dismukes,IND,480101,1,0,20,21,
Marshall,Insurance Commissioner,Glen Mulready,REP,480101,7,61,323,391,
Marshall,Insurance Commissioner,Kimberly Fobbs,DEM,480101,8,22,132,162,
Marshall,Corporation Commissioner,Bob Anthony,REP,480101,6,59,310,375,
Marshall,Corporation Commissioner,Ashley Nicole Mccray,DEM,480101,8,24,126,158,
Marshall,Corporation Commissioner,Jackie Short,IND,480101,1,0,21,22,
Marshall,U.S. House,Richard Castaldo,LIB,480101,1,2,11,14,2
Marshall,U.S. House,Markwayne Mullin,REP,480101,6,62,330,398,2
Marshall,U.S. House,Jason Nichols,DEM,480101,8,20,108,136,2
Marshall,U.S. House,John Foreman,IND,480101,0,0,9,9,2
Marshall,State Senate,David Bullard,REP,480101,7,60,323,390,6
Marshall,State Senate,Arnold Bourne,DEM,480101,8,22,133,163,6
Marshall,State House,Tommy Hardin,REP,480101,6,55,303,364,49
Marshall,State House,Miranda Shelton,DEM,480101,9,29,157,195,49
Marshall,Governor,Chris Powell,LIB,480102,0,1,8,9,
Marshall,Governor,Kevin Stitt,REP,480102,3,25,143,171,
Marshall,Governor,Drew Edmondson,DEM,480102,3,12,101,116,
Marshall,Lieutenant Governor,Matt Pinnell,REP,480102,4,27,162,193,
Marshall,Lieutenant Governor,Anastasia Pittman,DEM,480102,2,10,83,95,
Marshall,Lieutenant Governor,Ivan Holmes,IND,480102,0,1,5,6,
Marshall,State Auditor,John Yeutter,LIB,480102,0,8,54,62,
Marshall,State Auditor,Cindy Byrd,REP,480102,5,28,180,213,
Marshall,Attorney General,Mike Hunter,REP,480102,4,24,160,188,
Marshall,Attorney General,Mark Myles,DEM,480102,1,13,91,105,
Marshall,State Treasurer,Randy Mcdaniel,REP,480102,5,29,177,211,
Marshall,State Treasurer,Charles De Coune,IND,480102,1,7,56,64,
Marshall,Superintendent of Public Instruction,Joy Hofmeister,REP,480102,3,25,143,171,
Marshall,Superintendent of Public Instruction,John Cox,DEM,480102,2,11,86,99,
Marshall,Superintendent of Public Instruction,Larry Huff,IND,480102,0,2,21,23,
Marshall,Commissioner of Labor,Leslie Osborn,REP,480102,4,26,156,186,
Marshall,Commissioner of Labor,Fred Dorrell,DEM,480102,1,10,77,88,
Marshall,Commissioner of Labor,Brandt Dismukes,IND,480102,0,1,13,14,
Marshall,Insurance Commissioner,Glen Mulready,REP,480102,4,26,153,183,
Marshall,Insurance Commissioner,Kimberly Fobbs,DEM,480102,1,12,93,106,
Marshall,Corporation Commissioner,Bob Anthony,REP,480102,3,25,144,172,
Marshall,Corporation Commissioner,Ashley Nicole Mccray,DEM,480102,1,10,88,99,
Marshall,Corporation Commissioner,Jackie Short,IND,480102,0,2,16,18,
Marshall,U.S. House,Richard Castaldo,LIB,480102,0,0,5,5,2
Marshall,U.S. House,Markwayne Mullin,REP,480102,5,28,154,187,2
Marshall,U.S. House,Jason Nichols,DEM,480102,1,9,80,90,2
Marshall,U.S. House,John Foreman,IND,480102,0,1,12,13,2
Marshall,State Senate,David Bullard,REP,480102,3,26,157,186,6
Marshall,State Senate,Arnold Bourne,DEM,480102,1,11,94,106,6
Marshall,State House,Tommy Hardin,REP,480102,4,31,148,183,49
Marshall,State House,Miranda Shelton,DEM,480102,2,7,105,114,49
Marshall,Governor,Chris Powell,LIB,480105,0,0,6,6,
Marshall,Governor,Kevin Stitt,REP,480105,10,26,179,215,
Marshall,Governor,Drew Edmondson,DEM,480105,2,12,78,92,
Marshall,Lieutenant Governor,Matt Pinnell,REP,480105,11,30,186,227,
Marshall,Lieutenant Governor,Anastasia Pittman,DEM,480105,0,8,65,73,
Marshall,Lieutenant Governor,Ivan Holmes,IND,480105,1,0,10,11,
Marshall,State Auditor,John Yeutter,LIB,480105,1,5,33,39,
Marshall,State Auditor,Cindy Byrd,REP,480105,11,28,208,247,
Marshall,Attorney General,Mike Hunter,REP,480105,11,28,195,234,
Marshall,Attorney General,Mark Myles,DEM,480105,1,8,64,73,
Marshall,State Treasurer,Randy Mcdaniel,REP,480105,11,31,197,239,
Marshall,State Treasurer,Charles De Coune,IND,480105,1,4,44,49,
Marshall,Superintendent of Public Instruction,Joy Hofmeister,REP,480105,11,25,185,221,
Marshall,Superintendent of Public Instruction,John Cox,DEM,480105,0,12,64,76,
Marshall,Superintendent of Public Instruction,Larry Huff,IND,480105,1,1,13,15,
Marshall,Commissioner of Labor,Leslie Osborn,REP,480105,11,27,182,220,
Marshall,Commissioner of Labor,Fred Dorrell,DEM,480105,0,8,68,76,
Marshall,Commissioner of Labor,Brandt Dismukes,IND,480105,1,1,8,10,
Marshall,Insurance Commissioner,Glen Mulready,REP,480105,11,28,185,224,
Marshall,Insurance Commissioner,Kimberly Fobbs,DEM,480105,1,8,72,81,
Marshall,Corporation Commissioner,Bob Anthony,REP,480105,11,26,179,216,
Marshall,Corporation Commissioner,Ashley Nicole Mccray,DEM,480105,1,9,65,75,
Marshall,Corporation Commissioner,Jackie Short,IND,480105,0,1,16,17,
Marshall,U.S. House,Richard Castaldo,LIB,480105,0,0,5,5,2
Marshall,U.S. House,Markwayne Mullin,REP,480105,11,28,192,231,2
Marshall,U.S. House,Jason Nichols,DEM,480105,0,10,55,65,2
Marshall,U.S. House,John Foreman,IND,480105,1,0,10,11,2
Marshall,State Senate,David Bullard,REP,480105,11,28,174,213,6
Marshall,State Senate,Arnold Bourne,DEM,480105,1,8,81,90,6
Marshall,State House,Tommy Hardin,REP,480105,11,30,179,220,49
Marshall,State House,Miranda Shelton,DEM,480105,1,8,83,92,49
Marshall,Governor,Chris Powell,LIB,480106,0,0,3,3,
Marshall,Governor,Kevin Stitt,REP,480106,0,19,127,146,
Marshall,Governor,Drew Edmondson,DEM,480106,1,6,50,57,
Marshall,Lieutenant Governor,Matt Pinnell,REP,480106,0,20,130,150,
Marshall,Lieutenant Governor,Anastasia Pittman,DEM,480106,1,5,43,49,
Marshall,Lieutenant Governor,Ivan Holmes,IND,480106,0,0,4,4,
Marshall,State Auditor,John Yeutter,LIB,480106,0,2,24,26,
Marshall,State Auditor,Cindy Byrd,REP,480106,1,21,139,161,
Marshall,Attorney General,Mike Hunter,REP,480106,0,19,128,147,
Marshall,Attorney General,Mark Myles,DEM,480106,1,6,51,58,
Marshall,State Treasurer,Randy Mcdaniel,REP,480106,1,21,138,160,
Marshall,State Treasurer,Charles De Coune,IND,480106,0,2,24,26,
Marshall,Superintendent of Public Instruction,Joy Hofmeister,REP,480106,0,19,120,139,
Marshall,Superintendent of Public Instruction,John Cox,DEM,480106,1,4,50,55,
Marshall,Superintendent of Public Instruction,Larry Huff,IND,480106,0,1,9,10,
Marshall,Commissioner of Labor,Leslie Osborn,REP,480106,0,19,117,136,
Marshall,Commissioner of Labor,Fred Dorrell,DEM,480106,1,6,52,59,
Marshall,Commissioner of Labor,Brandt Dismukes,IND,480106,0,0,7,7,
Marshall,Insurance Commissioner,Glen Mulready,REP,480106,1,19,120,140,
Marshall,Insurance Commissioner,Kimberly Fobbs,DEM,480106,0,6,56,62,
Marshall,Corporation Commissioner,Bob Anthony,REP,480106,0,18,117,135,
Marshall,Corporation Commissioner,Ashley Nicole Mccray,DEM,480106,1,7,52,60,
Marshall,Corporation Commissioner,Jackie Short,IND,480106,0,0,8,8,
Marshall,U.S. House,Richard Castaldo,LIB,480106,0,0,3,3,2
Marshall,U.S. House,Markwayne Mullin,REP,480106,0,19,128,147,2
Marshall,U.S. House,Jason Nichols,DEM,480106,1,6,47,54,2
Marshall,U.S. House,John Foreman,IND,480106,0,0,2,2,2
Marshall,State Senate,David Bullard,REP,480106,0,19,127,146,6
Marshall,State Senate,Arnold Bourne,DEM,480106,1,6,51,58,6
Marshall,State House,Tommy Hardin,REP,480106,0,19,108,127,49
Marshall,State House,Miranda Shelton,DEM,480106,1,6,72,79,49
Marshall,Governor,Chris Powell,LIB,480201,1,0,8,9,
Marshall,Governor,Kevin Stitt,REP,480201,0,18,141,159,
Marshall,Governor,Drew Edmondson,DEM,480201,1,5,64,70,
Marshall,Lieutenant Governor,Matt Pinnell,REP,480201,2,21,140,163,
Marshall,Lieutenant Governor,Anastasia Pittman,DEM,480201,0,2,59,61,
Marshall,Lieutenant Governor,Ivan Holmes,IND,480201,0,0,7,7,
Marshall,State Auditor,John Yeutter,LIB,480201,0,1,37,38,
Marshall,State Auditor,Cindy Byrd,REP,480201,3,22,163,188,
Marshall,Attorney General,Mike Hunter,REP,480201,1,22,147,170,
Marshall,Attorney General,Mark Myles,DEM,480201,1,1,60,62,
Marshall,State Treasurer,Randy Mcdaniel,REP,480201,1,21,157,179,
Marshall,State Treasurer,Charles De Coune,IND,480201,1,2,41,44,
Marshall,Superintendent of Public Instruction,Joy Hofmeister,REP,480201,2,19,132,153,
Marshall,Superintendent of Public Instruction,John Cox,DEM,480201,0,4,64,68,
Marshall,Superintendent of Public Instruction,Larry Huff,IND,480201,0,0,11,11,
Marshall,Commissioner of Labor,Leslie Osborn,REP,480201,2,18,141,161,
Marshall,Commissioner of Labor,Fred Dorrell,DEM,480201,0,5,61,66,
Marshall,Commissioner of Labor,Brandt Dismukes,IND,480201,0,0,4,4,
Marshall,Insurance Commissioner,Glen Mulready,REP,480201,2,21,147,170,
Marshall,Insurance Commissioner,Kimberly Fobbs,DEM,480201,0,2,57,59,
Marshall,Corporation Commissioner,Bob Anthony,REP,480201,1,20,141,162,
Marshall,Corporation Commissioner,Ashley Nicole Mccray,DEM,480201,1,3,58,62,
Marshall,Corporation Commissioner,Jackie Short,IND,480201,0,0,8,8,
Marshall,U.S. House,Richard Castaldo,LIB,480201,0,0,3,3,2
Marshall,U.S. House,Markwayne Mullin,REP,480201,3,19,146,168,2
Marshall,U.S. House,Jason Nichols,DEM,480201,0,3,56,59,2
Marshall,U.S. House,John Foreman,IND,480201,0,0,5,5,2
Marshall,State Senate,David Bullard,REP,480201,2,20,149,171,6
Marshall,State Senate,Arnold Bourne,DEM,480201,1,3,60,64,6
Marshall,State House,Tommy Hardin,REP,480201,1,18,131,150,49
Marshall,State House,Miranda Shelton,DEM,480201,2,5,81,88,49
Marshall,Governor,Chris Powell,LIB,480202,0,3,3,6,
Marshall,Governor,Kevin Stitt,REP,480202,5,25,124,154,
Marshall,Governor,Drew Edmondson,DEM,480202,4,17,77,98,
Marshall,Lieutenant Governor,Matt Pinnell,REP,480202,5,28,120,153,
Marshall,Lieutenant Governor,Anastasia Pittman,DEM,480202,4,15,76,95,
Marshall,Lieutenant Governor,Ivan Holmes,IND,480202,0,2,5,7,
Marshall,State Auditor,John Yeutter,LIB,480202,0,8,27,35,
Marshall,State Auditor,Cindy Byrd,REP,480202,7,32,145,184,
Marshall,Attorney General,Mike Hunter,REP,480202,6,31,135,172,
Marshall,Attorney General,Mark Myles,DEM,480202,3,13,66,82,
Marshall,State Treasurer,Randy Mcdaniel,REP,480202,7,32,137,176,
Marshall,State Treasurer,Charles De Coune,IND,480202,0,8,34,42,
Marshall,Superintendent of Public Instruction,Joy Hofmeister,REP,480202,5,30,124,159,
Marshall,Superintendent of Public Instruction,John Cox,DEM,480202,3,14,70,87,
Marshall,Superintendent of Public Instruction,Larry Huff,IND,480202,1,1,9,11,
Marshall,Commissioner of Labor,Leslie Osborn,REP,480202,5,29,128,162,
Marshall,Commissioner of Labor,Fred Dorrell,DEM,480202,3,11,68,82,
Marshall,Commissioner of Labor,Brandt Dismukes,IND,480202,1,4,6,11,
Marshall,Insurance Commissioner,Glen Mulready,REP,480202,5,30,119,154,
Marshall,Insurance Commissioner,Kimberly Fobbs,DEM,480202,3,14,82,99,
Marshall,Corporation Commissioner,Bob Anthony,REP,480202,6,28,118,152,
Marshall,Corporation Commissioner,Ashley Nicole Mccray,DEM,480202,2,15,76,93,
Marshall,Corporation Commissioner,Jackie Short,IND,480202,0,1,7,8,
Marshall,U.S. House,Richard Castaldo,LIB,480202,1,2,2,5,2
Marshall,U.S. House,Markwayne Mullin,REP,480202,5,29,136,170,2
Marshall,U.S. House,Jason Nichols,DEM,480202,3,12,62,77,2
Marshall,U.S. House,John Foreman,IND,480202,0,2,3,5,2
Marshall,State Senate,David Bullard,REP,480202,5,31,130,166,6
Marshall,State Senate,Arnold Bourne,DEM,480202,4,13,73,90,6
Marshall,State House,Tommy Hardin,REP,480202,6,27,111,144,49
Marshall,State House,Miranda Shelton,DEM,480202,3,18,93,114,49
Marshall,Governor,Chris Powell,LIB,480204,1,0,15,16,
Marshall,Governor,Kevin Stitt,REP,480204,10,37,235,282,
Marshall,Governor,Drew Edmondson,DEM,480204,5,11,114,130,
Marshall,Lieutenant Governor,Matt Pinnell,REP,480204,11,39,263,313,
Marshall,Lieutenant Governor,Anastasia Pittman,DEM,480204,5,10,85,100,
Marshall,Lieutenant Governor,Ivan Holmes,IND,480204,0,0,12,12,
Marshall,State Auditor,John Yeutter,LIB,480204,1,6,56,63,
Marshall,State Auditor,Cindy Byrd,REP,480204,14,43,291,348,
Marshall,Attorney General,Mike Hunter,REP,480204,12,40,266,318,
Marshall,Attorney General,Mark Myles,DEM,480204,3,8,95,106,
Marshall,State Treasurer,Randy Mcdaniel,REP,480204,13,43,291,347,
Marshall,State Treasurer,Charles De Coune,IND,480204,2,6,58,66,
Marshall,Superintendent of Public Instruction,Joy Hofmeister,REP,480204,12,41,238,291,
Marshall,Superintendent of Public Instruction,John Cox,DEM,480204,4,7,105,116,
Marshall,Superintendent of Public Instruction,Larry Huff,IND,480204,0,1,18,19,
Marshall,Commissioner of Labor,Leslie Osborn,REP,480204,12,39,251,302,
Marshall,Commissioner of Labor,Fred Dorrell,DEM,480204,4,9,91,104,
Marshall,Commissioner of Labor,Brandt Dismukes,IND,480204,0,0,16,16,
Marshall,Insurance Commissioner,Glen Mulready,REP,480204,13,39,246,298,
Marshall,Insurance Commissioner,Kimberly Fobbs,DEM,480204,3,8,110,121,
Marshall,Corporation Commissioner,Bob Anthony,REP,480204,11,36,241,288,
Marshall,Corporation Commissioner,Ashley Nicole Mccray,DEM,480204,4,10,93,107,
Marshall,Corporation Commissioner,Jackie Short,IND,480204,1,1,25,27,
Marshall,U.S. House,Richard Castaldo,LIB,480204,0,0,8,8,2
Marshall,U.S. House,Markwayne Mullin,REP,480204,13,42,251,306,2
Marshall,U.S. House,Jason Nichols,DEM,480204,3,7,84,94,2
Marshall,U.S. House,John Foreman,IND,480204,0,0,18,18,2
Marshall,State Senate,David Bullard,REP,480204,12,41,257,310,6
Marshall,State Senate,Arnold Bourne,DEM,480204,3,8,103,114,6
Marshall,State House,Tommy Hardin,REP,480204,10,40,199,249,49
Marshall,State House,Miranda Shelton,DEM,480204,6,9,164,179,49
Marshall,Governor,Chris Powell,LIB,480206,0,0,10,10,
Marshall,Governor,Kevin Stitt,REP,480206,10,18,179,207,
Marshall,Governor,Drew Edmondson,DEM,480206,1,6,68,75,
Marshall,Lieutenant Governor,Matt Pinnell,REP,480206,9,16,185,210,
Marshall,Lieutenant Governor,Anastasia Pittman,DEM,480206,2,7,62,71,
Marshall,Lieutenant Governor,Ivan Holmes,IND,480206,0,1,10,11,
Marshall,State Auditor,John Yeutter,LIB,480206,1,4,35,40,
Marshall,State Auditor,Cindy Byrd,REP,480206,10,20,206,236,
Marshall,Attorney General,Mike Hunter,REP,480206,10,16,203,229,
Marshall,Attorney General,Mark Myles,DEM,480206,1,8,54,63,
Marshall,State Treasurer,Randy Mcdaniel,REP,480206,10,20,206,236,
Marshall,State Treasurer,Charles De Coune,IND,480206,1,4,33,38,
Marshall,Superintendent of Public Instruction,Joy Hofmeister,REP,480206,10,16,170,196,
Marshall,Superintendent of Public Instruction,John Cox,DEM,480206,0,7,59,66,
Marshall,Superintendent of Public Instruction,Larry Huff,IND,480206,1,1,26,28,
Marshall,Commissioner of Labor,Leslie Osborn,REP,480206,9,16,186,211,
Marshall,Commissioner of Labor,Fred Dorrell,DEM,480206,1,8,56,65,
Marshall,Commissioner of Labor,Brandt Dismukes,IND,480206,1,0,14,15,
Marshall,Insurance Commissioner,Glen Mulready,REP,480206,11,16,190,217,
Marshall,Insurance Commissioner,Kimberly Fobbs,DEM,480206,0,8,64,72,
Marshall,Corporation Commissioner,Bob Anthony,REP,480206,10,18,179,207,
Marshall,Corporation Commissioner,Ashley Nicole Mccray,DEM,480206,0,5,62,67,
Marshall,Corporation Commissioner,Jackie Short,IND,480206,1,1,15,17,
Marshall,U.S. House,Richard Castaldo,LIB,480206,1,0,6,7,2
Marshall,U.S. House,Markwayne Mullin,REP,480206,10,20,194,224,2
Marshall,U.S. House,Jason Nichols,DEM,480206,0,4,49,53,2
Marshall,U.S. House,John Foreman,IND,480206,0,0,8,8,2
Marshall,State Senate,David Bullard,REP,480206,10,18,193,221,6
Marshall,State Senate,Arnold Bourne,DEM,480206,1,6,63,70,6
Marshall,State House,Tommy Hardin,REP,480206,10,17,172,199,49
Marshall,State House,Miranda Shelton,DEM,480206,1,7,86,94,49
Marshall,Governor,Chris Powell,LIB,480302,0,1,9,10,
Marshall,Governor,Kevin Stitt,REP,480302,6,27,214,247,
Marshall,Governor,Drew Edmondson,DEM,480302,6,14,95,115,
Marshall,Lieutenant Governor,Matt Pinnell,REP,480302,6,29,223,258,
Marshall,Lieutenant Governor,Anastasia Pittman,DEM,480302,4,11,86,101,
Marshall,Lieutenant Governor,Ivan Holmes,IND,480302,2,1,8,11,
Marshall,State Auditor,John Yeutter,LIB,480302,2,4,45,51,
Marshall,State Auditor,Cindy Byrd,REP,480302,9,32,242,283,
Marshall,Attorney General,Mike Hunter,REP,480302,5,31,231,267,
Marshall,Attorney General,Mark Myles,DEM,480302,7,10,84,101,
Marshall,State Treasurer,Randy Mcdaniel,REP,480302,8,32,247,287,
Marshall,State Treasurer,Charles De Coune,IND,480302,3,3,45,51,
Marshall,Superintendent of Public Instruction,Joy Hofmeister,REP,480302,5,30,213,248,
Marshall,Superintendent of Public Instruction,John Cox,DEM,480302,5,10,83,98,
Marshall,Superintendent of Public Instruction,Larry Huff,IND,480302,2,1,21,24,
Marshall,Commissioner of Labor,Leslie Osborn,REP,480302,6,29,225,260,
Marshall,Commissioner of Labor,Fred Dorrell,DEM,480302,4,10,80,94,
Marshall,Commissioner of Labor,Brandt Dismukes,IND,480302,2,1,9,12,
Marshall,Insurance Commissioner,Glen Mulready,REP,480302,6,30,232,268,
Marshall,Insurance Commissioner,Kimberly Fobbs,DEM,480302,6,10,83,99,
Marshall,Corporation Commissioner,Bob Anthony,REP,480302,5,29,214,248,
Marshall,Corporation Commissioner,Ashley Nicole Mccray,DEM,480302,4,9,80,93,
Marshall,Corporation Commissioner,Jackie Short,IND,480302,3,2,21,26,
Marshall,U.S. House,Richard Castaldo,LIB,480302,0,0,7,7,2
Marshall,U.S. House,Markwayne Mullin,REP,480302,6,31,226,263,2
Marshall,U.S. House,Jason Nichols,DEM,480302,4,10,74,88,2
Marshall,U.S. House,John Foreman,IND,480302,2,1,8,11,2
Marshall,State Senate,David Bullard,REP,480302,7,29,227,263,6
Marshall,State Senate,Arnold Bourne,DEM,480302,5,12,91,108,6
Marshall,State House,Tommy Hardin,REP,480302,6,27,191,224,49
Marshall,State House,Miranda Shelton,DEM,480302,6,15,126,147,49
Marshall,Governor,Chris Powell,LIB,480303,0,1,11,12,
Marshall,Governor,Kevin Stitt,REP,480303,14,66,337,417,
Marshall,Governor,Drew Edmondson,DEM,480303,13,20,156,189,
Marshall,Lieutenant Governor,Matt Pinnell,REP,480303,15,73,364,452,
Marshall,Lieutenant Governor,Anastasia Pittman,DEM,480303,12,11,129,152,
Marshall,Lieutenant Governor,Ivan Holmes,IND,480303,0,3,9,12,
Marshall,State Auditor,John Yeutter,LIB,480303,3,4,62,69,
Marshall,State Auditor,Cindy Byrd,REP,480303,18,80,397,495,
Marshall,Attorney General,Mike Hunter,REP,480303,17,77,370,464,
Marshall,Attorney General,Mark Myles,DEM,480303,10,10,129,149,
Marshall,State Treasurer,Randy Mcdaniel,REP,480303,19,77,396,492,
Marshall,State Treasurer,Charles De Coune,IND,480303,4,7,69,80,
Marshall,Superintendent of Public Instruction,Joy Hofmeister,REP,480303,15,73,347,435,
Marshall,Superintendent of Public Instruction,John Cox,DEM,480303,11,11,123,145,
Marshall,Superintendent of Public Instruction,Larry Huff,IND,480303,1,3,31,35,
Marshall,Commissioner of Labor,Leslie Osborn,REP,480303,18,76,354,448,
Marshall,Commissioner of Labor,Fred Dorrell,DEM,480303,9,9,125,143,
Marshall,Commissioner of Labor,Brandt Dismukes,IND,480303,0,1,18,19,
Marshall,Insurance Commissioner,Glen Mulready,REP,480303,16,76,370,462,
Marshall,Insurance Commissioner,Kimberly Fobbs,DEM,480303,10,11,127,148,
Marshall,Corporation Commissioner,Bob Anthony,REP,480303,15,66,356,437,
Marshall,Corporation Commissioner,Ashley Nicole Mccray,DEM,480303,10,13,123,146,
Marshall,Corporation Commissioner,Jackie Short,IND,480303,2,8,19,29,
Marshall,U.S. House,Richard Castaldo,LIB,480303,2,1,1,4,2
Marshall,U.S. House,Markwayne Mullin,REP,480303,15,75,371,461,2
Marshall,U.S. House,Jason Nichols,DEM,480303,10,10,120,140,2
Marshall,U.S. House,John Foreman,IND,480303,0,1,11,12,2
Marshall,State Senate,David Bullard,REP,480303,15,77,347,439,6
Marshall,State Senate,Arnold Bourne,DEM,480303,12,10,151,173,6
Marshall,State House,Tommy Hardin,REP,480303,15,61,310,386,49
Marshall,State House,Miranda Shelton,DEM,480303,12,26,188,226,49
Marshall,Governor,Chris Powell,LIB,480304,1,4,18,23,
Marshall,Governor,Kevin Stitt,REP,480304,25,75,489,589,
Marshall,Governor,Drew Edmondson,DEM,480304,6,28,188,222,
Marshall,Lieutenant Governor,Matt Pinnell,REP,480304,25,78,508,611,
Marshall,Lieutenant Governor,Anastasia Pittman,DEM,480304,6,26,158,190,
Marshall,Lieutenant Governor,Ivan Holmes,IND,480304,1,2,26,29,
Marshall,State Auditor,John Yeutter,LIB,480304,3,14,99,116,
Marshall,State Auditor,Cindy Byrd,REP,480304,26,80,543,649,
Marshall,Attorney General,Mike Hunter,REP,480304,26,80,523,629,
Marshall,Attorney General,Mark Myles,DEM,480304,6,25,164,195,
Marshall,State Treasurer,Randy Mcdaniel,REP,480304,28,77,544,649,
Marshall,State Treasurer,Charles De Coune,IND,480304,1,16,103,120,
Marshall,Superintendent of Public Instruction,Joy Hofmeister,REP,480304,26,77,482,585,
Marshall,Superintendent of Public Instruction,John Cox,DEM,480304,4,24,158,186,
Marshall,Superintendent of Public Instruction,Larry Huff,IND,480304,2,5,47,54,
Marshall,Commissioner of Labor,Leslie Osborn,REP,480304,28,77,488,593,
Marshall,Commissioner of Labor,Fred Dorrell,DEM,480304,3,23,161,187,
Marshall,Commissioner of Labor,Brandt Dismukes,IND,480304,1,5,31,37,
Marshall,Insurance Commissioner,Glen Mulready,REP,480304,27,77,505,609,
Marshall,Insurance Commissioner,Kimberly Fobbs,DEM,480304,5,28,177,210,
Marshall,Corporation Commissioner,Bob Anthony,REP,480304,24,79,488,591,
Marshall,Corporation Commissioner,Ashley Nicole Mccray,DEM,480304,4,24,164,192,
Marshall,Corporation Commissioner,Jackie Short,IND,480304,4,2,34,40,
Marshall,U.S. House,Richard Castaldo,LIB,480304,1,1,5,7,2
Marshall,U.S. House,Markwayne Mullin,REP,480304,27,77,512,616,2
Marshall,U.S. House,Jason Nichols,DEM,480304,4,25,146,175,2
Marshall,U.S. House,John Foreman,IND,480304,0,4,25,29,2
Marshall,State Senate,David Bullard,REP,480304,26,79,509,614,6
Marshall,State Senate,Arnold Bourne,DEM,480304,6,26,181,213,6
Marshall,State House,Tommy Hardin,REP,480304,26,74,449,549,49
Marshall,State House,Miranda Shelton,DEM,480304,6,32,242,280,49
Mayes,Governor,Chris Powell,LIB,490011,2,0,17,19,
Mayes,Governor,Kevin Stitt,REP,490011,9,25,329,363,
Mayes,Governor,Drew Edmondson,DEM,490011,8,12,147,167,
Mayes,Lieutenant Governor,Matt Pinnell,REP,490011,12,27,351,390,
Mayes,Lieutenant Governor,Anastasia Pittman,DEM,490011,7,10,117,134,
Mayes,Lieutenant Governor,Ivan Holmes,IND,490011,0,0,14,14,
Mayes,State Auditor,John Yeutter,LIB,490011,8,8,90,106,
Mayes,State Auditor,Cindy Byrd,REP,490011,11,26,371,408,
Mayes,Attorney General,Mike Hunter,REP,490011,13,28,354,395,
Mayes,Attorney General,Mark Myles,DEM,490011,6,9,126,141,
Mayes,State Treasurer,Randy Mcdaniel,REP,490011,13,28,370,411,
Mayes,State Treasurer,Charles De Coune,IND,490011,6,6,88,100,
Mayes,Superintendent of Public Instruction,Joy Hofmeister,REP,490011,9,22,286,317,
Mayes,Superintendent of Public Instruction,John Cox,DEM,490011,7,13,161,181,
Mayes,Superintendent of Public Instruction,Larry Huff,IND,490011,3,2,37,42,
Mayes,Commissioner of Labor,Leslie Osborn,REP,490011,11,26,327,364,
Mayes,Commissioner of Labor,Fred Dorrell,DEM,490011,6,10,130,146,
Mayes,Commissioner of Labor,Brandt Dismukes,IND,490011,2,1,24,27,
Mayes,Insurance Commissioner,Glen Mulready,REP,490011,11,26,341,378,
Mayes,Insurance Commissioner,Kimberly Fobbs,DEM,490011,8,10,138,156,
Mayes,Corporation Commissioner,Bob Anthony,REP,490011,11,25,338,374,
Mayes,Corporation Commissioner,Ashley Nicole Mccray,DEM,490011,6,10,121,137,
Mayes,Corporation Commissioner,Jackie Short,IND,490011,2,1,20,23,
Mayes,U.S. House,Richard Castaldo,LIB,490011,1,0,12,13,2
Mayes,U.S. House,Markwayne Mullin,REP,490011,10,25,343,378,2
Mayes,U.S. House,Jason Nichols,DEM,490011,6,12,116,134,2
Mayes,U.S. House,John Foreman,IND,490011,2,0,14,16,2
Mayes,State House,Rusty Cornwell,REP,490011,12,25,338,375,6
Mayes,State House,John Myers,DEM,490011,7,12,144,163,6
Mayes,Governor,Chris Powell,LIB,490012,0,0,15,15,
Mayes,Governor,Kevin Stitt,REP,490012,3,20,288,311,
Mayes,Governor,Drew Edmondson,DEM,490012,12,13,181,206,
Mayes,Lieutenant Governor,Matt Pinnell,REP,490012,6,26,344,376,
Mayes,Lieutenant Governor,Anastasia Pittman,DEM,490012,9,4,124,137,
Mayes,Lieutenant Governor,Ivan Holmes,IND,490012,1,1,12,14,
Mayes,State Auditor,John Yeutter,LIB,490012,7,5,87,99,
Mayes,State Auditor,Cindy Byrd,REP,490012,7,25,367,399,
Mayes,Attorney General,Mike Hunter,REP,490012,6,25,337,368,
Mayes,Attorney General,Mark Myles,DEM,490012,10,6,142,158,
Mayes,State Treasurer,Randy Mcdaniel,REP,490012,6,27,378,411,
Mayes,State Treasurer,Charles De Coune,IND,490012,8,3,77,88,
Mayes,Superintendent of Public Instruction,Joy Hofmeister,REP,490012,6,20,250,276,
Mayes,Superintendent of Public Instruction,John Cox,DEM,490012,9,10,206,225,
Mayes,Superintendent of Public Instruction,Larry Huff,IND,490012,1,3,24,28,
Mayes,Commissioner of Labor,Leslie Osborn,REP,490012,5,21,302,328,
Mayes,Commissioner of Labor,Fred Dorrell,DEM,490012,11,8,153,172,
Mayes,Commissioner of Labor,Brandt Dismukes,IND,490012,0,2,21,23,
Mayes,Insurance Commissioner,Glen Mulready,REP,490012,6,24,324,354,
Mayes,Insurance Commissioner,Kimberly Fobbs,DEM,490012,10,6,146,162,
Mayes,Corporation Commissioner,Bob Anthony,REP,490012,5,25,318,348,
Mayes,Corporation Commissioner,Ashley Nicole Mccray,DEM,490012,10,6,133,149,
Mayes,Corporation Commissioner,Jackie Short,IND,490012,1,0,24,25,
Mayes,U.S. House,Richard Castaldo,LIB,490012,0,2,8,10,2
Mayes,U.S. House,Markwayne Mullin,REP,490012,6,25,317,348,2
Mayes,U.S. House,Jason Nichols,DEM,490012,10,5,143,158,2
Mayes,U.S. House,John Foreman,IND,490012,0,0,15,15,2
Mayes,State House,Rusty Cornwell,REP,490012,4,18,292,314,6
Mayes,State House,John Myers,DEM,490012,12,15,187,214,6
Mayes,Governor,Chris Powell,LIB,490014,0,1,12,13,
Mayes,Governor,Kevin Stitt,REP,490014,2,3,103,108,
Mayes,Governor,Drew Edmondson,DEM,490014,0,6,53,59,
Mayes,Lieutenant Governor,Matt Pinnell,REP,490014,0,4,112,116,
Mayes,Lieutenant Governor,Anastasia Pittman,DEM,490014,0,6,42,48,
Mayes,Lieutenant Governor,Ivan Holmes,IND,490014,2,0,11,13,
Mayes,State Auditor,John Yeutter,LIB,490014,0,4,24,28,
Mayes,State Auditor,Cindy Byrd,REP,490014,2,6,120,128,
Mayes,Attorney General,Mike Hunter,REP,490014,0,4,119,123,
Mayes,Attorney General,Mark Myles,DEM,490014,2,6,44,52,
Mayes,State Treasurer,Randy Mcdaniel,REP,490014,2,4,117,123,
Mayes,State Treasurer,Charles De Coune,IND,490014,0,6,25,31,
Mayes,Superintendent of Public Instruction,Joy Hofmeister,REP,490014,2,2,86,90,
Mayes,Superintendent of Public Instruction,John Cox,DEM,490014,0,6,61,67,
Mayes,Superintendent of Public Instruction,Larry Huff,IND,490014,0,2,17,19,
Mayes,Commissioner of Labor,Leslie Osborn,REP,490014,1,4,100,105,
Mayes,Commissioner of Labor,Fred Dorrell,DEM,490014,1,5,47,53,
Mayes,Commissioner of Labor,Brandt Dismukes,IND,490014,0,1,14,15,
Mayes,Insurance Commissioner,Glen Mulready,REP,490014,0,4,108,112,
Mayes,Insurance Commissioner,Kimberly Fobbs,DEM,490014,2,6,51,59,
Mayes,Corporation Commissioner,Bob Anthony,REP,490014,2,2,105,109,
Mayes,Corporation Commissioner,Ashley Nicole Mccray,DEM,490014,0,6,45,51,
Mayes,Corporation Commissioner,Jackie Short,IND,490014,0,2,11,13,
Mayes,U.S. House,Richard Castaldo,LIB,490014,0,0,3,3,2
Mayes,U.S. House,Markwayne Mullin,REP,490014,0,3,113,116,2
Mayes,U.S. House,Jason Nichols,DEM,490014,2,6,42,50,2
Mayes,U.S. House,John Foreman,IND,490014,0,1,7,8,2
Mayes,State House,Josh West,REP,490014,0,4,122,126,5
Mayes,State House,Ed Trumbull,DEM,490014,2,6,41,49,5
Mayes,Governor,Chris Powell,LIB,490015,0,2,12,14,
Mayes,Governor,Kevin Stitt,REP,490015,10,40,224,274,
Mayes,Governor,Drew Edmondson,DEM,490015,9,19,145,173,
Mayes,Lieutenant Governor,Matt Pinnell,REP,490015,10,43,263,316,
Mayes,Lieutenant Governor,Anastasia Pittman,DEM,490015,8,16,108,132,
Mayes,Lieutenant Governor,Ivan Holmes,IND,490015,1,2,7,10,
Mayes,State Auditor,John Yeutter,LIB,490015,5,11,74,90,
Mayes,State Auditor,Cindy Byrd,REP,490015,12,49,277,338,
Mayes,Attorney General,Mike Hunter,REP,490015,8,43,261,312,
Mayes,Attorney General,Mark Myles,DEM,490015,8,18,118,144,
Mayes,State Treasurer,Randy Mcdaniel,REP,490015,8,46,281,335,
Mayes,State Treasurer,Charles De Coune,IND,490015,7,14,71,92,
Mayes,Superintendent of Public Instruction,Joy Hofmeister,REP,490015,10,26,225,261,
Mayes,Superintendent of Public Instruction,John Cox,DEM,490015,7,31,129,167,
Mayes,Superintendent of Public Instruction,Larry Huff,IND,490015,2,4,23,29,
Mayes,Commissioner of Labor,Leslie Osborn,REP,490015,10,42,232,284,
Mayes,Commissioner of Labor,Fred Dorrell,DEM,490015,8,15,127,150,
Mayes,Commissioner of Labor,Brandt Dismukes,IND,490015,0,4,16,20,
Mayes,Insurance Commissioner,Glen Mulready,REP,490015,10,43,253,306,
Mayes,Insurance Commissioner,Kimberly Fobbs,DEM,490015,7,17,121,145,
Mayes,Corporation Commissioner,Bob Anthony,REP,490015,8,39,249,296,
Mayes,Corporation Commissioner,Ashley Nicole Mccray,DEM,490015,9,17,108,134,
Mayes,Corporation Commissioner,Jackie Short,IND,490015,2,4,18,24,
Mayes,U.S. House,Richard Castaldo,LIB,490015,0,1,7,8,2
Mayes,U.S. House,Markwayne Mullin,REP,490015,10,39,251,300,2
Mayes,U.S. House,Jason Nichols,DEM,490015,9,17,112,138,2
Mayes,U.S. House,John Foreman,IND,490015,0,3,9,12,2
Mayes,State House,Josh West,REP,490015,11,41,243,295,5
Mayes,State House,Ed Trumbull,DEM,490015,7,19,130,156,5
Mayes,Governor,Chris Powell,LIB,490016,0,2,9,11,
Mayes,Governor,Kevin Stitt,REP,490016,10,17,208,235,
Mayes,Governor,Drew Edmondson,DEM,490016,4,18,96,118,
Mayes,Lieutenant Governor,Matt Pinnell,REP,490016,9,20,236,265,
Mayes,Lieutenant Governor,Anastasia Pittman,DEM,490016,5,15,70,90,
Mayes,Lieutenant Governor,Ivan Holmes,IND,490016,0,1,5,6,
Mayes,State Auditor,John Yeutter,LIB,490016,5,12,47,64,
Mayes,State Auditor,Cindy Byrd,REP,490016,8,22,242,272,
Mayes,Attorney General,Mike Hunter,REP,490016,8,21,231,260,
Mayes,Attorney General,Mark Myles,DEM,490016,5,16,77,98,
Mayes,State Treasurer,Randy Mcdaniel,REP,490016,9,22,246,277,
Mayes,State Treasurer,Charles De Coune,IND,490016,3,12,43,58,
Mayes,Superintendent of Public Instruction,Joy Hofmeister,REP,490016,6,18,172,196,
Mayes,Superintendent of Public Instruction,John Cox,DEM,490016,7,15,123,145,
Mayes,Superintendent of Public Instruction,Larry Huff,IND,490016,1,4,16,21,
Mayes,Commissioner of Labor,Leslie Osborn,REP,490016,7,19,216,242,
Mayes,Commissioner of Labor,Fred Dorrell,DEM,490016,6,17,79,102,
Mayes,Commissioner of Labor,Brandt Dismukes,IND,490016,1,1,11,13,
Mayes,Insurance Commissioner,Glen Mulready,REP,490016,6,19,217,242,
Mayes,Insurance Commissioner,Kimberly Fobbs,DEM,490016,7,17,87,111,
Mayes,Corporation Commissioner,Bob Anthony,REP,490016,9,20,223,252,
Mayes,Corporation Commissioner,Ashley Nicole Mccray,DEM,490016,5,16,74,95,
Mayes,Corporation Commissioner,Jackie Short,IND,490016,0,1,9,10,
Mayes,U.S. House,Richard Castaldo,LIB,490016,0,1,6,7,2
Mayes,U.S. House,Markwayne Mullin,REP,490016,10,17,225,252,2
Mayes,U.S. House,Jason Nichols,DEM,490016,4,19,76,99,2
Mayes,U.S. House,John Foreman,IND,490016,0,0,6,6,2
Mayes,State House,Rusty Cornwell,REP,490016,7,17,214,238,6
Mayes,State House,John Myers,DEM,490016,6,20,97,123,6
Mayes,Governor,Chris Powell,LIB,490020,0,4,29,33,
Mayes,Governor,Kevin Stitt,REP,490020,12,66,408,486,
Mayes,Governor,Drew Edmondson,DEM,490020,17,36,207,260,
Mayes,Lieutenant Governor,Matt Pinnell,REP,490020,15,78,457,550,
Mayes,Lieutenant Governor,Anastasia Pittman,DEM,490020,14,25,155,194,
Mayes,Lieutenant Governor,Ivan Holmes,IND,490020,0,2,29,31,
Mayes,State Auditor,John Yeutter,LIB,490020,3,25,124,152,
Mayes,State Auditor,Cindy Byrd,REP,490020,22,75,484,581,
Mayes,Attorney General,Mike Hunter,REP,490020,16,65,460,541,
Mayes,Attorney General,Mark Myles,DEM,490020,12,39,175,226,
Mayes,State Treasurer,Randy Mcdaniel,REP,490020,19,79,483,581,
Mayes,State Treasurer,Charles De Coune,IND,490020,6,21,119,146,
Mayes,Superintendent of Public Instruction,Joy Hofmeister,REP,490020,13,60,344,417,
Mayes,Superintendent of Public Instruction,John Cox,DEM,490020,14,37,240,291,
Mayes,Superintendent of Public Instruction,Larry Huff,IND,490020,1,8,51,60,
Mayes,Commissioner of Labor,Leslie Osborn,REP,490020,15,73,415,503,
Mayes,Commissioner of Labor,Fred Dorrell,DEM,490020,12,29,185,226,
Mayes,Commissioner of Labor,Brandt Dismukes,IND,490020,0,1,30,31,
Mayes,Insurance Commissioner,Glen Mulready,REP,490020,15,72,438,525,
Mayes,Insurance Commissioner,Kimberly Fobbs,DEM,490020,12,31,191,234,
Mayes,Corporation Commissioner,Bob Anthony,REP,490020,19,72,432,523,
Mayes,Corporation Commissioner,Ashley Nicole Mccray,DEM,490020,10,29,165,204,
Mayes,Corporation Commissioner,Jackie Short,IND,490020,0,3,35,38,
Mayes,U.S. House,Richard Castaldo,LIB,490020,0,1,29,30,2
Mayes,U.S. House,Markwayne Mullin,REP,490020,16,68,440,524,2
Mayes,U.S. House,Jason Nichols,DEM,490020,12,35,157,204,2
Mayes,U.S. House,John Foreman,IND,490020,0,2,17,19,2
Mayes,State Senate,Marty Quinn,REP,490020,14,67,408,489,2
Mayes,State Senate,Jennifer Esau,DEM,490020,15,36,228,279,2
Mayes,State House,Tom Gann,REP,490020,13,59,326,398,8
Mayes,State House,Darrell Moore,DEM,490020,16,46,310,372,8
Mayes,Governor,Chris Powell,LIB,490021,0,1,17,18,
Mayes,Governor,Kevin Stitt,REP,490021,7,25,203,235,
Mayes,Governor,Drew Edmondson,DEM,490021,7,10,86,103,
Mayes,Lieutenant Governor,Matt Pinnell,REP,490021,9,29,218,256,
Mayes,Lieutenant Governor,Anastasia Pittman,DEM,490021,3,7,72,82,
Mayes,Lieutenant Governor,Ivan Holmes,IND,490021,2,0,17,19,
Mayes,State Auditor,John Yeutter,LIB,490021,2,2,70,74,
Mayes,State Auditor,Cindy Byrd,REP,490021,11,31,229,271,
Mayes,Attorney General,Mike Hunter,REP,490021,9,29,225,263,
Mayes,Attorney General,Mark Myles,DEM,490021,5,7,79,91,
Mayes,State Treasurer,Randy Mcdaniel,REP,490021,10,31,236,277,
Mayes,State Treasurer,Charles De Coune,IND,490021,3,2,61,66,
Mayes,Superintendent of Public Instruction,Joy Hofmeister,REP,490021,10,24,179,213,
Mayes,Superintendent of Public Instruction,John Cox,DEM,490021,4,8,101,113,
Mayes,Superintendent of Public Instruction,Larry Huff,IND,490021,0,4,24,28,
Mayes,Commissioner of Labor,Leslie Osborn,REP,490021,9,28,203,240,
Mayes,Commissioner of Labor,Fred Dorrell,DEM,490021,5,7,85,97,
Mayes,Commissioner of Labor,Brandt Dismukes,IND,490021,0,1,13,14,
Mayes,Insurance Commissioner,Glen Mulready,REP,490021,10,29,223,262,
Mayes,Insurance Commissioner,Kimberly Fobbs,DEM,490021,4,7,79,90,
Mayes,Corporation Commissioner,Bob Anthony,REP,490021,9,28,204,241,
Mayes,Corporation Commissioner,Ashley Nicole Mccray,DEM,490021,4,8,78,90,
Mayes,Corporation Commissioner,Jackie Short,IND,490021,1,0,23,24,
Mayes,U.S. House,Richard Castaldo,LIB,490021,0,0,6,6,2
Mayes,U.S. House,Markwayne Mullin,REP,490021,8,27,219,254,2
Mayes,U.S. House,Jason Nichols,DEM,490021,6,8,69,83,2
Mayes,U.S. House,John Foreman,IND,490021,0,1,11,12,2
Mayes,State House,Tom Gann,REP,490021,8,28,176,212,8
Mayes,State House,Darrell Moore,DEM,490021,6,6,131,143,8
Mayes,Governor,Chris Powell,LIB,490022,0,2,22,24,
Mayes,Governor,Kevin Stitt,REP,490022,3,15,290,308,
Mayes,Governor,Drew Edmondson,DEM,490022,5,7,118,130,
Mayes,Lieutenant Governor,Matt Pinnell,REP,490022,5,20,323,348,
Mayes,Lieutenant Governor,Anastasia Pittman,DEM,490022,3,4,87,94,
Mayes,Lieutenant Governor,Ivan Holmes,IND,490022,0,0,19,19,
Mayes,State Auditor,John Yeutter,LIB,490022,2,3,74,79,
Mayes,State Auditor,Cindy Byrd,REP,490022,3,17,340,360,
Mayes,Attorney General,Mike Hunter,REP,490022,3,19,325,347,
Mayes,Attorney General,Mark Myles,DEM,490022,5,5,104,114,
Mayes,State Treasurer,Randy Mcdaniel,REP,490022,3,19,324,346,
Mayes,State Treasurer,Charles De Coune,IND,490022,2,2,92,96,
Mayes,Superintendent of Public Instruction,Joy Hofmeister,REP,490022,2,13,249,264,
Mayes,Superintendent of Public Instruction,John Cox,DEM,490022,4,9,145,158,
Mayes,Superintendent of Public Instruction,Larry Huff,IND,490022,2,1,33,36,
Mayes,Commissioner of Labor,Leslie Osborn,REP,490022,3,17,296,316,
Mayes,Commissioner of Labor,Fred Dorrell,DEM,490022,5,6,110,121,
Mayes,Commissioner of Labor,Brandt Dismukes,IND,490022,0,1,19,20,
Mayes,Insurance Commissioner,Glen Mulready,REP,490022,3,15,309,327,
Mayes,Insurance Commissioner,Kimberly Fobbs,DEM,490022,5,8,119,132,
Mayes,Corporation Commissioner,Bob Anthony,REP,490022,3,17,310,330,
Mayes,Corporation Commissioner,Ashley Nicole Mccray,DEM,490022,5,6,90,101,
Mayes,Corporation Commissioner,Jackie Short,IND,490022,0,1,27,28,
Mayes,U.S. House,Richard Castaldo,LIB,490022,0,0,11,11,2
Mayes,U.S. House,Markwayne Mullin,REP,490022,3,19,308,330,2
Mayes,U.S. House,Jason Nichols,DEM,490022,5,4,93,102,2
Mayes,U.S. House,John Foreman,IND,490022,0,1,18,19,2
Mayes,State House,Tom Gann,REP,490022,2,14,249,265,8
Mayes,State House,Darrell Moore,DEM,490022,6,10,181,197,8
Mayes,Governor,Chris Powell,LIB,490023,2,0,16,18,
Mayes,Governor,Kevin Stitt,REP,490023,6,31,377,414,
Mayes,Governor,Drew Edmondson,DEM,490023,9,19,184,212,
Mayes,Lieutenant Governor,Matt Pinnell,REP,490023,8,30,410,448,
Mayes,Lieutenant Governor,Anastasia Pittman,DEM,490023,9,18,148,175,
Mayes,Lieutenant Governor,Ivan Holmes,IND,490023,0,2,20,22,
Mayes,State Auditor,John Yeutter,LIB,490023,4,13,102,119,
Mayes,State Auditor,Cindy Byrd,REP,490023,10,35,442,487,
Mayes,Attorney General,Mike Hunter,REP,490023,9,32,418,459,
Mayes,Attorney General,Mark Myles,DEM,490023,7,16,157,180,
Mayes,State Treasurer,Randy Mcdaniel,REP,490023,10,35,442,487,
Mayes,State Treasurer,Charles De Coune,IND,490023,4,12,102,118,
Mayes,Superintendent of Public Instruction,Joy Hofmeister,REP,490023,8,31,345,384,
Mayes,Superintendent of Public Instruction,John Cox,DEM,490023,7,17,201,225,
Mayes,Superintendent of Public Instruction,Larry Huff,IND,490023,2,1,30,33,
Mayes,Commissioner of Labor,Leslie Osborn,REP,490023,7,31,386,424,
Mayes,Commissioner of Labor,Fred Dorrell,DEM,490023,9,18,158,185,
Mayes,Commissioner of Labor,Brandt Dismukes,IND,490023,1,0,27,28,
Mayes,Insurance Commissioner,Glen Mulready,REP,490023,6,35,406,447,
Mayes,Insurance Commissioner,Kimberly Fobbs,DEM,490023,11,15,167,193,
Mayes,Corporation Commissioner,Bob Anthony,REP,490023,6,33,398,437,
Mayes,Corporation Commissioner,Ashley Nicole Mccray,DEM,490023,9,16,141,166,
Mayes,Corporation Commissioner,Jackie Short,IND,490023,2,1,32,35,
Mayes,U.S. House,Richard Castaldo,LIB,490023,0,1,12,13,2
Mayes,U.S. House,Markwayne Mullin,REP,490023,6,32,396,434,2
Mayes,U.S. House,Jason Nichols,DEM,490023,10,16,146,172,2
Mayes,U.S. House,John Foreman,IND,490023,1,1,23,25,2
Mayes,State House,Tom Gann,REP,490023,7,27,314,348,8
Mayes,State House,Darrell Moore,DEM,490023,10,23,262,295,8
Mayes,Governor,Chris Powell,LIB,490024,0,1,15,16,
Mayes,Governor,Kevin Stitt,REP,490024,6,12,268,286,
Mayes,Governor,Drew Edmondson,DEM,490024,3,4,102,109,
Mayes,Lieutenant Governor,Matt Pinnell,REP,490024,7,12,287,306,
Mayes,Lieutenant Governor,Anastasia Pittman,DEM,490024,2,5,81,88,
Mayes,Lieutenant Governor,Ivan Holmes,IND,490024,0,0,18,18,
Mayes,State Auditor,John Yeutter,LIB,490024,0,2,76,78,
Mayes,State Auditor,Cindy Byrd,REP,490024,8,12,290,310,
Mayes,Attorney General,Mike Hunter,REP,490024,7,12,292,311,
Mayes,Attorney General,Mark Myles,DEM,490024,2,5,92,99,
Mayes,State Treasurer,Randy Mcdaniel,REP,490024,7,12,295,314,
Mayes,State Treasurer,Charles De Coune,IND,490024,1,2,73,76,
Mayes,Superintendent of Public Instruction,Joy Hofmeister,REP,490024,5,11,242,258,
Mayes,Superintendent of Public Instruction,John Cox,DEM,490024,3,5,111,119,
Mayes,Superintendent of Public Instruction,Larry Huff,IND,490024,0,1,32,33,
Mayes,Commissioner of Labor,Leslie Osborn,REP,490024,6,12,271,289,
Mayes,Commissioner of Labor,Fred Dorrell,DEM,490024,3,4,94,101,
Mayes,Commissioner of Labor,Brandt Dismukes,IND,490024,0,1,17,18,
Mayes,Insurance Commissioner,Glen Mulready,REP,490024,6,12,290,308,
Mayes,Insurance Commissioner,Kimberly Fobbs,DEM,490024,3,5,94,102,
Mayes,Corporation Commissioner,Bob Anthony,REP,490024,5,12,275,292,
Mayes,Corporation Commissioner,Ashley Nicole Mccray,DEM,490024,2,4,85,91,
Mayes,Corporation Commissioner,Jackie Short,IND,490024,2,1,26,29,
Mayes,U.S. House,Richard Castaldo,LIB,490024,0,1,10,11,2
Mayes,U.S. House,Markwayne Mullin,REP,490024,6,12,277,295,2
Mayes,U.S. House,Jason Nichols,DEM,490024,2,4,79,85,2
Mayes,U.S. House,John Foreman,IND,490024,1,0,20,21,2
Mayes,State House,Tom Gann,REP,490024,5,10,260,275,8
Mayes,State House,Darrell Moore,DEM,490024,4,7,126,137,8
Mayes,Governor,Chris Powell,LIB,490025,2,0,10,12,
Mayes,Governor,Kevin Stitt,REP,490025,3,12,203,218,
Mayes,Governor,Drew Edmondson,DEM,490025,4,7,100,111,
Mayes,Lieutenant Governor,Matt Pinnell,REP,490025,5,13,214,232,
Mayes,Lieutenant Governor,Anastasia Pittman,DEM,490025,2,6,79,87,
Mayes,Lieutenant Governor,Ivan Holmes,IND,490025,1,0,19,20,
Mayes,State Auditor,John Yeutter,LIB,490025,2,5,64,71,
Mayes,State Auditor,Cindy Byrd,REP,490025,7,13,232,252,
Mayes,Attorney General,Mike Hunter,REP,490025,5,13,225,243,
Mayes,Attorney General,Mark Myles,DEM,490025,3,6,86,95,
Mayes,State Treasurer,Randy Mcdaniel,REP,490025,4,12,226,242,
Mayes,State Treasurer,Charles De Coune,IND,490025,4,5,69,78,
Mayes,Superintendent of Public Instruction,Joy Hofmeister,REP,490025,4,8,163,175,
Mayes,Superintendent of Public Instruction,John Cox,DEM,490025,4,11,127,142,
Mayes,Superintendent of Public Instruction,Larry Huff,IND,490025,0,0,22,22,
Mayes,Commissioner of Labor,Leslie Osborn,REP,490025,4,12,212,228,
Mayes,Commissioner of Labor,Fred Dorrell,DEM,490025,3,7,84,94,
Mayes,Commissioner of Labor,Brandt Dismukes,IND,490025,2,0,12,14,
Mayes,Insurance Commissioner,Glen Mulready,REP,490025,5,12,210,227,
Mayes,Insurance Commissioner,Kimberly Fobbs,DEM,490025,3,6,100,109,
Mayes,Corporation Commissioner,Bob Anthony,REP,490025,4,11,205,220,
Mayes,Corporation Commissioner,Ashley Nicole Mccray,DEM,490025,1,8,82,91,
Mayes,Corporation Commissioner,Jackie Short,IND,490025,3,0,23,26,
Mayes,U.S. House,Richard Castaldo,LIB,490025,1,0,6,7,2
Mayes,U.S. House,Markwayne Mullin,REP,490025,6,14,212,232,2
Mayes,U.S. House,Jason Nichols,DEM,490025,2,5,81,88,2
Mayes,U.S. House,John Foreman,IND,490025,0,0,13,13,2
Mayes,State Senate,Kim David,REP,490025,5,11,205,221,18
Mayes,State Senate,Charles Arnall,DEM,490025,2,8,104,114,18
Mayes,State House,Tom Gann,REP,490025,5,12,201,218,8
Mayes,State House,Darrell Moore,DEM,490025,4,7,111,122,8
Mayes,Governor,Chris Powell,LIB,490026,0,0,0,0,
Mayes,Governor,Kevin Stitt,REP,490026,1,0,36,37,
Mayes,Governor,Drew Edmondson,DEM,490026,1,0,11,12,
Mayes,Lieutenant Governor,Matt Pinnell,REP,490026,1,0,38,39,
Mayes,Lieutenant Governor,Anastasia Pittman,DEM,490026,1,0,9,10,
Mayes,Lieutenant Governor,Ivan Holmes,IND,490026,0,0,0,0,
Mayes,State Auditor,John Yeutter,LIB,490026,0,0,4,4,
Mayes,State Auditor,Cindy Byrd,REP,490026,1,0,39,40,
Mayes,Attorney General,Mike Hunter,REP,490026,1,0,42,43,
Mayes,Attorney General,Mark Myles,DEM,490026,1,0,5,6,
Mayes,State Treasurer,Randy Mcdaniel,REP,490026,1,0,42,43,
Mayes,State Treasurer,Charles De Coune,IND,490026,0,0,1,1,
Mayes,Superintendent of Public Instruction,Joy Hofmeister,REP,490026,0,0,33,33,
Mayes,Superintendent of Public Instruction,John Cox,DEM,490026,1,0,12,13,
Mayes,Superintendent of Public Instruction,Larry Huff,IND,490026,1,0,2,3,
Mayes,Commissioner of Labor,Leslie Osborn,REP,490026,0,0,36,36,
Mayes,Commissioner of Labor,Fred Dorrell,DEM,490026,1,0,9,10,
Mayes,Commissioner of Labor,Brandt Dismukes,IND,490026,1,0,0,1,
Mayes,Insurance Commissioner,Glen Mulready,REP,490026,1,0,36,37,
Mayes,Insurance Commissioner,Kimberly Fobbs,DEM,490026,1,0,10,11,
Mayes,Corporation Commissioner,Bob Anthony,REP,490026,1,0,39,40,
Mayes,Corporation Commissioner,Ashley Nicole Mccray,DEM,490026,1,0,7,8,
Mayes,Corporation Commissioner,Jackie Short,IND,490026,0,0,0,0,
Mayes,U.S. House,Richard Castaldo,LIB,490026,0,0,0,0,2
Mayes,U.S. House,Markwayne Mullin,REP,490026,1,0,39,40,2
Mayes,U.S. House,Jason Nichols,DEM,490026,1,0,8,9,2
Mayes,U.S. House,John Foreman,IND,490026,0,0,0,0,2
Mayes,State House,Tom Gann,REP,490026,1,0,36,37,8
Mayes,State House,Darrell Moore,DEM,490026,1,0,11,12,8
Mayes,Governor,Chris Powell,LIB,490027,0,0,1,1,
Mayes,Governor,Kevin Stitt,REP,490027,0,0,34,34,
Mayes,Governor,Drew Edmondson,DEM,490027,0,0,19,19,
Mayes,Lieutenant Governor,Matt Pinnell,REP,490027,0,0,36,36,
Mayes,Lieutenant Governor,Anastasia Pittman,DEM,490027,0,0,17,17,
Mayes,Lieutenant Governor,Ivan Holmes,IND,490027,0,0,1,1,
Mayes,State Auditor,John Yeutter,LIB,490027,0,0,11,11,
Mayes,State Auditor,Cindy Byrd,REP,490027,0,0,39,39,
Mayes,Attorney General,Mike Hunter,REP,490027,0,0,37,37,
Mayes,Attorney General,Mark Myles,DEM,490027,0,0,17,17,
Mayes,State Treasurer,Randy Mcdaniel,REP,490027,0,0,36,36,
Mayes,State Treasurer,Charles De Coune,IND,490027,0,0,14,14,
Mayes,Superintendent of Public Instruction,Joy Hofmeister,REP,490027,0,0,24,24,
Mayes,Superintendent of Public Instruction,John Cox,DEM,490027,0,0,22,22,
Mayes,Superintendent of Public Instruction,Larry Huff,IND,490027,0,0,8,8,
Mayes,Commissioner of Labor,Leslie Osborn,REP,490027,0,0,37,37,
Mayes,Commissioner of Labor,Fred Dorrell,DEM,490027,0,0,13,13,
Mayes,Commissioner of Labor,Brandt Dismukes,IND,490027,0,0,4,4,
Mayes,Insurance Commissioner,Glen Mulready,REP,490027,0,0,38,38,
Mayes,Insurance Commissioner,Kimberly Fobbs,DEM,490027,0,0,16,16,
Mayes,Corporation Commissioner,Bob Anthony,REP,490027,0,0,32,32,
Mayes,Corporation Commissioner,Ashley Nicole Mccray,DEM,490027,0,0,15,15,
Mayes,Corporation Commissioner,Jackie Short,IND,490027,0,0,7,7,
Mayes,U.S. House,Richard Castaldo,LIB,490027,0,0,2,2,2
Mayes,U.S. House,Markwayne Mullin,REP,490027,0,0,34,34,2
Mayes,U.S. House,Jason Nichols,DEM,490027,0,0,14,14,2
Mayes,U.S. House,John Foreman,IND,490027,0,0,4,4,2
Mayes,State Senate,Kim David,REP,490027,0,0,38,38,18
Mayes,State Senate,Charles Arnall,DEM,490027,0,0,15,15,18
Mayes,State House,Tom Gann,REP,490027,0,0,34,34,8
Mayes,State House,Darrell Moore,DEM,490027,0,0,20,20,8
Mayes,Governor,Chris Powell,LIB,490031,2,1,23,26,
Mayes,Governor,Kevin Stitt,REP,490031,18,10,428,456,
Mayes,Governor,Drew Edmondson,DEM,490031,8,9,229,246,
Mayes,Lieutenant Governor,Matt Pinnell,REP,490031,20,11,475,506,
Mayes,Lieutenant Governor,Anastasia Pittman,DEM,490031,6,9,183,198,
Mayes,Lieutenant Governor,Ivan Holmes,IND,490031,2,0,20,22,
Mayes,State Auditor,John Yeutter,LIB,490031,4,2,135,141,
Mayes,State Auditor,Cindy Byrd,REP,490031,21,16,506,543,
Mayes,Attorney General,Mike Hunter,REP,490031,21,11,492,524,
Mayes,Attorney General,Mark Myles,DEM,490031,8,9,185,202,
Mayes,State Treasurer,Randy Mcdaniel,REP,490031,22,16,507,545,
Mayes,State Treasurer,Charles De Coune,IND,490031,3,2,127,132,
Mayes,Superintendent of Public Instruction,Joy Hofmeister,REP,490031,21,9,424,454,
Mayes,Superintendent of Public Instruction,John Cox,DEM,490031,7,7,201,215,
Mayes,Superintendent of Public Instruction,Larry Huff,IND,490031,1,4,55,60,
Mayes,Commissioner of Labor,Leslie Osborn,REP,490031,22,11,454,487,
Mayes,Commissioner of Labor,Fred Dorrell,DEM,490031,7,8,191,206,
Mayes,Commissioner of Labor,Brandt Dismukes,IND,490031,0,1,29,30,
Mayes,Insurance Commissioner,Glen Mulready,REP,490031,21,9,476,506,
Mayes,Insurance Commissioner,Kimberly Fobbs,DEM,490031,8,11,196,215,
Mayes,Corporation Commissioner,Bob Anthony,REP,490031,20,9,447,476,
Mayes,Corporation Commissioner,Ashley Nicole Mccray,DEM,490031,7,9,186,202,
Mayes,Corporation Commissioner,Jackie Short,IND,490031,1,1,39,41,
Mayes,U.S. House,Richard Castaldo,LIB,490031,1,0,13,14,2
Mayes,U.S. House,Markwayne Mullin,REP,490031,20,11,470,501,2
Mayes,U.S. House,Jason Nichols,DEM,490031,7,9,186,202,2
Mayes,U.S. House,John Foreman,IND,490031,1,0,11,12,2
Mayes,State House,Josh West,REP,490031,22,12,472,506,5
Mayes,State House,Ed Trumbull,DEM,490031,7,8,207,222,5
Mayes,Governor,Chris Powell,LIB,490034,2,0,15,17,
Mayes,Governor,Kevin Stitt,REP,490034,3,5,180,188,
Mayes,Governor,Drew Edmondson,DEM,490034,8,6,109,123,
Mayes,Lieutenant Governor,Matt Pinnell,REP,490034,5,5,199,209,
Mayes,Lieutenant Governor,Anastasia Pittman,DEM,490034,4,6,92,102,
Mayes,Lieutenant Governor,Ivan Holmes,IND,490034,3,0,11,14,
Mayes,State Auditor,John Yeutter,LIB,490034,2,3,60,65,
Mayes,State Auditor,Cindy Byrd,REP,490034,7,6,220,233,
Mayes,Attorney General,Mike Hunter,REP,490034,7,5,207,219,
Mayes,Attorney General,Mark Myles,DEM,490034,6,6,95,107,
Mayes,State Treasurer,Randy Mcdaniel,REP,490034,9,5,212,226,
Mayes,State Treasurer,Charles De Coune,IND,490034,1,3,69,73,
Mayes,Superintendent of Public Instruction,Joy Hofmeister,REP,490034,4,4,153,161,
Mayes,Superintendent of Public Instruction,John Cox,DEM,490034,8,5,126,139,
Mayes,Superintendent of Public Instruction,Larry Huff,IND,490034,1,1,24,26,
Mayes,Commissioner of Labor,Leslie Osborn,REP,490034,7,5,186,198,
Mayes,Commissioner of Labor,Fred Dorrell,DEM,490034,6,5,95,106,
Mayes,Commissioner of Labor,Brandt Dismukes,IND,490034,0,0,18,18,
Mayes,Insurance Commissioner,Glen Mulready,REP,490034,6,5,196,207,
Mayes,Insurance Commissioner,Kimberly Fobbs,DEM,490034,7,5,102,114,
Mayes,Corporation Commissioner,Bob Anthony,REP,490034,6,4,185,195,
Mayes,Corporation Commissioner,Ashley Nicole Mccray,DEM,490034,5,6,89,100,
Mayes,Corporation Commissioner,Jackie Short,IND,490034,2,0,25,27,
Mayes,U.S. House,Richard Castaldo,LIB,490034,0,0,3,3,2
Mayes,U.S. House,Markwayne Mullin,REP,490034,7,6,198,211,2
Mayes,U.S. House,Jason Nichols,DEM,490034,5,5,85,95,2
Mayes,U.S. House,John Foreman,IND,490034,1,0,17,18,2
Mayes,State House,Josh West,REP,490034,6,5,197,208,5
Mayes,State House,Ed Trumbull,DEM,490034,6,6,103,115,5
Mayes,Governor,Chris Powell,LIB,490036,1,1,41,43,
Mayes,Governor,Kevin Stitt,REP,490036,13,25,542,580,
Mayes,Governor,Drew Edmondson,DEM,490036,15,19,379,413,
Mayes,Lieutenant Governor,Matt Pinnell,REP,490036,16,25,619,660,
Mayes,Lieutenant Governor,Anastasia Pittman,DEM,490036,9,20,303,332,
Mayes,Lieutenant Governor,Ivan Holmes,IND,490036,4,0,28,32,
Mayes,State Auditor,John Yeutter,LIB,490036,11,10,195,216,
Mayes,State Auditor,Cindy Byrd,REP,490036,18,32,671,721,
Mayes,Attorney General,Mike Hunter,REP,490036,14,28,631,673,
Mayes,Attorney General,Mark Myles,DEM,490036,15,17,315,347,
Mayes,State Treasurer,Randy Mcdaniel,REP,490036,19,33,678,730,
Mayes,State Treasurer,Charles De Coune,IND,490036,10,10,189,209,
Mayes,Superintendent of Public Instruction,Joy Hofmeister,REP,490036,12,21,437,470,
Mayes,Superintendent of Public Instruction,John Cox,DEM,490036,15,21,448,484,
Mayes,Superintendent of Public Instruction,Larry Huff,IND,490036,2,3,70,75,
Mayes,Commissioner of Labor,Leslie Osborn,REP,490036,16,25,570,611,
Mayes,Commissioner of Labor,Fred Dorrell,DEM,490036,9,19,324,352,
Mayes,Commissioner of Labor,Brandt Dismukes,IND,490036,4,1,48,53,
Mayes,Insurance Commissioner,Glen Mulready,REP,490036,18,27,605,650,
Mayes,Insurance Commissioner,Kimberly Fobbs,DEM,490036,11,18,337,366,
Mayes,Corporation Commissioner,Bob Anthony,REP,490036,14,28,588,630,
Mayes,Corporation Commissioner,Ashley Nicole Mccray,DEM,490036,10,16,308,334,
Mayes,Corporation Commissioner,Jackie Short,IND,490036,5,1,54,60,
Mayes,U.S. House,Richard Castaldo,LIB,490036,1,1,23,25,2
Mayes,U.S. House,Markwayne Mullin,REP,490036,16,29,607,652,2
Mayes,U.S. House,Jason Nichols,DEM,490036,12,14,301,327,2
Mayes,U.S. House,John Foreman,IND,490036,0,0,27,27,2
Mayes,State House,Josh West,REP,490036,17,24,595,636,5
Mayes,State House,Ed Trumbull,DEM,490036,12,20,356,388,5
Mayes,Governor,Chris Powell,LIB,490037,0,1,21,22,
Mayes,Governor,Kevin Stitt,REP,490037,9,19,372,400,
Mayes,Governor,Drew Edmondson,DEM,490037,5,4,160,169,
Mayes,Lieutenant Governor,Matt Pinnell,REP,490037,10,21,389,420,
Mayes,Lieutenant Governor,Anastasia Pittman,DEM,490037,4,3,142,149,
Mayes,Lieutenant Governor,Ivan Holmes,IND,490037,0,0,18,18,
Mayes,State Auditor,John Yeutter,LIB,490037,3,6,103,112,
Mayes,State Auditor,Cindy Byrd,REP,490037,11,16,413,440,
Mayes,Attorney General,Mike Hunter,REP,490037,11,21,402,434,
Mayes,Attorney General,Mark Myles,DEM,490037,3,3,145,151,
Mayes,State Treasurer,Randy Mcdaniel,REP,490037,10,19,422,451,
Mayes,State Treasurer,Charles De Coune,IND,490037,4,4,91,99,
Mayes,Superintendent of Public Instruction,Joy Hofmeister,REP,490037,9,10,268,287,
Mayes,Superintendent of Public Instruction,John Cox,DEM,490037,4,13,253,270,
Mayes,Superintendent of Public Instruction,Larry Huff,IND,490037,1,1,31,33,
Mayes,Commissioner of Labor,Leslie Osborn,REP,490037,10,19,370,399,
Mayes,Commissioner of Labor,Fred Dorrell,DEM,490037,2,2,153,157,
Mayes,Commissioner of Labor,Brandt Dismukes,IND,490037,1,3,23,27,
Mayes,Insurance Commissioner,Glen Mulready,REP,490037,12,20,386,418,
Mayes,Insurance Commissioner,Kimberly Fobbs,DEM,490037,2,4,162,168,
Mayes,Corporation Commissioner,Bob Anthony,REP,490037,11,20,363,394,
Mayes,Corporation Commissioner,Ashley Nicole Mccray,DEM,490037,2,3,152,157,
Mayes,Corporation Commissioner,Jackie Short,IND,490037,1,1,33,35,
Mayes,U.S. House,Richard Castaldo,LIB,490037,1,1,6,8,2
Mayes,U.S. House,Markwayne Mullin,REP,490037,11,18,387,416,2
Mayes,U.S. House,Jason Nichols,DEM,490037,2,5,140,147,2
Mayes,U.S. House,John Foreman,IND,490037,0,0,17,17,2
Mayes,State House,Tom Gann,REP,490037,12,19,339,370,8
Mayes,State House,Darrell Moore,DEM,490037,2,5,211,218,8
Mayes,Governor,Chris Powell,LIB,490038,0,0,9,9,
Mayes,Governor,Kevin Stitt,REP,490038,1,10,129,140,
Mayes,Governor,Drew Edmondson,DEM,490038,4,5,77,86,
Mayes,Lieutenant Governor,Matt Pinnell,REP,490038,1,12,140,153,
Mayes,Lieutenant Governor,Anastasia Pittman,DEM,490038,4,2,65,71,
Mayes,Lieutenant Governor,Ivan Holmes,IND,490038,0,1,9,10,
Mayes,State Auditor,John Yeutter,LIB,490038,5,2,39,46,
Mayes,State Auditor,Cindy Byrd,REP,490038,0,13,157,170,
Mayes,Attorney General,Mike Hunter,REP,490038,1,13,147,161,
Mayes,Attorney General,Mark Myles,DEM,490038,4,2,67,73,
Mayes,State Treasurer,Randy Mcdaniel,REP,490038,1,15,161,177,
Mayes,State Treasurer,Charles De Coune,IND,490038,4,0,37,41,
Mayes,Superintendent of Public Instruction,Joy Hofmeister,REP,490038,0,9,94,103,
Mayes,Superintendent of Public Instruction,John Cox,DEM,490038,4,6,109,119,
Mayes,Superintendent of Public Instruction,Larry Huff,IND,490038,1,0,11,12,
Mayes,Commissioner of Labor,Leslie Osborn,REP,490038,1,13,140,154,
Mayes,Commissioner of Labor,Fred Dorrell,DEM,490038,4,2,64,70,
Mayes,Commissioner of Labor,Brandt Dismukes,IND,490038,0,0,8,8,
Mayes,Insurance Commissioner,Glen Mulready,REP,490038,1,13,146,160,
Mayes,Insurance Commissioner,Kimberly Fobbs,DEM,490038,4,2,66,72,
Mayes,Corporation Commissioner,Bob Anthony,REP,490038,1,10,143,154,
Mayes,Corporation Commissioner,Ashley Nicole Mccray,DEM,490038,4,4,64,72,
Mayes,Corporation Commissioner,Jackie Short,IND,490038,0,1,6,7,
Mayes,U.S. House,Richard Castaldo,LIB,490038,0,0,3,3,2
Mayes,U.S. House,Markwayne Mullin,REP,490038,1,12,133,146,2
Mayes,U.S. House,Jason Nichols,DEM,490038,4,2,70,76,2
Mayes,U.S. House,John Foreman,IND,490038,0,1,6,7,2
Mayes,State House,Tom Gann,REP,490038,1,10,123,134,8
Mayes,State House,Darrell Moore,DEM,490038,4,5,90,99,8
Mayes,Governor,Chris Powell,LIB,490039,0,3,18,21,
Mayes,Governor,Kevin Stitt,REP,490039,7,30,314,351,
Mayes,Governor,Drew Edmondson,DEM,490039,6,9,252,267,
Mayes,Lieutenant Governor,Matt Pinnell,REP,490039,7,32,344,383,
Mayes,Lieutenant Governor,Anastasia Pittman,DEM,490039,4,7,213,224,
Mayes,Lieutenant Governor,Ivan Holmes,IND,490039,0,3,22,25,
Mayes,State Auditor,John Yeutter,LIB,490039,4,6,148,158,
Mayes,State Auditor,Cindy Byrd,REP,490039,8,34,397,439,
Mayes,Attorney General,Mike Hunter,REP,490039,9,34,345,388,
Mayes,Attorney General,Mark Myles,DEM,490039,3,7,234,244,
Mayes,State Treasurer,Randy Mcdaniel,REP,490039,9,36,397,442,
Mayes,State Treasurer,Charles De Coune,IND,490039,3,4,146,153,
Mayes,Superintendent of Public Instruction,Joy Hofmeister,REP,490039,8,21,223,252,
Mayes,Superintendent of Public Instruction,John Cox,DEM,490039,5,17,320,342,
Mayes,Superintendent of Public Instruction,Larry Huff,IND,490039,0,3,36,39,
Mayes,Commissioner of Labor,Leslie Osborn,REP,490039,8,31,322,361,
Mayes,Commissioner of Labor,Fred Dorrell,DEM,490039,4,9,227,240,
Mayes,Commissioner of Labor,Brandt Dismukes,IND,490039,0,1,29,30,
Mayes,Insurance Commissioner,Glen Mulready,REP,490039,8,32,328,368,
Mayes,Insurance Commissioner,Kimberly Fobbs,DEM,490039,3,8,246,257,
Mayes,Corporation Commissioner,Bob Anthony,REP,490039,9,33,328,370,
Mayes,Corporation Commissioner,Ashley Nicole Mccray,DEM,490039,4,6,221,231,
Mayes,Corporation Commissioner,Jackie Short,IND,490039,0,2,28,30,
Mayes,U.S. House,Richard Castaldo,LIB,490039,0,1,6,7,2
Mayes,U.S. House,Markwayne Mullin,REP,490039,8,34,347,389,2
Mayes,U.S. House,Jason Nichols,DEM,490039,5,6,210,221,2
Mayes,U.S. House,John Foreman,IND,490039,0,1,15,16,2
Mayes,State House,Tom Gann,REP,490039,8,27,279,314,8
Mayes,State House,Darrell Moore,DEM,490039,5,15,299,319,8
Mayes,Governor,Chris Powell,LIB,490101,0,0,11,11,
Mayes,Governor,Kevin Stitt,REP,490101,3,22,164,189,
Mayes,Governor,Drew Edmondson,DEM,490101,8,19,126,153,
Mayes,Lieutenant Governor,Matt Pinnell,REP,490101,5,25,184,214,
Mayes,Lieutenant Governor,Anastasia Pittman,DEM,490101,5,16,103,124,
Mayes,Lieutenant Governor,Ivan Holmes,IND,490101,0,0,10,10,
Mayes,State Auditor,John Yeutter,LIB,490101,2,8,73,83,
Mayes,State Auditor,Cindy Byrd,REP,490101,5,26,205,236,
Mayes,Attorney General,Mike Hunter,REP,490101,3,23,185,211,
Mayes,Attorney General,Mark Myles,DEM,490101,6,18,112,136,
Mayes,State Treasurer,Randy Mcdaniel,REP,490101,4,26,209,239,
Mayes,State Treasurer,Charles De Coune,IND,490101,3,8,68,79,
Mayes,Superintendent of Public Instruction,Joy Hofmeister,REP,490101,4,19,149,172,
Mayes,Superintendent of Public Instruction,John Cox,DEM,490101,7,18,123,148,
Mayes,Superintendent of Public Instruction,Larry Huff,IND,490101,0,4,31,35,
Mayes,Commissioner of Labor,Leslie Osborn,REP,490101,3,24,167,194,
Mayes,Commissioner of Labor,Fred Dorrell,DEM,490101,7,16,111,134,
Mayes,Commissioner of Labor,Brandt Dismukes,IND,490101,0,1,14,15,
Mayes,Insurance Commissioner,Glen Mulready,REP,490101,4,24,177,205,
Mayes,Insurance Commissioner,Kimberly Fobbs,DEM,490101,6,16,115,137,
Mayes,Corporation Commissioner,Bob Anthony,REP,490101,5,28,168,201,
Mayes,Corporation Commissioner,Ashley Nicole Mccray,DEM,490101,5,12,103,120,
Mayes,Corporation Commissioner,Jackie Short,IND,490101,0,1,23,24,
Mayes,U.S. House,Richard Castaldo,LIB,490101,0,0,5,5,2
Mayes,U.S. House,Markwayne Mullin,REP,490101,4,23,187,214,2
Mayes,U.S. House,Jason Nichols,DEM,490101,5,16,98,119,2
Mayes,U.S. House,John Foreman,IND,490101,0,1,12,13,2
Mayes,State Senate,Marty Quinn,REP,490101,5,22,165,192,2
Mayes,State Senate,Jennifer Esau,DEM,490101,5,19,133,157,2
Mayes,State House,Tom Gann,REP,490101,2,17,131,150,8
Mayes,State House,Darrell Moore,DEM,490101,9,24,170,203,8
Mayes,Governor,Chris Powell,LIB,490121,0,3,27,30,
Mayes,Governor,Kevin Stitt,REP,490121,13,46,345,404,
Mayes,Governor,Drew Edmondson,DEM,490121,7,34,250,291,
Mayes,Lieutenant Governor,Matt Pinnell,REP,490121,14,52,401,467,
Mayes,Lieutenant Governor,Anastasia Pittman,DEM,490121,5,28,190,223,
Mayes,Lieutenant Governor,Ivan Holmes,IND,490121,0,3,26,29,
Mayes,State Auditor,John Yeutter,LIB,490121,3,17,137,157,
Mayes,State Auditor,Cindy Byrd,REP,490121,15,59,442,516,
Mayes,Attorney General,Mike Hunter,REP,490121,14,58,407,479,
Mayes,Attorney General,Mark Myles,DEM,490121,5,24,207,236,
Mayes,State Treasurer,Randy Mcdaniel,REP,490121,15,62,434,511,
Mayes,State Treasurer,Charles De Coune,IND,490121,2,15,135,152,
Mayes,Superintendent of Public Instruction,Joy Hofmeister,REP,490121,14,41,318,373,
Mayes,Superintendent of Public Instruction,John Cox,DEM,490121,6,33,265,304,
Mayes,Superintendent of Public Instruction,Larry Huff,IND,490121,0,8,34,42,
Mayes,Commissioner of Labor,Leslie Osborn,REP,490121,13,49,376,438,
Mayes,Commissioner of Labor,Fred Dorrell,DEM,490121,6,31,211,248,
Mayes,Commissioner of Labor,Brandt Dismukes,IND,490121,1,2,25,28,
Mayes,Insurance Commissioner,Glen Mulready,REP,490121,15,52,390,457,
Mayes,Insurance Commissioner,Kimberly Fobbs,DEM,490121,5,27,225,257,
Mayes,Corporation Commissioner,Bob Anthony,REP,490121,15,50,386,451,
Mayes,Corporation Commissioner,Ashley Nicole Mccray,DEM,490121,3,22,195,220,
Mayes,Corporation Commissioner,Jackie Short,IND,490121,2,7,31,40,
Mayes,U.S. House,Richard Castaldo,LIB,490121,0,3,9,12,2
Mayes,U.S. House,Markwayne Mullin,REP,490121,14,56,392,462,2
Mayes,U.S. House,Jason Nichols,DEM,490121,6,20,202,228,2
Mayes,U.S. House,John Foreman,IND,490121,0,3,16,19,2
Mayes,State Senate,Marty Quinn,REP,490121,14,49,376,439,2
Mayes,State Senate,Jennifer Esau,DEM,490121,6,33,239,278,2
Mayes,State House,Tom Gann,REP,490121,10,35,280,325,8
Mayes,State House,Darrell Moore,DEM,490121,10,47,341,398,8
Mayes,Governor,Chris Powell,LIB,490122,0,0,3,3,
Mayes,Governor,Kevin Stitt,REP,490122,2,5,58,65,
Mayes,Governor,Drew Edmondson,DEM,490122,0,2,19,21,
Mayes,Lieutenant Governor,Matt Pinnell,REP,490122,2,5,63,70,
Mayes,Lieutenant Governor,Anastasia Pittman,DEM,490122,0,2,15,17,
Mayes,Lieutenant Governor,Ivan Holmes,IND,490122,0,0,2,2,
Mayes,State Auditor,John Yeutter,LIB,490122,0,1,8,9,
Mayes,State Auditor,Cindy Byrd,REP,490122,2,4,67,73,
Mayes,Attorney General,Mike Hunter,REP,490122,2,5,57,64,
Mayes,Attorney General,Mark Myles,DEM,490122,0,2,21,23,
Mayes,State Treasurer,Randy Mcdaniel,REP,490122,2,5,67,74,
Mayes,State Treasurer,Charles De Coune,IND,490122,0,0,11,11,
Mayes,Superintendent of Public Instruction,Joy Hofmeister,REP,490122,2,3,37,42,
Mayes,Superintendent of Public Instruction,John Cox,DEM,490122,0,4,40,44,
Mayes,Superintendent of Public Instruction,Larry Huff,IND,490122,0,0,3,3,
Mayes,Commissioner of Labor,Leslie Osborn,REP,490122,2,4,55,61,
Mayes,Commissioner of Labor,Fred Dorrell,DEM,490122,0,3,21,24,
Mayes,Commissioner of Labor,Brandt Dismukes,IND,490122,0,0,3,3,
Mayes,Insurance Commissioner,Glen Mulready,REP,490122,2,5,58,65,
Mayes,Insurance Commissioner,Kimberly Fobbs,DEM,490122,0,2,21,23,
Mayes,Corporation Commissioner,Bob Anthony,REP,490122,2,4,61,67,
Mayes,Corporation Commissioner,Ashley Nicole Mccray,DEM,490122,0,3,15,18,
Mayes,Corporation Commissioner,Jackie Short,IND,490122,0,0,4,4,
Mayes,U.S. House,Richard Castaldo,LIB,490122,0,0,0,0,2
Mayes,U.S. House,Markwayne Mullin,REP,490122,2,5,63,70,2
Mayes,U.S. House,Jason Nichols,DEM,490122,0,2,16,18,2
Mayes,U.S. House,John Foreman,IND,490122,0,0,1,1,2
Mayes,State House,Tom Gann,REP,490122,2,4,33,39,8
Mayes,State House,Darrell Moore,DEM,490122,0,3,47,50,8
Mayes,Governor,Chris Powell,LIB,490130,0,0,15,15,
Mayes,Governor,Kevin Stitt,REP,490130,11,25,266,302,
Mayes,Governor,Drew Edmondson,DEM,490130,6,12,127,145,
Mayes,Lieutenant Governor,Matt Pinnell,REP,490130,11,29,301,341,
Mayes,Lieutenant Governor,Anastasia Pittman,DEM,490130,6,6,94,106,
Mayes,Lieutenant Governor,Ivan Holmes,IND,490130,0,2,11,13,
Mayes,State Auditor,John Yeutter,LIB,490130,6,5,75,86,
Mayes,State Auditor,Cindy Byrd,REP,490130,11,30,308,349,
Mayes,Attorney General,Mike Hunter,REP,490130,12,27,297,336,
Mayes,Attorney General,Mark Myles,DEM,490130,5,9,108,122,
Mayes,State Treasurer,Randy Mcdaniel,REP,490130,11,26,316,353,
Mayes,State Treasurer,Charles De Coune,IND,490130,5,10,70,85,
Mayes,Superintendent of Public Instruction,Joy Hofmeister,REP,490130,11,19,244,274,
Mayes,Superintendent of Public Instruction,John Cox,DEM,490130,5,16,132,153,
Mayes,Superintendent of Public Instruction,Larry Huff,IND,490130,1,2,32,35,
Mayes,Commissioner of Labor,Leslie Osborn,REP,490130,11,25,283,319,
Mayes,Commissioner of Labor,Fred Dorrell,DEM,490130,4,10,105,119,
Mayes,Commissioner of Labor,Brandt Dismukes,IND,490130,2,1,18,21,
Mayes,Insurance Commissioner,Glen Mulready,REP,490130,10,28,289,327,
Mayes,Insurance Commissioner,Kimberly Fobbs,DEM,490130,6,8,117,131,
Mayes,Corporation Commissioner,Bob Anthony,REP,490130,11,24,284,319,
Mayes,Corporation Commissioner,Ashley Nicole Mccray,DEM,490130,6,10,104,120,
Mayes,Corporation Commissioner,Jackie Short,IND,490130,0,3,18,21,
Mayes,U.S. House,Richard Castaldo,LIB,490130,0,0,15,15,2
Mayes,U.S. House,Markwayne Mullin,REP,490130,11,27,285,323,2
Mayes,U.S. House,Jason Nichols,DEM,490130,5,10,99,114,2
Mayes,U.S. House,John Foreman,IND,490130,1,0,11,12,2
Mayes,State House,Josh West,REP,490130,12,31,291,334,5
Mayes,State House,Ed Trumbull,DEM,490130,5,6,114,125,5
Mayes,Governor,Chris Powell,LIB,490132,0,0,22,22,
Mayes,Governor,Kevin Stitt,REP,490132,9,41,249,299,
Mayes,Governor,Drew Edmondson,DEM,490132,9,28,186,223,
Mayes,Lieutenant Governor,Matt Pinnell,REP,490132,13,46,285,344,
Mayes,Lieutenant Governor,Anastasia Pittman,DEM,490132,5,22,155,182,
Mayes,Lieutenant Governor,Ivan Holmes,IND,490132,0,1,18,19,
Mayes,State Auditor,John Yeutter,LIB,490132,5,13,114,132,
Mayes,State Auditor,Cindy Byrd,REP,490132,11,47,312,370,
Mayes,Attorney General,Mike Hunter,REP,490132,11,46,291,348,
Mayes,Attorney General,Mark Myles,DEM,490132,7,23,165,195,
Mayes,State Treasurer,Randy Mcdaniel,REP,490132,14,51,323,388,
Mayes,State Treasurer,Charles De Coune,IND,490132,2,9,104,115,
Mayes,Superintendent of Public Instruction,Joy Hofmeister,REP,490132,10,35,205,250,
Mayes,Superintendent of Public Instruction,John Cox,DEM,490132,7,32,215,254,
Mayes,Superintendent of Public Instruction,Larry Huff,IND,490132,1,2,32,35,
Mayes,Commissioner of Labor,Leslie Osborn,REP,490132,12,41,252,305,
Mayes,Commissioner of Labor,Fred Dorrell,DEM,490132,6,27,176,209,
Mayes,Commissioner of Labor,Brandt Dismukes,IND,490132,0,0,23,23,
Mayes,Insurance Commissioner,Glen Mulready,REP,490132,10,46,264,320,
Mayes,Insurance Commissioner,Kimberly Fobbs,DEM,490132,7,23,185,215,
Mayes,Corporation Commissioner,Bob Anthony,REP,490132,9,43,260,312,
Mayes,Corporation Commissioner,Ashley Nicole Mccray,DEM,490132,8,23,161,192,
Mayes,Corporation Commissioner,Jackie Short,IND,490132,1,1,30,32,
Mayes,U.S. House,Richard Castaldo,LIB,490132,0,0,9,9,2
Mayes,U.S. House,Markwayne Mullin,REP,490132,10,48,269,327,2
Mayes,U.S. House,Jason Nichols,DEM,490132,8,21,158,187,2
Mayes,U.S. House,John Foreman,IND,490132,0,0,20,20,2
Mayes,State Senate,Marty Quinn,REP,490132,9,37,260,306,2
Mayes,State Senate,Jennifer Esau,DEM,490132,9,30,194,233,2
Mayes,State House,Tom Gann,REP,490132,9,24,201,234,8
Mayes,State House,Darrell Moore,DEM,490132,9,44,254,307,8
Mayes,Governor,Chris Powell,LIB,490241,0,3,34,37,
Mayes,Governor,Kevin Stitt,REP,490241,11,97,505,613,
Mayes,Governor,Drew Edmondson,DEM,490241,20,72,331,423,
Mayes,Lieutenant Governor,Matt Pinnell,REP,490241,13,111,572,696,
Mayes,Lieutenant Governor,Anastasia Pittman,DEM,490241,18,57,264,339,
Mayes,Lieutenant Governor,Ivan Holmes,IND,490241,0,3,30,33,
Mayes,State Auditor,John Yeutter,LIB,490241,7,26,164,197,
Mayes,State Auditor,Cindy Byrd,REP,490241,21,127,635,783,
Mayes,Attorney General,Mike Hunter,REP,490241,16,112,595,723,
Mayes,Attorney General,Mark Myles,DEM,490241,16,57,261,334,
Mayes,State Treasurer,Randy Mcdaniel,REP,490241,18,121,623,762,
Mayes,State Treasurer,Charles De Coune,IND,490241,11,34,174,219,
Mayes,Superintendent of Public Instruction,Joy Hofmeister,REP,490241,10,92,443,545,
Mayes,Superintendent of Public Instruction,John Cox,DEM,490241,22,72,354,448,
Mayes,Superintendent of Public Instruction,Larry Huff,IND,490241,0,8,68,76,
Mayes,Commissioner of Labor,Leslie Osborn,REP,490241,14,106,547,667,
Mayes,Commissioner of Labor,Fred Dorrell,DEM,490241,18,55,268,341,
Mayes,Commissioner of Labor,Brandt Dismukes,IND,490241,0,6,37,43,
Mayes,Insurance Commissioner,Glen Mulready,REP,490241,14,106,576,696,
Mayes,Insurance Commissioner,Kimberly Fobbs,DEM,490241,18,63,280,361,
Mayes,Corporation Commissioner,Bob Anthony,REP,490241,19,108,560,687,
Mayes,Corporation Commissioner,Ashley Nicole Mccray,DEM,490241,12,55,245,312,
Mayes,Corporation Commissioner,Jackie Short,IND,490241,1,9,49,59,
Mayes,U.S. House,Richard Castaldo,LIB,490241,0,3,12,15,2
Mayes,U.S. House,Markwayne Mullin,REP,490241,14,100,572,686,2
Mayes,U.S. House,Jason Nichols,DEM,490241,17,65,257,339,2
Mayes,U.S. House,John Foreman,IND,490241,1,3,27,31,2
Mayes,State Senate,Marty Quinn,REP,490241,11,95,512,618,2
Mayes,State Senate,Jennifer Esau,DEM,490241,21,76,350,447,2
Mayes,State House,Tom Gann,REP,490241,10,69,375,454,8
Mayes,State House,Darrell Moore,DEM,490241,22,103,494,619,8
Mayes,Governor,Chris Powell,LIB,490242,1,5,25,31,
Mayes,Governor,Kevin Stitt,REP,490242,2,28,302,332,
Mayes,Governor,Drew Edmondson,DEM,490242,11,34,217,262,
Mayes,Lieutenant Governor,Matt Pinnell,REP,490242,4,40,364,408,
Mayes,Lieutenant Governor,Anastasia Pittman,DEM,490242,8,23,161,192,
Mayes,Lieutenant Governor,Ivan Holmes,IND,490242,2,4,17,23,
Mayes,State Auditor,John Yeutter,LIB,490242,6,13,110,129,
Mayes,State Auditor,Cindy Byrd,REP,490242,5,46,398,449,
Mayes,Attorney General,Mike Hunter,REP,490242,4,38,374,416,
Mayes,Attorney General,Mark Myles,DEM,490242,10,29,163,202,
Mayes,State Treasurer,Randy Mcdaniel,REP,490242,6,42,399,447,
Mayes,State Treasurer,Charles De Coune,IND,490242,7,17,109,133,
Mayes,Superintendent of Public Instruction,Joy Hofmeister,REP,490242,6,32,276,314,
Mayes,Superintendent of Public Instruction,John Cox,DEM,490242,7,31,222,260,
Mayes,Superintendent of Public Instruction,Larry Huff,IND,490242,1,4,43,48,
Mayes,Commissioner of Labor,Leslie Osborn,REP,490242,5,37,349,391,
Mayes,Commissioner of Labor,Fred Dorrell,DEM,490242,8,25,165,198,
Mayes,Commissioner of Labor,Brandt Dismukes,IND,490242,1,3,23,27,
Mayes,Insurance Commissioner,Glen Mulready,REP,490242,3,39,359,401,
Mayes,Insurance Commissioner,Kimberly Fobbs,DEM,490242,11,26,172,209,
Mayes,Corporation Commissioner,Bob Anthony,REP,490242,5,37,348,390,
Mayes,Corporation Commissioner,Ashley Nicole Mccray,DEM,490242,8,25,159,192,
Mayes,Corporation Commissioner,Jackie Short,IND,490242,1,5,27,33,
Mayes,U.S. House,Richard Castaldo,LIB,490242,0,2,16,18,2
Mayes,U.S. House,Markwayne Mullin,REP,490242,2,37,352,391,2
Mayes,U.S. House,Jason Nichols,DEM,490242,12,27,166,205,2
Mayes,U.S. House,John Foreman,IND,490242,0,1,9,10,2
Mayes,State Senate,Marty Quinn,REP,490242,3,32,338,373,2
Mayes,State Senate,Jennifer Esau,DEM,490242,11,33,202,246,2
Mayes,State House,Tom Gann,REP,490242,3,23,249,275,8
Mayes,State House,Darrell Moore,DEM,490242,11,43,296,350,8
Mayes,Governor,Chris Powell,LIB,490311,0,0,5,5,
Mayes,Governor,Kevin Stitt,REP,490311,4,4,201,209,
Mayes,Governor,Drew Edmondson,DEM,490311,2,6,95,103,
Mayes,Lieutenant Governor,Matt Pinnell,REP,490311,4,4,207,215,
Mayes,Lieutenant Governor,Anastasia Pittman,DEM,490311,2,5,80,87,
Mayes,Lieutenant Governor,Ivan Holmes,IND,490311,0,1,12,13,
Mayes,State Auditor,John Yeutter,LIB,490311,2,5,57,64,
Mayes,State Auditor,Cindy Byrd,REP,490311,4,4,223,231,
Mayes,Attorney General,Mike Hunter,REP,490311,4,4,219,227,
Mayes,Attorney General,Mark Myles,DEM,490311,2,6,78,86,
Mayes,State Treasurer,Randy Mcdaniel,REP,490311,4,4,227,235,
Mayes,State Treasurer,Charles De Coune,IND,490311,2,5,52,59,
Mayes,Superintendent of Public Instruction,Joy Hofmeister,REP,490311,2,3,140,145,
Mayes,Superintendent of Public Instruction,John Cox,DEM,490311,4,7,147,158,
Mayes,Superintendent of Public Instruction,Larry Huff,IND,490311,0,0,13,13,
Mayes,Commissioner of Labor,Leslie Osborn,REP,490311,4,4,193,201,
Mayes,Commissioner of Labor,Fred Dorrell,DEM,490311,2,6,90,98,
Mayes,Commissioner of Labor,Brandt Dismukes,IND,490311,0,0,16,16,
Mayes,Insurance Commissioner,Glen Mulready,REP,490311,4,4,205,213,
Mayes,Insurance Commissioner,Kimberly Fobbs,DEM,490311,2,6,93,101,
Mayes,Corporation Commissioner,Bob Anthony,REP,490311,4,4,198,206,
Mayes,Corporation Commissioner,Ashley Nicole Mccray,DEM,490311,2,5,77,84,
Mayes,Corporation Commissioner,Jackie Short,IND,490311,0,1,21,22,
Mayes,U.S. House,Richard Castaldo,LIB,490311,0,0,9,9,2
Mayes,U.S. House,Markwayne Mullin,REP,490311,3,3,203,209,2
Mayes,U.S. House,Jason Nichols,DEM,490311,3,6,79,88,2
Mayes,U.S. House,John Foreman,IND,490311,0,1,11,12,2
Mayes,State Senate,Kim David,REP,490311,4,4,214,222,18
Mayes,State Senate,Charles Arnall,DEM,490311,2,6,78,86,18
Mayes,State House,Tom Gann,REP,490311,4,3,187,194,8
Mayes,State House,Darrell Moore,DEM,490311,2,6,110,118,8
Murray,Governor,Chris Powell,LIB,500004,1,1,17,19,
Murray,Governor,Kevin Stitt,REP,500004,16,56,381,453,
Murray,Governor,Drew Edmondson,DEM,500004,10,31,141,182,
Murray,Lieutenant Governor,Matt Pinnell,REP,500004,17,61,415,493,
Murray,Lieutenant Governor,Anastasia Pittman,DEM,500004,7,25,103,135,
Murray,Lieutenant Governor,Ivan Holmes,IND,500004,3,1,17,21,
Murray,State Auditor,John Yeutter,LIB,500004,9,10,70,89,
Murray,State Auditor,Cindy Byrd,REP,500004,16,71,441,528,
Murray,Attorney General,Mike Hunter,REP,500004,17,67,429,513,
Murray,Attorney General,Mark Myles,DEM,500004,10,21,103,134,
Murray,State Treasurer,Randy Mcdaniel,REP,500004,17,72,433,522,
Murray,State Treasurer,Charles De Coune,IND,500004,9,10,77,96,
Murray,Superintendent of Public Instruction,Joy Hofmeister,REP,500004,16,64,381,461,
Murray,Superintendent of Public Instruction,John Cox,DEM,500004,8,22,111,141,
Murray,Superintendent of Public Instruction,Larry Huff,IND,500004,3,1,41,45,
Murray,Commissioner of Labor,Leslie Osborn,REP,500004,16,61,403,480,
Murray,Commissioner of Labor,Fred Dorrell,DEM,500004,9,21,102,132,
Murray,Commissioner of Labor,Brandt Dismukes,IND,500004,2,4,23,29,
Murray,Insurance Commissioner,Glen Mulready,REP,500004,18,61,406,485,
Murray,Insurance Commissioner,Kimberly Fobbs,DEM,500004,9,26,129,164,
Murray,Corporation Commissioner,Bob Anthony,REP,500004,15,59,390,464,
Murray,Corporation Commissioner,Ashley Nicole Mccray,DEM,500004,8,26,118,152,
Murray,Corporation Commissioner,Jackie Short,IND,500004,4,2,26,32,
Murray,U.S. House,Tom Cole,REP,500004,17,66,434,517,4
Murray,U.S. House,Mary Brannon,DEM,500004,8,21,84,113,4
Murray,U.S. House,Ruby Peters,IND,500004,1,1,18,20,4
Murray,State Senate,Frank Simpson,REP,500004,18,66,418,502,14
Murray,State Senate,Justin Arledge,DEM,500004,9,22,116,147,14
Murray,State House,Charles Mccall,REP,500004,14,56,345,415,22
Murray,State House,Wayne Eidson,DEM,500004,11,29,173,213,22
Murray,State House,Renae Ward,IND,500004,2,3,20,25,22
Murray,Governor,Chris Powell,LIB,500005,3,3,32,38,
Murray,Governor,Kevin Stitt,REP,500005,13,41,502,556,
Murray,Governor,Drew Edmondson,DEM,500005,11,26,264,301,
Murray,Lieutenant Governor,Matt Pinnell,REP,500005,13,46,534,593,
Murray,Lieutenant Governor,Anastasia Pittman,DEM,500005,11,20,236,267,
Murray,Lieutenant Governor,Ivan Holmes,IND,500005,2,2,24,28,
Murray,State Auditor,John Yeutter,LIB,500005,10,8,148,166,
Murray,State Auditor,Cindy Byrd,REP,500005,16,54,590,660,
Murray,Attorney General,Mike Hunter,REP,500005,13,48,540,601,
Murray,Attorney General,Mark Myles,DEM,500005,13,21,248,282,
Murray,State Treasurer,Randy Mcdaniel,REP,500005,15,49,581,645,
Murray,State Treasurer,Charles De Coune,IND,500005,10,12,156,178,
Murray,Superintendent of Public Instruction,Joy Hofmeister,REP,500005,17,44,502,563,
Murray,Superintendent of Public Instruction,John Cox,DEM,500005,7,16,219,242,
Murray,Superintendent of Public Instruction,Larry Huff,IND,500005,2,7,68,77,
Murray,Commissioner of Labor,Leslie Osborn,REP,500005,13,48,532,593,
Murray,Commissioner of Labor,Fred Dorrell,DEM,500005,11,16,221,248,
Murray,Commissioner of Labor,Brandt Dismukes,IND,500005,2,5,32,39,
Murray,Insurance Commissioner,Glen Mulready,REP,500005,12,46,509,567,
Murray,Insurance Commissioner,Kimberly Fobbs,DEM,500005,14,21,277,312,
Murray,Corporation Commissioner,Bob Anthony,REP,500005,16,45,508,569,
Murray,Corporation Commissioner,Ashley Nicole Mccray,DEM,500005,8,19,236,263,
Murray,Corporation Commissioner,Jackie Short,IND,500005,2,4,47,53,
Murray,U.S. House,Tom Cole,REP,500005,17,45,561,623,4
Murray,U.S. House,Mary Brannon,DEM,500005,9,20,206,235,4
Murray,U.S. House,Ruby Peters,IND,500005,1,4,27,32,4
Murray,State Senate,Frank Simpson,REP,500005,15,47,550,612,14
Murray,State Senate,Justin Arledge,DEM,500005,12,22,236,270,14
Murray,State House,Charles Mccall,REP,500005,10,33,435,478,22
Murray,State House,Wayne Eidson,DEM,500005,16,32,321,369,22
Murray,State House,Renae Ward,IND,500005,1,3,39,43,22
Murray,Governor,Chris Powell,LIB,500007,1,1,11,13,
Murray,Governor,Kevin Stitt,REP,500007,5,9,144,158,
Murray,Governor,Drew Edmondson,DEM,500007,2,7,78,87,
Murray,Lieutenant Governor,Matt Pinnell,REP,500007,5,10,161,176,
Murray,Lieutenant Governor,Anastasia Pittman,DEM,500007,1,6,69,76,
Murray,Lieutenant Governor,Ivan Holmes,IND,500007,1,1,4,6,
Murray,State Auditor,John Yeutter,LIB,500007,3,4,38,45,
Murray,State Auditor,Cindy Byrd,REP,500007,4,11,173,188,
Murray,Attorney General,Mike Hunter,REP,500007,5,10,167,182,
Murray,Attorney General,Mark Myles,DEM,500007,2,7,67,76,
Murray,State Treasurer,Randy Mcdaniel,REP,500007,5,9,176,190,
Murray,State Treasurer,Charles De Coune,IND,500007,1,5,35,41,
Murray,Superintendent of Public Instruction,Joy Hofmeister,REP,500007,5,6,154,165,
Murray,Superintendent of Public Instruction,John Cox,DEM,500007,1,8,62,71,
Murray,Superintendent of Public Instruction,Larry Huff,IND,500007,1,3,18,22,
Murray,Commissioner of Labor,Leslie Osborn,REP,500007,5,8,152,165,
Murray,Commissioner of Labor,Fred Dorrell,DEM,500007,2,8,70,80,
Murray,Commissioner of Labor,Brandt Dismukes,IND,500007,0,1,10,11,
Murray,Insurance Commissioner,Glen Mulready,REP,500007,5,10,159,174,
Murray,Insurance Commissioner,Kimberly Fobbs,DEM,500007,2,7,73,82,
Murray,Corporation Commissioner,Bob Anthony,REP,500007,4,8,155,167,
Murray,Corporation Commissioner,Ashley Nicole Mccray,DEM,500007,2,8,66,76,
Murray,Corporation Commissioner,Jackie Short,IND,500007,1,1,12,14,
Murray,U.S. House,Tom Cole,REP,500007,4,9,175,188,4
Murray,U.S. House,Mary Brannon,DEM,500007,2,7,52,61,4
Murray,U.S. House,Ruby Peters,IND,500007,1,1,7,9,4
Murray,State Senate,Frank Simpson,REP,500007,5,9,160,174,14
Murray,State Senate,Justin Arledge,DEM,500007,2,8,73,83,14
Murray,State House,Tammy Townley,REP,500007,4,9,148,161,48
Murray,State House,Cheryl Key,DEM,500007,2,8,82,92,48
Murray,Governor,Chris Powell,LIB,500009,0,2,15,17,
Murray,Governor,Kevin Stitt,REP,500009,5,15,165,185,
Murray,Governor,Drew Edmondson,DEM,500009,7,18,87,112,
Murray,Lieutenant Governor,Matt Pinnell,REP,500009,5,22,196,223,
Murray,Lieutenant Governor,Anastasia Pittman,DEM,500009,6,13,66,85,
Murray,Lieutenant Governor,Ivan Holmes,IND,500009,0,0,3,3,
Murray,State Auditor,John Yeutter,LIB,500009,2,8,34,44,
Murray,State Auditor,Cindy Byrd,REP,500009,8,26,223,257,
Murray,Attorney General,Mike Hunter,REP,500009,6,21,205,232,
Murray,Attorney General,Mark Myles,DEM,500009,5,14,61,80,
Murray,State Treasurer,Randy Mcdaniel,REP,500009,6,26,218,250,
Murray,State Treasurer,Charles De Coune,IND,500009,4,8,39,51,
Murray,Superintendent of Public Instruction,Joy Hofmeister,REP,500009,6,26,173,205,
Murray,Superintendent of Public Instruction,John Cox,DEM,500009,4,7,70,81,
Murray,Superintendent of Public Instruction,Larry Huff,IND,500009,2,2,24,28,
Murray,Commissioner of Labor,Leslie Osborn,REP,500009,6,22,191,219,
Murray,Commissioner of Labor,Fred Dorrell,DEM,500009,5,12,60,77,
Murray,Commissioner of Labor,Brandt Dismukes,IND,500009,0,1,11,12,
Murray,Insurance Commissioner,Glen Mulready,REP,500009,5,22,191,218,
Murray,Insurance Commissioner,Kimberly Fobbs,DEM,500009,5,13,73,91,
Murray,Corporation Commissioner,Bob Anthony,REP,500009,5,21,186,212,
Murray,Corporation Commissioner,Ashley Nicole Mccray,DEM,500009,6,13,65,84,
Murray,Corporation Commissioner,Jackie Short,IND,500009,0,1,14,15,
Murray,U.S. House,Tom Cole,REP,500009,5,25,216,246,4
Murray,U.S. House,Mary Brannon,DEM,500009,6,10,45,61,4
Murray,U.S. House,Ruby Peters,IND,500009,0,0,6,6,4
Murray,State Senate,Frank Simpson,REP,500009,8,21,207,236,14
Murray,State Senate,Justin Arledge,DEM,500009,3,13,58,74,14
Murray,State House,Charles Mccall,REP,500009,5,10,139,154,22
Murray,State House,Wayne Eidson,DEM,500009,6,23,110,139,22
Murray,State House,Renae Ward,IND,500009,0,2,19,21,22
Murray,Governor,Chris Powell,LIB,500012,0,0,4,4,
Murray,Governor,Kevin Stitt,REP,500012,2,8,160,170,
Murray,Governor,Drew Edmondson,DEM,500012,3,2,78,83,
Murray,Lieutenant Governor,Matt Pinnell,REP,500012,2,9,176,187,
Murray,Lieutenant Governor,Anastasia Pittman,DEM,500012,3,1,56,60,
Murray,Lieutenant Governor,Ivan Holmes,IND,500012,0,0,9,9,
Murray,State Auditor,John Yeutter,LIB,500012,1,2,28,31,
Murray,State Auditor,Cindy Byrd,REP,500012,2,7,204,213,
Murray,Attorney General,Mike Hunter,REP,500012,2,8,186,196,
Murray,Attorney General,Mark Myles,DEM,500012,3,2,55,60,
Murray,State Treasurer,Randy Mcdaniel,REP,500012,2,6,196,204,
Murray,State Treasurer,Charles De Coune,IND,500012,1,2,37,40,
Murray,Superintendent of Public Instruction,Joy Hofmeister,REP,500012,2,6,165,173,
Murray,Superintendent of Public Instruction,John Cox,DEM,500012,3,2,60,65,
Murray,Superintendent of Public Instruction,Larry Huff,IND,500012,0,2,17,19,
Murray,Commissioner of Labor,Leslie Osborn,REP,500012,2,6,169,177,
Murray,Commissioner of Labor,Fred Dorrell,DEM,500012,3,2,62,67,
Murray,Commissioner of Labor,Brandt Dismukes,IND,500012,0,2,9,11,
Murray,Insurance Commissioner,Glen Mulready,REP,500012,2,8,173,183,
Murray,Insurance Commissioner,Kimberly Fobbs,DEM,500012,3,2,67,72,
Murray,Corporation Commissioner,Bob Anthony,REP,500012,2,7,170,179,
Murray,Corporation Commissioner,Ashley Nicole Mccray,DEM,500012,3,1,59,63,
Murray,Corporation Commissioner,Jackie Short,IND,500012,0,2,12,14,
Murray,U.S. House,Tom Cole,REP,500012,2,8,187,197,4
Murray,U.S. House,Mary Brannon,DEM,500012,3,2,46,51,4
Murray,U.S. House,Ruby Peters,IND,500012,0,0,8,8,4
Murray,State Senate,Frank Simpson,REP,500012,2,9,181,192,14
Murray,State Senate,Justin Arledge,DEM,500012,3,1,59,63,14
Murray,State House,Charles Mccall,REP,500012,0,7,155,162,22
Murray,State House,Wayne Eidson,DEM,500012,5,2,74,81,22
Murray,State House,Renae Ward,IND,500012,0,1,12,13,22
Murray,Governor,Chris Powell,LIB,500014,0,1,6,7,
Murray,Governor,Kevin Stitt,REP,500014,0,4,90,94,
Murray,Governor,Drew Edmondson,DEM,500014,0,8,38,46,
Murray,Lieutenant Governor,Matt Pinnell,REP,500014,0,4,91,95,
Murray,Lieutenant Governor,Anastasia Pittman,DEM,500014,0,8,36,44,
Murray,Lieutenant Governor,Ivan Holmes,IND,500014,0,1,7,8,
Murray,State Auditor,John Yeutter,LIB,500014,0,3,20,23,
Murray,State Auditor,Cindy Byrd,REP,500014,0,7,104,111,
Murray,Attorney General,Mike Hunter,REP,500014,0,6,93,99,
Murray,Attorney General,Mark Myles,DEM,500014,0,7,41,48,
Murray,State Treasurer,Randy Mcdaniel,REP,500014,0,6,102,108,
Murray,State Treasurer,Charles De Coune,IND,500014,0,4,20,24,
Murray,Superintendent of Public Instruction,Joy Hofmeister,REP,500014,0,5,85,90,
Murray,Superintendent of Public Instruction,John Cox,DEM,500014,0,6,39,45,
Murray,Superintendent of Public Instruction,Larry Huff,IND,500014,0,2,10,12,
Murray,Commissioner of Labor,Leslie Osborn,REP,500014,0,5,87,92,
Murray,Commissioner of Labor,Fred Dorrell,DEM,500014,0,7,40,47,
Murray,Commissioner of Labor,Brandt Dismukes,IND,500014,0,1,5,6,
Murray,Insurance Commissioner,Glen Mulready,REP,500014,0,4,93,97,
Murray,Insurance Commissioner,Kimberly Fobbs,DEM,500014,0,9,40,49,
Murray,Corporation Commissioner,Bob Anthony,REP,500014,0,3,86,89,
Murray,Corporation Commissioner,Ashley Nicole Mccray,DEM,500014,0,8,40,48,
Murray,Corporation Commissioner,Jackie Short,IND,500014,0,1,7,8,
Murray,U.S. House,Tom Cole,REP,500014,0,5,107,112,4
Murray,U.S. House,Mary Brannon,DEM,500014,0,6,21,27,4
Murray,U.S. House,Ruby Peters,IND,500014,0,1,6,7,4
Murray,State Senate,Frank Simpson,REP,500014,0,5,97,102,14
Murray,State Senate,Justin Arledge,DEM,500014,0,8,37,45,14
Murray,State House,Charles Mccall,REP,500014,0,4,79,83,22
Murray,State House,Wayne Eidson,DEM,500014,0,8,48,56,22
Murray,State House,Renae Ward,IND,500014,0,1,6,7,22
Murray,Governor,Chris Powell,LIB,500015,1,5,23,29,
Murray,Governor,Kevin Stitt,REP,500015,27,77,381,485,
Murray,Governor,Drew Edmondson,DEM,500015,13,48,178,239,
Murray,Lieutenant Governor,Matt Pinnell,REP,500015,27,85,397,509,
Murray,Lieutenant Governor,Anastasia Pittman,DEM,500015,12,40,163,215,
Murray,Lieutenant Governor,Ivan Holmes,IND,500015,1,4,17,22,
Murray,State Auditor,John Yeutter,LIB,500015,5,28,91,124,
Murray,State Auditor,Cindy Byrd,REP,500015,32,92,449,573,
Murray,Attorney General,Mike Hunter,REP,500015,29,88,417,534,
Murray,Attorney General,Mark Myles,DEM,500015,11,40,158,209,
Murray,State Treasurer,Randy Mcdaniel,REP,500015,28,88,447,563,
Murray,State Treasurer,Charles De Coune,IND,500015,8,29,95,132,
Murray,Superintendent of Public Instruction,Joy Hofmeister,REP,500015,27,86,391,504,
Murray,Superintendent of Public Instruction,John Cox,DEM,500015,10,36,140,186,
Murray,Superintendent of Public Instruction,Larry Huff,IND,500015,3,6,45,54,
Murray,Commissioner of Labor,Leslie Osborn,REP,500015,28,87,394,509,
Murray,Commissioner of Labor,Fred Dorrell,DEM,500015,9,39,156,204,
Murray,Commissioner of Labor,Brandt Dismukes,IND,500015,2,3,24,29,
Murray,Insurance Commissioner,Glen Mulready,REP,500015,27,92,381,500,
Murray,Insurance Commissioner,Kimberly Fobbs,DEM,500015,13,38,192,243,
Murray,Corporation Commissioner,Bob Anthony,REP,500015,27,88,389,504,
Murray,Corporation Commissioner,Ashley Nicole Mccray,DEM,500015,11,37,160,208,
Murray,Corporation Commissioner,Jackie Short,IND,500015,3,4,28,35,
Murray,U.S. House,Tom Cole,REP,500015,31,94,422,547,4
Murray,U.S. House,Mary Brannon,DEM,500015,7,32,137,176,4
Murray,U.S. House,Ruby Peters,IND,500015,2,4,19,25,4
Murray,State Senate,Frank Simpson,REP,500015,27,88,418,533,14
Murray,State Senate,Justin Arledge,DEM,500015,12,41,160,213,14
Murray,State House,Charles Mccall,REP,500015,27,74,321,422,22
Murray,State House,Wayne Eidson,DEM,500015,11,48,233,292,22
Murray,State House,Renae Ward,IND,500015,3,8,30,41,22
Murray,Governor,Chris Powell,LIB,500017,1,0,3,4,
Murray,Governor,Kevin Stitt,REP,500017,3,2,41,46,
Murray,Governor,Drew Edmondson,DEM,500017,1,0,21,22,
Murray,Lieutenant Governor,Matt Pinnell,REP,500017,4,2,45,51,
Murray,Lieutenant Governor,Anastasia Pittman,DEM,500017,1,0,19,20,
Murray,Lieutenant Governor,Ivan Holmes,IND,500017,0,0,2,2,
Murray,State Auditor,John Yeutter,LIB,500017,0,0,9,9,
Murray,State Auditor,Cindy Byrd,REP,500017,5,2,53,60,
Murray,Attorney General,Mike Hunter,REP,500017,5,2,49,56,
Murray,Attorney General,Mark Myles,DEM,500017,0,0,17,17,
Murray,State Treasurer,Randy Mcdaniel,REP,500017,5,2,52,59,
Murray,State Treasurer,Charles De Coune,IND,500017,0,0,10,10,
Murray,Superintendent of Public Instruction,Joy Hofmeister,REP,500017,5,2,47,54,
Murray,Superintendent of Public Instruction,John Cox,DEM,500017,0,0,18,18,
Murray,Superintendent of Public Instruction,Larry Huff,IND,500017,0,0,1,1,
Murray,Commissioner of Labor,Leslie Osborn,REP,500017,5,2,44,51,
Murray,Commissioner of Labor,Fred Dorrell,DEM,500017,0,0,19,19,
Murray,Commissioner of Labor,Brandt Dismukes,IND,500017,0,0,2,2,
Murray,Insurance Commissioner,Glen Mulready,REP,500017,5,2,49,56,
Murray,Insurance Commissioner,Kimberly Fobbs,DEM,500017,0,0,17,17,
Murray,Corporation Commissioner,Bob Anthony,REP,500017,5,2,45,52,
Murray,Corporation Commissioner,Ashley Nicole Mccray,DEM,500017,0,0,17,17,
Murray,Corporation Commissioner,Jackie Short,IND,500017,0,0,4,4,
Murray,U.S. House,Tom Cole,REP,500017,5,2,51,58,4
Murray,U.S. House,Mary Brannon,DEM,500017,0,0,13,13,4
Murray,U.S. House,Ruby Peters,IND,500017,0,0,2,2,4
Murray,State Senate,Frank Simpson,REP,500017,4,2,46,52,14
Murray,State Senate,Justin Arledge,DEM,500017,1,0,20,21,14
Murray,State House,Charles Mccall,REP,500017,5,2,37,44,22
Murray,State House,Wayne Eidson,DEM,500017,0,0,26,26,22
Murray,State House,Renae Ward,IND,500017,0,0,3,3,22
Murray,Governor,Chris Powell,LIB,500018,0,0,18,18,
Murray,Governor,Kevin Stitt,REP,500018,5,20,200,225,
Murray,Governor,Drew Edmondson,DEM,500018,2,11,102,115,
Murray,Lieutenant Governor,Matt Pinnell,REP,500018,4,22,235,261,
Murray,Lieutenant Governor,Anastasia Pittman,DEM,500018,3,8,74,85,
Murray,Lieutenant Governor,Ivan Holmes,IND,500018,0,1,8,9,
Murray,State Auditor,John Yeutter,LIB,500018,1,3,56,60,
Murray,State Auditor,Cindy Byrd,REP,500018,5,25,244,274,
Murray,Attorney General,Mike Hunter,REP,500018,5,23,230,258,
Murray,Attorney General,Mark Myles,DEM,500018,2,8,87,97,
Murray,State Treasurer,Randy Mcdaniel,REP,500018,5,23,239,267,
Murray,State Treasurer,Charles De Coune,IND,500018,1,5,59,65,
Murray,Superintendent of Public Instruction,Joy Hofmeister,REP,500018,5,21,213,239,
Murray,Superintendent of Public Instruction,John Cox,DEM,500018,2,9,81,92,
Murray,Superintendent of Public Instruction,Larry Huff,IND,500018,0,1,25,26,
Murray,Commissioner of Labor,Leslie Osborn,REP,500018,5,19,221,245,
Murray,Commissioner of Labor,Fred Dorrell,DEM,500018,2,9,74,85,
Murray,Commissioner of Labor,Brandt Dismukes,IND,500018,0,2,18,20,
Murray,Insurance Commissioner,Glen Mulready,REP,500018,5,22,215,242,
Murray,Insurance Commissioner,Kimberly Fobbs,DEM,500018,2,9,98,109,
Murray,Corporation Commissioner,Bob Anthony,REP,500018,5,20,217,242,
Murray,Corporation Commissioner,Ashley Nicole Mccray,DEM,500018,2,8,81,91,
Murray,Corporation Commissioner,Jackie Short,IND,500018,0,3,20,23,
Murray,U.S. House,Tom Cole,REP,500018,5,21,244,270,4
Murray,U.S. House,Mary Brannon,DEM,500018,2,9,64,75,4
Murray,U.S. House,Ruby Peters,IND,500018,0,1,12,13,4
Murray,State Senate,Frank Simpson,REP,500018,5,22,231,258,14
Murray,State Senate,Justin Arledge,DEM,500018,2,9,87,98,14
Murray,State House,Charles Mccall,REP,500018,5,15,183,203,22
Murray,State House,Wayne Eidson,DEM,500018,2,14,119,135,22
Murray,State House,Renae Ward,IND,500018,0,2,17,19,22
Murray,Governor,Chris Powell,LIB,500020,0,5,21,26,
Murray,Governor,Kevin Stitt,REP,500020,18,55,306,379,
Murray,Governor,Drew Edmondson,DEM,500020,7,39,210,256,
Murray,Lieutenant Governor,Matt Pinnell,REP,500020,19,70,350,439,
Murray,Lieutenant Governor,Anastasia Pittman,DEM,500020,6,27,158,191,
Murray,Lieutenant Governor,Ivan Holmes,IND,500020,0,2,24,26,
Murray,State Auditor,John Yeutter,LIB,500020,3,16,94,113,
Murray,State Auditor,Cindy Byrd,REP,500020,19,77,412,508,
Murray,Attorney General,Mike Hunter,REP,500020,19,74,349,442,
Murray,Attorney General,Mark Myles,DEM,500020,6,24,184,214,
Murray,State Treasurer,Randy Mcdaniel,REP,500020,19,79,399,497,
Murray,State Treasurer,Charles De Coune,IND,500020,3,16,107,126,
Murray,Superintendent of Public Instruction,Joy Hofmeister,REP,500020,18,69,333,420,
Murray,Superintendent of Public Instruction,John Cox,DEM,500020,6,27,163,196,
Murray,Superintendent of Public Instruction,Larry Huff,IND,500020,1,3,39,43,
Murray,Commissioner of Labor,Leslie Osborn,REP,500020,20,69,331,420,
Murray,Commissioner of Labor,Fred Dorrell,DEM,500020,4,27,165,196,
Murray,Commissioner of Labor,Brandt Dismukes,IND,500020,1,3,30,34,
Murray,Insurance Commissioner,Glen Mulready,REP,500020,17,65,338,420,
Murray,Insurance Commissioner,Kimberly Fobbs,DEM,500020,8,33,189,230,
Murray,Corporation Commissioner,Bob Anthony,REP,500020,16,68,330,414,
Murray,Corporation Commissioner,Ashley Nicole Mccray,DEM,500020,7,26,169,202,
Murray,Corporation Commissioner,Jackie Short,IND,500020,2,5,31,38,
Murray,U.S. House,Tom Cole,REP,500020,21,77,383,481,4
Murray,U.S. House,Mary Brannon,DEM,500020,4,20,134,158,4
Murray,U.S. House,Ruby Peters,IND,500020,0,2,20,22,4
Murray,State Senate,Frank Simpson,REP,500020,20,66,368,454,14
Murray,State Senate,Justin Arledge,DEM,500020,4,32,169,205,14
Murray,State House,Charles Mccall,REP,500020,15,43,250,308,22
Murray,State House,Wayne Eidson,DEM,500020,8,53,253,314,22
Murray,State House,Renae Ward,IND,500020,2,3,35,40,22
Muskogee,Governor,Chris Powell,LIB,510005,2,4,43,49,
Muskogee,Governor,Kevin Stitt,REP,510005,9,28,327,364,
Muskogee,Governor,Drew Edmondson,DEM,510005,18,70,449,537,
Muskogee,Lieutenant Governor,Matt Pinnell,REP,510005,11,42,375,428,
Muskogee,Lieutenant Governor,Anastasia Pittman,DEM,510005,16,54,397,467,
Muskogee,Lieutenant Governor,Ivan Holmes,IND,510005,2,4,40,46,
Muskogee,State Auditor,John Yeutter,LIB,510005,11,34,287,332,
Muskogee,State Auditor,Cindy Byrd,REP,510005,16,54,466,536,
Muskogee,Attorney General,Mike Hunter,REP,510005,11,42,405,458,
Muskogee,Attorney General,Mark Myles,DEM,510005,18,60,403,481,
Muskogee,State Treasurer,Randy Mcdaniel,REP,510005,18,50,439,507,
Muskogee,State Treasurer,Charles De Coune,IND,510005,7,38,317,362,
Muskogee,Superintendent of Public Instruction,Joy Hofmeister,REP,510005,16,37,361,414,
Muskogee,Superintendent of Public Instruction,John Cox,DEM,510005,10,60,357,427,
Muskogee,Superintendent of Public Instruction,Larry Huff,IND,510005,3,4,93,100,
Muskogee,Commissioner of Labor,Leslie Osborn,REP,510005,15,38,373,426,
Muskogee,Commissioner of Labor,Fred Dorrell,DEM,510005,12,58,376,446,
Muskogee,Commissioner of Labor,Brandt Dismukes,IND,510005,2,4,58,64,
Muskogee,Insurance Commissioner,Glen Mulready,REP,510005,16,42,370,428,
Muskogee,Insurance Commissioner,Kimberly Fobbs,DEM,510005,13,59,436,508,
Muskogee,Corporation Commissioner,Bob Anthony,REP,510005,14,34,361,409,
Muskogee,Corporation Commissioner,Ashley Nicole Mccray,DEM,510005,12,60,378,450,
Muskogee,Corporation Commissioner,Jackie Short,IND,510005,3,7,69,79,
Muskogee,U.S. House,Richard Castaldo,LIB,510005,2,2,33,37,2
Muskogee,U.S. House,Markwayne Mullin,REP,510005,16,35,362,413,2
Muskogee,U.S. House,Jason Nichols,DEM,510005,10,57,389,456,2
Muskogee,U.S. House,John Foreman,IND,510005,1,7,36,44,2
Muskogee,State House,Chris Sneed,REP,510005,12,33,349,394,14
Muskogee,State House,Jack Reavis,DEM,510005,17,68,463,548,14
Muskogee,Governor,Chris Powell,LIB,510007,0,3,30,33,
Muskogee,Governor,Kevin Stitt,REP,510007,18,76,522,616,
Muskogee,Governor,Drew Edmondson,DEM,510007,29,88,557,674,
Muskogee,Lieutenant Governor,Matt Pinnell,REP,510007,19,88,654,761,
Muskogee,Lieutenant Governor,Anastasia Pittman,DEM,510007,28,73,408,509,
Muskogee,Lieutenant Governor,Ivan Holmes,IND,510007,0,5,37,42,
Muskogee,State Auditor,John Yeutter,LIB,510007,7,46,245,298,
Muskogee,State Auditor,Cindy Byrd,REP,510007,21,105,767,893,
Muskogee,Attorney General,Mike Hunter,REP,510007,21,92,679,792,
Muskogee,Attorney General,Mark Myles,DEM,510007,26,72,419,517,
Muskogee,State Treasurer,Randy Mcdaniel,REP,510007,21,100,715,836,
Muskogee,State Treasurer,Charles De Coune,IND,510007,7,52,291,350,
Muskogee,Superintendent of Public Instruction,Joy Hofmeister,REP,510007,24,89,607,720,
Muskogee,Superintendent of Public Instruction,John Cox,DEM,510007,23,68,402,493,
Muskogee,Superintendent of Public Instruction,Larry Huff,IND,510007,0,8,92,100,
Muskogee,Commissioner of Labor,Leslie Osborn,REP,510007,18,83,616,717,
Muskogee,Commissioner of Labor,Fred Dorrell,DEM,510007,28,75,402,505,
Muskogee,Commissioner of Labor,Brandt Dismukes,IND,510007,0,7,70,77,
Muskogee,Insurance Commissioner,Glen Mulready,REP,510007,19,85,648,752,
Muskogee,Insurance Commissioner,Kimberly Fobbs,DEM,510007,26,79,439,544,
Muskogee,Corporation Commissioner,Bob Anthony,REP,510007,19,94,642,755,
Muskogee,Corporation Commissioner,Ashley Nicole Mccray,DEM,510007,27,67,397,491,
Muskogee,Corporation Commissioner,Jackie Short,IND,510007,0,4,51,55,
Muskogee,U.S. House,Richard Castaldo,LIB,510007,0,4,30,34,2
Muskogee,U.S. House,Markwayne Mullin,REP,510007,19,82,594,695,2
Muskogee,U.S. House,Jason Nichols,DEM,510007,27,76,452,555,2
Muskogee,U.S. House,John Foreman,IND,510007,0,4,27,31,2
Muskogee,State House,Chris Sneed,REP,510007,14,80,499,593,14
Muskogee,State House,Jack Reavis,DEM,510007,32,83,600,715,14
Muskogee,Governor,Chris Powell,LIB,510009,0,4,32,36,
Muskogee,Governor,Kevin Stitt,REP,510009,25,107,574,706,
Muskogee,Governor,Drew Edmondson,DEM,510009,24,93,535,652,
Muskogee,Lieutenant Governor,Matt Pinnell,REP,510009,31,124,683,838,
Muskogee,Lieutenant Governor,Anastasia Pittman,DEM,510009,16,73,414,503,
Muskogee,Lieutenant Governor,Ivan Holmes,IND,510009,1,3,35,39,
Muskogee,State Auditor,John Yeutter,LIB,510009,9,48,284,341,
Muskogee,State Auditor,Cindy Byrd,REP,510009,36,142,774,952,
Muskogee,Attorney General,Mike Hunter,REP,510009,33,129,708,870,
Muskogee,Attorney General,Mark Myles,DEM,510009,15,71,416,502,
Muskogee,State Treasurer,Randy Mcdaniel,REP,510009,35,143,754,932,
Muskogee,State Treasurer,Charles De Coune,IND,510009,10,49,297,356,
Muskogee,Superintendent of Public Instruction,Joy Hofmeister,REP,510009,34,128,650,812,
Muskogee,Superintendent of Public Instruction,John Cox,DEM,510009,14,65,402,481,
Muskogee,Superintendent of Public Instruction,Larry Huff,IND,510009,1,9,79,89,
Muskogee,Commissioner of Labor,Leslie Osborn,REP,510009,32,120,659,811,
Muskogee,Commissioner of Labor,Fred Dorrell,DEM,510009,14,75,406,495,
Muskogee,Commissioner of Labor,Brandt Dismukes,IND,510009,1,5,54,60,
Muskogee,Insurance Commissioner,Glen Mulready,REP,510009,33,117,681,831,
Muskogee,Insurance Commissioner,Kimberly Fobbs,DEM,510009,14,82,439,535,
Muskogee,Corporation Commissioner,Bob Anthony,REP,510009,29,123,662,814,
Muskogee,Corporation Commissioner,Ashley Nicole Mccray,DEM,510009,17,74,402,493,
Muskogee,Corporation Commissioner,Jackie Short,IND,510009,1,4,60,65,
Muskogee,U.S. House,Richard Castaldo,LIB,510009,0,1,32,33,2
Muskogee,U.S. House,Markwayne Mullin,REP,510009,33,117,626,776,2
Muskogee,U.S. House,Jason Nichols,DEM,510009,15,83,443,541,2
Muskogee,U.S. House,John Foreman,IND,510009,0,1,31,32,2
Muskogee,State House,Chris Sneed,REP,510009,28,109,569,706,14
Muskogee,State House,Jack Reavis,DEM,510009,20,92,558,670,14
Muskogee,Governor,Chris Powell,LIB,510011,0,0,26,26,
Muskogee,Governor,Kevin Stitt,REP,510011,6,13,183,202,
Muskogee,Governor,Drew Edmondson,DEM,510011,9,22,216,247,
Muskogee,Lieutenant Governor,Matt Pinnell,REP,510011,8,18,213,239,
Muskogee,Lieutenant Governor,Anastasia Pittman,DEM,510011,6,16,190,212,
Muskogee,Lieutenant Governor,Ivan Holmes,IND,510011,1,1,21,23,
Muskogee,State Auditor,John Yeutter,LIB,510011,4,11,133,148,
Muskogee,State Auditor,Cindy Byrd,REP,510011,10,19,259,288,
Muskogee,Attorney General,Mike Hunter,REP,510011,10,19,225,254,
Muskogee,Attorney General,Mark Myles,DEM,510011,5,16,193,214,
Muskogee,State Treasurer,Randy Mcdaniel,REP,510011,9,20,254,283,
Muskogee,State Treasurer,Charles De Coune,IND,510011,5,10,135,150,
Muskogee,Superintendent of Public Instruction,Joy Hofmeister,REP,510011,5,16,196,217,
Muskogee,Superintendent of Public Instruction,John Cox,DEM,510011,7,16,178,201,
Muskogee,Superintendent of Public Instruction,Larry Huff,IND,510011,3,3,46,52,
Muskogee,Commissioner of Labor,Leslie Osborn,REP,510011,10,19,211,240,
Muskogee,Commissioner of Labor,Fred Dorrell,DEM,510011,5,15,182,202,
Muskogee,Commissioner of Labor,Brandt Dismukes,IND,510011,0,1,27,28,
Muskogee,Insurance Commissioner,Glen Mulready,REP,510011,6,18,217,241,
Muskogee,Insurance Commissioner,Kimberly Fobbs,DEM,510011,9,17,205,231,
Muskogee,Corporation Commissioner,Bob Anthony,REP,510011,9,14,203,226,
Muskogee,Corporation Commissioner,Ashley Nicole Mccray,DEM,510011,6,19,184,209,
Muskogee,Corporation Commissioner,Jackie Short,IND,510011,0,2,34,36,
Muskogee,U.S. House,Richard Castaldo,LIB,510011,0,0,6,6,2
Muskogee,U.S. House,Markwayne Mullin,REP,510011,8,17,211,236,2
Muskogee,U.S. House,Jason Nichols,DEM,510011,7,17,183,207,2
Muskogee,U.S. House,John Foreman,IND,510011,0,1,23,24,2
Muskogee,State House,Chris Sneed,REP,510011,6,15,189,210,14
Muskogee,State House,Jack Reavis,DEM,510011,9,20,232,261,14
Muskogee,Governor,Chris Powell,LIB,510013,1,1,33,35,
Muskogee,Governor,Kevin Stitt,REP,510013,8,34,278,320,
Muskogee,Governor,Drew Edmondson,DEM,510013,5,31,323,359,
Muskogee,Lieutenant Governor,Matt Pinnell,REP,510013,8,39,347,394,
Muskogee,Lieutenant Governor,Anastasia Pittman,DEM,510013,5,27,256,288,
Muskogee,Lieutenant Governor,Ivan Holmes,IND,510013,1,0,24,25,
Muskogee,State Auditor,John Yeutter,LIB,510013,2,11,181,194,
Muskogee,State Auditor,Cindy Byrd,REP,510013,9,45,401,455,
Muskogee,Attorney General,Mike Hunter,REP,510013,9,38,355,402,
Muskogee,Attorney General,Mark Myles,DEM,510013,5,25,268,298,
Muskogee,State Treasurer,Randy Mcdaniel,REP,510013,9,41,394,444,
Muskogee,State Treasurer,Charles De Coune,IND,510013,2,12,186,200,
Muskogee,Superintendent of Public Instruction,Joy Hofmeister,REP,510013,7,39,318,364,
Muskogee,Superintendent of Public Instruction,John Cox,DEM,510013,5,23,251,279,
Muskogee,Superintendent of Public Instruction,Larry Huff,IND,510013,2,4,59,65,
Muskogee,Commissioner of Labor,Leslie Osborn,REP,510013,9,38,329,376,
Muskogee,Commissioner of Labor,Fred Dorrell,DEM,510013,4,23,260,287,
Muskogee,Commissioner of Labor,Brandt Dismukes,IND,510013,1,4,32,37,
Muskogee,Insurance Commissioner,Glen Mulready,REP,510013,8,38,343,389,
Muskogee,Insurance Commissioner,Kimberly Fobbs,DEM,510013,6,26,277,309,
Muskogee,Corporation Commissioner,Bob Anthony,REP,510013,8,40,334,382,
Muskogee,Corporation Commissioner,Ashley Nicole Mccray,DEM,510013,6,25,253,284,
Muskogee,Corporation Commissioner,Jackie Short,IND,510013,0,0,37,37,
Muskogee,U.S. House,Richard Castaldo,LIB,510013,1,0,19,20,2
Muskogee,U.S. House,Markwayne Mullin,REP,510013,8,38,330,376,2
Muskogee,U.S. House,Jason Nichols,DEM,510013,5,26,263,294,2
Muskogee,U.S. House,John Foreman,IND,510013,0,1,20,21,2
Muskogee,State House,Chris Sneed,REP,510013,7,35,301,343,14
Muskogee,State House,Jack Reavis,DEM,510013,7,30,328,365,14
Muskogee,Governor,Chris Powell,LIB,510017,0,0,6,6,
Muskogee,Governor,Kevin Stitt,REP,510017,2,5,47,54,
Muskogee,Governor,Drew Edmondson,DEM,510017,7,25,187,219,
Muskogee,Lieutenant Governor,Matt Pinnell,REP,510017,2,7,60,69,
Muskogee,Lieutenant Governor,Anastasia Pittman,DEM,510017,7,22,170,199,
Muskogee,Lieutenant Governor,Ivan Holmes,IND,510017,0,1,9,10,
Muskogee,State Auditor,John Yeutter,LIB,510017,5,17,120,142,
Muskogee,State Auditor,Cindy Byrd,REP,510017,4,7,95,106,
Muskogee,Attorney General,Mike Hunter,REP,510017,3,7,67,77,
Muskogee,Attorney General,Mark Myles,DEM,510017,6,23,172,201,
Muskogee,State Treasurer,Randy Mcdaniel,REP,510017,4,7,81,92,
Muskogee,State Treasurer,Charles De Coune,IND,510017,5,17,135,157,
Muskogee,Superintendent of Public Instruction,Joy Hofmeister,REP,510017,2,5,62,69,
Muskogee,Superintendent of Public Instruction,John Cox,DEM,510017,7,22,165,194,
Muskogee,Superintendent of Public Instruction,Larry Huff,IND,510017,0,3,12,15,
Muskogee,Commissioner of Labor,Leslie Osborn,REP,510017,2,6,53,61,
Muskogee,Commissioner of Labor,Fred Dorrell,DEM,510017,7,23,171,201,
Muskogee,Commissioner of Labor,Brandt Dismukes,IND,510017,0,1,14,15,
Muskogee,Insurance Commissioner,Glen Mulready,REP,510017,2,7,66,75,
Muskogee,Insurance Commissioner,Kimberly Fobbs,DEM,510017,7,23,171,201,
Muskogee,Corporation Commissioner,Bob Anthony,REP,510017,2,5,59,66,
Muskogee,Corporation Commissioner,Ashley Nicole Mccray,DEM,510017,7,22,168,197,
Muskogee,Corporation Commissioner,Jackie Short,IND,510017,0,3,11,14,
Muskogee,U.S. House,Richard Castaldo,LIB,510017,0,0,6,6,2
Muskogee,U.S. House,Markwayne Mullin,REP,510017,2,5,60,67,2
Muskogee,U.S. House,Jason Nichols,DEM,510017,7,24,165,196,2
Muskogee,U.S. House,John Foreman,IND,510017,0,1,7,8,2
Muskogee,State House,Avery Carl Frix,REP,510017,3,10,106,119,13
Muskogee,State House,Jolene Armstrong,DEM,510017,6,20,132,158,13
Muskogee,Governor,Chris Powell,LIB,510021,0,2,21,23,
Muskogee,Governor,Kevin Stitt,REP,510021,9,20,117,146,
Muskogee,Governor,Drew Edmondson,DEM,510021,13,44,406,463,
Muskogee,Lieutenant Governor,Matt Pinnell,REP,510021,9,24,148,181,
Muskogee,Lieutenant Governor,Anastasia Pittman,DEM,510021,11,39,370,420,
Muskogee,Lieutenant Governor,Ivan Holmes,IND,510021,2,3,25,30,
Muskogee,State Auditor,John Yeutter,LIB,510021,4,24,270,298,
Muskogee,State Auditor,Cindy Byrd,REP,510021,12,30,211,253,
Muskogee,Attorney General,Mike Hunter,REP,510021,11,27,165,203,
Muskogee,Attorney General,Mark Myles,DEM,510021,11,39,377,427,
Muskogee,State Treasurer,Randy Mcdaniel,REP,510021,11,35,188,234,
Muskogee,State Treasurer,Charles De Coune,IND,510021,5,21,293,319,
Muskogee,Superintendent of Public Instruction,Joy Hofmeister,REP,510021,10,30,145,185,
Muskogee,Superintendent of Public Instruction,John Cox,DEM,510021,10,31,360,401,
Muskogee,Superintendent of Public Instruction,Larry Huff,IND,510021,2,5,39,46,
Muskogee,Commissioner of Labor,Leslie Osborn,REP,510021,10,25,141,176,
Muskogee,Commissioner of Labor,Fred Dorrell,DEM,510021,10,36,363,409,
Muskogee,Commissioner of Labor,Brandt Dismukes,IND,510021,2,5,38,45,
Muskogee,Insurance Commissioner,Glen Mulready,REP,510021,11,29,155,195,
Muskogee,Insurance Commissioner,Kimberly Fobbs,DEM,510021,11,35,384,430,
Muskogee,Corporation Commissioner,Bob Anthony,REP,510021,12,26,155,193,
Muskogee,Corporation Commissioner,Ashley Nicole Mccray,DEM,510021,9,35,345,389,
Muskogee,Corporation Commissioner,Jackie Short,IND,510021,1,4,41,46,
Muskogee,U.S. House,Richard Castaldo,LIB,510021,0,2,16,18,2
Muskogee,U.S. House,Markwayne Mullin,REP,510021,10,22,145,177,2
Muskogee,U.S. House,Jason Nichols,DEM,510021,11,40,375,426,2
Muskogee,U.S. House,John Foreman,IND,510021,1,2,9,12,2
Muskogee,State House,Avery Carl Frix,REP,510021,15,34,252,301,13
Muskogee,State House,Jolene Armstrong,DEM,510021,7,32,293,332,13
Muskogee,Governor,Chris Powell,LIB,510022,2,0,25,27,
Muskogee,Governor,Kevin Stitt,REP,510022,21,54,296,371,
Muskogee,Governor,Drew Edmondson,DEM,510022,21,69,416,506,
Muskogee,Lieutenant Governor,Matt Pinnell,REP,510022,21,62,373,456,
Muskogee,Lieutenant Governor,Anastasia Pittman,DEM,510022,20,59,325,404,
Muskogee,Lieutenant Governor,Ivan Holmes,IND,510022,2,1,29,32,
Muskogee,State Auditor,John Yeutter,LIB,510022,7,28,219,254,
Muskogee,State Auditor,Cindy Byrd,REP,510022,28,75,451,554,
Muskogee,Attorney General,Mike Hunter,REP,510022,26,65,403,494,
Muskogee,Attorney General,Mark Myles,DEM,510022,17,57,320,394,
Muskogee,State Treasurer,Randy Mcdaniel,REP,510022,30,75,430,535,
Muskogee,State Treasurer,Charles De Coune,IND,510022,5,32,240,277,
Muskogee,Superintendent of Public Instruction,Joy Hofmeister,REP,510022,25,54,346,425,
Muskogee,Superintendent of Public Instruction,John Cox,DEM,510022,17,62,320,399,
Muskogee,Superintendent of Public Instruction,Larry Huff,IND,510022,2,6,61,69,
Muskogee,Commissioner of Labor,Leslie Osborn,REP,510022,25,62,367,454,
Muskogee,Commissioner of Labor,Fred Dorrell,DEM,510022,16,58,312,386,
Muskogee,Commissioner of Labor,Brandt Dismukes,IND,510022,2,2,42,46,
Muskogee,Insurance Commissioner,Glen Mulready,REP,510022,25,67,381,473,
Muskogee,Insurance Commissioner,Kimberly Fobbs,DEM,510022,19,55,336,410,
Muskogee,Corporation Commissioner,Bob Anthony,REP,510022,26,65,372,463,
Muskogee,Corporation Commissioner,Ashley Nicole Mccray,DEM,510022,17,55,315,387,
Muskogee,Corporation Commissioner,Jackie Short,IND,510022,1,3,40,44,
Muskogee,U.S. House,Richard Castaldo,LIB,510022,4,0,20,24,2
Muskogee,U.S. House,Markwayne Mullin,REP,510022,25,59,353,437,2
Muskogee,U.S. House,Jason Nichols,DEM,510022,14,62,337,413,2
Muskogee,U.S. House,John Foreman,IND,510022,1,2,24,27,2
Muskogee,State House,Avery Carl Frix,REP,510022,29,84,491,604,13
Muskogee,State House,Jolene Armstrong,DEM,510022,14,39,239,292,13
Muskogee,Governor,Chris Powell,LIB,510023,0,1,18,19,
Muskogee,Governor,Kevin Stitt,REP,510023,2,25,92,119,
Muskogee,Governor,Drew Edmondson,DEM,510023,19,70,474,563,
Muskogee,Lieutenant Governor,Matt Pinnell,REP,510023,3,33,100,136,
Muskogee,Lieutenant Governor,Anastasia Pittman,DEM,510023,19,58,464,541,
Muskogee,Lieutenant Governor,Ivan Holmes,IND,510023,0,5,17,22,
Muskogee,State Auditor,John Yeutter,LIB,510023,15,49,260,324,
Muskogee,State Auditor,Cindy Byrd,REP,510023,3,37,175,215,
Muskogee,Attorney General,Mike Hunter,REP,510023,3,33,116,152,
Muskogee,Attorney General,Mark Myles,DEM,510023,19,63,464,546,
Muskogee,State Treasurer,Randy Mcdaniel,REP,510023,2,38,143,183,
Muskogee,State Treasurer,Charles De Coune,IND,510023,15,48,290,353,
Muskogee,Superintendent of Public Instruction,Joy Hofmeister,REP,510023,3,26,114,143,
Muskogee,Superintendent of Public Instruction,John Cox,DEM,510023,18,63,432,513,
Muskogee,Superintendent of Public Instruction,Larry Huff,IND,510023,0,6,36,42,
Muskogee,Commissioner of Labor,Leslie Osborn,REP,510023,3,29,103,135,
Muskogee,Commissioner of Labor,Fred Dorrell,DEM,510023,18,59,439,516,
Muskogee,Commissioner of Labor,Brandt Dismukes,IND,510023,1,6,39,46,
Muskogee,Insurance Commissioner,Glen Mulready,REP,510023,2,32,110,144,
Muskogee,Insurance Commissioner,Kimberly Fobbs,DEM,510023,20,63,470,553,
Muskogee,Corporation Commissioner,Bob Anthony,REP,510023,2,31,110,143,
Muskogee,Corporation Commissioner,Ashley Nicole Mccray,DEM,510023,19,61,449,529,
Muskogee,Corporation Commissioner,Jackie Short,IND,510023,1,3,21,25,
Muskogee,U.S. House,Richard Castaldo,LIB,510023,0,3,7,10,2
Muskogee,U.S. House,Markwayne Mullin,REP,510023,2,29,104,135,2
Muskogee,U.S. House,Jason Nichols,DEM,510023,18,61,459,538,2
Muskogee,U.S. House,John Foreman,IND,510023,1,3,12,16,2
Muskogee,State House,Avery Carl Frix,REP,510023,6,50,190,246,13
Muskogee,State House,Jolene Armstrong,DEM,510023,16,45,390,451,13
Muskogee,Governor,Chris Powell,LIB,510028,0,0,13,13,
Muskogee,Governor,Kevin Stitt,REP,510028,1,15,124,140,
Muskogee,Governor,Drew Edmondson,DEM,510028,4,25,218,247,
Muskogee,Lieutenant Governor,Matt Pinnell,REP,510028,1,17,144,162,
Muskogee,Lieutenant Governor,Anastasia Pittman,DEM,510028,4,22,203,229,
Muskogee,Lieutenant Governor,Ivan Holmes,IND,510028,0,1,7,8,
Muskogee,State Auditor,John Yeutter,LIB,510028,2,15,133,150,
Muskogee,State Auditor,Cindy Byrd,REP,510028,3,21,182,206,
Muskogee,Attorney General,Mike Hunter,REP,510028,1,19,157,177,
Muskogee,Attorney General,Mark Myles,DEM,510028,4,21,198,223,
Muskogee,State Treasurer,Randy Mcdaniel,REP,510028,3,20,165,188,
Muskogee,State Treasurer,Charles De Coune,IND,510028,2,15,154,171,
Muskogee,Superintendent of Public Instruction,Joy Hofmeister,REP,510028,0,19,141,160,
Muskogee,Superintendent of Public Instruction,John Cox,DEM,510028,4,16,180,200,
Muskogee,Superintendent of Public Instruction,Larry Huff,IND,510028,1,5,32,38,
Muskogee,Commissioner of Labor,Leslie Osborn,REP,510028,1,17,139,157,
Muskogee,Commissioner of Labor,Fred Dorrell,DEM,510028,4,20,201,225,
Muskogee,Commissioner of Labor,Brandt Dismukes,IND,510028,0,3,15,18,
Muskogee,Insurance Commissioner,Glen Mulready,REP,510028,1,18,146,165,
Muskogee,Insurance Commissioner,Kimberly Fobbs,DEM,510028,4,22,204,230,
Muskogee,Corporation Commissioner,Bob Anthony,REP,510028,2,17,147,166,
Muskogee,Corporation Commissioner,Ashley Nicole Mccray,DEM,510028,3,21,189,213,
Muskogee,Corporation Commissioner,Jackie Short,IND,510028,0,1,18,19,
Muskogee,U.S. House,Richard Castaldo,LIB,510028,0,0,6,6,2
Muskogee,U.S. House,Markwayne Mullin,REP,510028,1,15,141,157,2
Muskogee,U.S. House,Jason Nichols,DEM,510028,4,24,196,224,2
Muskogee,U.S. House,John Foreman,IND,510028,0,1,9,10,2
Muskogee,State House,Avery Carl Frix,REP,510028,4,24,201,229,13
Muskogee,State House,Jolene Armstrong,DEM,510028,1,16,153,170,13
Muskogee,Governor,Chris Powell,LIB,510033,0,0,35,35,
Muskogee,Governor,Kevin Stitt,REP,510033,26,22,534,582,
Muskogee,Governor,Drew Edmondson,DEM,510033,20,8,296,324,
Muskogee,Lieutenant Governor,Matt Pinnell,REP,510033,25,23,585,633,
Muskogee,Lieutenant Governor,Anastasia Pittman,DEM,510033,19,7,240,266,
Muskogee,Lieutenant Governor,Ivan Holmes,IND,510033,1,0,33,34,
Muskogee,State Auditor,John Yeutter,LIB,510033,11,2,160,173,
Muskogee,State Auditor,Cindy Byrd,REP,510033,26,24,646,696,
Muskogee,Attorney General,Mike Hunter,REP,510033,24,24,611,659,
Muskogee,Attorney General,Mark Myles,DEM,510033,21,6,243,270,
Muskogee,State Treasurer,Randy Mcdaniel,REP,510033,27,22,620,669,
Muskogee,State Treasurer,Charles De Coune,IND,510033,10,4,187,201,
Muskogee,Superintendent of Public Instruction,Joy Hofmeister,REP,510033,23,21,495,539,
Muskogee,Superintendent of Public Instruction,John Cox,DEM,510033,22,9,294,325,
Muskogee,Superintendent of Public Instruction,Larry Huff,IND,510033,1,0,73,74,
Muskogee,Commissioner of Labor,Leslie Osborn,REP,510033,24,21,561,606,
Muskogee,Commissioner of Labor,Fred Dorrell,DEM,510033,20,7,258,285,
Muskogee,Commissioner of Labor,Brandt Dismukes,IND,510033,1,2,33,36,
Muskogee,Insurance Commissioner,Glen Mulready,REP,510033,25,22,586,633,
Muskogee,Insurance Commissioner,Kimberly Fobbs,DEM,510033,19,8,265,292,
Muskogee,Corporation Commissioner,Bob Anthony,REP,510033,22,18,560,600,
Muskogee,Corporation Commissioner,Ashley Nicole Mccray,DEM,510033,20,9,247,276,
Muskogee,Corporation Commissioner,Jackie Short,IND,510033,1,3,46,50,
Muskogee,U.S. House,Richard Castaldo,LIB,510033,0,0,21,21,2
Muskogee,U.S. House,Markwayne Mullin,REP,510033,26,24,576,626,2
Muskogee,U.S. House,Jason Nichols,DEM,510033,19,6,236,261,2
Muskogee,U.S. House,John Foreman,IND,510033,1,0,27,28,2
Muskogee,State Senate,Kim David,REP,510033,25,23,577,625,18
Muskogee,State Senate,Charles Arnall,DEM,510033,20,7,275,302,18
Muskogee,State House,Scott Fetgatter,REP,510033,26,20,540,586,16
Muskogee,State House,Chandler Torbett,DEM,510033,19,8,273,300,16
Muskogee,State House,James Delso,IND,510033,1,2,39,42,16
Muskogee,Governor,Chris Powell,LIB,510036,0,0,5,5,
Muskogee,Governor,Kevin Stitt,REP,510036,0,3,35,38,
Muskogee,Governor,Drew Edmondson,DEM,510036,1,4,109,114,
Muskogee,Lieutenant Governor,Matt Pinnell,REP,510036,0,3,40,43,
Muskogee,Lieutenant Governor,Anastasia Pittman,DEM,510036,1,4,98,103,
Muskogee,Lieutenant Governor,Ivan Holmes,IND,510036,0,0,9,9,
Muskogee,State Auditor,John Yeutter,LIB,510036,0,2,75,77,
Muskogee,State Auditor,Cindy Byrd,REP,510036,1,5,53,59,
Muskogee,Attorney General,Mike Hunter,REP,510036,0,3,45,48,
Muskogee,Attorney General,Mark Myles,DEM,510036,1,4,103,108,
Muskogee,State Treasurer,Randy Mcdaniel,REP,510036,1,3,50,54,
Muskogee,State Treasurer,Charles De Coune,IND,510036,0,4,74,78,
Muskogee,Superintendent of Public Instruction,Joy Hofmeister,REP,510036,0,3,35,38,
Muskogee,Superintendent of Public Instruction,John Cox,DEM,510036,1,4,99,104,
Muskogee,Superintendent of Public Instruction,Larry Huff,IND,510036,0,0,11,11,
Muskogee,Commissioner of Labor,Leslie Osborn,REP,510036,1,3,40,44,
Muskogee,Commissioner of Labor,Fred Dorrell,DEM,510036,0,3,101,104,
Muskogee,Commissioner of Labor,Brandt Dismukes,IND,510036,0,1,5,6,
Muskogee,Insurance Commissioner,Glen Mulready,REP,510036,0,3,37,40,
Muskogee,Insurance Commissioner,Kimberly Fobbs,DEM,510036,1,4,110,115,
Muskogee,Corporation Commissioner,Bob Anthony,REP,510036,0,3,37,40,
Muskogee,Corporation Commissioner,Ashley Nicole Mccray,DEM,510036,1,4,100,105,
Muskogee,Corporation Commissioner,Jackie Short,IND,510036,0,0,10,10,
Muskogee,U.S. House,Richard Castaldo,LIB,510036,0,0,2,2,2
Muskogee,U.S. House,Markwayne Mullin,REP,510036,0,3,34,37,2
Muskogee,U.S. House,Jason Nichols,DEM,510036,0,4,105,109,2
Muskogee,U.S. House,John Foreman,IND,510036,1,0,7,8,2
Muskogee,State House,Avery Carl Frix,REP,510036,0,3,74,77,13
Muskogee,State House,Jolene Armstrong,DEM,510036,1,4,74,79,13
Muskogee,Governor,Chris Powell,LIB,510037,1,0,17,18,
Muskogee,Governor,Kevin Stitt,REP,510037,2,18,299,319,
Muskogee,Governor,Drew Edmondson,DEM,510037,7,24,243,274,
Muskogee,Lieutenant Governor,Matt Pinnell,REP,510037,3,22,359,384,
Muskogee,Lieutenant Governor,Anastasia Pittman,DEM,510037,7,20,174,201,
Muskogee,Lieutenant Governor,Ivan Holmes,IND,510037,0,0,22,22,
Muskogee,State Auditor,John Yeutter,LIB,510037,5,12,135,152,
Muskogee,State Auditor,Cindy Byrd,REP,510037,3,25,391,419,
Muskogee,Attorney General,Mike Hunter,REP,510037,3,25,364,392,
Muskogee,Attorney General,Mark Myles,DEM,510037,7,17,188,212,
Muskogee,State Treasurer,Randy Mcdaniel,REP,510037,4,23,379,406,
Muskogee,State Treasurer,Charles De Coune,IND,510037,4,16,143,163,
Muskogee,Superintendent of Public Instruction,Joy Hofmeister,REP,510037,2,20,310,332,
Muskogee,Superintendent of Public Instruction,John Cox,DEM,510037,7,19,195,221,
Muskogee,Superintendent of Public Instruction,Larry Huff,IND,510037,1,3,48,52,
Muskogee,Commissioner of Labor,Leslie Osborn,REP,510037,4,22,318,344,
Muskogee,Commissioner of Labor,Fred Dorrell,DEM,510037,6,20,194,220,
Muskogee,Commissioner of Labor,Brandt Dismukes,IND,510037,0,0,36,36,
Muskogee,Insurance Commissioner,Glen Mulready,REP,510037,2,21,343,366,
Muskogee,Insurance Commissioner,Kimberly Fobbs,DEM,510037,8,21,205,234,
Muskogee,Corporation Commissioner,Bob Anthony,REP,510037,3,22,340,365,
Muskogee,Corporation Commissioner,Ashley Nicole Mccray,DEM,510037,7,20,189,216,
Muskogee,Corporation Commissioner,Jackie Short,IND,510037,0,0,23,23,
Muskogee,U.S. House,Richard Castaldo,LIB,510037,1,0,8,9,2
Muskogee,U.S. House,Markwayne Mullin,REP,510037,3,24,343,370,2
Muskogee,U.S. House,Jason Nichols,DEM,510037,6,18,188,212,2
Muskogee,U.S. House,John Foreman,IND,510037,0,0,18,18,2
Muskogee,State House,Avery Carl Frix,REP,510037,3,30,448,481,13
Muskogee,State House,Jolene Armstrong,DEM,510037,7,12,110,129,13
Muskogee,Governor,Chris Powell,LIB,510038,1,4,14,19,
Muskogee,Governor,Kevin Stitt,REP,510038,16,70,360,446,
Muskogee,Governor,Drew Edmondson,DEM,510038,27,85,373,485,
Muskogee,Lieutenant Governor,Matt Pinnell,REP,510038,18,90,454,562,
Muskogee,Lieutenant Governor,Anastasia Pittman,DEM,510038,24,62,279,365,
Muskogee,Lieutenant Governor,Ivan Holmes,IND,510038,1,6,13,20,
Muskogee,State Auditor,John Yeutter,LIB,510038,11,36,166,213,
Muskogee,State Auditor,Cindy Byrd,REP,510038,27,113,531,671,
Muskogee,Attorney General,Mike Hunter,REP,510038,24,104,479,607,
Muskogee,Attorney General,Mark Myles,DEM,510038,20,54,268,342,
Muskogee,State Treasurer,Randy Mcdaniel,REP,510038,25,111,507,643,
Muskogee,State Treasurer,Charles De Coune,IND,510038,12,38,194,244,
Muskogee,Superintendent of Public Instruction,Joy Hofmeister,REP,510038,21,84,446,551,
Muskogee,Superintendent of Public Instruction,John Cox,DEM,510038,21,64,252,337,
Muskogee,Superintendent of Public Instruction,Larry Huff,IND,510038,2,9,54,65,
Muskogee,Commissioner of Labor,Leslie Osborn,REP,510038,23,91,438,552,
Muskogee,Commissioner of Labor,Fred Dorrell,DEM,510038,21,62,275,358,
Muskogee,Commissioner of Labor,Brandt Dismukes,IND,510038,0,3,30,33,
Muskogee,Insurance Commissioner,Glen Mulready,REP,510038,19,91,460,570,
Muskogee,Insurance Commissioner,Kimberly Fobbs,DEM,510038,25,67,280,372,
Muskogee,Corporation Commissioner,Bob Anthony,REP,510038,24,100,447,571,
Muskogee,Corporation Commissioner,Ashley Nicole Mccray,DEM,510038,19,54,261,334,
Muskogee,Corporation Commissioner,Jackie Short,IND,510038,1,4,37,42,
Muskogee,U.S. House,Richard Castaldo,LIB,510038,1,1,16,18,2
Muskogee,U.S. House,Markwayne Mullin,REP,510038,19,75,427,521,2
Muskogee,U.S. House,Jason Nichols,DEM,510038,24,80,290,394,2
Muskogee,U.S. House,John Foreman,IND,510038,0,3,17,20,2
Muskogee,State House,Chris Sneed,REP,510038,16,66,348,430,14
Muskogee,State House,Jack Reavis,DEM,510038,28,90,398,516,14
Muskogee,Governor,Chris Powell,LIB,510040,0,0,7,7,
Muskogee,Governor,Kevin Stitt,REP,510040,8,19,149,176,
Muskogee,Governor,Drew Edmondson,DEM,510040,6,10,96,112,
Muskogee,Lieutenant Governor,Matt Pinnell,REP,510040,8,18,190,216,
Muskogee,Lieutenant Governor,Anastasia Pittman,DEM,510040,6,10,57,73,
Muskogee,Lieutenant Governor,Ivan Holmes,IND,510040,0,1,1,2,
Muskogee,State Auditor,John Yeutter,LIB,510040,3,7,34,44,
Muskogee,State Auditor,Cindy Byrd,REP,510040,8,21,205,234,
Muskogee,Attorney General,Mike Hunter,REP,510040,8,20,195,223,
Muskogee,Attorney General,Mark Myles,DEM,510040,6,9,53,68,
Muskogee,State Treasurer,Randy Mcdaniel,REP,510040,9,21,193,223,
Muskogee,State Treasurer,Charles De Coune,IND,510040,2,7,45,54,
Muskogee,Superintendent of Public Instruction,Joy Hofmeister,REP,510040,9,19,176,204,
Muskogee,Superintendent of Public Instruction,John Cox,DEM,510040,5,9,61,75,
Muskogee,Superintendent of Public Instruction,Larry Huff,IND,510040,0,1,14,15,
Muskogee,Commissioner of Labor,Leslie Osborn,REP,510040,8,20,177,205,
Muskogee,Commissioner of Labor,Fred Dorrell,DEM,510040,6,9,59,74,
Muskogee,Commissioner of Labor,Brandt Dismukes,IND,510040,0,0,13,13,
Muskogee,Insurance Commissioner,Glen Mulready,REP,510040,8,20,185,213,
Muskogee,Insurance Commissioner,Kimberly Fobbs,DEM,510040,6,9,63,78,
Muskogee,Corporation Commissioner,Bob Anthony,REP,510040,8,18,186,212,
Muskogee,Corporation Commissioner,Ashley Nicole Mccray,DEM,510040,6,10,48,64,
Muskogee,Corporation Commissioner,Jackie Short,IND,510040,0,1,14,15,
Muskogee,U.S. House,Richard Castaldo,LIB,510040,0,1,3,4,2
Muskogee,U.S. House,Markwayne Mullin,REP,510040,7,19,179,205,2
Muskogee,U.S. House,Jason Nichols,DEM,510040,6,9,65,80,2
Muskogee,U.S. House,John Foreman,IND,510040,1,0,5,6,2
Muskogee,State House,Chris Sneed,REP,510040,8,20,183,211,14
Muskogee,State House,Jack Reavis,DEM,510040,6,9,69,84,14
Muskogee,Governor,Chris Powell,LIB,510041,1,2,50,53,
Muskogee,Governor,Kevin Stitt,REP,510041,40,97,777,914,
Muskogee,Governor,Drew Edmondson,DEM,510041,24,78,630,732,
Muskogee,Lieutenant Governor,Matt Pinnell,REP,510041,46,115,938,1099,
Muskogee,Lieutenant Governor,Anastasia Pittman,DEM,510041,16,61,453,530,
Muskogee,Lieutenant Governor,Ivan Holmes,IND,510041,4,1,45,50,
Muskogee,State Auditor,John Yeutter,LIB,510041,7,34,329,370,
Muskogee,State Auditor,Cindy Byrd,REP,510041,54,133,1046,1233,
Muskogee,Attorney General,Mike Hunter,REP,510041,45,114,971,1130,
Muskogee,Attorney General,Mark Myles,DEM,510041,20,63,460,543,
Muskogee,State Treasurer,Randy Mcdaniel,REP,510041,52,129,1042,1223,
Muskogee,State Treasurer,Charles De Coune,IND,510041,9,37,330,376,
Muskogee,Superintendent of Public Instruction,Joy Hofmeister,REP,510041,42,107,840,989,
Muskogee,Superintendent of Public Instruction,John Cox,DEM,510041,21,62,501,584,
Muskogee,Superintendent of Public Instruction,Larry Huff,IND,510041,3,8,104,115,
Muskogee,Commissioner of Labor,Leslie Osborn,REP,510041,44,112,903,1059,
Muskogee,Commissioner of Labor,Fred Dorrell,DEM,510041,20,59,453,532,
Muskogee,Commissioner of Labor,Brandt Dismukes,IND,510041,2,6,70,78,
Muskogee,Insurance Commissioner,Glen Mulready,REP,510041,43,113,937,1093,
Muskogee,Insurance Commissioner,Kimberly Fobbs,DEM,510041,22,61,490,573,
Muskogee,Corporation Commissioner,Bob Anthony,REP,510041,39,111,882,1032,
Muskogee,Corporation Commissioner,Ashley Nicole Mccray,DEM,510041,24,61,462,547,
Muskogee,Corporation Commissioner,Jackie Short,IND,510041,3,6,84,93,
Muskogee,U.S. House,Richard Castaldo,LIB,510041,2,5,28,35,2
Muskogee,U.S. House,Markwayne Mullin,REP,510041,40,100,827,967,2
Muskogee,U.S. House,Jason Nichols,DEM,510041,24,70,546,640,2
Muskogee,U.S. House,John Foreman,IND,510041,0,3,40,43,2
Muskogee,State Senate,Kim David,REP,510041,44,117,914,1075,18
Muskogee,State Senate,Charles Arnall,DEM,510041,21,60,530,611,18
Muskogee,State House,Chris Sneed,REP,510041,39,107,872,1018,14
Muskogee,State House,Jack Reavis,DEM,510041,26,71,580,677,14
Muskogee,Governor,Chris Powell,LIB,510044,1,0,13,14,
Muskogee,Governor,Kevin Stitt,REP,510044,4,5,243,252,
Muskogee,Governor,Drew Edmondson,DEM,510044,4,3,128,135,
Muskogee,Lieutenant Governor,Matt Pinnell,REP,510044,6,7,267,280,
Muskogee,Lieutenant Governor,Anastasia Pittman,DEM,510044,3,1,101,105,
Muskogee,Lieutenant Governor,Ivan Holmes,IND,510044,0,0,13,13,
Muskogee,State Auditor,John Yeutter,LIB,510044,3,2,73,78,
Muskogee,State Auditor,Cindy Byrd,REP,510044,3,6,288,297,
Muskogee,Attorney General,Mike Hunter,REP,510044,6,6,263,275,
Muskogee,Attorney General,Mark Myles,DEM,510044,3,2,114,119,
Muskogee,State Treasurer,Randy Mcdaniel,REP,510044,6,6,286,298,
Muskogee,State Treasurer,Charles De Coune,IND,510044,3,2,73,78,
Muskogee,Superintendent of Public Instruction,Joy Hofmeister,REP,510044,6,6,220,232,
Muskogee,Superintendent of Public Instruction,John Cox,DEM,510044,1,1,127,129,
Muskogee,Superintendent of Public Instruction,Larry Huff,IND,510044,1,1,30,32,
Muskogee,Commissioner of Labor,Leslie Osborn,REP,510044,5,6,245,256,
Muskogee,Commissioner of Labor,Fred Dorrell,DEM,510044,2,2,118,122,
Muskogee,Commissioner of Labor,Brandt Dismukes,IND,510044,1,0,13,14,
Muskogee,Insurance Commissioner,Glen Mulready,REP,510044,5,6,263,274,
Muskogee,Insurance Commissioner,Kimberly Fobbs,DEM,510044,3,2,113,118,
Muskogee,Corporation Commissioner,Bob Anthony,REP,510044,5,5,243,253,
Muskogee,Corporation Commissioner,Ashley Nicole Mccray,DEM,510044,3,2,118,123,
Muskogee,Corporation Commissioner,Jackie Short,IND,510044,0,1,17,18,
Muskogee,U.S. House,Richard Castaldo,LIB,510044,0,0,5,5,2
Muskogee,U.S. House,Markwayne Mullin,REP,510044,5,5,260,270,2
Muskogee,U.S. House,Jason Nichols,DEM,510044,3,3,98,104,2
Muskogee,U.S. House,John Foreman,IND,510044,1,0,18,19,2
Muskogee,State House,Chris Sneed,REP,510044,6,6,226,238,14
Muskogee,State House,Jack Reavis,DEM,510044,3,2,149,154,14
Muskogee,Governor,Chris Powell,LIB,510045,0,0,13,13,
Muskogee,Governor,Kevin Stitt,REP,510045,2,14,253,269,
Muskogee,Governor,Drew Edmondson,DEM,510045,6,8,193,207,
Muskogee,Lieutenant Governor,Matt Pinnell,REP,510045,2,18,295,315,
Muskogee,Lieutenant Governor,Anastasia Pittman,DEM,510045,6,3,148,157,
Muskogee,Lieutenant Governor,Ivan Holmes,IND,510045,0,0,9,9,
Muskogee,State Auditor,John Yeutter,LIB,510045,1,2,95,98,
Muskogee,State Auditor,Cindy Byrd,REP,510045,5,17,325,347,
Muskogee,Attorney General,Mike Hunter,REP,510045,3,15,318,336,
Muskogee,Attorney General,Mark Myles,DEM,510045,5,6,132,143,
Muskogee,State Treasurer,Randy Mcdaniel,REP,510045,4,18,328,350,
Muskogee,State Treasurer,Charles De Coune,IND,510045,2,1,92,95,
Muskogee,Superintendent of Public Instruction,Joy Hofmeister,REP,510045,2,14,286,302,
Muskogee,Superintendent of Public Instruction,John Cox,DEM,510045,6,6,134,146,
Muskogee,Superintendent of Public Instruction,Larry Huff,IND,510045,0,1,34,35,
Muskogee,Commissioner of Labor,Leslie Osborn,REP,510045,2,16,279,297,
Muskogee,Commissioner of Labor,Fred Dorrell,DEM,510045,5,4,151,160,
Muskogee,Commissioner of Labor,Brandt Dismukes,IND,510045,0,1,17,18,
Muskogee,Insurance Commissioner,Glen Mulready,REP,510045,3,16,292,311,
Muskogee,Insurance Commissioner,Kimberly Fobbs,DEM,510045,5,4,157,166,
Muskogee,Corporation Commissioner,Bob Anthony,REP,510045,2,18,289,309,
Muskogee,Corporation Commissioner,Ashley Nicole Mccray,DEM,510045,5,4,141,150,
Muskogee,Corporation Commissioner,Jackie Short,IND,510045,0,0,21,21,
Muskogee,U.S. House,Richard Castaldo,LIB,510045,0,0,4,4,2
Muskogee,U.S. House,Markwayne Mullin,REP,510045,2,15,285,302,2
Muskogee,U.S. House,Jason Nichols,DEM,510045,6,6,153,165,2
Muskogee,U.S. House,John Foreman,IND,510045,0,0,15,15,2
Muskogee,State House,Chris Sneed,REP,510045,2,15,261,278,14
Muskogee,State House,Jack Reavis,DEM,510045,6,7,195,208,14
Muskogee,Governor,Chris Powell,LIB,510046,0,2,22,24,
Muskogee,Governor,Kevin Stitt,REP,510046,8,43,402,453,
Muskogee,Governor,Drew Edmondson,DEM,510046,10,26,335,371,
Muskogee,Lieutenant Governor,Matt Pinnell,REP,510046,8,46,490,544,
Muskogee,Lieutenant Governor,Anastasia Pittman,DEM,510046,10,24,240,274,
Muskogee,Lieutenant Governor,Ivan Holmes,IND,510046,0,1,22,23,
Muskogee,State Auditor,John Yeutter,LIB,510046,8,13,141,162,
Muskogee,State Auditor,Cindy Byrd,REP,510046,10,53,562,625,
Muskogee,Attorney General,Mike Hunter,REP,510046,11,51,510,572,
Muskogee,Attorney General,Mark Myles,DEM,510046,7,19,237,263,
Muskogee,State Treasurer,Randy Mcdaniel,REP,510046,11,51,531,593,
Muskogee,State Treasurer,Charles De Coune,IND,510046,7,15,170,192,
Muskogee,Superintendent of Public Instruction,Joy Hofmeister,REP,510046,10,45,442,497,
Muskogee,Superintendent of Public Instruction,John Cox,DEM,510046,7,18,243,268,
Muskogee,Superintendent of Public Instruction,Larry Huff,IND,510046,1,6,68,75,
Muskogee,Commissioner of Labor,Leslie Osborn,REP,510046,8,45,460,513,
Muskogee,Commissioner of Labor,Fred Dorrell,DEM,510046,9,22,245,276,
Muskogee,Commissioner of Labor,Brandt Dismukes,IND,510046,1,2,36,39,
Muskogee,Insurance Commissioner,Glen Mulready,REP,510046,7,47,459,513,
Muskogee,Insurance Commissioner,Kimberly Fobbs,DEM,510046,11,23,287,321,
Muskogee,Corporation Commissioner,Bob Anthony,REP,510046,9,47,483,539,
Muskogee,Corporation Commissioner,Ashley Nicole Mccray,DEM,510046,9,20,235,264,
Muskogee,Corporation Commissioner,Jackie Short,IND,510046,0,4,31,35,
Muskogee,U.S. House,Richard Castaldo,LIB,510046,0,0,7,7,2
Muskogee,U.S. House,Markwayne Mullin,REP,510046,8,45,458,511,2
Muskogee,U.S. House,Jason Nichols,DEM,510046,10,20,264,294,2
Muskogee,U.S. House,John Foreman,IND,510046,0,4,24,28,2
Muskogee,State House,Avery Carl Frix,REP,510046,10,57,584,651,13
Muskogee,State House,Jolene Armstrong,DEM,510046,8,13,170,191,13
Muskogee,Governor,Chris Powell,LIB,510047,0,2,21,23,
Muskogee,Governor,Kevin Stitt,REP,510047,8,18,223,249,
Muskogee,Governor,Drew Edmondson,DEM,510047,7,31,250,288,
Muskogee,Lieutenant Governor,Matt Pinnell,REP,510047,7,18,269,294,
Muskogee,Lieutenant Governor,Anastasia Pittman,DEM,510047,7,33,208,248,
Muskogee,Lieutenant Governor,Ivan Holmes,IND,510047,1,0,17,18,
Muskogee,State Auditor,John Yeutter,LIB,510047,4,20,148,172,
Muskogee,State Auditor,Cindy Byrd,REP,510047,10,26,317,353,
Muskogee,Attorney General,Mike Hunter,REP,510047,8,22,278,308,
Muskogee,Attorney General,Mark Myles,DEM,510047,7,29,215,251,
Muskogee,State Treasurer,Randy Mcdaniel,REP,510047,9,24,316,349,
Muskogee,State Treasurer,Charles De Coune,IND,510047,5,23,149,177,
Muskogee,Superintendent of Public Instruction,Joy Hofmeister,REP,510047,9,19,252,280,
Muskogee,Superintendent of Public Instruction,John Cox,DEM,510047,6,29,205,240,
Muskogee,Superintendent of Public Instruction,Larry Huff,IND,510047,0,3,35,38,
Muskogee,Commissioner of Labor,Leslie Osborn,REP,510047,10,20,255,285,
Muskogee,Commissioner of Labor,Fred Dorrell,DEM,510047,4,29,209,242,
Muskogee,Commissioner of Labor,Brandt Dismukes,IND,510047,1,2,28,31,
Muskogee,Insurance Commissioner,Glen Mulready,REP,510047,7,17,263,287,
Muskogee,Insurance Commissioner,Kimberly Fobbs,DEM,510047,7,34,231,272,
Muskogee,Corporation Commissioner,Bob Anthony,REP,510047,7,22,272,301,
Muskogee,Corporation Commissioner,Ashley Nicole Mccray,DEM,510047,8,29,198,235,
Muskogee,Corporation Commissioner,Jackie Short,IND,510047,0,0,24,24,
Muskogee,U.S. House,Richard Castaldo,LIB,510047,0,1,15,16,2
Muskogee,U.S. House,Markwayne Mullin,REP,510047,7,22,261,290,2
Muskogee,U.S. House,Jason Nichols,DEM,510047,7,28,209,244,2
Muskogee,U.S. House,John Foreman,IND,510047,1,0,10,11,2
Muskogee,State House,Avery Carl Frix,REP,510047,8,28,349,385,13
Muskogee,State House,Jolene Armstrong,DEM,510047,7,23,146,176,13
Muskogee,Governor,Chris Powell,LIB,510049,1,2,4,7,
Muskogee,Governor,Kevin Stitt,REP,510049,4,22,88,114,
Muskogee,Governor,Drew Edmondson,DEM,510049,3,8,89,100,
Muskogee,Lieutenant Governor,Matt Pinnell,REP,510049,5,24,103,132,
Muskogee,Lieutenant Governor,Anastasia Pittman,DEM,510049,3,7,69,79,
Muskogee,Lieutenant Governor,Ivan Holmes,IND,510049,0,1,6,7,
Muskogee,State Auditor,John Yeutter,LIB,510049,1,6,40,47,
Muskogee,State Auditor,Cindy Byrd,REP,510049,6,24,125,155,
Muskogee,Attorney General,Mike Hunter,REP,510049,6,24,117,147,
Muskogee,Attorney General,Mark Myles,DEM,510049,2,8,63,73,
Muskogee,State Treasurer,Randy Mcdaniel,REP,510049,6,25,129,160,
Muskogee,State Treasurer,Charles De Coune,IND,510049,0,5,35,40,
Muskogee,Superintendent of Public Instruction,Joy Hofmeister,REP,510049,5,19,101,125,
Muskogee,Superintendent of Public Instruction,John Cox,DEM,510049,2,7,66,75,
Muskogee,Superintendent of Public Instruction,Larry Huff,IND,510049,1,5,12,18,
Muskogee,Commissioner of Labor,Leslie Osborn,REP,510049,5,23,103,131,
Muskogee,Commissioner of Labor,Fred Dorrell,DEM,510049,2,7,67,76,
Muskogee,Commissioner of Labor,Brandt Dismukes,IND,510049,0,1,7,8,
Muskogee,Insurance Commissioner,Glen Mulready,REP,510049,5,24,108,137,
Muskogee,Insurance Commissioner,Kimberly Fobbs,DEM,510049,2,8,69,79,
Muskogee,Corporation Commissioner,Bob Anthony,REP,510049,5,20,105,130,
Muskogee,Corporation Commissioner,Ashley Nicole Mccray,DEM,510049,2,10,65,77,
Muskogee,Corporation Commissioner,Jackie Short,IND,510049,0,1,9,10,
Muskogee,U.S. House,Richard Castaldo,LIB,510049,0,0,8,8,2
Muskogee,U.S. House,Markwayne Mullin,REP,510049,5,20,105,130,2
Muskogee,U.S. House,Jason Nichols,DEM,510049,2,8,60,70,2
Muskogee,U.S. House,John Foreman,IND,510049,0,3,6,9,2
Muskogee,State House,Chris Sneed,REP,510049,5,19,89,113,14
Muskogee,State House,Jack Reavis,DEM,510049,2,13,88,103,14
Muskogee,Governor,Chris Powell,LIB,510050,0,0,3,3,
Muskogee,Governor,Kevin Stitt,REP,510050,0,2,95,97,
Muskogee,Governor,Drew Edmondson,DEM,510050,2,5,82,89,
Muskogee,Lieutenant Governor,Matt Pinnell,REP,510050,0,2,97,99,
Muskogee,Lieutenant Governor,Anastasia Pittman,DEM,510050,2,5,79,86,
Muskogee,Lieutenant Governor,Ivan Holmes,IND,510050,0,0,4,4,
Muskogee,State Auditor,John Yeutter,LIB,510050,1,3,55,59,
Muskogee,State Auditor,Cindy Byrd,REP,510050,0,2,102,104,
Muskogee,Attorney General,Mike Hunter,REP,510050,0,2,97,99,
Muskogee,Attorney General,Mark Myles,DEM,510050,2,5,83,90,
Muskogee,State Treasurer,Randy Mcdaniel,REP,510050,0,2,101,103,
Muskogee,State Treasurer,Charles De Coune,IND,510050,1,2,58,61,
Muskogee,Superintendent of Public Instruction,Joy Hofmeister,REP,510050,0,1,81,82,
Muskogee,Superintendent of Public Instruction,John Cox,DEM,510050,2,6,91,99,
Muskogee,Superintendent of Public Instruction,Larry Huff,IND,510050,0,0,8,8,
Muskogee,Commissioner of Labor,Leslie Osborn,REP,510050,0,2,94,96,
Muskogee,Commissioner of Labor,Fred Dorrell,DEM,510050,2,5,80,87,
Muskogee,Commissioner of Labor,Brandt Dismukes,IND,510050,0,0,7,7,
Muskogee,Insurance Commissioner,Glen Mulready,REP,510050,0,2,96,98,
Muskogee,Insurance Commissioner,Kimberly Fobbs,DEM,510050,2,5,84,91,
Muskogee,Corporation Commissioner,Bob Anthony,REP,510050,0,2,95,97,
Muskogee,Corporation Commissioner,Ashley Nicole Mccray,DEM,510050,2,5,79,86,
Muskogee,Corporation Commissioner,Jackie Short,IND,510050,0,0,6,6,
Muskogee,U.S. House,Richard Castaldo,LIB,510050,0,0,2,2,2
Muskogee,U.S. House,Markwayne Mullin,REP,510050,0,1,91,92,2
Muskogee,U.S. House,Jason Nichols,DEM,510050,2,6,83,91,2
Muskogee,U.S. House,John Foreman,IND,510050,0,0,5,5,2
Muskogee,State Senate,Kim David,REP,510050,0,2,96,98,18
Muskogee,State Senate,Charles Arnall,DEM,510050,2,5,83,90,18
Muskogee,State House,Scott Fetgatter,REP,510050,0,2,91,93,16
Muskogee,State House,Chandler Torbett,DEM,510050,2,5,82,89,16
Muskogee,State House,James Delso,IND,510050,0,0,7,7,16
Muskogee,Governor,Chris Powell,LIB,510051,0,0,5,5,
Muskogee,Governor,Kevin Stitt,REP,510051,1,0,59,60,
Muskogee,Governor,Drew Edmondson,DEM,510051,0,1,37,38,
Muskogee,Lieutenant Governor,Matt Pinnell,REP,510051,1,0,67,68,
Muskogee,Lieutenant Governor,Anastasia Pittman,DEM,510051,0,1,32,33,
Muskogee,Lieutenant Governor,Ivan Holmes,IND,510051,0,0,1,1,
Muskogee,State Auditor,John Yeutter,LIB,510051,0,0,21,21,
Muskogee,State Auditor,Cindy Byrd,REP,510051,1,0,71,72,
Muskogee,Attorney General,Mike Hunter,REP,510051,1,0,62,63,
Muskogee,Attorney General,Mark Myles,DEM,510051,0,1,39,40,
Muskogee,State Treasurer,Randy Mcdaniel,REP,510051,0,0,75,75,
Muskogee,State Treasurer,Charles De Coune,IND,510051,1,0,21,22,
Muskogee,Superintendent of Public Instruction,Joy Hofmeister,REP,510051,0,0,51,51,
Muskogee,Superintendent of Public Instruction,John Cox,DEM,510051,1,1,42,44,
Muskogee,Superintendent of Public Instruction,Larry Huff,IND,510051,0,0,8,8,
Muskogee,Commissioner of Labor,Leslie Osborn,REP,510051,0,0,57,57,
Muskogee,Commissioner of Labor,Fred Dorrell,DEM,510051,1,1,41,43,
Muskogee,Commissioner of Labor,Brandt Dismukes,IND,510051,0,0,2,2,
Muskogee,Insurance Commissioner,Glen Mulready,REP,510051,1,0,64,65,
Muskogee,Insurance Commissioner,Kimberly Fobbs,DEM,510051,0,1,36,37,
Muskogee,Corporation Commissioner,Bob Anthony,REP,510051,0,0,63,63,
Muskogee,Corporation Commissioner,Ashley Nicole Mccray,DEM,510051,0,1,37,38,
Muskogee,Corporation Commissioner,Jackie Short,IND,510051,1,0,1,2,
Muskogee,U.S. House,Richard Castaldo,LIB,510051,0,0,0,0,2
Muskogee,U.S. House,Markwayne Mullin,REP,510051,0,0,61,61,2
Muskogee,U.S. House,Jason Nichols,DEM,510051,0,1,37,38,2
Muskogee,U.S. House,John Foreman,IND,510051,1,0,3,4,2
Muskogee,State Senate,Kim David,REP,510051,0,0,60,60,18
Muskogee,State Senate,Charles Arnall,DEM,510051,1,1,41,43,18
Muskogee,State House,Scott Fetgatter,REP,510051,0,0,59,59,16
Muskogee,State House,Chandler Torbett,DEM,510051,1,1,40,42,16
Muskogee,State House,James Delso,IND,510051,0,0,2,2,16
Muskogee,Governor,Chris Powell,LIB,510052,0,0,7,7,
Muskogee,Governor,Kevin Stitt,REP,510052,3,9,111,123,
Muskogee,Governor,Drew Edmondson,DEM,510052,0,9,80,89,
Muskogee,Lieutenant Governor,Matt Pinnell,REP,510052,2,9,129,140,
Muskogee,Lieutenant Governor,Anastasia Pittman,DEM,510052,1,9,61,71,
Muskogee,Lieutenant Governor,Ivan Holmes,IND,510052,0,0,5,5,
Muskogee,State Auditor,John Yeutter,LIB,510052,0,4,34,38,
Muskogee,State Auditor,Cindy Byrd,REP,510052,3,13,144,160,
Muskogee,Attorney General,Mike Hunter,REP,510052,2,11,123,136,
Muskogee,Attorney General,Mark Myles,DEM,510052,1,7,69,77,
Muskogee,State Treasurer,Randy Mcdaniel,REP,510052,2,11,132,145,
Muskogee,State Treasurer,Charles De Coune,IND,510052,1,5,47,53,
Muskogee,Superintendent of Public Instruction,Joy Hofmeister,REP,510052,1,9,94,104,
Muskogee,Superintendent of Public Instruction,John Cox,DEM,510052,2,7,84,93,
Muskogee,Superintendent of Public Instruction,Larry Huff,IND,510052,0,2,18,20,
Muskogee,Commissioner of Labor,Leslie Osborn,REP,510052,3,8,113,124,
Muskogee,Commissioner of Labor,Fred Dorrell,DEM,510052,0,9,65,74,
Muskogee,Commissioner of Labor,Brandt Dismukes,IND,510052,0,1,14,15,
Muskogee,Insurance Commissioner,Glen Mulready,REP,510052,2,9,126,137,
Muskogee,Insurance Commissioner,Kimberly Fobbs,DEM,510052,1,9,66,76,
Muskogee,Corporation Commissioner,Bob Anthony,REP,510052,2,10,113,125,
Muskogee,Corporation Commissioner,Ashley Nicole Mccray,DEM,510052,1,8,69,78,
Muskogee,Corporation Commissioner,Jackie Short,IND,510052,0,0,9,9,
Muskogee,U.S. House,Richard Castaldo,LIB,510052,0,0,4,4,2
Muskogee,U.S. House,Markwayne Mullin,REP,510052,3,10,125,138,2
Muskogee,U.S. House,Jason Nichols,DEM,510052,0,8,61,69,2
Muskogee,U.S. House,John Foreman,IND,510052,0,0,5,5,2
Muskogee,State Senate,Kim David,REP,510052,3,9,123,135,18
Muskogee,State Senate,Charles Arnall,DEM,510052,0,9,68,77,18
Muskogee,State House,Avery Carl Frix,REP,510052,3,12,145,160,13
Muskogee,State House,Jolene Armstrong,DEM,510052,0,5,50,55,13
Muskogee,Governor,Chris Powell,LIB,510053,0,2,19,21,
Muskogee,Governor,Kevin Stitt,REP,510053,11,11,237,259,
Muskogee,Governor,Drew Edmondson,DEM,510053,4,7,176,187,
Muskogee,Lieutenant Governor,Matt Pinnell,REP,510053,13,13,293,319,
Muskogee,Lieutenant Governor,Anastasia Pittman,DEM,510053,1,6,121,128,
Muskogee,Lieutenant Governor,Ivan Holmes,IND,510053,1,1,19,21,
Muskogee,State Auditor,John Yeutter,LIB,510053,3,5,95,103,
Muskogee,State Auditor,Cindy Byrd,REP,510053,11,14,318,343,
Muskogee,Attorney General,Mike Hunter,REP,510053,12,15,298,325,
Muskogee,Attorney General,Mark Myles,DEM,510053,2,5,131,138,
Muskogee,State Treasurer,Randy Mcdaniel,REP,510053,14,15,337,366,
Muskogee,State Treasurer,Charles De Coune,IND,510053,1,4,74,79,
Muskogee,Superintendent of Public Instruction,Joy Hofmeister,REP,510053,11,12,240,263,
Muskogee,Superintendent of Public Instruction,John Cox,DEM,510053,3,5,147,155,
Muskogee,Superintendent of Public Instruction,Larry Huff,IND,510053,1,3,45,49,
Muskogee,Commissioner of Labor,Leslie Osborn,REP,510053,11,15,266,292,
Muskogee,Commissioner of Labor,Fred Dorrell,DEM,510053,1,5,130,136,
Muskogee,Commissioner of Labor,Brandt Dismukes,IND,510053,3,0,31,34,
Muskogee,Insurance Commissioner,Glen Mulready,REP,510053,13,14,276,303,
Muskogee,Insurance Commissioner,Kimberly Fobbs,DEM,510053,1,6,153,160,
Muskogee,Corporation Commissioner,Bob Anthony,REP,510053,13,12,277,302,
Muskogee,Corporation Commissioner,Ashley Nicole Mccray,DEM,510053,2,6,134,142,
Muskogee,Corporation Commissioner,Jackie Short,IND,510053,0,2,19,21,
Muskogee,U.S. House,Richard Castaldo,LIB,510053,0,3,14,17,2
Muskogee,U.S. House,Markwayne Mullin,REP,510053,10,14,285,309,2
Muskogee,U.S. House,Jason Nichols,DEM,510053,5,3,124,132,2
Muskogee,U.S. House,John Foreman,IND,510053,0,0,10,10,2
Muskogee,State House,Avery Carl Frix,REP,510053,13,17,352,382,13
Muskogee,State House,Jolene Armstrong,DEM,510053,1,3,79,83,13
Muskogee,Governor,Chris Powell,LIB,510055,4,4,37,45,
Muskogee,Governor,Kevin Stitt,REP,510055,35,115,754,904,
Muskogee,Governor,Drew Edmondson,DEM,510055,20,92,522,634,
Muskogee,Lieutenant Governor,Matt Pinnell,REP,510055,38,137,885,1060,
Muskogee,Lieutenant Governor,Anastasia Pittman,DEM,510055,19,71,388,478,
Muskogee,Lieutenant Governor,Ivan Holmes,IND,510055,1,3,30,34,
Muskogee,State Auditor,John Yeutter,LIB,510055,12,45,249,306,
Muskogee,State Auditor,Cindy Byrd,REP,510055,41,146,976,1163,
Muskogee,Attorney General,Mike Hunter,REP,510055,36,129,898,1063,
Muskogee,Attorney General,Mark Myles,DEM,510055,22,81,394,497,
Muskogee,State Treasurer,Randy Mcdaniel,REP,510055,37,142,948,1127,
Muskogee,State Treasurer,Charles De Coune,IND,510055,16,49,270,335,
Muskogee,Superintendent of Public Instruction,Joy Hofmeister,REP,510055,35,111,777,923,
Muskogee,Superintendent of Public Instruction,John Cox,DEM,510055,20,81,422,523,
Muskogee,Superintendent of Public Instruction,Larry Huff,IND,510055,3,18,96,117,
Muskogee,Commissioner of Labor,Leslie Osborn,REP,510055,33,116,815,964,
Muskogee,Commissioner of Labor,Fred Dorrell,DEM,510055,22,84,415,521,
Muskogee,Commissioner of Labor,Brandt Dismukes,IND,510055,2,9,56,67,
Muskogee,Insurance Commissioner,Glen Mulready,REP,510055,34,122,850,1006,
Muskogee,Insurance Commissioner,Kimberly Fobbs,DEM,510055,22,88,438,548,
Muskogee,Corporation Commissioner,Bob Anthony,REP,510055,36,125,827,988,
Muskogee,Corporation Commissioner,Ashley Nicole Mccray,DEM,510055,20,78,412,510,
Muskogee,Corporation Commissioner,Jackie Short,IND,510055,1,6,50,57,
Muskogee,U.S. House,Richard Castaldo,LIB,510055,2,2,27,31,2
Muskogee,U.S. House,Markwayne Mullin,REP,510055,40,121,846,1007,2
Muskogee,U.S. House,Jason Nichols,DEM,510055,16,81,395,492,2
Muskogee,U.S. House,John Foreman,IND,510055,1,5,39,45,2
Muskogee,State House,Avery Carl Frix,REP,510055,41,156,1022,1219,13
Muskogee,State House,Jolene Armstrong,DEM,510055,16,54,286,356,13
Muskogee,Governor,Chris Powell,LIB,510056,0,0,4,4,
Muskogee,Governor,Kevin Stitt,REP,510056,3,5,66,74,
Muskogee,Governor,Drew Edmondson,DEM,510056,1,3,42,46,
Muskogee,Lieutenant Governor,Matt Pinnell,REP,510056,3,6,84,93,
Muskogee,Lieutenant Governor,Anastasia Pittman,DEM,510056,1,2,28,31,
Muskogee,Lieutenant Governor,Ivan Holmes,IND,510056,0,0,0,0,
Muskogee,State Auditor,John Yeutter,LIB,510056,1,2,17,20,
Muskogee,State Auditor,Cindy Byrd,REP,510056,3,6,93,102,
Muskogee,Attorney General,Mike Hunter,REP,510056,3,6,82,91,
Muskogee,Attorney General,Mark Myles,DEM,510056,1,2,29,32,
Muskogee,State Treasurer,Randy Mcdaniel,REP,510056,3,7,89,99,
Muskogee,State Treasurer,Charles De Coune,IND,510056,1,1,20,22,
Muskogee,Superintendent of Public Instruction,Joy Hofmeister,REP,510056,3,8,70,81,
Muskogee,Superintendent of Public Instruction,John Cox,DEM,510056,1,0,32,33,
Muskogee,Superintendent of Public Instruction,Larry Huff,IND,510056,0,0,9,9,
Muskogee,Commissioner of Labor,Leslie Osborn,REP,510056,3,7,74,84,
Muskogee,Commissioner of Labor,Fred Dorrell,DEM,510056,1,1,33,35,
Muskogee,Commissioner of Labor,Brandt Dismukes,IND,510056,0,0,4,4,
Muskogee,Insurance Commissioner,Glen Mulready,REP,510056,3,7,80,90,
Muskogee,Insurance Commissioner,Kimberly Fobbs,DEM,510056,1,1,31,33,
Muskogee,Corporation Commissioner,Bob Anthony,REP,510056,3,7,80,90,
Muskogee,Corporation Commissioner,Ashley Nicole Mccray,DEM,510056,1,1,30,32,
Muskogee,Corporation Commissioner,Jackie Short,IND,510056,0,0,2,2,
Muskogee,U.S. House,Richard Castaldo,LIB,510056,0,0,1,1,2
Muskogee,U.S. House,Markwayne Mullin,REP,510056,3,5,80,88,2
Muskogee,U.S. House,Jason Nichols,DEM,510056,1,3,31,35,2
Muskogee,U.S. House,John Foreman,IND,510056,0,0,1,1,2
Muskogee,State House,Avery Carl Frix,REP,510056,3,7,89,99,13
Muskogee,State House,Jolene Armstrong,DEM,510056,1,1,24,26,13
Muskogee,Governor,Chris Powell,LIB,510057,0,1,2,3,
Muskogee,Governor,Kevin Stitt,REP,510057,0,0,14,14,
Muskogee,Governor,Drew Edmondson,DEM,510057,0,1,7,8,
Muskogee,Lieutenant Governor,Matt Pinnell,REP,510057,0,0,15,15,
Muskogee,Lieutenant Governor,Anastasia Pittman,DEM,510057,0,1,6,7,
Muskogee,Lieutenant Governor,Ivan Holmes,IND,510057,0,1,2,3,
Muskogee,State Auditor,John Yeutter,LIB,510057,0,0,7,7,
Muskogee,State Auditor,Cindy Byrd,REP,510057,0,2,15,17,
Muskogee,Attorney General,Mike Hunter,REP,510057,0,1,17,18,
Muskogee,Attorney General,Mark Myles,DEM,510057,0,1,6,7,
Muskogee,State Treasurer,Randy Mcdaniel,REP,510057,0,1,15,16,
Muskogee,State Treasurer,Charles De Coune,IND,510057,0,1,7,8,
Muskogee,Superintendent of Public Instruction,Joy Hofmeister,REP,510057,0,0,11,11,
Muskogee,Superintendent of Public Instruction,John Cox,DEM,510057,0,1,8,9,
Muskogee,Superintendent of Public Instruction,Larry Huff,IND,510057,0,1,4,5,
Muskogee,Commissioner of Labor,Leslie Osborn,REP,510057,0,1,15,16,
Muskogee,Commissioner of Labor,Fred Dorrell,DEM,510057,0,1,6,7,
Muskogee,Commissioner of Labor,Brandt Dismukes,IND,510057,0,0,2,2,
Muskogee,Insurance Commissioner,Glen Mulready,REP,510057,0,0,16,16,
Muskogee,Insurance Commissioner,Kimberly Fobbs,DEM,510057,0,2,7,9,
Muskogee,Corporation Commissioner,Bob Anthony,REP,510057,0,1,15,16,
Muskogee,Corporation Commissioner,Ashley Nicole Mccray,DEM,510057,0,1,6,7,
Muskogee,Corporation Commissioner,Jackie Short,IND,510057,0,0,2,2,
Muskogee,U.S. House,Richard Castaldo,LIB,510057,0,0,0,0,2
Muskogee,U.S. House,Markwayne Mullin,REP,510057,0,0,14,14,2
Muskogee,U.S. House,Jason Nichols,DEM,510057,0,1,7,8,2
Muskogee,U.S. House,John Foreman,IND,510057,0,1,2,3,2
Muskogee,State House,Chris Sneed,REP,510057,0,0,15,15,14
Muskogee,State House,Jack Reavis,DEM,510057,0,2,8,10,14
Muskogee,Governor,Chris Powell,LIB,510058,1,0,19,20,
Muskogee,Governor,Kevin Stitt,REP,510058,4,5,209,218,
Muskogee,Governor,Drew Edmondson,DEM,510058,3,5,140,148,
Muskogee,Lieutenant Governor,Matt Pinnell,REP,510058,3,7,230,240,
Muskogee,Lieutenant Governor,Anastasia Pittman,DEM,510058,3,2,119,124,
Muskogee,Lieutenant Governor,Ivan Holmes,IND,510058,2,1,14,17,
Muskogee,State Auditor,John Yeutter,LIB,510058,1,1,79,81,
Muskogee,State Auditor,Cindy Byrd,REP,510058,4,8,253,265,
Muskogee,Attorney General,Mike Hunter,REP,510058,5,9,242,256,
Muskogee,Attorney General,Mark Myles,DEM,510058,3,1,124,128,
Muskogee,State Treasurer,Randy Mcdaniel,REP,510058,3,8,263,274,
Muskogee,State Treasurer,Charles De Coune,IND,510058,2,1,66,69,
Muskogee,Superintendent of Public Instruction,Joy Hofmeister,REP,510058,7,6,198,211,
Muskogee,Superintendent of Public Instruction,John Cox,DEM,510058,1,3,138,142,
Muskogee,Superintendent of Public Instruction,Larry Huff,IND,510058,0,1,29,30,
Muskogee,Commissioner of Labor,Leslie Osborn,REP,510058,5,8,213,226,
Muskogee,Commissioner of Labor,Fred Dorrell,DEM,510058,3,1,128,132,
Muskogee,Commissioner of Labor,Brandt Dismukes,IND,510058,0,1,21,22,
Muskogee,Insurance Commissioner,Glen Mulready,REP,510058,5,8,226,239,
Muskogee,Insurance Commissioner,Kimberly Fobbs,DEM,510058,3,2,136,141,
Muskogee,Corporation Commissioner,Bob Anthony,REP,510058,3,5,219,227,
Muskogee,Corporation Commissioner,Ashley Nicole Mccray,DEM,510058,3,4,126,133,
Muskogee,Corporation Commissioner,Jackie Short,IND,510058,2,1,21,24,
Muskogee,U.S. House,Richard Castaldo,LIB,510058,0,1,10,11,2
Muskogee,U.S. House,Markwayne Mullin,REP,510058,5,6,235,246,2
Muskogee,U.S. House,Jason Nichols,DEM,510058,3,3,112,118,2
Muskogee,U.S. House,John Foreman,IND,510058,0,0,10,10,2
Muskogee,State Senate,Roger Thompson,REP,510058,2,7,227,236,8
Muskogee,State Senate,Shannan Tucker,DEM,510058,3,2,126,131,8
Muskogee,State Senate,Marlena Nobles,IND,510058,3,1,11,15,8
Muskogee,State House,Chris Sneed,REP,510058,5,7,227,239,14
Muskogee,State House,Jack Reavis,DEM,510058,3,3,138,144,14
Muskogee,Governor,Chris Powell,LIB,510059,1,0,27,28,
Muskogee,Governor,Kevin Stitt,REP,510059,2,9,308,319,
Muskogee,Governor,Drew Edmondson,DEM,510059,7,13,201,221,
Muskogee,Lieutenant Governor,Matt Pinnell,REP,510059,4,10,344,358,
Muskogee,Lieutenant Governor,Anastasia Pittman,DEM,510059,6,11,170,187,
Muskogee,Lieutenant Governor,Ivan Holmes,IND,510059,0,0,17,17,
Muskogee,State Auditor,John Yeutter,LIB,510059,3,2,125,130,
Muskogee,State Auditor,Cindy Byrd,REP,510059,5,18,379,402,
Muskogee,Attorney General,Mike Hunter,REP,510059,3,16,351,370,
Muskogee,Attorney General,Mark Myles,DEM,510059,6,5,175,186,
Muskogee,State Treasurer,Randy Mcdaniel,REP,510059,4,16,380,400,
Muskogee,State Treasurer,Charles De Coune,IND,510059,4,3,125,132,
Muskogee,Superintendent of Public Instruction,Joy Hofmeister,REP,510059,1,10,294,305,
Muskogee,Superintendent of Public Instruction,John Cox,DEM,510059,8,10,196,214,
Muskogee,Superintendent of Public Instruction,Larry Huff,IND,510059,1,0,42,43,
Muskogee,Commissioner of Labor,Leslie Osborn,REP,510059,4,13,327,344,
Muskogee,Commissioner of Labor,Fred Dorrell,DEM,510059,6,8,166,180,
Muskogee,Commissioner of Labor,Brandt Dismukes,IND,510059,0,0,30,30,
Muskogee,Insurance Commissioner,Glen Mulready,REP,510059,2,10,338,350,
Muskogee,Insurance Commissioner,Kimberly Fobbs,DEM,510059,8,11,187,206,
Muskogee,Corporation Commissioner,Bob Anthony,REP,510059,2,13,322,337,
Muskogee,Corporation Commissioner,Ashley Nicole Mccray,DEM,510059,8,7,177,192,
Muskogee,Corporation Commissioner,Jackie Short,IND,510059,0,1,30,31,
Muskogee,U.S. House,Richard Castaldo,LIB,510059,0,0,7,7,2
Muskogee,U.S. House,Markwayne Mullin,REP,510059,2,14,351,367,2
Muskogee,U.S. House,Jason Nichols,DEM,510059,7,7,161,175,2
Muskogee,U.S. House,John Foreman,IND,510059,1,0,17,18,2
Muskogee,State Senate,Roger Thompson,REP,510059,4,15,360,379,8
Muskogee,State Senate,Shannan Tucker,DEM,510059,6,5,143,154,8
Muskogee,State Senate,Marlena Nobles,IND,510059,0,1,23,24,8
Muskogee,State House,Avery Carl Frix,REP,510059,6,19,419,444,13
Muskogee,State House,Jolene Armstrong,DEM,510059,4,3,112,119,13
Muskogee,Governor,Chris Powell,LIB,510060,3,0,4,7,
Muskogee,Governor,Kevin Stitt,REP,510060,1,4,85,90,
Muskogee,Governor,Drew Edmondson,DEM,510060,1,0,61,62,
Muskogee,Lieutenant Governor,Matt Pinnell,REP,510060,1,4,104,109,
Muskogee,Lieutenant Governor,Anastasia Pittman,DEM,510060,1,0,43,44,
Muskogee,Lieutenant Governor,Ivan Holmes,IND,510060,3,0,3,6,
Muskogee,State Auditor,John Yeutter,LIB,510060,4,1,36,41,
Muskogee,State Auditor,Cindy Byrd,REP,510060,1,3,106,110,
Muskogee,Attorney General,Mike Hunter,REP,510060,0,4,101,105,
Muskogee,Attorney General,Mark Myles,DEM,510060,5,0,48,53,
Muskogee,State Treasurer,Randy Mcdaniel,REP,510060,1,3,107,111,
Muskogee,State Treasurer,Charles De Coune,IND,510060,3,1,35,39,
Muskogee,Superintendent of Public Instruction,Joy Hofmeister,REP,510060,2,4,92,98,
Muskogee,Superintendent of Public Instruction,John Cox,DEM,510060,0,0,52,52,
Muskogee,Superintendent of Public Instruction,Larry Huff,IND,510060,3,0,6,9,
Muskogee,Commissioner of Labor,Leslie Osborn,REP,510060,0,3,86,89,
Muskogee,Commissioner of Labor,Fred Dorrell,DEM,510060,5,0,52,57,
Muskogee,Commissioner of Labor,Brandt Dismukes,IND,510060,0,1,9,10,
Muskogee,Insurance Commissioner,Glen Mulready,REP,510060,0,4,96,100,
Muskogee,Insurance Commissioner,Kimberly Fobbs,DEM,510060,5,0,52,57,
Muskogee,Corporation Commissioner,Bob Anthony,REP,510060,1,4,95,100,
Muskogee,Corporation Commissioner,Ashley Nicole Mccray,DEM,510060,0,0,47,47,
Muskogee,Corporation Commissioner,Jackie Short,IND,510060,4,0,8,12,
Muskogee,U.S. House,Richard Castaldo,LIB,510060,0,1,1,2,2
Muskogee,U.S. House,Markwayne Mullin,REP,510060,1,3,104,108,2
Muskogee,U.S. House,Jason Nichols,DEM,510060,0,0,41,41,2
Muskogee,U.S. House,John Foreman,IND,510060,4,0,4,8,2
Muskogee,State Senate,Roger Thompson,REP,510060,0,4,98,102,8
Muskogee,State Senate,Shannan Tucker,DEM,510060,2,0,47,49,8
Muskogee,State Senate,Marlena Nobles,IND,510060,3,0,4,7,8
Muskogee,State House,Randy Randleman,REP,510060,1,3,94,98,15
Muskogee,State House,Judy Ross Moore,DEM,510060,4,1,55,60,15
Muskogee,Governor,Chris Powell,LIB,510061,0,1,12,13,
Muskogee,Governor,Kevin Stitt,REP,510061,4,12,152,168,
Muskogee,Governor,Drew Edmondson,DEM,510061,2,6,125,133,
Muskogee,Lieutenant Governor,Matt Pinnell,REP,510061,4,13,179,196,
Muskogee,Lieutenant Governor,Anastasia Pittman,DEM,510061,2,6,101,109,
Muskogee,Lieutenant Governor,Ivan Holmes,IND,510061,0,1,8,9,
Muskogee,State Auditor,John Yeutter,LIB,510061,1,6,72,79,
Muskogee,State Auditor,Cindy Byrd,REP,510061,4,14,195,213,
Muskogee,Attorney General,Mike Hunter,REP,510061,4,13,185,202,
Muskogee,Attorney General,Mark Myles,DEM,510061,2,7,102,111,
Muskogee,State Treasurer,Randy Mcdaniel,REP,510061,4,13,192,209,
Muskogee,State Treasurer,Charles De Coune,IND,510061,1,6,79,86,
Muskogee,Superintendent of Public Instruction,Joy Hofmeister,REP,510061,4,11,136,151,
Muskogee,Superintendent of Public Instruction,John Cox,DEM,510061,2,4,125,131,
Muskogee,Superintendent of Public Instruction,Larry Huff,IND,510061,0,4,28,32,
Muskogee,Commissioner of Labor,Leslie Osborn,REP,510061,4,10,156,170,
Muskogee,Commissioner of Labor,Fred Dorrell,DEM,510061,2,8,111,121,
Muskogee,Commissioner of Labor,Brandt Dismukes,IND,510061,0,2,19,21,
Muskogee,Insurance Commissioner,Glen Mulready,REP,510061,4,11,170,185,
Muskogee,Insurance Commissioner,Kimberly Fobbs,DEM,510061,2,8,115,125,
Muskogee,Corporation Commissioner,Bob Anthony,REP,510061,4,13,175,192,
Muskogee,Corporation Commissioner,Ashley Nicole Mccray,DEM,510061,2,5,98,105,
Muskogee,Corporation Commissioner,Jackie Short,IND,510061,0,1,15,16,
Muskogee,U.S. House,Richard Castaldo,LIB,510061,0,0,5,5,2
Muskogee,U.S. House,Markwayne Mullin,REP,510061,4,12,177,193,2
Muskogee,U.S. House,Jason Nichols,DEM,510061,2,7,100,109,2
Muskogee,U.S. House,John Foreman,IND,510061,0,1,6,7,2
Muskogee,State House,Avery Carl Frix,REP,510061,5,13,199,217,13
Muskogee,State House,Jolene Armstrong,DEM,510061,1,7,89,97,13
Muskogee,Governor,Chris Powell,LIB,510064,1,1,25,27,
Muskogee,Governor,Kevin Stitt,REP,510064,5,19,315,339,
Muskogee,Governor,Drew Edmondson,DEM,510064,6,8,238,252,
Muskogee,Lieutenant Governor,Matt Pinnell,REP,510064,6,21,350,377,
Muskogee,Lieutenant Governor,Anastasia Pittman,DEM,510064,5,7,198,210,
Muskogee,Lieutenant Governor,Ivan Holmes,IND,510064,1,0,25,26,
Muskogee,State Auditor,John Yeutter,LIB,510064,3,6,127,136,
Muskogee,State Auditor,Cindy Byrd,REP,510064,7,21,410,438,
Muskogee,Attorney General,Mike Hunter,REP,510064,6,21,380,407,
Muskogee,Attorney General,Mark Myles,DEM,510064,6,7,192,205,
Muskogee,State Treasurer,Randy Mcdaniel,REP,510064,7,22,408,437,
Muskogee,State Treasurer,Charles De Coune,IND,510064,3,5,132,140,
Muskogee,Superintendent of Public Instruction,Joy Hofmeister,REP,510064,7,20,286,313,
Muskogee,Superintendent of Public Instruction,John Cox,DEM,510064,4,7,244,255,
Muskogee,Superintendent of Public Instruction,Larry Huff,IND,510064,1,1,45,47,
Muskogee,Commissioner of Labor,Leslie Osborn,REP,510064,6,20,321,347,
Muskogee,Commissioner of Labor,Fred Dorrell,DEM,510064,5,7,210,222,
Muskogee,Commissioner of Labor,Brandt Dismukes,IND,510064,1,1,39,41,
Muskogee,Insurance Commissioner,Glen Mulready,REP,510064,7,20,337,364,
Muskogee,Insurance Commissioner,Kimberly Fobbs,DEM,510064,5,8,232,245,
Muskogee,Corporation Commissioner,Bob Anthony,REP,510064,6,21,340,367,
Muskogee,Corporation Commissioner,Ashley Nicole Mccray,DEM,510064,5,6,196,207,
Muskogee,Corporation Commissioner,Jackie Short,IND,510064,1,1,35,37,
Muskogee,U.S. House,Richard Castaldo,LIB,510064,1,0,8,9,2
Muskogee,U.S. House,Markwayne Mullin,REP,510064,6,21,376,403,2
Muskogee,U.S. House,Jason Nichols,DEM,510064,5,7,172,184,2
Muskogee,U.S. House,John Foreman,IND,510064,0,0,22,22,2
Muskogee,State Senate,Roger Thompson,REP,510064,6,20,347,373,8
Muskogee,State Senate,Shannan Tucker,DEM,510064,5,7,201,213,8
Muskogee,State Senate,Marlena Nobles,IND,510064,1,1,27,29,8
Muskogee,State House,Randy Randleman,REP,510064,6,19,303,328,15
Muskogee,State House,Judy Ross Moore,DEM,510064,6,9,274,289,15
Noble,Governor,Chris Powell,LIB,520101,1,4,14,19,
Noble,Governor,Kevin Stitt,REP,520101,14,76,300,390,
Noble,Governor,Drew Edmondson,DEM,520101,6,32,129,167,
Noble,Lieutenant Governor,Matt Pinnell,REP,520101,13,89,360,462,
Noble,Lieutenant Governor,Anastasia Pittman,DEM,520101,7,19,72,98,
Noble,Lieutenant Governor,Ivan Holmes,IND,520101,1,3,8,12,
Noble,State Auditor,John Yeutter,LIB,520101,1,16,65,82,
Noble,State Auditor,Cindy Byrd,REP,520101,20,90,368,478,
Noble,Attorney General,Mike Hunter,REP,520101,18,88,358,464,
Noble,Attorney General,Mark Myles,DEM,520101,5,24,83,112,
Noble,State Treasurer,Randy Mcdaniel,REP,520101,19,95,377,491,
Noble,State Treasurer,Charles De Coune,IND,520101,2,11,58,71,
Noble,Superintendent of Public Instruction,Joy Hofmeister,REP,520101,16,80,324,420,
Noble,Superintendent of Public Instruction,John Cox,DEM,520101,6,20,77,103,
Noble,Superintendent of Public Instruction,Larry Huff,IND,520101,1,12,42,55,
Noble,Commissioner of Labor,Leslie Osborn,REP,520101,16,86,352,454,
Noble,Commissioner of Labor,Fred Dorrell,DEM,520101,7,21,64,92,
Noble,Commissioner of Labor,Brandt Dismukes,IND,520101,0,3,21,24,
Noble,Insurance Commissioner,Glen Mulready,REP,520101,18,88,348,454,
Noble,Insurance Commissioner,Kimberly Fobbs,DEM,520101,5,23,91,119,
Noble,Corporation Commissioner,Bob Anthony,REP,520101,14,87,343,444,
Noble,Corporation Commissioner,Ashley Nicole Mccray,DEM,520101,7,20,82,109,
Noble,Corporation Commissioner,Jackie Short,IND,520101,2,5,16,23,
Noble,U.S. House,Frank Lucas,REP,520101,17,88,364,469,3
Noble,U.S. House,Frankie Robbins,DEM,520101,5,23,79,107,3
Noble,State Senate,Chuck Hall,REP,520101,15,85,360,460,20
Noble,State Senate,Heady Coleman,DEM,520101,7,26,83,116,20
Noble,State House,Ty Burns,REP,520101,16,84,343,443,35
Noble,State House,Jasha Lyons Echo-Hawk,DEM,520101,6,27,97,130,35
Noble,Governor,Chris Powell,LIB,520102,0,0,7,7,
Noble,Governor,Kevin Stitt,REP,520102,3,18,87,108,
Noble,Governor,Drew Edmondson,DEM,520102,2,4,41,47,
Noble,Lieutenant Governor,Matt Pinnell,REP,520102,5,17,99,121,
Noble,Lieutenant Governor,Anastasia Pittman,DEM,520102,0,4,31,35,
Noble,Lieutenant Governor,Ivan Holmes,IND,520102,0,1,3,4,
Noble,State Auditor,John Yeutter,LIB,520102,3,3,25,31,
Noble,State Auditor,Cindy Byrd,REP,520102,2,19,102,123,
Noble,Attorney General,Mike Hunter,REP,520102,5,18,105,128,
Noble,Attorney General,Mark Myles,DEM,520102,0,4,26,30,
Noble,State Treasurer,Randy Mcdaniel,REP,520102,4,19,104,127,
Noble,State Treasurer,Charles De Coune,IND,520102,1,3,22,26,
Noble,Superintendent of Public Instruction,Joy Hofmeister,REP,520102,3,16,85,104,
Noble,Superintendent of Public Instruction,John Cox,DEM,520102,1,4,32,37,
Noble,Superintendent of Public Instruction,Larry Huff,IND,520102,1,2,16,19,
Noble,Commissioner of Labor,Leslie Osborn,REP,520102,2,18,95,115,
Noble,Commissioner of Labor,Fred Dorrell,DEM,520102,0,4,31,35,
Noble,Commissioner of Labor,Brandt Dismukes,IND,520102,3,0,7,10,
Noble,Insurance Commissioner,Glen Mulready,REP,520102,5,17,102,124,
Noble,Insurance Commissioner,Kimberly Fobbs,DEM,520102,0,5,29,34,
Noble,Corporation Commissioner,Bob Anthony,REP,520102,4,18,92,114,
Noble,Corporation Commissioner,Ashley Nicole Mccray,DEM,520102,0,3,26,29,
Noble,Corporation Commissioner,Jackie Short,IND,520102,1,1,14,16,
Noble,U.S. House,Frank Lucas,REP,520102,3,19,110,132,3
Noble,U.S. House,Frankie Robbins,DEM,520102,2,3,25,30,3
Noble,State Senate,Chuck Hall,REP,520102,3,16,104,123,20
Noble,State Senate,Heady Coleman,DEM,520102,2,6,30,38,20
Noble,Governor,Chris Powell,LIB,520103,7,0,12,19,
Noble,Governor,Kevin Stitt,REP,520103,6,2,97,105,
Noble,Governor,Drew Edmondson,DEM,520103,6,1,52,59,
Noble,Lieutenant Governor,Matt Pinnell,REP,520103,9,2,118,129,
Noble,Lieutenant Governor,Anastasia Pittman,DEM,520103,5,1,36,42,
Noble,Lieutenant Governor,Ivan Holmes,IND,520103,4,0,3,7,
Noble,State Auditor,John Yeutter,LIB,520103,7,0,31,38,
Noble,State Auditor,Cindy Byrd,REP,520103,12,2,123,137,
Noble,Attorney General,Mike Hunter,REP,520103,12,2,111,125,
Noble,Attorney General,Mark Myles,DEM,520103,6,1,47,54,
Noble,State Treasurer,Randy Mcdaniel,REP,520103,12,2,125,139,
Noble,State Treasurer,Charles De Coune,IND,520103,6,1,29,36,
Noble,Superintendent of Public Instruction,Joy Hofmeister,REP,520103,9,2,106,117,
Noble,Superintendent of Public Instruction,John Cox,DEM,520103,6,1,38,45,
Noble,Superintendent of Public Instruction,Larry Huff,IND,520103,3,0,14,17,
Noble,Commissioner of Labor,Leslie Osborn,REP,520103,8,3,112,123,
Noble,Commissioner of Labor,Fred Dorrell,DEM,520103,7,0,37,44,
Noble,Commissioner of Labor,Brandt Dismukes,IND,520103,3,0,10,13,
Noble,Insurance Commissioner,Glen Mulready,REP,520103,8,2,111,121,
Noble,Insurance Commissioner,Kimberly Fobbs,DEM,520103,10,1,46,57,
Noble,Corporation Commissioner,Bob Anthony,REP,520103,7,2,113,122,
Noble,Corporation Commissioner,Ashley Nicole Mccray,DEM,520103,4,1,34,39,
Noble,Corporation Commissioner,Jackie Short,IND,520103,6,0,13,19,
Noble,U.S. House,Frank Lucas,REP,520103,12,2,121,135,3
Noble,U.S. House,Frankie Robbins,DEM,520103,6,1,38,45,3
Noble,State Senate,Chuck Hall,REP,520103,12,2,113,127,20
Noble,State Senate,Heady Coleman,DEM,520103,6,1,45,52,20
Noble,Governor,Chris Powell,LIB,520104,1,1,6,8,
Noble,Governor,Kevin Stitt,REP,520104,1,4,116,121,
Noble,Governor,Drew Edmondson,DEM,520104,0,0,50,50,
Noble,Lieutenant Governor,Matt Pinnell,REP,520104,2,5,118,125,
Noble,Lieutenant Governor,Anastasia Pittman,DEM,520104,0,0,43,43,
Noble,Lieutenant Governor,Ivan Holmes,IND,520104,0,0,9,9,
Noble,State Auditor,John Yeutter,LIB,520104,1,0,39,40,
Noble,State Auditor,Cindy Byrd,REP,520104,1,5,117,123,
Noble,Attorney General,Mike Hunter,REP,520104,2,2,123,127,
Noble,Attorney General,Mark Myles,DEM,520104,0,3,44,47,
Noble,State Treasurer,Randy Mcdaniel,REP,520104,1,5,121,127,
Noble,State Treasurer,Charles De Coune,IND,520104,1,0,37,38,
Noble,Superintendent of Public Instruction,Joy Hofmeister,REP,520104,1,2,105,108,
Noble,Superintendent of Public Instruction,John Cox,DEM,520104,1,3,45,49,
Noble,Superintendent of Public Instruction,Larry Huff,IND,520104,0,0,19,19,
Noble,Commissioner of Labor,Leslie Osborn,REP,520104,1,5,116,122,
Noble,Commissioner of Labor,Fred Dorrell,DEM,520104,1,0,42,43,
Noble,Commissioner of Labor,Brandt Dismukes,IND,520104,0,0,12,12,
Noble,Insurance Commissioner,Glen Mulready,REP,520104,2,5,120,127,
Noble,Insurance Commissioner,Kimberly Fobbs,DEM,520104,0,0,50,50,
Noble,Corporation Commissioner,Bob Anthony,REP,520104,2,2,106,110,
Noble,Corporation Commissioner,Ashley Nicole Mccray,DEM,520104,0,3,48,51,
Noble,Corporation Commissioner,Jackie Short,IND,520104,0,0,15,15,
Noble,U.S. House,Frank Lucas,REP,520104,2,5,122,129,3
Noble,U.S. House,Frankie Robbins,DEM,520104,0,0,49,49,3
Noble,State Senate,Chuck Hall,REP,520104,2,4,124,130,20
Noble,State Senate,Heady Coleman,DEM,520104,0,1,47,48,20
Noble,Governor,Chris Powell,LIB,520105,0,0,11,11,
Noble,Governor,Kevin Stitt,REP,520105,1,5,69,75,
Noble,Governor,Drew Edmondson,DEM,520105,0,3,68,71,
Noble,Lieutenant Governor,Matt Pinnell,REP,520105,1,5,83,89,
Noble,Lieutenant Governor,Anastasia Pittman,DEM,520105,0,3,57,60,
Noble,Lieutenant Governor,Ivan Holmes,IND,520105,0,1,7,8,
Noble,State Auditor,John Yeutter,LIB,520105,0,2,46,48,
Noble,State Auditor,Cindy Byrd,REP,520105,1,7,88,96,
Noble,Attorney General,Mike Hunter,REP,520105,1,6,82,89,
Noble,Attorney General,Mark Myles,DEM,520105,0,3,66,69,
Noble,State Treasurer,Randy Mcdaniel,REP,520105,1,6,83,90,
Noble,State Treasurer,Charles De Coune,IND,520105,0,3,52,55,
Noble,Superintendent of Public Instruction,Joy Hofmeister,REP,520105,1,4,75,80,
Noble,Superintendent of Public Instruction,John Cox,DEM,520105,0,2,56,58,
Noble,Superintendent of Public Instruction,Larry Huff,IND,520105,0,3,16,19,
Noble,Commissioner of Labor,Leslie Osborn,REP,520105,1,6,78,85,
Noble,Commissioner of Labor,Fred Dorrell,DEM,520105,0,2,61,63,
Noble,Commissioner of Labor,Brandt Dismukes,IND,520105,0,1,9,10,
Noble,Insurance Commissioner,Glen Mulready,REP,520105,1,6,74,81,
Noble,Insurance Commissioner,Kimberly Fobbs,DEM,520105,0,3,74,77,
Noble,Corporation Commissioner,Bob Anthony,REP,520105,1,6,76,83,
Noble,Corporation Commissioner,Ashley Nicole Mccray,DEM,520105,0,2,66,68,
Noble,Corporation Commissioner,Jackie Short,IND,520105,0,1,6,7,
Noble,U.S. House,Frank Lucas,REP,520105,1,6,80,87,3
Noble,U.S. House,Frankie Robbins,DEM,520105,0,3,68,71,3
Noble,State Senate,Chuck Hall,REP,520105,0,6,83,89,20
Noble,State Senate,Heady Coleman,DEM,520105,1,3,65,69,20
Noble,Governor,Chris Powell,LIB,520106,0,0,3,3,
Noble,Governor,Kevin Stitt,REP,520106,0,4,59,63,
Noble,Governor,Drew Edmondson,DEM,520106,1,2,20,23,
Noble,Lieutenant Governor,Matt Pinnell,REP,520106,0,5,70,75,
Noble,Lieutenant Governor,Anastasia Pittman,DEM,520106,1,1,11,13,
Noble,Lieutenant Governor,Ivan Holmes,IND,520106,0,0,1,1,
Noble,State Auditor,John Yeutter,LIB,520106,0,1,14,15,
Noble,State Auditor,Cindy Byrd,REP,520106,0,5,65,70,
Noble,Attorney General,Mike Hunter,REP,520106,0,5,67,72,
Noble,Attorney General,Mark Myles,DEM,520106,1,1,15,17,
Noble,State Treasurer,Randy Mcdaniel,REP,520106,0,5,72,77,
Noble,State Treasurer,Charles De Coune,IND,520106,0,1,7,8,
Noble,Superintendent of Public Instruction,Joy Hofmeister,REP,520106,0,2,52,54,
Noble,Superintendent of Public Instruction,John Cox,DEM,520106,1,3,23,27,
Noble,Superintendent of Public Instruction,Larry Huff,IND,520106,0,1,7,8,
Noble,Commissioner of Labor,Leslie Osborn,REP,520106,0,5,65,70,
Noble,Commissioner of Labor,Fred Dorrell,DEM,520106,1,1,15,17,
Noble,Commissioner of Labor,Brandt Dismukes,IND,520106,0,0,2,2,
Noble,Insurance Commissioner,Glen Mulready,REP,520106,0,5,64,69,
Noble,Insurance Commissioner,Kimberly Fobbs,DEM,520106,1,1,17,19,
Noble,Corporation Commissioner,Bob Anthony,REP,520106,0,4,62,66,
Noble,Corporation Commissioner,Ashley Nicole Mccray,DEM,520106,1,1,16,18,
Noble,Corporation Commissioner,Jackie Short,IND,520106,0,1,3,4,
Noble,U.S. House,Frank Lucas,REP,520106,0,5,63,68,3
Noble,U.S. House,Frankie Robbins,DEM,520106,1,1,18,20,3
Noble,State Senate,Chuck Hall,REP,520106,0,4,61,65,20
Noble,State Senate,Heady Coleman,DEM,520106,1,2,20,23,20
Noble,Governor,Chris Powell,LIB,520201,0,7,16,23,
Noble,Governor,Kevin Stitt,REP,520201,5,72,253,330,
Noble,Governor,Drew Edmondson,DEM,520201,3,41,120,164,
Noble,Lieutenant Governor,Matt Pinnell,REP,520201,6,82,283,371,
Noble,Lieutenant Governor,Anastasia Pittman,DEM,520201,2,28,91,121,
Noble,Lieutenant Governor,Ivan Holmes,IND,520201,0,9,11,20,
Noble,State Auditor,John Yeutter,LIB,520201,1,17,59,77,
Noble,State Auditor,Cindy Byrd,REP,520201,6,95,316,417,
Noble,Attorney General,Mike Hunter,REP,520201,6,81,288,375,
Noble,Attorney General,Mark Myles,DEM,520201,1,39,97,137,
Noble,State Treasurer,Randy Mcdaniel,REP,520201,5,95,309,409,
Noble,State Treasurer,Charles De Coune,IND,520201,2,20,68,90,
Noble,Superintendent of Public Instruction,Joy Hofmeister,REP,520201,3,79,263,345,
Noble,Superintendent of Public Instruction,John Cox,DEM,520201,2,32,85,119,
Noble,Superintendent of Public Instruction,Larry Huff,IND,520201,2,9,38,49,
Noble,Commissioner of Labor,Leslie Osborn,REP,520201,3,84,290,377,
Noble,Commissioner of Labor,Fred Dorrell,DEM,520201,3,31,78,112,
Noble,Commissioner of Labor,Brandt Dismukes,IND,520201,2,4,12,18,
Noble,Insurance Commissioner,Glen Mulready,REP,520201,6,73,281,360,
Noble,Insurance Commissioner,Kimberly Fobbs,DEM,520201,2,46,99,147,
Noble,Corporation Commissioner,Bob Anthony,REP,520201,6,80,272,358,
Noble,Corporation Commissioner,Ashley Nicole Mccray,DEM,520201,1,29,90,120,
Noble,Corporation Commissioner,Jackie Short,IND,520201,1,11,19,31,
Noble,U.S. House,Frank Lucas,REP,520201,6,96,305,407,3
Noble,U.S. House,Frankie Robbins,DEM,520201,2,24,81,107,3
Noble,State Senate,Chuck Hall,REP,520201,6,84,289,379,20
Noble,State Senate,Heady Coleman,DEM,520201,2,36,98,136,20
Noble,State House,Ty Burns,REP,520201,7,79,282,368,35
Noble,State House,Jasha Lyons Echo-Hawk,DEM,520201,1,41,104,146,35
Noble,Governor,Chris Powell,LIB,520202,0,1,17,18,
Noble,Governor,Kevin Stitt,REP,520202,14,31,127,172,
Noble,Governor,Drew Edmondson,DEM,520202,5,13,84,102,
Noble,Lieutenant Governor,Matt Pinnell,REP,520202,15,32,148,195,
Noble,Lieutenant Governor,Anastasia Pittman,DEM,520202,4,12,67,83,
Noble,Lieutenant Governor,Ivan Holmes,IND,520202,0,0,8,8,
Noble,State Auditor,John Yeutter,LIB,520202,2,4,45,51,
Noble,State Auditor,Cindy Byrd,REP,520202,15,39,164,218,
Noble,Attorney General,Mike Hunter,REP,520202,13,34,153,200,
Noble,Attorney General,Mark Myles,DEM,520202,4,10,66,80,
Noble,State Treasurer,Randy Mcdaniel,REP,520202,13,36,161,210,
Noble,State Treasurer,Charles De Coune,IND,520202,4,7,51,62,
Noble,Superintendent of Public Instruction,Joy Hofmeister,REP,520202,15,30,140,185,
Noble,Superintendent of Public Instruction,John Cox,DEM,520202,3,11,59,73,
Noble,Superintendent of Public Instruction,Larry Huff,IND,520202,1,4,25,30,
Noble,Commissioner of Labor,Leslie Osborn,REP,520202,15,31,148,194,
Noble,Commissioner of Labor,Fred Dorrell,DEM,520202,3,12,56,71,
Noble,Commissioner of Labor,Brandt Dismukes,IND,520202,1,1,16,18,
Noble,Insurance Commissioner,Glen Mulready,REP,520202,13,32,142,187,
Noble,Insurance Commissioner,Kimberly Fobbs,DEM,520202,5,12,80,97,
Noble,Corporation Commissioner,Bob Anthony,REP,520202,13,31,136,180,
Noble,Corporation Commissioner,Ashley Nicole Mccray,DEM,520202,4,13,72,89,
Noble,Corporation Commissioner,Jackie Short,IND,520202,1,0,14,15,
Noble,U.S. House,Frank Lucas,REP,520202,15,33,156,204,3
Noble,U.S. House,Frankie Robbins,DEM,520202,4,10,67,81,3
Noble,State Senate,Chuck Hall,REP,520202,15,29,154,198,20
Noble,State Senate,Heady Coleman,DEM,520202,4,15,72,91,20
Noble,Governor,Chris Powell,LIB,520203,1,4,13,18,
Noble,Governor,Kevin Stitt,REP,520203,3,18,120,141,
Noble,Governor,Drew Edmondson,DEM,520203,2,15,68,85,
Noble,Lieutenant Governor,Matt Pinnell,REP,520203,4,23,138,165,
Noble,Lieutenant Governor,Anastasia Pittman,DEM,520203,2,13,47,62,
Noble,Lieutenant Governor,Ivan Holmes,IND,520203,0,0,13,13,
Noble,State Auditor,John Yeutter,LIB,520203,1,5,40,46,
Noble,State Auditor,Cindy Byrd,REP,520203,4,30,156,190,
Noble,Attorney General,Mike Hunter,REP,520203,4,27,141,172,
Noble,Attorney General,Mark Myles,DEM,520203,2,9,57,68,
Noble,State Treasurer,Randy Mcdaniel,REP,520203,4,27,153,184,
Noble,State Treasurer,Charles De Coune,IND,520203,1,7,43,51,
Noble,Superintendent of Public Instruction,Joy Hofmeister,REP,520203,3,29,127,159,
Noble,Superintendent of Public Instruction,John Cox,DEM,520203,3,7,49,59,
Noble,Superintendent of Public Instruction,Larry Huff,IND,520203,0,0,23,23,
Noble,Commissioner of Labor,Leslie Osborn,REP,520203,4,29,139,172,
Noble,Commissioner of Labor,Fred Dorrell,DEM,520203,2,6,46,54,
Noble,Commissioner of Labor,Brandt Dismukes,IND,520203,0,1,12,13,
Noble,Insurance Commissioner,Glen Mulready,REP,520203,3,24,127,154,
Noble,Insurance Commissioner,Kimberly Fobbs,DEM,520203,3,12,70,85,
Noble,Corporation Commissioner,Bob Anthony,REP,520203,4,23,121,148,
Noble,Corporation Commissioner,Ashley Nicole Mccray,DEM,520203,2,11,64,77,
Noble,Corporation Commissioner,Jackie Short,IND,520203,0,2,13,15,
Noble,U.S. House,Frank Lucas,REP,520203,4,28,152,184,3
Noble,U.S. House,Frankie Robbins,DEM,520203,2,8,47,57,3
Noble,State Senate,Chuck Hall,REP,520203,3,22,143,168,20
Noble,State Senate,Heady Coleman,DEM,520203,3,14,55,72,20
Noble,State House,Ty Burns,REP,520203,3,24,141,168,35
Noble,State House,Jasha Lyons Echo-Hawk,DEM,520203,3,12,58,73,35
Noble,Governor,Chris Powell,LIB,520301,1,2,9,12,
Noble,Governor,Kevin Stitt,REP,520301,7,62,204,273,
Noble,Governor,Drew Edmondson,DEM,520301,2,16,76,94,
Noble,Lieutenant Governor,Matt Pinnell,REP,520301,8,69,228,305,
Noble,Lieutenant Governor,Anastasia Pittman,DEM,520301,2,10,48,60,
Noble,Lieutenant Governor,Ivan Holmes,IND,520301,0,1,8,9,
Noble,State Auditor,John Yeutter,LIB,520301,1,7,43,51,
Noble,State Auditor,Cindy Byrd,REP,520301,9,70,236,315,
Noble,Attorney General,Mike Hunter,REP,520301,9,66,219,294,
Noble,Attorney General,Mark Myles,DEM,520301,1,13,66,80,
Noble,State Treasurer,Randy Mcdaniel,REP,520301,7,72,232,311,
Noble,State Treasurer,Charles De Coune,IND,520301,3,6,47,56,
Noble,Superintendent of Public Instruction,Joy Hofmeister,REP,520301,8,62,201,271,
Noble,Superintendent of Public Instruction,John Cox,DEM,520301,2,8,63,73,
Noble,Superintendent of Public Instruction,Larry Huff,IND,520301,0,10,21,31,
Noble,Commissioner of Labor,Leslie Osborn,REP,520301,8,67,215,290,
Noble,Commissioner of Labor,Fred Dorrell,DEM,520301,2,10,61,73,
Noble,Commissioner of Labor,Brandt Dismukes,IND,520301,0,1,8,9,
Noble,Insurance Commissioner,Glen Mulready,REP,520301,5,63,219,287,
Noble,Insurance Commissioner,Kimberly Fobbs,DEM,520301,5,16,62,83,
Noble,Corporation Commissioner,Bob Anthony,REP,520301,9,62,201,272,
Noble,Corporation Commissioner,Ashley Nicole Mccray,DEM,520301,1,13,69,83,
Noble,Corporation Commissioner,Jackie Short,IND,520301,0,4,12,16,
Noble,U.S. House,Frank Lucas,REP,520301,8,71,236,315,3
Noble,U.S. House,Frankie Robbins,DEM,520301,1,9,52,62,3
Noble,State Senate,Chuck Hall,REP,520301,8,59,221,288,20
Noble,State Senate,Heady Coleman,DEM,520301,2,21,69,92,20
Noble,Governor,Chris Powell,LIB,520305,2,3,23,28,
Noble,Governor,Kevin Stitt,REP,520305,19,23,364,406,
Noble,Governor,Drew Edmondson,DEM,520305,6,9,204,219,
Noble,Lieutenant Governor,Matt Pinnell,REP,520305,22,27,427,476,
Noble,Lieutenant Governor,Anastasia Pittman,DEM,520305,3,7,134,144,
Noble,Lieutenant Governor,Ivan Holmes,IND,520305,2,1,26,29,
Noble,State Auditor,John Yeutter,LIB,520305,1,6,90,97,
Noble,State Auditor,Cindy Byrd,REP,520305,26,27,482,535,
Noble,Attorney General,Mike Hunter,REP,520305,23,27,440,490,
Noble,Attorney General,Mark Myles,DEM,520305,4,8,142,154,
Noble,State Treasurer,Randy Mcdaniel,REP,520305,23,29,450,502,
Noble,State Treasurer,Charles De Coune,IND,520305,4,4,111,119,
Noble,Superintendent of Public Instruction,Joy Hofmeister,REP,520305,21,23,367,411,
Noble,Superintendent of Public Instruction,John Cox,DEM,520305,3,5,168,176,
Noble,Superintendent of Public Instruction,Larry Huff,IND,520305,3,6,50,59,
Noble,Commissioner of Labor,Leslie Osborn,REP,520305,23,27,427,477,
Noble,Commissioner of Labor,Fred Dorrell,DEM,520305,1,6,124,131,
Noble,Commissioner of Labor,Brandt Dismukes,IND,520305,3,1,32,36,
Noble,Insurance Commissioner,Glen Mulready,REP,520305,22,28,429,479,
Noble,Insurance Commissioner,Kimberly Fobbs,DEM,520305,5,6,152,163,
Noble,Corporation Commissioner,Bob Anthony,REP,520305,22,25,412,459,
Noble,Corporation Commissioner,Ashley Nicole Mccray,DEM,520305,3,5,133,141,
Noble,Corporation Commissioner,Jackie Short,IND,520305,2,3,40,45,
Noble,U.S. House,Frank Lucas,REP,520305,24,28,456,508,3
Noble,U.S. House,Frankie Robbins,DEM,520305,3,6,132,141,3
Noble,State Senate,Chuck Hall,REP,520305,24,28,453,505,20
Noble,State Senate,Heady Coleman,DEM,520305,3,7,134,144,20
Noble,State House,Ty Burns,REP,520305,25,30,453,508,35
Noble,State House,Jasha Lyons Echo-Hawk,DEM,520305,2,5,136,143,35
Noble,Governor,Chris Powell,LIB,520307,1,6,16,23,
Noble,Governor,Kevin Stitt,REP,520307,17,102,240,359,
Noble,Governor,Drew Edmondson,DEM,520307,8,48,115,171,
Noble,Lieutenant Governor,Matt Pinnell,REP,520307,18,121,280,419,
Noble,Lieutenant Governor,Anastasia Pittman,DEM,520307,4,32,75,111,
Noble,Lieutenant Governor,Ivan Holmes,IND,520307,2,3,14,19,
Noble,State Auditor,John Yeutter,LIB,520307,6,14,58,78,
Noble,State Auditor,Cindy Byrd,REP,520307,18,133,303,454,
Noble,Attorney General,Mike Hunter,REP,520307,20,118,285,423,
Noble,Attorney General,Mark Myles,DEM,520307,4,38,82,124,
Noble,State Treasurer,Randy Mcdaniel,REP,520307,21,129,292,442,
Noble,State Treasurer,Charles De Coune,IND,520307,3,18,68,89,
Noble,Superintendent of Public Instruction,Joy Hofmeister,REP,520307,15,123,252,390,
Noble,Superintendent of Public Instruction,John Cox,DEM,520307,4,25,77,106,
Noble,Superintendent of Public Instruction,Larry Huff,IND,520307,5,8,38,51,
Noble,Commissioner of Labor,Leslie Osborn,REP,520307,18,128,286,432,
Noble,Commissioner of Labor,Fred Dorrell,DEM,520307,4,24,64,92,
Noble,Commissioner of Labor,Brandt Dismukes,IND,520307,2,2,15,19,
Noble,Insurance Commissioner,Glen Mulready,REP,520307,17,122,274,413,
Noble,Insurance Commissioner,Kimberly Fobbs,DEM,520307,6,33,92,131,
Noble,Corporation Commissioner,Bob Anthony,REP,520307,14,122,261,397,
Noble,Corporation Commissioner,Ashley Nicole Mccray,DEM,520307,6,29,74,109,
Noble,Corporation Commissioner,Jackie Short,IND,520307,4,4,31,39,
Noble,U.S. House,Frank Lucas,REP,520307,20,128,292,440,3
Noble,U.S. House,Frankie Robbins,DEM,520307,6,29,74,109,3
Noble,State Senate,Chuck Hall,REP,520307,19,116,267,402,20
Noble,State Senate,Heady Coleman,DEM,520307,7,41,99,147,20
Noble,State House,Ty Burns,REP,520307,19,119,285,423,35
Noble,State House,Jasha Lyons Echo-Hawk,DEM,520307,5,35,81,121,35
Nowata,Governor,Chris Powell,LIB,530101,2,4,30,36,
Nowata,Governor,Kevin Stitt,REP,530101,12,47,230,289,
Nowata,Governor,Drew Edmondson,DEM,530101,3,29,102,134,
Nowata,Lieutenant Governor,Matt Pinnell,REP,530101,14,57,258,329,
Nowata,Lieutenant Governor,Anastasia Pittman,DEM,530101,2,19,85,106,
Nowata,Lieutenant Governor,Ivan Holmes,IND,530101,1,4,17,22,
Nowata,State Auditor,John Yeutter,LIB,530101,2,19,67,88,
Nowata,State Auditor,Cindy Byrd,REP,530101,13,60,275,348,
Nowata,Attorney General,Mike Hunter,REP,530101,14,57,274,345,
Nowata,Attorney General,Mark Myles,DEM,530101,3,22,85,110,
Nowata,State Treasurer,Randy Mcdaniel,REP,530101,13,62,275,350,
Nowata,State Treasurer,Charles De Coune,IND,530101,3,17,68,88,
Nowata,Superintendent of Public Instruction,Joy Hofmeister,REP,530101,14,52,223,289,
Nowata,Superintendent of Public Instruction,John Cox,DEM,530101,3,24,94,121,
Nowata,Superintendent of Public Instruction,Larry Huff,IND,530101,0,5,39,44,
Nowata,Commissioner of Labor,Leslie Osborn,REP,530101,11,55,263,329,
Nowata,Commissioner of Labor,Fred Dorrell,DEM,530101,3,19,79,101,
Nowata,Commissioner of Labor,Brandt Dismukes,IND,530101,1,4,14,19,
Nowata,Insurance Commissioner,Glen Mulready,REP,530101,12,51,256,319,
Nowata,Insurance Commissioner,Kimberly Fobbs,DEM,530101,3,26,101,130,
Nowata,Corporation Commissioner,Bob Anthony,REP,530101,11,46,248,305,
Nowata,Corporation Commissioner,Ashley Nicole Mccray,DEM,530101,3,24,82,109,
Nowata,Corporation Commissioner,Jackie Short,IND,530101,2,8,27,37,
Nowata,U.S. House,Richard Castaldo,LIB,530101,0,1,12,13,2
Nowata,U.S. House,Markwayne Mullin,REP,530101,15,56,256,327,2
Nowata,U.S. House,Jason Nichols,DEM,530101,2,22,83,107,2
Nowata,U.S. House,John Foreman,IND,530101,0,2,8,10,2
Nowata,State House,Judd Strom,REP,530101,8,34,180,222,10
Nowata,State House,Kevin Stacy,DEM,530101,9,47,179,235,10
Nowata,Governor,Chris Powell,LIB,530102,1,6,15,22,
Nowata,Governor,Kevin Stitt,REP,530102,15,49,294,358,
Nowata,Governor,Drew Edmondson,DEM,530102,10,17,140,167,
Nowata,Lieutenant Governor,Matt Pinnell,REP,530102,15,54,327,396,
Nowata,Lieutenant Governor,Anastasia Pittman,DEM,530102,8,14,107,129,
Nowata,Lieutenant Governor,Ivan Holmes,IND,530102,3,3,12,18,
Nowata,State Auditor,John Yeutter,LIB,530102,6,7,101,114,
Nowata,State Auditor,Cindy Byrd,REP,530102,19,61,337,417,
Nowata,Attorney General,Mike Hunter,REP,530102,17,52,318,387,
Nowata,Attorney General,Mark Myles,DEM,530102,8,18,124,150,
Nowata,State Treasurer,Randy Mcdaniel,REP,530102,19,55,332,406,
Nowata,State Treasurer,Charles De Coune,IND,530102,6,14,104,124,
Nowata,Superintendent of Public Instruction,Joy Hofmeister,REP,530102,17,47,279,343,
Nowata,Superintendent of Public Instruction,John Cox,DEM,530102,7,16,131,154,
Nowata,Superintendent of Public Instruction,Larry Huff,IND,530102,2,8,38,48,
Nowata,Commissioner of Labor,Leslie Osborn,REP,530102,17,54,308,379,
Nowata,Commissioner of Labor,Fred Dorrell,DEM,530102,8,14,118,140,
Nowata,Commissioner of Labor,Brandt Dismukes,IND,530102,1,1,17,19,
Nowata,Insurance Commissioner,Glen Mulready,REP,530102,17,51,307,375,
Nowata,Insurance Commissioner,Kimberly Fobbs,DEM,530102,9,17,138,164,
Nowata,Corporation Commissioner,Bob Anthony,REP,530102,16,48,302,366,
Nowata,Corporation Commissioner,Ashley Nicole Mccray,DEM,530102,9,18,115,142,
Nowata,Corporation Commissioner,Jackie Short,IND,530102,1,4,24,29,
Nowata,U.S. House,Richard Castaldo,LIB,530102,1,2,11,14,2
Nowata,U.S. House,Markwayne Mullin,REP,530102,16,57,319,392,2
Nowata,U.S. House,Jason Nichols,DEM,530102,8,12,105,125,2
Nowata,U.S. House,John Foreman,IND,530102,1,0,12,13,2
Nowata,State House,Judd Strom,REP,530102,14,31,199,244,10
Nowata,State House,Kevin Stacy,DEM,530102,12,40,251,303,10
Nowata,Governor,Chris Powell,LIB,530103,0,0,4,4,
Nowata,Governor,Kevin Stitt,REP,530103,1,26,113,140,
Nowata,Governor,Drew Edmondson,DEM,530103,0,5,63,68,
Nowata,Lieutenant Governor,Matt Pinnell,REP,530103,1,26,126,153,
Nowata,Lieutenant Governor,Anastasia Pittman,DEM,530103,0,4,52,56,
Nowata,Lieutenant Governor,Ivan Holmes,IND,530103,0,1,4,5,
Nowata,State Auditor,John Yeutter,LIB,530103,0,3,33,36,
Nowata,State Auditor,Cindy Byrd,REP,530103,1,27,137,165,
Nowata,Attorney General,Mike Hunter,REP,530103,1,28,124,153,
Nowata,Attorney General,Mark Myles,DEM,530103,0,2,56,58,
Nowata,State Treasurer,Randy Mcdaniel,REP,530103,1,26,134,161,
Nowata,State Treasurer,Charles De Coune,IND,530103,0,4,35,39,
Nowata,Superintendent of Public Instruction,Joy Hofmeister,REP,530103,1,21,100,122,
Nowata,Superintendent of Public Instruction,John Cox,DEM,530103,0,5,71,76,
Nowata,Superintendent of Public Instruction,Larry Huff,IND,530103,0,4,10,14,
Nowata,Commissioner of Labor,Leslie Osborn,REP,530103,1,24,125,150,
Nowata,Commissioner of Labor,Fred Dorrell,DEM,530103,0,3,53,56,
Nowata,Commissioner of Labor,Brandt Dismukes,IND,530103,0,2,4,6,
Nowata,Insurance Commissioner,Glen Mulready,REP,530103,1,25,119,145,
Nowata,Insurance Commissioner,Kimberly Fobbs,DEM,530103,0,4,61,65,
Nowata,Corporation Commissioner,Bob Anthony,REP,530103,1,21,117,139,
Nowata,Corporation Commissioner,Ashley Nicole Mccray,DEM,530103,0,6,60,66,
Nowata,Corporation Commissioner,Jackie Short,IND,530103,0,2,4,6,
Nowata,U.S. House,Richard Castaldo,LIB,530103,0,0,5,5,2
Nowata,U.S. House,Markwayne Mullin,REP,530103,1,25,121,147,2
Nowata,U.S. House,Jason Nichols,DEM,530103,0,5,53,58,2
Nowata,U.S. House,John Foreman,IND,530103,0,1,3,4,2
Nowata,State House,Judd Strom,REP,530103,0,16,54,70,10
Nowata,State House,Kevin Stacy,DEM,530103,1,14,128,143,10
Nowata,Governor,Chris Powell,LIB,530201,0,1,8,9,
Nowata,Governor,Kevin Stitt,REP,530201,9,3,161,173,
Nowata,Governor,Drew Edmondson,DEM,530201,2,1,60,63,
Nowata,Lieutenant Governor,Matt Pinnell,REP,530201,9,4,175,188,
Nowata,Lieutenant Governor,Anastasia Pittman,DEM,530201,2,0,45,47,
Nowata,Lieutenant Governor,Ivan Holmes,IND,530201,0,1,9,10,
Nowata,State Auditor,John Yeutter,LIB,530201,2,1,43,46,
Nowata,State Auditor,Cindy Byrd,REP,530201,9,4,175,188,
Nowata,Attorney General,Mike Hunter,REP,530201,8,4,170,182,
Nowata,Attorney General,Mark Myles,DEM,530201,2,1,54,57,
Nowata,State Treasurer,Randy Mcdaniel,REP,530201,9,4,179,192,
Nowata,State Treasurer,Charles De Coune,IND,530201,2,1,35,38,
Nowata,Superintendent of Public Instruction,Joy Hofmeister,REP,530201,8,4,141,153,
Nowata,Superintendent of Public Instruction,John Cox,DEM,530201,2,0,60,62,
Nowata,Superintendent of Public Instruction,Larry Huff,IND,530201,1,1,28,30,
Nowata,Commissioner of Labor,Leslie Osborn,REP,530201,9,4,158,171,
Nowata,Commissioner of Labor,Fred Dorrell,DEM,530201,2,0,58,60,
Nowata,Commissioner of Labor,Brandt Dismukes,IND,530201,0,1,12,13,
Nowata,Insurance Commissioner,Glen Mulready,REP,530201,9,4,165,178,
Nowata,Insurance Commissioner,Kimberly Fobbs,DEM,530201,2,1,60,63,
Nowata,Corporation Commissioner,Bob Anthony,REP,530201,9,4,157,170,
Nowata,Corporation Commissioner,Ashley Nicole Mccray,DEM,530201,2,0,54,56,
Nowata,Corporation Commissioner,Jackie Short,IND,530201,0,1,16,17,
Nowata,U.S. House,Richard Castaldo,LIB,530201,0,1,5,6,2
Nowata,U.S. House,Markwayne Mullin,REP,530201,9,3,165,177,2
Nowata,U.S. House,Jason Nichols,DEM,530201,2,1,46,49,2
Nowata,U.S. House,John Foreman,IND,530201,0,0,13,13,2
Nowata,State House,Judd Strom,REP,530201,8,3,110,121,10
Nowata,State House,Kevin Stacy,DEM,530201,3,2,116,121,10
Nowata,Governor,Chris Powell,LIB,530202,1,4,7,12,
Nowata,Governor,Kevin Stitt,REP,530202,9,49,159,217,
Nowata,Governor,Drew Edmondson,DEM,530202,2,11,47,60,
Nowata,Lieutenant Governor,Matt Pinnell,REP,530202,10,58,170,238,
Nowata,Lieutenant Governor,Anastasia Pittman,DEM,530202,1,4,29,34,
Nowata,Lieutenant Governor,Ivan Holmes,IND,530202,1,2,9,12,
Nowata,State Auditor,John Yeutter,LIB,530202,1,6,37,44,
Nowata,State Auditor,Cindy Byrd,REP,530202,10,56,169,235,
Nowata,Attorney General,Mike Hunter,REP,530202,10,55,166,231,
Nowata,Attorney General,Mark Myles,DEM,530202,1,8,41,50,
Nowata,State Treasurer,Randy Mcdaniel,REP,530202,10,58,178,246,
Nowata,State Treasurer,Charles De Coune,IND,530202,1,5,29,35,
Nowata,Superintendent of Public Instruction,Joy Hofmeister,REP,530202,8,53,142,203,
Nowata,Superintendent of Public Instruction,John Cox,DEM,530202,3,11,52,66,
Nowata,Superintendent of Public Instruction,Larry Huff,IND,530202,0,1,16,17,
Nowata,Commissioner of Labor,Leslie Osborn,REP,530202,10,55,154,219,
Nowata,Commissioner of Labor,Fred Dorrell,DEM,530202,1,5,34,40,
Nowata,Commissioner of Labor,Brandt Dismukes,IND,530202,0,4,18,22,
Nowata,Insurance Commissioner,Glen Mulready,REP,530202,9,56,166,231,
Nowata,Insurance Commissioner,Kimberly Fobbs,DEM,530202,2,8,41,51,
Nowata,Corporation Commissioner,Bob Anthony,REP,530202,10,53,154,217,
Nowata,Corporation Commissioner,Ashley Nicole Mccray,DEM,530202,1,6,31,38,
Nowata,Corporation Commissioner,Jackie Short,IND,530202,0,5,19,24,
Nowata,U.S. House,Richard Castaldo,LIB,530202,0,3,3,6,2
Nowata,U.S. House,Markwayne Mullin,REP,530202,10,55,162,227,2
Nowata,U.S. House,Jason Nichols,DEM,530202,2,5,30,37,2
Nowata,U.S. House,John Foreman,IND,530202,0,1,14,15,2
Nowata,State House,Judd Strom,REP,530202,6,33,115,154,10
Nowata,State House,Kevin Stacy,DEM,530202,6,33,98,137,10
Nowata,Governor,Chris Powell,LIB,530203,0,6,24,30,
Nowata,Governor,Kevin Stitt,REP,530203,8,30,253,291,
Nowata,Governor,Drew Edmondson,DEM,530203,5,25,115,145,
Nowata,Lieutenant Governor,Matt Pinnell,REP,530203,9,44,272,325,
Nowata,Lieutenant Governor,Anastasia Pittman,DEM,530203,3,14,100,117,
Nowata,Lieutenant Governor,Ivan Holmes,IND,530203,1,3,16,20,
Nowata,State Auditor,John Yeutter,LIB,530203,2,17,80,99,
Nowata,State Auditor,Cindy Byrd,REP,530203,11,40,296,347,
Nowata,Attorney General,Mike Hunter,REP,530203,7,41,280,328,
Nowata,Attorney General,Mark Myles,DEM,530203,5,19,103,127,
Nowata,State Treasurer,Randy Mcdaniel,REP,530203,11,43,295,349,
Nowata,State Treasurer,Charles De Coune,IND,530203,2,14,80,96,
Nowata,Superintendent of Public Instruction,Joy Hofmeister,REP,530203,8,31,252,291,
Nowata,Superintendent of Public Instruction,John Cox,DEM,530203,4,21,106,131,
Nowata,Superintendent of Public Instruction,Larry Huff,IND,530203,1,7,28,36,
Nowata,Commissioner of Labor,Leslie Osborn,REP,530203,9,38,266,313,
Nowata,Commissioner of Labor,Fred Dorrell,DEM,530203,3,18,91,112,
Nowata,Commissioner of Labor,Brandt Dismukes,IND,530203,1,1,26,28,
Nowata,Insurance Commissioner,Glen Mulready,REP,530203,8,39,275,322,
Nowata,Insurance Commissioner,Kimberly Fobbs,DEM,530203,5,19,108,132,
Nowata,Corporation Commissioner,Bob Anthony,REP,530203,8,35,258,301,
Nowata,Corporation Commissioner,Ashley Nicole Mccray,DEM,530203,5,19,100,124,
Nowata,Corporation Commissioner,Jackie Short,IND,530203,0,4,22,26,
Nowata,U.S. House,Richard Castaldo,LIB,530203,0,0,14,14,2
Nowata,U.S. House,Markwayne Mullin,REP,530203,8,41,266,315,2
Nowata,U.S. House,Jason Nichols,DEM,530203,4,17,87,108,2
Nowata,U.S. House,John Foreman,IND,530203,1,1,17,19,2
Nowata,State House,Judd Strom,REP,530203,6,25,182,213,10
Nowata,State House,Kevin Stacy,DEM,530203,7,37,206,250,10
Nowata,Governor,Chris Powell,LIB,530204,0,1,6,7,
Nowata,Governor,Kevin Stitt,REP,530204,4,8,126,138,
Nowata,Governor,Drew Edmondson,DEM,530204,0,1,46,47,
Nowata,Lieutenant Governor,Matt Pinnell,REP,530204,4,9,135,148,
Nowata,Lieutenant Governor,Anastasia Pittman,DEM,530204,0,0,39,39,
Nowata,Lieutenant Governor,Ivan Holmes,IND,530204,0,1,4,5,
Nowata,State Auditor,John Yeutter,LIB,530204,0,3,28,31,
Nowata,State Auditor,Cindy Byrd,REP,530204,4,7,142,153,
Nowata,Attorney General,Mike Hunter,REP,530204,4,10,134,148,
Nowata,Attorney General,Mark Myles,DEM,530204,0,0,43,43,
Nowata,State Treasurer,Randy Mcdaniel,REP,530204,3,9,143,155,
Nowata,State Treasurer,Charles De Coune,IND,530204,1,1,30,32,
Nowata,Superintendent of Public Instruction,Joy Hofmeister,REP,530204,3,6,107,116,
Nowata,Superintendent of Public Instruction,John Cox,DEM,530204,0,0,61,61,
Nowata,Superintendent of Public Instruction,Larry Huff,IND,530204,1,3,10,14,
Nowata,Commissioner of Labor,Leslie Osborn,REP,530204,3,8,124,135,
Nowata,Commissioner of Labor,Fred Dorrell,DEM,530204,1,0,46,47,
Nowata,Commissioner of Labor,Brandt Dismukes,IND,530204,0,1,8,9,
Nowata,Insurance Commissioner,Glen Mulready,REP,530204,4,9,132,145,
Nowata,Insurance Commissioner,Kimberly Fobbs,DEM,530204,0,0,46,46,
Nowata,Corporation Commissioner,Bob Anthony,REP,530204,3,8,126,137,
Nowata,Corporation Commissioner,Ashley Nicole Mccray,DEM,530204,1,1,42,44,
Nowata,Corporation Commissioner,Jackie Short,IND,530204,0,0,9,9,
Nowata,U.S. House,Richard Castaldo,LIB,530204,0,0,5,5,2
Nowata,U.S. House,Markwayne Mullin,REP,530204,4,7,139,150,2
Nowata,U.S. House,Jason Nichols,DEM,530204,0,0,31,31,2
Nowata,U.S. House,John Foreman,IND,530204,0,2,3,5,2
Nowata,State House,Judd Strom,REP,530204,4,7,72,83,10
Nowata,State House,Kevin Stacy,DEM,530204,0,3,108,111,10
Nowata,Governor,Chris Powell,LIB,530301,0,1,20,21,
Nowata,Governor,Kevin Stitt,REP,530301,9,9,328,346,
Nowata,Governor,Drew Edmondson,DEM,530301,8,2,133,143,
Nowata,Lieutenant Governor,Matt Pinnell,REP,530301,9,10,345,364,
Nowata,Lieutenant Governor,Anastasia Pittman,DEM,530301,8,2,113,123,
Nowata,Lieutenant Governor,Ivan Holmes,IND,530301,0,0,21,21,
Nowata,State Auditor,John Yeutter,LIB,530301,3,0,79,82,
Nowata,State Auditor,Cindy Byrd,REP,530301,12,12,368,392,
Nowata,Attorney General,Mike Hunter,REP,530301,9,11,352,372,
Nowata,Attorney General,Mark Myles,DEM,530301,8,1,123,132,
Nowata,State Treasurer,Randy Mcdaniel,REP,530301,12,11,373,396,
Nowata,State Treasurer,Charles De Coune,IND,530301,3,1,80,84,
Nowata,Superintendent of Public Instruction,Joy Hofmeister,REP,530301,10,11,307,328,
Nowata,Superintendent of Public Instruction,John Cox,DEM,530301,7,1,137,145,
Nowata,Superintendent of Public Instruction,Larry Huff,IND,530301,0,0,34,34,
Nowata,Commissioner of Labor,Leslie Osborn,REP,530301,9,10,334,353,
Nowata,Commissioner of Labor,Fred Dorrell,DEM,530301,8,2,121,131,
Nowata,Commissioner of Labor,Brandt Dismukes,IND,530301,0,0,18,18,
Nowata,Insurance Commissioner,Glen Mulready,REP,530301,9,10,345,364,
Nowata,Insurance Commissioner,Kimberly Fobbs,DEM,530301,8,2,128,138,
Nowata,Corporation Commissioner,Bob Anthony,REP,530301,9,9,326,344,
Nowata,Corporation Commissioner,Ashley Nicole Mccray,DEM,530301,8,2,123,133,
Nowata,Corporation Commissioner,Jackie Short,IND,530301,0,0,28,28,
Nowata,U.S. House,Richard Castaldo,LIB,530301,0,0,9,9,2
Nowata,U.S. House,Markwayne Mullin,REP,530301,13,11,355,379,2
Nowata,U.S. House,Jason Nichols,DEM,530301,4,1,102,107,2
Nowata,U.S. House,John Foreman,IND,530301,0,0,11,11,2
Nowata,State House,Judd Strom,REP,530301,11,7,232,250,10
Nowata,State House,Kevin Stacy,DEM,530301,6,5,247,258,10
Nowata,Governor,Chris Powell,LIB,530302,0,3,14,17,
Nowata,Governor,Kevin Stitt,REP,530302,3,34,113,150,
Nowata,Governor,Drew Edmondson,DEM,530302,0,28,63,91,
Nowata,Lieutenant Governor,Matt Pinnell,REP,530302,3,36,132,171,
Nowata,Lieutenant Governor,Anastasia Pittman,DEM,530302,1,25,47,73,
Nowata,Lieutenant Governor,Ivan Holmes,IND,530302,0,1,11,12,
Nowata,State Auditor,John Yeutter,LIB,530302,0,21,46,67,
Nowata,State Auditor,Cindy Byrd,REP,530302,4,38,136,178,
Nowata,Attorney General,Mike Hunter,REP,530302,3,35,138,176,
Nowata,Attorney General,Mark Myles,DEM,530302,1,29,52,82,
Nowata,State Treasurer,Randy Mcdaniel,REP,530302,4,43,140,187,
Nowata,State Treasurer,Charles De Coune,IND,530302,0,17,43,60,
Nowata,Superintendent of Public Instruction,Joy Hofmeister,REP,530302,4,33,104,141,
Nowata,Superintendent of Public Instruction,John Cox,DEM,530302,0,26,64,90,
Nowata,Superintendent of Public Instruction,Larry Huff,IND,530302,0,4,21,25,
Nowata,Commissioner of Labor,Leslie Osborn,REP,530302,4,34,112,150,
Nowata,Commissioner of Labor,Fred Dorrell,DEM,530302,0,29,61,90,
Nowata,Commissioner of Labor,Brandt Dismukes,IND,530302,0,0,15,15,
Nowata,Insurance Commissioner,Glen Mulready,REP,530302,3,38,130,171,
Nowata,Insurance Commissioner,Kimberly Fobbs,DEM,530302,1,26,57,84,
Nowata,Corporation Commissioner,Bob Anthony,REP,530302,3,36,118,157,
Nowata,Corporation Commissioner,Ashley Nicole Mccray,DEM,530302,1,26,56,83,
Nowata,Corporation Commissioner,Jackie Short,IND,530302,0,1,15,16,
Nowata,U.S. House,Richard Castaldo,LIB,530302,0,1,7,8,2
Nowata,U.S. House,Markwayne Mullin,REP,530302,3,39,129,171,2
Nowata,U.S. House,Jason Nichols,DEM,530302,1,24,46,71,2
Nowata,U.S. House,John Foreman,IND,530302,0,0,7,7,2
Nowata,State House,Judd Strom,REP,530302,3,23,80,106,10
Nowata,State House,Kevin Stacy,DEM,530302,1,42,111,154,10
Nowata,Governor,Chris Powell,LIB,530303,0,0,10,10,
Nowata,Governor,Kevin Stitt,REP,530303,3,7,130,140,
Nowata,Governor,Drew Edmondson,DEM,530303,0,6,57,63,
Nowata,Lieutenant Governor,Matt Pinnell,REP,530303,3,10,137,150,
Nowata,Lieutenant Governor,Anastasia Pittman,DEM,530303,0,3,50,53,
Nowata,Lieutenant Governor,Ivan Holmes,IND,530303,0,0,9,9,
Nowata,State Auditor,John Yeutter,LIB,530303,0,4,34,38,
Nowata,State Auditor,Cindy Byrd,REP,530303,3,9,157,169,
Nowata,Attorney General,Mike Hunter,REP,530303,3,9,149,161,
Nowata,Attorney General,Mark Myles,DEM,530303,0,4,46,50,
Nowata,State Treasurer,Randy Mcdaniel,REP,530303,3,9,148,160,
Nowata,State Treasurer,Charles De Coune,IND,530303,0,4,42,46,
Nowata,Superintendent of Public Instruction,Joy Hofmeister,REP,530303,2,10,117,129,
Nowata,Superintendent of Public Instruction,John Cox,DEM,530303,1,2,57,60,
Nowata,Superintendent of Public Instruction,Larry Huff,IND,530303,0,1,22,23,
Nowata,Commissioner of Labor,Leslie Osborn,REP,530303,3,8,135,146,
Nowata,Commissioner of Labor,Fred Dorrell,DEM,530303,0,4,46,50,
Nowata,Commissioner of Labor,Brandt Dismukes,IND,530303,0,1,12,13,
Nowata,Insurance Commissioner,Glen Mulready,REP,530303,3,8,139,150,
Nowata,Insurance Commissioner,Kimberly Fobbs,DEM,530303,0,5,55,60,
Nowata,Corporation Commissioner,Bob Anthony,REP,530303,3,10,134,147,
Nowata,Corporation Commissioner,Ashley Nicole Mccray,DEM,530303,0,3,48,51,
Nowata,Corporation Commissioner,Jackie Short,IND,530303,0,0,11,11,
Nowata,U.S. House,Richard Castaldo,LIB,530303,0,0,5,5,2
Nowata,U.S. House,Markwayne Mullin,REP,530303,3,9,149,161,2
Nowata,U.S. House,Jason Nichols,DEM,530303,0,3,35,38,2
Nowata,U.S. House,John Foreman,IND,530303,0,1,6,7,2
Nowata,State House,Judd Strom,REP,530303,0,4,66,70,10
Nowata,State House,Kevin Stacy,DEM,530303,3,10,134,147,10
Nowata,Governor,Chris Powell,LIB,530304,0,0,3,3,
Nowata,Governor,Kevin Stitt,REP,530304,2,12,63,77,
Nowata,Governor,Drew Edmondson,DEM,530304,3,8,24,35,
Nowata,Lieutenant Governor,Matt Pinnell,REP,530304,2,12,74,88,
Nowata,Lieutenant Governor,Anastasia Pittman,DEM,530304,3,6,13,22,
Nowata,Lieutenant Governor,Ivan Holmes,IND,530304,0,0,1,1,
Nowata,State Auditor,John Yeutter,LIB,530304,1,2,10,13,
Nowata,State Auditor,Cindy Byrd,REP,530304,3,15,75,93,
Nowata,Attorney General,Mike Hunter,REP,530304,2,12,75,89,
Nowata,Attorney General,Mark Myles,DEM,530304,3,5,13,21,
Nowata,State Treasurer,Randy Mcdaniel,REP,530304,4,11,78,93,
Nowata,State Treasurer,Charles De Coune,IND,530304,1,6,11,18,
Nowata,Superintendent of Public Instruction,Joy Hofmeister,REP,530304,3,11,59,73,
Nowata,Superintendent of Public Instruction,John Cox,DEM,530304,2,7,26,35,
Nowata,Superintendent of Public Instruction,Larry Huff,IND,530304,0,0,4,4,
Nowata,Commissioner of Labor,Leslie Osborn,REP,530304,2,8,64,74,
Nowata,Commissioner of Labor,Fred Dorrell,DEM,530304,3,9,19,31,
Nowata,Commissioner of Labor,Brandt Dismukes,IND,530304,0,0,2,2,
Nowata,Insurance Commissioner,Glen Mulready,REP,530304,2,9,68,79,
Nowata,Insurance Commissioner,Kimberly Fobbs,DEM,530304,3,9,21,33,
Nowata,Corporation Commissioner,Bob Anthony,REP,530304,2,11,69,82,
Nowata,Corporation Commissioner,Ashley Nicole Mccray,DEM,530304,3,7,16,26,
Nowata,Corporation Commissioner,Jackie Short,IND,530304,0,0,4,4,
Nowata,U.S. House,Richard Castaldo,LIB,530304,0,2,0,2,2
Nowata,U.S. House,Markwayne Mullin,REP,530304,3,10,74,87,2
Nowata,U.S. House,Jason Nichols,DEM,530304,2,6,12,20,2
Nowata,U.S. House,John Foreman,IND,530304,0,0,3,3,2
Nowata,State House,Judd Strom,REP,530304,2,2,33,37,10
Nowata,State House,Kevin Stacy,DEM,530304,3,18,57,78,10
Okfuskee,Governor,Chris Powell,LIB,540101,1,2,24,27,
Okfuskee,Governor,Kevin Stitt,REP,540101,8,19,385,412,
Okfuskee,Governor,Drew Edmondson,DEM,540101,9,5,137,151,
Okfuskee,Lieutenant Governor,Matt Pinnell,REP,540101,11,18,418,447,
Okfuskee,Lieutenant Governor,Anastasia Pittman,DEM,540101,6,8,108,122,
Okfuskee,Lieutenant Governor,Ivan Holmes,IND,540101,1,0,14,15,
Okfuskee,State Auditor,John Yeutter,LIB,540101,5,3,87,95,
Okfuskee,State Auditor,Cindy Byrd,REP,540101,11,21,422,454,
Okfuskee,Attorney General,Mike Hunter,REP,540101,10,18,420,448,
Okfuskee,Attorney General,Mark Myles,DEM,540101,8,8,121,137,
Okfuskee,State Treasurer,Randy Mcdaniel,REP,540101,11,20,437,468,
Okfuskee,State Treasurer,Charles De Coune,IND,540101,6,4,74,84,
Okfuskee,Superintendent of Public Instruction,Joy Hofmeister,REP,540101,11,14,348,373,
Okfuskee,Superintendent of Public Instruction,John Cox,DEM,540101,4,10,140,154,
Okfuskee,Superintendent of Public Instruction,Larry Huff,IND,540101,3,2,50,55,
Okfuskee,Commissioner of Labor,Leslie Osborn,REP,540101,11,16,402,429,
Okfuskee,Commissioner of Labor,Fred Dorrell,DEM,540101,4,8,113,125,
Okfuskee,Commissioner of Labor,Brandt Dismukes,IND,540101,2,1,15,18,
Okfuskee,Insurance Commissioner,Glen Mulready,REP,540101,11,19,421,451,
Okfuskee,Insurance Commissioner,Kimberly Fobbs,DEM,540101,7,7,119,133,
Okfuskee,Corporation Commissioner,Bob Anthony,REP,540101,9,18,394,421,
Okfuskee,Corporation Commissioner,Ashley Nicole Mccray,DEM,540101,7,8,118,133,
Okfuskee,Corporation Commissioner,Jackie Short,IND,540101,2,0,29,31,
Okfuskee,U.S. House,Richard Castaldo,LIB,540101,1,0,6,7,2
Okfuskee,U.S. House,Markwayne Mullin,REP,540101,10,18,390,418,2
Okfuskee,U.S. House,Jason Nichols,DEM,540101,5,8,122,135,2
Okfuskee,U.S. House,John Foreman,IND,540101,2,0,24,26,2
Okfuskee,State Senate,Roger Thompson,REP,540101,9,18,378,405,8
Okfuskee,State Senate,Shannan Tucker,DEM,540101,6,8,143,157,8
Okfuskee,State Senate,Marlena Nobles,IND,540101,2,0,19,21,8
Okfuskee,State House,Logan Phillips,REP,540101,10,16,383,409,24
Okfuskee,State House,Steve Kouplen,DEM,540101,7,10,154,171,24
Okfuskee,Governor,Chris Powell,LIB,540102,0,1,1,2,
Okfuskee,Governor,Kevin Stitt,REP,540102,3,5,21,29,
Okfuskee,Governor,Drew Edmondson,DEM,540102,5,12,98,115,
Okfuskee,Lieutenant Governor,Matt Pinnell,REP,540102,3,6,22,31,
Okfuskee,Lieutenant Governor,Anastasia Pittman,DEM,540102,5,12,96,113,
Okfuskee,Lieutenant Governor,Ivan Holmes,IND,540102,0,0,1,1,
Okfuskee,State Auditor,John Yeutter,LIB,540102,3,6,60,69,
Okfuskee,State Auditor,Cindy Byrd,REP,540102,4,7,35,46,
Okfuskee,Attorney General,Mike Hunter,REP,540102,3,6,21,30,
Okfuskee,Attorney General,Mark Myles,DEM,540102,5,12,98,115,
Okfuskee,State Treasurer,Randy Mcdaniel,REP,540102,4,6,29,39,
Okfuskee,State Treasurer,Charles De Coune,IND,540102,3,8,63,74,
Okfuskee,Superintendent of Public Instruction,Joy Hofmeister,REP,540102,3,4,27,34,
Okfuskee,Superintendent of Public Instruction,John Cox,DEM,540102,5,14,90,109,
Okfuskee,Superintendent of Public Instruction,Larry Huff,IND,540102,0,0,2,2,
Okfuskee,Commissioner of Labor,Leslie Osborn,REP,540102,2,5,26,33,
Okfuskee,Commissioner of Labor,Fred Dorrell,DEM,540102,5,12,93,110,
Okfuskee,Commissioner of Labor,Brandt Dismukes,IND,540102,1,1,0,2,
Okfuskee,Insurance Commissioner,Glen Mulready,REP,540102,3,6,21,30,
Okfuskee,Insurance Commissioner,Kimberly Fobbs,DEM,540102,5,12,98,115,
Okfuskee,Corporation Commissioner,Bob Anthony,REP,540102,2,7,24,33,
Okfuskee,Corporation Commissioner,Ashley Nicole Mccray,DEM,540102,5,11,93,109,
Okfuskee,Corporation Commissioner,Jackie Short,IND,540102,1,0,2,3,
Okfuskee,U.S. House,Richard Castaldo,LIB,540102,0,0,2,2,2
Okfuskee,U.S. House,Markwayne Mullin,REP,540102,3,6,22,31,2
Okfuskee,U.S. House,Jason Nichols,DEM,540102,5,12,93,110,2
Okfuskee,U.S. House,John Foreman,IND,540102,0,0,3,3,2
Okfuskee,State Senate,Roger Thompson,REP,540102,2,7,30,39,8
Okfuskee,State Senate,Shannan Tucker,DEM,540102,6,11,88,105,8
Okfuskee,State Senate,Marlena Nobles,IND,540102,0,0,2,2,8
Okfuskee,State House,Logan Phillips,REP,540102,3,6,20,29,24
Okfuskee,State House,Steve Kouplen,DEM,540102,5,12,100,117,24
Okfuskee,Governor,Chris Powell,LIB,540103,0,0,0,0,
Okfuskee,Governor,Kevin Stitt,REP,540103,2,2,71,75,
Okfuskee,Governor,Drew Edmondson,DEM,540103,0,0,42,42,
Okfuskee,Lieutenant Governor,Matt Pinnell,REP,540103,2,2,72,76,
Okfuskee,Lieutenant Governor,Anastasia Pittman,DEM,540103,0,0,36,36,
Okfuskee,Lieutenant Governor,Ivan Holmes,IND,540103,0,0,2,2,
Okfuskee,State Auditor,John Yeutter,LIB,540103,0,0,24,24,
Okfuskee,State Auditor,Cindy Byrd,REP,540103,2,2,76,80,
Okfuskee,Attorney General,Mike Hunter,REP,540103,2,2,73,77,
Okfuskee,Attorney General,Mark Myles,DEM,540103,0,0,36,36,
Okfuskee,State Treasurer,Randy Mcdaniel,REP,540103,2,2,73,77,
Okfuskee,State Treasurer,Charles De Coune,IND,540103,0,0,29,29,
Okfuskee,Superintendent of Public Instruction,Joy Hofmeister,REP,540103,2,1,57,60,
Okfuskee,Superintendent of Public Instruction,John Cox,DEM,540103,0,0,45,45,
Okfuskee,Superintendent of Public Instruction,Larry Huff,IND,540103,0,1,9,10,
Okfuskee,Commissioner of Labor,Leslie Osborn,REP,540103,2,2,69,73,
Okfuskee,Commissioner of Labor,Fred Dorrell,DEM,540103,0,0,34,34,
Okfuskee,Commissioner of Labor,Brandt Dismukes,IND,540103,0,0,6,6,
Okfuskee,Insurance Commissioner,Glen Mulready,REP,540103,2,2,72,76,
Okfuskee,Insurance Commissioner,Kimberly Fobbs,DEM,540103,0,0,38,38,
Okfuskee,Corporation Commissioner,Bob Anthony,REP,540103,2,2,71,75,
Okfuskee,Corporation Commissioner,Ashley Nicole Mccray,DEM,540103,0,0,34,34,
Okfuskee,Corporation Commissioner,Jackie Short,IND,540103,0,0,4,4,
Okfuskee,U.S. House,Richard Castaldo,LIB,540103,0,0,4,4,2
Okfuskee,U.S. House,Markwayne Mullin,REP,540103,2,1,70,73,2
Okfuskee,U.S. House,Jason Nichols,DEM,540103,0,0,32,32,2
Okfuskee,U.S. House,John Foreman,IND,540103,0,1,6,7,2
Okfuskee,State Senate,Roger Thompson,REP,540103,2,2,62,66,8
Okfuskee,State Senate,Shannan Tucker,DEM,540103,0,0,45,45,8
Okfuskee,State Senate,Marlena Nobles,IND,540103,0,0,5,5,8
Okfuskee,State House,Logan Phillips,REP,540103,2,1,49,52,24
Okfuskee,State House,Steve Kouplen,DEM,540103,0,1,60,61,24
Okfuskee,Governor,Chris Powell,LIB,540105,0,1,5,6,
Okfuskee,Governor,Kevin Stitt,REP,540105,0,9,53,62,
Okfuskee,Governor,Drew Edmondson,DEM,540105,0,15,56,71,
Okfuskee,Lieutenant Governor,Matt Pinnell,REP,540105,0,11,61,72,
Okfuskee,Lieutenant Governor,Anastasia Pittman,DEM,540105,0,14,42,56,
Okfuskee,Lieutenant Governor,Ivan Holmes,IND,540105,0,0,10,10,
Okfuskee,State Auditor,John Yeutter,LIB,540105,0,7,26,33,
Okfuskee,State Auditor,Cindy Byrd,REP,540105,0,14,76,90,
Okfuskee,Attorney General,Mike Hunter,REP,540105,0,11,67,78,
Okfuskee,Attorney General,Mark Myles,DEM,540105,0,14,47,61,
Okfuskee,State Treasurer,Randy Mcdaniel,REP,540105,0,12,78,90,
Okfuskee,State Treasurer,Charles De Coune,IND,540105,0,9,26,35,
Okfuskee,Superintendent of Public Instruction,Joy Hofmeister,REP,540105,0,11,56,67,
Okfuskee,Superintendent of Public Instruction,John Cox,DEM,540105,0,13,47,60,
Okfuskee,Superintendent of Public Instruction,Larry Huff,IND,540105,0,1,10,11,
Okfuskee,Commissioner of Labor,Leslie Osborn,REP,540105,0,11,58,69,
Okfuskee,Commissioner of Labor,Fred Dorrell,DEM,540105,0,13,44,57,
Okfuskee,Commissioner of Labor,Brandt Dismukes,IND,540105,0,1,12,13,
Okfuskee,Insurance Commissioner,Glen Mulready,REP,540105,0,10,65,75,
Okfuskee,Insurance Commissioner,Kimberly Fobbs,DEM,540105,0,15,49,64,
Okfuskee,Corporation Commissioner,Bob Anthony,REP,540105,0,11,60,71,
Okfuskee,Corporation Commissioner,Ashley Nicole Mccray,DEM,540105,0,13,43,56,
Okfuskee,Corporation Commissioner,Jackie Short,IND,540105,0,1,11,12,
Okfuskee,U.S. House,Richard Castaldo,LIB,540105,0,1,4,5,2
Okfuskee,U.S. House,Markwayne Mullin,REP,540105,0,10,61,71,2
Okfuskee,U.S. House,Jason Nichols,DEM,540105,0,14,41,55,2
Okfuskee,U.S. House,John Foreman,IND,540105,0,0,8,8,2
Okfuskee,State Senate,Roger Thompson,REP,540105,0,8,45,53,8
Okfuskee,State Senate,Shannan Tucker,DEM,540105,0,16,60,76,8
Okfuskee,State Senate,Marlena Nobles,IND,540105,0,1,9,10,8
Okfuskee,State House,Logan Phillips,REP,540105,0,7,54,61,24
Okfuskee,State House,Steve Kouplen,DEM,540105,0,18,60,78,24
Okfuskee,Governor,Chris Powell,LIB,540206,2,2,4,8,
Okfuskee,Governor,Kevin Stitt,REP,540206,9,12,141,162,
Okfuskee,Governor,Drew Edmondson,DEM,540206,8,10,68,86,
Okfuskee,Lieutenant Governor,Matt Pinnell,REP,540206,10,16,167,193,
Okfuskee,Lieutenant Governor,Anastasia Pittman,DEM,540206,8,7,43,58,
Okfuskee,Lieutenant Governor,Ivan Holmes,IND,540206,1,1,3,5,
Okfuskee,State Auditor,John Yeutter,LIB,540206,3,3,34,40,
Okfuskee,State Auditor,Cindy Byrd,REP,540206,13,19,166,198,
Okfuskee,Attorney General,Mike Hunter,REP,540206,10,14,160,184,
Okfuskee,Attorney General,Mark Myles,DEM,540206,9,10,51,70,
Okfuskee,State Treasurer,Randy Mcdaniel,REP,540206,11,17,177,205,
Okfuskee,State Treasurer,Charles De Coune,IND,540206,4,5,23,32,
Okfuskee,Superintendent of Public Instruction,Joy Hofmeister,REP,540206,9,16,138,163,
Okfuskee,Superintendent of Public Instruction,John Cox,DEM,540206,8,6,65,79,
Okfuskee,Superintendent of Public Instruction,Larry Huff,IND,540206,2,2,8,12,
Okfuskee,Commissioner of Labor,Leslie Osborn,REP,540206,7,18,154,179,
Okfuskee,Commissioner of Labor,Fred Dorrell,DEM,540206,9,6,47,62,
Okfuskee,Commissioner of Labor,Brandt Dismukes,IND,540206,1,0,9,10,
Okfuskee,Insurance Commissioner,Glen Mulready,REP,540206,10,14,160,184,
Okfuskee,Insurance Commissioner,Kimberly Fobbs,DEM,540206,8,10,49,67,
Okfuskee,Corporation Commissioner,Bob Anthony,REP,540206,12,15,160,187,
Okfuskee,Corporation Commissioner,Ashley Nicole Mccray,DEM,540206,7,7,46,60,
Okfuskee,Corporation Commissioner,Jackie Short,IND,540206,0,2,6,8,
Okfuskee,U.S. House,Richard Castaldo,LIB,540206,2,1,3,6,2
Okfuskee,U.S. House,Markwayne Mullin,REP,540206,9,17,160,186,2
Okfuskee,U.S. House,Jason Nichols,DEM,540206,8,4,47,59,2
Okfuskee,U.S. House,John Foreman,IND,540206,0,2,4,6,2
Okfuskee,State Senate,Roger Thompson,REP,540206,7,14,102,123,8
Okfuskee,State Senate,Shannan Tucker,DEM,540206,11,10,107,128,8
Okfuskee,State Senate,Marlena Nobles,IND,540206,0,0,6,6,8
Okfuskee,State House,Logan Phillips,REP,540206,7,14,107,128,24
Okfuskee,State House,Steve Kouplen,DEM,540206,11,10,107,128,24
Okfuskee,Governor,Chris Powell,LIB,540207,0,0,3,3,
Okfuskee,Governor,Kevin Stitt,REP,540207,3,4,61,68,
Okfuskee,Governor,Drew Edmondson,DEM,540207,1,3,33,37,
Okfuskee,Lieutenant Governor,Matt Pinnell,REP,540207,3,4,61,68,
Okfuskee,Lieutenant Governor,Anastasia Pittman,DEM,540207,1,3,29,33,
Okfuskee,Lieutenant Governor,Ivan Holmes,IND,540207,0,0,6,6,
Okfuskee,State Auditor,John Yeutter,LIB,540207,0,0,21,21,
Okfuskee,State Auditor,Cindy Byrd,REP,540207,3,7,72,82,
Okfuskee,Attorney General,Mike Hunter,REP,540207,3,4,64,71,
Okfuskee,Attorney General,Mark Myles,DEM,540207,1,3,32,36,
Okfuskee,State Treasurer,Randy Mcdaniel,REP,540207,3,7,72,82,
Okfuskee,State Treasurer,Charles De Coune,IND,540207,0,0,21,21,
Okfuskee,Superintendent of Public Instruction,Joy Hofmeister,REP,540207,2,5,56,63,
Okfuskee,Superintendent of Public Instruction,John Cox,DEM,540207,1,2,25,28,
Okfuskee,Superintendent of Public Instruction,Larry Huff,IND,540207,1,0,13,14,
Okfuskee,Commissioner of Labor,Leslie Osborn,REP,540207,3,5,60,68,
Okfuskee,Commissioner of Labor,Fred Dorrell,DEM,540207,1,2,27,30,
Okfuskee,Commissioner of Labor,Brandt Dismukes,IND,540207,0,0,8,8,
Okfuskee,Insurance Commissioner,Glen Mulready,REP,540207,3,2,56,61,
Okfuskee,Insurance Commissioner,Kimberly Fobbs,DEM,540207,1,5,39,45,
Okfuskee,Corporation Commissioner,Bob Anthony,REP,540207,2,3,62,67,
Okfuskee,Corporation Commissioner,Ashley Nicole Mccray,DEM,540207,1,3,30,34,
Okfuskee,Corporation Commissioner,Jackie Short,IND,540207,1,1,4,6,
Okfuskee,U.S. House,Richard Castaldo,LIB,540207,0,0,1,1,2
Okfuskee,U.S. House,Markwayne Mullin,REP,540207,3,4,64,71,2
Okfuskee,U.S. House,Jason Nichols,DEM,540207,1,3,24,28,2
Okfuskee,U.S. House,John Foreman,IND,540207,0,0,9,9,2
Okfuskee,State Senate,Roger Thompson,REP,540207,2,2,48,52,8
Okfuskee,State Senate,Shannan Tucker,DEM,540207,2,5,44,51,8
Okfuskee,State Senate,Marlena Nobles,IND,540207,0,0,6,6,8
Okfuskee,State House,Logan Phillips,REP,540207,2,3,39,44,24
Okfuskee,State House,Steve Kouplen,DEM,540207,2,4,57,63,24
Okfuskee,Governor,Chris Powell,LIB,540208,0,3,11,14,
Okfuskee,Governor,Kevin Stitt,REP,540208,4,36,121,161,
Okfuskee,Governor,Drew Edmondson,DEM,540208,5,21,81,107,
Okfuskee,Lieutenant Governor,Matt Pinnell,REP,540208,5,41,150,196,
Okfuskee,Lieutenant Governor,Anastasia Pittman,DEM,540208,4,18,52,74,
Okfuskee,Lieutenant Governor,Ivan Holmes,IND,540208,0,2,10,12,
Okfuskee,State Auditor,John Yeutter,LIB,540208,2,10,38,50,
Okfuskee,State Auditor,Cindy Byrd,REP,540208,5,47,167,219,
Okfuskee,Attorney General,Mike Hunter,REP,540208,4,46,147,197,
Okfuskee,Attorney General,Mark Myles,DEM,540208,4,14,63,81,
Okfuskee,State Treasurer,Randy Mcdaniel,REP,540208,5,48,170,223,
Okfuskee,State Treasurer,Charles De Coune,IND,540208,2,8,36,46,
Okfuskee,Superintendent of Public Instruction,Joy Hofmeister,REP,540208,4,39,117,160,
Okfuskee,Superintendent of Public Instruction,John Cox,DEM,540208,5,20,70,95,
Okfuskee,Superintendent of Public Instruction,Larry Huff,IND,540208,0,2,23,25,
Okfuskee,Commissioner of Labor,Leslie Osborn,REP,540208,5,37,136,178,
Okfuskee,Commissioner of Labor,Fred Dorrell,DEM,540208,3,18,59,80,
Okfuskee,Commissioner of Labor,Brandt Dismukes,IND,540208,0,6,11,17,
Okfuskee,Insurance Commissioner,Glen Mulready,REP,540208,4,43,143,190,
Okfuskee,Insurance Commissioner,Kimberly Fobbs,DEM,540208,4,18,66,88,
Okfuskee,Corporation Commissioner,Bob Anthony,REP,540208,6,43,143,192,
Okfuskee,Corporation Commissioner,Ashley Nicole Mccray,DEM,540208,3,16,53,72,
Okfuskee,Corporation Commissioner,Jackie Short,IND,540208,0,2,16,18,
Okfuskee,U.S. House,Richard Castaldo,LIB,540208,0,0,5,5,2
Okfuskee,U.S. House,Markwayne Mullin,REP,540208,6,42,139,187,2
Okfuskee,U.S. House,Jason Nichols,DEM,540208,3,16,56,75,2
Okfuskee,U.S. House,John Foreman,IND,540208,0,3,10,13,2
Okfuskee,State Senate,Roger Thompson,REP,540208,4,34,92,130,8
Okfuskee,State Senate,Shannan Tucker,DEM,540208,4,26,114,144,8
Okfuskee,State Senate,Marlena Nobles,IND,540208,1,1,6,8,8
Okfuskee,State House,Logan Phillips,REP,540208,4,29,99,132,24
Okfuskee,State House,Steve Kouplen,DEM,540208,4,32,112,148,24
Okfuskee,Governor,Chris Powell,LIB,540209,3,6,15,24,
Okfuskee,Governor,Kevin Stitt,REP,540209,5,41,198,244,
Okfuskee,Governor,Drew Edmondson,DEM,540209,12,19,180,211,
Okfuskee,Lieutenant Governor,Matt Pinnell,REP,540209,10,45,252,307,
Okfuskee,Lieutenant Governor,Anastasia Pittman,DEM,540209,9,18,124,151,
Okfuskee,Lieutenant Governor,Ivan Holmes,IND,540209,0,2,15,17,
Okfuskee,State Auditor,John Yeutter,LIB,540209,4,10,77,91,
Okfuskee,State Auditor,Cindy Byrd,REP,540209,12,49,287,348,
Okfuskee,Attorney General,Mike Hunter,REP,540209,13,47,263,323,
Okfuskee,Attorney General,Mark Myles,DEM,540209,6,18,127,151,
Okfuskee,State Treasurer,Randy Mcdaniel,REP,540209,11,47,290,348,
Okfuskee,State Treasurer,Charles De Coune,IND,540209,3,13,71,87,
Okfuskee,Superintendent of Public Instruction,Joy Hofmeister,REP,540209,7,41,222,270,
Okfuskee,Superintendent of Public Instruction,John Cox,DEM,540209,9,20,132,161,
Okfuskee,Superintendent of Public Instruction,Larry Huff,IND,540209,2,5,36,43,
Okfuskee,Commissioner of Labor,Leslie Osborn,REP,540209,10,43,240,293,
Okfuskee,Commissioner of Labor,Fred Dorrell,DEM,540209,7,17,119,143,
Okfuskee,Commissioner of Labor,Brandt Dismukes,IND,540209,1,4,24,29,
Okfuskee,Insurance Commissioner,Glen Mulready,REP,540209,8,48,237,293,
Okfuskee,Insurance Commissioner,Kimberly Fobbs,DEM,540209,10,17,144,171,
Okfuskee,Corporation Commissioner,Bob Anthony,REP,540209,10,41,236,287,
Okfuskee,Corporation Commissioner,Ashley Nicole Mccray,DEM,540209,7,21,127,155,
Okfuskee,Corporation Commissioner,Jackie Short,IND,540209,2,2,20,24,
Okfuskee,U.S. House,Richard Castaldo,LIB,540209,1,3,8,12,2
Okfuskee,U.S. House,Markwayne Mullin,REP,540209,11,43,233,287,2
Okfuskee,U.S. House,Jason Nichols,DEM,540209,6,19,131,156,2
Okfuskee,U.S. House,John Foreman,IND,540209,2,1,13,16,2
Okfuskee,State Senate,Roger Thompson,REP,540209,6,39,168,213,8
Okfuskee,State Senate,Shannan Tucker,DEM,540209,12,25,215,252,8
Okfuskee,State Senate,Marlena Nobles,IND,540209,1,2,11,14,8
Okfuskee,State House,Logan Phillips,REP,540209,7,36,174,217,24
Okfuskee,State House,Steve Kouplen,DEM,540209,12,30,215,257,24
Okfuskee,Governor,Chris Powell,LIB,540210,1,1,3,5,
Okfuskee,Governor,Kevin Stitt,REP,540210,1,18,81,100,
Okfuskee,Governor,Drew Edmondson,DEM,540210,3,7,42,52,
Okfuskee,Lieutenant Governor,Matt Pinnell,REP,540210,0,22,86,108,
Okfuskee,Lieutenant Governor,Anastasia Pittman,DEM,540210,3,4,34,41,
Okfuskee,Lieutenant Governor,Ivan Holmes,IND,540210,1,0,4,5,
Okfuskee,State Auditor,John Yeutter,LIB,540210,1,2,24,27,
Okfuskee,State Auditor,Cindy Byrd,REP,540210,4,24,89,117,
Okfuskee,Attorney General,Mike Hunter,REP,540210,2,24,82,108,
Okfuskee,Attorney General,Mark Myles,DEM,540210,3,2,41,46,
Okfuskee,State Treasurer,Randy Mcdaniel,REP,540210,2,24,94,120,
Okfuskee,State Treasurer,Charles De Coune,IND,540210,3,2,21,26,
Okfuskee,Superintendent of Public Instruction,Joy Hofmeister,REP,540210,0,15,66,81,
Okfuskee,Superintendent of Public Instruction,John Cox,DEM,540210,4,11,45,60,
Okfuskee,Superintendent of Public Instruction,Larry Huff,IND,540210,1,0,13,14,
Okfuskee,Commissioner of Labor,Leslie Osborn,REP,540210,2,19,80,101,
Okfuskee,Commissioner of Labor,Fred Dorrell,DEM,540210,2,7,35,44,
Okfuskee,Commissioner of Labor,Brandt Dismukes,IND,540210,1,0,7,8,
Okfuskee,Insurance Commissioner,Glen Mulready,REP,540210,1,22,82,105,
Okfuskee,Insurance Commissioner,Kimberly Fobbs,DEM,540210,4,4,42,50,
Okfuskee,Corporation Commissioner,Bob Anthony,REP,540210,2,20,84,106,
Okfuskee,Corporation Commissioner,Ashley Nicole Mccray,DEM,540210,2,5,32,39,
Okfuskee,Corporation Commissioner,Jackie Short,IND,540210,1,1,9,11,
Okfuskee,U.S. House,Richard Castaldo,LIB,540210,1,0,2,3,2
Okfuskee,U.S. House,Markwayne Mullin,REP,540210,1,18,88,107,2
Okfuskee,U.S. House,Jason Nichols,DEM,540210,3,8,31,42,2
Okfuskee,U.S. House,John Foreman,IND,540210,0,0,6,6,2
Okfuskee,State House,Logan Phillips,REP,540210,1,13,57,71,24
Okfuskee,State House,Steve Kouplen,DEM,540210,4,13,68,85,24
Okfuskee,Governor,Chris Powell,LIB,540311,0,0,2,2,
Okfuskee,Governor,Kevin Stitt,REP,540311,5,13,131,149,
Okfuskee,Governor,Drew Edmondson,DEM,540311,4,11,74,89,
Okfuskee,Lieutenant Governor,Matt Pinnell,REP,540311,5,14,142,161,
Okfuskee,Lieutenant Governor,Anastasia Pittman,DEM,540311,4,11,59,74,
Okfuskee,Lieutenant Governor,Ivan Holmes,IND,540311,0,0,5,5,
Okfuskee,State Auditor,John Yeutter,LIB,540311,0,6,37,43,
Okfuskee,State Auditor,Cindy Byrd,REP,540311,7,17,152,176,
Okfuskee,Attorney General,Mike Hunter,REP,540311,4,12,141,157,
Okfuskee,Attorney General,Mark Myles,DEM,540311,3,11,65,79,
Okfuskee,State Treasurer,Randy Mcdaniel,REP,540311,6,15,153,174,
Okfuskee,State Treasurer,Charles De Coune,IND,540311,0,8,36,44,
Okfuskee,Superintendent of Public Instruction,Joy Hofmeister,REP,540311,7,9,116,132,
Okfuskee,Superintendent of Public Instruction,John Cox,DEM,540311,2,12,75,89,
Okfuskee,Superintendent of Public Instruction,Larry Huff,IND,540311,0,4,14,18,
Okfuskee,Commissioner of Labor,Leslie Osborn,REP,540311,5,12,137,154,
Okfuskee,Commissioner of Labor,Fred Dorrell,DEM,540311,3,10,67,80,
Okfuskee,Commissioner of Labor,Brandt Dismukes,IND,540311,0,2,2,4,
Okfuskee,Insurance Commissioner,Glen Mulready,REP,540311,5,15,140,160,
Okfuskee,Insurance Commissioner,Kimberly Fobbs,DEM,540311,3,10,66,79,
Okfuskee,Corporation Commissioner,Bob Anthony,REP,540311,4,12,126,142,
Okfuskee,Corporation Commissioner,Ashley Nicole Mccray,DEM,540311,3,11,70,84,
Okfuskee,Corporation Commissioner,Jackie Short,IND,540311,1,2,10,13,
Okfuskee,U.S. House,Richard Castaldo,LIB,540311,0,0,1,1,2
Okfuskee,U.S. House,Markwayne Mullin,REP,540311,5,12,130,147,2
Okfuskee,U.S. House,Jason Nichols,DEM,540311,2,12,68,82,2
Okfuskee,U.S. House,John Foreman,IND,540311,1,1,8,10,2
Okfuskee,State Senate,Roger Thompson,REP,540311,6,8,109,123,8
Okfuskee,State Senate,Shannan Tucker,DEM,540311,2,15,91,108,8
Okfuskee,State Senate,Marlena Nobles,IND,540311,0,2,6,8,8
Okfuskee,State House,Logan Phillips,REP,540311,5,10,107,122,24
Okfuskee,State House,Steve Kouplen,DEM,540311,3,15,96,114,24
Okfuskee,Governor,Chris Powell,LIB,540312,0,0,7,7,
Okfuskee,Governor,Kevin Stitt,REP,540312,3,12,149,164,
Okfuskee,Governor,Drew Edmondson,DEM,540312,8,9,122,139,
Okfuskee,Lieutenant Governor,Matt Pinnell,REP,540312,3,14,162,179,
Okfuskee,Lieutenant Governor,Anastasia Pittman,DEM,540312,8,7,106,121,
Okfuskee,Lieutenant Governor,Ivan Holmes,IND,540312,0,0,8,8,
Okfuskee,State Auditor,John Yeutter,LIB,540312,8,9,64,81,
Okfuskee,State Auditor,Cindy Byrd,REP,540312,3,9,190,202,
Okfuskee,Attorney General,Mike Hunter,REP,540312,3,15,169,187,
Okfuskee,Attorney General,Mark Myles,DEM,540312,8,6,107,121,
Okfuskee,State Treasurer,Randy Mcdaniel,REP,540312,3,12,193,208,
Okfuskee,State Treasurer,Charles De Coune,IND,540312,8,6,61,75,
Okfuskee,Superintendent of Public Instruction,Joy Hofmeister,REP,540312,3,8,154,165,
Okfuskee,Superintendent of Public Instruction,John Cox,DEM,540312,8,12,103,123,
Okfuskee,Superintendent of Public Instruction,Larry Huff,IND,540312,0,1,21,22,
Okfuskee,Commissioner of Labor,Leslie Osborn,REP,540312,4,13,168,185,
Okfuskee,Commissioner of Labor,Fred Dorrell,DEM,540312,7,7,98,112,
Okfuskee,Commissioner of Labor,Brandt Dismukes,IND,540312,0,1,10,11,
Okfuskee,Insurance Commissioner,Glen Mulready,REP,540312,3,14,162,179,
Okfuskee,Insurance Commissioner,Kimberly Fobbs,DEM,540312,8,6,114,128,
Okfuskee,Corporation Commissioner,Bob Anthony,REP,540312,3,13,168,184,
Okfuskee,Corporation Commissioner,Ashley Nicole Mccray,DEM,540312,8,7,100,115,
Okfuskee,Corporation Commissioner,Jackie Short,IND,540312,0,0,7,7,
Okfuskee,U.S. House,Richard Castaldo,LIB,540312,0,1,1,2,2
Okfuskee,U.S. House,Markwayne Mullin,REP,540312,3,13,176,192,2
Okfuskee,U.S. House,Jason Nichols,DEM,540312,8,7,90,105,2
Okfuskee,U.S. House,John Foreman,IND,540312,0,0,10,10,2
Okfuskee,State House,Logan Phillips,REP,540312,3,9,122,134,24
Okfuskee,State House,Steve Kouplen,DEM,540312,8,11,153,172,24
Okfuskee,Governor,Chris Powell,LIB,540313,0,0,0,0,
Okfuskee,Governor,Kevin Stitt,REP,540313,2,3,35,40,
Okfuskee,Governor,Drew Edmondson,DEM,540313,1,4,36,41,
Okfuskee,Lieutenant Governor,Matt Pinnell,REP,540313,2,4,41,47,
Okfuskee,Lieutenant Governor,Anastasia Pittman,DEM,540313,1,3,29,33,
Okfuskee,Lieutenant Governor,Ivan Holmes,IND,540313,0,0,1,1,
Okfuskee,State Auditor,John Yeutter,LIB,540313,0,2,13,15,
Okfuskee,State Auditor,Cindy Byrd,REP,540313,2,4,52,58,
Okfuskee,Attorney General,Mike Hunter,REP,540313,2,4,39,45,
Okfuskee,Attorney General,Mark Myles,DEM,540313,1,3,32,36,
Okfuskee,State Treasurer,Randy Mcdaniel,REP,540313,2,4,48,54,
Okfuskee,State Treasurer,Charles De Coune,IND,540313,1,2,19,22,
Okfuskee,Superintendent of Public Instruction,Joy Hofmeister,REP,540313,2,4,33,39,
Okfuskee,Superintendent of Public Instruction,John Cox,DEM,540313,1,3,33,37,
Okfuskee,Superintendent of Public Instruction,Larry Huff,IND,540313,0,0,5,5,
Okfuskee,Commissioner of Labor,Leslie Osborn,REP,540313,2,4,39,45,
Okfuskee,Commissioner of Labor,Fred Dorrell,DEM,540313,1,3,31,35,
Okfuskee,Commissioner of Labor,Brandt Dismukes,IND,540313,0,0,1,1,
Okfuskee,Insurance Commissioner,Glen Mulready,REP,540313,2,4,39,45,
Okfuskee,Insurance Commissioner,Kimberly Fobbs,DEM,540313,1,3,31,35,
Okfuskee,Corporation Commissioner,Bob Anthony,REP,540313,2,4,39,45,
Okfuskee,Corporation Commissioner,Ashley Nicole Mccray,DEM,540313,1,3,28,32,
Okfuskee,Corporation Commissioner,Jackie Short,IND,540313,0,0,3,3,
Okfuskee,U.S. House,Richard Castaldo,LIB,540313,0,0,0,0,2
Okfuskee,U.S. House,Markwayne Mullin,REP,540313,2,4,46,52,2
Okfuskee,U.S. House,Jason Nichols,DEM,540313,1,3,23,27,2
Okfuskee,U.S. House,John Foreman,IND,540313,0,0,1,1,2
Okfuskee,State Senate,Roger Thompson,REP,540313,2,4,42,48,8
Okfuskee,State Senate,Shannan Tucker,DEM,540313,1,3,27,31,8
Okfuskee,State Senate,Marlena Nobles,IND,540313,0,0,1,1,8
Okfuskee,State House,Logan Phillips,REP,540313,2,3,30,35,24
Okfuskee,State House,Steve Kouplen,DEM,540313,1,4,40,45,24
Okfuskee,Governor,Chris Powell,LIB,540314,0,0,13,13,
Okfuskee,Governor,Kevin Stitt,REP,540314,5,16,65,86,
Okfuskee,Governor,Drew Edmondson,DEM,540314,5,19,76,100,
Okfuskee,Lieutenant Governor,Matt Pinnell,REP,540314,5,16,89,110,
Okfuskee,Lieutenant Governor,Anastasia Pittman,DEM,540314,4,19,58,81,
Okfuskee,Lieutenant Governor,Ivan Holmes,IND,540314,1,0,6,7,
Okfuskee,State Auditor,John Yeutter,LIB,540314,0,2,40,42,
Okfuskee,State Auditor,Cindy Byrd,REP,540314,6,28,101,135,
Okfuskee,Attorney General,Mike Hunter,REP,540314,5,19,83,107,
Okfuskee,Attorney General,Mark Myles,DEM,540314,5,16,70,91,
Okfuskee,State Treasurer,Randy Mcdaniel,REP,540314,5,25,105,135,
Okfuskee,State Treasurer,Charles De Coune,IND,540314,1,5,39,45,
Okfuskee,Superintendent of Public Instruction,Joy Hofmeister,REP,540314,5,15,71,91,
Okfuskee,Superintendent of Public Instruction,John Cox,DEM,540314,5,18,57,80,
Okfuskee,Superintendent of Public Instruction,Larry Huff,IND,540314,0,2,24,26,
Okfuskee,Commissioner of Labor,Leslie Osborn,REP,540314,5,17,79,101,
Okfuskee,Commissioner of Labor,Fred Dorrell,DEM,540314,5,16,67,88,
Okfuskee,Commissioner of Labor,Brandt Dismukes,IND,540314,0,2,6,8,
Okfuskee,Insurance Commissioner,Glen Mulready,REP,540314,6,16,86,108,
Okfuskee,Insurance Commissioner,Kimberly Fobbs,DEM,540314,4,19,66,89,
Okfuskee,Corporation Commissioner,Bob Anthony,REP,540314,5,18,77,100,
Okfuskee,Corporation Commissioner,Ashley Nicole Mccray,DEM,540314,5,17,61,83,
Okfuskee,Corporation Commissioner,Jackie Short,IND,540314,0,0,12,12,
Okfuskee,U.S. House,Richard Castaldo,LIB,540314,0,1,2,3,2
Okfuskee,U.S. House,Markwayne Mullin,REP,540314,5,15,83,103,2
Okfuskee,U.S. House,Jason Nichols,DEM,540314,5,17,59,81,2
Okfuskee,U.S. House,John Foreman,IND,540314,0,2,9,11,2
Okfuskee,State Senate,Roger Thompson,REP,540314,4,15,63,82,8
Okfuskee,State Senate,Shannan Tucker,DEM,540314,6,19,88,113,8
Okfuskee,State Senate,Marlena Nobles,IND,540314,0,1,2,3,8
Okfuskee,State House,Logan Phillips,REP,540314,5,13,55,73,24
Okfuskee,State House,Steve Kouplen,DEM,540314,5,21,94,120,24
Oklahoma,Governor,Chris Powell,LIB,550001,0,0,32,32,
Oklahoma,Governor,Kevin Stitt,REP,550001,0,0,227,227,
Oklahoma,Governor,Drew Edmondson,DEM,550001,0,0,332,332,
Oklahoma,Lieutenant Governor,Matt Pinnell,REP,550001,0,0,258,258,
Oklahoma,Lieutenant Governor,Anastasia Pittman,DEM,550001,0,0,301,301,
Oklahoma,Lieutenant Governor,Ivan Holmes,IND,550001,0,0,31,31,
Oklahoma,State Auditor,John Yeutter,LIB,550001,0,0,223,223,
Oklahoma,State Auditor,Cindy Byrd,REP,550001,0,0,315,315,
Oklahoma,Attorney General,Mike Hunter,REP,550001,0,0,271,271,
Oklahoma,Attorney General,Mark Myles,DEM,550001,0,0,313,313,
Oklahoma,State Treasurer,Randy Mcdaniel,REP,550001,0,0,298,298,
Oklahoma,State Treasurer,Charles De Coune,IND,550001,0,0,239,239,
Oklahoma,Superintendent of Public Instruction,Joy Hofmeister,REP,550001,0,0,262,262,
Oklahoma,Superintendent of Public Instruction,John Cox,DEM,550001,0,0,265,265,
Oklahoma,Superintendent of Public Instruction,Larry Huff,IND,550001,0,0,56,56,
Oklahoma,Commissioner of Labor,Leslie Osborn,REP,550001,0,0,270,270,
Oklahoma,Commissioner of Labor,Fred Dorrell,DEM,550001,0,0,275,275,
Oklahoma,Commissioner of Labor,Brandt Dismukes,IND,550001,0,0,38,38,
Oklahoma,Insurance Commissioner,Glen Mulready,REP,550001,0,0,266,266,
Oklahoma,Insurance Commissioner,Kimberly Fobbs,DEM,550001,0,0,312,312,
Oklahoma,Corporation Commissioner,Bob Anthony,REP,550001,0,0,257,257,
Oklahoma,Corporation Commissioner,Ashley Nicole Mccray,DEM,550001,0,0,277,277,
Oklahoma,Corporation Commissioner,Jackie Short,IND,550001,0,0,49,49,
Oklahoma,U.S. House,Steve Russell,REP,550001,0,0,244,244,5
Oklahoma,U.S. House,Kendra Horn,DEM,550001,0,0,340,340,5
Oklahoma,State Senate,John Symcox,REP,550001,0,0,247,247,30
Oklahoma,State Senate,Julia Kirt,DEM,550001,0,0,336,336,30
Oklahoma,State House,William Cagle,LIB,550001,0,0,41,41,84
Oklahoma,State House,Tammy West,REP,550001,0,0,270,270,84
Oklahoma,State House,Lauren Morris,DEM,550001,0,0,276,276,84
Oklahoma,Governor,Chris Powell,LIB,550002,0,0,33,33,
Oklahoma,Governor,Kevin Stitt,REP,550002,0,0,301,301,
Oklahoma,Governor,Drew Edmondson,DEM,550002,0,0,266,266,
Oklahoma,Lieutenant Governor,Matt Pinnell,REP,550002,0,0,339,339,
Oklahoma,Lieutenant Governor,Anastasia Pittman,DEM,550002,0,0,219,219,
Oklahoma,Lieutenant Governor,Ivan Holmes,IND,550002,0,0,39,39,
Oklahoma,State Auditor,John Yeutter,LIB,550002,0,0,167,167,
Oklahoma,State Auditor,Cindy Byrd,REP,550002,0,0,393,393,
Oklahoma,Attorney General,Mike Hunter,REP,550002,0,0,368,368,
Oklahoma,Attorney General,Mark Myles,DEM,550002,0,0,225,225,
Oklahoma,State Treasurer,Randy Mcdaniel,REP,550002,0,0,345,345,
Oklahoma,State Treasurer,Charles De Coune,IND,550002,0,0,213,213,
Oklahoma,Superintendent of Public Instruction,Joy Hofmeister,REP,550002,0,0,326,326,
Oklahoma,Superintendent of Public Instruction,John Cox,DEM,550002,0,0,202,202,
Oklahoma,Superintendent of Public Instruction,Larry Huff,IND,550002,0,0,69,69,
Oklahoma,Commissioner of Labor,Leslie Osborn,REP,550002,0,0,345,345,
Oklahoma,Commissioner of Labor,Fred Dorrell,DEM,550002,0,0,192,192,
Oklahoma,Commissioner of Labor,Brandt Dismukes,IND,550002,0,0,51,51,
Oklahoma,Insurance Commissioner,Glen Mulready,REP,550002,0,0,349,349,
Oklahoma,Insurance Commissioner,Kimberly Fobbs,DEM,550002,0,0,240,240,
Oklahoma,Corporation Commissioner,Bob Anthony,REP,550002,0,0,333,333,
Oklahoma,Corporation Commissioner,Ashley Nicole Mccray,DEM,550002,0,0,205,205,
Oklahoma,Corporation Commissioner,Jackie Short,IND,550002,0,0,57,57,
Oklahoma,U.S. House,Steve Russell,REP,550002,0,0,349,349,5
Oklahoma,U.S. House,Kendra Horn,DEM,550002,0,0,250,250,5
Oklahoma,State Senate,John Symcox,REP,550002,0,0,333,333,30
Oklahoma,State Senate,Julia Kirt,DEM,550002,0,0,261,261,30
Oklahoma,State House,William Cagle,LIB,550002,0,0,31,31,84
Oklahoma,State House,Tammy West,REP,550002,0,0,366,366,84
Oklahoma,State House,Lauren Morris,DEM,550002,0,0,202,202,84
Oklahoma,Governor,Chris Powell,LIB,550003,0,0,45,45,
Oklahoma,Governor,Kevin Stitt,REP,550003,0,0,426,426,
Oklahoma,Governor,Drew Edmondson,DEM,550003,0,0,314,314,
Oklahoma,Lieutenant Governor,Matt Pinnell,REP,550003,0,0,494,494,
Oklahoma,Lieutenant Governor,Anastasia Pittman,DEM,550003,0,0,244,244,
Oklahoma,Lieutenant Governor,Ivan Holmes,IND,550003,0,0,44,44,
Oklahoma,State Auditor,John Yeutter,LIB,550003,0,0,190,190,
Oklahoma,State Auditor,Cindy Byrd,REP,550003,0,0,544,544,
Oklahoma,Attorney General,Mike Hunter,REP,550003,0,0,513,513,
Oklahoma,Attorney General,Mark Myles,DEM,550003,0,0,262,262,
Oklahoma,State Treasurer,Randy Mcdaniel,REP,550003,0,0,517,517,
Oklahoma,State Treasurer,Charles De Coune,IND,550003,0,0,213,213,
Oklahoma,Superintendent of Public Instruction,Joy Hofmeister,REP,550003,0,0,460,460,
Oklahoma,Superintendent of Public Instruction,John Cox,DEM,550003,0,0,231,231,
Oklahoma,Superintendent of Public Instruction,Larry Huff,IND,550003,0,0,86,86,
Oklahoma,Commissioner of Labor,Leslie Osborn,REP,550003,0,0,487,487,
Oklahoma,Commissioner of Labor,Fred Dorrell,DEM,550003,0,0,224,224,
Oklahoma,Commissioner of Labor,Brandt Dismukes,IND,550003,0,0,55,55,
Oklahoma,Insurance Commissioner,Glen Mulready,REP,550003,0,0,492,492,
Oklahoma,Insurance Commissioner,Kimberly Fobbs,DEM,550003,0,0,270,270,
Oklahoma,Corporation Commissioner,Bob Anthony,REP,550003,0,0,466,466,
Oklahoma,Corporation Commissioner,Ashley Nicole Mccray,DEM,550003,0,0,234,234,
Oklahoma,Corporation Commissioner,Jackie Short,IND,550003,0,0,67,67,
Oklahoma,U.S. House,Steve Russell,REP,550003,0,0,483,483,5
Oklahoma,U.S. House,Kendra Horn,DEM,550003,0,0,291,291,5
Oklahoma,State Senate,John Symcox,REP,550003,0,0,467,467,30
Oklahoma,State Senate,Julia Kirt,DEM,550003,0,0,304,304,30
Oklahoma,State House,William Cagle,LIB,550003,0,0,45,45,84
Oklahoma,State House,Tammy West,REP,550003,0,0,522,522,84
Oklahoma,State House,Lauren Morris,DEM,550003,0,0,211,211,84
Oklahoma,Governor,Chris Powell,LIB,550004,0,0,42,42,
Oklahoma,Governor,Kevin Stitt,REP,550004,0,0,483,483,
Oklahoma,Governor,Drew Edmondson,DEM,550004,0,0,345,345,
Oklahoma,Lieutenant Governor,Matt Pinnell,REP,550004,0,0,562,562,
Oklahoma,Lieutenant Governor,Anastasia Pittman,DEM,550004,0,0,256,256,
Oklahoma,Lieutenant Governor,Ivan Holmes,IND,550004,0,0,48,48,
Oklahoma,State Auditor,John Yeutter,LIB,550004,0,0,191,191,
Oklahoma,State Auditor,Cindy Byrd,REP,550004,0,0,615,615,
Oklahoma,Attorney General,Mike Hunter,REP,550004,0,0,578,578,
Oklahoma,Attorney General,Mark Myles,DEM,550004,0,0,279,279,
Oklahoma,State Treasurer,Randy Mcdaniel,REP,550004,0,0,582,582,
Oklahoma,State Treasurer,Charles De Coune,IND,550004,0,0,219,219,
Oklahoma,Superintendent of Public Instruction,Joy Hofmeister,REP,550004,0,0,540,540,
Oklahoma,Superintendent of Public Instruction,John Cox,DEM,550004,0,0,240,240,
Oklahoma,Superintendent of Public Instruction,Larry Huff,IND,550004,0,0,78,78,
Oklahoma,Commissioner of Labor,Leslie Osborn,REP,550004,0,0,550,550,
Oklahoma,Commissioner of Labor,Fred Dorrell,DEM,550004,0,0,227,227,
Oklahoma,Commissioner of Labor,Brandt Dismukes,IND,550004,0,0,66,66,
Oklahoma,Insurance Commissioner,Glen Mulready,REP,550004,0,0,547,547,
Oklahoma,Insurance Commissioner,Kimberly Fobbs,DEM,550004,0,0,301,301,
Oklahoma,Corporation Commissioner,Bob Anthony,REP,550004,0,0,542,542,
Oklahoma,Corporation Commissioner,Ashley Nicole Mccray,DEM,550004,0,0,248,248,
Oklahoma,Corporation Commissioner,Jackie Short,IND,550004,0,0,63,63,
Oklahoma,U.S. House,Steve Russell,REP,550004,0,0,541,541,5
Oklahoma,U.S. House,Kendra Horn,DEM,550004,0,0,313,313,5
Oklahoma,State Senate,John Symcox,REP,550004,0,0,532,532,30
Oklahoma,State Senate,Julia Kirt,DEM,550004,0,0,325,325,30
Oklahoma,State House,William Cagle,LIB,550004,0,0,38,38,84
Oklahoma,State House,Tammy West,REP,550004,0,0,594,594,84
Oklahoma,State House,Lauren Morris,DEM,550004,0,0,231,231,84
Oklahoma,Governor,Chris Powell,LIB,550005,0,0,35,35,
Oklahoma,Governor,Kevin Stitt,REP,550005,0,0,362,362,
Oklahoma,Governor,Drew Edmondson,DEM,550005,0,0,326,326,
Oklahoma,Lieutenant Governor,Matt Pinnell,REP,550005,0,0,417,417,
Oklahoma,Lieutenant Governor,Anastasia Pittman,DEM,550005,0,0,271,271,
Oklahoma,Lieutenant Governor,Ivan Holmes,IND,550005,0,0,29,29,
Oklahoma,State Auditor,John Yeutter,LIB,550005,0,0,192,192,
Oklahoma,State Auditor,Cindy Byrd,REP,550005,0,0,463,463,
Oklahoma,Attorney General,Mike Hunter,REP,550005,0,0,431,431,
Oklahoma,Attorney General,Mark Myles,DEM,550005,0,0,284,284,
Oklahoma,State Treasurer,Randy Mcdaniel,REP,550005,0,0,430,430,
Oklahoma,State Treasurer,Charles De Coune,IND,550005,0,0,227,227,
Oklahoma,Superintendent of Public Instruction,Joy Hofmeister,REP,550005,0,0,402,402,
Oklahoma,Superintendent of Public Instruction,John Cox,DEM,550005,0,0,267,267,
Oklahoma,Superintendent of Public Instruction,Larry Huff,IND,550005,0,0,44,44,
Oklahoma,Commissioner of Labor,Leslie Osborn,REP,550005,0,0,419,419,
Oklahoma,Commissioner of Labor,Fred Dorrell,DEM,550005,0,0,257,257,
Oklahoma,Commissioner of Labor,Brandt Dismukes,IND,550005,0,0,31,31,
Oklahoma,Insurance Commissioner,Glen Mulready,REP,550005,0,0,420,420,
Oklahoma,Insurance Commissioner,Kimberly Fobbs,DEM,550005,0,0,280,280,
Oklahoma,Corporation Commissioner,Bob Anthony,REP,550005,0,0,406,406,
Oklahoma,Corporation Commissioner,Ashley Nicole Mccray,DEM,550005,0,0,258,258,
Oklahoma,Corporation Commissioner,Jackie Short,IND,550005,0,0,42,42,
Oklahoma,U.S. House,Steve Russell,REP,550005,0,0,396,396,5
Oklahoma,U.S. House,Kendra Horn,DEM,550005,0,0,321,321,5
Oklahoma,State Senate,Joe Howell,REP,550005,0,0,362,362,40
Oklahoma,State Senate,Carri Hicks,DEM,550005,0,0,323,323,40
Oklahoma,State Senate,Christopher Hensley,IND,550005,0,0,26,26,40
Oklahoma,State House,William Cagle,LIB,550005,0,0,34,34,84
Oklahoma,State House,Tammy West,REP,550005,0,0,432,432,84
Oklahoma,State House,Lauren Morris,DEM,550005,0,0,250,250,84
Oklahoma,Governor,Chris Powell,LIB,550006,0,0,38,38,
Oklahoma,Governor,Kevin Stitt,REP,550006,0,0,286,286,
Oklahoma,Governor,Drew Edmondson,DEM,550006,0,0,230,230,
Oklahoma,Lieutenant Governor,Matt Pinnell,REP,550006,0,0,318,318,
Oklahoma,Lieutenant Governor,Anastasia Pittman,DEM,550006,0,0,194,194,
Oklahoma,Lieutenant Governor,Ivan Holmes,IND,550006,0,0,34,34,
Oklahoma,State Auditor,John Yeutter,LIB,550006,0,0,139,139,
Oklahoma,State Auditor,Cindy Byrd,REP,550006,0,0,374,374,
Oklahoma,Attorney General,Mike Hunter,REP,550006,0,0,345,345,
Oklahoma,Attorney General,Mark Myles,DEM,550006,0,0,201,201,
Oklahoma,State Treasurer,Randy Mcdaniel,REP,550006,0,0,353,353,
Oklahoma,State Treasurer,Charles De Coune,IND,550006,0,0,163,163,
Oklahoma,Superintendent of Public Instruction,Joy Hofmeister,REP,550006,0,0,314,314,
Oklahoma,Superintendent of Public Instruction,John Cox,DEM,550006,0,0,175,175,
Oklahoma,Superintendent of Public Instruction,Larry Huff,IND,550006,0,0,54,54,
Oklahoma,Commissioner of Labor,Leslie Osborn,REP,550006,0,0,329,329,
Oklahoma,Commissioner of Labor,Fred Dorrell,DEM,550006,0,0,173,173,
Oklahoma,Commissioner of Labor,Brandt Dismukes,IND,550006,0,0,37,37,
Oklahoma,Insurance Commissioner,Glen Mulready,REP,550006,0,0,329,329,
Oklahoma,Insurance Commissioner,Kimberly Fobbs,DEM,550006,0,0,211,211,
Oklahoma,Corporation Commissioner,Bob Anthony,REP,550006,0,0,320,320,
Oklahoma,Corporation Commissioner,Ashley Nicole Mccray,DEM,550006,0,0,179,179,
Oklahoma,Corporation Commissioner,Jackie Short,IND,550006,0,0,46,46,
Oklahoma,U.S. House,Steve Russell,REP,550006,0,0,316,316,5
Oklahoma,U.S. House,Kendra Horn,DEM,550006,0,0,234,234,5
Oklahoma,State Senate,John Symcox,REP,550006,0,0,308,308,30
Oklahoma,State Senate,Julia Kirt,DEM,550006,0,0,242,242,30
Oklahoma,State House,William Cagle,LIB,550006,0,0,28,28,84
Oklahoma,State House,Tammy West,REP,550006,0,0,337,337,84
Oklahoma,State House,Lauren Morris,DEM,550006,0,0,186,186,84
Oklahoma,Governor,Chris Powell,LIB,550007,0,0,54,54,
Oklahoma,Governor,Kevin Stitt,REP,550007,0,0,530,530,
Oklahoma,Governor,Drew Edmondson,DEM,550007,0,0,325,325,
Oklahoma,Lieutenant Governor,Matt Pinnell,REP,550007,0,0,599,599,
Oklahoma,Lieutenant Governor,Anastasia Pittman,DEM,550007,0,0,250,250,
Oklahoma,Lieutenant Governor,Ivan Holmes,IND,550007,0,0,54,54,
Oklahoma,State Auditor,John Yeutter,LIB,550007,0,0,184,184,
Oklahoma,State Auditor,Cindy Byrd,REP,550007,0,0,673,673,
Oklahoma,Attorney General,Mike Hunter,REP,550007,0,0,641,641,
Oklahoma,Attorney General,Mark Myles,DEM,550007,0,0,261,261,
Oklahoma,State Treasurer,Randy Mcdaniel,REP,550007,0,0,631,631,
Oklahoma,State Treasurer,Charles De Coune,IND,550007,0,0,230,230,
Oklahoma,Superintendent of Public Instruction,Joy Hofmeister,REP,550007,0,0,580,580,
Oklahoma,Superintendent of Public Instruction,John Cox,DEM,550007,0,0,235,235,
Oklahoma,Superintendent of Public Instruction,Larry Huff,IND,550007,0,0,85,85,
Oklahoma,Commissioner of Labor,Leslie Osborn,REP,550007,0,0,608,608,
Oklahoma,Commissioner of Labor,Fred Dorrell,DEM,550007,0,0,230,230,
Oklahoma,Commissioner of Labor,Brandt Dismukes,IND,550007,0,0,50,50,
Oklahoma,Insurance Commissioner,Glen Mulready,REP,550007,0,0,608,608,
Oklahoma,Insurance Commissioner,Kimberly Fobbs,DEM,550007,0,0,280,280,
Oklahoma,Corporation Commissioner,Bob Anthony,REP,550007,0,0,572,572,
Oklahoma,Corporation Commissioner,Ashley Nicole Mccray,DEM,550007,0,0,244,244,
Oklahoma,Corporation Commissioner,Jackie Short,IND,550007,0,0,81,81,
Oklahoma,U.S. House,Steve Russell,REP,550007,0,0,589,589,5
Oklahoma,U.S. House,Kendra Horn,DEM,550007,0,0,312,312,5
Oklahoma,State House,William Cagle,LIB,550007,0,0,54,54,84
Oklahoma,State House,Tammy West,REP,550007,0,0,611,611,84
Oklahoma,State House,Lauren Morris,DEM,550007,0,0,237,237,84
Oklahoma,Governor,Chris Powell,LIB,550008,0,0,19,19,
Oklahoma,Governor,Kevin Stitt,REP,550008,0,0,265,265,
Oklahoma,Governor,Drew Edmondson,DEM,550008,0,0,127,127,
Oklahoma,Lieutenant Governor,Matt Pinnell,REP,550008,0,0,306,306,
Oklahoma,Lieutenant Governor,Anastasia Pittman,DEM,550008,0,0,85,85,
Oklahoma,Lieutenant Governor,Ivan Holmes,IND,550008,0,0,18,18,
Oklahoma,State Auditor,John Yeutter,LIB,550008,0,0,66,66,
Oklahoma,State Auditor,Cindy Byrd,REP,550008,0,0,318,318,
Oklahoma,Attorney General,Mike Hunter,REP,550008,0,0,319,319,
Oklahoma,Attorney General,Mark Myles,DEM,550008,0,0,86,86,
Oklahoma,State Treasurer,Randy Mcdaniel,REP,550008,0,0,319,319,
Oklahoma,State Treasurer,Charles De Coune,IND,550008,0,0,69,69,
Oklahoma,Superintendent of Public Instruction,Joy Hofmeister,REP,550008,0,0,280,280,
Oklahoma,Superintendent of Public Instruction,John Cox,DEM,550008,0,0,88,88,
Oklahoma,Superintendent of Public Instruction,Larry Huff,IND,550008,0,0,41,41,
Oklahoma,Commissioner of Labor,Leslie Osborn,REP,550008,0,0,306,306,
Oklahoma,Commissioner of Labor,Fred Dorrell,DEM,550008,0,0,79,79,
Oklahoma,Commissioner of Labor,Brandt Dismukes,IND,550008,0,0,19,19,
Oklahoma,Insurance Commissioner,Glen Mulready,REP,550008,0,0,295,295,
Oklahoma,Insurance Commissioner,Kimberly Fobbs,DEM,550008,0,0,100,100,
Oklahoma,Corporation Commissioner,Bob Anthony,REP,550008,0,0,302,302,
Oklahoma,Corporation Commissioner,Ashley Nicole Mccray,DEM,550008,0,0,80,80,
Oklahoma,Corporation Commissioner,Jackie Short,IND,550008,0,0,20,20,
Oklahoma,U.S. House,Steve Russell,REP,550008,0,0,291,291,5
Oklahoma,U.S. House,Kendra Horn,DEM,550008,0,0,117,117,5
Oklahoma,State Senate,John Symcox,REP,550008,0,0,286,286,30
Oklahoma,State Senate,Julia Kirt,DEM,550008,0,0,124,124,30
Oklahoma,State House,William Cagle,LIB,550008,0,0,22,22,84
Oklahoma,State House,Tammy West,REP,550008,0,0,303,303,84
Oklahoma,State House,Lauren Morris,DEM,550008,0,0,84,84,84
Oklahoma,Governor,Chris Powell,LIB,550009,0,0,22,22,
Oklahoma,Governor,Kevin Stitt,REP,550009,0,0,259,259,
Oklahoma,Governor,Drew Edmondson,DEM,550009,0,0,237,237,
Oklahoma,Lieutenant Governor,Matt Pinnell,REP,550009,0,0,306,306,
Oklahoma,Lieutenant Governor,Anastasia Pittman,DEM,550009,0,0,181,181,
Oklahoma,Lieutenant Governor,Ivan Holmes,IND,550009,0,0,28,28,
Oklahoma,State Auditor,John Yeutter,LIB,550009,0,0,104,104,
Oklahoma,State Auditor,Cindy Byrd,REP,550009,0,0,383,383,
Oklahoma,Attorney General,Mike Hunter,REP,550009,0,0,344,344,
Oklahoma,Attorney General,Mark Myles,DEM,550009,0,0,168,168,
Oklahoma,State Treasurer,Randy Mcdaniel,REP,550009,0,0,355,355,
Oklahoma,State Treasurer,Charles De Coune,IND,550009,0,0,133,133,
Oklahoma,Superintendent of Public Instruction,Joy Hofmeister,REP,550009,0,0,323,323,
Oklahoma,Superintendent of Public Instruction,John Cox,DEM,550009,0,0,139,139,
Oklahoma,Superintendent of Public Instruction,Larry Huff,IND,550009,0,0,46,46,
Oklahoma,Commissioner of Labor,Leslie Osborn,REP,550009,0,0,335,335,
Oklahoma,Commissioner of Labor,Fred Dorrell,DEM,550009,0,0,134,134,
Oklahoma,Commissioner of Labor,Brandt Dismukes,IND,550009,0,0,35,35,
Oklahoma,Insurance Commissioner,Glen Mulready,REP,550009,0,0,320,320,
Oklahoma,Insurance Commissioner,Kimberly Fobbs,DEM,550009,0,0,188,188,
Oklahoma,Corporation Commissioner,Bob Anthony,REP,550009,0,0,311,311,
Oklahoma,Corporation Commissioner,Ashley Nicole Mccray,DEM,550009,0,0,166,166,
Oklahoma,Corporation Commissioner,Jackie Short,IND,550009,0,0,32,32,
Oklahoma,U.S. House,Steve Russell,REP,550009,0,0,309,309,5
Oklahoma,U.S. House,Kendra Horn,DEM,550009,0,0,204,204,5
Oklahoma,State Senate,John Symcox,REP,550009,0,0,300,300,30
Oklahoma,State Senate,Julia Kirt,DEM,550009,0,0,215,215,30
Oklahoma,State House,Marilyn Stark,REP,550009,0,0,345,345,10
Oklahoma,State House,Zach Pearson,DEM,550009,0,0,166,166,10
Oklahoma,Governor,Chris Powell,LIB,550010,0,0,15,15,
Oklahoma,Governor,Kevin Stitt,REP,550010,0,0,217,217,
Oklahoma,Governor,Drew Edmondson,DEM,550010,0,0,182,182,
Oklahoma,Lieutenant Governor,Matt Pinnell,REP,550010,0,0,255,255,
Oklahoma,Lieutenant Governor,Anastasia Pittman,DEM,550010,0,0,132,132,
Oklahoma,Lieutenant Governor,Ivan Holmes,IND,550010,0,0,26,26,
Oklahoma,State Auditor,John Yeutter,LIB,550010,0,0,106,106,
Oklahoma,State Auditor,Cindy Byrd,REP,550010,0,0,277,277,
Oklahoma,Attorney General,Mike Hunter,REP,550010,0,0,246,246,
Oklahoma,Attorney General,Mark Myles,DEM,550010,0,0,164,164,
Oklahoma,State Treasurer,Randy Mcdaniel,REP,550010,0,0,260,260,
Oklahoma,State Treasurer,Charles De Coune,IND,550010,0,0,121,121,
Oklahoma,Superintendent of Public Instruction,Joy Hofmeister,REP,550010,0,0,235,235,
Oklahoma,Superintendent of Public Instruction,John Cox,DEM,550010,0,0,125,125,
Oklahoma,Superintendent of Public Instruction,Larry Huff,IND,550010,0,0,50,50,
Oklahoma,Commissioner of Labor,Leslie Osborn,REP,550010,0,0,246,246,
Oklahoma,Commissioner of Labor,Fred Dorrell,DEM,550010,0,0,139,139,
Oklahoma,Commissioner of Labor,Brandt Dismukes,IND,550010,0,0,22,22,
Oklahoma,Insurance Commissioner,Glen Mulready,REP,550010,0,0,250,250,
Oklahoma,Insurance Commissioner,Kimberly Fobbs,DEM,550010,0,0,155,155,
Oklahoma,Corporation Commissioner,Bob Anthony,REP,550010,0,0,230,230,
Oklahoma,Corporation Commissioner,Ashley Nicole Mccray,DEM,550010,0,0,137,137,
Oklahoma,Corporation Commissioner,Jackie Short,IND,550010,0,0,40,40,
Oklahoma,U.S. House,Steve Russell,REP,550010,0,0,235,235,5
Oklahoma,U.S. House,Kendra Horn,DEM,550010,0,0,178,178,5
Oklahoma,State Senate,John Symcox,REP,550010,0,0,233,233,30
Oklahoma,State Senate,Julia Kirt,DEM,550010,0,0,177,177,30
Oklahoma,State House,William Cagle,LIB,550010,0,0,21,21,84
Oklahoma,State House,Tammy West,REP,550010,0,0,253,253,84
Oklahoma,State House,Lauren Morris,DEM,550010,0,0,137,137,84
Oklahoma,Governor,Chris Powell,LIB,550011,0,0,32,32,
Oklahoma,Governor,Kevin Stitt,REP,550011,0,0,272,272,
Oklahoma,Governor,Drew Edmondson,DEM,550011,0,0,290,290,
Oklahoma,Lieutenant Governor,Matt Pinnell,REP,550011,0,0,309,309,
Oklahoma,Lieutenant Governor,Anastasia Pittman,DEM,550011,0,0,246,246,
Oklahoma,Lieutenant Governor,Ivan Holmes,IND,550011,0,0,32,32,
Oklahoma,State Auditor,John Yeutter,LIB,550011,0,0,184,184,
Oklahoma,State Auditor,Cindy Byrd,REP,550011,0,0,350,350,
Oklahoma,Attorney General,Mike Hunter,REP,550011,0,0,306,306,
Oklahoma,Attorney General,Mark Myles,DEM,550011,0,0,279,279,
Oklahoma,State Treasurer,Randy Mcdaniel,REP,550011,0,0,319,319,
Oklahoma,State Treasurer,Charles De Coune,IND,550011,0,0,216,216,
Oklahoma,Superintendent of Public Instruction,Joy Hofmeister,REP,550011,0,0,294,294,
Oklahoma,Superintendent of Public Instruction,John Cox,DEM,550011,0,0,229,229,
Oklahoma,Superintendent of Public Instruction,Larry Huff,IND,550011,0,0,63,63,
Oklahoma,Commissioner of Labor,Leslie Osborn,REP,550011,0,0,314,314,
Oklahoma,Commissioner of Labor,Fred Dorrell,DEM,550011,0,0,232,232,
Oklahoma,Commissioner of Labor,Brandt Dismukes,IND,550011,0,0,29,29,
Oklahoma,Insurance Commissioner,Glen Mulready,REP,550011,0,0,293,293,
Oklahoma,Insurance Commissioner,Kimberly Fobbs,DEM,550011,0,0,281,281,
Oklahoma,Corporation Commissioner,Bob Anthony,REP,550011,0,0,300,300,
Oklahoma,Corporation Commissioner,Ashley Nicole Mccray,DEM,550011,0,0,233,233,
Oklahoma,Corporation Commissioner,Jackie Short,IND,550011,0,0,51,51,
Oklahoma,U.S. House,Steve Russell,REP,550011,0,0,297,297,5
Oklahoma,U.S. House,Kendra Horn,DEM,550011,0,0,293,293,5
Oklahoma,State Senate,Joe Howell,REP,550011,0,0,270,270,40
Oklahoma,State Senate,Carri Hicks,DEM,550011,0,0,287,287,40
Oklahoma,State Senate,Christopher Hensley,IND,550011,0,0,26,26,40
Oklahoma,State House,William Cagle,LIB,550011,0,0,25,25,84
Oklahoma,State House,Tammy West,REP,550011,0,0,328,328,84
Oklahoma,State House,Lauren Morris,DEM,550011,0,0,235,235,84
Oklahoma,Governor,Chris Powell,LIB,550012,0,0,47,47,
Oklahoma,Governor,Kevin Stitt,REP,550012,0,0,438,438,
Oklahoma,Governor,Drew Edmondson,DEM,550012,0,0,519,519,
Oklahoma,Lieutenant Governor,Matt Pinnell,REP,550012,0,0,509,509,
Oklahoma,Lieutenant Governor,Anastasia Pittman,DEM,550012,0,0,422,422,
Oklahoma,Lieutenant Governor,Ivan Holmes,IND,550012,0,0,64,64,
Oklahoma,State Auditor,John Yeutter,LIB,550012,0,0,302,302,
Oklahoma,State Auditor,Cindy Byrd,REP,550012,0,0,611,611,
Oklahoma,Attorney General,Mike Hunter,REP,550012,0,0,530,530,
Oklahoma,Attorney General,Mark Myles,DEM,550012,0,0,458,458,
Oklahoma,State Treasurer,Randy Mcdaniel,REP,550012,0,0,543,543,
Oklahoma,State Treasurer,Charles De Coune,IND,550012,0,0,367,367,
Oklahoma,Superintendent of Public Instruction,Joy Hofmeister,REP,550012,0,0,531,531,
Oklahoma,Superintendent of Public Instruction,John Cox,DEM,550012,0,0,374,374,
Oklahoma,Superintendent of Public Instruction,Larry Huff,IND,550012,0,0,84,84,
Oklahoma,Commissioner of Labor,Leslie Osborn,REP,550012,0,0,512,512,
Oklahoma,Commissioner of Labor,Fred Dorrell,DEM,550012,0,0,403,403,
Oklahoma,Commissioner of Labor,Brandt Dismukes,IND,550012,0,0,71,71,
Oklahoma,Insurance Commissioner,Glen Mulready,REP,550012,0,0,513,513,
Oklahoma,Insurance Commissioner,Kimberly Fobbs,DEM,550012,0,0,456,456,
Oklahoma,Corporation Commissioner,Bob Anthony,REP,550012,0,0,508,508,
Oklahoma,Corporation Commissioner,Ashley Nicole Mccray,DEM,550012,0,0,412,412,
Oklahoma,Corporation Commissioner,Jackie Short,IND,550012,0,0,64,64,
Oklahoma,U.S. House,Steve Russell,REP,550012,0,0,487,487,5
Oklahoma,U.S. House,Kendra Horn,DEM,550012,0,0,506,506,5
Oklahoma,State Senate,Joe Howell,REP,550012,0,0,422,422,40
Oklahoma,State Senate,Carri Hicks,DEM,550012,0,0,521,521,40
Oklahoma,State Senate,Christopher Hensley,IND,550012,0,0,47,47,40
Oklahoma,Governor,Chris Powell,LIB,550013,0,0,42,42,
Oklahoma,Governor,Kevin Stitt,REP,550013,0,0,318,318,
Oklahoma,Governor,Drew Edmondson,DEM,550013,0,0,313,313,
Oklahoma,Lieutenant Governor,Matt Pinnell,REP,550013,0,0,346,346,
Oklahoma,Lieutenant Governor,Anastasia Pittman,DEM,550013,0,0,276,276,
Oklahoma,Lieutenant Governor,Ivan Holmes,IND,550013,0,0,41,41,
Oklahoma,State Auditor,John Yeutter,LIB,550013,0,0,200,200,
Oklahoma,State Auditor,Cindy Byrd,REP,550013,0,0,406,406,
Oklahoma,Attorney General,Mike Hunter,REP,550013,0,0,361,361,
Oklahoma,Attorney General,Mark Myles,DEM,550013,0,0,303,303,
Oklahoma,State Treasurer,Randy Mcdaniel,REP,550013,0,0,376,376,
Oklahoma,State Treasurer,Charles De Coune,IND,550013,0,0,239,239,
Oklahoma,Superintendent of Public Instruction,Joy Hofmeister,REP,550013,0,0,337,337,
Oklahoma,Superintendent of Public Instruction,John Cox,DEM,550013,0,0,243,243,
Oklahoma,Superintendent of Public Instruction,Larry Huff,IND,550013,0,0,80,80,
Oklahoma,Commissioner of Labor,Leslie Osborn,REP,550013,0,0,359,359,
Oklahoma,Commissioner of Labor,Fred Dorrell,DEM,550013,0,0,250,250,
Oklahoma,Commissioner of Labor,Brandt Dismukes,IND,550013,0,0,49,49,
Oklahoma,Insurance Commissioner,Glen Mulready,REP,550013,0,0,348,348,
Oklahoma,Insurance Commissioner,Kimberly Fobbs,DEM,550013,0,0,306,306,
Oklahoma,Corporation Commissioner,Bob Anthony,REP,550013,0,0,339,339,
Oklahoma,Corporation Commissioner,Ashley Nicole Mccray,DEM,550013,0,0,262,262,
Oklahoma,Corporation Commissioner,Jackie Short,IND,550013,0,0,59,59,
Oklahoma,U.S. House,Steve Russell,REP,550013,0,0,344,344,5
Oklahoma,U.S. House,Kendra Horn,DEM,550013,0,0,322,322,5
Oklahoma,State Senate,John Symcox,REP,550013,0,0,338,338,30
Oklahoma,State Senate,Julia Kirt,DEM,550013,0,0,325,325,30
Oklahoma,State House,Marilyn Stark,REP,550013,0,0,366,366,10
Oklahoma,State House,Zach Pearson,DEM,550013,0,0,290,290,10
Oklahoma,Governor,Chris Powell,LIB,550014,0,0,35,35,
Oklahoma,Governor,Kevin Stitt,REP,550014,0,0,303,303,
Oklahoma,Governor,Drew Edmondson,DEM,550014,0,0,336,336,
Oklahoma,Lieutenant Governor,Matt Pinnell,REP,550014,0,0,350,350,
Oklahoma,Lieutenant Governor,Anastasia Pittman,DEM,550014,0,0,284,284,
Oklahoma,Lieutenant Governor,Ivan Holmes,IND,550014,0,0,35,35,
Oklahoma,State Auditor,John Yeutter,LIB,550014,0,0,178,178,
Oklahoma,State Auditor,Cindy Byrd,REP,550014,0,0,427,427,
Oklahoma,Attorney General,Mike Hunter,REP,550014,0,0,364,364,
Oklahoma,Attorney General,Mark Myles,DEM,550014,0,0,295,295,
Oklahoma,State Treasurer,Randy Mcdaniel,REP,550014,0,0,383,383,
Oklahoma,State Treasurer,Charles De Coune,IND,550014,0,0,220,220,
Oklahoma,Superintendent of Public Instruction,Joy Hofmeister,REP,550014,0,0,348,348,
Oklahoma,Superintendent of Public Instruction,John Cox,DEM,550014,0,0,253,253,
Oklahoma,Superintendent of Public Instruction,Larry Huff,IND,550014,0,0,63,63,
Oklahoma,Commissioner of Labor,Leslie Osborn,REP,550014,0,0,358,358,
Oklahoma,Commissioner of Labor,Fred Dorrell,DEM,550014,0,0,273,273,
Oklahoma,Commissioner of Labor,Brandt Dismukes,IND,550014,0,0,27,27,
Oklahoma,Insurance Commissioner,Glen Mulready,REP,550014,0,0,350,350,
Oklahoma,Insurance Commissioner,Kimberly Fobbs,DEM,550014,0,0,305,305,
Oklahoma,Corporation Commissioner,Bob Anthony,REP,550014,0,0,354,354,
Oklahoma,Corporation Commissioner,Ashley Nicole Mccray,DEM,550014,0,0,278,278,
Oklahoma,Corporation Commissioner,Jackie Short,IND,550014,0,0,33,33,
Oklahoma,U.S. House,Steve Russell,REP,550014,0,0,338,338,5
Oklahoma,U.S. House,Kendra Horn,DEM,550014,0,0,327,327,5
Oklahoma,State Senate,John Symcox,REP,550014,0,0,327,327,30
Oklahoma,State Senate,Julia Kirt,DEM,550014,0,0,340,340,30
Oklahoma,Governor,Chris Powell,LIB,550015,0,0,24,24,
Oklahoma,Governor,Kevin Stitt,REP,550015,0,0,365,365,
Oklahoma,Governor,Drew Edmondson,DEM,550015,0,0,471,471,
Oklahoma,Lieutenant Governor,Matt Pinnell,REP,550015,0,0,427,427,
Oklahoma,Lieutenant Governor,Anastasia Pittman,DEM,550015,0,0,382,382,
Oklahoma,Lieutenant Governor,Ivan Holmes,IND,550015,0,0,41,41,
Oklahoma,State Auditor,John Yeutter,LIB,550015,0,0,252,252,
Oklahoma,State Auditor,Cindy Byrd,REP,550015,0,0,515,515,
Oklahoma,Attorney General,Mike Hunter,REP,550015,0,0,454,454,
Oklahoma,Attorney General,Mark Myles,DEM,550015,0,0,396,396,
Oklahoma,State Treasurer,Randy Mcdaniel,REP,550015,0,0,455,455,
Oklahoma,State Treasurer,Charles De Coune,IND,550015,0,0,317,317,
Oklahoma,Superintendent of Public Instruction,Joy Hofmeister,REP,550015,0,0,422,422,
Oklahoma,Superintendent of Public Instruction,John Cox,DEM,550015,0,0,360,360,
Oklahoma,Superintendent of Public Instruction,Larry Huff,IND,550015,0,0,67,67,
Oklahoma,Commissioner of Labor,Leslie Osborn,REP,550015,0,0,453,453,
Oklahoma,Commissioner of Labor,Fred Dorrell,DEM,550015,0,0,352,352,
Oklahoma,Commissioner of Labor,Brandt Dismukes,IND,550015,0,0,39,39,
Oklahoma,Insurance Commissioner,Glen Mulready,REP,550015,0,0,437,437,
Oklahoma,Insurance Commissioner,Kimberly Fobbs,DEM,550015,0,0,404,404,
Oklahoma,Corporation Commissioner,Bob Anthony,REP,550015,0,0,428,428,
Oklahoma,Corporation Commissioner,Ashley Nicole Mccray,DEM,550015,0,0,366,366,
Oklahoma,Corporation Commissioner,Jackie Short,IND,550015,0,0,53,53,
Oklahoma,U.S. House,Steve Russell,REP,550015,0,0,410,410,5
Oklahoma,U.S. House,Kendra Horn,DEM,550015,0,0,445,445,5
Oklahoma,State Senate,Joe Howell,REP,550015,0,0,369,369,40
Oklahoma,State Senate,Carri Hicks,DEM,550015,0,0,452,452,40
Oklahoma,State Senate,Christopher Hensley,IND,550015,0,0,27,27,40
Oklahoma,Governor,Chris Powell,LIB,550016,0,0,4,4,
Oklahoma,Governor,Kevin Stitt,REP,550016,0,0,95,95,
Oklahoma,Governor,Drew Edmondson,DEM,550016,0,0,102,102,
Oklahoma,Lieutenant Governor,Matt Pinnell,REP,550016,0,0,114,114,
Oklahoma,Lieutenant Governor,Anastasia Pittman,DEM,550016,0,0,77,77,
Oklahoma,Lieutenant Governor,Ivan Holmes,IND,550016,0,0,10,10,
Oklahoma,State Auditor,John Yeutter,LIB,550016,0,0,44,44,
Oklahoma,State Auditor,Cindy Byrd,REP,550016,0,0,140,140,
Oklahoma,Attorney General,Mike Hunter,REP,550016,0,0,122,122,
Oklahoma,Attorney General,Mark Myles,DEM,550016,0,0,78,78,
Oklahoma,State Treasurer,Randy Mcdaniel,REP,550016,0,0,121,121,
Oklahoma,State Treasurer,Charles De Coune,IND,550016,0,0,63,63,
Oklahoma,Superintendent of Public Instruction,Joy Hofmeister,REP,550016,0,0,118,118,
Oklahoma,Superintendent of Public Instruction,John Cox,DEM,550016,0,0,61,61,
Oklahoma,Superintendent of Public Instruction,Larry Huff,IND,550016,0,0,22,22,
Oklahoma,Commissioner of Labor,Leslie Osborn,REP,550016,0,0,121,121,
Oklahoma,Commissioner of Labor,Fred Dorrell,DEM,550016,0,0,64,64,
Oklahoma,Commissioner of Labor,Brandt Dismukes,IND,550016,0,0,13,13,
Oklahoma,Insurance Commissioner,Glen Mulready,REP,550016,0,0,113,113,
Oklahoma,Insurance Commissioner,Kimberly Fobbs,DEM,550016,0,0,82,82,
Oklahoma,Corporation Commissioner,Bob Anthony,REP,550016,0,0,108,108,
Oklahoma,Corporation Commissioner,Ashley Nicole Mccray,DEM,550016,0,0,69,69,
Oklahoma,Corporation Commissioner,Jackie Short,IND,550016,0,0,21,21,
Oklahoma,U.S. House,Steve Russell,REP,550016,0,0,106,106,5
Oklahoma,U.S. House,Kendra Horn,DEM,550016,0,0,92,92,5
Oklahoma,State Senate,Joe Howell,REP,550016,0,0,87,87,40
Oklahoma,State Senate,Carri Hicks,DEM,550016,0,0,105,105,40
Oklahoma,State Senate,Christopher Hensley,IND,550016,0,0,9,9,40
Oklahoma,State House,Stephen Paulsen,LIB,550016,0,0,7,7,85
Oklahoma,State House,Matt Jackson,REP,550016,0,0,94,94,85
Oklahoma,State House,Cyndi Munson,DEM,550016,0,0,99,99,85
Oklahoma,Governor,Chris Powell,LIB,550017,0,0,0,0,
Oklahoma,Governor,Kevin Stitt,REP,550017,0,0,0,0,
Oklahoma,Governor,Drew Edmondson,DEM,550017,0,0,0,0,
Oklahoma,Lieutenant Governor,Matt Pinnell,REP,550017,0,0,0,0,
Oklahoma,Lieutenant Governor,Anastasia Pittman,DEM,550017,0,0,0,0,
Oklahoma,Lieutenant Governor,Ivan Holmes,IND,550017,0,0,0,0,
Oklahoma,State Auditor,John Yeutter,LIB,550017,0,0,0,0,
Oklahoma,State Auditor,Cindy Byrd,REP,550017,0,0,0,0,
Oklahoma,Attorney General,Mike Hunter,REP,550017,0,0,0,0,
Oklahoma,Attorney General,Mark Myles,DEM,550017,0,0,0,0,
Oklahoma,State Treasurer,Randy Mcdaniel,REP,550017,0,0,0,0,
Oklahoma,State Treasurer,Charles De Coune,IND,550017,0,0,0,0,
Oklahoma,Superintendent of Public Instruction,Joy Hofmeister,REP,550017,0,0,0,0,
Oklahoma,Superintendent of Public Instruction,John Cox,DEM,550017,0,0,0,0,
Oklahoma,Superintendent of Public Instruction,Larry Huff,IND,550017,0,0,0,0,
Oklahoma,Commissioner of Labor,Leslie Osborn,REP,550017,0,0,0,0,
Oklahoma,Commissioner of Labor,Fred Dorrell,DEM,550017,0,0,0,0,
Oklahoma,Commissioner of Labor,Brandt Dismukes,IND,550017,0,0,0,0,
Oklahoma,Insurance Commissioner,Glen Mulready,REP,550017,0,0,0,0,
Oklahoma,Insurance Commissioner,Kimberly Fobbs,DEM,550017,0,0,0,0,
Oklahoma,Corporation Commissioner,Bob Anthony,REP,550017,0,0,0,0,
Oklahoma,Corporation Commissioner,Ashley Nicole Mccray,DEM,550017,0,0,0,0,
Oklahoma,Corporation Commissioner,Jackie Short,IND,550017,0,0,0,0,
Oklahoma,U.S. House,Steve Russell,REP,550017,0,0,0,0,5
Oklahoma,U.S. House,Kendra Horn,DEM,550017,0,0,0,0,5
Oklahoma,State Senate,John Symcox,REP,550017,0,0,0,0,30
Oklahoma,State Senate,Julia Kirt,DEM,550017,0,0,0,0,30
Oklahoma,State House,Stephen Paulsen,LIB,550017,0,0,0,0,85
Oklahoma,State House,Matt Jackson,REP,550017,0,0,0,0,85
Oklahoma,State House,Cyndi Munson,DEM,550017,0,0,0,0,85
Oklahoma,Governor,Chris Powell,LIB,550018,0,0,18,18,
Oklahoma,Governor,Kevin Stitt,REP,550018,0,0,191,191,
Oklahoma,Governor,Drew Edmondson,DEM,550018,0,0,95,95,
Oklahoma,Lieutenant Governor,Matt Pinnell,REP,550018,0,0,215,215,
Oklahoma,Lieutenant Governor,Anastasia Pittman,DEM,550018,0,0,78,78,
Oklahoma,Lieutenant Governor,Ivan Holmes,IND,550018,0,0,9,9,
Oklahoma,State Auditor,John Yeutter,LIB,550018,0,0,67,67,
Oklahoma,State Auditor,Cindy Byrd,REP,550018,0,0,214,214,
Oklahoma,Attorney General,Mike Hunter,REP,550018,0,0,222,222,
Oklahoma,Attorney General,Mark Myles,DEM,550018,0,0,78,78,
Oklahoma,State Treasurer,Randy Mcdaniel,REP,550018,0,0,214,214,
Oklahoma,State Treasurer,Charles De Coune,IND,550018,0,0,69,69,
Oklahoma,Superintendent of Public Instruction,Joy Hofmeister,REP,550018,0,0,199,199,
Oklahoma,Superintendent of Public Instruction,John Cox,DEM,550018,0,0,72,72,
Oklahoma,Superintendent of Public Instruction,Larry Huff,IND,550018,0,0,32,32,
Oklahoma,Commissioner of Labor,Leslie Osborn,REP,550018,0,0,212,212,
Oklahoma,Commissioner of Labor,Fred Dorrell,DEM,550018,0,0,72,72,
Oklahoma,Commissioner of Labor,Brandt Dismukes,IND,550018,0,0,12,12,
Oklahoma,Insurance Commissioner,Glen Mulready,REP,550018,0,0,201,201,
Oklahoma,Insurance Commissioner,Kimberly Fobbs,DEM,550018,0,0,93,93,
Oklahoma,Corporation Commissioner,Bob Anthony,REP,550018,0,0,202,202,
Oklahoma,Corporation Commissioner,Ashley Nicole Mccray,DEM,550018,0,0,74,74,
Oklahoma,Corporation Commissioner,Jackie Short,IND,550018,0,0,18,18,
Oklahoma,U.S. House,Steve Russell,REP,550018,0,0,206,206,5
Oklahoma,U.S. House,Kendra Horn,DEM,550018,0,0,97,97,5
Oklahoma,State House,Lewis Moore,REP,550018,0,0,194,194,96
Oklahoma,State House,Kathy Wallis,DEM,550018,0,0,106,106,96
Oklahoma,Governor,Chris Powell,LIB,550019,0,0,37,37,
Oklahoma,Governor,Kevin Stitt,REP,550019,0,0,452,452,
Oklahoma,Governor,Drew Edmondson,DEM,550019,0,0,261,261,
Oklahoma,Lieutenant Governor,Matt Pinnell,REP,550019,0,0,531,531,
Oklahoma,Lieutenant Governor,Anastasia Pittman,DEM,550019,0,0,187,187,
Oklahoma,Lieutenant Governor,Ivan Holmes,IND,550019,0,0,28,28,
Oklahoma,State Auditor,John Yeutter,LIB,550019,0,0,131,131,
Oklahoma,State Auditor,Cindy Byrd,REP,550019,0,0,576,576,
Oklahoma,Attorney General,Mike Hunter,REP,550019,0,0,540,540,
Oklahoma,Attorney General,Mark Myles,DEM,550019,0,0,196,196,
Oklahoma,State Treasurer,Randy Mcdaniel,REP,550019,0,0,553,553,
Oklahoma,State Treasurer,Charles De Coune,IND,550019,0,0,146,146,
Oklahoma,Superintendent of Public Instruction,Joy Hofmeister,REP,550019,0,0,510,510,
Oklahoma,Superintendent of Public Instruction,John Cox,DEM,550019,0,0,162,162,
Oklahoma,Superintendent of Public Instruction,Larry Huff,IND,550019,0,0,67,67,
Oklahoma,Commissioner of Labor,Leslie Osborn,REP,550019,0,0,523,523,
Oklahoma,Commissioner of Labor,Fred Dorrell,DEM,550019,0,0,167,167,
Oklahoma,Commissioner of Labor,Brandt Dismukes,IND,550019,0,0,41,41,
Oklahoma,Insurance Commissioner,Glen Mulready,REP,550019,0,0,532,532,
Oklahoma,Insurance Commissioner,Kimberly Fobbs,DEM,550019,0,0,203,203,
Oklahoma,Corporation Commissioner,Bob Anthony,REP,550019,0,0,506,506,
Oklahoma,Corporation Commissioner,Ashley Nicole Mccray,DEM,550019,0,0,180,180,
Oklahoma,Corporation Commissioner,Jackie Short,IND,550019,0,0,51,51,
Oklahoma,U.S. House,Steve Russell,REP,550019,0,0,521,521,5
Oklahoma,U.S. House,Kendra Horn,DEM,550019,0,0,221,221,5
Oklahoma,State House,Lewis Moore,REP,550019,0,0,474,474,96
Oklahoma,State House,Kathy Wallis,DEM,550019,0,0,266,266,96
Oklahoma,Governor,Chris Powell,LIB,550020,0,0,48,48,
Oklahoma,Governor,Kevin Stitt,REP,550020,0,0,766,766,
Oklahoma,Governor,Drew Edmondson,DEM,550020,0,0,340,340,
Oklahoma,Lieutenant Governor,Matt Pinnell,REP,550020,0,0,853,853,
Oklahoma,Lieutenant Governor,Anastasia Pittman,DEM,550020,0,0,259,259,
Oklahoma,Lieutenant Governor,Ivan Holmes,IND,550020,0,0,36,36,
Oklahoma,State Auditor,John Yeutter,LIB,550020,0,0,168,168,
Oklahoma,State Auditor,Cindy Byrd,REP,550020,0,0,927,927,
Oklahoma,Attorney General,Mike Hunter,REP,550020,0,0,880,880,
Oklahoma,Attorney General,Mark Myles,DEM,550020,0,0,256,256,
Oklahoma,State Treasurer,Randy Mcdaniel,REP,550020,0,0,870,870,
Oklahoma,State Treasurer,Charles De Coune,IND,550020,0,0,211,211,
Oklahoma,Superintendent of Public Instruction,Joy Hofmeister,REP,550020,0,0,803,803,
Oklahoma,Superintendent of Public Instruction,John Cox,DEM,550020,0,0,226,226,
Oklahoma,Superintendent of Public Instruction,Larry Huff,IND,550020,0,0,111,111,
Oklahoma,Commissioner of Labor,Leslie Osborn,REP,550020,0,0,816,816,
Oklahoma,Commissioner of Labor,Fred Dorrell,DEM,550020,0,0,244,244,
Oklahoma,Commissioner of Labor,Brandt Dismukes,IND,550020,0,0,65,65,
Oklahoma,Insurance Commissioner,Glen Mulready,REP,550020,0,0,848,848,
Oklahoma,Insurance Commissioner,Kimberly Fobbs,DEM,550020,0,0,270,270,
Oklahoma,Corporation Commissioner,Bob Anthony,REP,550020,0,0,781,781,
Oklahoma,Corporation Commissioner,Ashley Nicole Mccray,DEM,550020,0,0,257,257,
Oklahoma,Corporation Commissioner,Jackie Short,IND,550020,0,0,89,89,
Oklahoma,U.S. House,Steve Russell,REP,550020,0,0,839,839,5
Oklahoma,U.S. House,Kendra Horn,DEM,550020,0,0,302,302,5
Oklahoma,State House,Lewis Moore,REP,550020,0,0,803,803,96
Oklahoma,State House,Kathy Wallis,DEM,550020,0,0,334,334,96
Oklahoma,Governor,Chris Powell,LIB,550021,0,0,53,53,
Oklahoma,Governor,Kevin Stitt,REP,550021,0,0,739,739,
Oklahoma,Governor,Drew Edmondson,DEM,550021,0,0,414,414,
Oklahoma,Lieutenant Governor,Matt Pinnell,REP,550021,0,0,848,848,
Oklahoma,Lieutenant Governor,Anastasia Pittman,DEM,550021,0,0,304,304,
Oklahoma,Lieutenant Governor,Ivan Holmes,IND,550021,0,0,47,47,
Oklahoma,State Auditor,John Yeutter,LIB,550021,0,0,212,212,
Oklahoma,State Auditor,Cindy Byrd,REP,550021,0,0,906,906,
Oklahoma,Attorney General,Mike Hunter,REP,550021,0,0,863,863,
Oklahoma,Attorney General,Mark Myles,DEM,550021,0,0,327,327,
Oklahoma,State Treasurer,Randy Mcdaniel,REP,550021,0,0,884,884,
Oklahoma,State Treasurer,Charles De Coune,IND,550021,0,0,238,238,
Oklahoma,Superintendent of Public Instruction,Joy Hofmeister,REP,550021,0,0,771,771,
Oklahoma,Superintendent of Public Instruction,John Cox,DEM,550021,0,0,311,311,
Oklahoma,Superintendent of Public Instruction,Larry Huff,IND,550021,0,0,109,109,
Oklahoma,Commissioner of Labor,Leslie Osborn,REP,550021,0,0,817,817,
Oklahoma,Commissioner of Labor,Fred Dorrell,DEM,550021,0,0,307,307,
Oklahoma,Commissioner of Labor,Brandt Dismukes,IND,550021,0,0,55,55,
Oklahoma,Insurance Commissioner,Glen Mulready,REP,550021,0,0,832,832,
Oklahoma,Insurance Commissioner,Kimberly Fobbs,DEM,550021,0,0,343,343,
Oklahoma,Corporation Commissioner,Bob Anthony,REP,550021,0,0,797,797,
Oklahoma,Corporation Commissioner,Ashley Nicole Mccray,DEM,550021,0,0,291,291,
Oklahoma,Corporation Commissioner,Jackie Short,IND,550021,0,0,89,89,
Oklahoma,U.S. House,Steve Russell,REP,550021,0,0,795,795,5
Oklahoma,U.S. House,Kendra Horn,DEM,550021,0,0,389,389,5
Oklahoma,State House,Robert Manger,REP,550021,0,0,816,816,10
Oklahoma,State House,John Carpenter,DEM,550021,0,0,366,366,10
Oklahoma,Governor,Chris Powell,LIB,550022,0,0,31,31,
Oklahoma,Governor,Kevin Stitt,REP,550022,0,0,443,443,
Oklahoma,Governor,Drew Edmondson,DEM,550022,0,0,196,196,
Oklahoma,Lieutenant Governor,Matt Pinnell,REP,550022,0,0,468,468,
Oklahoma,Lieutenant Governor,Anastasia Pittman,DEM,550022,0,0,163,163,
Oklahoma,Lieutenant Governor,Ivan Holmes,IND,550022,0,0,32,32,
Oklahoma,State Auditor,John Yeutter,LIB,550022,0,0,111,111,
Oklahoma,State Auditor,Cindy Byrd,REP,550022,0,0,514,514,
Oklahoma,Attorney General,Mike Hunter,REP,550022,0,0,481,481,
Oklahoma,Attorney General,Mark Myles,DEM,550022,0,0,175,175,
Oklahoma,State Treasurer,Randy Mcdaniel,REP,550022,0,0,492,492,
Oklahoma,State Treasurer,Charles De Coune,IND,550022,0,0,129,129,
Oklahoma,Superintendent of Public Instruction,Joy Hofmeister,REP,550022,0,0,446,446,
Oklahoma,Superintendent of Public Instruction,John Cox,DEM,550022,0,0,148,148,
Oklahoma,Superintendent of Public Instruction,Larry Huff,IND,550022,0,0,65,65,
Oklahoma,Commissioner of Labor,Leslie Osborn,REP,550022,0,0,457,457,
Oklahoma,Commissioner of Labor,Fred Dorrell,DEM,550022,0,0,144,144,
Oklahoma,Commissioner of Labor,Brandt Dismukes,IND,550022,0,0,49,49,
Oklahoma,Insurance Commissioner,Glen Mulready,REP,550022,0,0,466,466,
Oklahoma,Insurance Commissioner,Kimberly Fobbs,DEM,550022,0,0,186,186,
Oklahoma,Corporation Commissioner,Bob Anthony,REP,550022,0,0,461,461,
Oklahoma,Corporation Commissioner,Ashley Nicole Mccray,DEM,550022,0,0,156,156,
Oklahoma,Corporation Commissioner,Jackie Short,IND,550022,0,0,43,43,
Oklahoma,U.S. House,Tom Cole,REP,550022,0,0,485,485,4
Oklahoma,U.S. House,Mary Brannon,DEM,550022,0,0,153,153,4
Oklahoma,U.S. House,Ruby Peters,IND,550022,0,0,26,26,4
Oklahoma,State Senate,Brenda Stanley,REP,550022,0,0,476,476,42
Oklahoma,State Senate,Linda Wade,DEM,550022,0,0,147,147,42
Oklahoma,State Senate,Matt Campbell,IND,550022,0,0,37,37,42
Oklahoma,State House,Robert Manger,REP,550022,0,0,472,472,10
Oklahoma,State House,John Carpenter,DEM,550022,0,0,188,188,10
Oklahoma,Governor,Chris Powell,LIB,550023,0,0,36,36,
Oklahoma,Governor,Kevin Stitt,REP,550023,0,0,619,619,
Oklahoma,Governor,Drew Edmondson,DEM,550023,0,0,369,369,
Oklahoma,Lieutenant Governor,Matt Pinnell,REP,550023,0,0,708,708,
Oklahoma,Lieutenant Governor,Anastasia Pittman,DEM,550023,0,0,276,276,
Oklahoma,Lieutenant Governor,Ivan Holmes,IND,550023,0,0,32,32,
Oklahoma,State Auditor,John Yeutter,LIB,550023,0,0,187,187,
Oklahoma,State Auditor,Cindy Byrd,REP,550023,0,0,757,757,
Oklahoma,Attorney General,Mike Hunter,REP,550023,0,0,745,745,
Oklahoma,Attorney General,Mark Myles,DEM,550023,0,0,269,269,
Oklahoma,State Treasurer,Randy Mcdaniel,REP,550023,0,0,740,740,
Oklahoma,State Treasurer,Charles De Coune,IND,550023,0,0,208,208,
Oklahoma,Superintendent of Public Instruction,Joy Hofmeister,REP,550023,0,0,668,668,
Oklahoma,Superintendent of Public Instruction,John Cox,DEM,550023,0,0,253,253,
Oklahoma,Superintendent of Public Instruction,Larry Huff,IND,550023,0,0,93,93,
Oklahoma,Commissioner of Labor,Leslie Osborn,REP,550023,0,0,703,703,
Oklahoma,Commissioner of Labor,Fred Dorrell,DEM,550023,0,0,244,244,
Oklahoma,Commissioner of Labor,Brandt Dismukes,IND,550023,0,0,56,56,
Oklahoma,Insurance Commissioner,Glen Mulready,REP,550023,0,0,683,683,
Oklahoma,Insurance Commissioner,Kimberly Fobbs,DEM,550023,0,0,315,315,
Oklahoma,Corporation Commissioner,Bob Anthony,REP,550023,0,0,665,665,
Oklahoma,Corporation Commissioner,Ashley Nicole Mccray,DEM,550023,0,0,278,278,
Oklahoma,Corporation Commissioner,Jackie Short,IND,550023,0,0,62,62,
Oklahoma,U.S. House,Tom Cole,REP,550023,0,0,711,711,4
Oklahoma,U.S. House,Mary Brannon,DEM,550023,0,0,261,261,4
Oklahoma,U.S. House,Ruby Peters,IND,550023,0,0,39,39,4
Oklahoma,State House,Robert Manger,REP,550023,0,0,688,688,10
Oklahoma,State House,John Carpenter,DEM,550023,0,0,324,324,10
Oklahoma,Governor,Chris Powell,LIB,550024,0,0,1,1,
Oklahoma,Governor,Kevin Stitt,REP,550024,0,0,49,49,
Oklahoma,Governor,Drew Edmondson,DEM,550024,0,0,20,20,
Oklahoma,Lieutenant Governor,Matt Pinnell,REP,550024,0,0,55,55,
Oklahoma,Lieutenant Governor,Anastasia Pittman,DEM,550024,0,0,14,14,
Oklahoma,Lieutenant Governor,Ivan Holmes,IND,550024,0,0,1,1,
Oklahoma,State Auditor,John Yeutter,LIB,550024,0,0,5,5,
Oklahoma,State Auditor,Cindy Byrd,REP,550024,0,0,58,58,
Oklahoma,Attorney General,Mike Hunter,REP,550024,0,0,56,56,
Oklahoma,Attorney General,Mark Myles,DEM,550024,0,0,13,13,
Oklahoma,State Treasurer,Randy Mcdaniel,REP,550024,0,0,53,53,
Oklahoma,State Treasurer,Charles De Coune,IND,550024,0,0,11,11,
Oklahoma,Superintendent of Public Instruction,Joy Hofmeister,REP,550024,0,0,53,53,
Oklahoma,Superintendent of Public Instruction,John Cox,DEM,550024,0,0,15,15,
Oklahoma,Superintendent of Public Instruction,Larry Huff,IND,550024,0,0,2,2,
Oklahoma,Commissioner of Labor,Leslie Osborn,REP,550024,0,0,58,58,
Oklahoma,Commissioner of Labor,Fred Dorrell,DEM,550024,0,0,10,10,
Oklahoma,Commissioner of Labor,Brandt Dismukes,IND,550024,0,0,0,0,
Oklahoma,Insurance Commissioner,Glen Mulready,REP,550024,0,0,54,54,
Oklahoma,Insurance Commissioner,Kimberly Fobbs,DEM,550024,0,0,14,14,
Oklahoma,Corporation Commissioner,Bob Anthony,REP,550024,0,0,53,53,
Oklahoma,Corporation Commissioner,Ashley Nicole Mccray,DEM,550024,0,0,12,12,
Oklahoma,Corporation Commissioner,Jackie Short,IND,550024,0,0,2,2,
Oklahoma,U.S. House,Steve Russell,REP,550024,0,0,53,53,5
Oklahoma,U.S. House,Kendra Horn,DEM,550024,0,0,16,16,5
Oklahoma,State Senate,Willard Linzy,REP,550024,0,0,51,51,48
Oklahoma,State Senate,George Young,DEM,550024,0,0,16,16,48
Oklahoma,State House,Lewis Moore,REP,550024,0,0,47,47,96
Oklahoma,State House,Kathy Wallis,DEM,550024,0,0,22,22,96
Oklahoma,Governor,Chris Powell,LIB,550025,0,0,11,11,
Oklahoma,Governor,Kevin Stitt,REP,550025,0,0,128,128,
Oklahoma,Governor,Drew Edmondson,DEM,550025,0,0,138,138,
Oklahoma,Lieutenant Governor,Matt Pinnell,REP,550025,0,0,137,137,
Oklahoma,Lieutenant Governor,Anastasia Pittman,DEM,550025,0,0,134,134,
Oklahoma,Lieutenant Governor,Ivan Holmes,IND,550025,0,0,6,6,
Oklahoma,State Auditor,John Yeutter,LIB,550025,0,0,98,98,
Oklahoma,State Auditor,Cindy Byrd,REP,550025,0,0,146,146,
Oklahoma,Attorney General,Mike Hunter,REP,550025,0,0,140,140,
Oklahoma,Attorney General,Mark Myles,DEM,550025,0,0,135,135,
Oklahoma,State Treasurer,Randy Mcdaniel,REP,550025,0,0,148,148,
Oklahoma,State Treasurer,Charles De Coune,IND,550025,0,0,99,99,
Oklahoma,Superintendent of Public Instruction,Joy Hofmeister,REP,550025,0,0,131,131,
Oklahoma,Superintendent of Public Instruction,John Cox,DEM,550025,0,0,116,116,
Oklahoma,Superintendent of Public Instruction,Larry Huff,IND,550025,0,0,28,28,
Oklahoma,Commissioner of Labor,Leslie Osborn,REP,550025,0,0,132,132,
Oklahoma,Commissioner of Labor,Fred Dorrell,DEM,550025,0,0,120,120,
Oklahoma,Commissioner of Labor,Brandt Dismukes,IND,550025,0,0,22,22,
Oklahoma,Insurance Commissioner,Glen Mulready,REP,550025,0,0,132,132,
Oklahoma,Insurance Commissioner,Kimberly Fobbs,DEM,550025,0,0,141,141,
Oklahoma,Corporation Commissioner,Bob Anthony,REP,550025,0,0,132,132,
Oklahoma,Corporation Commissioner,Ashley Nicole Mccray,DEM,550025,0,0,120,120,
Oklahoma,Corporation Commissioner,Jackie Short,IND,550025,0,0,22,22,
Oklahoma,U.S. House,Steve Russell,REP,550025,0,0,133,133,5
Oklahoma,U.S. House,Kendra Horn,DEM,550025,0,0,142,142,5
Oklahoma,State Senate,Willard Linzy,REP,550025,0,0,135,135,48
Oklahoma,State Senate,George Young,DEM,550025,0,0,138,138,48
Oklahoma,Governor,Chris Powell,LIB,550026,0,0,29,29,
Oklahoma,Governor,Kevin Stitt,REP,550026,0,0,323,323,
Oklahoma,Governor,Drew Edmondson,DEM,550026,0,0,181,181,
Oklahoma,Lieutenant Governor,Matt Pinnell,REP,550026,0,0,368,368,
Oklahoma,Lieutenant Governor,Anastasia Pittman,DEM,550026,0,0,137,137,
Oklahoma,Lieutenant Governor,Ivan Holmes,IND,550026,0,0,23,23,
Oklahoma,State Auditor,John Yeutter,LIB,550026,0,0,101,101,
Oklahoma,State Auditor,Cindy Byrd,REP,550026,0,0,400,400,
Oklahoma,Attorney General,Mike Hunter,REP,550026,0,0,387,387,
Oklahoma,Attorney General,Mark Myles,DEM,550026,0,0,138,138,
Oklahoma,State Treasurer,Randy Mcdaniel,REP,550026,0,0,392,392,
Oklahoma,State Treasurer,Charles De Coune,IND,550026,0,0,107,107,
Oklahoma,Superintendent of Public Instruction,Joy Hofmeister,REP,550026,0,0,351,351,
Oklahoma,Superintendent of Public Instruction,John Cox,DEM,550026,0,0,113,113,
Oklahoma,Superintendent of Public Instruction,Larry Huff,IND,550026,0,0,60,60,
Oklahoma,Commissioner of Labor,Leslie Osborn,REP,550026,0,0,366,366,
Oklahoma,Commissioner of Labor,Fred Dorrell,DEM,550026,0,0,120,120,
Oklahoma,Commissioner of Labor,Brandt Dismukes,IND,550026,0,0,31,31,
Oklahoma,Insurance Commissioner,Glen Mulready,REP,550026,0,0,374,374,
Oklahoma,Insurance Commissioner,Kimberly Fobbs,DEM,550026,0,0,144,144,
Oklahoma,Corporation Commissioner,Bob Anthony,REP,550026,0,0,351,351,
Oklahoma,Corporation Commissioner,Ashley Nicole Mccray,DEM,550026,0,0,127,127,
Oklahoma,Corporation Commissioner,Jackie Short,IND,550026,0,0,45,45,
Oklahoma,U.S. House,Tom Cole,REP,550026,0,0,387,387,4
Oklahoma,U.S. House,Mary Brannon,DEM,550026,0,0,113,113,4
Oklahoma,U.S. House,Ruby Peters,IND,550026,0,0,28,28,4
Oklahoma,State House,Robert Manger,REP,550026,0,0,364,364,10
Oklahoma,State House,John Carpenter,DEM,550026,0,0,160,160,10
Oklahoma,Governor,Chris Powell,LIB,550027,0,0,1,1,
Oklahoma,Governor,Kevin Stitt,REP,550027,0,0,72,72,
Oklahoma,Governor,Drew Edmondson,DEM,550027,0,0,44,44,
Oklahoma,Lieutenant Governor,Matt Pinnell,REP,550027,0,0,77,77,
Oklahoma,Lieutenant Governor,Anastasia Pittman,DEM,550027,0,0,38,38,
Oklahoma,Lieutenant Governor,Ivan Holmes,IND,550027,0,0,2,2,
Oklahoma,State Auditor,John Yeutter,LIB,550027,0,0,22,22,
Oklahoma,State Auditor,Cindy Byrd,REP,550027,0,0,84,84,
Oklahoma,Attorney General,Mike Hunter,REP,550027,0,0,73,73,
Oklahoma,Attorney General,Mark Myles,DEM,550027,0,0,44,44,
Oklahoma,State Treasurer,Randy Mcdaniel,REP,550027,0,0,78,78,
Oklahoma,State Treasurer,Charles De Coune,IND,550027,0,0,29,29,
Oklahoma,Superintendent of Public Instruction,Joy Hofmeister,REP,550027,0,0,73,73,
Oklahoma,Superintendent of Public Instruction,John Cox,DEM,550027,0,0,34,34,
Oklahoma,Superintendent of Public Instruction,Larry Huff,IND,550027,0,0,10,10,
Oklahoma,Commissioner of Labor,Leslie Osborn,REP,550027,0,0,71,71,
Oklahoma,Commissioner of Labor,Fred Dorrell,DEM,550027,0,0,39,39,
Oklahoma,Commissioner of Labor,Brandt Dismukes,IND,550027,0,0,7,7,
Oklahoma,Insurance Commissioner,Glen Mulready,REP,550027,0,0,74,74,
Oklahoma,Insurance Commissioner,Kimberly Fobbs,DEM,550027,0,0,43,43,
Oklahoma,Corporation Commissioner,Bob Anthony,REP,550027,0,0,73,73,
Oklahoma,Corporation Commissioner,Ashley Nicole Mccray,DEM,550027,0,0,40,40,
Oklahoma,Corporation Commissioner,Jackie Short,IND,550027,0,0,4,4,
Oklahoma,U.S. House,Tom Cole,REP,550027,0,0,72,72,4
Oklahoma,U.S. House,Mary Brannon,DEM,550027,0,0,42,42,4
Oklahoma,U.S. House,Ruby Peters,IND,550027,0,0,3,3,4
Oklahoma,State Senate,Willard Linzy,REP,550027,0,0,70,70,48
Oklahoma,State Senate,George Young,DEM,550027,0,0,47,47,48
Oklahoma,State House,Robert Manger,REP,550027,0,0,72,72,10
Oklahoma,State House,John Carpenter,DEM,550027,0,0,45,45,10
Oklahoma,Governor,Chris Powell,LIB,550028,0,0,40,40,
Oklahoma,Governor,Kevin Stitt,REP,550028,0,0,230,230,
Oklahoma,Governor,Drew Edmondson,DEM,550028,0,0,447,447,
Oklahoma,Lieutenant Governor,Matt Pinnell,REP,550028,0,0,251,251,
Oklahoma,Lieutenant Governor,Anastasia Pittman,DEM,550028,0,0,435,435,
Oklahoma,Lieutenant Governor,Ivan Holmes,IND,550028,0,0,28,28,
Oklahoma,State Auditor,John Yeutter,LIB,550028,0,0,279,279,
Oklahoma,State Auditor,Cindy Byrd,REP,550028,0,0,340,340,
Oklahoma,Attorney General,Mike Hunter,REP,550028,0,0,271,271,
Oklahoma,Attorney General,Mark Myles,DEM,550028,0,0,437,437,
Oklahoma,State Treasurer,Randy Mcdaniel,REP,550028,0,0,289,289,
Oklahoma,State Treasurer,Charles De Coune,IND,550028,0,0,331,331,
Oklahoma,Superintendent of Public Instruction,Joy Hofmeister,REP,550028,0,0,271,271,
Oklahoma,Superintendent of Public Instruction,John Cox,DEM,550028,0,0,372,372,
Oklahoma,Superintendent of Public Instruction,Larry Huff,IND,550028,0,0,60,60,
Oklahoma,Commissioner of Labor,Leslie Osborn,REP,550028,0,0,261,261,
Oklahoma,Commissioner of Labor,Fred Dorrell,DEM,550028,0,0,390,390,
Oklahoma,Commissioner of Labor,Brandt Dismukes,IND,550028,0,0,45,45,
Oklahoma,Insurance Commissioner,Glen Mulready,REP,550028,0,0,258,258,
Oklahoma,Insurance Commissioner,Kimberly Fobbs,DEM,550028,0,0,439,439,
Oklahoma,Corporation Commissioner,Bob Anthony,REP,550028,0,0,251,251,
Oklahoma,Corporation Commissioner,Ashley Nicole Mccray,DEM,550028,0,0,395,395,
Oklahoma,Corporation Commissioner,Jackie Short,IND,550028,0,0,59,59,
Oklahoma,U.S. House,Steve Russell,REP,550028,0,0,263,263,5
Oklahoma,U.S. House,Kendra Horn,DEM,550028,0,0,448,448,5
Oklahoma,State Senate,Brenda Stanley,REP,550028,0,0,234,234,42
Oklahoma,State Senate,Linda Wade,DEM,550028,0,0,425,425,42
Oklahoma,State Senate,Matt Campbell,IND,550028,0,0,42,42,42
Oklahoma,State House,Jason Sansone,REP,550028,0,0,238,238,94
Oklahoma,State House,Andy Fugate,DEM,550028,0,0,469,469,94
Oklahoma,Governor,Chris Powell,LIB,550029,0,0,60,60,
Oklahoma,Governor,Kevin Stitt,REP,550029,0,0,432,432,
Oklahoma,Governor,Drew Edmondson,DEM,550029,0,0,443,443,
Oklahoma,Lieutenant Governor,Matt Pinnell,REP,550029,0,0,475,475,
Oklahoma,Lieutenant Governor,Anastasia Pittman,DEM,550029,0,0,403,403,
Oklahoma,Lieutenant Governor,Ivan Holmes,IND,550029,0,0,54,54,
Oklahoma,State Auditor,John Yeutter,LIB,550029,0,0,300,300,
Oklahoma,State Auditor,Cindy Byrd,REP,550029,0,0,546,546,
Oklahoma,Attorney General,Mike Hunter,REP,550029,0,0,522,522,
Oklahoma,Attorney General,Mark Myles,DEM,550029,0,0,399,399,
Oklahoma,State Treasurer,Randy Mcdaniel,REP,550029,0,0,520,520,
Oklahoma,State Treasurer,Charles De Coune,IND,550029,0,0,324,324,
Oklahoma,Superintendent of Public Instruction,Joy Hofmeister,REP,550029,0,0,465,465,
Oklahoma,Superintendent of Public Instruction,John Cox,DEM,550029,0,0,349,349,
Oklahoma,Superintendent of Public Instruction,Larry Huff,IND,550029,0,0,109,109,
Oklahoma,Commissioner of Labor,Leslie Osborn,REP,550029,0,0,473,473,
Oklahoma,Commissioner of Labor,Fred Dorrell,DEM,550029,0,0,357,357,
Oklahoma,Commissioner of Labor,Brandt Dismukes,IND,550029,0,0,86,86,
Oklahoma,Insurance Commissioner,Glen Mulready,REP,550029,0,0,486,486,
Oklahoma,Insurance Commissioner,Kimberly Fobbs,DEM,550029,0,0,424,424,
Oklahoma,Corporation Commissioner,Bob Anthony,REP,550029,0,0,454,454,
Oklahoma,Corporation Commissioner,Ashley Nicole Mccray,DEM,550029,0,0,372,372,
Oklahoma,Corporation Commissioner,Jackie Short,IND,550029,0,0,93,93,
Oklahoma,U.S. House,Steve Russell,REP,550029,0,0,479,479,5
Oklahoma,U.S. House,Kendra Horn,DEM,550029,0,0,447,447,5
Oklahoma,State Senate,Brenda Stanley,REP,550029,0,0,444,444,42
Oklahoma,State Senate,Linda Wade,DEM,550029,0,0,388,388,42
Oklahoma,State Senate,Matt Campbell,IND,550029,0,0,86,86,42
Oklahoma,State House,Jason Sansone,REP,550029,0,0,458,458,94
Oklahoma,State House,Andy Fugate,DEM,550029,0,0,467,467,94
Oklahoma,Governor,Chris Powell,LIB,550030,0,0,46,46,
Oklahoma,Governor,Kevin Stitt,REP,550030,0,0,325,325,
Oklahoma,Governor,Drew Edmondson,DEM,550030,0,0,399,399,
Oklahoma,Lieutenant Governor,Matt Pinnell,REP,550030,0,0,355,355,
Oklahoma,Lieutenant Governor,Anastasia Pittman,DEM,550030,0,0,376,376,
Oklahoma,Lieutenant Governor,Ivan Holmes,IND,550030,0,0,35,35,
Oklahoma,State Auditor,John Yeutter,LIB,550030,0,0,262,262,
Oklahoma,State Auditor,Cindy Byrd,REP,550030,0,0,422,422,
Oklahoma,Attorney General,Mike Hunter,REP,550030,0,0,391,391,
Oklahoma,Attorney General,Mark Myles,DEM,550030,0,0,372,372,
Oklahoma,State Treasurer,Randy Mcdaniel,REP,550030,0,0,387,387,
Oklahoma,State Treasurer,Charles De Coune,IND,550030,0,0,300,300,
Oklahoma,Superintendent of Public Instruction,Joy Hofmeister,REP,550030,0,0,337,337,
Oklahoma,Superintendent of Public Instruction,John Cox,DEM,550030,0,0,334,334,
Oklahoma,Superintendent of Public Instruction,Larry Huff,IND,550030,0,0,89,89,
Oklahoma,Commissioner of Labor,Leslie Osborn,REP,550030,0,0,368,368,
Oklahoma,Commissioner of Labor,Fred Dorrell,DEM,550030,0,0,334,334,
Oklahoma,Commissioner of Labor,Brandt Dismukes,IND,550030,0,0,57,57,
Oklahoma,Insurance Commissioner,Glen Mulready,REP,550030,0,0,357,357,
Oklahoma,Insurance Commissioner,Kimberly Fobbs,DEM,550030,0,0,403,403,
Oklahoma,Corporation Commissioner,Bob Anthony,REP,550030,0,0,343,343,
Oklahoma,Corporation Commissioner,Ashley Nicole Mccray,DEM,550030,0,0,357,357,
Oklahoma,Corporation Commissioner,Jackie Short,IND,550030,0,0,62,62,
Oklahoma,U.S. House,Steve Russell,REP,550030,0,0,369,369,5
Oklahoma,U.S. House,Kendra Horn,DEM,550030,0,0,394,394,5
Oklahoma,State Senate,Brenda Stanley,REP,550030,0,0,328,328,42
Oklahoma,State Senate,Linda Wade,DEM,550030,0,0,370,370,42
Oklahoma,State Senate,Matt Campbell,IND,550030,0,0,61,61,42
Oklahoma,State House,Jason Sansone,REP,550030,0,0,334,334,94
Oklahoma,State House,Andy Fugate,DEM,550030,0,0,427,427,94
Oklahoma,Governor,Chris Powell,LIB,550031,0,0,59,59,
Oklahoma,Governor,Kevin Stitt,REP,550031,0,0,398,398,
Oklahoma,Governor,Drew Edmondson,DEM,550031,0,0,433,433,
Oklahoma,Lieutenant Governor,Matt Pinnell,REP,550031,0,0,440,440,
Oklahoma,Lieutenant Governor,Anastasia Pittman,DEM,550031,0,0,384,384,
Oklahoma,Lieutenant Governor,Ivan Holmes,IND,550031,0,0,57,57,
Oklahoma,State Auditor,John Yeutter,LIB,550031,0,0,270,270,
Oklahoma,State Auditor,Cindy Byrd,REP,550031,0,0,544,544,
Oklahoma,Attorney General,Mike Hunter,REP,550031,0,0,495,495,
Oklahoma,Attorney General,Mark Myles,DEM,550031,0,0,378,378,
Oklahoma,State Treasurer,Randy Mcdaniel,REP,550031,0,0,510,510,
Oklahoma,State Treasurer,Charles De Coune,IND,550031,0,0,301,301,
Oklahoma,Superintendent of Public Instruction,Joy Hofmeister,REP,550031,0,0,438,438,
Oklahoma,Superintendent of Public Instruction,John Cox,DEM,550031,0,0,324,324,
Oklahoma,Superintendent of Public Instruction,Larry Huff,IND,550031,0,0,111,111,
Oklahoma,Commissioner of Labor,Leslie Osborn,REP,550031,0,0,453,453,
Oklahoma,Commissioner of Labor,Fred Dorrell,DEM,550031,0,0,336,336,
Oklahoma,Commissioner of Labor,Brandt Dismukes,IND,550031,0,0,72,72,
Oklahoma,Insurance Commissioner,Glen Mulready,REP,550031,0,0,462,462,
Oklahoma,Insurance Commissioner,Kimberly Fobbs,DEM,550031,0,0,397,397,
Oklahoma,Corporation Commissioner,Bob Anthony,REP,550031,0,0,459,459,
Oklahoma,Corporation Commissioner,Ashley Nicole Mccray,DEM,550031,0,0,337,337,
Oklahoma,Corporation Commissioner,Jackie Short,IND,550031,0,0,79,79,
Oklahoma,U.S. House,Steve Russell,REP,550031,0,0,468,468,5
Oklahoma,U.S. House,Kendra Horn,DEM,550031,0,0,417,417,5
Oklahoma,State Senate,Brenda Stanley,REP,550031,0,0,444,444,42
Oklahoma,State Senate,Linda Wade,DEM,550031,0,0,350,350,42
Oklahoma,State Senate,Matt Campbell,IND,550031,0,0,76,76,42
Oklahoma,State House,Jason Sansone,REP,550031,0,0,410,410,94
Oklahoma,State House,Andy Fugate,DEM,550031,0,0,463,463,94
Oklahoma,Governor,Chris Powell,LIB,550032,0,0,29,29,
Oklahoma,Governor,Kevin Stitt,REP,550032,0,0,314,314,
Oklahoma,Governor,Drew Edmondson,DEM,550032,0,0,271,271,
Oklahoma,Lieutenant Governor,Matt Pinnell,REP,550032,0,0,361,361,
Oklahoma,Lieutenant Governor,Anastasia Pittman,DEM,550032,0,0,216,216,
Oklahoma,Lieutenant Governor,Ivan Holmes,IND,550032,0,0,30,30,
Oklahoma,State Auditor,John Yeutter,LIB,550032,0,0,156,156,
Oklahoma,State Auditor,Cindy Byrd,REP,550032,0,0,405,405,
Oklahoma,Attorney General,Mike Hunter,REP,550032,0,0,377,377,
Oklahoma,Attorney General,Mark Myles,DEM,550032,0,0,224,224,
Oklahoma,State Treasurer,Randy Mcdaniel,REP,550032,0,0,390,390,
Oklahoma,State Treasurer,Charles De Coune,IND,550032,0,0,168,168,
Oklahoma,Superintendent of Public Instruction,Joy Hofmeister,REP,550032,0,0,349,349,
Oklahoma,Superintendent of Public Instruction,John Cox,DEM,550032,0,0,191,191,
Oklahoma,Superintendent of Public Instruction,Larry Huff,IND,550032,0,0,66,66,
Oklahoma,Commissioner of Labor,Leslie Osborn,REP,550032,0,0,349,349,
Oklahoma,Commissioner of Labor,Fred Dorrell,DEM,550032,0,0,211,211,
Oklahoma,Commissioner of Labor,Brandt Dismukes,IND,550032,0,0,35,35,
Oklahoma,Insurance Commissioner,Glen Mulready,REP,550032,0,0,357,357,
Oklahoma,Insurance Commissioner,Kimberly Fobbs,DEM,550032,0,0,233,233,
Oklahoma,Corporation Commissioner,Bob Anthony,REP,550032,0,0,350,350,
Oklahoma,Corporation Commissioner,Ashley Nicole Mccray,DEM,550032,0,0,204,204,
Oklahoma,Corporation Commissioner,Jackie Short,IND,550032,0,0,43,43,
Oklahoma,U.S. House,Steve Russell,REP,550032,0,0,371,371,5
Oklahoma,U.S. House,Kendra Horn,DEM,550032,0,0,236,236,5
Oklahoma,State Senate,Brenda Stanley,REP,550032,0,0,336,336,42
Oklahoma,State Senate,Linda Wade,DEM,550032,0,0,217,217,42
Oklahoma,State Senate,Matt Campbell,IND,550032,0,0,46,46,42
Oklahoma,State House,Jason Sansone,REP,550032,0,0,298,298,94
Oklahoma,State House,Andy Fugate,DEM,550032,0,0,304,304,94
Oklahoma,Governor,Chris Powell,LIB,550033,0,0,50,50,
Oklahoma,Governor,Kevin Stitt,REP,550033,0,0,543,543,
Oklahoma,Governor,Drew Edmondson,DEM,550033,0,0,649,649,
Oklahoma,Lieutenant Governor,Matt Pinnell,REP,550033,0,0,617,617,
Oklahoma,Lieutenant Governor,Anastasia Pittman,DEM,550033,0,0,552,552,
Oklahoma,Lieutenant Governor,Ivan Holmes,IND,550033,0,0,66,66,
Oklahoma,State Auditor,John Yeutter,LIB,550033,0,0,393,393,
Oklahoma,State Auditor,Cindy Byrd,REP,550033,0,0,734,734,
Oklahoma,Attorney General,Mike Hunter,REP,550033,0,0,666,666,
Oklahoma,Attorney General,Mark Myles,DEM,550033,0,0,571,571,
Oklahoma,State Treasurer,Randy Mcdaniel,REP,550033,0,0,674,674,
Oklahoma,State Treasurer,Charles De Coune,IND,550033,0,0,450,450,
Oklahoma,Superintendent of Public Instruction,Joy Hofmeister,REP,550033,0,0,599,599,
Oklahoma,Superintendent of Public Instruction,John Cox,DEM,550033,0,0,531,531,
Oklahoma,Superintendent of Public Instruction,Larry Huff,IND,550033,0,0,108,108,
Oklahoma,Commissioner of Labor,Leslie Osborn,REP,550033,0,0,625,625,
Oklahoma,Commissioner of Labor,Fred Dorrell,DEM,550033,0,0,516,516,
Oklahoma,Commissioner of Labor,Brandt Dismukes,IND,550033,0,0,76,76,
Oklahoma,Insurance Commissioner,Glen Mulready,REP,550033,0,0,621,621,
Oklahoma,Insurance Commissioner,Kimberly Fobbs,DEM,550033,0,0,600,600,
Oklahoma,Corporation Commissioner,Bob Anthony,REP,550033,0,0,613,613,
Oklahoma,Corporation Commissioner,Ashley Nicole Mccray,DEM,550033,0,0,517,517,
Oklahoma,Corporation Commissioner,Jackie Short,IND,550033,0,0,100,100,
Oklahoma,U.S. House,Steve Russell,REP,550033,0,0,628,628,5
Oklahoma,U.S. House,Kendra Horn,DEM,550033,0,0,609,609,5
Oklahoma,State Senate,Brenda Stanley,REP,550033,0,0,587,587,42
Oklahoma,State Senate,Linda Wade,DEM,550033,0,0,569,569,42
Oklahoma,State Senate,Matt Campbell,IND,550033,0,0,69,69,42
Oklahoma,State House,Jason Sansone,REP,550033,0,0,514,514,94
Oklahoma,State House,Andy Fugate,DEM,550033,0,0,717,717,94
Oklahoma,Governor,Chris Powell,LIB,550034,0,0,29,29,
Oklahoma,Governor,Kevin Stitt,REP,550034,0,0,523,523,
Oklahoma,Governor,Drew Edmondson,DEM,550034,0,0,257,257,
Oklahoma,Lieutenant Governor,Matt Pinnell,REP,550034,0,0,612,612,
Oklahoma,Lieutenant Governor,Anastasia Pittman,DEM,550034,0,0,158,158,
Oklahoma,Lieutenant Governor,Ivan Holmes,IND,550034,0,0,30,30,
Oklahoma,State Auditor,John Yeutter,LIB,550034,0,0,120,120,
Oklahoma,State Auditor,Cindy Byrd,REP,550034,0,0,652,652,
Oklahoma,Attorney General,Mike Hunter,REP,550034,0,0,632,632,
Oklahoma,Attorney General,Mark Myles,DEM,550034,0,0,171,171,
Oklahoma,State Treasurer,Randy Mcdaniel,REP,550034,0,0,624,624,
Oklahoma,State Treasurer,Charles De Coune,IND,550034,0,0,145,145,
Oklahoma,Superintendent of Public Instruction,Joy Hofmeister,REP,550034,0,0,588,588,
Oklahoma,Superintendent of Public Instruction,John Cox,DEM,550034,0,0,149,149,
Oklahoma,Superintendent of Public Instruction,Larry Huff,IND,550034,0,0,57,57,
Oklahoma,Commissioner of Labor,Leslie Osborn,REP,550034,0,0,608,608,
Oklahoma,Commissioner of Labor,Fred Dorrell,DEM,550034,0,0,137,137,
Oklahoma,Commissioner of Labor,Brandt Dismukes,IND,550034,0,0,40,40,
Oklahoma,Insurance Commissioner,Glen Mulready,REP,550034,0,0,596,596,
Oklahoma,Insurance Commissioner,Kimberly Fobbs,DEM,550034,0,0,189,189,
Oklahoma,Corporation Commissioner,Bob Anthony,REP,550034,0,0,583,583,
Oklahoma,Corporation Commissioner,Ashley Nicole Mccray,DEM,550034,0,0,158,158,
Oklahoma,Corporation Commissioner,Jackie Short,IND,550034,0,0,54,54,
Oklahoma,U.S. House,Steve Russell,REP,550034,0,0,582,582,5
Oklahoma,U.S. House,Kendra Horn,DEM,550034,0,0,220,220,5
Oklahoma,State Senate,Stephanie Bice,REP,550034,0,0,635,635,22
Oklahoma,State Senate,William Andrews,DEM,550034,0,0,156,156,22
Oklahoma,State House,Garry Mize,REP,550034,0,0,602,602,31
Oklahoma,State House,Kara Sawyer,DEM,550034,0,0,185,185,31
Oklahoma,Governor,Chris Powell,LIB,550035,0,0,48,48,
Oklahoma,Governor,Kevin Stitt,REP,550035,0,0,881,881,
Oklahoma,Governor,Drew Edmondson,DEM,550035,0,0,794,794,
Oklahoma,Lieutenant Governor,Matt Pinnell,REP,550035,0,0,1040,1040,
Oklahoma,Lieutenant Governor,Anastasia Pittman,DEM,550035,0,0,612,612,
Oklahoma,Lieutenant Governor,Ivan Holmes,IND,550035,0,0,61,61,
Oklahoma,State Auditor,John Yeutter,LIB,550035,0,0,405,405,
Oklahoma,State Auditor,Cindy Byrd,REP,550035,0,0,1188,1188,
Oklahoma,Attorney General,Mike Hunter,REP,550035,0,0,1087,1087,
Oklahoma,Attorney General,Mark Myles,DEM,550035,0,0,605,605,
Oklahoma,State Treasurer,Randy Mcdaniel,REP,550035,0,0,1103,1103,
Oklahoma,State Treasurer,Charles De Coune,IND,550035,0,0,487,487,
Oklahoma,Superintendent of Public Instruction,Joy Hofmeister,REP,550035,0,0,1012,1012,
Oklahoma,Superintendent of Public Instruction,John Cox,DEM,550035,0,0,558,558,
Oklahoma,Superintendent of Public Instruction,Larry Huff,IND,550035,0,0,132,132,
Oklahoma,Commissioner of Labor,Leslie Osborn,REP,550035,0,0,1072,1072,
Oklahoma,Commissioner of Labor,Fred Dorrell,DEM,550035,0,0,529,529,
Oklahoma,Commissioner of Labor,Brandt Dismukes,IND,550035,0,0,82,82,
Oklahoma,Insurance Commissioner,Glen Mulready,REP,550035,0,0,1057,1057,
Oklahoma,Insurance Commissioner,Kimberly Fobbs,DEM,550035,0,0,622,622,
Oklahoma,Corporation Commissioner,Bob Anthony,REP,550035,0,0,994,994,
Oklahoma,Corporation Commissioner,Ashley Nicole Mccray,DEM,550035,0,0,608,608,
Oklahoma,Corporation Commissioner,Jackie Short,IND,550035,0,0,90,90,
Oklahoma,U.S. House,Steve Russell,REP,550035,0,0,1006,1006,5
Oklahoma,U.S. House,Kendra Horn,DEM,550035,0,0,699,699,5
Oklahoma,State Senate,Stephanie Bice,REP,550035,0,0,1129,1129,22
Oklahoma,State Senate,William Andrews,DEM,550035,0,0,572,572,22
Oklahoma,State House,Nicole Miller,REP,550035,0,0,1176,1176,82
Oklahoma,State House,Oraynab Jwayyed,DEM,550035,0,0,525,525,82
Oklahoma,Governor,Chris Powell,LIB,550036,0,0,18,18,
Oklahoma,Governor,Kevin Stitt,REP,550036,0,0,603,603,
Oklahoma,Governor,Drew Edmondson,DEM,550036,0,0,432,432,
Oklahoma,Lieutenant Governor,Matt Pinnell,REP,550036,0,0,723,723,
Oklahoma,Lieutenant Governor,Anastasia Pittman,DEM,550036,0,0,294,294,
Oklahoma,Lieutenant Governor,Ivan Holmes,IND,550036,0,0,27,27,
Oklahoma,State Auditor,John Yeutter,LIB,550036,0,0,172,172,
Oklahoma,State Auditor,Cindy Byrd,REP,550036,0,0,794,794,
Oklahoma,Attorney General,Mike Hunter,REP,550036,0,0,765,765,
Oklahoma,Attorney General,Mark Myles,DEM,550036,0,0,267,267,
Oklahoma,State Treasurer,Randy Mcdaniel,REP,550036,0,0,747,747,
Oklahoma,State Treasurer,Charles De Coune,IND,550036,0,0,234,234,
Oklahoma,Superintendent of Public Instruction,Joy Hofmeister,REP,550036,0,0,682,682,
Oklahoma,Superintendent of Public Instruction,John Cox,DEM,550036,0,0,282,282,
Oklahoma,Superintendent of Public Instruction,Larry Huff,IND,550036,0,0,66,66,
Oklahoma,Commissioner of Labor,Leslie Osborn,REP,550036,0,0,732,732,
Oklahoma,Commissioner of Labor,Fred Dorrell,DEM,550036,0,0,246,246,
Oklahoma,Commissioner of Labor,Brandt Dismukes,IND,550036,0,0,37,37,
Oklahoma,Insurance Commissioner,Glen Mulready,REP,550036,0,0,717,717,
Oklahoma,Insurance Commissioner,Kimberly Fobbs,DEM,550036,0,0,299,299,
Oklahoma,Corporation Commissioner,Bob Anthony,REP,550036,0,0,703,703,
Oklahoma,Corporation Commissioner,Ashley Nicole Mccray,DEM,550036,0,0,257,257,
Oklahoma,Corporation Commissioner,Jackie Short,IND,550036,0,0,61,61,
Oklahoma,U.S. House,Steve Russell,REP,550036,0,0,701,701,5
Oklahoma,U.S. House,Kendra Horn,DEM,550036,0,0,338,338,5
Oklahoma,State Senate,Stephanie Bice,REP,550036,0,0,746,746,22
Oklahoma,State Senate,William Andrews,DEM,550036,0,0,276,276,22
Oklahoma,State House,Ryan Martinez,REP,550036,0,0,712,712,39
Oklahoma,State House,Devyn Denton,DEM,550036,0,0,271,271,39
Oklahoma,State House,Richard Prawdzienski,IND,550036,0,0,34,34,39
Oklahoma,Governor,Chris Powell,LIB,550037,0,0,21,21,
Oklahoma,Governor,Kevin Stitt,REP,550037,0,0,476,476,
Oklahoma,Governor,Drew Edmondson,DEM,550037,0,0,412,412,
Oklahoma,Lieutenant Governor,Matt Pinnell,REP,550037,0,0,562,562,
Oklahoma,Lieutenant Governor,Anastasia Pittman,DEM,550037,0,0,314,314,
Oklahoma,Lieutenant Governor,Ivan Holmes,IND,550037,0,0,27,27,
Oklahoma,State Auditor,John Yeutter,LIB,550037,0,0,177,177,
Oklahoma,State Auditor,Cindy Byrd,REP,550037,0,0,655,655,
Oklahoma,Attorney General,Mike Hunter,REP,550037,0,0,591,591,
Oklahoma,Attorney General,Mark Myles,DEM,550037,0,0,302,302,
Oklahoma,State Treasurer,Randy Mcdaniel,REP,550037,0,0,601,601,
Oklahoma,State Treasurer,Charles De Coune,IND,550037,0,0,237,237,
Oklahoma,Superintendent of Public Instruction,Joy Hofmeister,REP,550037,0,0,562,562,
Oklahoma,Superintendent of Public Instruction,John Cox,DEM,550037,0,0,272,272,
Oklahoma,Superintendent of Public Instruction,Larry Huff,IND,550037,0,0,66,66,
Oklahoma,Commissioner of Labor,Leslie Osborn,REP,550037,0,0,573,573,
Oklahoma,Commissioner of Labor,Fred Dorrell,DEM,550037,0,0,281,281,
Oklahoma,Commissioner of Labor,Brandt Dismukes,IND,550037,0,0,29,29,
Oklahoma,Insurance Commissioner,Glen Mulready,REP,550037,0,0,566,566,
Oklahoma,Insurance Commissioner,Kimberly Fobbs,DEM,550037,0,0,320,320,
Oklahoma,Corporation Commissioner,Bob Anthony,REP,550037,0,0,558,558,
Oklahoma,Corporation Commissioner,Ashley Nicole Mccray,DEM,550037,0,0,282,282,
Oklahoma,Corporation Commissioner,Jackie Short,IND,550037,0,0,48,48,
Oklahoma,U.S. House,Steve Russell,REP,550037,0,0,531,531,5
Oklahoma,U.S. House,Kendra Horn,DEM,550037,0,0,373,373,5
Oklahoma,State Senate,Stephanie Bice,REP,550037,0,0,602,602,22
Oklahoma,State Senate,William Andrews,DEM,550037,0,0,292,292,22
Oklahoma,State House,Ryan Martinez,REP,550037,0,0,557,557,39
Oklahoma,State House,Devyn Denton,DEM,550037,0,0,299,299,39
Oklahoma,State House,Richard Prawdzienski,IND,550037,0,0,32,32,39
Oklahoma,Governor,Chris Powell,LIB,550038,0,0,30,30,
Oklahoma,Governor,Kevin Stitt,REP,550038,0,0,349,349,
Oklahoma,Governor,Drew Edmondson,DEM,550038,0,0,413,413,
Oklahoma,Lieutenant Governor,Matt Pinnell,REP,550038,0,0,431,431,
Oklahoma,Lieutenant Governor,Anastasia Pittman,DEM,550038,0,0,326,326,
Oklahoma,Lieutenant Governor,Ivan Holmes,IND,550038,0,0,33,33,
Oklahoma,State Auditor,John Yeutter,LIB,550038,0,0,211,211,
Oklahoma,State Auditor,Cindy Byrd,REP,550038,0,0,499,499,
Oklahoma,Attorney General,Mike Hunter,REP,550038,0,0,451,451,
Oklahoma,Attorney General,Mark Myles,DEM,550038,0,0,330,330,
Oklahoma,State Treasurer,Randy Mcdaniel,REP,550038,0,0,473,473,
Oklahoma,State Treasurer,Charles De Coune,IND,550038,0,0,242,242,
Oklahoma,Superintendent of Public Instruction,Joy Hofmeister,REP,550038,0,0,419,419,
Oklahoma,Superintendent of Public Instruction,John Cox,DEM,550038,0,0,284,284,
Oklahoma,Superintendent of Public Instruction,Larry Huff,IND,550038,0,0,80,80,
Oklahoma,Commissioner of Labor,Leslie Osborn,REP,550038,0,0,429,429,
Oklahoma,Commissioner of Labor,Fred Dorrell,DEM,550038,0,0,289,289,
Oklahoma,Commissioner of Labor,Brandt Dismukes,IND,550038,0,0,53,53,
Oklahoma,Insurance Commissioner,Glen Mulready,REP,550038,0,0,434,434,
Oklahoma,Insurance Commissioner,Kimberly Fobbs,DEM,550038,0,0,336,336,
Oklahoma,Corporation Commissioner,Bob Anthony,REP,550038,0,0,410,410,
Oklahoma,Corporation Commissioner,Ashley Nicole Mccray,DEM,550038,0,0,307,307,
Oklahoma,Corporation Commissioner,Jackie Short,IND,550038,0,0,61,61,
Oklahoma,U.S. House,Steve Russell,REP,550038,0,0,414,414,5
Oklahoma,U.S. House,Kendra Horn,DEM,550038,0,0,372,372,5
Oklahoma,State Senate,Stephanie Bice,REP,550038,0,0,461,461,22
Oklahoma,State Senate,William Andrews,DEM,550038,0,0,314,314,22
Oklahoma,State House,Ryan Martinez,REP,550038,0,0,427,427,39
Oklahoma,State House,Devyn Denton,DEM,550038,0,0,310,310,39
Oklahoma,State House,Richard Prawdzienski,IND,550038,0,0,43,43,39
Oklahoma,Governor,Chris Powell,LIB,550039,0,0,39,39,
Oklahoma,Governor,Kevin Stitt,REP,550039,0,0,487,487,
Oklahoma,Governor,Drew Edmondson,DEM,550039,0,0,535,535,
Oklahoma,Lieutenant Governor,Matt Pinnell,REP,550039,0,0,599,599,
Oklahoma,Lieutenant Governor,Anastasia Pittman,DEM,550039,0,0,410,410,
Oklahoma,Lieutenant Governor,Ivan Holmes,IND,550039,0,0,40,40,
Oklahoma,State Auditor,John Yeutter,LIB,550039,0,0,303,303,
Oklahoma,State Auditor,Cindy Byrd,REP,550039,0,0,664,664,
Oklahoma,Attorney General,Mike Hunter,REP,550039,0,0,598,598,
Oklahoma,Attorney General,Mark Myles,DEM,550039,0,0,442,442,
Oklahoma,State Treasurer,Randy Mcdaniel,REP,550039,0,0,625,625,
Oklahoma,State Treasurer,Charles De Coune,IND,550039,0,0,349,349,
Oklahoma,Superintendent of Public Instruction,Joy Hofmeister,REP,550039,0,0,606,606,
Oklahoma,Superintendent of Public Instruction,John Cox,DEM,550039,0,0,351,351,
Oklahoma,Superintendent of Public Instruction,Larry Huff,IND,550039,0,0,81,81,
Oklahoma,Commissioner of Labor,Leslie Osborn,REP,550039,0,0,611,611,
Oklahoma,Commissioner of Labor,Fred Dorrell,DEM,550039,0,0,364,364,
Oklahoma,Commissioner of Labor,Brandt Dismukes,IND,550039,0,0,49,49,
Oklahoma,Insurance Commissioner,Glen Mulready,REP,550039,0,0,581,581,
Oklahoma,Insurance Commissioner,Kimberly Fobbs,DEM,550039,0,0,447,447,
Oklahoma,Corporation Commissioner,Bob Anthony,REP,550039,0,0,560,560,
Oklahoma,Corporation Commissioner,Ashley Nicole Mccray,DEM,550039,0,0,414,414,
Oklahoma,Corporation Commissioner,Jackie Short,IND,550039,0,0,59,59,
Oklahoma,U.S. House,Steve Russell,REP,550039,0,0,566,566,5
Oklahoma,U.S. House,Kendra Horn,DEM,550039,0,0,484,484,5
Oklahoma,State House,Jason Reese,REP,550039,0,0,553,553,83
Oklahoma,State House,Chelsey Branham,DEM,550039,0,0,491,491,83
Oklahoma,Governor,Chris Powell,LIB,550040,0,0,40,40,
Oklahoma,Governor,Kevin Stitt,REP,550040,0,0,559,559,
Oklahoma,Governor,Drew Edmondson,DEM,550040,0,0,601,601,
Oklahoma,Lieutenant Governor,Matt Pinnell,REP,550040,0,0,670,670,
Oklahoma,Lieutenant Governor,Anastasia Pittman,DEM,550040,0,0,471,471,
Oklahoma,Lieutenant Governor,Ivan Holmes,IND,550040,0,0,48,48,
Oklahoma,State Auditor,John Yeutter,LIB,550040,0,0,292,292,
Oklahoma,State Auditor,Cindy Byrd,REP,550040,0,0,813,813,
Oklahoma,Attorney General,Mike Hunter,REP,550040,0,0,711,711,
Oklahoma,Attorney General,Mark Myles,DEM,550040,0,0,472,472,
Oklahoma,State Treasurer,Randy Mcdaniel,REP,550040,0,0,725,725,
Oklahoma,State Treasurer,Charles De Coune,IND,550040,0,0,382,382,
Oklahoma,Superintendent of Public Instruction,Joy Hofmeister,REP,550040,0,0,653,653,
Oklahoma,Superintendent of Public Instruction,John Cox,DEM,550040,0,0,425,425,
Oklahoma,Superintendent of Public Instruction,Larry Huff,IND,550040,0,0,106,106,
Oklahoma,Commissioner of Labor,Leslie Osborn,REP,550040,0,0,695,695,
Oklahoma,Commissioner of Labor,Fred Dorrell,DEM,550040,0,0,411,411,
Oklahoma,Commissioner of Labor,Brandt Dismukes,IND,550040,0,0,61,61,
Oklahoma,Insurance Commissioner,Glen Mulready,REP,550040,0,0,686,686,
Oklahoma,Insurance Commissioner,Kimberly Fobbs,DEM,550040,0,0,480,480,
Oklahoma,Corporation Commissioner,Bob Anthony,REP,550040,0,0,647,647,
Oklahoma,Corporation Commissioner,Ashley Nicole Mccray,DEM,550040,0,0,441,441,
Oklahoma,Corporation Commissioner,Jackie Short,IND,550040,0,0,79,79,
Oklahoma,U.S. House,Steve Russell,REP,550040,0,0,634,634,5
Oklahoma,U.S. House,Kendra Horn,DEM,550040,0,0,556,556,5
Oklahoma,State Senate,Stephanie Bice,REP,550040,0,0,716,716,22
Oklahoma,State Senate,William Andrews,DEM,550040,0,0,457,457,22
Oklahoma,State House,Ryan Martinez,REP,550040,0,0,672,672,39
Oklahoma,State House,Devyn Denton,DEM,550040,0,0,447,447,39
Oklahoma,State House,Richard Prawdzienski,IND,550040,0,0,56,56,39
Oklahoma,Governor,Chris Powell,LIB,550041,0,0,27,27,
Oklahoma,Governor,Kevin Stitt,REP,550041,0,0,425,425,
Oklahoma,Governor,Drew Edmondson,DEM,550041,0,0,515,515,
Oklahoma,Lieutenant Governor,Matt Pinnell,REP,550041,0,0,527,527,
Oklahoma,Lieutenant Governor,Anastasia Pittman,DEM,550041,0,0,395,395,
Oklahoma,Lieutenant Governor,Ivan Holmes,IND,550041,0,0,35,35,
Oklahoma,State Auditor,John Yeutter,LIB,550041,0,0,262,262,
Oklahoma,State Auditor,Cindy Byrd,REP,550041,0,0,613,613,
Oklahoma,Attorney General,Mike Hunter,REP,550041,0,0,546,546,
Oklahoma,Attorney General,Mark Myles,DEM,550041,0,0,409,409,
Oklahoma,State Treasurer,Randy Mcdaniel,REP,550041,0,0,558,558,
Oklahoma,State Treasurer,Charles De Coune,IND,550041,0,0,330,330,
Oklahoma,Superintendent of Public Instruction,Joy Hofmeister,REP,550041,0,0,502,502,
Oklahoma,Superintendent of Public Instruction,John Cox,DEM,550041,0,0,374,374,
Oklahoma,Superintendent of Public Instruction,Larry Huff,IND,550041,0,0,73,73,
Oklahoma,Commissioner of Labor,Leslie Osborn,REP,550041,0,0,523,523,
Oklahoma,Commissioner of Labor,Fred Dorrell,DEM,550041,0,0,378,378,
Oklahoma,Commissioner of Labor,Brandt Dismukes,IND,550041,0,0,39,39,
Oklahoma,Insurance Commissioner,Glen Mulready,REP,550041,0,0,502,502,
Oklahoma,Insurance Commissioner,Kimberly Fobbs,DEM,550041,0,0,439,439,
Oklahoma,Corporation Commissioner,Bob Anthony,REP,550041,0,0,481,481,
Oklahoma,Corporation Commissioner,Ashley Nicole Mccray,DEM,550041,0,0,395,395,
Oklahoma,Corporation Commissioner,Jackie Short,IND,550041,0,0,69,69,
Oklahoma,U.S. House,Steve Russell,REP,550041,0,0,488,488,5
Oklahoma,U.S. House,Kendra Horn,DEM,550041,0,0,470,470,5
Oklahoma,State Senate,Stephanie Bice,REP,550041,0,0,562,562,22
Oklahoma,State Senate,William Andrews,DEM,550041,0,0,381,381,22
Oklahoma,State House,Ryan Martinez,REP,550041,0,0,517,517,39
Oklahoma,State House,Devyn Denton,DEM,550041,0,0,375,375,39
Oklahoma,State House,Richard Prawdzienski,IND,550041,0,0,50,50,39
Oklahoma,Governor,Chris Powell,LIB,550042,0,0,24,24,
Oklahoma,Governor,Kevin Stitt,REP,550042,0,0,723,723,
Oklahoma,Governor,Drew Edmondson,DEM,550042,0,0,565,565,
Oklahoma,Lieutenant Governor,Matt Pinnell,REP,550042,0,0,844,844,
Oklahoma,Lieutenant Governor,Anastasia Pittman,DEM,550042,0,0,420,420,
Oklahoma,Lieutenant Governor,Ivan Holmes,IND,550042,0,0,41,41,
Oklahoma,State Auditor,John Yeutter,LIB,550042,0,0,280,280,
Oklahoma,State Auditor,Cindy Byrd,REP,550042,0,0,931,931,
Oklahoma,Attorney General,Mike Hunter,REP,550042,0,0,882,882,
Oklahoma,Attorney General,Mark Myles,DEM,550042,0,0,410,410,
Oklahoma,State Treasurer,Randy Mcdaniel,REP,550042,0,0,876,876,
Oklahoma,State Treasurer,Charles De Coune,IND,550042,0,0,340,340,
Oklahoma,Superintendent of Public Instruction,Joy Hofmeister,REP,550042,0,0,807,807,
Oklahoma,Superintendent of Public Instruction,John Cox,DEM,550042,0,0,402,402,
Oklahoma,Superintendent of Public Instruction,Larry Huff,IND,550042,0,0,90,90,
Oklahoma,Commissioner of Labor,Leslie Osborn,REP,550042,0,0,855,855,
Oklahoma,Commissioner of Labor,Fred Dorrell,DEM,550042,0,0,377,377,
Oklahoma,Commissioner of Labor,Brandt Dismukes,IND,550042,0,0,56,56,
Oklahoma,Insurance Commissioner,Glen Mulready,REP,550042,0,0,830,830,
Oklahoma,Insurance Commissioner,Kimberly Fobbs,DEM,550042,0,0,440,440,
Oklahoma,Corporation Commissioner,Bob Anthony,REP,550042,0,0,794,794,
Oklahoma,Corporation Commissioner,Ashley Nicole Mccray,DEM,550042,0,0,417,417,
Oklahoma,Corporation Commissioner,Jackie Short,IND,550042,0,0,66,66,
Oklahoma,U.S. House,Steve Russell,REP,550042,0,0,807,807,5
Oklahoma,U.S. House,Kendra Horn,DEM,550042,0,0,496,496,5
Oklahoma,State House,Ryan Martinez,REP,550042,0,0,836,836,39
Oklahoma,State House,Devyn Denton,DEM,550042,0,0,417,417,39
Oklahoma,State House,Richard Prawdzienski,IND,550042,0,0,36,36,39
Oklahoma,Governor,Chris Powell,LIB,550043,0,0,39,39,
Oklahoma,Governor,Kevin Stitt,REP,550043,0,0,1185,1185,
Oklahoma,Governor,Drew Edmondson,DEM,550043,0,0,587,587,
Oklahoma,Lieutenant Governor,Matt Pinnell,REP,550043,0,0,1364,1364,
Oklahoma,Lieutenant Governor,Anastasia Pittman,DEM,550043,0,0,381,381,
Oklahoma,Lieutenant Governor,Ivan Holmes,IND,550043,0,0,51,51,
Oklahoma,State Auditor,John Yeutter,LIB,550043,0,0,269,269,
Oklahoma,State Auditor,Cindy Byrd,REP,550043,0,0,1427,1427,
Oklahoma,Attorney General,Mike Hunter,REP,550043,0,0,1366,1366,
Oklahoma,Attorney General,Mark Myles,DEM,550043,0,0,420,420,
Oklahoma,State Treasurer,Randy Mcdaniel,REP,550043,0,0,1383,1383,
Oklahoma,State Treasurer,Charles De Coune,IND,550043,0,0,320,320,
Oklahoma,Superintendent of Public Instruction,Joy Hofmeister,REP,550043,0,0,1235,1235,
Oklahoma,Superintendent of Public Instruction,John Cox,DEM,550043,0,0,389,389,
Oklahoma,Superintendent of Public Instruction,Larry Huff,IND,550043,0,0,146,146,
Oklahoma,Commissioner of Labor,Leslie Osborn,REP,550043,0,0,1329,1329,
Oklahoma,Commissioner of Labor,Fred Dorrell,DEM,550043,0,0,358,358,
Oklahoma,Commissioner of Labor,Brandt Dismukes,IND,550043,0,0,76,76,
Oklahoma,Insurance Commissioner,Glen Mulready,REP,550043,0,0,1318,1318,
Oklahoma,Insurance Commissioner,Kimberly Fobbs,DEM,550043,0,0,436,436,
Oklahoma,Corporation Commissioner,Bob Anthony,REP,550043,0,0,1285,1285,
Oklahoma,Corporation Commissioner,Ashley Nicole Mccray,DEM,550043,0,0,398,398,
Oklahoma,Corporation Commissioner,Jackie Short,IND,550043,0,0,78,78,
Oklahoma,U.S. House,Steve Russell,REP,550043,0,0,1296,1296,5
Oklahoma,U.S. House,Kendra Horn,DEM,550043,0,0,498,498,5
Oklahoma,State House,Ryan Martinez,REP,550043,0,0,1310,1310,39
Oklahoma,State House,Devyn Denton,DEM,550043,0,0,402,402,39
Oklahoma,State House,Richard Prawdzienski,IND,550043,0,0,54,54,39
Oklahoma,Governor,Chris Powell,LIB,550044,0,0,50,50,
Oklahoma,Governor,Kevin Stitt,REP,550044,0,0,737,737,
Oklahoma,Governor,Drew Edmondson,DEM,550044,0,0,676,676,
Oklahoma,Lieutenant Governor,Matt Pinnell,REP,550044,0,0,901,901,
Oklahoma,Lieutenant Governor,Anastasia Pittman,DEM,550044,0,0,512,512,
Oklahoma,Lieutenant Governor,Ivan Holmes,IND,550044,0,0,39,39,
Oklahoma,State Auditor,John Yeutter,LIB,550044,0,0,309,309,
Oklahoma,State Auditor,Cindy Byrd,REP,550044,0,0,1024,1024,
Oklahoma,Attorney General,Mike Hunter,REP,550044,0,0,923,923,
Oklahoma,Attorney General,Mark Myles,DEM,550044,0,0,519,519,
Oklahoma,State Treasurer,Randy Mcdaniel,REP,550044,0,0,944,944,
Oklahoma,State Treasurer,Charles De Coune,IND,550044,0,0,397,397,
Oklahoma,Superintendent of Public Instruction,Joy Hofmeister,REP,550044,0,0,880,880,
Oklahoma,Superintendent of Public Instruction,John Cox,DEM,550044,0,0,457,457,
Oklahoma,Superintendent of Public Instruction,Larry Huff,IND,550044,0,0,112,112,
Oklahoma,Commissioner of Labor,Leslie Osborn,REP,550044,0,0,912,912,
Oklahoma,Commissioner of Labor,Fred Dorrell,DEM,550044,0,0,446,446,
Oklahoma,Commissioner of Labor,Brandt Dismukes,IND,550044,0,0,58,58,
Oklahoma,Insurance Commissioner,Glen Mulready,REP,550044,0,0,876,876,
Oklahoma,Insurance Commissioner,Kimberly Fobbs,DEM,550044,0,0,536,536,
Oklahoma,Corporation Commissioner,Bob Anthony,REP,550044,0,0,835,835,
Oklahoma,Corporation Commissioner,Ashley Nicole Mccray,DEM,550044,0,0,512,512,
Oklahoma,Corporation Commissioner,Jackie Short,IND,550044,0,0,80,80,
Oklahoma,U.S. House,Steve Russell,REP,550044,0,0,838,838,5
Oklahoma,U.S. House,Kendra Horn,DEM,550044,0,0,608,608,5
Oklahoma,State House,Ryan Martinez,REP,550044,0,0,883,883,39
Oklahoma,State House,Devyn Denton,DEM,550044,0,0,496,496,39
Oklahoma,State House,Richard Prawdzienski,IND,550044,0,0,54,54,39
Oklahoma,Governor,Chris Powell,LIB,550045,0,0,49,49,
Oklahoma,Governor,Kevin Stitt,REP,550045,0,0,823,823,
Oklahoma,Governor,Drew Edmondson,DEM,550045,0,0,570,570,
Oklahoma,Lieutenant Governor,Matt Pinnell,REP,550045,0,0,964,964,
Oklahoma,Lieutenant Governor,Anastasia Pittman,DEM,550045,0,0,415,415,
Oklahoma,Lieutenant Governor,Ivan Holmes,IND,550045,0,0,51,51,
Oklahoma,State Auditor,John Yeutter,LIB,550045,0,0,263,263,
Oklahoma,State Auditor,Cindy Byrd,REP,550045,0,0,1079,1079,
Oklahoma,Attorney General,Mike Hunter,REP,550045,0,0,1017,1017,
Oklahoma,Attorney General,Mark Myles,DEM,550045,0,0,409,409,
Oklahoma,State Treasurer,Randy Mcdaniel,REP,550045,0,0,1020,1020,
Oklahoma,State Treasurer,Charles De Coune,IND,550045,0,0,325,325,
Oklahoma,Superintendent of Public Instruction,Joy Hofmeister,REP,550045,0,0,945,945,
Oklahoma,Superintendent of Public Instruction,John Cox,DEM,550045,0,0,356,356,
Oklahoma,Superintendent of Public Instruction,Larry Huff,IND,550045,0,0,124,124,
Oklahoma,Commissioner of Labor,Leslie Osborn,REP,550045,0,0,992,992,
Oklahoma,Commissioner of Labor,Fred Dorrell,DEM,550045,0,0,351,351,
Oklahoma,Commissioner of Labor,Brandt Dismukes,IND,550045,0,0,73,73,
Oklahoma,Insurance Commissioner,Glen Mulready,REP,550045,0,0,979,979,
Oklahoma,Insurance Commissioner,Kimberly Fobbs,DEM,550045,0,0,426,426,
Oklahoma,Corporation Commissioner,Bob Anthony,REP,550045,0,0,940,940,
Oklahoma,Corporation Commissioner,Ashley Nicole Mccray,DEM,550045,0,0,382,382,
Oklahoma,Corporation Commissioner,Jackie Short,IND,550045,0,0,91,91,
Oklahoma,U.S. House,Steve Russell,REP,550045,0,0,938,938,5
Oklahoma,U.S. House,Kendra Horn,DEM,550045,0,0,497,497,5
Oklahoma,State House,Ryan Martinez,REP,550045,0,0,969,969,39
Oklahoma,State House,Devyn Denton,DEM,550045,0,0,396,396,39
Oklahoma,State House,Richard Prawdzienski,IND,550045,0,0,55,55,39
Oklahoma,Governor,Chris Powell,LIB,550046,0,0,15,15,
Oklahoma,Governor,Kevin Stitt,REP,550046,0,0,208,208,
Oklahoma,Governor,Drew Edmondson,DEM,550046,0,0,345,345,
Oklahoma,Lieutenant Governor,Matt Pinnell,REP,550046,0,0,261,261,
Oklahoma,Lieutenant Governor,Anastasia Pittman,DEM,550046,0,0,276,276,
Oklahoma,Lieutenant Governor,Ivan Holmes,IND,550046,0,0,28,28,
Oklahoma,State Auditor,John Yeutter,LIB,550046,0,0,224,224,
Oklahoma,State Auditor,Cindy Byrd,REP,550046,0,0,297,297,
Oklahoma,Attorney General,Mike Hunter,REP,550046,0,0,258,258,
Oklahoma,Attorney General,Mark Myles,DEM,550046,0,0,302,302,
Oklahoma,State Treasurer,Randy Mcdaniel,REP,550046,0,0,280,280,
Oklahoma,State Treasurer,Charles De Coune,IND,550046,0,0,243,243,
Oklahoma,Superintendent of Public Instruction,Joy Hofmeister,REP,550046,0,0,253,253,
Oklahoma,Superintendent of Public Instruction,John Cox,DEM,550046,0,0,261,261,
Oklahoma,Superintendent of Public Instruction,Larry Huff,IND,550046,0,0,50,50,
Oklahoma,Commissioner of Labor,Leslie Osborn,REP,550046,0,0,261,261,
Oklahoma,Commissioner of Labor,Fred Dorrell,DEM,550046,0,0,255,255,
Oklahoma,Commissioner of Labor,Brandt Dismukes,IND,550046,0,0,37,37,
Oklahoma,Insurance Commissioner,Glen Mulready,REP,550046,0,0,256,256,
Oklahoma,Insurance Commissioner,Kimberly Fobbs,DEM,550046,0,0,299,299,
Oklahoma,Corporation Commissioner,Bob Anthony,REP,550046,0,0,244,244,
Oklahoma,Corporation Commissioner,Ashley Nicole Mccray,DEM,550046,0,0,266,266,
Oklahoma,Corporation Commissioner,Jackie Short,IND,550046,0,0,48,48,
Oklahoma,U.S. House,Steve Russell,REP,550046,0,0,238,238,5
Oklahoma,U.S. House,Kendra Horn,DEM,550046,0,0,321,321,5
Oklahoma,State House,Mike Osburn,REP,550046,0,0,255,255,81
Oklahoma,State House,Jackie Phillips,DEM,550046,0,0,304,304,81
Oklahoma,Governor,Chris Powell,LIB,550047,0,0,21,21,
Oklahoma,Governor,Kevin Stitt,REP,550047,0,0,162,162,
Oklahoma,Governor,Drew Edmondson,DEM,550047,0,0,285,285,
Oklahoma,Lieutenant Governor,Matt Pinnell,REP,550047,0,0,198,198,
Oklahoma,Lieutenant Governor,Anastasia Pittman,DEM,550047,0,0,239,239,
Oklahoma,Lieutenant Governor,Ivan Holmes,IND,550047,0,0,24,24,
Oklahoma,State Auditor,John Yeutter,LIB,550047,0,0,147,147,
Oklahoma,State Auditor,Cindy Byrd,REP,550047,0,0,258,258,
Oklahoma,Attorney General,Mike Hunter,REP,550047,0,0,216,216,
Oklahoma,Attorney General,Mark Myles,DEM,550047,0,0,242,242,
Oklahoma,State Treasurer,Randy Mcdaniel,REP,550047,0,0,218,218,
Oklahoma,State Treasurer,Charles De Coune,IND,550047,0,0,190,190,
Oklahoma,Superintendent of Public Instruction,Joy Hofmeister,REP,550047,0,0,199,199,
Oklahoma,Superintendent of Public Instruction,John Cox,DEM,550047,0,0,216,216,
Oklahoma,Superintendent of Public Instruction,Larry Huff,IND,550047,0,0,43,43,
Oklahoma,Commissioner of Labor,Leslie Osborn,REP,550047,0,0,209,209,
Oklahoma,Commissioner of Labor,Fred Dorrell,DEM,550047,0,0,221,221,
Oklahoma,Commissioner of Labor,Brandt Dismukes,IND,550047,0,0,24,24,
Oklahoma,Insurance Commissioner,Glen Mulready,REP,550047,0,0,196,196,
Oklahoma,Insurance Commissioner,Kimberly Fobbs,DEM,550047,0,0,253,253,
Oklahoma,Corporation Commissioner,Bob Anthony,REP,550047,0,0,197,197,
Oklahoma,Corporation Commissioner,Ashley Nicole Mccray,DEM,550047,0,0,221,221,
Oklahoma,Corporation Commissioner,Jackie Short,IND,550047,0,0,37,37,
Oklahoma,U.S. House,Steve Russell,REP,550047,0,0,201,201,5
Oklahoma,U.S. House,Kendra Horn,DEM,550047,0,0,262,262,5
Oklahoma,State House,Mike Osburn,REP,550047,0,0,203,203,81
Oklahoma,State House,Jackie Phillips,DEM,550047,0,0,255,255,81
Oklahoma,Governor,Chris Powell,LIB,550048,0,0,46,46,
Oklahoma,Governor,Kevin Stitt,REP,550048,0,0,297,297,
Oklahoma,Governor,Drew Edmondson,DEM,550048,0,0,393,393,
Oklahoma,Lieutenant Governor,Matt Pinnell,REP,550048,0,0,371,371,
Oklahoma,Lieutenant Governor,Anastasia Pittman,DEM,550048,0,0,329,329,
Oklahoma,Lieutenant Governor,Ivan Holmes,IND,550048,0,0,36,36,
Oklahoma,State Auditor,John Yeutter,LIB,550048,0,0,232,232,
Oklahoma,State Auditor,Cindy Byrd,REP,550048,0,0,451,451,
Oklahoma,Attorney General,Mike Hunter,REP,550048,0,0,391,391,
Oklahoma,Attorney General,Mark Myles,DEM,550048,0,0,332,332,
Oklahoma,State Treasurer,Randy Mcdaniel,REP,550048,0,0,397,397,
Oklahoma,State Treasurer,Charles De Coune,IND,550048,0,0,290,290,
Oklahoma,Superintendent of Public Instruction,Joy Hofmeister,REP,550048,0,0,367,367,
Oklahoma,Superintendent of Public Instruction,John Cox,DEM,550048,0,0,284,284,
Oklahoma,Superintendent of Public Instruction,Larry Huff,IND,550048,0,0,80,80,
Oklahoma,Commissioner of Labor,Leslie Osborn,REP,550048,0,0,395,395,
Oklahoma,Commissioner of Labor,Fred Dorrell,DEM,550048,0,0,279,279,
Oklahoma,Commissioner of Labor,Brandt Dismukes,IND,550048,0,0,46,46,
Oklahoma,Insurance Commissioner,Glen Mulready,REP,550048,0,0,382,382,
Oklahoma,Insurance Commissioner,Kimberly Fobbs,DEM,550048,0,0,338,338,
Oklahoma,Corporation Commissioner,Bob Anthony,REP,550048,0,0,360,360,
Oklahoma,Corporation Commissioner,Ashley Nicole Mccray,DEM,550048,0,0,303,303,
Oklahoma,Corporation Commissioner,Jackie Short,IND,550048,0,0,63,63,
Oklahoma,U.S. House,Steve Russell,REP,550048,0,0,360,360,5
Oklahoma,U.S. House,Kendra Horn,DEM,550048,0,0,373,373,5
Oklahoma,State House,Ryan Martinez,REP,550048,0,0,384,384,39
Oklahoma,State House,Devyn Denton,DEM,550048,0,0,291,291,39
Oklahoma,State House,Richard Prawdzienski,IND,550048,0,0,49,49,39
Oklahoma,Governor,Chris Powell,LIB,550049,0,0,20,20,
Oklahoma,Governor,Kevin Stitt,REP,550049,0,0,223,223,
Oklahoma,Governor,Drew Edmondson,DEM,550049,0,0,318,318,
Oklahoma,Lieutenant Governor,Matt Pinnell,REP,550049,0,0,272,272,
Oklahoma,Lieutenant Governor,Anastasia Pittman,DEM,550049,0,0,262,262,
Oklahoma,Lieutenant Governor,Ivan Holmes,IND,550049,0,0,23,23,
Oklahoma,State Auditor,John Yeutter,LIB,550049,0,0,192,192,
Oklahoma,State Auditor,Cindy Byrd,REP,550049,0,0,315,315,
Oklahoma,Attorney General,Mike Hunter,REP,550049,0,0,287,287,
Oklahoma,Attorney General,Mark Myles,DEM,550049,0,0,268,268,
Oklahoma,State Treasurer,Randy Mcdaniel,REP,550049,0,0,290,290,
Oklahoma,State Treasurer,Charles De Coune,IND,550049,0,0,212,212,
Oklahoma,Superintendent of Public Instruction,Joy Hofmeister,REP,550049,0,0,262,262,
Oklahoma,Superintendent of Public Instruction,John Cox,DEM,550049,0,0,238,238,
Oklahoma,Superintendent of Public Instruction,Larry Huff,IND,550049,0,0,53,53,
Oklahoma,Commissioner of Labor,Leslie Osborn,REP,550049,0,0,273,273,
Oklahoma,Commissioner of Labor,Fred Dorrell,DEM,550049,0,0,248,248,
Oklahoma,Commissioner of Labor,Brandt Dismukes,IND,550049,0,0,28,28,
Oklahoma,Insurance Commissioner,Glen Mulready,REP,550049,0,0,279,279,
Oklahoma,Insurance Commissioner,Kimberly Fobbs,DEM,550049,0,0,271,271,
Oklahoma,Corporation Commissioner,Bob Anthony,REP,550049,0,0,241,241,
Oklahoma,Corporation Commissioner,Ashley Nicole Mccray,DEM,550049,0,0,271,271,
Oklahoma,Corporation Commissioner,Jackie Short,IND,550049,0,0,38,38,
Oklahoma,U.S. House,Steve Russell,REP,550049,0,0,255,255,5
Oklahoma,U.S. House,Kendra Horn,DEM,550049,0,0,303,303,5
Oklahoma,State House,Ryan Martinez,REP,550049,0,0,262,262,39
Oklahoma,State House,Devyn Denton,DEM,550049,0,0,265,265,39
Oklahoma,State House,Richard Prawdzienski,IND,550049,0,0,24,24,39
Oklahoma,Governor,Chris Powell,LIB,550050,0,0,1,1,
Oklahoma,Governor,Kevin Stitt,REP,550050,0,0,7,7,
Oklahoma,Governor,Drew Edmondson,DEM,550050,0,0,27,27,
Oklahoma,Lieutenant Governor,Matt Pinnell,REP,550050,0,0,11,11,
Oklahoma,Lieutenant Governor,Anastasia Pittman,DEM,550050,0,0,21,21,
Oklahoma,Lieutenant Governor,Ivan Holmes,IND,550050,0,0,3,3,
Oklahoma,State Auditor,John Yeutter,LIB,550050,0,0,16,16,
Oklahoma,State Auditor,Cindy Byrd,REP,550050,0,0,17,17,
Oklahoma,Attorney General,Mike Hunter,REP,550050,0,0,12,12,
Oklahoma,Attorney General,Mark Myles,DEM,550050,0,0,23,23,
Oklahoma,State Treasurer,Randy Mcdaniel,REP,550050,0,0,11,11,
Oklahoma,State Treasurer,Charles De Coune,IND,550050,0,0,20,20,
Oklahoma,Superintendent of Public Instruction,Joy Hofmeister,REP,550050,0,0,11,11,
Oklahoma,Superintendent of Public Instruction,John Cox,DEM,550050,0,0,17,17,
Oklahoma,Superintendent of Public Instruction,Larry Huff,IND,550050,0,0,6,6,
Oklahoma,Commissioner of Labor,Leslie Osborn,REP,550050,0,0,10,10,
Oklahoma,Commissioner of Labor,Fred Dorrell,DEM,550050,0,0,20,20,
Oklahoma,Commissioner of Labor,Brandt Dismukes,IND,550050,0,0,3,3,
Oklahoma,Insurance Commissioner,Glen Mulready,REP,550050,0,0,8,8,
Oklahoma,Insurance Commissioner,Kimberly Fobbs,DEM,550050,0,0,27,27,
Oklahoma,Corporation Commissioner,Bob Anthony,REP,550050,0,0,5,5,
Oklahoma,Corporation Commissioner,Ashley Nicole Mccray,DEM,550050,0,0,21,21,
Oklahoma,Corporation Commissioner,Jackie Short,IND,550050,0,0,6,6,
Oklahoma,U.S. House,Steve Russell,REP,550050,0,0,9,9,5
Oklahoma,U.S. House,Kendra Horn,DEM,550050,0,0,25,25,5
Oklahoma,State House,Jason Reese,REP,550050,0,0,7,7,83
Oklahoma,State House,Chelsey Branham,DEM,550050,0,0,26,26,83
Oklahoma,Governor,Chris Powell,LIB,550051,0,0,32,32,
Oklahoma,Governor,Kevin Stitt,REP,550051,0,0,328,328,
Oklahoma,Governor,Drew Edmondson,DEM,550051,0,0,460,460,
Oklahoma,Lieutenant Governor,Matt Pinnell,REP,550051,0,0,390,390,
Oklahoma,Lieutenant Governor,Anastasia Pittman,DEM,550051,0,0,395,395,
Oklahoma,Lieutenant Governor,Ivan Holmes,IND,550051,0,0,27,27,
Oklahoma,State Auditor,John Yeutter,LIB,550051,0,0,252,252,
Oklahoma,State Auditor,Cindy Byrd,REP,550051,0,0,469,469,
Oklahoma,Attorney General,Mike Hunter,REP,550051,0,0,426,426,
Oklahoma,Attorney General,Mark Myles,DEM,550051,0,0,376,376,
Oklahoma,State Treasurer,Randy Mcdaniel,REP,550051,0,0,426,426,
Oklahoma,State Treasurer,Charles De Coune,IND,550051,0,0,289,289,
Oklahoma,Superintendent of Public Instruction,Joy Hofmeister,REP,550051,0,0,393,393,
Oklahoma,Superintendent of Public Instruction,John Cox,DEM,550051,0,0,354,354,
Oklahoma,Superintendent of Public Instruction,Larry Huff,IND,550051,0,0,55,55,
Oklahoma,Commissioner of Labor,Leslie Osborn,REP,550051,0,0,413,413,
Oklahoma,Commissioner of Labor,Fred Dorrell,DEM,550051,0,0,337,337,
Oklahoma,Commissioner of Labor,Brandt Dismukes,IND,550051,0,0,40,40,
Oklahoma,Insurance Commissioner,Glen Mulready,REP,550051,0,0,379,379,
Oklahoma,Insurance Commissioner,Kimberly Fobbs,DEM,550051,0,0,410,410,
Oklahoma,Corporation Commissioner,Bob Anthony,REP,550051,0,0,366,366,
Oklahoma,Corporation Commissioner,Ashley Nicole Mccray,DEM,550051,0,0,370,370,
Oklahoma,Corporation Commissioner,Jackie Short,IND,550051,0,0,58,58,
Oklahoma,U.S. House,Steve Russell,REP,550051,0,0,360,360,5
Oklahoma,U.S. House,Kendra Horn,DEM,550051,0,0,444,444,5
Oklahoma,State House,Mike Osburn,REP,550051,0,0,371,371,81
Oklahoma,State House,Jackie Phillips,DEM,550051,0,0,423,423,81
Oklahoma,Governor,Chris Powell,LIB,550052,0,0,20,20,
Oklahoma,Governor,Kevin Stitt,REP,550052,0,0,400,400,
Oklahoma,Governor,Drew Edmondson,DEM,550052,0,0,384,384,
Oklahoma,Lieutenant Governor,Matt Pinnell,REP,550052,0,0,502,502,
Oklahoma,Lieutenant Governor,Anastasia Pittman,DEM,550052,0,0,276,276,
Oklahoma,Lieutenant Governor,Ivan Holmes,IND,550052,0,0,20,20,
Oklahoma,State Auditor,John Yeutter,LIB,550052,0,0,153,153,
Oklahoma,State Auditor,Cindy Byrd,REP,550052,0,0,578,578,
Oklahoma,Attorney General,Mike Hunter,REP,550052,0,0,528,528,
Oklahoma,Attorney General,Mark Myles,DEM,550052,0,0,259,259,
Oklahoma,State Treasurer,Randy Mcdaniel,REP,550052,0,0,528,528,
Oklahoma,State Treasurer,Charles De Coune,IND,550052,0,0,199,199,
Oklahoma,Superintendent of Public Instruction,Joy Hofmeister,REP,550052,0,0,489,489,
Oklahoma,Superintendent of Public Instruction,John Cox,DEM,550052,0,0,247,247,
Oklahoma,Superintendent of Public Instruction,Larry Huff,IND,550052,0,0,54,54,
Oklahoma,Commissioner of Labor,Leslie Osborn,REP,550052,0,0,493,493,
Oklahoma,Commissioner of Labor,Fred Dorrell,DEM,550052,0,0,237,237,
Oklahoma,Commissioner of Labor,Brandt Dismukes,IND,550052,0,0,36,36,
Oklahoma,Insurance Commissioner,Glen Mulready,REP,550052,0,0,487,487,
Oklahoma,Insurance Commissioner,Kimberly Fobbs,DEM,550052,0,0,275,275,
Oklahoma,Corporation Commissioner,Bob Anthony,REP,550052,0,0,473,473,
Oklahoma,Corporation Commissioner,Ashley Nicole Mccray,DEM,550052,0,0,271,271,
Oklahoma,Corporation Commissioner,Jackie Short,IND,550052,0,0,33,33,
Oklahoma,U.S. House,Steve Russell,REP,550052,0,0,470,470,5
Oklahoma,U.S. House,Kendra Horn,DEM,550052,0,0,321,321,5
Oklahoma,State House,Mike Osburn,REP,550052,0,0,500,500,81
Oklahoma,State House,Jackie Phillips,DEM,550052,0,0,288,288,81
Oklahoma,Governor,Chris Powell,LIB,550053,0,0,23,23,
Oklahoma,Governor,Kevin Stitt,REP,550053,0,0,374,374,
Oklahoma,Governor,Drew Edmondson,DEM,550053,0,0,405,405,
Oklahoma,Lieutenant Governor,Matt Pinnell,REP,550053,0,0,456,456,
Oklahoma,Lieutenant Governor,Anastasia Pittman,DEM,550053,0,0,300,300,
Oklahoma,Lieutenant Governor,Ivan Holmes,IND,550053,0,0,39,39,
Oklahoma,State Auditor,John Yeutter,LIB,550053,0,0,205,205,
Oklahoma,State Auditor,Cindy Byrd,REP,550053,0,0,525,525,
Oklahoma,Attorney General,Mike Hunter,REP,550053,0,0,478,478,
Oklahoma,Attorney General,Mark Myles,DEM,550053,0,0,308,308,
Oklahoma,State Treasurer,Randy Mcdaniel,REP,550053,0,0,478,478,
Oklahoma,State Treasurer,Charles De Coune,IND,550053,0,0,250,250,
Oklahoma,Superintendent of Public Instruction,Joy Hofmeister,REP,550053,0,0,457,457,
Oklahoma,Superintendent of Public Instruction,John Cox,DEM,550053,0,0,266,266,
Oklahoma,Superintendent of Public Instruction,Larry Huff,IND,550053,0,0,68,68,
Oklahoma,Commissioner of Labor,Leslie Osborn,REP,550053,0,0,466,466,
Oklahoma,Commissioner of Labor,Fred Dorrell,DEM,550053,0,0,275,275,
Oklahoma,Commissioner of Labor,Brandt Dismukes,IND,550053,0,0,36,36,
Oklahoma,Insurance Commissioner,Glen Mulready,REP,550053,0,0,455,455,
Oklahoma,Insurance Commissioner,Kimberly Fobbs,DEM,550053,0,0,317,317,
Oklahoma,Corporation Commissioner,Bob Anthony,REP,550053,0,0,446,446,
Oklahoma,Corporation Commissioner,Ashley Nicole Mccray,DEM,550053,0,0,279,279,
Oklahoma,Corporation Commissioner,Jackie Short,IND,550053,0,0,57,57,
Oklahoma,U.S. House,Steve Russell,REP,550053,0,0,441,441,5
Oklahoma,U.S. House,Kendra Horn,DEM,550053,0,0,351,351,5
Oklahoma,State House,Mike Osburn,REP,550053,0,0,457,457,81
Oklahoma,State House,Jackie Phillips,DEM,550053,0,0,330,330,81
Oklahoma,Governor,Chris Powell,LIB,550054,0,0,45,45,
Oklahoma,Governor,Kevin Stitt,REP,550054,0,0,494,494,
Oklahoma,Governor,Drew Edmondson,DEM,550054,0,0,377,377,
Oklahoma,Lieutenant Governor,Matt Pinnell,REP,550054,0,0,570,570,
Oklahoma,Lieutenant Governor,Anastasia Pittman,DEM,550054,0,0,295,295,
Oklahoma,Lieutenant Governor,Ivan Holmes,IND,550054,0,0,41,41,
Oklahoma,State Auditor,John Yeutter,LIB,550054,0,0,192,192,
Oklahoma,State Auditor,Cindy Byrd,REP,550054,0,0,651,651,
Oklahoma,Attorney General,Mike Hunter,REP,550054,0,0,609,609,
Oklahoma,Attorney General,Mark Myles,DEM,550054,0,0,293,293,
Oklahoma,State Treasurer,Randy Mcdaniel,REP,550054,0,0,604,604,
Oklahoma,State Treasurer,Charles De Coune,IND,550054,0,0,241,241,
Oklahoma,Superintendent of Public Instruction,Joy Hofmeister,REP,550054,0,0,572,572,
Oklahoma,Superintendent of Public Instruction,John Cox,DEM,550054,0,0,244,244,
Oklahoma,Superintendent of Public Instruction,Larry Huff,IND,550054,0,0,85,85,
Oklahoma,Commissioner of Labor,Leslie Osborn,REP,550054,0,0,596,596,
Oklahoma,Commissioner of Labor,Fred Dorrell,DEM,550054,0,0,240,240,
Oklahoma,Commissioner of Labor,Brandt Dismukes,IND,550054,0,0,56,56,
Oklahoma,Insurance Commissioner,Glen Mulready,REP,550054,0,0,562,562,
Oklahoma,Insurance Commissioner,Kimberly Fobbs,DEM,550054,0,0,316,316,
Oklahoma,Corporation Commissioner,Bob Anthony,REP,550054,0,0,545,545,
Oklahoma,Corporation Commissioner,Ashley Nicole Mccray,DEM,550054,0,0,274,274,
Oklahoma,Corporation Commissioner,Jackie Short,IND,550054,0,0,70,70,
Oklahoma,U.S. House,Steve Russell,REP,550054,0,0,534,534,5
Oklahoma,U.S. House,Kendra Horn,DEM,550054,0,0,366,366,5
Oklahoma,State House,Mike Osburn,REP,550054,0,0,564,564,81
Oklahoma,State House,Jackie Phillips,DEM,550054,0,0,335,335,81
Oklahoma,Governor,Chris Powell,LIB,550055,0,0,29,29,
Oklahoma,Governor,Kevin Stitt,REP,550055,0,0,390,390,
Oklahoma,Governor,Drew Edmondson,DEM,550055,0,0,415,415,
Oklahoma,Lieutenant Governor,Matt Pinnell,REP,550055,0,0,499,499,
Oklahoma,Lieutenant Governor,Anastasia Pittman,DEM,550055,0,0,302,302,
Oklahoma,Lieutenant Governor,Ivan Holmes,IND,550055,0,0,33,33,
Oklahoma,State Auditor,John Yeutter,LIB,550055,0,0,208,208,
Oklahoma,State Auditor,Cindy Byrd,REP,550055,0,0,558,558,
Oklahoma,Attorney General,Mike Hunter,REP,550055,0,0,513,513,
Oklahoma,Attorney General,Mark Myles,DEM,550055,0,0,305,305,
Oklahoma,State Treasurer,Randy Mcdaniel,REP,550055,0,0,509,509,
Oklahoma,State Treasurer,Charles De Coune,IND,550055,0,0,252,252,
Oklahoma,Superintendent of Public Instruction,Joy Hofmeister,REP,550055,0,0,478,478,
Oklahoma,Superintendent of Public Instruction,John Cox,DEM,550055,0,0,281,281,
Oklahoma,Superintendent of Public Instruction,Larry Huff,IND,550055,0,0,66,66,
Oklahoma,Commissioner of Labor,Leslie Osborn,REP,550055,0,0,503,503,
Oklahoma,Commissioner of Labor,Fred Dorrell,DEM,550055,0,0,257,257,
Oklahoma,Commissioner of Labor,Brandt Dismukes,IND,550055,0,0,50,50,
Oklahoma,Insurance Commissioner,Glen Mulready,REP,550055,0,0,491,491,
Oklahoma,Insurance Commissioner,Kimberly Fobbs,DEM,550055,0,0,319,319,
Oklahoma,Corporation Commissioner,Bob Anthony,REP,550055,0,0,480,480,
Oklahoma,Corporation Commissioner,Ashley Nicole Mccray,DEM,550055,0,0,273,273,
Oklahoma,Corporation Commissioner,Jackie Short,IND,550055,0,0,64,64,
Oklahoma,U.S. House,Steve Russell,REP,550055,0,0,476,476,5
Oklahoma,U.S. House,Kendra Horn,DEM,550055,0,0,351,351,5
Oklahoma,State House,Mike Osburn,REP,550055,0,0,477,477,81
Oklahoma,State House,Jackie Phillips,DEM,550055,0,0,349,349,81
Oklahoma,Governor,Chris Powell,LIB,550056,0,0,20,20,
Oklahoma,Governor,Kevin Stitt,REP,550056,0,0,386,386,
Oklahoma,Governor,Drew Edmondson,DEM,550056,0,0,410,410,
Oklahoma,Lieutenant Governor,Matt Pinnell,REP,550056,0,0,477,477,
Oklahoma,Lieutenant Governor,Anastasia Pittman,DEM,550056,0,0,306,306,
Oklahoma,Lieutenant Governor,Ivan Holmes,IND,550056,0,0,19,19,
Oklahoma,State Auditor,John Yeutter,LIB,550056,0,0,185,185,
Oklahoma,State Auditor,Cindy Byrd,REP,550056,0,0,552,552,
Oklahoma,Attorney General,Mike Hunter,REP,550056,0,0,504,504,
Oklahoma,Attorney General,Mark Myles,DEM,550056,0,0,297,297,
Oklahoma,State Treasurer,Randy Mcdaniel,REP,550056,0,0,503,503,
Oklahoma,State Treasurer,Charles De Coune,IND,550056,0,0,238,238,
Oklahoma,Superintendent of Public Instruction,Joy Hofmeister,REP,550056,0,0,463,463,
Oklahoma,Superintendent of Public Instruction,John Cox,DEM,550056,0,0,283,283,
Oklahoma,Superintendent of Public Instruction,Larry Huff,IND,550056,0,0,52,52,
Oklahoma,Commissioner of Labor,Leslie Osborn,REP,550056,0,0,485,485,
Oklahoma,Commissioner of Labor,Fred Dorrell,DEM,550056,0,0,273,273,
Oklahoma,Commissioner of Labor,Brandt Dismukes,IND,550056,0,0,34,34,
Oklahoma,Insurance Commissioner,Glen Mulready,REP,550056,0,0,471,471,
Oklahoma,Insurance Commissioner,Kimberly Fobbs,DEM,550056,0,0,312,312,
Oklahoma,Corporation Commissioner,Bob Anthony,REP,550056,0,0,452,452,
Oklahoma,Corporation Commissioner,Ashley Nicole Mccray,DEM,550056,0,0,283,283,
Oklahoma,Corporation Commissioner,Jackie Short,IND,550056,0,0,60,60,
Oklahoma,U.S. House,Steve Russell,REP,550056,0,0,451,451,5
Oklahoma,U.S. House,Kendra Horn,DEM,550056,0,0,358,358,5
Oklahoma,State House,Mike Osburn,REP,550056,0,0,465,465,81
Oklahoma,State House,Jackie Phillips,DEM,550056,0,0,338,338,81
Oklahoma,Governor,Chris Powell,LIB,550057,0,0,21,21,
Oklahoma,Governor,Kevin Stitt,REP,550057,0,0,357,357,
Oklahoma,Governor,Drew Edmondson,DEM,550057,0,0,380,380,
Oklahoma,Lieutenant Governor,Matt Pinnell,REP,550057,0,0,428,428,
Oklahoma,Lieutenant Governor,Anastasia Pittman,DEM,550057,0,0,297,297,
Oklahoma,Lieutenant Governor,Ivan Holmes,IND,550057,0,0,26,26,
Oklahoma,State Auditor,John Yeutter,LIB,550057,0,0,172,172,
Oklahoma,State Auditor,Cindy Byrd,REP,550057,0,0,515,515,
Oklahoma,Attorney General,Mike Hunter,REP,550057,0,0,445,445,
Oklahoma,Attorney General,Mark Myles,DEM,550057,0,0,296,296,
Oklahoma,State Treasurer,Randy Mcdaniel,REP,550057,0,0,464,464,
Oklahoma,State Treasurer,Charles De Coune,IND,550057,0,0,224,224,
Oklahoma,Superintendent of Public Instruction,Joy Hofmeister,REP,550057,0,0,409,409,
Oklahoma,Superintendent of Public Instruction,John Cox,DEM,550057,0,0,275,275,
Oklahoma,Superintendent of Public Instruction,Larry Huff,IND,550057,0,0,61,61,
Oklahoma,Commissioner of Labor,Leslie Osborn,REP,550057,0,0,436,436,
Oklahoma,Commissioner of Labor,Fred Dorrell,DEM,550057,0,0,265,265,
Oklahoma,Commissioner of Labor,Brandt Dismukes,IND,550057,0,0,33,33,
Oklahoma,Insurance Commissioner,Glen Mulready,REP,550057,0,0,426,426,
Oklahoma,Insurance Commissioner,Kimberly Fobbs,DEM,550057,0,0,305,305,
Oklahoma,Corporation Commissioner,Bob Anthony,REP,550057,0,0,415,415,
Oklahoma,Corporation Commissioner,Ashley Nicole Mccray,DEM,550057,0,0,267,267,
Oklahoma,Corporation Commissioner,Jackie Short,IND,550057,0,0,56,56,
Oklahoma,U.S. House,Steve Russell,REP,550057,0,0,415,415,5
Oklahoma,U.S. House,Kendra Horn,DEM,550057,0,0,330,330,5
Oklahoma,State House,Mike Osburn,REP,550057,0,0,418,418,81
Oklahoma,State House,Jackie Phillips,DEM,550057,0,0,323,323,81
Oklahoma,Governor,Chris Powell,LIB,550058,0,0,38,38,
Oklahoma,Governor,Kevin Stitt,REP,550058,0,0,996,996,
Oklahoma,Governor,Drew Edmondson,DEM,550058,0,0,650,650,
Oklahoma,Lieutenant Governor,Matt Pinnell,REP,550058,0,0,1203,1203,
Oklahoma,Lieutenant Governor,Anastasia Pittman,DEM,550058,0,0,422,422,
Oklahoma,Lieutenant Governor,Ivan Holmes,IND,550058,0,0,43,43,
Oklahoma,State Auditor,John Yeutter,LIB,550058,0,0,229,229,
Oklahoma,State Auditor,Cindy Byrd,REP,550058,0,0,1325,1325,
Oklahoma,Attorney General,Mike Hunter,REP,550058,0,0,1225,1225,
Oklahoma,Attorney General,Mark Myles,DEM,550058,0,0,428,428,
Oklahoma,State Treasurer,Randy Mcdaniel,REP,550058,0,0,1235,1235,
Oklahoma,State Treasurer,Charles De Coune,IND,550058,0,0,322,322,
Oklahoma,Superintendent of Public Instruction,Joy Hofmeister,REP,550058,0,0,1150,1150,
Oklahoma,Superintendent of Public Instruction,John Cox,DEM,550058,0,0,388,388,
Oklahoma,Superintendent of Public Instruction,Larry Huff,IND,550058,0,0,114,114,
Oklahoma,Commissioner of Labor,Leslie Osborn,REP,550058,0,0,1195,1195,
Oklahoma,Commissioner of Labor,Fred Dorrell,DEM,550058,0,0,376,376,
Oklahoma,Commissioner of Labor,Brandt Dismukes,IND,550058,0,0,58,58,
Oklahoma,Insurance Commissioner,Glen Mulready,REP,550058,0,0,1172,1172,
Oklahoma,Insurance Commissioner,Kimberly Fobbs,DEM,550058,0,0,448,448,
Oklahoma,Corporation Commissioner,Bob Anthony,REP,550058,0,0,1135,1135,
Oklahoma,Corporation Commissioner,Ashley Nicole Mccray,DEM,550058,0,0,423,423,
Oklahoma,Corporation Commissioner,Jackie Short,IND,550058,0,0,84,84,
Oklahoma,U.S. House,Steve Russell,REP,550058,0,0,1147,1147,5
Oklahoma,U.S. House,Kendra Horn,DEM,550058,0,0,520,520,5
Oklahoma,State House,Lewis Moore,REP,550058,0,0,1001,1001,96
Oklahoma,State House,Kathy Wallis,DEM,550058,0,0,654,654,96
Oklahoma,Governor,Chris Powell,LIB,550059,0,0,22,22,
Oklahoma,Governor,Kevin Stitt,REP,550059,0,0,842,842,
Oklahoma,Governor,Drew Edmondson,DEM,550059,0,0,403,403,
Oklahoma,Lieutenant Governor,Matt Pinnell,REP,550059,0,0,942,942,
Oklahoma,Lieutenant Governor,Anastasia Pittman,DEM,550059,0,0,291,291,
Oklahoma,Lieutenant Governor,Ivan Holmes,IND,550059,0,0,27,27,
Oklahoma,State Auditor,John Yeutter,LIB,550059,0,0,188,188,
Oklahoma,State Auditor,Cindy Byrd,REP,550059,0,0,997,997,
Oklahoma,Attorney General,Mike Hunter,REP,550059,0,0,960,960,
Oklahoma,Attorney General,Mark Myles,DEM,550059,0,0,296,296,
Oklahoma,State Treasurer,Randy Mcdaniel,REP,550059,0,0,979,979,
Oklahoma,State Treasurer,Charles De Coune,IND,550059,0,0,207,207,
Oklahoma,Superintendent of Public Instruction,Joy Hofmeister,REP,550059,0,0,857,857,
Oklahoma,Superintendent of Public Instruction,John Cox,DEM,550059,0,0,277,277,
Oklahoma,Superintendent of Public Instruction,Larry Huff,IND,550059,0,0,116,116,
Oklahoma,Commissioner of Labor,Leslie Osborn,REP,550059,0,0,943,943,
Oklahoma,Commissioner of Labor,Fred Dorrell,DEM,550059,0,0,251,251,
Oklahoma,Commissioner of Labor,Brandt Dismukes,IND,550059,0,0,39,39,
Oklahoma,Insurance Commissioner,Glen Mulready,REP,550059,0,0,930,930,
Oklahoma,Insurance Commissioner,Kimberly Fobbs,DEM,550059,0,0,303,303,
Oklahoma,Corporation Commissioner,Bob Anthony,REP,550059,0,0,901,901,
Oklahoma,Corporation Commissioner,Ashley Nicole Mccray,DEM,550059,0,0,277,277,
Oklahoma,Corporation Commissioner,Jackie Short,IND,550059,0,0,62,62,
Oklahoma,U.S. House,Steve Russell,REP,550059,0,0,912,912,5
Oklahoma,U.S. House,Kendra Horn,DEM,550059,0,0,348,348,5
Oklahoma,State House,Garry Mize,REP,550059,0,0,911,911,31
Oklahoma,State House,Kara Sawyer,DEM,550059,0,0,332,332,31
Oklahoma,Governor,Chris Powell,LIB,550060,0,0,42,42,
Oklahoma,Governor,Kevin Stitt,REP,550060,0,0,928,928,
Oklahoma,Governor,Drew Edmondson,DEM,550060,0,0,639,639,
Oklahoma,Lieutenant Governor,Matt Pinnell,REP,550060,0,0,1053,1053,
Oklahoma,Lieutenant Governor,Anastasia Pittman,DEM,550060,0,0,479,479,
Oklahoma,Lieutenant Governor,Ivan Holmes,IND,550060,0,0,62,62,
Oklahoma,State Auditor,John Yeutter,LIB,550060,0,0,281,281,
Oklahoma,State Auditor,Cindy Byrd,REP,550060,0,0,1207,1207,
Oklahoma,Attorney General,Mike Hunter,REP,550060,0,0,1114,1114,
Oklahoma,Attorney General,Mark Myles,DEM,550060,0,0,465,465,
Oklahoma,State Treasurer,Randy Mcdaniel,REP,550060,0,0,1120,1120,
Oklahoma,State Treasurer,Charles De Coune,IND,550060,0,0,357,357,
Oklahoma,Superintendent of Public Instruction,Joy Hofmeister,REP,550060,0,0,1022,1022,
Oklahoma,Superintendent of Public Instruction,John Cox,DEM,550060,0,0,429,429,
Oklahoma,Superintendent of Public Instruction,Larry Huff,IND,550060,0,0,127,127,
Oklahoma,Commissioner of Labor,Leslie Osborn,REP,550060,0,0,1062,1062,
Oklahoma,Commissioner of Labor,Fred Dorrell,DEM,550060,0,0,420,420,
Oklahoma,Commissioner of Labor,Brandt Dismukes,IND,550060,0,0,71,71,
Oklahoma,Insurance Commissioner,Glen Mulready,REP,550060,0,0,1049,1049,
Oklahoma,Insurance Commissioner,Kimberly Fobbs,DEM,550060,0,0,497,497,
Oklahoma,Corporation Commissioner,Bob Anthony,REP,550060,0,0,1029,1029,
Oklahoma,Corporation Commissioner,Ashley Nicole Mccray,DEM,550060,0,0,438,438,
Oklahoma,Corporation Commissioner,Jackie Short,IND,550060,0,0,93,93,
Oklahoma,U.S. House,Steve Russell,REP,550060,0,0,1019,1019,5
Oklahoma,U.S. House,Kendra Horn,DEM,550060,0,0,570,570,5
Oklahoma,State House,Lewis Moore,REP,550060,0,0,939,939,96
Oklahoma,State House,Kathy Wallis,DEM,550060,0,0,629,629,96
Oklahoma,Governor,Chris Powell,LIB,550061,0,0,34,34,
Oklahoma,Governor,Kevin Stitt,REP,550061,0,0,741,741,
Oklahoma,Governor,Drew Edmondson,DEM,550061,0,0,511,511,
Oklahoma,Lieutenant Governor,Matt Pinnell,REP,550061,0,0,900,900,
Oklahoma,Lieutenant Governor,Anastasia Pittman,DEM,550061,0,0,335,335,
Oklahoma,Lieutenant Governor,Ivan Holmes,IND,550061,0,0,42,42,
Oklahoma,State Auditor,John Yeutter,LIB,550061,0,0,201,201,
Oklahoma,State Auditor,Cindy Byrd,REP,550061,0,0,985,985,
Oklahoma,Attorney General,Mike Hunter,REP,550061,0,0,932,932,
Oklahoma,Attorney General,Mark Myles,DEM,550061,0,0,338,338,
Oklahoma,State Treasurer,Randy Mcdaniel,REP,550061,0,0,930,930,
Oklahoma,State Treasurer,Charles De Coune,IND,550061,0,0,268,268,
Oklahoma,Superintendent of Public Instruction,Joy Hofmeister,REP,550061,0,0,865,865,
Oklahoma,Superintendent of Public Instruction,John Cox,DEM,550061,0,0,308,308,
Oklahoma,Superintendent of Public Instruction,Larry Huff,IND,550061,0,0,93,93,
Oklahoma,Commissioner of Labor,Leslie Osborn,REP,550061,0,0,899,899,
Oklahoma,Commissioner of Labor,Fred Dorrell,DEM,550061,0,0,303,303,
Oklahoma,Commissioner of Labor,Brandt Dismukes,IND,550061,0,0,47,47,
Oklahoma,Insurance Commissioner,Glen Mulready,REP,550061,0,0,893,893,
Oklahoma,Insurance Commissioner,Kimberly Fobbs,DEM,550061,0,0,350,350,
Oklahoma,Corporation Commissioner,Bob Anthony,REP,550061,0,0,877,877,
Oklahoma,Corporation Commissioner,Ashley Nicole Mccray,DEM,550061,0,0,325,325,
Oklahoma,Corporation Commissioner,Jackie Short,IND,550061,0,0,58,58,
Oklahoma,U.S. House,Steve Russell,REP,550061,0,0,854,854,5
Oklahoma,U.S. House,Kendra Horn,DEM,550061,0,0,424,424,5
Oklahoma,State House,Mike Osburn,REP,550061,0,0,880,880,81
Oklahoma,State House,Jackie Phillips,DEM,550061,0,0,388,388,81
Oklahoma,Governor,Chris Powell,LIB,550062,0,0,40,40,
Oklahoma,Governor,Kevin Stitt,REP,550062,0,0,843,843,
Oklahoma,Governor,Drew Edmondson,DEM,550062,0,0,639,639,
Oklahoma,Lieutenant Governor,Matt Pinnell,REP,550062,0,0,1003,1003,
Oklahoma,Lieutenant Governor,Anastasia Pittman,DEM,550062,0,0,454,454,
Oklahoma,Lieutenant Governor,Ivan Holmes,IND,550062,0,0,54,54,
Oklahoma,State Auditor,John Yeutter,LIB,550062,0,0,280,280,
Oklahoma,State Auditor,Cindy Byrd,REP,550062,0,0,1138,1138,
Oklahoma,Attorney General,Mike Hunter,REP,550062,0,0,1047,1047,
Oklahoma,Attorney General,Mark Myles,DEM,550062,0,0,461,461,
Oklahoma,State Treasurer,Randy Mcdaniel,REP,550062,0,0,1060,1060,
Oklahoma,State Treasurer,Charles De Coune,IND,550062,0,0,363,363,
Oklahoma,Superintendent of Public Instruction,Joy Hofmeister,REP,550062,0,0,971,971,
Oklahoma,Superintendent of Public Instruction,John Cox,DEM,550062,0,0,424,424,
Oklahoma,Superintendent of Public Instruction,Larry Huff,IND,550062,0,0,104,104,
Oklahoma,Commissioner of Labor,Leslie Osborn,REP,550062,0,0,1027,1027,
Oklahoma,Commissioner of Labor,Fred Dorrell,DEM,550062,0,0,402,402,
Oklahoma,Commissioner of Labor,Brandt Dismukes,IND,550062,0,0,59,59,
Oklahoma,Insurance Commissioner,Glen Mulready,REP,550062,0,0,990,990,
Oklahoma,Insurance Commissioner,Kimberly Fobbs,DEM,550062,0,0,483,483,
Oklahoma,Corporation Commissioner,Bob Anthony,REP,550062,0,0,964,964,
Oklahoma,Corporation Commissioner,Ashley Nicole Mccray,DEM,550062,0,0,421,421,
Oklahoma,Corporation Commissioner,Jackie Short,IND,550062,0,0,106,106,
Oklahoma,U.S. House,Steve Russell,REP,550062,0,0,972,972,5
Oklahoma,U.S. House,Kendra Horn,DEM,550062,0,0,537,537,5
Oklahoma,State House,Mike Osburn,REP,550062,0,0,969,969,81
Oklahoma,State House,Jackie Phillips,DEM,550062,0,0,527,527,81
Oklahoma,Governor,Chris Powell,LIB,550063,0,0,15,15,
Oklahoma,Governor,Kevin Stitt,REP,550063,0,0,389,389,
Oklahoma,Governor,Drew Edmondson,DEM,550063,0,0,182,182,
Oklahoma,Lieutenant Governor,Matt Pinnell,REP,550063,0,0,443,443,
Oklahoma,Lieutenant Governor,Anastasia Pittman,DEM,550063,0,0,130,130,
Oklahoma,Lieutenant Governor,Ivan Holmes,IND,550063,0,0,10,10,
Oklahoma,State Auditor,John Yeutter,LIB,550063,0,0,92,92,
Oklahoma,State Auditor,Cindy Byrd,REP,550063,0,0,470,470,
Oklahoma,Attorney General,Mike Hunter,REP,550063,0,0,464,464,
Oklahoma,Attorney General,Mark Myles,DEM,550063,0,0,117,117,
Oklahoma,State Treasurer,Randy Mcdaniel,REP,550063,0,0,444,444,
Oklahoma,State Treasurer,Charles De Coune,IND,550063,0,0,117,117,
Oklahoma,Superintendent of Public Instruction,Joy Hofmeister,REP,550063,0,0,407,407,
Oklahoma,Superintendent of Public Instruction,John Cox,DEM,550063,0,0,123,123,
Oklahoma,Superintendent of Public Instruction,Larry Huff,IND,550063,0,0,51,51,
Oklahoma,Commissioner of Labor,Leslie Osborn,REP,550063,0,0,443,443,
Oklahoma,Commissioner of Labor,Fred Dorrell,DEM,550063,0,0,116,116,
Oklahoma,Commissioner of Labor,Brandt Dismukes,IND,550063,0,0,20,20,
Oklahoma,Insurance Commissioner,Glen Mulready,REP,550063,0,0,443,443,
Oklahoma,Insurance Commissioner,Kimberly Fobbs,DEM,550063,0,0,128,128,
Oklahoma,Corporation Commissioner,Bob Anthony,REP,550063,0,0,421,421,
Oklahoma,Corporation Commissioner,Ashley Nicole Mccray,DEM,550063,0,0,118,118,
Oklahoma,Corporation Commissioner,Jackie Short,IND,550063,0,0,35,35,
Oklahoma,U.S. House,Steve Russell,REP,550063,0,0,419,419,5
Oklahoma,U.S. House,Kendra Horn,DEM,550063,0,0,162,162,5
Oklahoma,State House,Lewis Moore,REP,550063,0,0,394,394,96
Oklahoma,State House,Kathy Wallis,DEM,550063,0,0,183,183,96
Oklahoma,Governor,Chris Powell,LIB,550064,0,0,24,24,
Oklahoma,Governor,Kevin Stitt,REP,550064,0,0,1062,1062,
Oklahoma,Governor,Drew Edmondson,DEM,550064,0,0,565,565,
Oklahoma,Lieutenant Governor,Matt Pinnell,REP,550064,0,0,1228,1228,
Oklahoma,Lieutenant Governor,Anastasia Pittman,DEM,550064,0,0,377,377,
Oklahoma,Lieutenant Governor,Ivan Holmes,IND,550064,0,0,42,42,
Oklahoma,State Auditor,John Yeutter,LIB,550064,0,0,242,242,
Oklahoma,State Auditor,Cindy Byrd,REP,550064,0,0,1296,1296,
Oklahoma,Attorney General,Mike Hunter,REP,550064,0,0,1242,1242,
Oklahoma,Attorney General,Mark Myles,DEM,550064,0,0,392,392,
Oklahoma,State Treasurer,Randy Mcdaniel,REP,550064,0,0,1233,1233,
Oklahoma,State Treasurer,Charles De Coune,IND,550064,0,0,311,311,
Oklahoma,Superintendent of Public Instruction,Joy Hofmeister,REP,550064,0,0,1104,1104,
Oklahoma,Superintendent of Public Instruction,John Cox,DEM,550064,0,0,385,385,
Oklahoma,Superintendent of Public Instruction,Larry Huff,IND,550064,0,0,139,139,
Oklahoma,Commissioner of Labor,Leslie Osborn,REP,550064,0,0,1209,1209,
Oklahoma,Commissioner of Labor,Fred Dorrell,DEM,550064,0,0,330,330,
Oklahoma,Commissioner of Labor,Brandt Dismukes,IND,550064,0,0,75,75,
Oklahoma,Insurance Commissioner,Glen Mulready,REP,550064,0,0,1199,1199,
Oklahoma,Insurance Commissioner,Kimberly Fobbs,DEM,550064,0,0,408,408,
Oklahoma,Corporation Commissioner,Bob Anthony,REP,550064,0,0,1147,1147,
Oklahoma,Corporation Commissioner,Ashley Nicole Mccray,DEM,550064,0,0,378,378,
Oklahoma,Corporation Commissioner,Jackie Short,IND,550064,0,0,98,98,
Oklahoma,U.S. House,Steve Russell,REP,550064,0,0,1178,1178,5
Oklahoma,U.S. House,Kendra Horn,DEM,550064,0,0,469,469,5
Oklahoma,State House,Lewis Moore,REP,550064,0,0,1107,1107,96
Oklahoma,State House,Kathy Wallis,DEM,550064,0,0,517,517,96
Oklahoma,Governor,Chris Powell,LIB,550065,0,0,31,31,
Oklahoma,Governor,Kevin Stitt,REP,550065,0,0,571,571,
Oklahoma,Governor,Drew Edmondson,DEM,550065,0,0,338,338,
Oklahoma,Lieutenant Governor,Matt Pinnell,REP,550065,0,0,636,636,
Oklahoma,Lieutenant Governor,Anastasia Pittman,DEM,550065,0,0,273,273,
Oklahoma,Lieutenant Governor,Ivan Holmes,IND,550065,0,0,21,21,
Oklahoma,State Auditor,John Yeutter,LIB,550065,0,0,173,173,
Oklahoma,State Auditor,Cindy Byrd,REP,550065,0,0,696,696,
Oklahoma,Attorney General,Mike Hunter,REP,550065,0,0,657,657,
Oklahoma,Attorney General,Mark Myles,DEM,550065,0,0,270,270,
Oklahoma,State Treasurer,Randy Mcdaniel,REP,550065,0,0,651,651,
Oklahoma,State Treasurer,Charles De Coune,IND,550065,0,0,227,227,
Oklahoma,Superintendent of Public Instruction,Joy Hofmeister,REP,550065,0,0,582,582,
Oklahoma,Superintendent of Public Instruction,John Cox,DEM,550065,0,0,259,259,
Oklahoma,Superintendent of Public Instruction,Larry Huff,IND,550065,0,0,86,86,
Oklahoma,Commissioner of Labor,Leslie Osborn,REP,550065,0,0,622,622,
Oklahoma,Commissioner of Labor,Fred Dorrell,DEM,550065,0,0,240,240,
Oklahoma,Commissioner of Labor,Brandt Dismukes,IND,550065,0,0,46,46,
Oklahoma,Insurance Commissioner,Glen Mulready,REP,550065,0,0,632,632,
Oklahoma,Insurance Commissioner,Kimberly Fobbs,DEM,550065,0,0,282,282,
Oklahoma,Corporation Commissioner,Bob Anthony,REP,550065,0,0,616,616,
Oklahoma,Corporation Commissioner,Ashley Nicole Mccray,DEM,550065,0,0,246,246,
Oklahoma,Corporation Commissioner,Jackie Short,IND,550065,0,0,62,62,
Oklahoma,U.S. House,Steve Russell,REP,550065,0,0,625,625,5
Oklahoma,U.S. House,Kendra Horn,DEM,550065,0,0,309,309,5
Oklahoma,State House,Lewis Moore,REP,550065,0,0,588,588,96
Oklahoma,State House,Kathy Wallis,DEM,550065,0,0,339,339,96
Oklahoma,Governor,Chris Powell,LIB,550066,0,0,21,21,
Oklahoma,Governor,Kevin Stitt,REP,550066,0,0,149,149,
Oklahoma,Governor,Drew Edmondson,DEM,550066,0,0,743,743,
Oklahoma,Lieutenant Governor,Matt Pinnell,REP,550066,0,0,160,160,
Oklahoma,Lieutenant Governor,Anastasia Pittman,DEM,550066,0,0,726,726,
Oklahoma,Lieutenant Governor,Ivan Holmes,IND,550066,0,0,25,25,
Oklahoma,State Auditor,John Yeutter,LIB,550066,0,0,431,431,
Oklahoma,State Auditor,Cindy Byrd,REP,550066,0,0,300,300,
Oklahoma,Attorney General,Mike Hunter,REP,550066,0,0,186,186,
Oklahoma,Attorney General,Mark Myles,DEM,550066,0,0,721,721,
Oklahoma,State Treasurer,Randy Mcdaniel,REP,550066,0,0,235,235,
Oklahoma,State Treasurer,Charles De Coune,IND,550066,0,0,501,501,
Oklahoma,Superintendent of Public Instruction,Joy Hofmeister,REP,550066,0,0,219,219,
Oklahoma,Superintendent of Public Instruction,John Cox,DEM,550066,0,0,630,630,
Oklahoma,Superintendent of Public Instruction,Larry Huff,IND,550066,0,0,53,53,
Oklahoma,Commissioner of Labor,Leslie Osborn,REP,550066,0,0,189,189,
Oklahoma,Commissioner of Labor,Fred Dorrell,DEM,550066,0,0,667,667,
Oklahoma,Commissioner of Labor,Brandt Dismukes,IND,550066,0,0,38,38,
Oklahoma,Insurance Commissioner,Glen Mulready,REP,550066,0,0,172,172,
Oklahoma,Insurance Commissioner,Kimberly Fobbs,DEM,550066,0,0,724,724,
Oklahoma,Corporation Commissioner,Bob Anthony,REP,550066,0,0,205,205,
Oklahoma,Corporation Commissioner,Ashley Nicole Mccray,DEM,550066,0,0,664,664,
Oklahoma,Corporation Commissioner,Jackie Short,IND,550066,0,0,32,32,
Oklahoma,U.S. House,Steve Russell,REP,550066,0,0,166,166,5
Oklahoma,U.S. House,Kendra Horn,DEM,550066,0,0,744,744,5
Oklahoma,State Senate,Willard Linzy,REP,550066,0,0,164,164,48
Oklahoma,State Senate,George Young,DEM,550066,0,0,737,737,48
Oklahoma,Governor,Chris Powell,LIB,550067,0,0,52,52,
Oklahoma,Governor,Kevin Stitt,REP,550067,0,0,634,634,
Oklahoma,Governor,Drew Edmondson,DEM,550067,0,0,310,310,
Oklahoma,Lieutenant Governor,Matt Pinnell,REP,550067,0,0,721,721,
Oklahoma,Lieutenant Governor,Anastasia Pittman,DEM,550067,0,0,219,219,
Oklahoma,Lieutenant Governor,Ivan Holmes,IND,550067,0,0,51,51,
Oklahoma,State Auditor,John Yeutter,LIB,550067,0,0,173,173,
Oklahoma,State Auditor,Cindy Byrd,REP,550067,0,0,763,763,
Oklahoma,Attorney General,Mike Hunter,REP,550067,0,0,741,741,
Oklahoma,Attorney General,Mark Myles,DEM,550067,0,0,240,240,
Oklahoma,State Treasurer,Randy Mcdaniel,REP,550067,0,0,737,737,
Oklahoma,State Treasurer,Charles De Coune,IND,550067,0,0,201,201,
Oklahoma,Superintendent of Public Instruction,Joy Hofmeister,REP,550067,0,0,665,665,
Oklahoma,Superintendent of Public Instruction,John Cox,DEM,550067,0,0,202,202,
Oklahoma,Superintendent of Public Instruction,Larry Huff,IND,550067,0,0,112,112,
Oklahoma,Commissioner of Labor,Leslie Osborn,REP,550067,0,0,712,712,
Oklahoma,Commissioner of Labor,Fred Dorrell,DEM,550067,0,0,198,198,
Oklahoma,Commissioner of Labor,Brandt Dismukes,IND,550067,0,0,59,59,
Oklahoma,Insurance Commissioner,Glen Mulready,REP,550067,0,0,711,711,
Oklahoma,Insurance Commissioner,Kimberly Fobbs,DEM,550067,0,0,250,250,
Oklahoma,Corporation Commissioner,Bob Anthony,REP,550067,0,0,677,677,
Oklahoma,Corporation Commissioner,Ashley Nicole Mccray,DEM,550067,0,0,230,230,
Oklahoma,Corporation Commissioner,Jackie Short,IND,550067,0,0,70,70,
Oklahoma,U.S. House,Steve Russell,REP,550067,0,0,681,681,5
Oklahoma,U.S. House,Kendra Horn,DEM,550067,0,0,306,306,5
Oklahoma,State House,Robert Manger,REP,550067,0,0,713,713,10
Oklahoma,State House,John Carpenter,DEM,550067,0,0,256,256,10
Oklahoma,Governor,Chris Powell,LIB,550068,0,0,18,18,
Oklahoma,Governor,Kevin Stitt,REP,550068,0,0,496,496,
Oklahoma,Governor,Drew Edmondson,DEM,550068,0,0,208,208,
Oklahoma,Lieutenant Governor,Matt Pinnell,REP,550068,0,0,539,539,
Oklahoma,Lieutenant Governor,Anastasia Pittman,DEM,550068,0,0,151,151,
Oklahoma,Lieutenant Governor,Ivan Holmes,IND,550068,0,0,26,26,
Oklahoma,State Auditor,John Yeutter,LIB,550068,0,0,109,109,
Oklahoma,State Auditor,Cindy Byrd,REP,550068,0,0,580,580,
Oklahoma,Attorney General,Mike Hunter,REP,550068,0,0,558,558,
Oklahoma,Attorney General,Mark Myles,DEM,550068,0,0,158,158,
Oklahoma,State Treasurer,Randy Mcdaniel,REP,550068,0,0,558,558,
Oklahoma,State Treasurer,Charles De Coune,IND,550068,0,0,134,134,
Oklahoma,Superintendent of Public Instruction,Joy Hofmeister,REP,550068,0,0,519,519,
Oklahoma,Superintendent of Public Instruction,John Cox,DEM,550068,0,0,139,139,
Oklahoma,Superintendent of Public Instruction,Larry Huff,IND,550068,0,0,65,65,
Oklahoma,Commissioner of Labor,Leslie Osborn,REP,550068,0,0,536,536,
Oklahoma,Commissioner of Labor,Fred Dorrell,DEM,550068,0,0,142,142,
Oklahoma,Commissioner of Labor,Brandt Dismukes,IND,550068,0,0,37,37,
Oklahoma,Insurance Commissioner,Glen Mulready,REP,550068,0,0,539,539,
Oklahoma,Insurance Commissioner,Kimberly Fobbs,DEM,550068,0,0,171,171,
Oklahoma,Corporation Commissioner,Bob Anthony,REP,550068,0,0,492,492,
Oklahoma,Corporation Commissioner,Ashley Nicole Mccray,DEM,550068,0,0,163,163,
Oklahoma,Corporation Commissioner,Jackie Short,IND,550068,0,0,57,57,
Oklahoma,U.S. House,Steve Russell,REP,550068,0,0,537,537,5
Oklahoma,U.S. House,Kendra Horn,DEM,550068,0,0,184,184,5
Oklahoma,State House,Lewis Moore,REP,550068,0,0,484,484,96
Oklahoma,State House,Kathy Wallis,DEM,550068,0,0,230,230,96
Oklahoma,Governor,Chris Powell,LIB,550069,0,0,32,32,
Oklahoma,Governor,Kevin Stitt,REP,550069,0,0,555,555,
Oklahoma,Governor,Drew Edmondson,DEM,550069,0,0,293,293,
Oklahoma,Lieutenant Governor,Matt Pinnell,REP,550069,0,0,630,630,
Oklahoma,Lieutenant Governor,Anastasia Pittman,DEM,550069,0,0,208,208,
Oklahoma,Lieutenant Governor,Ivan Holmes,IND,550069,0,0,38,38,
Oklahoma,State Auditor,John Yeutter,LIB,550069,0,0,145,145,
Oklahoma,State Auditor,Cindy Byrd,REP,550069,0,0,699,699,
Oklahoma,Attorney General,Mike Hunter,REP,550069,0,0,656,656,
Oklahoma,Attorney General,Mark Myles,DEM,550069,0,0,219,219,
Oklahoma,State Treasurer,Randy Mcdaniel,REP,550069,0,0,669,669,
Oklahoma,State Treasurer,Charles De Coune,IND,550069,0,0,172,172,
Oklahoma,Superintendent of Public Instruction,Joy Hofmeister,REP,550069,0,0,600,600,
Oklahoma,Superintendent of Public Instruction,John Cox,DEM,550069,0,0,186,186,
Oklahoma,Superintendent of Public Instruction,Larry Huff,IND,550069,0,0,81,81,
Oklahoma,Commissioner of Labor,Leslie Osborn,REP,550069,0,0,628,628,
Oklahoma,Commissioner of Labor,Fred Dorrell,DEM,550069,0,0,190,190,
Oklahoma,Commissioner of Labor,Brandt Dismukes,IND,550069,0,0,39,39,
Oklahoma,Insurance Commissioner,Glen Mulready,REP,550069,0,0,621,621,
Oklahoma,Insurance Commissioner,Kimberly Fobbs,DEM,550069,0,0,243,243,
Oklahoma,Corporation Commissioner,Bob Anthony,REP,550069,0,0,607,607,
Oklahoma,Corporation Commissioner,Ashley Nicole Mccray,DEM,550069,0,0,201,201,
Oklahoma,Corporation Commissioner,Jackie Short,IND,550069,0,0,61,61,
Oklahoma,U.S. House,Steve Russell,REP,550069,0,0,607,607,5
Oklahoma,U.S. House,Kendra Horn,DEM,550069,0,0,267,267,5
Oklahoma,State House,Lewis Moore,REP,550069,0,0,553,553,96
Oklahoma,State House,Kathy Wallis,DEM,550069,0,0,319,319,96
Oklahoma,Governor,Chris Powell,LIB,550070,0,0,38,38,
Oklahoma,Governor,Kevin Stitt,REP,550070,0,0,436,436,
Oklahoma,Governor,Drew Edmondson,DEM,550070,0,0,215,215,
Oklahoma,Lieutenant Governor,Matt Pinnell,REP,550070,0,0,475,475,
Oklahoma,Lieutenant Governor,Anastasia Pittman,DEM,550070,0,0,168,168,
Oklahoma,Lieutenant Governor,Ivan Holmes,IND,550070,0,0,36,36,
Oklahoma,State Auditor,John Yeutter,LIB,550070,0,0,125,125,
Oklahoma,State Auditor,Cindy Byrd,REP,550070,0,0,520,520,
Oklahoma,Attorney General,Mike Hunter,REP,550070,0,0,506,506,
Oklahoma,Attorney General,Mark Myles,DEM,550070,0,0,172,172,
Oklahoma,State Treasurer,Randy Mcdaniel,REP,550070,0,0,512,512,
Oklahoma,State Treasurer,Charles De Coune,IND,550070,0,0,132,132,
Oklahoma,Superintendent of Public Instruction,Joy Hofmeister,REP,550070,0,0,455,455,
Oklahoma,Superintendent of Public Instruction,John Cox,DEM,550070,0,0,156,156,
Oklahoma,Superintendent of Public Instruction,Larry Huff,IND,550070,0,0,69,69,
Oklahoma,Commissioner of Labor,Leslie Osborn,REP,550070,0,0,472,472,
Oklahoma,Commissioner of Labor,Fred Dorrell,DEM,550070,0,0,151,151,
Oklahoma,Commissioner of Labor,Brandt Dismukes,IND,550070,0,0,46,46,
Oklahoma,Insurance Commissioner,Glen Mulready,REP,550070,0,0,475,475,
Oklahoma,Insurance Commissioner,Kimberly Fobbs,DEM,550070,0,0,196,196,
Oklahoma,Corporation Commissioner,Bob Anthony,REP,550070,0,0,443,443,
Oklahoma,Corporation Commissioner,Ashley Nicole Mccray,DEM,550070,0,0,166,166,
Oklahoma,Corporation Commissioner,Jackie Short,IND,550070,0,0,67,67,
Oklahoma,U.S. House,Steve Russell,REP,550070,0,0,460,460,5
Oklahoma,U.S. House,Kendra Horn,DEM,550070,0,0,222,222,5
Oklahoma,State House,Lewis Moore,REP,550070,0,0,414,414,96
Oklahoma,State House,Kathy Wallis,DEM,550070,0,0,261,261,96
Oklahoma,Governor,Chris Powell,LIB,550071,0,0,45,45,
Oklahoma,Governor,Kevin Stitt,REP,550071,0,0,629,629,
Oklahoma,Governor,Drew Edmondson,DEM,550071,0,0,296,296,
Oklahoma,Lieutenant Governor,Matt Pinnell,REP,550071,0,0,704,704,
Oklahoma,Lieutenant Governor,Anastasia Pittman,DEM,550071,0,0,231,231,
Oklahoma,Lieutenant Governor,Ivan Holmes,IND,550071,0,0,30,30,
Oklahoma,State Auditor,John Yeutter,LIB,550071,0,0,177,177,
Oklahoma,State Auditor,Cindy Byrd,REP,550071,0,0,730,730,
Oklahoma,Attorney General,Mike Hunter,REP,550071,0,0,699,699,
Oklahoma,Attorney General,Mark Myles,DEM,550071,0,0,264,264,
Oklahoma,State Treasurer,Randy Mcdaniel,REP,550071,0,0,712,712,
Oklahoma,State Treasurer,Charles De Coune,IND,550071,0,0,201,201,
Oklahoma,Superintendent of Public Instruction,Joy Hofmeister,REP,550071,0,0,635,635,
Oklahoma,Superintendent of Public Instruction,John Cox,DEM,550071,0,0,224,224,
Oklahoma,Superintendent of Public Instruction,Larry Huff,IND,550071,0,0,108,108,
Oklahoma,Commissioner of Labor,Leslie Osborn,REP,550071,0,0,672,672,
Oklahoma,Commissioner of Labor,Fred Dorrell,DEM,550071,0,0,228,228,
Oklahoma,Commissioner of Labor,Brandt Dismukes,IND,550071,0,0,57,57,
Oklahoma,Insurance Commissioner,Glen Mulready,REP,550071,0,0,688,688,
Oklahoma,Insurance Commissioner,Kimberly Fobbs,DEM,550071,0,0,269,269,
Oklahoma,Corporation Commissioner,Bob Anthony,REP,550071,0,0,637,637,
Oklahoma,Corporation Commissioner,Ashley Nicole Mccray,DEM,550071,0,0,239,239,
Oklahoma,Corporation Commissioner,Jackie Short,IND,550071,0,0,85,85,
Oklahoma,U.S. House,Steve Russell,REP,550071,0,0,657,657,5
Oklahoma,U.S. House,Kendra Horn,DEM,550071,0,0,306,306,5
Oklahoma,State House,Lewis Moore,REP,550071,0,0,614,614,96
Oklahoma,State House,Kathy Wallis,DEM,550071,0,0,346,346,96
Oklahoma,Governor,Chris Powell,LIB,550072,0,0,38,38,
Oklahoma,Governor,Kevin Stitt,REP,550072,0,0,367,367,
Oklahoma,Governor,Drew Edmondson,DEM,550072,0,0,242,242,
Oklahoma,Lieutenant Governor,Matt Pinnell,REP,550072,0,0,433,433,
Oklahoma,Lieutenant Governor,Anastasia Pittman,DEM,550072,0,0,186,186,
Oklahoma,Lieutenant Governor,Ivan Holmes,IND,550072,0,0,25,25,
Oklahoma,State Auditor,John Yeutter,LIB,550072,0,0,149,149,
Oklahoma,State Auditor,Cindy Byrd,REP,550072,0,0,460,460,
Oklahoma,Attorney General,Mike Hunter,REP,550072,0,0,462,462,
Oklahoma,Attorney General,Mark Myles,DEM,550072,0,0,182,182,
Oklahoma,State Treasurer,Randy Mcdaniel,REP,550072,0,0,451,451,
Oklahoma,State Treasurer,Charles De Coune,IND,550072,0,0,153,153,
Oklahoma,Superintendent of Public Instruction,Joy Hofmeister,REP,550072,0,0,407,407,
Oklahoma,Superintendent of Public Instruction,John Cox,DEM,550072,0,0,165,165,
Oklahoma,Superintendent of Public Instruction,Larry Huff,IND,550072,0,0,70,70,
Oklahoma,Commissioner of Labor,Leslie Osborn,REP,550072,0,0,423,423,
Oklahoma,Commissioner of Labor,Fred Dorrell,DEM,550072,0,0,179,179,
Oklahoma,Commissioner of Labor,Brandt Dismukes,IND,550072,0,0,31,31,
Oklahoma,Insurance Commissioner,Glen Mulready,REP,550072,0,0,424,424,
Oklahoma,Insurance Commissioner,Kimberly Fobbs,DEM,550072,0,0,207,207,
Oklahoma,Corporation Commissioner,Bob Anthony,REP,550072,0,0,394,394,
Oklahoma,Corporation Commissioner,Ashley Nicole Mccray,DEM,550072,0,0,186,186,
Oklahoma,Corporation Commissioner,Jackie Short,IND,550072,0,0,60,60,
Oklahoma,U.S. House,Steve Russell,REP,550072,0,0,416,416,5
Oklahoma,U.S. House,Kendra Horn,DEM,550072,0,0,229,229,5
Oklahoma,State House,Lewis Moore,REP,550072,0,0,373,373,96
Oklahoma,State House,Kathy Wallis,DEM,550072,0,0,267,267,96
Oklahoma,Governor,Chris Powell,LIB,550073,0,0,8,8,
Oklahoma,Governor,Kevin Stitt,REP,550073,0,0,113,113,
Oklahoma,Governor,Drew Edmondson,DEM,550073,0,0,75,75,
Oklahoma,Lieutenant Governor,Matt Pinnell,REP,550073,0,0,113,113,
Oklahoma,Lieutenant Governor,Anastasia Pittman,DEM,550073,0,0,70,70,
Oklahoma,Lieutenant Governor,Ivan Holmes,IND,550073,0,0,13,13,
Oklahoma,State Auditor,John Yeutter,LIB,550073,0,0,46,46,
Oklahoma,State Auditor,Cindy Byrd,REP,550073,0,0,140,140,
Oklahoma,Attorney General,Mike Hunter,REP,550073,0,0,135,135,
Oklahoma,Attorney General,Mark Myles,DEM,550073,0,0,61,61,
Oklahoma,State Treasurer,Randy Mcdaniel,REP,550073,0,0,138,138,
Oklahoma,State Treasurer,Charles De Coune,IND,550073,0,0,46,46,
Oklahoma,Superintendent of Public Instruction,Joy Hofmeister,REP,550073,0,0,113,113,
Oklahoma,Superintendent of Public Instruction,John Cox,DEM,550073,0,0,52,52,
Oklahoma,Superintendent of Public Instruction,Larry Huff,IND,550073,0,0,31,31,
Oklahoma,Commissioner of Labor,Leslie Osborn,REP,550073,0,0,125,125,
Oklahoma,Commissioner of Labor,Fred Dorrell,DEM,550073,0,0,55,55,
Oklahoma,Commissioner of Labor,Brandt Dismukes,IND,550073,0,0,14,14,
Oklahoma,Insurance Commissioner,Glen Mulready,REP,550073,0,0,126,126,
Oklahoma,Insurance Commissioner,Kimberly Fobbs,DEM,550073,0,0,66,66,
Oklahoma,Corporation Commissioner,Bob Anthony,REP,550073,0,0,123,123,
Oklahoma,Corporation Commissioner,Ashley Nicole Mccray,DEM,550073,0,0,54,54,
Oklahoma,Corporation Commissioner,Jackie Short,IND,550073,0,0,19,19,
Oklahoma,U.S. House,Steve Russell,REP,550073,0,0,121,121,5
Oklahoma,U.S. House,Kendra Horn,DEM,550073,0,0,74,74,5
Oklahoma,Governor,Chris Powell,LIB,550074,0,0,7,7,
Oklahoma,Governor,Kevin Stitt,REP,550074,0,0,35,35,
Oklahoma,Governor,Drew Edmondson,DEM,550074,0,0,181,181,
Oklahoma,Lieutenant Governor,Matt Pinnell,REP,550074,0,0,32,32,
Oklahoma,Lieutenant Governor,Anastasia Pittman,DEM,550074,0,0,184,184,
Oklahoma,Lieutenant Governor,Ivan Holmes,IND,550074,0,0,7,7,
Oklahoma,State Auditor,John Yeutter,LIB,550074,0,0,99,99,
Oklahoma,State Auditor,Cindy Byrd,REP,550074,0,0,64,64,
Oklahoma,Attorney General,Mike Hunter,REP,550074,0,0,48,48,
Oklahoma,Attorney General,Mark Myles,DEM,550074,0,0,174,174,
Oklahoma,State Treasurer,Randy Mcdaniel,REP,550074,0,0,46,46,
Oklahoma,State Treasurer,Charles De Coune,IND,550074,0,0,125,125,
Oklahoma,Superintendent of Public Instruction,Joy Hofmeister,REP,550074,0,0,48,48,
Oklahoma,Superintendent of Public Instruction,John Cox,DEM,550074,0,0,158,158,
Oklahoma,Superintendent of Public Instruction,Larry Huff,IND,550074,0,0,14,14,
Oklahoma,Commissioner of Labor,Leslie Osborn,REP,550074,0,0,37,37,
Oklahoma,Commissioner of Labor,Fred Dorrell,DEM,550074,0,0,173,173,
Oklahoma,Commissioner of Labor,Brandt Dismukes,IND,550074,0,0,8,8,
Oklahoma,Insurance Commissioner,Glen Mulready,REP,550074,0,0,35,35,
Oklahoma,Insurance Commissioner,Kimberly Fobbs,DEM,550074,0,0,181,181,
Oklahoma,Corporation Commissioner,Bob Anthony,REP,550074,0,0,37,37,
Oklahoma,Corporation Commissioner,Ashley Nicole Mccray,DEM,550074,0,0,170,170,
Oklahoma,Corporation Commissioner,Jackie Short,IND,550074,0,0,10,10,
Oklahoma,U.S. House,Steve Russell,REP,550074,0,0,37,37,5
Oklahoma,U.S. House,Kendra Horn,DEM,550074,0,0,187,187,5
Oklahoma,State Senate,Willard Linzy,REP,550074,0,0,40,40,48
Oklahoma,State Senate,George Young,DEM,550074,0,0,181,181,48
Oklahoma,Governor,Chris Powell,LIB,550075,0,0,22,22,
Oklahoma,Governor,Kevin Stitt,REP,550075,0,0,163,163,
Oklahoma,Governor,Drew Edmondson,DEM,550075,0,0,620,620,
Oklahoma,Lieutenant Governor,Matt Pinnell,REP,550075,0,0,193,193,
Oklahoma,Lieutenant Governor,Anastasia Pittman,DEM,550075,0,0,590,590,
Oklahoma,Lieutenant Governor,Ivan Holmes,IND,550075,0,0,21,21,
Oklahoma,State Auditor,John Yeutter,LIB,550075,0,0,421,421,
Oklahoma,State Auditor,Cindy Byrd,REP,550075,0,0,287,287,
Oklahoma,Attorney General,Mike Hunter,REP,550075,0,0,200,200,
Oklahoma,Attorney General,Mark Myles,DEM,550075,0,0,600,600,
Oklahoma,State Treasurer,Randy Mcdaniel,REP,550075,0,0,236,236,
Oklahoma,State Treasurer,Charles De Coune,IND,550075,0,0,470,470,
Oklahoma,Superintendent of Public Instruction,Joy Hofmeister,REP,550075,0,0,204,204,
Oklahoma,Superintendent of Public Instruction,John Cox,DEM,550075,0,0,546,546,
Oklahoma,Superintendent of Public Instruction,Larry Huff,IND,550075,0,0,48,48,
Oklahoma,Commissioner of Labor,Leslie Osborn,REP,550075,0,0,189,189,
Oklahoma,Commissioner of Labor,Fred Dorrell,DEM,550075,0,0,561,561,
Oklahoma,Commissioner of Labor,Brandt Dismukes,IND,550075,0,0,46,46,
Oklahoma,Insurance Commissioner,Glen Mulready,REP,550075,0,0,201,201,
Oklahoma,Insurance Commissioner,Kimberly Fobbs,DEM,550075,0,0,597,597,
Oklahoma,Corporation Commissioner,Bob Anthony,REP,550075,0,0,199,199,
Oklahoma,Corporation Commissioner,Ashley Nicole Mccray,DEM,550075,0,0,567,567,
Oklahoma,Corporation Commissioner,Jackie Short,IND,550075,0,0,34,34,
Oklahoma,U.S. House,Steve Russell,REP,550075,0,0,185,185,5
Oklahoma,U.S. House,Kendra Horn,DEM,550075,0,0,621,621,5
Oklahoma,State Senate,Willard Linzy,REP,550075,0,0,186,186,48
Oklahoma,State Senate,George Young,DEM,550075,0,0,614,614,48
Oklahoma,Governor,Chris Powell,LIB,550076,0,0,35,35,
Oklahoma,Governor,Kevin Stitt,REP,550076,0,0,459,459,
Oklahoma,Governor,Drew Edmondson,DEM,550076,0,0,281,281,
Oklahoma,Lieutenant Governor,Matt Pinnell,REP,550076,0,0,513,513,
Oklahoma,Lieutenant Governor,Anastasia Pittman,DEM,550076,0,0,221,221,
Oklahoma,Lieutenant Governor,Ivan Holmes,IND,550076,0,0,37,37,
Oklahoma,State Auditor,John Yeutter,LIB,550076,0,0,174,174,
Oklahoma,State Auditor,Cindy Byrd,REP,550076,0,0,543,543,
Oklahoma,Attorney General,Mike Hunter,REP,550076,0,0,525,525,
Oklahoma,Attorney General,Mark Myles,DEM,550076,0,0,239,239,
Oklahoma,State Treasurer,Randy Mcdaniel,REP,550076,0,0,527,527,
Oklahoma,State Treasurer,Charles De Coune,IND,550076,0,0,190,190,
Oklahoma,Superintendent of Public Instruction,Joy Hofmeister,REP,550076,0,0,463,463,
Oklahoma,Superintendent of Public Instruction,John Cox,DEM,550076,0,0,214,214,
Oklahoma,Superintendent of Public Instruction,Larry Huff,IND,550076,0,0,90,90,
Oklahoma,Commissioner of Labor,Leslie Osborn,REP,550076,0,0,488,488,
Oklahoma,Commissioner of Labor,Fred Dorrell,DEM,550076,0,0,217,217,
Oklahoma,Commissioner of Labor,Brandt Dismukes,IND,550076,0,0,50,50,
Oklahoma,Insurance Commissioner,Glen Mulready,REP,550076,0,0,514,514,
Oklahoma,Insurance Commissioner,Kimberly Fobbs,DEM,550076,0,0,235,235,
Oklahoma,Corporation Commissioner,Bob Anthony,REP,550076,0,0,476,476,
Oklahoma,Corporation Commissioner,Ashley Nicole Mccray,DEM,550076,0,0,220,220,
Oklahoma,Corporation Commissioner,Jackie Short,IND,550076,0,0,68,68,
Oklahoma,U.S. House,Steve Russell,REP,550076,0,0,484,484,5
Oklahoma,U.S. House,Kendra Horn,DEM,550076,0,0,282,282,5
Oklahoma,State House,Lewis Moore,REP,550076,0,0,435,435,96
Oklahoma,State House,Kathy Wallis,DEM,550076,0,0,327,327,96
Oklahoma,Governor,Chris Powell,LIB,550077,0,0,30,30,
Oklahoma,Governor,Kevin Stitt,REP,550077,0,0,165,165,
Oklahoma,Governor,Drew Edmondson,DEM,550077,0,0,601,601,
Oklahoma,Lieutenant Governor,Matt Pinnell,REP,550077,0,0,179,179,
Oklahoma,Lieutenant Governor,Anastasia Pittman,DEM,550077,0,0,575,575,
Oklahoma,Lieutenant Governor,Ivan Holmes,IND,550077,0,0,41,41,
Oklahoma,State Auditor,John Yeutter,LIB,550077,0,0,418,418,
Oklahoma,State Auditor,Cindy Byrd,REP,550077,0,0,288,288,
Oklahoma,Attorney General,Mike Hunter,REP,550077,0,0,194,194,
Oklahoma,Attorney General,Mark Myles,DEM,550077,0,0,598,598,
Oklahoma,State Treasurer,Randy Mcdaniel,REP,550077,0,0,221,221,
Oklahoma,State Treasurer,Charles De Coune,IND,550077,0,0,490,490,
Oklahoma,Superintendent of Public Instruction,Joy Hofmeister,REP,550077,0,0,201,201,
Oklahoma,Superintendent of Public Instruction,John Cox,DEM,550077,0,0,516,516,
Oklahoma,Superintendent of Public Instruction,Larry Huff,IND,550077,0,0,70,70,
Oklahoma,Commissioner of Labor,Leslie Osborn,REP,550077,0,0,190,190,
Oklahoma,Commissioner of Labor,Fred Dorrell,DEM,550077,0,0,549,549,
Oklahoma,Commissioner of Labor,Brandt Dismukes,IND,550077,0,0,49,49,
Oklahoma,Insurance Commissioner,Glen Mulready,REP,550077,0,0,189,189,
Oklahoma,Insurance Commissioner,Kimberly Fobbs,DEM,550077,0,0,598,598,
Oklahoma,Corporation Commissioner,Bob Anthony,REP,550077,0,0,201,201,
Oklahoma,Corporation Commissioner,Ashley Nicole Mccray,DEM,550077,0,0,549,549,
Oklahoma,Corporation Commissioner,Jackie Short,IND,550077,0,0,41,41,
Oklahoma,U.S. House,Steve Russell,REP,550077,0,0,192,192,5
Oklahoma,U.S. House,Kendra Horn,DEM,550077,0,0,604,604,5
Oklahoma,State Senate,Willard Linzy,REP,550077,0,0,184,184,48
Oklahoma,State Senate,George Young,DEM,550077,0,0,607,607,48
Oklahoma,Governor,Chris Powell,LIB,550078,0,0,20,20,
Oklahoma,Governor,Kevin Stitt,REP,550078,0,0,108,108,
Oklahoma,Governor,Drew Edmondson,DEM,550078,0,0,465,465,
Oklahoma,Lieutenant Governor,Matt Pinnell,REP,550078,0,0,102,102,
Oklahoma,Lieutenant Governor,Anastasia Pittman,DEM,550078,0,0,475,475,
Oklahoma,Lieutenant Governor,Ivan Holmes,IND,550078,0,0,15,15,
Oklahoma,State Auditor,John Yeutter,LIB,550078,0,0,342,342,
Oklahoma,State Auditor,Cindy Byrd,REP,550078,0,0,177,177,
Oklahoma,Attorney General,Mike Hunter,REP,550078,0,0,114,114,
Oklahoma,Attorney General,Mark Myles,DEM,550078,0,0,473,473,
Oklahoma,State Treasurer,Randy Mcdaniel,REP,550078,0,0,150,150,
Oklahoma,State Treasurer,Charles De Coune,IND,550078,0,0,363,363,
Oklahoma,Superintendent of Public Instruction,Joy Hofmeister,REP,550078,0,0,125,125,
Oklahoma,Superintendent of Public Instruction,John Cox,DEM,550078,0,0,425,425,
Oklahoma,Superintendent of Public Instruction,Larry Huff,IND,550078,0,0,37,37,
Oklahoma,Commissioner of Labor,Leslie Osborn,REP,550078,0,0,111,111,
Oklahoma,Commissioner of Labor,Fred Dorrell,DEM,550078,0,0,444,444,
Oklahoma,Commissioner of Labor,Brandt Dismukes,IND,550078,0,0,30,30,
Oklahoma,Insurance Commissioner,Glen Mulready,REP,550078,0,0,111,111,
Oklahoma,Insurance Commissioner,Kimberly Fobbs,DEM,550078,0,0,477,477,
Oklahoma,Corporation Commissioner,Bob Anthony,REP,550078,0,0,111,111,
Oklahoma,Corporation Commissioner,Ashley Nicole Mccray,DEM,550078,0,0,446,446,
Oklahoma,Corporation Commissioner,Jackie Short,IND,550078,0,0,29,29,
Oklahoma,U.S. House,Steve Russell,REP,550078,0,0,109,109,5
Oklahoma,U.S. House,Kendra Horn,DEM,550078,0,0,483,483,5
Oklahoma,State Senate,Willard Linzy,REP,550078,0,0,117,117,48
Oklahoma,State Senate,George Young,DEM,550078,0,0,472,472,48
Oklahoma,Governor,Chris Powell,LIB,550079,0,0,25,25,
Oklahoma,Governor,Kevin Stitt,REP,550079,0,0,127,127,
Oklahoma,Governor,Drew Edmondson,DEM,550079,0,0,656,656,
Oklahoma,Lieutenant Governor,Matt Pinnell,REP,550079,0,0,140,140,
Oklahoma,Lieutenant Governor,Anastasia Pittman,DEM,550079,0,0,647,647,
Oklahoma,Lieutenant Governor,Ivan Holmes,IND,550079,0,0,19,19,
Oklahoma,State Auditor,John Yeutter,LIB,550079,0,0,414,414,
Oklahoma,State Auditor,Cindy Byrd,REP,550079,0,0,234,234,
Oklahoma,Attorney General,Mike Hunter,REP,550079,0,0,154,154,
Oklahoma,Attorney General,Mark Myles,DEM,550079,0,0,643,643,
Oklahoma,State Treasurer,Randy Mcdaniel,REP,550079,0,0,191,191,
Oklahoma,State Treasurer,Charles De Coune,IND,550079,0,0,465,465,
Oklahoma,Superintendent of Public Instruction,Joy Hofmeister,REP,550079,0,0,166,166,
Oklahoma,Superintendent of Public Instruction,John Cox,DEM,550079,0,0,583,583,
Oklahoma,Superintendent of Public Instruction,Larry Huff,IND,550079,0,0,52,52,
Oklahoma,Commissioner of Labor,Leslie Osborn,REP,550079,0,0,155,155,
Oklahoma,Commissioner of Labor,Fred Dorrell,DEM,550079,0,0,616,616,
Oklahoma,Commissioner of Labor,Brandt Dismukes,IND,550079,0,0,26,26,
Oklahoma,Insurance Commissioner,Glen Mulready,REP,550079,0,0,140,140,
Oklahoma,Insurance Commissioner,Kimberly Fobbs,DEM,550079,0,0,655,655,
Oklahoma,Corporation Commissioner,Bob Anthony,REP,550079,0,0,152,152,
Oklahoma,Corporation Commissioner,Ashley Nicole Mccray,DEM,550079,0,0,615,615,
Oklahoma,Corporation Commissioner,Jackie Short,IND,550079,0,0,33,33,
Oklahoma,U.S. House,Steve Russell,REP,550079,0,0,145,145,5
Oklahoma,U.S. House,Kendra Horn,DEM,550079,0,0,663,663,5
Oklahoma,State Senate,Willard Linzy,REP,550079,0,0,147,147,48
Oklahoma,State Senate,George Young,DEM,550079,0,0,651,651,48
Oklahoma,Governor,Chris Powell,LIB,550080,0,0,61,61,
Oklahoma,Governor,Kevin Stitt,REP,550080,0,0,587,587,
Oklahoma,Governor,Drew Edmondson,DEM,550080,0,0,760,760,
Oklahoma,Lieutenant Governor,Matt Pinnell,REP,550080,0,0,703,703,
Oklahoma,Lieutenant Governor,Anastasia Pittman,DEM,550080,0,0,639,639,
Oklahoma,Lieutenant Governor,Ivan Holmes,IND,550080,0,0,50,50,
Oklahoma,State Auditor,John Yeutter,LIB,550080,0,0,439,439,
Oklahoma,State Auditor,Cindy Byrd,REP,550080,0,0,817,817,
Oklahoma,Attorney General,Mike Hunter,REP,550080,0,0,752,752,
Oklahoma,Attorney General,Mark Myles,DEM,550080,0,0,631,631,
Oklahoma,State Treasurer,Randy Mcdaniel,REP,550080,0,0,756,756,
Oklahoma,State Treasurer,Charles De Coune,IND,550080,0,0,501,501,
Oklahoma,Superintendent of Public Instruction,Joy Hofmeister,REP,550080,0,0,718,718,
Oklahoma,Superintendent of Public Instruction,John Cox,DEM,550080,0,0,543,543,
Oklahoma,Superintendent of Public Instruction,Larry Huff,IND,550080,0,0,127,127,
Oklahoma,Commissioner of Labor,Leslie Osborn,REP,550080,0,0,708,708,
Oklahoma,Commissioner of Labor,Fred Dorrell,DEM,550080,0,0,571,571,
Oklahoma,Commissioner of Labor,Brandt Dismukes,IND,550080,0,0,89,89,
Oklahoma,Insurance Commissioner,Glen Mulready,REP,550080,0,0,698,698,
Oklahoma,Insurance Commissioner,Kimberly Fobbs,DEM,550080,0,0,673,673,
Oklahoma,Corporation Commissioner,Bob Anthony,REP,550080,0,0,681,681,
Oklahoma,Corporation Commissioner,Ashley Nicole Mccray,DEM,550080,0,0,601,601,
Oklahoma,Corporation Commissioner,Jackie Short,IND,550080,0,0,94,94,
Oklahoma,U.S. House,Tom Cole,REP,550080,0,0,749,749,4
Oklahoma,U.S. House,Mary Brannon,DEM,550080,0,0,587,587,4
Oklahoma,U.S. House,Ruby Peters,IND,550080,0,0,59,59,4
Oklahoma,State Senate,Brenda Stanley,REP,550080,0,0,738,738,42
Oklahoma,State Senate,Linda Wade,DEM,550080,0,0,583,583,42
Oklahoma,State Senate,Matt Campbell,IND,550080,0,0,66,66,42
Oklahoma,State House,Paul Brewbaker,LIB,550080,0,0,41,41,95
Oklahoma,State House,Jack Beall Jr,REP,550080,0,0,621,621,95
Oklahoma,State House,Kelly Albright,DEM,550080,0,0,685,685,95
Oklahoma,State House,Rashard Bickham,IND,550080,0,0,36,36,95
Oklahoma,Governor,Chris Powell,LIB,550081,0,0,49,49,
Oklahoma,Governor,Kevin Stitt,REP,550081,0,0,309,309,
Oklahoma,Governor,Drew Edmondson,DEM,550081,0,0,344,344,
Oklahoma,Lieutenant Governor,Matt Pinnell,REP,550081,0,0,348,348,
Oklahoma,Lieutenant Governor,Anastasia Pittman,DEM,550081,0,0,312,312,
Oklahoma,Lieutenant Governor,Ivan Holmes,IND,550081,0,0,41,41,
Oklahoma,State Auditor,John Yeutter,LIB,550081,0,0,219,219,
Oklahoma,State Auditor,Cindy Byrd,REP,550081,0,0,410,410,
Oklahoma,Attorney General,Mike Hunter,REP,550081,0,0,377,377,
Oklahoma,Attorney General,Mark Myles,DEM,550081,0,0,321,321,
Oklahoma,State Treasurer,Randy Mcdaniel,REP,550081,0,0,386,386,
Oklahoma,State Treasurer,Charles De Coune,IND,550081,0,0,249,249,
Oklahoma,Superintendent of Public Instruction,Joy Hofmeister,REP,550081,0,0,329,329,
Oklahoma,Superintendent of Public Instruction,John Cox,DEM,550081,0,0,288,288,
Oklahoma,Superintendent of Public Instruction,Larry Huff,IND,550081,0,0,80,80,
Oklahoma,Commissioner of Labor,Leslie Osborn,REP,550081,0,0,358,358,
Oklahoma,Commissioner of Labor,Fred Dorrell,DEM,550081,0,0,291,291,
Oklahoma,Commissioner of Labor,Brandt Dismukes,IND,550081,0,0,44,44,
Oklahoma,Insurance Commissioner,Glen Mulready,REP,550081,0,0,353,353,
Oklahoma,Insurance Commissioner,Kimberly Fobbs,DEM,550081,0,0,340,340,
Oklahoma,Corporation Commissioner,Bob Anthony,REP,550081,0,0,336,336,
Oklahoma,Corporation Commissioner,Ashley Nicole Mccray,DEM,550081,0,0,306,306,
Oklahoma,Corporation Commissioner,Jackie Short,IND,550081,0,0,51,51,
Oklahoma,U.S. House,Tom Cole,REP,550081,0,0,359,359,4
Oklahoma,U.S. House,Mary Brannon,DEM,550081,0,0,290,290,4
Oklahoma,U.S. House,Ruby Peters,IND,550081,0,0,49,49,4
Oklahoma,State Senate,Brenda Stanley,REP,550081,0,0,328,328,42
Oklahoma,State Senate,Linda Wade,DEM,550081,0,0,302,302,42
Oklahoma,State Senate,Matt Campbell,IND,550081,0,0,61,61,42
Oklahoma,State House,Paul Brewbaker,LIB,550081,0,0,30,30,95
Oklahoma,State House,Jack Beall Jr,REP,550081,0,0,324,324,95
Oklahoma,State House,Kelly Albright,DEM,550081,0,0,312,312,95
Oklahoma,State House,Rashard Bickham,IND,550081,0,0,28,28,95
Oklahoma,Governor,Chris Powell,LIB,550082,0,0,25,25,
Oklahoma,Governor,Kevin Stitt,REP,550082,0,0,145,145,
Oklahoma,Governor,Drew Edmondson,DEM,550082,0,0,195,195,
Oklahoma,Lieutenant Governor,Matt Pinnell,REP,550082,0,0,162,162,
Oklahoma,Lieutenant Governor,Anastasia Pittman,DEM,550082,0,0,172,172,
Oklahoma,Lieutenant Governor,Ivan Holmes,IND,550082,0,0,27,27,
Oklahoma,State Auditor,John Yeutter,LIB,550082,0,0,141,141,
Oklahoma,State Auditor,Cindy Byrd,REP,550082,0,0,188,188,
Oklahoma,Attorney General,Mike Hunter,REP,550082,0,0,180,180,
Oklahoma,Attorney General,Mark Myles,DEM,550082,0,0,182,182,
Oklahoma,State Treasurer,Randy Mcdaniel,REP,550082,0,0,182,182,
Oklahoma,State Treasurer,Charles De Coune,IND,550082,0,0,149,149,
Oklahoma,Superintendent of Public Instruction,Joy Hofmeister,REP,550082,0,0,148,148,
Oklahoma,Superintendent of Public Instruction,John Cox,DEM,550082,0,0,170,170,
Oklahoma,Superintendent of Public Instruction,Larry Huff,IND,550082,0,0,42,42,
Oklahoma,Commissioner of Labor,Leslie Osborn,REP,550082,0,0,163,163,
Oklahoma,Commissioner of Labor,Fred Dorrell,DEM,550082,0,0,159,159,
Oklahoma,Commissioner of Labor,Brandt Dismukes,IND,550082,0,0,32,32,
Oklahoma,Insurance Commissioner,Glen Mulready,REP,550082,0,0,170,170,
Oklahoma,Insurance Commissioner,Kimberly Fobbs,DEM,550082,0,0,187,187,
Oklahoma,Corporation Commissioner,Bob Anthony,REP,550082,0,0,150,150,
Oklahoma,Corporation Commissioner,Ashley Nicole Mccray,DEM,550082,0,0,174,174,
Oklahoma,Corporation Commissioner,Jackie Short,IND,550082,0,0,34,34,
Oklahoma,U.S. House,Tom Cole,REP,550082,0,0,164,164,4
Oklahoma,U.S. House,Mary Brannon,DEM,550082,0,0,179,179,4
Oklahoma,U.S. House,Ruby Peters,IND,550082,0,0,19,19,4
Oklahoma,State Senate,Brenda Stanley,REP,550082,0,0,144,144,42
Oklahoma,State Senate,Linda Wade,DEM,550082,0,0,174,174,42
Oklahoma,State Senate,Matt Campbell,IND,550082,0,0,38,38,42
Oklahoma,State House,Paul Brewbaker,LIB,550082,0,0,19,19,95
Oklahoma,State House,Jack Beall Jr,REP,550082,0,0,138,138,95
Oklahoma,State House,Kelly Albright,DEM,550082,0,0,190,190,95
Oklahoma,State House,Rashard Bickham,IND,550082,0,0,10,10,95
Oklahoma,Governor,Chris Powell,LIB,550083,0,0,71,71,
Oklahoma,Governor,Kevin Stitt,REP,550083,0,0,319,319,
Oklahoma,Governor,Drew Edmondson,DEM,550083,0,0,456,456,
Oklahoma,Lieutenant Governor,Matt Pinnell,REP,550083,0,0,369,369,
Oklahoma,Lieutenant Governor,Anastasia Pittman,DEM,550083,0,0,417,417,
Oklahoma,Lieutenant Governor,Ivan Holmes,IND,550083,0,0,52,52,
Oklahoma,State Auditor,John Yeutter,LIB,550083,0,0,302,302,
Oklahoma,State Auditor,Cindy Byrd,REP,550083,0,0,462,462,
Oklahoma,Attorney General,Mike Hunter,REP,550083,0,0,412,412,
Oklahoma,Attorney General,Mark Myles,DEM,550083,0,0,420,420,
Oklahoma,State Treasurer,Randy Mcdaniel,REP,550083,0,0,406,406,
Oklahoma,State Treasurer,Charles De Coune,IND,550083,0,0,357,357,
Oklahoma,Superintendent of Public Instruction,Joy Hofmeister,REP,550083,0,0,371,371,
Oklahoma,Superintendent of Public Instruction,John Cox,DEM,550083,0,0,358,358,
Oklahoma,Superintendent of Public Instruction,Larry Huff,IND,550083,0,0,104,104,
Oklahoma,Commissioner of Labor,Leslie Osborn,REP,550083,0,0,377,377,
Oklahoma,Commissioner of Labor,Fred Dorrell,DEM,550083,0,0,374,374,
Oklahoma,Commissioner of Labor,Brandt Dismukes,IND,550083,0,0,79,79,
Oklahoma,Insurance Commissioner,Glen Mulready,REP,550083,0,0,370,370,
Oklahoma,Insurance Commissioner,Kimberly Fobbs,DEM,550083,0,0,455,455,
Oklahoma,Corporation Commissioner,Bob Anthony,REP,550083,0,0,355,355,
Oklahoma,Corporation Commissioner,Ashley Nicole Mccray,DEM,550083,0,0,387,387,
Oklahoma,Corporation Commissioner,Jackie Short,IND,550083,0,0,88,88,
Oklahoma,U.S. House,Tom Cole,REP,550083,0,0,384,384,4
Oklahoma,U.S. House,Mary Brannon,DEM,550083,0,0,385,385,4
Oklahoma,U.S. House,Ruby Peters,IND,550083,0,0,71,71,4
Oklahoma,State Senate,Brenda Stanley,REP,550083,0,0,344,344,42
Oklahoma,State Senate,Linda Wade,DEM,550083,0,0,408,408,42
Oklahoma,State Senate,Matt Campbell,IND,550083,0,0,84,84,42
Oklahoma,State House,Paul Brewbaker,LIB,550083,0,0,46,46,95
Oklahoma,State House,Jack Beall Jr,REP,550083,0,0,316,316,95
Oklahoma,State House,Kelly Albright,DEM,550083,0,0,426,426,95
Oklahoma,State House,Rashard Bickham,IND,550083,0,0,46,46,95
Oklahoma,Governor,Chris Powell,LIB,550084,0,0,26,26,
Oklahoma,Governor,Kevin Stitt,REP,550084,0,0,253,253,
Oklahoma,Governor,Drew Edmondson,DEM,550084,0,0,317,317,
Oklahoma,Lieutenant Governor,Matt Pinnell,REP,550084,0,0,288,288,
Oklahoma,Lieutenant Governor,Anastasia Pittman,DEM,550084,0,0,282,282,
Oklahoma,Lieutenant Governor,Ivan Holmes,IND,550084,0,0,25,25,
Oklahoma,State Auditor,John Yeutter,LIB,550084,0,0,208,208,
Oklahoma,State Auditor,Cindy Byrd,REP,550084,0,0,332,332,
Oklahoma,Attorney General,Mike Hunter,REP,550084,0,0,296,296,
Oklahoma,Attorney General,Mark Myles,DEM,550084,0,0,292,292,
Oklahoma,State Treasurer,Randy Mcdaniel,REP,550084,0,0,302,302,
Oklahoma,State Treasurer,Charles De Coune,IND,550084,0,0,236,236,
Oklahoma,Superintendent of Public Instruction,Joy Hofmeister,REP,550084,0,0,273,273,
Oklahoma,Superintendent of Public Instruction,John Cox,DEM,550084,0,0,251,251,
Oklahoma,Superintendent of Public Instruction,Larry Huff,IND,550084,0,0,63,63,
Oklahoma,Commissioner of Labor,Leslie Osborn,REP,550084,0,0,293,293,
Oklahoma,Commissioner of Labor,Fred Dorrell,DEM,550084,0,0,252,252,
Oklahoma,Commissioner of Labor,Brandt Dismukes,IND,550084,0,0,40,40,
Oklahoma,Insurance Commissioner,Glen Mulready,REP,550084,0,0,277,277,
Oklahoma,Insurance Commissioner,Kimberly Fobbs,DEM,550084,0,0,307,307,
Oklahoma,Corporation Commissioner,Bob Anthony,REP,550084,0,0,254,254,
Oklahoma,Corporation Commissioner,Ashley Nicole Mccray,DEM,550084,0,0,286,286,
Oklahoma,Corporation Commissioner,Jackie Short,IND,550084,0,0,44,44,
Oklahoma,U.S. House,Tom Cole,REP,550084,0,0,280,280,4
Oklahoma,U.S. House,Mary Brannon,DEM,550084,0,0,274,274,4
Oklahoma,U.S. House,Ruby Peters,IND,550084,0,0,36,36,4
Oklahoma,State Senate,Brenda Stanley,REP,550084,0,0,278,278,42
Oklahoma,State Senate,Linda Wade,DEM,550084,0,0,271,271,42
Oklahoma,State Senate,Matt Campbell,IND,550084,0,0,39,39,42
Oklahoma,State House,Paul Brewbaker,LIB,550084,0,0,24,24,95
Oklahoma,State House,Jack Beall Jr,REP,550084,0,0,250,250,95
Oklahoma,State House,Kelly Albright,DEM,550084,0,0,301,301,95
Oklahoma,State House,Rashard Bickham,IND,550084,0,0,16,16,95
Oklahoma,Governor,Chris Powell,LIB,550085,0,0,43,43,
Oklahoma,Governor,Kevin Stitt,REP,550085,0,0,361,361,
Oklahoma,Governor,Drew Edmondson,DEM,550085,0,0,507,507,
Oklahoma,Lieutenant Governor,Matt Pinnell,REP,550085,0,0,422,422,
Oklahoma,Lieutenant Governor,Anastasia Pittman,DEM,550085,0,0,442,442,
Oklahoma,Lieutenant Governor,Ivan Holmes,IND,550085,0,0,44,44,
Oklahoma,State Auditor,John Yeutter,LIB,550085,0,0,325,325,
Oklahoma,State Auditor,Cindy Byrd,REP,550085,0,0,490,490,
Oklahoma,Attorney General,Mike Hunter,REP,550085,0,0,452,452,
Oklahoma,Attorney General,Mark Myles,DEM,550085,0,0,450,450,
Oklahoma,State Treasurer,Randy Mcdaniel,REP,550085,0,0,469,469,
Oklahoma,State Treasurer,Charles De Coune,IND,550085,0,0,361,361,
Oklahoma,Superintendent of Public Instruction,Joy Hofmeister,REP,550085,0,0,426,426,
Oklahoma,Superintendent of Public Instruction,John Cox,DEM,550085,0,0,392,392,
Oklahoma,Superintendent of Public Instruction,Larry Huff,IND,550085,0,0,88,88,
Oklahoma,Commissioner of Labor,Leslie Osborn,REP,550085,0,0,445,445,
Oklahoma,Commissioner of Labor,Fred Dorrell,DEM,550085,0,0,397,397,
Oklahoma,Commissioner of Labor,Brandt Dismukes,IND,550085,0,0,54,54,
Oklahoma,Insurance Commissioner,Glen Mulready,REP,550085,0,0,431,431,
Oklahoma,Insurance Commissioner,Kimberly Fobbs,DEM,550085,0,0,463,463,
Oklahoma,Corporation Commissioner,Bob Anthony,REP,550085,0,0,432,432,
Oklahoma,Corporation Commissioner,Ashley Nicole Mccray,DEM,550085,0,0,416,416,
Oklahoma,Corporation Commissioner,Jackie Short,IND,550085,0,0,52,52,
Oklahoma,U.S. House,Tom Cole,REP,550085,0,0,456,456,4
Oklahoma,U.S. House,Mary Brannon,DEM,550085,0,0,403,403,4
Oklahoma,U.S. House,Ruby Peters,IND,550085,0,0,48,48,4
Oklahoma,State Senate,Brenda Stanley,REP,550085,0,0,416,416,42
Oklahoma,State Senate,Linda Wade,DEM,550085,0,0,427,427,42
Oklahoma,State Senate,Matt Campbell,IND,550085,0,0,66,66,42
Oklahoma,State House,Paul Brewbaker,LIB,550085,0,0,26,26,95
Oklahoma,State House,Jack Beall Jr,REP,550085,0,0,377,377,95
Oklahoma,State House,Kelly Albright,DEM,550085,0,0,471,471,95
Oklahoma,State House,Rashard Bickham,IND,550085,0,0,27,27,95
Oklahoma,Governor,Chris Powell,LIB,550086,0,0,63,63,
Oklahoma,Governor,Kevin Stitt,REP,550086,0,0,504,504,
Oklahoma,Governor,Drew Edmondson,DEM,550086,0,0,549,549,
Oklahoma,Lieutenant Governor,Matt Pinnell,REP,550086,0,0,577,577,
Oklahoma,Lieutenant Governor,Anastasia Pittman,DEM,550086,0,0,477,477,
Oklahoma,Lieutenant Governor,Ivan Holmes,IND,550086,0,0,49,49,
Oklahoma,State Auditor,John Yeutter,LIB,550086,0,0,323,323,
Oklahoma,State Auditor,Cindy Byrd,REP,550086,0,0,693,693,
Oklahoma,Attorney General,Mike Hunter,REP,550086,0,0,621,621,
Oklahoma,Attorney General,Mark Myles,DEM,550086,0,0,481,481,
Oklahoma,State Treasurer,Randy Mcdaniel,REP,550086,0,0,629,629,
Oklahoma,State Treasurer,Charles De Coune,IND,550086,0,0,389,389,
Oklahoma,Superintendent of Public Instruction,Joy Hofmeister,REP,550086,0,0,599,599,
Oklahoma,Superintendent of Public Instruction,John Cox,DEM,550086,0,0,411,411,
Oklahoma,Superintendent of Public Instruction,Larry Huff,IND,550086,0,0,95,95,
Oklahoma,Commissioner of Labor,Leslie Osborn,REP,550086,0,0,604,604,
Oklahoma,Commissioner of Labor,Fred Dorrell,DEM,550086,0,0,425,425,
Oklahoma,Commissioner of Labor,Brandt Dismukes,IND,550086,0,0,61,61,
Oklahoma,Insurance Commissioner,Glen Mulready,REP,550086,0,0,594,594,
Oklahoma,Insurance Commissioner,Kimberly Fobbs,DEM,550086,0,0,496,496,
Oklahoma,Corporation Commissioner,Bob Anthony,REP,550086,0,0,586,586,
Oklahoma,Corporation Commissioner,Ashley Nicole Mccray,DEM,550086,0,0,446,446,
Oklahoma,Corporation Commissioner,Jackie Short,IND,550086,0,0,69,69,
Oklahoma,U.S. House,Tom Cole,REP,550086,0,0,610,610,4
Oklahoma,U.S. House,Mary Brannon,DEM,550086,0,0,443,443,4
Oklahoma,U.S. House,Ruby Peters,IND,550086,0,0,56,56,4
Oklahoma,State Senate,Brenda Stanley,REP,550086,0,0,590,590,42
Oklahoma,State Senate,Linda Wade,DEM,550086,0,0,440,440,42
Oklahoma,State Senate,Matt Campbell,IND,550086,0,0,77,77,42
Oklahoma,State House,Paul Brewbaker,LIB,550086,0,0,40,40,95
Oklahoma,State House,Jack Beall Jr,REP,550086,0,0,544,544,95
Oklahoma,State House,Kelly Albright,DEM,550086,0,0,492,492,95
Oklahoma,State House,Rashard Bickham,IND,550086,0,0,33,33,95
Oklahoma,Governor,Chris Powell,LIB,550087,0,0,29,29,
Oklahoma,Governor,Kevin Stitt,REP,550087,0,0,140,140,
Oklahoma,Governor,Drew Edmondson,DEM,550087,0,0,290,290,
Oklahoma,Lieutenant Governor,Matt Pinnell,REP,550087,0,0,157,157,
Oklahoma,Lieutenant Governor,Anastasia Pittman,DEM,550087,0,0,281,281,
Oklahoma,Lieutenant Governor,Ivan Holmes,IND,550087,0,0,21,21,
Oklahoma,State Auditor,John Yeutter,LIB,550087,0,0,208,208,
Oklahoma,State Auditor,Cindy Byrd,REP,550087,0,0,214,214,
Oklahoma,Attorney General,Mike Hunter,REP,550087,0,0,175,175,
Oklahoma,Attorney General,Mark Myles,DEM,550087,0,0,283,283,
Oklahoma,State Treasurer,Randy Mcdaniel,REP,550087,0,0,187,187,
Oklahoma,State Treasurer,Charles De Coune,IND,550087,0,0,231,231,
Oklahoma,Superintendent of Public Instruction,Joy Hofmeister,REP,550087,0,0,157,157,
Oklahoma,Superintendent of Public Instruction,John Cox,DEM,550087,0,0,245,245,
Oklahoma,Superintendent of Public Instruction,Larry Huff,IND,550087,0,0,53,53,
Oklahoma,Commissioner of Labor,Leslie Osborn,REP,550087,0,0,161,161,
Oklahoma,Commissioner of Labor,Fred Dorrell,DEM,550087,0,0,266,266,
Oklahoma,Commissioner of Labor,Brandt Dismukes,IND,550087,0,0,27,27,
Oklahoma,Insurance Commissioner,Glen Mulready,REP,550087,0,0,164,164,
Oklahoma,Insurance Commissioner,Kimberly Fobbs,DEM,550087,0,0,290,290,
Oklahoma,Corporation Commissioner,Bob Anthony,REP,550087,0,0,157,157,
Oklahoma,Corporation Commissioner,Ashley Nicole Mccray,DEM,550087,0,0,268,268,
Oklahoma,Corporation Commissioner,Jackie Short,IND,550087,0,0,31,31,
Oklahoma,U.S. House,Tom Cole,REP,550087,0,0,169,169,4
Oklahoma,U.S. House,Mary Brannon,DEM,550087,0,0,266,266,4
Oklahoma,U.S. House,Ruby Peters,IND,550087,0,0,24,24,4
Oklahoma,State Senate,Brenda Stanley,REP,550087,0,0,156,156,42
Oklahoma,State Senate,Linda Wade,DEM,550087,0,0,276,276,42
Oklahoma,State Senate,Matt Campbell,IND,550087,0,0,26,26,42
Oklahoma,State House,Paul Brewbaker,LIB,550087,0,0,16,16,95
Oklahoma,State House,Jack Beall Jr,REP,550087,0,0,145,145,95
Oklahoma,State House,Kelly Albright,DEM,550087,0,0,276,276,95
Oklahoma,State House,Rashard Bickham,IND,550087,0,0,22,22,95
Oklahoma,Governor,Chris Powell,LIB,550088,0,0,18,18,
Oklahoma,Governor,Kevin Stitt,REP,550088,0,0,64,64,
Oklahoma,Governor,Drew Edmondson,DEM,550088,0,0,226,226,
Oklahoma,Lieutenant Governor,Matt Pinnell,REP,550088,0,0,64,64,
Oklahoma,Lieutenant Governor,Anastasia Pittman,DEM,550088,0,0,235,235,
Oklahoma,Lieutenant Governor,Ivan Holmes,IND,550088,0,0,7,7,
Oklahoma,State Auditor,John Yeutter,LIB,550088,0,0,167,167,
Oklahoma,State Auditor,Cindy Byrd,REP,550088,0,0,101,101,
Oklahoma,Attorney General,Mike Hunter,REP,550088,0,0,87,87,
Oklahoma,Attorney General,Mark Myles,DEM,550088,0,0,219,219,
Oklahoma,State Treasurer,Randy Mcdaniel,REP,550088,0,0,85,85,
Oklahoma,State Treasurer,Charles De Coune,IND,550088,0,0,180,180,
Oklahoma,Superintendent of Public Instruction,Joy Hofmeister,REP,550088,0,0,82,82,
Oklahoma,Superintendent of Public Instruction,John Cox,DEM,550088,0,0,200,200,
Oklahoma,Superintendent of Public Instruction,Larry Huff,IND,550088,0,0,23,23,
Oklahoma,Commissioner of Labor,Leslie Osborn,REP,550088,0,0,77,77,
Oklahoma,Commissioner of Labor,Fred Dorrell,DEM,550088,0,0,207,207,
Oklahoma,Commissioner of Labor,Brandt Dismukes,IND,550088,0,0,18,18,
Oklahoma,Insurance Commissioner,Glen Mulready,REP,550088,0,0,73,73,
Oklahoma,Insurance Commissioner,Kimberly Fobbs,DEM,550088,0,0,230,230,
Oklahoma,Corporation Commissioner,Bob Anthony,REP,550088,0,0,84,84,
Oklahoma,Corporation Commissioner,Ashley Nicole Mccray,DEM,550088,0,0,208,208,
Oklahoma,Corporation Commissioner,Jackie Short,IND,550088,0,0,11,11,
Oklahoma,U.S. House,Tom Cole,REP,550088,0,0,84,84,4
Oklahoma,U.S. House,Mary Brannon,DEM,550088,0,0,208,208,4
Oklahoma,U.S. House,Ruby Peters,IND,550088,0,0,12,12,4
Oklahoma,State Senate,Brenda Stanley,REP,550088,0,0,69,69,42
Oklahoma,State Senate,Linda Wade,DEM,550088,0,0,212,212,42
Oklahoma,State Senate,Matt Campbell,IND,550088,0,0,21,21,42
Oklahoma,State House,Robert Manger,REP,550088,0,0,69,69,10
Oklahoma,State House,John Carpenter,DEM,550088,0,0,233,233,10
Oklahoma,Governor,Chris Powell,LIB,550089,0,0,30,30,
Oklahoma,Governor,Kevin Stitt,REP,550089,0,0,119,119,
Oklahoma,Governor,Drew Edmondson,DEM,550089,0,0,407,407,
Oklahoma,Lieutenant Governor,Matt Pinnell,REP,550089,0,0,131,131,
Oklahoma,Lieutenant Governor,Anastasia Pittman,DEM,550089,0,0,400,400,
Oklahoma,Lieutenant Governor,Ivan Holmes,IND,550089,0,0,22,22,
Oklahoma,State Auditor,John Yeutter,LIB,550089,0,0,298,298,
Oklahoma,State Auditor,Cindy Byrd,REP,550089,0,0,188,188,
Oklahoma,Attorney General,Mike Hunter,REP,550089,0,0,153,153,
Oklahoma,Attorney General,Mark Myles,DEM,550089,0,0,401,401,
Oklahoma,State Treasurer,Randy Mcdaniel,REP,550089,0,0,158,158,
Oklahoma,State Treasurer,Charles De Coune,IND,550089,0,0,324,324,
Oklahoma,Superintendent of Public Instruction,Joy Hofmeister,REP,550089,0,0,137,137,
Oklahoma,Superintendent of Public Instruction,John Cox,DEM,550089,0,0,369,369,
Oklahoma,Superintendent of Public Instruction,Larry Huff,IND,550089,0,0,46,46,
Oklahoma,Commissioner of Labor,Leslie Osborn,REP,550089,0,0,132,132,
Oklahoma,Commissioner of Labor,Fred Dorrell,DEM,550089,0,0,383,383,
Oklahoma,Commissioner of Labor,Brandt Dismukes,IND,550089,0,0,37,37,
Oklahoma,Insurance Commissioner,Glen Mulready,REP,550089,0,0,138,138,
Oklahoma,Insurance Commissioner,Kimberly Fobbs,DEM,550089,0,0,414,414,
Oklahoma,Corporation Commissioner,Bob Anthony,REP,550089,0,0,133,133,
Oklahoma,Corporation Commissioner,Ashley Nicole Mccray,DEM,550089,0,0,387,387,
Oklahoma,Corporation Commissioner,Jackie Short,IND,550089,0,0,34,34,
Oklahoma,U.S. House,Steve Russell,REP,550089,0,0,130,130,5
Oklahoma,U.S. House,Kendra Horn,DEM,550089,0,0,424,424,5
Oklahoma,State Senate,Willard Linzy,REP,550089,0,0,132,132,48
Oklahoma,State Senate,George Young,DEM,550089,0,0,418,418,48
Oklahoma,Governor,Chris Powell,LIB,550090,0,0,5,5,
Oklahoma,Governor,Kevin Stitt,REP,550090,0,0,36,36,
Oklahoma,Governor,Drew Edmondson,DEM,550090,0,0,75,75,
Oklahoma,Lieutenant Governor,Matt Pinnell,REP,550090,0,0,38,38,
Oklahoma,Lieutenant Governor,Anastasia Pittman,DEM,550090,0,0,73,73,
Oklahoma,Lieutenant Governor,Ivan Holmes,IND,550090,0,0,5,5,
Oklahoma,State Auditor,John Yeutter,LIB,550090,0,0,40,40,
Oklahoma,State Auditor,Cindy Byrd,REP,550090,0,0,48,48,
Oklahoma,Attorney General,Mike Hunter,REP,550090,0,0,45,45,
Oklahoma,Attorney General,Mark Myles,DEM,550090,0,0,71,71,
Oklahoma,State Treasurer,Randy Mcdaniel,REP,550090,0,0,45,45,
Oklahoma,State Treasurer,Charles De Coune,IND,550090,0,0,45,45,
Oklahoma,Superintendent of Public Instruction,Joy Hofmeister,REP,550090,0,0,39,39,
Oklahoma,Superintendent of Public Instruction,John Cox,DEM,550090,0,0,64,64,
Oklahoma,Superintendent of Public Instruction,Larry Huff,IND,550090,0,0,13,13,
Oklahoma,Commissioner of Labor,Leslie Osborn,REP,550090,0,0,38,38,
Oklahoma,Commissioner of Labor,Fred Dorrell,DEM,550090,0,0,68,68,
Oklahoma,Commissioner of Labor,Brandt Dismukes,IND,550090,0,0,9,9,
Oklahoma,Insurance Commissioner,Glen Mulready,REP,550090,0,0,39,39,
Oklahoma,Insurance Commissioner,Kimberly Fobbs,DEM,550090,0,0,76,76,
Oklahoma,Corporation Commissioner,Bob Anthony,REP,550090,0,0,37,37,
Oklahoma,Corporation Commissioner,Ashley Nicole Mccray,DEM,550090,0,0,72,72,
Oklahoma,Corporation Commissioner,Jackie Short,IND,550090,0,0,7,7,
Oklahoma,U.S. House,Steve Russell,REP,550090,0,0,46,46,5
Oklahoma,U.S. House,Kendra Horn,DEM,550090,0,0,70,70,5
Oklahoma,State Senate,Willard Linzy,REP,550090,0,0,41,41,48
Oklahoma,State Senate,George Young,DEM,550090,0,0,75,75,48
Oklahoma,State House,Robert Manger,REP,550090,0,0,40,40,10
Oklahoma,State House,John Carpenter,DEM,550090,0,0,76,76,10
Oklahoma,Governor,Chris Powell,LIB,550091,0,0,10,10,
Oklahoma,Governor,Kevin Stitt,REP,550091,0,0,60,60,
Oklahoma,Governor,Drew Edmondson,DEM,550091,0,0,97,97,
Oklahoma,Lieutenant Governor,Matt Pinnell,REP,550091,0,0,71,71,
Oklahoma,Lieutenant Governor,Anastasia Pittman,DEM,550091,0,0,87,87,
Oklahoma,Lieutenant Governor,Ivan Holmes,IND,550091,0,0,7,7,
Oklahoma,State Auditor,John Yeutter,LIB,550091,0,0,63,63,
Oklahoma,State Auditor,Cindy Byrd,REP,550091,0,0,87,87,
Oklahoma,Attorney General,Mike Hunter,REP,550091,0,0,69,69,
Oklahoma,Attorney General,Mark Myles,DEM,550091,0,0,96,96,
Oklahoma,State Treasurer,Randy Mcdaniel,REP,550091,0,0,79,79,
Oklahoma,State Treasurer,Charles De Coune,IND,550091,0,0,74,74,
Oklahoma,Superintendent of Public Instruction,Joy Hofmeister,REP,550091,0,0,72,72,
Oklahoma,Superintendent of Public Instruction,John Cox,DEM,550091,0,0,75,75,
Oklahoma,Superintendent of Public Instruction,Larry Huff,IND,550091,0,0,17,17,
Oklahoma,Commissioner of Labor,Leslie Osborn,REP,550091,0,0,71,71,
Oklahoma,Commissioner of Labor,Fred Dorrell,DEM,550091,0,0,83,83,
Oklahoma,Commissioner of Labor,Brandt Dismukes,IND,550091,0,0,10,10,
Oklahoma,Insurance Commissioner,Glen Mulready,REP,550091,0,0,66,66,
Oklahoma,Insurance Commissioner,Kimberly Fobbs,DEM,550091,0,0,95,95,
Oklahoma,Corporation Commissioner,Bob Anthony,REP,550091,0,0,68,68,
Oklahoma,Corporation Commissioner,Ashley Nicole Mccray,DEM,550091,0,0,88,88,
Oklahoma,Corporation Commissioner,Jackie Short,IND,550091,0,0,8,8,
Oklahoma,U.S. House,Tom Cole,REP,550091,0,0,72,72,4
Oklahoma,U.S. House,Mary Brannon,DEM,550091,0,0,84,84,4
Oklahoma,U.S. House,Ruby Peters,IND,550091,0,0,9,9,4
Oklahoma,State Senate,Willard Linzy,REP,550091,0,0,70,70,48
Oklahoma,State Senate,George Young,DEM,550091,0,0,93,93,48
Oklahoma,State House,Robert Manger,REP,550091,0,0,72,72,10
Oklahoma,State House,John Carpenter,DEM,550091,0,0,92,92,10
Oklahoma,Governor,Chris Powell,LIB,550092,0,0,55,55,
Oklahoma,Governor,Kevin Stitt,REP,550092,0,0,482,482,
Oklahoma,Governor,Drew Edmondson,DEM,550092,0,0,686,686,
Oklahoma,Lieutenant Governor,Matt Pinnell,REP,550092,0,0,539,539,
Oklahoma,Lieutenant Governor,Anastasia Pittman,DEM,550092,0,0,625,625,
Oklahoma,Lieutenant Governor,Ivan Holmes,IND,550092,0,0,52,52,
Oklahoma,State Auditor,John Yeutter,LIB,550092,0,0,422,422,
Oklahoma,State Auditor,Cindy Byrd,REP,550092,0,0,667,667,
Oklahoma,Attorney General,Mike Hunter,REP,550092,0,0,590,590,
Oklahoma,Attorney General,Mark Myles,DEM,550092,0,0,620,620,
Oklahoma,State Treasurer,Randy Mcdaniel,REP,550092,0,0,615,615,
Oklahoma,State Treasurer,Charles De Coune,IND,550092,0,0,478,478,
Oklahoma,Superintendent of Public Instruction,Joy Hofmeister,REP,550092,0,0,553,553,
Oklahoma,Superintendent of Public Instruction,John Cox,DEM,550092,0,0,536,536,
Oklahoma,Superintendent of Public Instruction,Larry Huff,IND,550092,0,0,122,122,
Oklahoma,Commissioner of Labor,Leslie Osborn,REP,550092,0,0,576,576,
Oklahoma,Commissioner of Labor,Fred Dorrell,DEM,550092,0,0,555,555,
Oklahoma,Commissioner of Labor,Brandt Dismukes,IND,550092,0,0,70,70,
Oklahoma,Insurance Commissioner,Glen Mulready,REP,550092,0,0,563,563,
Oklahoma,Insurance Commissioner,Kimberly Fobbs,DEM,550092,0,0,635,635,
Oklahoma,Corporation Commissioner,Bob Anthony,REP,550092,0,0,572,572,
Oklahoma,Corporation Commissioner,Ashley Nicole Mccray,DEM,550092,0,0,555,555,
Oklahoma,Corporation Commissioner,Jackie Short,IND,550092,0,0,84,84,
Oklahoma,U.S. House,Tom Cole,REP,550092,0,0,581,581,4
Oklahoma,U.S. House,Mary Brannon,DEM,550092,0,0,572,572,4
Oklahoma,U.S. House,Ruby Peters,IND,550092,0,0,60,60,4
Oklahoma,State Senate,Brenda Stanley,REP,550092,0,0,552,552,42
Oklahoma,State Senate,Linda Wade,DEM,550092,0,0,585,585,42
Oklahoma,State Senate,Matt Campbell,IND,550092,0,0,77,77,42
Oklahoma,State House,Robert Manger,REP,550092,0,0,538,538,10
Oklahoma,State House,John Carpenter,DEM,550092,0,0,669,669,10
Oklahoma,Governor,Chris Powell,LIB,550093,0,0,19,19,
Oklahoma,Governor,Kevin Stitt,REP,550093,0,0,340,340,
Oklahoma,Governor,Drew Edmondson,DEM,550093,0,0,265,265,
Oklahoma,Lieutenant Governor,Matt Pinnell,REP,550093,0,0,396,396,
Oklahoma,Lieutenant Governor,Anastasia Pittman,DEM,550093,0,0,202,202,
Oklahoma,Lieutenant Governor,Ivan Holmes,IND,550093,0,0,24,24,
Oklahoma,State Auditor,John Yeutter,LIB,550093,0,0,137,137,
Oklahoma,State Auditor,Cindy Byrd,REP,550093,0,0,431,431,
Oklahoma,Attorney General,Mike Hunter,REP,550093,0,0,399,399,
Oklahoma,Attorney General,Mark Myles,DEM,550093,0,0,218,218,
Oklahoma,State Treasurer,Randy Mcdaniel,REP,550093,0,0,406,406,
Oklahoma,State Treasurer,Charles De Coune,IND,550093,0,0,161,161,
Oklahoma,Superintendent of Public Instruction,Joy Hofmeister,REP,550093,0,0,352,352,
Oklahoma,Superintendent of Public Instruction,John Cox,DEM,550093,0,0,209,209,
Oklahoma,Superintendent of Public Instruction,Larry Huff,IND,550093,0,0,57,57,
Oklahoma,Commissioner of Labor,Leslie Osborn,REP,550093,0,0,397,397,
Oklahoma,Commissioner of Labor,Fred Dorrell,DEM,550093,0,0,184,184,
Oklahoma,Commissioner of Labor,Brandt Dismukes,IND,550093,0,0,27,27,
Oklahoma,Insurance Commissioner,Glen Mulready,REP,550093,0,0,381,381,
Oklahoma,Insurance Commissioner,Kimberly Fobbs,DEM,550093,0,0,227,227,
Oklahoma,Corporation Commissioner,Bob Anthony,REP,550093,0,0,371,371,
Oklahoma,Corporation Commissioner,Ashley Nicole Mccray,DEM,550093,0,0,206,206,
Oklahoma,Corporation Commissioner,Jackie Short,IND,550093,0,0,36,36,
Oklahoma,U.S. House,Tom Cole,REP,550093,0,0,406,406,4
Oklahoma,U.S. House,Mary Brannon,DEM,550093,0,0,194,194,4
Oklahoma,U.S. House,Ruby Peters,IND,550093,0,0,18,18,4
Oklahoma,State House,Robert Manger,REP,550093,0,0,376,376,10
Oklahoma,State House,John Carpenter,DEM,550093,0,0,244,244,10
Oklahoma,Governor,Chris Powell,LIB,550094,0,0,44,44,
Oklahoma,Governor,Kevin Stitt,REP,550094,0,0,508,508,
Oklahoma,Governor,Drew Edmondson,DEM,550094,0,0,434,434,
Oklahoma,Lieutenant Governor,Matt Pinnell,REP,550094,0,0,587,587,
Oklahoma,Lieutenant Governor,Anastasia Pittman,DEM,550094,0,0,356,356,
Oklahoma,Lieutenant Governor,Ivan Holmes,IND,550094,0,0,40,40,
Oklahoma,State Auditor,John Yeutter,LIB,550094,0,0,209,209,
Oklahoma,State Auditor,Cindy Byrd,REP,550094,0,0,687,687,
Oklahoma,Attorney General,Mike Hunter,REP,550094,0,0,622,622,
Oklahoma,Attorney General,Mark Myles,DEM,550094,0,0,357,357,
Oklahoma,State Treasurer,Randy Mcdaniel,REP,550094,0,0,633,633,
Oklahoma,State Treasurer,Charles De Coune,IND,550094,0,0,266,266,
Oklahoma,Superintendent of Public Instruction,Joy Hofmeister,REP,550094,0,0,585,585,
Oklahoma,Superintendent of Public Instruction,John Cox,DEM,550094,0,0,293,293,
Oklahoma,Superintendent of Public Instruction,Larry Huff,IND,550094,0,0,97,97,
Oklahoma,Commissioner of Labor,Leslie Osborn,REP,550094,0,0,594,594,
Oklahoma,Commissioner of Labor,Fred Dorrell,DEM,550094,0,0,320,320,
Oklahoma,Commissioner of Labor,Brandt Dismukes,IND,550094,0,0,61,61,
Oklahoma,Insurance Commissioner,Glen Mulready,REP,550094,0,0,598,598,
Oklahoma,Insurance Commissioner,Kimberly Fobbs,DEM,550094,0,0,373,373,
Oklahoma,Corporation Commissioner,Bob Anthony,REP,550094,0,0,563,563,
Oklahoma,Corporation Commissioner,Ashley Nicole Mccray,DEM,550094,0,0,335,335,
Oklahoma,Corporation Commissioner,Jackie Short,IND,550094,0,0,75,75,
Oklahoma,U.S. House,Tom Cole,REP,550094,0,0,615,615,4
Oklahoma,U.S. House,Mary Brannon,DEM,550094,0,0,323,323,4
Oklahoma,U.S. House,Ruby Peters,IND,550094,0,0,41,41,4
Oklahoma,State Senate,Brenda Stanley,REP,550094,0,0,564,564,42
Oklahoma,State Senate,Linda Wade,DEM,550094,0,0,341,341,42
Oklahoma,State Senate,Matt Campbell,IND,550094,0,0,72,72,42
Oklahoma,State House,Robert Manger,REP,550094,0,0,577,577,10
Oklahoma,State House,John Carpenter,DEM,550094,0,0,401,401,10
Oklahoma,Governor,Chris Powell,LIB,550095,0,0,25,25,
Oklahoma,Governor,Kevin Stitt,REP,550095,0,0,395,395,
Oklahoma,Governor,Drew Edmondson,DEM,550095,0,0,328,328,
Oklahoma,Lieutenant Governor,Matt Pinnell,REP,550095,0,0,486,486,
Oklahoma,Lieutenant Governor,Anastasia Pittman,DEM,550095,0,0,228,228,
Oklahoma,Lieutenant Governor,Ivan Holmes,IND,550095,0,0,27,27,
Oklahoma,State Auditor,John Yeutter,LIB,550095,0,0,169,169,
Oklahoma,State Auditor,Cindy Byrd,REP,550095,0,0,507,507,
Oklahoma,Attorney General,Mike Hunter,REP,550095,0,0,492,492,
Oklahoma,Attorney General,Mark Myles,DEM,550095,0,0,249,249,
Oklahoma,State Treasurer,Randy Mcdaniel,REP,550095,0,0,496,496,
Oklahoma,State Treasurer,Charles De Coune,IND,550095,0,0,182,182,
Oklahoma,Superintendent of Public Instruction,Joy Hofmeister,REP,550095,0,0,454,454,
Oklahoma,Superintendent of Public Instruction,John Cox,DEM,550095,0,0,216,216,
Oklahoma,Superintendent of Public Instruction,Larry Huff,IND,550095,0,0,65,65,
Oklahoma,Commissioner of Labor,Leslie Osborn,REP,550095,0,0,463,463,
Oklahoma,Commissioner of Labor,Fred Dorrell,DEM,550095,0,0,232,232,
Oklahoma,Commissioner of Labor,Brandt Dismukes,IND,550095,0,0,31,31,
Oklahoma,Insurance Commissioner,Glen Mulready,REP,550095,0,0,461,461,
Oklahoma,Insurance Commissioner,Kimberly Fobbs,DEM,550095,0,0,266,266,
Oklahoma,Corporation Commissioner,Bob Anthony,REP,550095,0,0,467,467,
Oklahoma,Corporation Commissioner,Ashley Nicole Mccray,DEM,550095,0,0,228,228,
Oklahoma,Corporation Commissioner,Jackie Short,IND,550095,0,0,37,37,
Oklahoma,U.S. House,Tom Cole,REP,550095,0,0,488,488,4
Oklahoma,U.S. House,Mary Brannon,DEM,550095,0,0,231,231,4
Oklahoma,U.S. House,Ruby Peters,IND,550095,0,0,23,23,4
Oklahoma,State Senate,Brenda Stanley,REP,550095,0,0,465,465,42
Oklahoma,State Senate,Linda Wade,DEM,550095,0,0,228,228,42
Oklahoma,State Senate,Matt Campbell,IND,550095,0,0,41,41,42
Oklahoma,State House,Robert Manger,REP,550095,0,0,443,443,10
Oklahoma,State House,John Carpenter,DEM,550095,0,0,290,290,10
Oklahoma,Governor,Chris Powell,LIB,550096,0,0,49,49,
Oklahoma,Governor,Kevin Stitt,REP,550096,0,0,431,431,
Oklahoma,Governor,Drew Edmondson,DEM,550096,0,0,503,503,
Oklahoma,Lieutenant Governor,Matt Pinnell,REP,550096,0,0,480,480,
Oklahoma,Lieutenant Governor,Anastasia Pittman,DEM,550096,0,0,439,439,
Oklahoma,Lieutenant Governor,Ivan Holmes,IND,550096,0,0,58,58,
Oklahoma,State Auditor,John Yeutter,LIB,550096,0,0,304,304,
Oklahoma,State Auditor,Cindy Byrd,REP,550096,0,0,592,592,
Oklahoma,Attorney General,Mike Hunter,REP,550096,0,0,516,516,
Oklahoma,Attorney General,Mark Myles,DEM,550096,0,0,450,450,
Oklahoma,State Treasurer,Randy Mcdaniel,REP,550096,0,0,534,534,
Oklahoma,State Treasurer,Charles De Coune,IND,550096,0,0,364,364,
Oklahoma,Superintendent of Public Instruction,Joy Hofmeister,REP,550096,0,0,489,489,
Oklahoma,Superintendent of Public Instruction,John Cox,DEM,550096,0,0,393,393,
Oklahoma,Superintendent of Public Instruction,Larry Huff,IND,550096,0,0,89,89,
Oklahoma,Commissioner of Labor,Leslie Osborn,REP,550096,0,0,505,505,
Oklahoma,Commissioner of Labor,Fred Dorrell,DEM,550096,0,0,402,402,
Oklahoma,Commissioner of Labor,Brandt Dismukes,IND,550096,0,0,55,55,
Oklahoma,Insurance Commissioner,Glen Mulready,REP,550096,0,0,503,503,
Oklahoma,Insurance Commissioner,Kimberly Fobbs,DEM,550096,0,0,456,456,
Oklahoma,Corporation Commissioner,Bob Anthony,REP,550096,0,0,472,472,
Oklahoma,Corporation Commissioner,Ashley Nicole Mccray,DEM,550096,0,0,426,426,
Oklahoma,Corporation Commissioner,Jackie Short,IND,550096,0,0,67,67,
Oklahoma,U.S. House,Tom Cole,REP,550096,0,0,504,504,4
Oklahoma,U.S. House,Mary Brannon,DEM,550096,0,0,422,422,4
Oklahoma,U.S. House,Ruby Peters,IND,550096,0,0,46,46,4
Oklahoma,State Senate,Brenda Stanley,REP,550096,0,0,474,474,42
Oklahoma,State Senate,Linda Wade,DEM,550096,0,0,419,419,42
Oklahoma,State Senate,Matt Campbell,IND,550096,0,0,76,76,42
Oklahoma,State House,Robert Manger,REP,550096,0,0,480,480,10
Oklahoma,State House,John Carpenter,DEM,550096,0,0,481,481,10
Oklahoma,Governor,Chris Powell,LIB,550097,0,0,25,25,
Oklahoma,Governor,Kevin Stitt,REP,550097,0,0,318,318,
Oklahoma,Governor,Drew Edmondson,DEM,550097,0,0,345,345,
Oklahoma,Lieutenant Governor,Matt Pinnell,REP,550097,0,0,351,351,
Oklahoma,Lieutenant Governor,Anastasia Pittman,DEM,550097,0,0,302,302,
Oklahoma,Lieutenant Governor,Ivan Holmes,IND,550097,0,0,28,28,
Oklahoma,State Auditor,John Yeutter,LIB,550097,0,0,189,189,
Oklahoma,State Auditor,Cindy Byrd,REP,550097,0,0,427,427,
Oklahoma,Attorney General,Mike Hunter,REP,550097,0,0,396,396,
Oklahoma,Attorney General,Mark Myles,DEM,550097,0,0,284,284,
Oklahoma,State Treasurer,Randy Mcdaniel,REP,550097,0,0,385,385,
Oklahoma,State Treasurer,Charles De Coune,IND,550097,0,0,223,223,
Oklahoma,Superintendent of Public Instruction,Joy Hofmeister,REP,550097,0,0,342,342,
Oklahoma,Superintendent of Public Instruction,John Cox,DEM,550097,0,0,275,275,
Oklahoma,Superintendent of Public Instruction,Larry Huff,IND,550097,0,0,66,66,
Oklahoma,Commissioner of Labor,Leslie Osborn,REP,550097,0,0,362,362,
Oklahoma,Commissioner of Labor,Fred Dorrell,DEM,550097,0,0,274,274,
Oklahoma,Commissioner of Labor,Brandt Dismukes,IND,550097,0,0,46,46,
Oklahoma,Insurance Commissioner,Glen Mulready,REP,550097,0,0,357,357,
Oklahoma,Insurance Commissioner,Kimberly Fobbs,DEM,550097,0,0,321,321,
Oklahoma,Corporation Commissioner,Bob Anthony,REP,550097,0,0,350,350,
Oklahoma,Corporation Commissioner,Ashley Nicole Mccray,DEM,550097,0,0,279,279,
Oklahoma,Corporation Commissioner,Jackie Short,IND,550097,0,0,51,51,
Oklahoma,U.S. House,Tom Cole,REP,550097,0,0,382,382,4
Oklahoma,U.S. House,Mary Brannon,DEM,550097,0,0,276,276,4
Oklahoma,U.S. House,Ruby Peters,IND,550097,0,0,25,25,4
Oklahoma,State Senate,Brenda Stanley,REP,550097,0,0,353,353,42
Oklahoma,State Senate,Linda Wade,DEM,550097,0,0,283,283,42
Oklahoma,State Senate,Matt Campbell,IND,550097,0,0,44,44,42
Oklahoma,State House,Robert Manger,REP,550097,0,0,349,349,10
Oklahoma,State House,John Carpenter,DEM,550097,0,0,329,329,10
Oklahoma,Governor,Chris Powell,LIB,550098,0,0,54,54,
Oklahoma,Governor,Kevin Stitt,REP,550098,0,0,754,754,
Oklahoma,Governor,Drew Edmondson,DEM,550098,0,0,585,585,
Oklahoma,Lieutenant Governor,Matt Pinnell,REP,550098,0,0,881,881,
Oklahoma,Lieutenant Governor,Anastasia Pittman,DEM,550098,0,0,447,447,
Oklahoma,Lieutenant Governor,Ivan Holmes,IND,550098,0,0,54,54,
Oklahoma,State Auditor,John Yeutter,LIB,550098,0,0,318,318,
Oklahoma,State Auditor,Cindy Byrd,REP,550098,0,0,975,975,
Oklahoma,Attorney General,Mike Hunter,REP,550098,0,0,911,911,
Oklahoma,Attorney General,Mark Myles,DEM,550098,0,0,459,459,
Oklahoma,State Treasurer,Randy Mcdaniel,REP,550098,0,0,916,916,
Oklahoma,State Treasurer,Charles De Coune,IND,550098,0,0,366,366,
Oklahoma,Superintendent of Public Instruction,Joy Hofmeister,REP,550098,0,0,830,830,
Oklahoma,Superintendent of Public Instruction,John Cox,DEM,550098,0,0,418,418,
Oklahoma,Superintendent of Public Instruction,Larry Huff,IND,550098,0,0,131,131,
Oklahoma,Commissioner of Labor,Leslie Osborn,REP,550098,0,0,877,877,
Oklahoma,Commissioner of Labor,Fred Dorrell,DEM,550098,0,0,401,401,
Oklahoma,Commissioner of Labor,Brandt Dismukes,IND,550098,0,0,81,81,
Oklahoma,Insurance Commissioner,Glen Mulready,REP,550098,0,0,877,877,
Oklahoma,Insurance Commissioner,Kimberly Fobbs,DEM,550098,0,0,473,473,
Oklahoma,Corporation Commissioner,Bob Anthony,REP,550098,0,0,841,841,
Oklahoma,Corporation Commissioner,Ashley Nicole Mccray,DEM,550098,0,0,439,439,
Oklahoma,Corporation Commissioner,Jackie Short,IND,550098,0,0,87,87,
Oklahoma,U.S. House,Tom Cole,REP,550098,0,0,895,895,4
Oklahoma,U.S. House,Mary Brannon,DEM,550098,0,0,436,436,4
Oklahoma,U.S. House,Ruby Peters,IND,550098,0,0,49,49,4
Oklahoma,State Senate,Brenda Stanley,REP,550098,0,0,890,890,42
Oklahoma,State Senate,Linda Wade,DEM,550098,0,0,409,409,42
Oklahoma,State Senate,Matt Campbell,IND,550098,0,0,69,69,42
Oklahoma,State House,Robert Manger,REP,550098,0,0,879,879,10
Oklahoma,State House,John Carpenter,DEM,550098,0,0,495,495,10
Oklahoma,Governor,Chris Powell,LIB,550099,0,0,19,19,
Oklahoma,Governor,Kevin Stitt,REP,550099,0,0,460,460,
Oklahoma,Governor,Drew Edmondson,DEM,550099,0,0,470,470,
Oklahoma,Lieutenant Governor,Matt Pinnell,REP,550099,0,0,561,561,
Oklahoma,Lieutenant Governor,Anastasia Pittman,DEM,550099,0,0,342,342,
Oklahoma,Lieutenant Governor,Ivan Holmes,IND,550099,0,0,33,33,
Oklahoma,State Auditor,John Yeutter,LIB,550099,0,0,171,171,
Oklahoma,State Auditor,Cindy Byrd,REP,550099,0,0,669,669,
Oklahoma,Attorney General,Mike Hunter,REP,550099,0,0,599,599,
Oklahoma,Attorney General,Mark Myles,DEM,550099,0,0,330,330,
Oklahoma,State Treasurer,Randy Mcdaniel,REP,550099,0,0,651,651,
Oklahoma,State Treasurer,Charles De Coune,IND,550099,0,0,205,205,
Oklahoma,Superintendent of Public Instruction,Joy Hofmeister,REP,550099,0,0,576,576,
Oklahoma,Superintendent of Public Instruction,John Cox,DEM,550099,0,0,295,295,
Oklahoma,Superintendent of Public Instruction,Larry Huff,IND,550099,0,0,56,56,
Oklahoma,Commissioner of Labor,Leslie Osborn,REP,550099,0,0,613,613,
Oklahoma,Commissioner of Labor,Fred Dorrell,DEM,550099,0,0,269,269,
Oklahoma,Commissioner of Labor,Brandt Dismukes,IND,550099,0,0,28,28,
Oklahoma,Insurance Commissioner,Glen Mulready,REP,550099,0,0,558,558,
Oklahoma,Insurance Commissioner,Kimberly Fobbs,DEM,550099,0,0,345,345,
Oklahoma,Corporation Commissioner,Bob Anthony,REP,550099,0,0,603,603,
Oklahoma,Corporation Commissioner,Ashley Nicole Mccray,DEM,550099,0,0,287,287,
Oklahoma,Corporation Commissioner,Jackie Short,IND,550099,0,0,34,34,
Oklahoma,U.S. House,Steve Russell,REP,550099,0,0,521,521,5
Oklahoma,U.S. House,Kendra Horn,DEM,550099,0,0,421,421,5
Oklahoma,State Senate,Joe Howell,REP,550099,0,0,485,485,40
Oklahoma,State Senate,Carri Hicks,DEM,550099,0,0,416,416,40
Oklahoma,State Senate,Christopher Hensley,IND,550099,0,0,27,27,40
Oklahoma,State House,Stephen Paulsen,LIB,550099,0,0,25,25,85
Oklahoma,State House,Matt Jackson,REP,550099,0,0,429,429,85
Oklahoma,State House,Cyndi Munson,DEM,550099,0,0,483,483,85
Oklahoma,Governor,Chris Powell,LIB,550100,0,0,26,26,
Oklahoma,Governor,Kevin Stitt,REP,550100,0,0,585,585,
Oklahoma,Governor,Drew Edmondson,DEM,550100,0,0,461,461,
Oklahoma,Lieutenant Governor,Matt Pinnell,REP,550100,0,0,692,692,
Oklahoma,Lieutenant Governor,Anastasia Pittman,DEM,550100,0,0,330,330,
Oklahoma,Lieutenant Governor,Ivan Holmes,IND,550100,0,0,34,34,
Oklahoma,State Auditor,John Yeutter,LIB,550100,0,0,129,129,
Oklahoma,State Auditor,Cindy Byrd,REP,550100,0,0,837,837,
Oklahoma,Attorney General,Mike Hunter,REP,550100,0,0,747,747,
Oklahoma,Attorney General,Mark Myles,DEM,550100,0,0,300,300,
Oklahoma,State Treasurer,Randy Mcdaniel,REP,550100,0,0,838,838,
Oklahoma,State Treasurer,Charles De Coune,IND,550100,0,0,157,157,
Oklahoma,Superintendent of Public Instruction,Joy Hofmeister,REP,550100,0,0,700,700,
Oklahoma,Superintendent of Public Instruction,John Cox,DEM,550100,0,0,291,291,
Oklahoma,Superintendent of Public Instruction,Larry Huff,IND,550100,0,0,55,55,
Oklahoma,Commissioner of Labor,Leslie Osborn,REP,550100,0,0,727,727,
Oklahoma,Commissioner of Labor,Fred Dorrell,DEM,550100,0,0,252,252,
Oklahoma,Commissioner of Labor,Brandt Dismukes,IND,550100,0,0,27,27,
Oklahoma,Insurance Commissioner,Glen Mulready,REP,550100,0,0,686,686,
Oklahoma,Insurance Commissioner,Kimberly Fobbs,DEM,550100,0,0,326,326,
Oklahoma,Corporation Commissioner,Bob Anthony,REP,550100,0,0,751,751,
Oklahoma,Corporation Commissioner,Ashley Nicole Mccray,DEM,550100,0,0,255,255,
Oklahoma,Corporation Commissioner,Jackie Short,IND,550100,0,0,42,42,
Oklahoma,U.S. House,Steve Russell,REP,550100,0,0,656,656,5
Oklahoma,U.S. House,Kendra Horn,DEM,550100,0,0,398,398,5
Oklahoma,State Senate,Joe Howell,REP,550100,0,0,597,597,40
Oklahoma,State Senate,Carri Hicks,DEM,550100,0,0,414,414,40
Oklahoma,State Senate,Christopher Hensley,IND,550100,0,0,24,24,40
Oklahoma,State House,Jason Reese,REP,550100,0,0,654,654,83
Oklahoma,State House,Chelsey Branham,DEM,550100,0,0,371,371,83
Oklahoma,Governor,Chris Powell,LIB,550101,0,0,9,9,
Oklahoma,Governor,Kevin Stitt,REP,550101,0,0,246,246,
Oklahoma,Governor,Drew Edmondson,DEM,550101,0,0,173,173,
Oklahoma,Lieutenant Governor,Matt Pinnell,REP,550101,0,0,305,305,
Oklahoma,Lieutenant Governor,Anastasia Pittman,DEM,550101,0,0,107,107,
Oklahoma,Lieutenant Governor,Ivan Holmes,IND,550101,0,0,12,12,
Oklahoma,State Auditor,John Yeutter,LIB,550101,0,0,58,58,
Oklahoma,State Auditor,Cindy Byrd,REP,550101,0,0,325,325,
Oklahoma,Attorney General,Mike Hunter,REP,550101,0,0,325,325,
Oklahoma,Attorney General,Mark Myles,DEM,550101,0,0,102,102,
Oklahoma,State Treasurer,Randy Mcdaniel,REP,550101,0,0,335,335,
Oklahoma,State Treasurer,Charles De Coune,IND,550101,0,0,63,63,
Oklahoma,Superintendent of Public Instruction,Joy Hofmeister,REP,550101,0,0,285,285,
Oklahoma,Superintendent of Public Instruction,John Cox,DEM,550101,0,0,105,105,
Oklahoma,Superintendent of Public Instruction,Larry Huff,IND,550101,0,0,28,28,
Oklahoma,Commissioner of Labor,Leslie Osborn,REP,550101,0,0,301,301,
Oklahoma,Commissioner of Labor,Fred Dorrell,DEM,550101,0,0,97,97,
Oklahoma,Commissioner of Labor,Brandt Dismukes,IND,550101,0,0,11,11,
Oklahoma,Insurance Commissioner,Glen Mulready,REP,550101,0,0,296,296,
Oklahoma,Insurance Commissioner,Kimberly Fobbs,DEM,550101,0,0,111,111,
Oklahoma,Corporation Commissioner,Bob Anthony,REP,550101,0,0,313,313,
Oklahoma,Corporation Commissioner,Ashley Nicole Mccray,DEM,550101,0,0,87,87,
Oklahoma,Corporation Commissioner,Jackie Short,IND,550101,0,0,22,22,
Oklahoma,U.S. House,Steve Russell,REP,550101,0,0,281,281,5
Oklahoma,U.S. House,Kendra Horn,DEM,550101,0,0,146,146,5
Oklahoma,State Senate,Joe Howell,REP,550101,0,0,263,263,40
Oklahoma,State Senate,Carri Hicks,DEM,550101,0,0,139,139,40
Oklahoma,State Senate,Christopher Hensley,IND,550101,0,0,14,14,40
Oklahoma,State House,Jason Reese,REP,550101,0,0,283,283,83
Oklahoma,State House,Chelsey Branham,DEM,550101,0,0,137,137,83
Oklahoma,Governor,Chris Powell,LIB,550102,0,0,34,34,
Oklahoma,Governor,Kevin Stitt,REP,550102,0,0,571,571,
Oklahoma,Governor,Drew Edmondson,DEM,550102,0,0,582,582,
Oklahoma,Lieutenant Governor,Matt Pinnell,REP,550102,0,0,710,710,
Oklahoma,Lieutenant Governor,Anastasia Pittman,DEM,550102,0,0,430,430,
Oklahoma,Lieutenant Governor,Ivan Holmes,IND,550102,0,0,38,38,
Oklahoma,State Auditor,John Yeutter,LIB,550102,0,0,242,242,
Oklahoma,State Auditor,Cindy Byrd,REP,550102,0,0,826,826,
Oklahoma,Attorney General,Mike Hunter,REP,550102,0,0,746,746,
Oklahoma,Attorney General,Mark Myles,DEM,550102,0,0,424,424,
Oklahoma,State Treasurer,Randy Mcdaniel,REP,550102,0,0,778,778,
Oklahoma,State Treasurer,Charles De Coune,IND,550102,0,0,301,301,
Oklahoma,Superintendent of Public Instruction,Joy Hofmeister,REP,550102,0,0,690,690,
Oklahoma,Superintendent of Public Instruction,John Cox,DEM,550102,0,0,377,377,
Oklahoma,Superintendent of Public Instruction,Larry Huff,IND,550102,0,0,88,88,
Oklahoma,Commissioner of Labor,Leslie Osborn,REP,550102,0,0,749,749,
Oklahoma,Commissioner of Labor,Fred Dorrell,DEM,550102,0,0,342,342,
Oklahoma,Commissioner of Labor,Brandt Dismukes,IND,550102,0,0,50,50,
Oklahoma,Insurance Commissioner,Glen Mulready,REP,550102,0,0,677,677,
Oklahoma,Insurance Commissioner,Kimberly Fobbs,DEM,550102,0,0,455,455,
Oklahoma,Corporation Commissioner,Bob Anthony,REP,550102,0,0,713,713,
Oklahoma,Corporation Commissioner,Ashley Nicole Mccray,DEM,550102,0,0,378,378,
Oklahoma,Corporation Commissioner,Jackie Short,IND,550102,0,0,66,66,
Oklahoma,U.S. House,Steve Russell,REP,550102,0,0,634,634,5
Oklahoma,U.S. House,Kendra Horn,DEM,550102,0,0,541,541,5
Oklahoma,State Senate,Joe Howell,REP,550102,0,0,613,613,40
Oklahoma,State Senate,Carri Hicks,DEM,550102,0,0,519,519,40
Oklahoma,State Senate,Christopher Hensley,IND,550102,0,0,33,33,40
Oklahoma,State House,Stephen Paulsen,LIB,550102,0,0,39,39,85
Oklahoma,State House,Matt Jackson,REP,550102,0,0,557,557,85
Oklahoma,State House,Cyndi Munson,DEM,550102,0,0,574,574,85
Oklahoma,Governor,Chris Powell,LIB,550103,0,0,28,28,
Oklahoma,Governor,Kevin Stitt,REP,550103,0,0,265,265,
Oklahoma,Governor,Drew Edmondson,DEM,550103,0,0,454,454,
Oklahoma,Lieutenant Governor,Matt Pinnell,REP,550103,0,0,313,313,
Oklahoma,Lieutenant Governor,Anastasia Pittman,DEM,550103,0,0,392,392,
Oklahoma,Lieutenant Governor,Ivan Holmes,IND,550103,0,0,35,35,
Oklahoma,State Auditor,John Yeutter,LIB,550103,0,0,264,264,
Oklahoma,State Auditor,Cindy Byrd,REP,550103,0,0,401,401,
Oklahoma,Attorney General,Mike Hunter,REP,550103,0,0,340,340,
Oklahoma,Attorney General,Mark Myles,DEM,550103,0,0,399,399,
Oklahoma,State Treasurer,Randy Mcdaniel,REP,550103,0,0,372,372,
Oklahoma,State Treasurer,Charles De Coune,IND,550103,0,0,298,298,
Oklahoma,Superintendent of Public Instruction,Joy Hofmeister,REP,550103,0,0,326,326,
Oklahoma,Superintendent of Public Instruction,John Cox,DEM,550103,0,0,344,344,
Oklahoma,Superintendent of Public Instruction,Larry Huff,IND,550103,0,0,62,62,
Oklahoma,Commissioner of Labor,Leslie Osborn,REP,550103,0,0,326,326,
Oklahoma,Commissioner of Labor,Fred Dorrell,DEM,550103,0,0,351,351,
Oklahoma,Commissioner of Labor,Brandt Dismukes,IND,550103,0,0,43,43,
Oklahoma,Insurance Commissioner,Glen Mulready,REP,550103,0,0,319,319,
Oklahoma,Insurance Commissioner,Kimberly Fobbs,DEM,550103,0,0,403,403,
Oklahoma,Corporation Commissioner,Bob Anthony,REP,550103,0,0,318,318,
Oklahoma,Corporation Commissioner,Ashley Nicole Mccray,DEM,550103,0,0,360,360,
Oklahoma,Corporation Commissioner,Jackie Short,IND,550103,0,0,49,49,
Oklahoma,U.S. House,Steve Russell,REP,550103,0,0,282,282,5
Oklahoma,U.S. House,Kendra Horn,DEM,550103,0,0,457,457,5
Oklahoma,State Senate,Joe Howell,REP,550103,0,0,261,261,40
Oklahoma,State Senate,Carri Hicks,DEM,550103,0,0,446,446,40
Oklahoma,State Senate,Christopher Hensley,IND,550103,0,0,24,24,40
Oklahoma,State House,Jason Reese,REP,550103,0,0,290,290,83
Oklahoma,State House,Chelsey Branham,DEM,550103,0,0,443,443,83
Oklahoma,Governor,Chris Powell,LIB,550104,0,0,18,18,
Oklahoma,Governor,Kevin Stitt,REP,550104,0,0,175,175,
Oklahoma,Governor,Drew Edmondson,DEM,550104,0,0,421,421,
Oklahoma,Lieutenant Governor,Matt Pinnell,REP,550104,0,0,229,229,
Oklahoma,Lieutenant Governor,Anastasia Pittman,DEM,550104,0,0,360,360,
Oklahoma,Lieutenant Governor,Ivan Holmes,IND,550104,0,0,23,23,
Oklahoma,State Auditor,John Yeutter,LIB,550104,0,0,227,227,
Oklahoma,State Auditor,Cindy Byrd,REP,550104,0,0,322,322,
Oklahoma,Attorney General,Mike Hunter,REP,550104,0,0,262,262,
Oklahoma,Attorney General,Mark Myles,DEM,550104,0,0,347,347,
Oklahoma,State Treasurer,Randy Mcdaniel,REP,550104,0,0,275,275,
Oklahoma,State Treasurer,Charles De Coune,IND,550104,0,0,270,270,
Oklahoma,Superintendent of Public Instruction,Joy Hofmeister,REP,550104,0,0,241,241,
Oklahoma,Superintendent of Public Instruction,John Cox,DEM,550104,0,0,319,319,
Oklahoma,Superintendent of Public Instruction,Larry Huff,IND,550104,0,0,53,53,
Oklahoma,Commissioner of Labor,Leslie Osborn,REP,550104,0,0,253,253,
Oklahoma,Commissioner of Labor,Fred Dorrell,DEM,550104,0,0,307,307,
Oklahoma,Commissioner of Labor,Brandt Dismukes,IND,550104,0,0,42,42,
Oklahoma,Insurance Commissioner,Glen Mulready,REP,550104,0,0,228,228,
Oklahoma,Insurance Commissioner,Kimberly Fobbs,DEM,550104,0,0,376,376,
Oklahoma,Corporation Commissioner,Bob Anthony,REP,550104,0,0,239,239,
Oklahoma,Corporation Commissioner,Ashley Nicole Mccray,DEM,550104,0,0,327,327,
Oklahoma,Corporation Commissioner,Jackie Short,IND,550104,0,0,44,44,
Oklahoma,U.S. House,Steve Russell,REP,550104,0,0,216,216,5
Oklahoma,U.S. House,Kendra Horn,DEM,550104,0,0,396,396,5
Oklahoma,State Senate,John Symcox,REP,550104,0,0,213,213,30
Oklahoma,State Senate,Julia Kirt,DEM,550104,0,0,398,398,30
Oklahoma,State House,Jason Reese,REP,550104,0,0,200,200,83
Oklahoma,State House,Chelsey Branham,DEM,550104,0,0,407,407,83
Oklahoma,Governor,Chris Powell,LIB,550105,0,0,21,21,
Oklahoma,Governor,Kevin Stitt,REP,550105,0,0,401,401,
Oklahoma,Governor,Drew Edmondson,DEM,550105,0,0,480,480,
Oklahoma,Lieutenant Governor,Matt Pinnell,REP,550105,0,0,487,487,
Oklahoma,Lieutenant Governor,Anastasia Pittman,DEM,550105,0,0,364,364,
Oklahoma,Lieutenant Governor,Ivan Holmes,IND,550105,0,0,44,44,
Oklahoma,State Auditor,John Yeutter,LIB,550105,0,0,226,226,
Oklahoma,State Auditor,Cindy Byrd,REP,550105,0,0,590,590,
Oklahoma,Attorney General,Mike Hunter,REP,550105,0,0,513,513,
Oklahoma,Attorney General,Mark Myles,DEM,550105,0,0,369,369,
Oklahoma,State Treasurer,Randy Mcdaniel,REP,550105,0,0,526,526,
Oklahoma,State Treasurer,Charles De Coune,IND,550105,0,0,287,287,
Oklahoma,Superintendent of Public Instruction,Joy Hofmeister,REP,550105,0,0,488,488,
Oklahoma,Superintendent of Public Instruction,John Cox,DEM,550105,0,0,335,335,
Oklahoma,Superintendent of Public Instruction,Larry Huff,IND,550105,0,0,69,69,
Oklahoma,Commissioner of Labor,Leslie Osborn,REP,550105,0,0,505,505,
Oklahoma,Commissioner of Labor,Fred Dorrell,DEM,550105,0,0,328,328,
Oklahoma,Commissioner of Labor,Brandt Dismukes,IND,550105,0,0,46,46,
Oklahoma,Insurance Commissioner,Glen Mulready,REP,550105,0,0,479,479,
Oklahoma,Insurance Commissioner,Kimberly Fobbs,DEM,550105,0,0,396,396,
Oklahoma,Corporation Commissioner,Bob Anthony,REP,550105,0,0,484,484,
Oklahoma,Corporation Commissioner,Ashley Nicole Mccray,DEM,550105,0,0,341,341,
Oklahoma,Corporation Commissioner,Jackie Short,IND,550105,0,0,50,50,
Oklahoma,U.S. House,Steve Russell,REP,550105,0,0,446,446,5
Oklahoma,U.S. House,Kendra Horn,DEM,550105,0,0,448,448,5
Oklahoma,State Senate,John Symcox,REP,550105,0,0,441,441,30
Oklahoma,State Senate,Julia Kirt,DEM,550105,0,0,453,453,30
Oklahoma,State House,Jason Reese,REP,550105,0,0,425,425,83
Oklahoma,State House,Chelsey Branham,DEM,550105,0,0,461,461,83
Oklahoma,Governor,Chris Powell,LIB,550106,0,0,31,31,
Oklahoma,Governor,Kevin Stitt,REP,550106,0,0,445,445,
Oklahoma,Governor,Drew Edmondson,DEM,550106,0,0,565,565,
Oklahoma,Lieutenant Governor,Matt Pinnell,REP,550106,0,0,559,559,
Oklahoma,Lieutenant Governor,Anastasia Pittman,DEM,550106,0,0,432,432,
Oklahoma,Lieutenant Governor,Ivan Holmes,IND,550106,0,0,41,41,
Oklahoma,State Auditor,John Yeutter,LIB,550106,0,0,256,256,
Oklahoma,State Auditor,Cindy Byrd,REP,550106,0,0,680,680,
Oklahoma,Attorney General,Mike Hunter,REP,550106,0,0,573,573,
Oklahoma,Attorney General,Mark Myles,DEM,550106,0,0,445,445,
Oklahoma,State Treasurer,Randy Mcdaniel,REP,550106,0,0,624,624,
Oklahoma,State Treasurer,Charles De Coune,IND,550106,0,0,317,317,
Oklahoma,Superintendent of Public Instruction,Joy Hofmeister,REP,550106,0,0,557,557,
Oklahoma,Superintendent of Public Instruction,John Cox,DEM,550106,0,0,385,385,
Oklahoma,Superintendent of Public Instruction,Larry Huff,IND,550106,0,0,74,74,
Oklahoma,Commissioner of Labor,Leslie Osborn,REP,550106,0,0,590,590,
Oklahoma,Commissioner of Labor,Fred Dorrell,DEM,550106,0,0,374,374,
Oklahoma,Commissioner of Labor,Brandt Dismukes,IND,550106,0,0,39,39,
Oklahoma,Insurance Commissioner,Glen Mulready,REP,550106,0,0,552,552,
Oklahoma,Insurance Commissioner,Kimberly Fobbs,DEM,550106,0,0,451,451,
Oklahoma,Corporation Commissioner,Bob Anthony,REP,550106,0,0,559,559,
Oklahoma,Corporation Commissioner,Ashley Nicole Mccray,DEM,550106,0,0,400,400,
Oklahoma,Corporation Commissioner,Jackie Short,IND,550106,0,0,52,52,
Oklahoma,U.S. House,Steve Russell,REP,550106,0,0,513,513,5
Oklahoma,U.S. House,Kendra Horn,DEM,550106,0,0,518,518,5
Oklahoma,State Senate,John Symcox,REP,550106,0,0,505,505,30
Oklahoma,State Senate,Julia Kirt,DEM,550106,0,0,517,517,30
Oklahoma,State House,Stephen Paulsen,LIB,550106,0,0,24,24,85
Oklahoma,State House,Matt Jackson,REP,550106,0,0,442,442,85
Oklahoma,State House,Cyndi Munson,DEM,550106,0,0,564,564,85
Oklahoma,Governor,Chris Powell,LIB,550107,0,0,23,23,
Oklahoma,Governor,Kevin Stitt,REP,550107,0,0,204,204,
Oklahoma,Governor,Drew Edmondson,DEM,550107,0,0,127,127,
Oklahoma,Lieutenant Governor,Matt Pinnell,REP,550107,0,0,224,224,
Oklahoma,Lieutenant Governor,Anastasia Pittman,DEM,550107,0,0,120,120,
Oklahoma,Lieutenant Governor,Ivan Holmes,IND,550107,0,0,11,11,
Oklahoma,State Auditor,John Yeutter,LIB,550107,0,0,81,81,
Oklahoma,State Auditor,Cindy Byrd,REP,550107,0,0,250,250,
Oklahoma,Attorney General,Mike Hunter,REP,550107,0,0,245,245,
Oklahoma,Attorney General,Mark Myles,DEM,550107,0,0,108,108,
Oklahoma,State Treasurer,Randy Mcdaniel,REP,550107,0,0,246,246,
Oklahoma,State Treasurer,Charles De Coune,IND,550107,0,0,88,88,
Oklahoma,Superintendent of Public Instruction,Joy Hofmeister,REP,550107,0,0,213,213,
Oklahoma,Superintendent of Public Instruction,John Cox,DEM,550107,0,0,94,94,
Oklahoma,Superintendent of Public Instruction,Larry Huff,IND,550107,0,0,47,47,
Oklahoma,Commissioner of Labor,Leslie Osborn,REP,550107,0,0,229,229,
Oklahoma,Commissioner of Labor,Fred Dorrell,DEM,550107,0,0,95,95,
Oklahoma,Commissioner of Labor,Brandt Dismukes,IND,550107,0,0,29,29,
Oklahoma,Insurance Commissioner,Glen Mulready,REP,550107,0,0,229,229,
Oklahoma,Insurance Commissioner,Kimberly Fobbs,DEM,550107,0,0,121,121,
Oklahoma,Corporation Commissioner,Bob Anthony,REP,550107,0,0,225,225,
Oklahoma,Corporation Commissioner,Ashley Nicole Mccray,DEM,550107,0,0,98,98,
Oklahoma,Corporation Commissioner,Jackie Short,IND,550107,0,0,28,28,
Oklahoma,U.S. House,Steve Russell,REP,550107,0,0,228,228,5
Oklahoma,U.S. House,Kendra Horn,DEM,550107,0,0,126,126,5
Oklahoma,State House,Lewis Moore,REP,550107,0,0,210,210,96
Oklahoma,State House,Kathy Wallis,DEM,550107,0,0,143,143,96
Oklahoma,Governor,Chris Powell,LIB,550108,0,0,5,5,
Oklahoma,Governor,Kevin Stitt,REP,550108,0,0,157,157,
Oklahoma,Governor,Drew Edmondson,DEM,550108,0,0,112,112,
Oklahoma,Lieutenant Governor,Matt Pinnell,REP,550108,0,0,185,185,
Oklahoma,Lieutenant Governor,Anastasia Pittman,DEM,550108,0,0,81,81,
Oklahoma,Lieutenant Governor,Ivan Holmes,IND,550108,0,0,6,6,
Oklahoma,State Auditor,John Yeutter,LIB,550108,0,0,48,48,
Oklahoma,State Auditor,Cindy Byrd,REP,550108,0,0,206,206,
Oklahoma,Attorney General,Mike Hunter,REP,550108,0,0,194,194,
Oklahoma,Attorney General,Mark Myles,DEM,550108,0,0,79,79,
Oklahoma,State Treasurer,Randy Mcdaniel,REP,550108,0,0,192,192,
Oklahoma,State Treasurer,Charles De Coune,IND,550108,0,0,63,63,
Oklahoma,Superintendent of Public Instruction,Joy Hofmeister,REP,550108,0,0,182,182,
Oklahoma,Superintendent of Public Instruction,John Cox,DEM,550108,0,0,72,72,
Oklahoma,Superintendent of Public Instruction,Larry Huff,IND,550108,0,0,20,20,
Oklahoma,Commissioner of Labor,Leslie Osborn,REP,550108,0,0,187,187,
Oklahoma,Commissioner of Labor,Fred Dorrell,DEM,550108,0,0,72,72,
Oklahoma,Commissioner of Labor,Brandt Dismukes,IND,550108,0,0,10,10,
Oklahoma,Insurance Commissioner,Glen Mulready,REP,550108,0,0,182,182,
Oklahoma,Insurance Commissioner,Kimberly Fobbs,DEM,550108,0,0,88,88,
Oklahoma,Corporation Commissioner,Bob Anthony,REP,550108,0,0,181,181,
Oklahoma,Corporation Commissioner,Ashley Nicole Mccray,DEM,550108,0,0,75,75,
Oklahoma,Corporation Commissioner,Jackie Short,IND,550108,0,0,13,13,
Oklahoma,U.S. House,Steve Russell,REP,550108,0,0,178,178,5
Oklahoma,U.S. House,Kendra Horn,DEM,550108,0,0,95,95,5
Oklahoma,State House,Lewis Moore,REP,550108,0,0,162,162,96
Oklahoma,State House,Kathy Wallis,DEM,550108,0,0,106,106,96
Oklahoma,Governor,Chris Powell,LIB,550109,0,0,28,28,
Oklahoma,Governor,Kevin Stitt,REP,550109,0,0,755,755,
Oklahoma,Governor,Drew Edmondson,DEM,550109,0,0,600,600,
Oklahoma,Lieutenant Governor,Matt Pinnell,REP,550109,0,0,905,905,
Oklahoma,Lieutenant Governor,Anastasia Pittman,DEM,550109,0,0,422,422,
Oklahoma,Lieutenant Governor,Ivan Holmes,IND,550109,0,0,44,44,
Oklahoma,State Auditor,John Yeutter,LIB,550109,0,0,272,272,
Oklahoma,State Auditor,Cindy Byrd,REP,550109,0,0,1008,1008,
Oklahoma,Attorney General,Mike Hunter,REP,550109,0,0,934,934,
Oklahoma,Attorney General,Mark Myles,DEM,550109,0,0,433,433,
Oklahoma,State Treasurer,Randy Mcdaniel,REP,550109,0,0,935,935,
Oklahoma,State Treasurer,Charles De Coune,IND,550109,0,0,347,347,
Oklahoma,Superintendent of Public Instruction,Joy Hofmeister,REP,550109,0,0,872,872,
Oklahoma,Superintendent of Public Instruction,John Cox,DEM,550109,0,0,395,395,
Oklahoma,Superintendent of Public Instruction,Larry Huff,IND,550109,0,0,100,100,
Oklahoma,Commissioner of Labor,Leslie Osborn,REP,550109,0,0,888,888,
Oklahoma,Commissioner of Labor,Fred Dorrell,DEM,550109,0,0,403,403,
Oklahoma,Commissioner of Labor,Brandt Dismukes,IND,550109,0,0,49,49,
Oklahoma,Insurance Commissioner,Glen Mulready,REP,550109,0,0,867,867,
Oklahoma,Insurance Commissioner,Kimberly Fobbs,DEM,550109,0,0,474,474,
Oklahoma,Corporation Commissioner,Bob Anthony,REP,550109,0,0,879,879,
Oklahoma,Corporation Commissioner,Ashley Nicole Mccray,DEM,550109,0,0,398,398,
Oklahoma,Corporation Commissioner,Jackie Short,IND,550109,0,0,70,70,
Oklahoma,U.S. House,Steve Russell,REP,550109,0,0,877,877,5
Oklahoma,U.S. House,Kendra Horn,DEM,550109,0,0,500,500,5
Oklahoma,Governor,Chris Powell,LIB,550110,0,0,11,11,
Oklahoma,Governor,Kevin Stitt,REP,550110,0,0,218,218,
Oklahoma,Governor,Drew Edmondson,DEM,550110,0,0,155,155,
Oklahoma,Lieutenant Governor,Matt Pinnell,REP,550110,0,0,245,245,
Oklahoma,Lieutenant Governor,Anastasia Pittman,DEM,550110,0,0,131,131,
Oklahoma,Lieutenant Governor,Ivan Holmes,IND,550110,0,0,8,8,
Oklahoma,State Auditor,John Yeutter,LIB,550110,0,0,67,67,
Oklahoma,State Auditor,Cindy Byrd,REP,550110,0,0,288,288,
Oklahoma,Attorney General,Mike Hunter,REP,550110,0,0,251,251,
Oklahoma,Attorney General,Mark Myles,DEM,550110,0,0,131,131,
Oklahoma,State Treasurer,Randy Mcdaniel,REP,550110,0,0,279,279,
Oklahoma,State Treasurer,Charles De Coune,IND,550110,0,0,77,77,
Oklahoma,Superintendent of Public Instruction,Joy Hofmeister,REP,550110,0,0,260,260,
Oklahoma,Superintendent of Public Instruction,John Cox,DEM,550110,0,0,103,103,
Oklahoma,Superintendent of Public Instruction,Larry Huff,IND,550110,0,0,19,19,
Oklahoma,Commissioner of Labor,Leslie Osborn,REP,550110,0,0,259,259,
Oklahoma,Commissioner of Labor,Fred Dorrell,DEM,550110,0,0,98,98,
Oklahoma,Commissioner of Labor,Brandt Dismukes,IND,550110,0,0,12,12,
Oklahoma,Insurance Commissioner,Glen Mulready,REP,550110,0,0,254,254,
Oklahoma,Insurance Commissioner,Kimberly Fobbs,DEM,550110,0,0,119,119,
Oklahoma,Corporation Commissioner,Bob Anthony,REP,550110,0,0,251,251,
Oklahoma,Corporation Commissioner,Ashley Nicole Mccray,DEM,550110,0,0,104,104,
Oklahoma,Corporation Commissioner,Jackie Short,IND,550110,0,0,25,25,
Oklahoma,U.S. House,Steve Russell,REP,550110,0,0,254,254,5
Oklahoma,U.S. House,Kendra Horn,DEM,550110,0,0,132,132,5
Oklahoma,Governor,Chris Powell,LIB,550111,0,0,25,25,
Oklahoma,Governor,Kevin Stitt,REP,550111,0,0,695,695,
Oklahoma,Governor,Drew Edmondson,DEM,550111,0,0,572,572,
Oklahoma,Lieutenant Governor,Matt Pinnell,REP,550111,0,0,849,849,
Oklahoma,Lieutenant Governor,Anastasia Pittman,DEM,550111,0,0,395,395,
Oklahoma,Lieutenant Governor,Ivan Holmes,IND,550111,0,0,33,33,
Oklahoma,State Auditor,John Yeutter,LIB,550111,0,0,234,234,
Oklahoma,State Auditor,Cindy Byrd,REP,550111,0,0,965,965,
Oklahoma,Attorney General,Mike Hunter,REP,550111,0,0,879,879,
Oklahoma,Attorney General,Mark Myles,DEM,550111,0,0,399,399,
Oklahoma,State Treasurer,Randy Mcdaniel,REP,550111,0,0,904,904,
Oklahoma,State Treasurer,Charles De Coune,IND,550111,0,0,289,289,
Oklahoma,Superintendent of Public Instruction,Joy Hofmeister,REP,550111,0,0,802,802,
Oklahoma,Superintendent of Public Instruction,John Cox,DEM,550111,0,0,373,373,
Oklahoma,Superintendent of Public Instruction,Larry Huff,IND,550111,0,0,100,100,
Oklahoma,Commissioner of Labor,Leslie Osborn,REP,550111,0,0,847,847,
Oklahoma,Commissioner of Labor,Fred Dorrell,DEM,550111,0,0,361,361,
Oklahoma,Commissioner of Labor,Brandt Dismukes,IND,550111,0,0,54,54,
Oklahoma,Insurance Commissioner,Glen Mulready,REP,550111,0,0,819,819,
Oklahoma,Insurance Commissioner,Kimberly Fobbs,DEM,550111,0,0,438,438,
Oklahoma,Corporation Commissioner,Bob Anthony,REP,550111,0,0,826,826,
Oklahoma,Corporation Commissioner,Ashley Nicole Mccray,DEM,550111,0,0,363,363,
Oklahoma,Corporation Commissioner,Jackie Short,IND,550111,0,0,81,81,
Oklahoma,U.S. House,Steve Russell,REP,550111,0,0,810,810,5
Oklahoma,U.S. House,Kendra Horn,DEM,550111,0,0,471,471,5
Oklahoma,State House,Mike Osburn,REP,550111,0,0,815,815,81
Oklahoma,State House,Jackie Phillips,DEM,550111,0,0,459,459,81
Oklahoma,Governor,Chris Powell,LIB,550112,0,0,2,2,
Oklahoma,Governor,Kevin Stitt,REP,550112,0,0,70,70,
Oklahoma,Governor,Drew Edmondson,DEM,550112,0,0,61,61,
Oklahoma,Lieutenant Governor,Matt Pinnell,REP,550112,0,0,76,76,
Oklahoma,Lieutenant Governor,Anastasia Pittman,DEM,550112,0,0,46,46,
Oklahoma,Lieutenant Governor,Ivan Holmes,IND,550112,0,0,10,10,
Oklahoma,State Auditor,John Yeutter,LIB,550112,0,0,34,34,
Oklahoma,State Auditor,Cindy Byrd,REP,550112,0,0,85,85,
Oklahoma,Attorney General,Mike Hunter,REP,550112,0,0,85,85,
Oklahoma,Attorney General,Mark Myles,DEM,550112,0,0,45,45,
Oklahoma,State Treasurer,Randy Mcdaniel,REP,550112,0,0,79,79,
Oklahoma,State Treasurer,Charles De Coune,IND,550112,0,0,39,39,
Oklahoma,Superintendent of Public Instruction,Joy Hofmeister,REP,550112,0,0,70,70,
Oklahoma,Superintendent of Public Instruction,John Cox,DEM,550112,0,0,48,48,
Oklahoma,Superintendent of Public Instruction,Larry Huff,IND,550112,0,0,13,13,
Oklahoma,Commissioner of Labor,Leslie Osborn,REP,550112,0,0,81,81,
Oklahoma,Commissioner of Labor,Fred Dorrell,DEM,550112,0,0,41,41,
Oklahoma,Commissioner of Labor,Brandt Dismukes,IND,550112,0,0,7,7,
Oklahoma,Insurance Commissioner,Glen Mulready,REP,550112,0,0,76,76,
Oklahoma,Insurance Commissioner,Kimberly Fobbs,DEM,550112,0,0,54,54,
Oklahoma,Corporation Commissioner,Bob Anthony,REP,550112,0,0,80,80,
Oklahoma,Corporation Commissioner,Ashley Nicole Mccray,DEM,550112,0,0,37,37,
Oklahoma,Corporation Commissioner,Jackie Short,IND,550112,0,0,11,11,
Oklahoma,U.S. House,Steve Russell,REP,550112,0,0,76,76,5
Oklahoma,U.S. House,Kendra Horn,DEM,550112,0,0,55,55,5
Oklahoma,State Senate,Willard Linzy,REP,550112,0,0,76,76,48
Oklahoma,State Senate,George Young,DEM,550112,0,0,54,54,48
Oklahoma,Governor,Chris Powell,LIB,550113,0,0,9,9,
Oklahoma,Governor,Kevin Stitt,REP,550113,0,0,115,115,
Oklahoma,Governor,Drew Edmondson,DEM,550113,0,0,118,118,
Oklahoma,Lieutenant Governor,Matt Pinnell,REP,550113,0,0,135,135,
Oklahoma,Lieutenant Governor,Anastasia Pittman,DEM,550113,0,0,97,97,
Oklahoma,Lieutenant Governor,Ivan Holmes,IND,550113,0,0,10,10,
Oklahoma,State Auditor,John Yeutter,LIB,550113,0,0,56,56,
Oklahoma,State Auditor,Cindy Byrd,REP,550113,0,0,154,154,
Oklahoma,Attorney General,Mike Hunter,REP,550113,0,0,139,139,
Oklahoma,Attorney General,Mark Myles,DEM,550113,0,0,103,103,
Oklahoma,State Treasurer,Randy Mcdaniel,REP,550113,0,0,137,137,
Oklahoma,State Treasurer,Charles De Coune,IND,550113,0,0,74,74,
Oklahoma,Superintendent of Public Instruction,Joy Hofmeister,REP,550113,0,0,136,136,
Oklahoma,Superintendent of Public Instruction,John Cox,DEM,550113,0,0,73,73,
Oklahoma,Superintendent of Public Instruction,Larry Huff,IND,550113,0,0,30,30,
Oklahoma,Commissioner of Labor,Leslie Osborn,REP,550113,0,0,139,139,
Oklahoma,Commissioner of Labor,Fred Dorrell,DEM,550113,0,0,86,86,
Oklahoma,Commissioner of Labor,Brandt Dismukes,IND,550113,0,0,15,15,
Oklahoma,Insurance Commissioner,Glen Mulready,REP,550113,0,0,126,126,
Oklahoma,Insurance Commissioner,Kimberly Fobbs,DEM,550113,0,0,114,114,
Oklahoma,Corporation Commissioner,Bob Anthony,REP,550113,0,0,129,129,
Oklahoma,Corporation Commissioner,Ashley Nicole Mccray,DEM,550113,0,0,93,93,
Oklahoma,Corporation Commissioner,Jackie Short,IND,550113,0,0,18,18,
Oklahoma,U.S. House,Steve Russell,REP,550113,0,0,127,127,5
Oklahoma,U.S. House,Kendra Horn,DEM,550113,0,0,115,115,5
Oklahoma,State Senate,Willard Linzy,REP,550113,0,0,128,128,48
Oklahoma,State Senate,George Young,DEM,550113,0,0,110,110,48
Oklahoma,Governor,Chris Powell,LIB,550114,0,0,12,12,
Oklahoma,Governor,Kevin Stitt,REP,550114,0,0,56,56,
Oklahoma,Governor,Drew Edmondson,DEM,550114,0,0,599,599,
Oklahoma,Lieutenant Governor,Matt Pinnell,REP,550114,0,0,54,54,
Oklahoma,Lieutenant Governor,Anastasia Pittman,DEM,550114,0,0,597,597,
Oklahoma,Lieutenant Governor,Ivan Holmes,IND,550114,0,0,16,16,
Oklahoma,State Auditor,John Yeutter,LIB,550114,0,0,383,383,
Oklahoma,State Auditor,Cindy Byrd,REP,550114,0,0,142,142,
Oklahoma,Attorney General,Mike Hunter,REP,550114,0,0,65,65,
Oklahoma,Attorney General,Mark Myles,DEM,550114,0,0,599,599,
Oklahoma,State Treasurer,Randy Mcdaniel,REP,550114,0,0,98,98,
Oklahoma,State Treasurer,Charles De Coune,IND,550114,0,0,428,428,
Oklahoma,Superintendent of Public Instruction,Joy Hofmeister,REP,550114,0,0,100,100,
Oklahoma,Superintendent of Public Instruction,John Cox,DEM,550114,0,0,532,532,
Oklahoma,Superintendent of Public Instruction,Larry Huff,IND,550114,0,0,29,29,
Oklahoma,Commissioner of Labor,Leslie Osborn,REP,550114,0,0,80,80,
Oklahoma,Commissioner of Labor,Fred Dorrell,DEM,550114,0,0,553,553,
Oklahoma,Commissioner of Labor,Brandt Dismukes,IND,550114,0,0,30,30,
Oklahoma,Insurance Commissioner,Glen Mulready,REP,550114,0,0,59,59,
Oklahoma,Insurance Commissioner,Kimberly Fobbs,DEM,550114,0,0,604,604,
Oklahoma,Corporation Commissioner,Bob Anthony,REP,550114,0,0,75,75,
Oklahoma,Corporation Commissioner,Ashley Nicole Mccray,DEM,550114,0,0,567,567,
Oklahoma,Corporation Commissioner,Jackie Short,IND,550114,0,0,24,24,
Oklahoma,U.S. House,Steve Russell,REP,550114,0,0,69,69,5
Oklahoma,U.S. House,Kendra Horn,DEM,550114,0,0,600,600,5
Oklahoma,State Senate,Willard Linzy,REP,550114,0,0,60,60,48
Oklahoma,State Senate,George Young,DEM,550114,0,0,605,605,48
Oklahoma,Governor,Chris Powell,LIB,550115,0,0,14,14,
Oklahoma,Governor,Kevin Stitt,REP,550115,0,0,37,37,
Oklahoma,Governor,Drew Edmondson,DEM,550115,0,0,834,834,
Oklahoma,Lieutenant Governor,Matt Pinnell,REP,550115,0,0,38,38,
Oklahoma,Lieutenant Governor,Anastasia Pittman,DEM,550115,0,0,816,816,
Oklahoma,Lieutenant Governor,Ivan Holmes,IND,550115,0,0,26,26,
Oklahoma,State Auditor,John Yeutter,LIB,550115,0,0,565,565,
Oklahoma,State Auditor,Cindy Byrd,REP,550115,0,0,165,165,
Oklahoma,Attorney General,Mike Hunter,REP,550115,0,0,56,56,
Oklahoma,Attorney General,Mark Myles,DEM,550115,0,0,822,822,
Oklahoma,State Treasurer,Randy Mcdaniel,REP,550115,0,0,98,98,
Oklahoma,State Treasurer,Charles De Coune,IND,550115,0,0,627,627,
Oklahoma,Superintendent of Public Instruction,Joy Hofmeister,REP,550115,0,0,97,97,
Oklahoma,Superintendent of Public Instruction,John Cox,DEM,550115,0,0,735,735,
Oklahoma,Superintendent of Public Instruction,Larry Huff,IND,550115,0,0,49,49,
Oklahoma,Commissioner of Labor,Leslie Osborn,REP,550115,0,0,59,59,
Oklahoma,Commissioner of Labor,Fred Dorrell,DEM,550115,0,0,766,766,
Oklahoma,Commissioner of Labor,Brandt Dismukes,IND,550115,0,0,52,52,
Oklahoma,Insurance Commissioner,Glen Mulready,REP,550115,0,0,46,46,
Oklahoma,Insurance Commissioner,Kimberly Fobbs,DEM,550115,0,0,833,833,
Oklahoma,Corporation Commissioner,Bob Anthony,REP,550115,0,0,71,71,
Oklahoma,Corporation Commissioner,Ashley Nicole Mccray,DEM,550115,0,0,770,770,
Oklahoma,Corporation Commissioner,Jackie Short,IND,550115,0,0,35,35,
Oklahoma,U.S. House,Steve Russell,REP,550115,0,0,37,37,5
Oklahoma,U.S. House,Kendra Horn,DEM,550115,0,0,845,845,5
Oklahoma,State Senate,Willard Linzy,REP,550115,0,0,48,48,48
Oklahoma,State Senate,George Young,DEM,550115,0,0,834,834,48
Oklahoma,Governor,Chris Powell,LIB,550116,0,0,15,15,
Oklahoma,Governor,Kevin Stitt,REP,550116,0,0,89,89,
Oklahoma,Governor,Drew Edmondson,DEM,550116,0,0,286,286,
Oklahoma,Lieutenant Governor,Matt Pinnell,REP,550116,0,0,127,127,
Oklahoma,Lieutenant Governor,Anastasia Pittman,DEM,550116,0,0,236,236,
Oklahoma,Lieutenant Governor,Ivan Holmes,IND,550116,0,0,22,22,
Oklahoma,State Auditor,John Yeutter,LIB,550116,0,0,150,150,
Oklahoma,State Auditor,Cindy Byrd,REP,550116,0,0,178,178,
Oklahoma,Attorney General,Mike Hunter,REP,550116,0,0,135,135,
Oklahoma,Attorney General,Mark Myles,DEM,550116,0,0,249,249,
Oklahoma,State Treasurer,Randy Mcdaniel,REP,550116,0,0,146,146,
Oklahoma,State Treasurer,Charles De Coune,IND,550116,0,0,197,197,
Oklahoma,Superintendent of Public Instruction,Joy Hofmeister,REP,550116,0,0,138,138,
Oklahoma,Superintendent of Public Instruction,John Cox,DEM,550116,0,0,207,207,
Oklahoma,Superintendent of Public Instruction,Larry Huff,IND,550116,0,0,36,36,
Oklahoma,Commissioner of Labor,Leslie Osborn,REP,550116,0,0,143,143,
Oklahoma,Commissioner of Labor,Fred Dorrell,DEM,550116,0,0,204,204,
Oklahoma,Commissioner of Labor,Brandt Dismukes,IND,550116,0,0,27,27,
Oklahoma,Insurance Commissioner,Glen Mulready,REP,550116,0,0,130,130,
Oklahoma,Insurance Commissioner,Kimberly Fobbs,DEM,550116,0,0,245,245,
Oklahoma,Corporation Commissioner,Bob Anthony,REP,550116,0,0,120,120,
Oklahoma,Corporation Commissioner,Ashley Nicole Mccray,DEM,550116,0,0,229,229,
Oklahoma,Corporation Commissioner,Jackie Short,IND,550116,0,0,26,26,
Oklahoma,U.S. House,Steve Russell,REP,550116,0,0,116,116,5
Oklahoma,U.S. House,Kendra Horn,DEM,550116,0,0,269,269,5
Oklahoma,State Senate,Willard Linzy,REP,550116,0,0,110,110,48
Oklahoma,State Senate,George Young,DEM,550116,0,0,265,265,48
Oklahoma,Governor,Chris Powell,LIB,550117,0,0,22,22,
Oklahoma,Governor,Kevin Stitt,REP,550117,0,0,90,90,
Oklahoma,Governor,Drew Edmondson,DEM,550117,0,0,942,942,
Oklahoma,Lieutenant Governor,Matt Pinnell,REP,550117,0,0,98,98,
Oklahoma,Lieutenant Governor,Anastasia Pittman,DEM,550117,0,0,924,924,
Oklahoma,Lieutenant Governor,Ivan Holmes,IND,550117,0,0,29,29,
Oklahoma,State Auditor,John Yeutter,LIB,550117,0,0,626,626,
Oklahoma,State Auditor,Cindy Byrd,REP,550117,0,0,248,248,
Oklahoma,Attorney General,Mike Hunter,REP,550117,0,0,124,124,
Oklahoma,Attorney General,Mark Myles,DEM,550117,0,0,924,924,
Oklahoma,State Treasurer,Randy Mcdaniel,REP,550117,0,0,157,157,
Oklahoma,State Treasurer,Charles De Coune,IND,550117,0,0,725,725,
Oklahoma,Superintendent of Public Instruction,Joy Hofmeister,REP,550117,0,0,163,163,
Oklahoma,Superintendent of Public Instruction,John Cox,DEM,550117,0,0,837,837,
Oklahoma,Superintendent of Public Instruction,Larry Huff,IND,550117,0,0,43,43,
Oklahoma,Commissioner of Labor,Leslie Osborn,REP,550117,0,0,121,121,
Oklahoma,Commissioner of Labor,Fred Dorrell,DEM,550117,0,0,874,874,
Oklahoma,Commissioner of Labor,Brandt Dismukes,IND,550117,0,0,46,46,
Oklahoma,Insurance Commissioner,Glen Mulready,REP,550117,0,0,109,109,
Oklahoma,Insurance Commissioner,Kimberly Fobbs,DEM,550117,0,0,932,932,
Oklahoma,Corporation Commissioner,Bob Anthony,REP,550117,0,0,144,144,
Oklahoma,Corporation Commissioner,Ashley Nicole Mccray,DEM,550117,0,0,859,859,
Oklahoma,Corporation Commissioner,Jackie Short,IND,550117,0,0,40,40,
Oklahoma,U.S. House,Steve Russell,REP,550117,0,0,103,103,5
Oklahoma,U.S. House,Kendra Horn,DEM,550117,0,0,946,946,5
Oklahoma,State Senate,Willard Linzy,REP,550117,0,0,100,100,48
Oklahoma,State Senate,George Young,DEM,550117,0,0,942,942,48
Oklahoma,Governor,Chris Powell,LIB,550118,0,0,35,35,
Oklahoma,Governor,Kevin Stitt,REP,550118,0,0,132,132,
Oklahoma,Governor,Drew Edmondson,DEM,550118,0,0,740,740,
Oklahoma,Lieutenant Governor,Matt Pinnell,REP,550118,0,0,164,164,
Oklahoma,Lieutenant Governor,Anastasia Pittman,DEM,550118,0,0,700,700,
Oklahoma,Lieutenant Governor,Ivan Holmes,IND,550118,0,0,40,40,
Oklahoma,State Auditor,John Yeutter,LIB,550118,0,0,476,476,
Oklahoma,State Auditor,Cindy Byrd,REP,550118,0,0,296,296,
Oklahoma,Attorney General,Mike Hunter,REP,550118,0,0,188,188,
Oklahoma,Attorney General,Mark Myles,DEM,550118,0,0,715,715,
Oklahoma,State Treasurer,Randy Mcdaniel,REP,550118,0,0,219,219,
Oklahoma,State Treasurer,Charles De Coune,IND,550118,0,0,553,553,
Oklahoma,Superintendent of Public Instruction,Joy Hofmeister,REP,550118,0,0,204,204,
Oklahoma,Superintendent of Public Instruction,John Cox,DEM,550118,0,0,622,622,
Oklahoma,Superintendent of Public Instruction,Larry Huff,IND,550118,0,0,71,71,
Oklahoma,Commissioner of Labor,Leslie Osborn,REP,550118,0,0,178,178,
Oklahoma,Commissioner of Labor,Fred Dorrell,DEM,550118,0,0,670,670,
Oklahoma,Commissioner of Labor,Brandt Dismukes,IND,550118,0,0,48,48,
Oklahoma,Insurance Commissioner,Glen Mulready,REP,550118,0,0,176,176,
Oklahoma,Insurance Commissioner,Kimberly Fobbs,DEM,550118,0,0,719,719,
Oklahoma,Corporation Commissioner,Bob Anthony,REP,550118,0,0,183,183,
Oklahoma,Corporation Commissioner,Ashley Nicole Mccray,DEM,550118,0,0,673,673,
Oklahoma,Corporation Commissioner,Jackie Short,IND,550118,0,0,42,42,
Oklahoma,U.S. House,Steve Russell,REP,550118,0,0,160,160,5
Oklahoma,U.S. House,Kendra Horn,DEM,550118,0,0,739,739,5
Oklahoma,State Senate,Willard Linzy,REP,550118,0,0,162,162,48
Oklahoma,State Senate,George Young,DEM,550118,0,0,735,735,48
Oklahoma,Governor,Chris Powell,LIB,550119,0,0,4,4,
Oklahoma,Governor,Kevin Stitt,REP,550119,0,0,63,63,
Oklahoma,Governor,Drew Edmondson,DEM,550119,0,0,100,100,
Oklahoma,Lieutenant Governor,Matt Pinnell,REP,550119,0,0,81,81,
Oklahoma,Lieutenant Governor,Anastasia Pittman,DEM,550119,0,0,79,79,
Oklahoma,Lieutenant Governor,Ivan Holmes,IND,550119,0,0,7,7,
Oklahoma,State Auditor,John Yeutter,LIB,550119,0,0,36,36,
Oklahoma,State Auditor,Cindy Byrd,REP,550119,0,0,108,108,
Oklahoma,Attorney General,Mike Hunter,REP,550119,0,0,97,97,
Oklahoma,Attorney General,Mark Myles,DEM,550119,0,0,69,69,
Oklahoma,State Treasurer,Randy Mcdaniel,REP,550119,0,0,107,107,
Oklahoma,State Treasurer,Charles De Coune,IND,550119,0,0,41,41,
Oklahoma,Superintendent of Public Instruction,Joy Hofmeister,REP,550119,0,0,86,86,
Oklahoma,Superintendent of Public Instruction,John Cox,DEM,550119,0,0,68,68,
Oklahoma,Superintendent of Public Instruction,Larry Huff,IND,550119,0,0,12,12,
Oklahoma,Commissioner of Labor,Leslie Osborn,REP,550119,0,0,89,89,
Oklahoma,Commissioner of Labor,Fred Dorrell,DEM,550119,0,0,64,64,
Oklahoma,Commissioner of Labor,Brandt Dismukes,IND,550119,0,0,9,9,
Oklahoma,Insurance Commissioner,Glen Mulready,REP,550119,0,0,75,75,
Oklahoma,Insurance Commissioner,Kimberly Fobbs,DEM,550119,0,0,84,84,
Oklahoma,Corporation Commissioner,Bob Anthony,REP,550119,0,0,95,95,
Oklahoma,Corporation Commissioner,Ashley Nicole Mccray,DEM,550119,0,0,64,64,
Oklahoma,Corporation Commissioner,Jackie Short,IND,550119,0,0,5,5,
Oklahoma,U.S. House,Steve Russell,REP,550119,0,0,75,75,5
Oklahoma,U.S. House,Kendra Horn,DEM,550119,0,0,92,92,5
Oklahoma,State Senate,Joe Howell,REP,550119,0,0,68,68,40
Oklahoma,State Senate,Carri Hicks,DEM,550119,0,0,98,98,40
Oklahoma,State Senate,Christopher Hensley,IND,550119,0,0,0,0,40
Oklahoma,State House,Jason Reese,REP,550119,0,0,77,77,83
Oklahoma,State House,Chelsey Branham,DEM,550119,0,0,86,86,83
Oklahoma,Governor,Chris Powell,LIB,550120,0,0,29,29,
Oklahoma,Governor,Kevin Stitt,REP,550120,0,0,125,125,
Oklahoma,Governor,Drew Edmondson,DEM,550120,0,0,615,615,
Oklahoma,Lieutenant Governor,Matt Pinnell,REP,550120,0,0,137,137,
Oklahoma,Lieutenant Governor,Anastasia Pittman,DEM,550120,0,0,603,603,
Oklahoma,Lieutenant Governor,Ivan Holmes,IND,550120,0,0,26,26,
Oklahoma,State Auditor,John Yeutter,LIB,550120,0,0,409,409,
Oklahoma,State Auditor,Cindy Byrd,REP,550120,0,0,252,252,
Oklahoma,Attorney General,Mike Hunter,REP,550120,0,0,159,159,
Oklahoma,Attorney General,Mark Myles,DEM,550120,0,0,603,603,
Oklahoma,State Treasurer,Randy Mcdaniel,REP,550120,0,0,185,185,
Oklahoma,State Treasurer,Charles De Coune,IND,550120,0,0,475,475,
Oklahoma,Superintendent of Public Instruction,Joy Hofmeister,REP,550120,0,0,164,164,
Oklahoma,Superintendent of Public Instruction,John Cox,DEM,550120,0,0,534,534,
Oklahoma,Superintendent of Public Instruction,Larry Huff,IND,550120,0,0,60,60,
Oklahoma,Commissioner of Labor,Leslie Osborn,REP,550120,0,0,153,153,
Oklahoma,Commissioner of Labor,Fred Dorrell,DEM,550120,0,0,558,558,
Oklahoma,Commissioner of Labor,Brandt Dismukes,IND,550120,0,0,44,44,
Oklahoma,Insurance Commissioner,Glen Mulready,REP,550120,0,0,145,145,
Oklahoma,Insurance Commissioner,Kimberly Fobbs,DEM,550120,0,0,612,612,
Oklahoma,Corporation Commissioner,Bob Anthony,REP,550120,0,0,148,148,
Oklahoma,Corporation Commissioner,Ashley Nicole Mccray,DEM,550120,0,0,569,569,
Oklahoma,Corporation Commissioner,Jackie Short,IND,550120,0,0,43,43,
Oklahoma,U.S. House,Steve Russell,REP,550120,0,0,137,137,5
Oklahoma,U.S. House,Kendra Horn,DEM,550120,0,0,628,628,5
Oklahoma,State Senate,Willard Linzy,REP,550120,0,0,135,135,48
Oklahoma,State Senate,George Young,DEM,550120,0,0,625,625,48
Oklahoma,Governor,Chris Powell,LIB,550121,0,0,28,28,
Oklahoma,Governor,Kevin Stitt,REP,550121,0,0,148,148,
Oklahoma,Governor,Drew Edmondson,DEM,550121,0,0,912,912,
Oklahoma,Lieutenant Governor,Matt Pinnell,REP,550121,0,0,170,170,
Oklahoma,Lieutenant Governor,Anastasia Pittman,DEM,550121,0,0,885,885,
Oklahoma,Lieutenant Governor,Ivan Holmes,IND,550121,0,0,30,30,
Oklahoma,State Auditor,John Yeutter,LIB,550121,0,0,625,625,
Oklahoma,State Auditor,Cindy Byrd,REP,550121,0,0,327,327,
Oklahoma,Attorney General,Mike Hunter,REP,550121,0,0,200,200,
Oklahoma,Attorney General,Mark Myles,DEM,550121,0,0,884,884,
Oklahoma,State Treasurer,Randy Mcdaniel,REP,550121,0,0,260,260,
Oklahoma,State Treasurer,Charles De Coune,IND,550121,0,0,701,701,
Oklahoma,Superintendent of Public Instruction,Joy Hofmeister,REP,550121,0,0,201,201,
Oklahoma,Superintendent of Public Instruction,John Cox,DEM,550121,0,0,815,815,
Oklahoma,Superintendent of Public Instruction,Larry Huff,IND,550121,0,0,63,63,
Oklahoma,Commissioner of Labor,Leslie Osborn,REP,550121,0,0,209,209,
Oklahoma,Commissioner of Labor,Fred Dorrell,DEM,550121,0,0,825,825,
Oklahoma,Commissioner of Labor,Brandt Dismukes,IND,550121,0,0,43,43,
Oklahoma,Insurance Commissioner,Glen Mulready,REP,550121,0,0,196,196,
Oklahoma,Insurance Commissioner,Kimberly Fobbs,DEM,550121,0,0,883,883,
Oklahoma,Corporation Commissioner,Bob Anthony,REP,550121,0,0,182,182,
Oklahoma,Corporation Commissioner,Ashley Nicole Mccray,DEM,550121,0,0,844,844,
Oklahoma,Corporation Commissioner,Jackie Short,IND,550121,0,0,53,53,
Oklahoma,U.S. House,Steve Russell,REP,550121,0,0,173,173,5
Oklahoma,U.S. House,Kendra Horn,DEM,550121,0,0,910,910,5
Oklahoma,State Senate,Willard Linzy,REP,550121,0,0,182,182,48
Oklahoma,State Senate,George Young,DEM,550121,0,0,899,899,48
Oklahoma,Governor,Chris Powell,LIB,550122,0,0,24,24,
Oklahoma,Governor,Kevin Stitt,REP,550122,0,0,158,158,
Oklahoma,Governor,Drew Edmondson,DEM,550122,0,0,618,618,
Oklahoma,Lieutenant Governor,Matt Pinnell,REP,550122,0,0,196,196,
Oklahoma,Lieutenant Governor,Anastasia Pittman,DEM,550122,0,0,565,565,
Oklahoma,Lieutenant Governor,Ivan Holmes,IND,550122,0,0,26,26,
Oklahoma,State Auditor,John Yeutter,LIB,550122,0,0,398,398,
Oklahoma,State Auditor,Cindy Byrd,REP,550122,0,0,280,280,
Oklahoma,Attorney General,Mike Hunter,REP,550122,0,0,197,197,
Oklahoma,Attorney General,Mark Myles,DEM,550122,0,0,587,587,
Oklahoma,State Treasurer,Randy Mcdaniel,REP,550122,0,0,220,220,
Oklahoma,State Treasurer,Charles De Coune,IND,550122,0,0,449,449,
Oklahoma,Superintendent of Public Instruction,Joy Hofmeister,REP,550122,0,0,205,205,
Oklahoma,Superintendent of Public Instruction,John Cox,DEM,550122,0,0,529,529,
Oklahoma,Superintendent of Public Instruction,Larry Huff,IND,550122,0,0,55,55,
Oklahoma,Commissioner of Labor,Leslie Osborn,REP,550122,0,0,202,202,
Oklahoma,Commissioner of Labor,Fred Dorrell,DEM,550122,0,0,534,534,
Oklahoma,Commissioner of Labor,Brandt Dismukes,IND,550122,0,0,45,45,
Oklahoma,Insurance Commissioner,Glen Mulready,REP,550122,0,0,195,195,
Oklahoma,Insurance Commissioner,Kimberly Fobbs,DEM,550122,0,0,587,587,
Oklahoma,Corporation Commissioner,Bob Anthony,REP,550122,0,0,189,189,
Oklahoma,Corporation Commissioner,Ashley Nicole Mccray,DEM,550122,0,0,544,544,
Oklahoma,Corporation Commissioner,Jackie Short,IND,550122,0,0,50,50,
Oklahoma,U.S. House,Steve Russell,REP,550122,0,0,187,187,5
Oklahoma,U.S. House,Kendra Horn,DEM,550122,0,0,607,607,5
Oklahoma,State Senate,Willard Linzy,REP,550122,0,0,184,184,48
Oklahoma,State Senate,George Young,DEM,550122,0,0,601,601,48
Oklahoma,Governor,Chris Powell,LIB,550123,0,0,26,26,
Oklahoma,Governor,Kevin Stitt,REP,550123,0,0,171,171,
Oklahoma,Governor,Drew Edmondson,DEM,550123,0,0,642,642,
Oklahoma,Lieutenant Governor,Matt Pinnell,REP,550123,0,0,198,198,
Oklahoma,Lieutenant Governor,Anastasia Pittman,DEM,550123,0,0,590,590,
Oklahoma,Lieutenant Governor,Ivan Holmes,IND,550123,0,0,49,49,
Oklahoma,State Auditor,John Yeutter,LIB,550123,0,0,403,403,
Oklahoma,State Auditor,Cindy Byrd,REP,550123,0,0,318,318,
Oklahoma,Attorney General,Mike Hunter,REP,550123,0,0,228,228,
Oklahoma,Attorney General,Mark Myles,DEM,550123,0,0,605,605,
Oklahoma,State Treasurer,Randy Mcdaniel,REP,550123,0,0,257,257,
Oklahoma,State Treasurer,Charles De Coune,IND,550123,0,0,470,470,
Oklahoma,Superintendent of Public Instruction,Joy Hofmeister,REP,550123,0,0,238,238,
Oklahoma,Superintendent of Public Instruction,John Cox,DEM,550123,0,0,539,539,
Oklahoma,Superintendent of Public Instruction,Larry Huff,IND,550123,0,0,61,61,
Oklahoma,Commissioner of Labor,Leslie Osborn,REP,550123,0,0,212,212,
Oklahoma,Commissioner of Labor,Fred Dorrell,DEM,550123,0,0,580,580,
Oklahoma,Commissioner of Labor,Brandt Dismukes,IND,550123,0,0,41,41,
Oklahoma,Insurance Commissioner,Glen Mulready,REP,550123,0,0,204,204,
Oklahoma,Insurance Commissioner,Kimberly Fobbs,DEM,550123,0,0,629,629,
Oklahoma,Corporation Commissioner,Bob Anthony,REP,550123,0,0,221,221,
Oklahoma,Corporation Commissioner,Ashley Nicole Mccray,DEM,550123,0,0,569,569,
Oklahoma,Corporation Commissioner,Jackie Short,IND,550123,0,0,50,50,
Oklahoma,U.S. House,Steve Russell,REP,550123,0,0,208,208,5
Oklahoma,U.S. House,Kendra Horn,DEM,550123,0,0,635,635,5
Oklahoma,State Senate,Willard Linzy,REP,550123,0,0,188,188,48
Oklahoma,State Senate,George Young,DEM,550123,0,0,648,648,48
Oklahoma,Governor,Chris Powell,LIB,550124,0,0,18,18,
Oklahoma,Governor,Kevin Stitt,REP,550124,0,0,224,224,
Oklahoma,Governor,Drew Edmondson,DEM,550124,0,0,506,506,
Oklahoma,Lieutenant Governor,Matt Pinnell,REP,550124,0,0,257,257,
Oklahoma,Lieutenant Governor,Anastasia Pittman,DEM,550124,0,0,458,458,
Oklahoma,Lieutenant Governor,Ivan Holmes,IND,550124,0,0,29,29,
Oklahoma,State Auditor,John Yeutter,LIB,550124,0,0,292,292,
Oklahoma,State Auditor,Cindy Byrd,REP,550124,0,0,342,342,
Oklahoma,Attorney General,Mike Hunter,REP,550124,0,0,282,282,
Oklahoma,Attorney General,Mark Myles,DEM,550124,0,0,455,455,
Oklahoma,State Treasurer,Randy Mcdaniel,REP,550124,0,0,316,316,
Oklahoma,State Treasurer,Charles De Coune,IND,550124,0,0,328,328,
Oklahoma,Superintendent of Public Instruction,Joy Hofmeister,REP,550124,0,0,260,260,
Oklahoma,Superintendent of Public Instruction,John Cox,DEM,550124,0,0,413,413,
Oklahoma,Superintendent of Public Instruction,Larry Huff,IND,550124,0,0,68,68,
Oklahoma,Commissioner of Labor,Leslie Osborn,REP,550124,0,0,274,274,
Oklahoma,Commissioner of Labor,Fred Dorrell,DEM,550124,0,0,422,422,
Oklahoma,Commissioner of Labor,Brandt Dismukes,IND,550124,0,0,36,36,
Oklahoma,Insurance Commissioner,Glen Mulready,REP,550124,0,0,269,269,
Oklahoma,Insurance Commissioner,Kimberly Fobbs,DEM,550124,0,0,459,459,
Oklahoma,Corporation Commissioner,Bob Anthony,REP,550124,0,0,263,263,
Oklahoma,Corporation Commissioner,Ashley Nicole Mccray,DEM,550124,0,0,435,435,
Oklahoma,Corporation Commissioner,Jackie Short,IND,550124,0,0,41,41,
Oklahoma,U.S. House,Steve Russell,REP,550124,0,0,245,245,5
Oklahoma,U.S. House,Kendra Horn,DEM,550124,0,0,500,500,5
Oklahoma,State Senate,Willard Linzy,REP,550124,0,0,252,252,48
Oklahoma,State Senate,George Young,DEM,550124,0,0,478,478,48
Oklahoma,State House,Jason Reese,REP,550124,0,0,236,236,83
Oklahoma,State House,Chelsey Branham,DEM,550124,0,0,495,495,83
Oklahoma,Governor,Chris Powell,LIB,550125,0,0,22,22,
Oklahoma,Governor,Kevin Stitt,REP,550125,0,0,65,65,
Oklahoma,Governor,Drew Edmondson,DEM,550125,0,0,300,300,
Oklahoma,Lieutenant Governor,Matt Pinnell,REP,550125,0,0,85,85,
Oklahoma,Lieutenant Governor,Anastasia Pittman,DEM,550125,0,0,271,271,
Oklahoma,Lieutenant Governor,Ivan Holmes,IND,550125,0,0,30,30,
Oklahoma,State Auditor,John Yeutter,LIB,550125,0,0,207,207,
Oklahoma,State Auditor,Cindy Byrd,REP,550125,0,0,127,127,
Oklahoma,Attorney General,Mike Hunter,REP,550125,0,0,96,96,
Oklahoma,Attorney General,Mark Myles,DEM,550125,0,0,288,288,
Oklahoma,State Treasurer,Randy Mcdaniel,REP,550125,0,0,103,103,
Oklahoma,State Treasurer,Charles De Coune,IND,550125,0,0,232,232,
Oklahoma,Superintendent of Public Instruction,Joy Hofmeister,REP,550125,0,0,90,90,
Oklahoma,Superintendent of Public Instruction,John Cox,DEM,550125,0,0,248,248,
Oklahoma,Superintendent of Public Instruction,Larry Huff,IND,550125,0,0,45,45,
Oklahoma,Commissioner of Labor,Leslie Osborn,REP,550125,0,0,87,87,
Oklahoma,Commissioner of Labor,Fred Dorrell,DEM,550125,0,0,257,257,
Oklahoma,Commissioner of Labor,Brandt Dismukes,IND,550125,0,0,35,35,
Oklahoma,Insurance Commissioner,Glen Mulready,REP,550125,0,0,90,90,
Oklahoma,Insurance Commissioner,Kimberly Fobbs,DEM,550125,0,0,291,291,
Oklahoma,Corporation Commissioner,Bob Anthony,REP,550125,0,0,86,86,
Oklahoma,Corporation Commissioner,Ashley Nicole Mccray,DEM,550125,0,0,253,253,
Oklahoma,Corporation Commissioner,Jackie Short,IND,550125,0,0,44,44,
Oklahoma,U.S. House,Steve Russell,REP,550125,0,0,84,84,5
Oklahoma,U.S. House,Kendra Horn,DEM,550125,0,0,300,300,5
Oklahoma,State Senate,Willard Linzy,REP,550125,0,0,80,80,48
Oklahoma,State Senate,George Young,DEM,550125,0,0,299,299,48
Oklahoma,Governor,Chris Powell,LIB,550126,0,0,31,31,
Oklahoma,Governor,Kevin Stitt,REP,550126,0,0,187,187,
Oklahoma,Governor,Drew Edmondson,DEM,550126,0,0,575,575,
Oklahoma,Lieutenant Governor,Matt Pinnell,REP,550126,0,0,229,229,
Oklahoma,Lieutenant Governor,Anastasia Pittman,DEM,550126,0,0,526,526,
Oklahoma,Lieutenant Governor,Ivan Holmes,IND,550126,0,0,36,36,
Oklahoma,State Auditor,John Yeutter,LIB,550126,0,0,378,378,
Oklahoma,State Auditor,Cindy Byrd,REP,550126,0,0,324,324,
Oklahoma,Attorney General,Mike Hunter,REP,550126,0,0,253,253,
Oklahoma,Attorney General,Mark Myles,DEM,550126,0,0,535,535,
Oklahoma,State Treasurer,Randy Mcdaniel,REP,550126,0,0,274,274,
Oklahoma,State Treasurer,Charles De Coune,IND,550126,0,0,426,426,
Oklahoma,Superintendent of Public Instruction,Joy Hofmeister,REP,550126,0,0,231,231,
Oklahoma,Superintendent of Public Instruction,John Cox,DEM,550126,0,0,495,495,
Oklahoma,Superintendent of Public Instruction,Larry Huff,IND,550126,0,0,62,62,
Oklahoma,Commissioner of Labor,Leslie Osborn,REP,550126,0,0,243,243,
Oklahoma,Commissioner of Labor,Fred Dorrell,DEM,550126,0,0,486,486,
Oklahoma,Commissioner of Labor,Brandt Dismukes,IND,550126,0,0,49,49,
Oklahoma,Insurance Commissioner,Glen Mulready,REP,550126,0,0,233,233,
Oklahoma,Insurance Commissioner,Kimberly Fobbs,DEM,550126,0,0,542,542,
Oklahoma,Corporation Commissioner,Bob Anthony,REP,550126,0,0,237,237,
Oklahoma,Corporation Commissioner,Ashley Nicole Mccray,DEM,550126,0,0,503,503,
Oklahoma,Corporation Commissioner,Jackie Short,IND,550126,0,0,46,46,
Oklahoma,U.S. House,Steve Russell,REP,550126,0,0,227,227,5
Oklahoma,U.S. House,Kendra Horn,DEM,550126,0,0,563,563,5
Oklahoma,State Senate,Willard Linzy,REP,550126,0,0,222,222,48
Oklahoma,State Senate,George Young,DEM,550126,0,0,551,551,48
Oklahoma,State House,Jason Reese,REP,550126,0,0,229,229,83
Oklahoma,State House,Chelsey Branham,DEM,550126,0,0,555,555,83
Oklahoma,Governor,Chris Powell,LIB,550127,0,0,30,30,
Oklahoma,Governor,Kevin Stitt,REP,550127,0,0,504,504,
Oklahoma,Governor,Drew Edmondson,DEM,550127,0,0,503,503,
Oklahoma,Lieutenant Governor,Matt Pinnell,REP,550127,0,0,597,597,
Oklahoma,Lieutenant Governor,Anastasia Pittman,DEM,550127,0,0,394,394,
Oklahoma,Lieutenant Governor,Ivan Holmes,IND,550127,0,0,38,38,
Oklahoma,State Auditor,John Yeutter,LIB,550127,0,0,250,250,
Oklahoma,State Auditor,Cindy Byrd,REP,550127,0,0,695,695,
Oklahoma,Attorney General,Mike Hunter,REP,550127,0,0,637,637,
Oklahoma,Attorney General,Mark Myles,DEM,550127,0,0,382,382,
Oklahoma,State Treasurer,Randy Mcdaniel,REP,550127,0,0,663,663,
Oklahoma,State Treasurer,Charles De Coune,IND,550127,0,0,283,283,
Oklahoma,Superintendent of Public Instruction,Joy Hofmeister,REP,550127,0,0,578,578,
Oklahoma,Superintendent of Public Instruction,John Cox,DEM,550127,0,0,355,355,
Oklahoma,Superintendent of Public Instruction,Larry Huff,IND,550127,0,0,81,81,
Oklahoma,Commissioner of Labor,Leslie Osborn,REP,550127,0,0,600,600,
Oklahoma,Commissioner of Labor,Fred Dorrell,DEM,550127,0,0,361,361,
Oklahoma,Commissioner of Labor,Brandt Dismukes,IND,550127,0,0,48,48,
Oklahoma,Insurance Commissioner,Glen Mulready,REP,550127,0,0,599,599,
Oklahoma,Insurance Commissioner,Kimberly Fobbs,DEM,550127,0,0,410,410,
Oklahoma,Corporation Commissioner,Bob Anthony,REP,550127,0,0,578,578,
Oklahoma,Corporation Commissioner,Ashley Nicole Mccray,DEM,550127,0,0,383,383,
Oklahoma,Corporation Commissioner,Jackie Short,IND,550127,0,0,57,57,
Oklahoma,U.S. House,Steve Russell,REP,550127,0,0,574,574,5
Oklahoma,U.S. House,Kendra Horn,DEM,550127,0,0,445,445,5
Oklahoma,State House,Jason Reese,REP,550127,0,0,561,561,83
Oklahoma,State House,Chelsey Branham,DEM,550127,0,0,453,453,83
Oklahoma,Governor,Chris Powell,LIB,550128,0,0,41,41,
Oklahoma,Governor,Kevin Stitt,REP,550128,0,0,390,390,
Oklahoma,Governor,Drew Edmondson,DEM,550128,0,0,546,546,
Oklahoma,Lieutenant Governor,Matt Pinnell,REP,550128,0,0,458,458,
Oklahoma,Lieutenant Governor,Anastasia Pittman,DEM,550128,0,0,473,473,
Oklahoma,Lieutenant Governor,Ivan Holmes,IND,550128,0,0,35,35,
Oklahoma,State Auditor,John Yeutter,LIB,550128,0,0,328,328,
Oklahoma,State Auditor,Cindy Byrd,REP,550128,0,0,551,551,
Oklahoma,Attorney General,Mike Hunter,REP,550128,0,0,489,489,
Oklahoma,Attorney General,Mark Myles,DEM,550128,0,0,471,471,
Oklahoma,State Treasurer,Randy Mcdaniel,REP,550128,0,0,518,518,
Oklahoma,State Treasurer,Charles De Coune,IND,550128,0,0,366,366,
Oklahoma,Superintendent of Public Instruction,Joy Hofmeister,REP,550128,0,0,443,443,
Oklahoma,Superintendent of Public Instruction,John Cox,DEM,550128,0,0,437,437,
Oklahoma,Superintendent of Public Instruction,Larry Huff,IND,550128,0,0,87,87,
Oklahoma,Commissioner of Labor,Leslie Osborn,REP,550128,0,0,473,473,
Oklahoma,Commissioner of Labor,Fred Dorrell,DEM,550128,0,0,427,427,
Oklahoma,Commissioner of Labor,Brandt Dismukes,IND,550128,0,0,56,56,
Oklahoma,Insurance Commissioner,Glen Mulready,REP,550128,0,0,458,458,
Oklahoma,Insurance Commissioner,Kimberly Fobbs,DEM,550128,0,0,495,495,
Oklahoma,Corporation Commissioner,Bob Anthony,REP,550128,0,0,435,435,
Oklahoma,Corporation Commissioner,Ashley Nicole Mccray,DEM,550128,0,0,461,461,
Oklahoma,Corporation Commissioner,Jackie Short,IND,550128,0,0,63,63,
Oklahoma,U.S. House,Steve Russell,REP,550128,0,0,442,442,5
Oklahoma,U.S. House,Kendra Horn,DEM,550128,0,0,525,525,5
Oklahoma,State House,Jason Reese,REP,550128,0,0,434,434,83
Oklahoma,State House,Chelsey Branham,DEM,550128,0,0,527,527,83
Oklahoma,Governor,Chris Powell,LIB,550129,0,0,25,25,
Oklahoma,Governor,Kevin Stitt,REP,550129,0,0,228,228,
Oklahoma,Governor,Drew Edmondson,DEM,550129,0,0,335,335,
Oklahoma,Lieutenant Governor,Matt Pinnell,REP,550129,0,0,282,282,
Oklahoma,Lieutenant Governor,Anastasia Pittman,DEM,550129,0,0,267,267,
Oklahoma,Lieutenant Governor,Ivan Holmes,IND,550129,0,0,31,31,
Oklahoma,State Auditor,John Yeutter,LIB,550129,0,0,187,187,
Oklahoma,State Auditor,Cindy Byrd,REP,550129,0,0,334,334,
Oklahoma,Attorney General,Mike Hunter,REP,550129,0,0,306,306,
Oklahoma,Attorney General,Mark Myles,DEM,550129,0,0,272,272,
Oklahoma,State Treasurer,Randy Mcdaniel,REP,550129,0,0,313,313,
Oklahoma,State Treasurer,Charles De Coune,IND,550129,0,0,219,219,
Oklahoma,Superintendent of Public Instruction,Joy Hofmeister,REP,550129,0,0,272,272,
Oklahoma,Superintendent of Public Instruction,John Cox,DEM,550129,0,0,258,258,
Oklahoma,Superintendent of Public Instruction,Larry Huff,IND,550129,0,0,46,46,
Oklahoma,Commissioner of Labor,Leslie Osborn,REP,550129,0,0,278,278,
Oklahoma,Commissioner of Labor,Fred Dorrell,DEM,550129,0,0,256,256,
Oklahoma,Commissioner of Labor,Brandt Dismukes,IND,550129,0,0,31,31,
Oklahoma,Insurance Commissioner,Glen Mulready,REP,550129,0,0,278,278,
Oklahoma,Insurance Commissioner,Kimberly Fobbs,DEM,550129,0,0,288,288,
Oklahoma,Corporation Commissioner,Bob Anthony,REP,550129,0,0,278,278,
Oklahoma,Corporation Commissioner,Ashley Nicole Mccray,DEM,550129,0,0,259,259,
Oklahoma,Corporation Commissioner,Jackie Short,IND,550129,0,0,35,35,
Oklahoma,U.S. House,Steve Russell,REP,550129,0,0,262,262,5
Oklahoma,U.S. House,Kendra Horn,DEM,550129,0,0,320,320,5
Oklahoma,State House,Jason Reese,REP,550129,0,0,250,250,83
Oklahoma,State House,Chelsey Branham,DEM,550129,0,0,316,316,83
Oklahoma,Governor,Chris Powell,LIB,550130,0,0,47,47,
Oklahoma,Governor,Kevin Stitt,REP,550130,0,0,625,625,
Oklahoma,Governor,Drew Edmondson,DEM,550130,0,0,776,776,
Oklahoma,Lieutenant Governor,Matt Pinnell,REP,550130,0,0,749,749,
Oklahoma,Lieutenant Governor,Anastasia Pittman,DEM,550130,0,0,643,643,
Oklahoma,Lieutenant Governor,Ivan Holmes,IND,550130,0,0,50,50,
Oklahoma,State Auditor,John Yeutter,LIB,550130,0,0,375,375,
Oklahoma,State Auditor,Cindy Byrd,REP,550130,0,0,921,921,
Oklahoma,Attorney General,Mike Hunter,REP,550130,0,0,787,787,
Oklahoma,Attorney General,Mark Myles,DEM,550130,0,0,654,654,
Oklahoma,State Treasurer,Randy Mcdaniel,REP,550130,0,0,831,831,
Oklahoma,State Treasurer,Charles De Coune,IND,550130,0,0,474,474,
Oklahoma,Superintendent of Public Instruction,Joy Hofmeister,REP,550130,0,0,736,736,
Oklahoma,Superintendent of Public Instruction,John Cox,DEM,550130,0,0,560,560,
Oklahoma,Superintendent of Public Instruction,Larry Huff,IND,550130,0,0,134,134,
Oklahoma,Commissioner of Labor,Leslie Osborn,REP,550130,0,0,772,772,
Oklahoma,Commissioner of Labor,Fred Dorrell,DEM,550130,0,0,577,577,
Oklahoma,Commissioner of Labor,Brandt Dismukes,IND,550130,0,0,71,71,
Oklahoma,Insurance Commissioner,Glen Mulready,REP,550130,0,0,738,738,
Oklahoma,Insurance Commissioner,Kimberly Fobbs,DEM,550130,0,0,680,680,
Oklahoma,Corporation Commissioner,Bob Anthony,REP,550130,0,0,731,731,
Oklahoma,Corporation Commissioner,Ashley Nicole Mccray,DEM,550130,0,0,601,601,
Oklahoma,Corporation Commissioner,Jackie Short,IND,550130,0,0,94,94,
Oklahoma,U.S. House,Steve Russell,REP,550130,0,0,708,708,5
Oklahoma,U.S. House,Kendra Horn,DEM,550130,0,0,732,732,5
Oklahoma,State House,Jason Reese,REP,550130,0,0,685,685,83
Oklahoma,State House,Chelsey Branham,DEM,550130,0,0,737,737,83
Oklahoma,Governor,Chris Powell,LIB,550131,0,0,14,14,
Oklahoma,Governor,Kevin Stitt,REP,550131,0,0,372,372,
Oklahoma,Governor,Drew Edmondson,DEM,550131,0,0,321,321,
Oklahoma,Lieutenant Governor,Matt Pinnell,REP,550131,0,0,452,452,
Oklahoma,Lieutenant Governor,Anastasia Pittman,DEM,550131,0,0,231,231,
Oklahoma,Lieutenant Governor,Ivan Holmes,IND,550131,0,0,22,22,
Oklahoma,State Auditor,John Yeutter,LIB,550131,0,0,136,136,
Oklahoma,State Auditor,Cindy Byrd,REP,550131,0,0,502,502,
Oklahoma,Attorney General,Mike Hunter,REP,550131,0,0,464,464,
Oklahoma,Attorney General,Mark Myles,DEM,550131,0,0,235,235,
Oklahoma,State Treasurer,Randy Mcdaniel,REP,550131,0,0,484,484,
Oklahoma,State Treasurer,Charles De Coune,IND,550131,0,0,157,157,
Oklahoma,Superintendent of Public Instruction,Joy Hofmeister,REP,550131,0,0,444,444,
Oklahoma,Superintendent of Public Instruction,John Cox,DEM,550131,0,0,217,217,
Oklahoma,Superintendent of Public Instruction,Larry Huff,IND,550131,0,0,35,35,
Oklahoma,Commissioner of Labor,Leslie Osborn,REP,550131,0,0,460,460,
Oklahoma,Commissioner of Labor,Fred Dorrell,DEM,550131,0,0,204,204,
Oklahoma,Commissioner of Labor,Brandt Dismukes,IND,550131,0,0,21,21,
Oklahoma,Insurance Commissioner,Glen Mulready,REP,550131,0,0,438,438,
Oklahoma,Insurance Commissioner,Kimberly Fobbs,DEM,550131,0,0,244,244,
Oklahoma,Corporation Commissioner,Bob Anthony,REP,550131,0,0,437,437,
Oklahoma,Corporation Commissioner,Ashley Nicole Mccray,DEM,550131,0,0,228,228,
Oklahoma,Corporation Commissioner,Jackie Short,IND,550131,0,0,28,28,
Oklahoma,U.S. House,Steve Russell,REP,550131,0,0,423,423,5
Oklahoma,U.S. House,Kendra Horn,DEM,550131,0,0,281,281,5
Oklahoma,State House,Jason Reese,REP,550131,0,0,413,413,83
Oklahoma,State House,Chelsey Branham,DEM,550131,0,0,283,283,83
Oklahoma,Governor,Chris Powell,LIB,550132,0,0,21,21,
Oklahoma,Governor,Kevin Stitt,REP,550132,0,0,422,422,
Oklahoma,Governor,Drew Edmondson,DEM,550132,0,0,382,382,
Oklahoma,Lieutenant Governor,Matt Pinnell,REP,550132,0,0,479,479,
Oklahoma,Lieutenant Governor,Anastasia Pittman,DEM,550132,0,0,325,325,
Oklahoma,Lieutenant Governor,Ivan Holmes,IND,550132,0,0,19,19,
Oklahoma,State Auditor,John Yeutter,LIB,550132,0,0,195,195,
Oklahoma,State Auditor,Cindy Byrd,REP,550132,0,0,559,559,
Oklahoma,Attorney General,Mike Hunter,REP,550132,0,0,500,500,
Oklahoma,Attorney General,Mark Myles,DEM,550132,0,0,320,320,
Oklahoma,State Treasurer,Randy Mcdaniel,REP,550132,0,0,520,520,
Oklahoma,State Treasurer,Charles De Coune,IND,550132,0,0,240,240,
Oklahoma,Superintendent of Public Instruction,Joy Hofmeister,REP,550132,0,0,481,481,
Oklahoma,Superintendent of Public Instruction,John Cox,DEM,550132,0,0,276,276,
Oklahoma,Superintendent of Public Instruction,Larry Huff,IND,550132,0,0,60,60,
Oklahoma,Commissioner of Labor,Leslie Osborn,REP,550132,0,0,504,504,
Oklahoma,Commissioner of Labor,Fred Dorrell,DEM,550132,0,0,277,277,
Oklahoma,Commissioner of Labor,Brandt Dismukes,IND,550132,0,0,31,31,
Oklahoma,Insurance Commissioner,Glen Mulready,REP,550132,0,0,477,477,
Oklahoma,Insurance Commissioner,Kimberly Fobbs,DEM,550132,0,0,331,331,
Oklahoma,Corporation Commissioner,Bob Anthony,REP,550132,0,0,469,469,
Oklahoma,Corporation Commissioner,Ashley Nicole Mccray,DEM,550132,0,0,299,299,
Oklahoma,Corporation Commissioner,Jackie Short,IND,550132,0,0,44,44,
Oklahoma,U.S. House,Steve Russell,REP,550132,0,0,449,449,5
Oklahoma,U.S. House,Kendra Horn,DEM,550132,0,0,372,372,5
Oklahoma,State House,Jason Reese,REP,550132,0,0,452,452,83
Oklahoma,State House,Chelsey Branham,DEM,550132,0,0,364,364,83
Oklahoma,Governor,Chris Powell,LIB,550133,0,0,23,23,
Oklahoma,Governor,Kevin Stitt,REP,550133,0,0,397,397,
Oklahoma,Governor,Drew Edmondson,DEM,550133,0,0,515,515,
Oklahoma,Lieutenant Governor,Matt Pinnell,REP,550133,0,0,485,485,
Oklahoma,Lieutenant Governor,Anastasia Pittman,DEM,550133,0,0,421,421,
Oklahoma,Lieutenant Governor,Ivan Holmes,IND,550133,0,0,24,24,
Oklahoma,State Auditor,John Yeutter,LIB,550133,0,0,268,268,
Oklahoma,State Auditor,Cindy Byrd,REP,550133,0,0,601,601,
Oklahoma,Attorney General,Mike Hunter,REP,550133,0,0,511,511,
Oklahoma,Attorney General,Mark Myles,DEM,550133,0,0,408,408,
Oklahoma,State Treasurer,Randy Mcdaniel,REP,550133,0,0,529,529,
Oklahoma,State Treasurer,Charles De Coune,IND,550133,0,0,340,340,
Oklahoma,Superintendent of Public Instruction,Joy Hofmeister,REP,550133,0,0,494,494,
Oklahoma,Superintendent of Public Instruction,John Cox,DEM,550133,0,0,364,364,
Oklahoma,Superintendent of Public Instruction,Larry Huff,IND,550133,0,0,69,69,
Oklahoma,Commissioner of Labor,Leslie Osborn,REP,550133,0,0,515,515,
Oklahoma,Commissioner of Labor,Fred Dorrell,DEM,550133,0,0,370,370,
Oklahoma,Commissioner of Labor,Brandt Dismukes,IND,550133,0,0,30,30,
Oklahoma,Insurance Commissioner,Glen Mulready,REP,550133,0,0,486,486,
Oklahoma,Insurance Commissioner,Kimberly Fobbs,DEM,550133,0,0,423,423,
Oklahoma,Corporation Commissioner,Bob Anthony,REP,550133,0,0,464,464,
Oklahoma,Corporation Commissioner,Ashley Nicole Mccray,DEM,550133,0,0,401,401,
Oklahoma,Corporation Commissioner,Jackie Short,IND,550133,0,0,50,50,
Oklahoma,U.S. House,Steve Russell,REP,550133,0,0,452,452,5
Oklahoma,U.S. House,Kendra Horn,DEM,550133,0,0,474,474,5
Oklahoma,State Senate,Stephanie Bice,REP,550133,0,0,521,521,22
Oklahoma,State Senate,William Andrews,DEM,550133,0,0,390,390,22
Oklahoma,State House,Ryan Martinez,REP,550133,0,0,469,469,39
Oklahoma,State House,Devyn Denton,DEM,550133,0,0,408,408,39
Oklahoma,State House,Richard Prawdzienski,IND,550133,0,0,31,31,39
Oklahoma,Governor,Chris Powell,LIB,550134,0,0,60,60,
Oklahoma,Governor,Kevin Stitt,REP,550134,0,0,831,831,
Oklahoma,Governor,Drew Edmondson,DEM,550134,0,0,799,799,
Oklahoma,Lieutenant Governor,Matt Pinnell,REP,550134,0,0,1000,1000,
Oklahoma,Lieutenant Governor,Anastasia Pittman,DEM,550134,0,0,619,619,
Oklahoma,Lieutenant Governor,Ivan Holmes,IND,550134,0,0,58,58,
Oklahoma,State Auditor,John Yeutter,LIB,550134,0,0,406,406,
Oklahoma,State Auditor,Cindy Byrd,REP,550134,0,0,1124,1124,
Oklahoma,Attorney General,Mike Hunter,REP,550134,0,0,1028,1028,
Oklahoma,Attorney General,Mark Myles,DEM,550134,0,0,639,639,
Oklahoma,State Treasurer,Randy Mcdaniel,REP,550134,0,0,1034,1034,
Oklahoma,State Treasurer,Charles De Coune,IND,550134,0,0,499,499,
Oklahoma,Superintendent of Public Instruction,Joy Hofmeister,REP,550134,0,0,966,966,
Oklahoma,Superintendent of Public Instruction,John Cox,DEM,550134,0,0,574,574,
Oklahoma,Superintendent of Public Instruction,Larry Huff,IND,550134,0,0,129,129,
Oklahoma,Commissioner of Labor,Leslie Osborn,REP,550134,0,0,1008,1008,
Oklahoma,Commissioner of Labor,Fred Dorrell,DEM,550134,0,0,565,565,
Oklahoma,Commissioner of Labor,Brandt Dismukes,IND,550134,0,0,74,74,
Oklahoma,Insurance Commissioner,Glen Mulready,REP,550134,0,0,972,972,
Oklahoma,Insurance Commissioner,Kimberly Fobbs,DEM,550134,0,0,672,672,
Oklahoma,Corporation Commissioner,Bob Anthony,REP,550134,0,0,941,941,
Oklahoma,Corporation Commissioner,Ashley Nicole Mccray,DEM,550134,0,0,621,621,
Oklahoma,Corporation Commissioner,Jackie Short,IND,550134,0,0,92,92,
Oklahoma,U.S. House,Steve Russell,REP,550134,0,0,956,956,5
Oklahoma,U.S. House,Kendra Horn,DEM,550134,0,0,720,720,5
Oklahoma,State Senate,Stephanie Bice,REP,550134,0,0,1063,1063,22
Oklahoma,State Senate,William Andrews,DEM,550134,0,0,602,602,22
Oklahoma,State House,Nicole Miller,REP,550134,0,0,1091,1091,82
Oklahoma,State House,Oraynab Jwayyed,DEM,550134,0,0,573,573,82
Oklahoma,Governor,Chris Powell,LIB,550135,0,0,20,20,
Oklahoma,Governor,Kevin Stitt,REP,550135,0,0,260,260,
Oklahoma,Governor,Drew Edmondson,DEM,550135,0,0,304,304,
Oklahoma,Lieutenant Governor,Matt Pinnell,REP,550135,0,0,316,316,
Oklahoma,Lieutenant Governor,Anastasia Pittman,DEM,550135,0,0,238,238,
Oklahoma,Lieutenant Governor,Ivan Holmes,IND,550135,0,0,22,22,
Oklahoma,State Auditor,John Yeutter,LIB,550135,0,0,160,160,
Oklahoma,State Auditor,Cindy Byrd,REP,550135,0,0,377,377,
Oklahoma,Attorney General,Mike Hunter,REP,550135,0,0,335,335,
Oklahoma,Attorney General,Mark Myles,DEM,550135,0,0,238,238,
Oklahoma,State Treasurer,Randy Mcdaniel,REP,550135,0,0,318,318,
Oklahoma,State Treasurer,Charles De Coune,IND,550135,0,0,216,216,
Oklahoma,Superintendent of Public Instruction,Joy Hofmeister,REP,550135,0,0,327,327,
Oklahoma,Superintendent of Public Instruction,John Cox,DEM,550135,0,0,206,206,
Oklahoma,Superintendent of Public Instruction,Larry Huff,IND,550135,0,0,44,44,
Oklahoma,Commissioner of Labor,Leslie Osborn,REP,550135,0,0,324,324,
Oklahoma,Commissioner of Labor,Fred Dorrell,DEM,550135,0,0,216,216,
Oklahoma,Commissioner of Labor,Brandt Dismukes,IND,550135,0,0,27,27,
Oklahoma,Insurance Commissioner,Glen Mulready,REP,550135,0,0,308,308,
Oklahoma,Insurance Commissioner,Kimberly Fobbs,DEM,550135,0,0,255,255,
Oklahoma,Corporation Commissioner,Bob Anthony,REP,550135,0,0,280,280,
Oklahoma,Corporation Commissioner,Ashley Nicole Mccray,DEM,550135,0,0,243,243,
Oklahoma,Corporation Commissioner,Jackie Short,IND,550135,0,0,42,42,
Oklahoma,U.S. House,Steve Russell,REP,550135,0,0,296,296,5
Oklahoma,U.S. House,Kendra Horn,DEM,550135,0,0,282,282,5
Oklahoma,State Senate,Stephanie Bice,REP,550135,0,0,353,353,22
Oklahoma,State Senate,William Andrews,DEM,550135,0,0,219,219,22
Oklahoma,State House,Nicole Miller,REP,550135,0,0,360,360,82
Oklahoma,State House,Oraynab Jwayyed,DEM,550135,0,0,209,209,82
Oklahoma,Governor,Chris Powell,LIB,550136,0,0,57,57,
Oklahoma,Governor,Kevin Stitt,REP,550136,0,0,907,907,
Oklahoma,Governor,Drew Edmondson,DEM,550136,0,0,930,930,
Oklahoma,Lieutenant Governor,Matt Pinnell,REP,550136,0,0,1093,1093,
Oklahoma,Lieutenant Governor,Anastasia Pittman,DEM,550136,0,0,719,719,
Oklahoma,Lieutenant Governor,Ivan Holmes,IND,550136,0,0,62,62,
Oklahoma,State Auditor,John Yeutter,LIB,550136,0,0,454,454,
Oklahoma,State Auditor,Cindy Byrd,REP,550136,0,0,1297,1297,
Oklahoma,Attorney General,Mike Hunter,REP,550136,0,0,1145,1145,
Oklahoma,Attorney General,Mark Myles,DEM,550136,0,0,713,713,
Oklahoma,State Treasurer,Randy Mcdaniel,REP,550136,0,0,1170,1170,
Oklahoma,State Treasurer,Charles De Coune,IND,550136,0,0,566,566,
Oklahoma,Superintendent of Public Instruction,Joy Hofmeister,REP,550136,0,0,1063,1063,
Oklahoma,Superintendent of Public Instruction,John Cox,DEM,550136,0,0,649,649,
Oklahoma,Superintendent of Public Instruction,Larry Huff,IND,550136,0,0,154,154,
Oklahoma,Commissioner of Labor,Leslie Osborn,REP,550136,0,0,1133,1133,
Oklahoma,Commissioner of Labor,Fred Dorrell,DEM,550136,0,0,606,606,
Oklahoma,Commissioner of Labor,Brandt Dismukes,IND,550136,0,0,86,86,
Oklahoma,Insurance Commissioner,Glen Mulready,REP,550136,0,0,1052,1052,
Oklahoma,Insurance Commissioner,Kimberly Fobbs,DEM,550136,0,0,766,766,
Oklahoma,Corporation Commissioner,Bob Anthony,REP,550136,0,0,1019,1019,
Oklahoma,Corporation Commissioner,Ashley Nicole Mccray,DEM,550136,0,0,704,704,
Oklahoma,Corporation Commissioner,Jackie Short,IND,550136,0,0,109,109,
Oklahoma,U.S. House,Steve Russell,REP,550136,0,0,1010,1010,5
Oklahoma,U.S. House,Kendra Horn,DEM,550136,0,0,858,858,5
Oklahoma,State Senate,Stephanie Bice,REP,550136,0,0,1206,1206,22
Oklahoma,State Senate,William Andrews,DEM,550136,0,0,640,640,22
Oklahoma,State House,Nicole Miller,REP,550136,0,0,1245,1245,82
Oklahoma,State House,Oraynab Jwayyed,DEM,550136,0,0,598,598,82
Oklahoma,Governor,Chris Powell,LIB,550137,0,0,35,35,
Oklahoma,Governor,Kevin Stitt,REP,550137,0,0,870,870,
Oklahoma,Governor,Drew Edmondson,DEM,550137,0,0,640,640,
Oklahoma,Lieutenant Governor,Matt Pinnell,REP,550137,0,0,1063,1063,
Oklahoma,Lieutenant Governor,Anastasia Pittman,DEM,550137,0,0,428,428,
Oklahoma,Lieutenant Governor,Ivan Holmes,IND,550137,0,0,38,38,
Oklahoma,State Auditor,John Yeutter,LIB,550137,0,0,278,278,
Oklahoma,State Auditor,Cindy Byrd,REP,550137,0,0,1177,1177,
Oklahoma,Attorney General,Mike Hunter,REP,550137,0,0,1064,1064,
Oklahoma,Attorney General,Mark Myles,DEM,550137,0,0,453,453,
Oklahoma,State Treasurer,Randy Mcdaniel,REP,550137,0,0,1102,1102,
Oklahoma,State Treasurer,Charles De Coune,IND,550137,0,0,351,351,
Oklahoma,Superintendent of Public Instruction,Joy Hofmeister,REP,550137,0,0,1029,1029,
Oklahoma,Superintendent of Public Instruction,John Cox,DEM,550137,0,0,394,394,
Oklahoma,Superintendent of Public Instruction,Larry Huff,IND,550137,0,0,99,99,
Oklahoma,Commissioner of Labor,Leslie Osborn,REP,550137,0,0,1073,1073,
Oklahoma,Commissioner of Labor,Fred Dorrell,DEM,550137,0,0,373,373,
Oklahoma,Commissioner of Labor,Brandt Dismukes,IND,550137,0,0,53,53,
Oklahoma,Insurance Commissioner,Glen Mulready,REP,550137,0,0,1021,1021,
Oklahoma,Insurance Commissioner,Kimberly Fobbs,DEM,550137,0,0,478,478,
Oklahoma,Corporation Commissioner,Bob Anthony,REP,550137,0,0,990,990,
Oklahoma,Corporation Commissioner,Ashley Nicole Mccray,DEM,550137,0,0,429,429,
Oklahoma,Corporation Commissioner,Jackie Short,IND,550137,0,0,89,89,
Oklahoma,U.S. House,Steve Russell,REP,550137,0,0,985,985,5
Oklahoma,U.S. House,Kendra Horn,DEM,550137,0,0,541,541,5
Oklahoma,State Senate,Stephanie Bice,REP,550137,0,0,1108,1108,22
Oklahoma,State Senate,William Andrews,DEM,550137,0,0,405,405,22
Oklahoma,State House,Nicole Miller,REP,550137,0,0,1175,1175,82
Oklahoma,State House,Oraynab Jwayyed,DEM,550137,0,0,337,337,82
Oklahoma,Governor,Chris Powell,LIB,550138,0,0,8,8,
Oklahoma,Governor,Kevin Stitt,REP,550138,0,0,366,366,
Oklahoma,Governor,Drew Edmondson,DEM,550138,0,0,194,194,
Oklahoma,Lieutenant Governor,Matt Pinnell,REP,550138,0,0,415,415,
Oklahoma,Lieutenant Governor,Anastasia Pittman,DEM,550138,0,0,135,135,
Oklahoma,Lieutenant Governor,Ivan Holmes,IND,550138,0,0,15,15,
Oklahoma,State Auditor,John Yeutter,LIB,550138,0,0,101,101,
Oklahoma,State Auditor,Cindy Byrd,REP,550138,0,0,432,432,
Oklahoma,Attorney General,Mike Hunter,REP,550138,0,0,423,423,
Oklahoma,Attorney General,Mark Myles,DEM,550138,0,0,140,140,
Oklahoma,State Treasurer,Randy Mcdaniel,REP,550138,0,0,421,421,
Oklahoma,State Treasurer,Charles De Coune,IND,550138,0,0,112,112,
Oklahoma,Superintendent of Public Instruction,Joy Hofmeister,REP,550138,0,0,392,392,
Oklahoma,Superintendent of Public Instruction,John Cox,DEM,550138,0,0,125,125,
Oklahoma,Superintendent of Public Instruction,Larry Huff,IND,550138,0,0,44,44,
Oklahoma,Commissioner of Labor,Leslie Osborn,REP,550138,0,0,407,407,
Oklahoma,Commissioner of Labor,Fred Dorrell,DEM,550138,0,0,121,121,
Oklahoma,Commissioner of Labor,Brandt Dismukes,IND,550138,0,0,25,25,
Oklahoma,Insurance Commissioner,Glen Mulready,REP,550138,0,0,413,413,
Oklahoma,Insurance Commissioner,Kimberly Fobbs,DEM,550138,0,0,147,147,
Oklahoma,Corporation Commissioner,Bob Anthony,REP,550138,0,0,393,393,
Oklahoma,Corporation Commissioner,Ashley Nicole Mccray,DEM,550138,0,0,134,134,
Oklahoma,Corporation Commissioner,Jackie Short,IND,550138,0,0,35,35,
Oklahoma,U.S. House,Steve Russell,REP,550138,0,0,400,400,5
Oklahoma,U.S. House,Kendra Horn,DEM,550138,0,0,167,167,5
Oklahoma,State Senate,Stephanie Bice,REP,550138,0,0,424,424,22
Oklahoma,State Senate,William Andrews,DEM,550138,0,0,138,138,22
Oklahoma,State House,Denise Crosswhite Hader,REP,550138,0,0,400,400,41
Oklahoma,State House,Jennie Scott,DEM,550138,0,0,160,160,41
Oklahoma,Governor,Chris Powell,LIB,550139,0,0,51,51,
Oklahoma,Governor,Kevin Stitt,REP,550139,0,0,1179,1179,
Oklahoma,Governor,Drew Edmondson,DEM,550139,0,0,1046,1046,
Oklahoma,Lieutenant Governor,Matt Pinnell,REP,550139,0,0,1439,1439,
Oklahoma,Lieutenant Governor,Anastasia Pittman,DEM,550139,0,0,754,754,
Oklahoma,Lieutenant Governor,Ivan Holmes,IND,550139,0,0,69,69,
Oklahoma,State Auditor,John Yeutter,LIB,550139,0,0,501,501,
Oklahoma,State Auditor,Cindy Byrd,REP,550139,0,0,1609,1609,
Oklahoma,Attorney General,Mike Hunter,REP,550139,0,0,1490,1490,
Oklahoma,Attorney General,Mark Myles,DEM,550139,0,0,755,755,
Oklahoma,State Treasurer,Randy Mcdaniel,REP,550139,0,0,1506,1506,
Oklahoma,State Treasurer,Charles De Coune,IND,550139,0,0,589,589,
Oklahoma,Superintendent of Public Instruction,Joy Hofmeister,REP,550139,0,0,1417,1417,
Oklahoma,Superintendent of Public Instruction,John Cox,DEM,550139,0,0,665,665,
Oklahoma,Superintendent of Public Instruction,Larry Huff,IND,550139,0,0,164,164,
Oklahoma,Commissioner of Labor,Leslie Osborn,REP,550139,0,0,1478,1478,
Oklahoma,Commissioner of Labor,Fred Dorrell,DEM,550139,0,0,641,641,
Oklahoma,Commissioner of Labor,Brandt Dismukes,IND,550139,0,0,97,97,
Oklahoma,Insurance Commissioner,Glen Mulready,REP,550139,0,0,1412,1412,
Oklahoma,Insurance Commissioner,Kimberly Fobbs,DEM,550139,0,0,801,801,
Oklahoma,Corporation Commissioner,Bob Anthony,REP,550139,0,0,1366,1366,
Oklahoma,Corporation Commissioner,Ashley Nicole Mccray,DEM,550139,0,0,731,731,
Oklahoma,Corporation Commissioner,Jackie Short,IND,550139,0,0,130,130,
Oklahoma,U.S. House,Steve Russell,REP,550139,0,0,1319,1319,5
Oklahoma,U.S. House,Kendra Horn,DEM,550139,0,0,935,935,5
Oklahoma,State House,Nicole Miller,REP,550139,0,0,1629,1629,82
Oklahoma,State House,Oraynab Jwayyed,DEM,550139,0,0,610,610,82
Oklahoma,Governor,Chris Powell,LIB,550140,0,0,14,14,
Oklahoma,Governor,Kevin Stitt,REP,550140,0,0,461,461,
Oklahoma,Governor,Drew Edmondson,DEM,550140,0,0,354,354,
Oklahoma,Lieutenant Governor,Matt Pinnell,REP,550140,0,0,529,529,
Oklahoma,Lieutenant Governor,Anastasia Pittman,DEM,550140,0,0,271,271,
Oklahoma,Lieutenant Governor,Ivan Holmes,IND,550140,0,0,23,23,
Oklahoma,State Auditor,John Yeutter,LIB,550140,0,0,172,172,
Oklahoma,State Auditor,Cindy Byrd,REP,550140,0,0,597,597,
Oklahoma,Attorney General,Mike Hunter,REP,550140,0,0,548,548,
Oklahoma,Attorney General,Mark Myles,DEM,550140,0,0,269,269,
Oklahoma,State Treasurer,Randy Mcdaniel,REP,550140,0,0,561,561,
Oklahoma,State Treasurer,Charles De Coune,IND,550140,0,0,206,206,
Oklahoma,Superintendent of Public Instruction,Joy Hofmeister,REP,550140,0,0,512,512,
Oklahoma,Superintendent of Public Instruction,John Cox,DEM,550140,0,0,252,252,
Oklahoma,Superintendent of Public Instruction,Larry Huff,IND,550140,0,0,50,50,
Oklahoma,Commissioner of Labor,Leslie Osborn,REP,550140,0,0,540,540,
Oklahoma,Commissioner of Labor,Fred Dorrell,DEM,550140,0,0,248,248,
Oklahoma,Commissioner of Labor,Brandt Dismukes,IND,550140,0,0,23,23,
Oklahoma,Insurance Commissioner,Glen Mulready,REP,550140,0,0,528,528,
Oklahoma,Insurance Commissioner,Kimberly Fobbs,DEM,550140,0,0,280,280,
Oklahoma,Corporation Commissioner,Bob Anthony,REP,550140,0,0,508,508,
Oklahoma,Corporation Commissioner,Ashley Nicole Mccray,DEM,550140,0,0,273,273,
Oklahoma,Corporation Commissioner,Jackie Short,IND,550140,0,0,30,30,
Oklahoma,U.S. House,Steve Russell,REP,550140,0,0,504,504,5
Oklahoma,U.S. House,Kendra Horn,DEM,550140,0,0,319,319,5
Oklahoma,State House,Nicole Miller,REP,550140,0,0,572,572,82
Oklahoma,State House,Oraynab Jwayyed,DEM,550140,0,0,237,237,82
Oklahoma,Governor,Chris Powell,LIB,550141,0,0,42,42,
Oklahoma,Governor,Kevin Stitt,REP,550141,0,0,832,832,
Oklahoma,Governor,Drew Edmondson,DEM,550141,0,0,759,759,
Oklahoma,Lieutenant Governor,Matt Pinnell,REP,550141,0,0,985,985,
Oklahoma,Lieutenant Governor,Anastasia Pittman,DEM,550141,0,0,584,584,
Oklahoma,Lieutenant Governor,Ivan Holmes,IND,550141,0,0,52,52,
Oklahoma,State Auditor,John Yeutter,LIB,550141,0,0,380,380,
Oklahoma,State Auditor,Cindy Byrd,REP,550141,0,0,1117,1117,
Oklahoma,Attorney General,Mike Hunter,REP,550141,0,0,1018,1018,
Oklahoma,Attorney General,Mark Myles,DEM,550141,0,0,591,591,
Oklahoma,State Treasurer,Randy Mcdaniel,REP,550141,0,0,1040,1040,
Oklahoma,State Treasurer,Charles De Coune,IND,550141,0,0,466,466,
Oklahoma,Superintendent of Public Instruction,Joy Hofmeister,REP,550141,0,0,976,976,
Oklahoma,Superintendent of Public Instruction,John Cox,DEM,550141,0,0,524,524,
Oklahoma,Superintendent of Public Instruction,Larry Huff,IND,550141,0,0,116,116,
Oklahoma,Commissioner of Labor,Leslie Osborn,REP,550141,0,0,1011,1011,
Oklahoma,Commissioner of Labor,Fred Dorrell,DEM,550141,0,0,529,529,
Oklahoma,Commissioner of Labor,Brandt Dismukes,IND,550141,0,0,57,57,
Oklahoma,Insurance Commissioner,Glen Mulready,REP,550141,0,0,982,982,
Oklahoma,Insurance Commissioner,Kimberly Fobbs,DEM,550141,0,0,603,603,
Oklahoma,Corporation Commissioner,Bob Anthony,REP,550141,0,0,951,951,
Oklahoma,Corporation Commissioner,Ashley Nicole Mccray,DEM,550141,0,0,570,570,
Oklahoma,Corporation Commissioner,Jackie Short,IND,550141,0,0,80,80,
Oklahoma,U.S. House,Steve Russell,REP,550141,0,0,924,924,5
Oklahoma,U.S. House,Kendra Horn,DEM,550141,0,0,697,697,5
Oklahoma,State House,Denise Crosswhite Hader,REP,550141,0,0,944,944,41
Oklahoma,State House,Jennie Scott,DEM,550141,0,0,657,657,41
Oklahoma,Governor,Chris Powell,LIB,550142,0,0,49,49,
Oklahoma,Governor,Kevin Stitt,REP,550142,0,0,634,634,
Oklahoma,Governor,Drew Edmondson,DEM,550142,0,0,909,909,
Oklahoma,Lieutenant Governor,Matt Pinnell,REP,550142,0,0,770,770,
Oklahoma,Lieutenant Governor,Anastasia Pittman,DEM,550142,0,0,755,755,
Oklahoma,Lieutenant Governor,Ivan Holmes,IND,550142,0,0,55,55,
Oklahoma,State Auditor,John Yeutter,LIB,550142,0,0,451,451,
Oklahoma,State Auditor,Cindy Byrd,REP,550142,0,0,959,959,
Oklahoma,Attorney General,Mike Hunter,REP,550142,0,0,811,811,
Oklahoma,Attorney General,Mark Myles,DEM,550142,0,0,757,757,
Oklahoma,State Treasurer,Randy Mcdaniel,REP,550142,0,0,863,863,
Oklahoma,State Treasurer,Charles De Coune,IND,550142,0,0,548,548,
Oklahoma,Superintendent of Public Instruction,Joy Hofmeister,REP,550142,0,0,762,762,
Oklahoma,Superintendent of Public Instruction,John Cox,DEM,550142,0,0,676,676,
Oklahoma,Superintendent of Public Instruction,Larry Huff,IND,550142,0,0,133,133,
Oklahoma,Commissioner of Labor,Leslie Osborn,REP,550142,0,0,786,786,
Oklahoma,Commissioner of Labor,Fred Dorrell,DEM,550142,0,0,694,694,
Oklahoma,Commissioner of Labor,Brandt Dismukes,IND,550142,0,0,79,79,
Oklahoma,Insurance Commissioner,Glen Mulready,REP,550142,0,0,776,776,
Oklahoma,Insurance Commissioner,Kimberly Fobbs,DEM,550142,0,0,780,780,
Oklahoma,Corporation Commissioner,Bob Anthony,REP,550142,0,0,749,749,
Oklahoma,Corporation Commissioner,Ashley Nicole Mccray,DEM,550142,0,0,706,706,
Oklahoma,Corporation Commissioner,Jackie Short,IND,550142,0,0,108,108,
Oklahoma,U.S. House,Steve Russell,REP,550142,0,0,725,725,5
Oklahoma,U.S. House,Kendra Horn,DEM,550142,0,0,857,857,5
Oklahoma,State House,Nicole Miller,REP,550142,0,0,858,858,82
Oklahoma,State House,Oraynab Jwayyed,DEM,550142,0,0,703,703,82
Oklahoma,Governor,Chris Powell,LIB,550143,0,0,18,18,
Oklahoma,Governor,Kevin Stitt,REP,550143,0,0,514,514,
Oklahoma,Governor,Drew Edmondson,DEM,550143,0,0,371,371,
Oklahoma,Lieutenant Governor,Matt Pinnell,REP,550143,0,0,578,578,
Oklahoma,Lieutenant Governor,Anastasia Pittman,DEM,550143,0,0,295,295,
Oklahoma,Lieutenant Governor,Ivan Holmes,IND,550143,0,0,22,22,
Oklahoma,State Auditor,John Yeutter,LIB,550143,0,0,189,189,
Oklahoma,State Auditor,Cindy Byrd,REP,550143,0,0,650,650,
Oklahoma,Attorney General,Mike Hunter,REP,550143,0,0,601,601,
Oklahoma,Attorney General,Mark Myles,DEM,550143,0,0,293,293,
Oklahoma,State Treasurer,Randy Mcdaniel,REP,550143,0,0,629,629,
Oklahoma,State Treasurer,Charles De Coune,IND,550143,0,0,219,219,
Oklahoma,Superintendent of Public Instruction,Joy Hofmeister,REP,550143,0,0,573,573,
Oklahoma,Superintendent of Public Instruction,John Cox,DEM,550143,0,0,253,253,
Oklahoma,Superintendent of Public Instruction,Larry Huff,IND,550143,0,0,58,58,
Oklahoma,Commissioner of Labor,Leslie Osborn,REP,550143,0,0,587,587,
Oklahoma,Commissioner of Labor,Fred Dorrell,DEM,550143,0,0,255,255,
Oklahoma,Commissioner of Labor,Brandt Dismukes,IND,550143,0,0,36,36,
Oklahoma,Insurance Commissioner,Glen Mulready,REP,550143,0,0,575,575,
Oklahoma,Insurance Commissioner,Kimberly Fobbs,DEM,550143,0,0,302,302,
Oklahoma,Corporation Commissioner,Bob Anthony,REP,550143,0,0,566,566,
Oklahoma,Corporation Commissioner,Ashley Nicole Mccray,DEM,550143,0,0,270,270,
Oklahoma,Corporation Commissioner,Jackie Short,IND,550143,0,0,52,52,
Oklahoma,U.S. House,Steve Russell,REP,550143,0,0,561,561,5
Oklahoma,U.S. House,Kendra Horn,DEM,550143,0,0,337,337,5
Oklahoma,State House,Nicole Miller,REP,550143,0,0,624,624,82
Oklahoma,State House,Oraynab Jwayyed,DEM,550143,0,0,265,265,82
Oklahoma,Governor,Chris Powell,LIB,550144,0,0,26,26,
Oklahoma,Governor,Kevin Stitt,REP,550144,0,0,485,485,
Oklahoma,Governor,Drew Edmondson,DEM,550144,0,0,436,436,
Oklahoma,Lieutenant Governor,Matt Pinnell,REP,550144,0,0,565,565,
Oklahoma,Lieutenant Governor,Anastasia Pittman,DEM,550144,0,0,346,346,
Oklahoma,Lieutenant Governor,Ivan Holmes,IND,550144,0,0,32,32,
Oklahoma,State Auditor,John Yeutter,LIB,550144,0,0,222,222,
Oklahoma,State Auditor,Cindy Byrd,REP,550144,0,0,634,634,
Oklahoma,Attorney General,Mike Hunter,REP,550144,0,0,574,574,
Oklahoma,Attorney General,Mark Myles,DEM,550144,0,0,358,358,
Oklahoma,State Treasurer,Randy Mcdaniel,REP,550144,0,0,594,594,
Oklahoma,State Treasurer,Charles De Coune,IND,550144,0,0,265,265,
Oklahoma,Superintendent of Public Instruction,Joy Hofmeister,REP,550144,0,0,554,554,
Oklahoma,Superintendent of Public Instruction,John Cox,DEM,550144,0,0,303,303,
Oklahoma,Superintendent of Public Instruction,Larry Huff,IND,550144,0,0,80,80,
Oklahoma,Commissioner of Labor,Leslie Osborn,REP,550144,0,0,569,569,
Oklahoma,Commissioner of Labor,Fred Dorrell,DEM,550144,0,0,317,317,
Oklahoma,Commissioner of Labor,Brandt Dismukes,IND,550144,0,0,42,42,
Oklahoma,Insurance Commissioner,Glen Mulready,REP,550144,0,0,548,548,
Oklahoma,Insurance Commissioner,Kimberly Fobbs,DEM,550144,0,0,372,372,
Oklahoma,Corporation Commissioner,Bob Anthony,REP,550144,0,0,548,548,
Oklahoma,Corporation Commissioner,Ashley Nicole Mccray,DEM,550144,0,0,327,327,
Oklahoma,Corporation Commissioner,Jackie Short,IND,550144,0,0,55,55,
Oklahoma,U.S. House,Steve Russell,REP,550144,0,0,523,523,5
Oklahoma,U.S. House,Kendra Horn,DEM,550144,0,0,414,414,5
Oklahoma,State House,Nicole Miller,REP,550144,0,0,612,612,82
Oklahoma,State House,Oraynab Jwayyed,DEM,550144,0,0,318,318,82
Oklahoma,Governor,Chris Powell,LIB,550145,0,0,18,18,
Oklahoma,Governor,Kevin Stitt,REP,550145,0,0,515,515,
Oklahoma,Governor,Drew Edmondson,DEM,550145,0,0,357,357,
Oklahoma,Lieutenant Governor,Matt Pinnell,REP,550145,0,0,607,607,
Oklahoma,Lieutenant Governor,Anastasia Pittman,DEM,550145,0,0,264,264,
Oklahoma,Lieutenant Governor,Ivan Holmes,IND,550145,0,0,19,19,
Oklahoma,State Auditor,John Yeutter,LIB,550145,0,0,152,152,
Oklahoma,State Auditor,Cindy Byrd,REP,550145,0,0,674,674,
Oklahoma,Attorney General,Mike Hunter,REP,550145,0,0,631,631,
Oklahoma,Attorney General,Mark Myles,DEM,550145,0,0,251,251,
Oklahoma,State Treasurer,Randy Mcdaniel,REP,550145,0,0,666,666,
Oklahoma,State Treasurer,Charles De Coune,IND,550145,0,0,168,168,
Oklahoma,Superintendent of Public Instruction,Joy Hofmeister,REP,550145,0,0,590,590,
Oklahoma,Superintendent of Public Instruction,John Cox,DEM,550145,0,0,238,238,
Oklahoma,Superintendent of Public Instruction,Larry Huff,IND,550145,0,0,51,51,
Oklahoma,Commissioner of Labor,Leslie Osborn,REP,550145,0,0,633,633,
Oklahoma,Commissioner of Labor,Fred Dorrell,DEM,550145,0,0,209,209,
Oklahoma,Commissioner of Labor,Brandt Dismukes,IND,550145,0,0,30,30,
Oklahoma,Insurance Commissioner,Glen Mulready,REP,550145,0,0,590,590,
Oklahoma,Insurance Commissioner,Kimberly Fobbs,DEM,550145,0,0,273,273,
Oklahoma,Corporation Commissioner,Bob Anthony,REP,550145,0,0,625,625,
Oklahoma,Corporation Commissioner,Ashley Nicole Mccray,DEM,550145,0,0,207,207,
Oklahoma,Corporation Commissioner,Jackie Short,IND,550145,0,0,41,41,
Oklahoma,U.S. House,Steve Russell,REP,550145,0,0,583,583,5
Oklahoma,U.S. House,Kendra Horn,DEM,550145,0,0,306,306,5
Oklahoma,State Senate,John Symcox,REP,550145,0,0,560,560,30
Oklahoma,State Senate,Julia Kirt,DEM,550145,0,0,320,320,30
Oklahoma,State House,Jason Reese,REP,550145,0,0,582,582,83
Oklahoma,State House,Chelsey Branham,DEM,550145,0,0,292,292,83
Oklahoma,Governor,Chris Powell,LIB,550146,0,0,29,29,
Oklahoma,Governor,Kevin Stitt,REP,550146,0,0,631,631,
Oklahoma,Governor,Drew Edmondson,DEM,550146,0,0,609,609,
Oklahoma,Lieutenant Governor,Matt Pinnell,REP,550146,0,0,782,782,
Oklahoma,Lieutenant Governor,Anastasia Pittman,DEM,550146,0,0,437,437,
Oklahoma,Lieutenant Governor,Ivan Holmes,IND,550146,0,0,41,41,
Oklahoma,State Auditor,John Yeutter,LIB,550146,0,0,256,256,
Oklahoma,State Auditor,Cindy Byrd,REP,550146,0,0,897,897,
Oklahoma,Attorney General,Mike Hunter,REP,550146,0,0,797,797,
Oklahoma,Attorney General,Mark Myles,DEM,550146,0,0,454,454,
Oklahoma,State Treasurer,Randy Mcdaniel,REP,550146,0,0,836,836,
Oklahoma,State Treasurer,Charles De Coune,IND,550146,0,0,326,326,
Oklahoma,Superintendent of Public Instruction,Joy Hofmeister,REP,550146,0,0,764,764,
Oklahoma,Superintendent of Public Instruction,John Cox,DEM,550146,0,0,403,403,
Oklahoma,Superintendent of Public Instruction,Larry Huff,IND,550146,0,0,80,80,
Oklahoma,Commissioner of Labor,Leslie Osborn,REP,550146,0,0,789,789,
Oklahoma,Commissioner of Labor,Fred Dorrell,DEM,550146,0,0,403,403,
Oklahoma,Commissioner of Labor,Brandt Dismukes,IND,550146,0,0,49,49,
Oklahoma,Insurance Commissioner,Glen Mulready,REP,550146,0,0,742,742,
Oklahoma,Insurance Commissioner,Kimberly Fobbs,DEM,550146,0,0,483,483,
Oklahoma,Corporation Commissioner,Bob Anthony,REP,550146,0,0,769,769,
Oklahoma,Corporation Commissioner,Ashley Nicole Mccray,DEM,550146,0,0,414,414,
Oklahoma,Corporation Commissioner,Jackie Short,IND,550146,0,0,65,65,
Oklahoma,U.S. House,Steve Russell,REP,550146,0,0,710,710,5
Oklahoma,U.S. House,Kendra Horn,DEM,550146,0,0,547,547,5
Oklahoma,State Senate,John Symcox,REP,550146,0,0,691,691,30
Oklahoma,State Senate,Julia Kirt,DEM,550146,0,0,564,564,30
Oklahoma,State House,Stephen Paulsen,LIB,550146,0,0,37,37,85
Oklahoma,State House,Matt Jackson,REP,550146,0,0,627,627,85
Oklahoma,State House,Cyndi Munson,DEM,550146,0,0,597,597,85
Oklahoma,Governor,Chris Powell,LIB,550147,0,0,7,7,
Oklahoma,Governor,Kevin Stitt,REP,550147,0,0,238,238,
Oklahoma,Governor,Drew Edmondson,DEM,550147,0,0,150,150,
Oklahoma,Lieutenant Governor,Matt Pinnell,REP,550147,0,0,272,272,
Oklahoma,Lieutenant Governor,Anastasia Pittman,DEM,550147,0,0,107,107,
Oklahoma,Lieutenant Governor,Ivan Holmes,IND,550147,0,0,15,15,
Oklahoma,State Auditor,John Yeutter,LIB,550147,0,0,59,59,
Oklahoma,State Auditor,Cindy Byrd,REP,550147,0,0,303,303,
Oklahoma,Attorney General,Mike Hunter,REP,550147,0,0,279,279,
Oklahoma,Attorney General,Mark Myles,DEM,550147,0,0,113,113,
Oklahoma,State Treasurer,Randy Mcdaniel,REP,550147,0,0,273,273,
Oklahoma,State Treasurer,Charles De Coune,IND,550147,0,0,84,84,
Oklahoma,Superintendent of Public Instruction,Joy Hofmeister,REP,550147,0,0,263,263,
Oklahoma,Superintendent of Public Instruction,John Cox,DEM,550147,0,0,103,103,
Oklahoma,Superintendent of Public Instruction,Larry Huff,IND,550147,0,0,26,26,
Oklahoma,Commissioner of Labor,Leslie Osborn,REP,550147,0,0,277,277,
Oklahoma,Commissioner of Labor,Fred Dorrell,DEM,550147,0,0,103,103,
Oklahoma,Commissioner of Labor,Brandt Dismukes,IND,550147,0,0,9,9,
Oklahoma,Insurance Commissioner,Glen Mulready,REP,550147,0,0,267,267,
Oklahoma,Insurance Commissioner,Kimberly Fobbs,DEM,550147,0,0,119,119,
Oklahoma,Corporation Commissioner,Bob Anthony,REP,550147,0,0,266,266,
Oklahoma,Corporation Commissioner,Ashley Nicole Mccray,DEM,550147,0,0,103,103,
Oklahoma,Corporation Commissioner,Jackie Short,IND,550147,0,0,23,23,
Oklahoma,U.S. House,Steve Russell,REP,550147,0,0,252,252,5
Oklahoma,U.S. House,Kendra Horn,DEM,550147,0,0,144,144,5
Oklahoma,State House,Stephen Paulsen,LIB,550147,0,0,6,6,85
Oklahoma,State House,Matt Jackson,REP,550147,0,0,227,227,85
Oklahoma,State House,Cyndi Munson,DEM,550147,0,0,164,164,85
Oklahoma,Governor,Chris Powell,LIB,550148,0,0,33,33,
Oklahoma,Governor,Kevin Stitt,REP,550148,0,0,627,627,
Oklahoma,Governor,Drew Edmondson,DEM,550148,0,0,700,700,
Oklahoma,Lieutenant Governor,Matt Pinnell,REP,550148,0,0,742,742,
Oklahoma,Lieutenant Governor,Anastasia Pittman,DEM,550148,0,0,563,563,
Oklahoma,Lieutenant Governor,Ivan Holmes,IND,550148,0,0,44,44,
Oklahoma,State Auditor,John Yeutter,LIB,550148,0,0,331,331,
Oklahoma,State Auditor,Cindy Byrd,REP,550148,0,0,870,870,
Oklahoma,Attorney General,Mike Hunter,REP,550148,0,0,757,757,
Oklahoma,Attorney General,Mark Myles,DEM,550148,0,0,580,580,
Oklahoma,State Treasurer,Randy Mcdaniel,REP,550148,0,0,802,802,
Oklahoma,State Treasurer,Charles De Coune,IND,550148,0,0,408,408,
Oklahoma,Superintendent of Public Instruction,Joy Hofmeister,REP,550148,0,0,753,753,
Oklahoma,Superintendent of Public Instruction,John Cox,DEM,550148,0,0,494,494,
Oklahoma,Superintendent of Public Instruction,Larry Huff,IND,550148,0,0,85,85,
Oklahoma,Commissioner of Labor,Leslie Osborn,REP,550148,0,0,747,747,
Oklahoma,Commissioner of Labor,Fred Dorrell,DEM,550148,0,0,523,523,
Oklahoma,Commissioner of Labor,Brandt Dismukes,IND,550148,0,0,57,57,
Oklahoma,Insurance Commissioner,Glen Mulready,REP,550148,0,0,733,733,
Oklahoma,Insurance Commissioner,Kimberly Fobbs,DEM,550148,0,0,590,590,
Oklahoma,Corporation Commissioner,Bob Anthony,REP,550148,0,0,714,714,
Oklahoma,Corporation Commissioner,Ashley Nicole Mccray,DEM,550148,0,0,552,552,
Oklahoma,Corporation Commissioner,Jackie Short,IND,550148,0,0,63,63,
Oklahoma,U.S. House,Steve Russell,REP,550148,0,0,685,685,5
Oklahoma,U.S. House,Kendra Horn,DEM,550148,0,0,661,661,5
Oklahoma,State House,Nicole Miller,REP,550148,0,0,804,804,82
Oklahoma,State House,Oraynab Jwayyed,DEM,550148,0,0,524,524,82
Oklahoma,Governor,Chris Powell,LIB,550149,0,0,23,23,
Oklahoma,Governor,Kevin Stitt,REP,550149,0,0,720,720,
Oklahoma,Governor,Drew Edmondson,DEM,550149,0,0,521,521,
Oklahoma,Lieutenant Governor,Matt Pinnell,REP,550149,0,0,861,861,
Oklahoma,Lieutenant Governor,Anastasia Pittman,DEM,550149,0,0,358,358,
Oklahoma,Lieutenant Governor,Ivan Holmes,IND,550149,0,0,38,38,
Oklahoma,State Auditor,John Yeutter,LIB,550149,0,0,221,221,
Oklahoma,State Auditor,Cindy Byrd,REP,550149,0,0,947,947,
Oklahoma,Attorney General,Mike Hunter,REP,550149,0,0,886,886,
Oklahoma,Attorney General,Mark Myles,DEM,550149,0,0,371,371,
Oklahoma,State Treasurer,Randy Mcdaniel,REP,550149,0,0,911,911,
Oklahoma,State Treasurer,Charles De Coune,IND,550149,0,0,267,267,
Oklahoma,Superintendent of Public Instruction,Joy Hofmeister,REP,550149,0,0,848,848,
Oklahoma,Superintendent of Public Instruction,John Cox,DEM,550149,0,0,312,312,
Oklahoma,Superintendent of Public Instruction,Larry Huff,IND,550149,0,0,87,87,
Oklahoma,Commissioner of Labor,Leslie Osborn,REP,550149,0,0,870,870,
Oklahoma,Commissioner of Labor,Fred Dorrell,DEM,550149,0,0,316,316,
Oklahoma,Commissioner of Labor,Brandt Dismukes,IND,550149,0,0,47,47,
Oklahoma,Insurance Commissioner,Glen Mulready,REP,550149,0,0,853,853,
Oklahoma,Insurance Commissioner,Kimberly Fobbs,DEM,550149,0,0,371,371,
Oklahoma,Corporation Commissioner,Bob Anthony,REP,550149,0,0,857,857,
Oklahoma,Corporation Commissioner,Ashley Nicole Mccray,DEM,550149,0,0,328,328,
Oklahoma,Corporation Commissioner,Jackie Short,IND,550149,0,0,61,61,
Oklahoma,U.S. House,Steve Russell,REP,550149,0,0,821,821,5
Oklahoma,U.S. House,Kendra Horn,DEM,550149,0,0,435,435,5
Oklahoma,State House,Nicole Miller,REP,550149,0,0,923,923,82
Oklahoma,State House,Oraynab Jwayyed,DEM,550149,0,0,323,323,82
Oklahoma,Governor,Chris Powell,LIB,550150,0,0,42,42,
Oklahoma,Governor,Kevin Stitt,REP,550150,0,0,637,637,
Oklahoma,Governor,Drew Edmondson,DEM,550150,0,0,670,670,
Oklahoma,Lieutenant Governor,Matt Pinnell,REP,550150,0,0,737,737,
Oklahoma,Lieutenant Governor,Anastasia Pittman,DEM,550150,0,0,541,541,
Oklahoma,Lieutenant Governor,Ivan Holmes,IND,550150,0,0,61,61,
Oklahoma,State Auditor,John Yeutter,LIB,550150,0,0,355,355,
Oklahoma,State Auditor,Cindy Byrd,REP,550150,0,0,883,883,
Oklahoma,Attorney General,Mike Hunter,REP,550150,0,0,768,768,
Oklahoma,Attorney General,Mark Myles,DEM,550150,0,0,562,562,
Oklahoma,State Treasurer,Randy Mcdaniel,REP,550150,0,0,826,826,
Oklahoma,State Treasurer,Charles De Coune,IND,550150,0,0,406,406,
Oklahoma,Superintendent of Public Instruction,Joy Hofmeister,REP,550150,0,0,734,734,
Oklahoma,Superintendent of Public Instruction,John Cox,DEM,550150,0,0,486,486,
Oklahoma,Superintendent of Public Instruction,Larry Huff,IND,550150,0,0,109,109,
Oklahoma,Commissioner of Labor,Leslie Osborn,REP,550150,0,0,762,762,
Oklahoma,Commissioner of Labor,Fred Dorrell,DEM,550150,0,0,479,479,
Oklahoma,Commissioner of Labor,Brandt Dismukes,IND,550150,0,0,65,65,
Oklahoma,Insurance Commissioner,Glen Mulready,REP,550150,0,0,741,741,
Oklahoma,Insurance Commissioner,Kimberly Fobbs,DEM,550150,0,0,561,561,
Oklahoma,Corporation Commissioner,Bob Anthony,REP,550150,0,0,706,706,
Oklahoma,Corporation Commissioner,Ashley Nicole Mccray,DEM,550150,0,0,511,511,
Oklahoma,Corporation Commissioner,Jackie Short,IND,550150,0,0,88,88,
Oklahoma,U.S. House,Steve Russell,REP,550150,0,0,692,692,5
Oklahoma,U.S. House,Kendra Horn,DEM,550150,0,0,644,644,5
Oklahoma,State House,Marilyn Stark,REP,550150,0,0,734,734,10
Oklahoma,State House,Zach Pearson,DEM,550150,0,0,572,572,10
Oklahoma,Governor,Chris Powell,LIB,550151,0,0,45,45,
Oklahoma,Governor,Kevin Stitt,REP,550151,0,0,678,678,
Oklahoma,Governor,Drew Edmondson,DEM,550151,0,0,738,738,
Oklahoma,Lieutenant Governor,Matt Pinnell,REP,550151,0,0,804,804,
Oklahoma,Lieutenant Governor,Anastasia Pittman,DEM,550151,0,0,605,605,
Oklahoma,Lieutenant Governor,Ivan Holmes,IND,550151,0,0,49,49,
Oklahoma,State Auditor,John Yeutter,LIB,550151,0,0,385,385,
Oklahoma,State Auditor,Cindy Byrd,REP,550151,0,0,935,935,
Oklahoma,Attorney General,Mike Hunter,REP,550151,0,0,851,851,
Oklahoma,Attorney General,Mark Myles,DEM,550151,0,0,601,601,
Oklahoma,State Treasurer,Randy Mcdaniel,REP,550151,0,0,888,888,
Oklahoma,State Treasurer,Charles De Coune,IND,550151,0,0,436,436,
Oklahoma,Superintendent of Public Instruction,Joy Hofmeister,REP,550151,0,0,789,789,
Oklahoma,Superintendent of Public Instruction,John Cox,DEM,550151,0,0,553,553,
Oklahoma,Superintendent of Public Instruction,Larry Huff,IND,550151,0,0,112,112,
Oklahoma,Commissioner of Labor,Leslie Osborn,REP,550151,0,0,818,818,
Oklahoma,Commissioner of Labor,Fred Dorrell,DEM,550151,0,0,548,548,
Oklahoma,Commissioner of Labor,Brandt Dismukes,IND,550151,0,0,64,64,
Oklahoma,Insurance Commissioner,Glen Mulready,REP,550151,0,0,795,795,
Oklahoma,Insurance Commissioner,Kimberly Fobbs,DEM,550151,0,0,644,644,
Oklahoma,Corporation Commissioner,Bob Anthony,REP,550151,0,0,787,787,
Oklahoma,Corporation Commissioner,Ashley Nicole Mccray,DEM,550151,0,0,560,560,
Oklahoma,Corporation Commissioner,Jackie Short,IND,550151,0,0,96,96,
Oklahoma,U.S. House,Steve Russell,REP,550151,0,0,779,779,5
Oklahoma,U.S. House,Kendra Horn,DEM,550151,0,0,680,680,5
Oklahoma,State House,Marilyn Stark,REP,550151,0,0,801,801,10
Oklahoma,State House,Zach Pearson,DEM,550151,0,0,635,635,10
Oklahoma,Governor,Chris Powell,LIB,550152,0,0,33,33,
Oklahoma,Governor,Kevin Stitt,REP,550152,0,0,602,602,
Oklahoma,Governor,Drew Edmondson,DEM,550152,0,0,713,713,
Oklahoma,Lieutenant Governor,Matt Pinnell,REP,550152,0,0,745,745,
Oklahoma,Lieutenant Governor,Anastasia Pittman,DEM,550152,0,0,546,546,
Oklahoma,Lieutenant Governor,Ivan Holmes,IND,550152,0,0,53,53,
Oklahoma,State Auditor,John Yeutter,LIB,550152,0,0,351,351,
Oklahoma,State Auditor,Cindy Byrd,REP,550152,0,0,888,888,
Oklahoma,Attorney General,Mike Hunter,REP,550152,0,0,778,778,
Oklahoma,Attorney General,Mark Myles,DEM,550152,0,0,564,564,
Oklahoma,State Treasurer,Randy Mcdaniel,REP,550152,0,0,793,793,
Oklahoma,State Treasurer,Charles De Coune,IND,550152,0,0,453,453,
Oklahoma,Superintendent of Public Instruction,Joy Hofmeister,REP,550152,0,0,735,735,
Oklahoma,Superintendent of Public Instruction,John Cox,DEM,550152,0,0,514,514,
Oklahoma,Superintendent of Public Instruction,Larry Huff,IND,550152,0,0,89,89,
Oklahoma,Commissioner of Labor,Leslie Osborn,REP,550152,0,0,761,761,
Oklahoma,Commissioner of Labor,Fred Dorrell,DEM,550152,0,0,507,507,
Oklahoma,Commissioner of Labor,Brandt Dismukes,IND,550152,0,0,51,51,
Oklahoma,Insurance Commissioner,Glen Mulready,REP,550152,0,0,720,720,
Oklahoma,Insurance Commissioner,Kimberly Fobbs,DEM,550152,0,0,599,599,
Oklahoma,Corporation Commissioner,Bob Anthony,REP,550152,0,0,720,720,
Oklahoma,Corporation Commissioner,Ashley Nicole Mccray,DEM,550152,0,0,532,532,
Oklahoma,Corporation Commissioner,Jackie Short,IND,550152,0,0,81,81,
Oklahoma,U.S. House,Steve Russell,REP,550152,0,0,699,699,5
Oklahoma,U.S. House,Kendra Horn,DEM,550152,0,0,646,646,5
Oklahoma,State House,Marilyn Stark,REP,550152,0,0,729,729,10
Oklahoma,State House,Zach Pearson,DEM,550152,0,0,601,601,10
Oklahoma,Governor,Chris Powell,LIB,550153,0,0,54,54,
Oklahoma,Governor,Kevin Stitt,REP,550153,0,0,697,697,
Oklahoma,Governor,Drew Edmondson,DEM,550153,0,0,671,671,
Oklahoma,Lieutenant Governor,Matt Pinnell,REP,550153,0,0,802,802,
Oklahoma,Lieutenant Governor,Anastasia Pittman,DEM,550153,0,0,520,520,
Oklahoma,Lieutenant Governor,Ivan Holmes,IND,550153,0,0,79,79,
Oklahoma,State Auditor,John Yeutter,LIB,550153,0,0,358,358,
Oklahoma,State Auditor,Cindy Byrd,REP,550153,0,0,920,920,
Oklahoma,Attorney General,Mike Hunter,REP,550153,0,0,842,842,
Oklahoma,Attorney General,Mark Myles,DEM,550153,0,0,557,557,
Oklahoma,State Treasurer,Randy Mcdaniel,REP,550153,0,0,867,867,
Oklahoma,State Treasurer,Charles De Coune,IND,550153,0,0,418,418,
Oklahoma,Superintendent of Public Instruction,Joy Hofmeister,REP,550153,0,0,802,802,
Oklahoma,Superintendent of Public Instruction,John Cox,DEM,550153,0,0,482,482,
Oklahoma,Superintendent of Public Instruction,Larry Huff,IND,550153,0,0,122,122,
Oklahoma,Commissioner of Labor,Leslie Osborn,REP,550153,0,0,812,812,
Oklahoma,Commissioner of Labor,Fred Dorrell,DEM,550153,0,0,495,495,
Oklahoma,Commissioner of Labor,Brandt Dismukes,IND,550153,0,0,78,78,
Oklahoma,Insurance Commissioner,Glen Mulready,REP,550153,0,0,816,816,
Oklahoma,Insurance Commissioner,Kimberly Fobbs,DEM,550153,0,0,565,565,
Oklahoma,Corporation Commissioner,Bob Anthony,REP,550153,0,0,791,791,
Oklahoma,Corporation Commissioner,Ashley Nicole Mccray,DEM,550153,0,0,501,501,
Oklahoma,Corporation Commissioner,Jackie Short,IND,550153,0,0,101,101,
Oklahoma,U.S. House,Steve Russell,REP,550153,0,0,791,791,5
Oklahoma,U.S. House,Kendra Horn,DEM,550153,0,0,613,613,5
Oklahoma,State House,Marilyn Stark,REP,550153,0,0,815,815,10
Oklahoma,State House,Zach Pearson,DEM,550153,0,0,563,563,10
Oklahoma,Governor,Chris Powell,LIB,550154,0,0,46,46,
Oklahoma,Governor,Kevin Stitt,REP,550154,0,0,757,757,
Oklahoma,Governor,Drew Edmondson,DEM,550154,0,0,798,798,
Oklahoma,Lieutenant Governor,Matt Pinnell,REP,550154,0,0,874,874,
Oklahoma,Lieutenant Governor,Anastasia Pittman,DEM,550154,0,0,654,654,
Oklahoma,Lieutenant Governor,Ivan Holmes,IND,550154,0,0,64,64,
Oklahoma,State Auditor,John Yeutter,LIB,550154,0,0,376,376,
Oklahoma,State Auditor,Cindy Byrd,REP,550154,0,0,1050,1050,
Oklahoma,Attorney General,Mike Hunter,REP,550154,0,0,921,921,
Oklahoma,Attorney General,Mark Myles,DEM,550154,0,0,665,665,
Oklahoma,State Treasurer,Randy Mcdaniel,REP,550154,0,0,945,945,
Oklahoma,State Treasurer,Charles De Coune,IND,550154,0,0,487,487,
Oklahoma,Superintendent of Public Instruction,Joy Hofmeister,REP,550154,0,0,860,860,
Oklahoma,Superintendent of Public Instruction,John Cox,DEM,550154,0,0,618,618,
Oklahoma,Superintendent of Public Instruction,Larry Huff,IND,550154,0,0,106,106,
Oklahoma,Commissioner of Labor,Leslie Osborn,REP,550154,0,0,900,900,
Oklahoma,Commissioner of Labor,Fred Dorrell,DEM,550154,0,0,601,601,
Oklahoma,Commissioner of Labor,Brandt Dismukes,IND,550154,0,0,65,65,
Oklahoma,Insurance Commissioner,Glen Mulready,REP,550154,0,0,875,875,
Oklahoma,Insurance Commissioner,Kimberly Fobbs,DEM,550154,0,0,691,691,
Oklahoma,Corporation Commissioner,Bob Anthony,REP,550154,0,0,828,828,
Oklahoma,Corporation Commissioner,Ashley Nicole Mccray,DEM,550154,0,0,644,644,
Oklahoma,Corporation Commissioner,Jackie Short,IND,550154,0,0,103,103,
Oklahoma,U.S. House,Steve Russell,REP,550154,0,0,841,841,5
Oklahoma,U.S. House,Kendra Horn,DEM,550154,0,0,753,753,5
Oklahoma,State House,Stephen Paulsen,LIB,550154,0,0,49,49,85
Oklahoma,State House,Matt Jackson,REP,550154,0,0,725,725,85
Oklahoma,State House,Cyndi Munson,DEM,550154,0,0,819,819,85
Oklahoma,Governor,Chris Powell,LIB,550155,0,0,13,13,
Oklahoma,Governor,Kevin Stitt,REP,550155,0,0,218,218,
Oklahoma,Governor,Drew Edmondson,DEM,550155,0,0,208,208,
Oklahoma,Lieutenant Governor,Matt Pinnell,REP,550155,0,0,254,254,
Oklahoma,Lieutenant Governor,Anastasia Pittman,DEM,550155,0,0,163,163,
Oklahoma,Lieutenant Governor,Ivan Holmes,IND,550155,0,0,16,16,
Oklahoma,State Auditor,John Yeutter,LIB,550155,0,0,110,110,
Oklahoma,State Auditor,Cindy Byrd,REP,550155,0,0,287,287,
Oklahoma,Attorney General,Mike Hunter,REP,550155,0,0,264,264,
Oklahoma,Attorney General,Mark Myles,DEM,550155,0,0,167,167,
Oklahoma,State Treasurer,Randy Mcdaniel,REP,550155,0,0,252,252,
Oklahoma,State Treasurer,Charles De Coune,IND,550155,0,0,141,141,
Oklahoma,Superintendent of Public Instruction,Joy Hofmeister,REP,550155,0,0,262,262,
Oklahoma,Superintendent of Public Instruction,John Cox,DEM,550155,0,0,136,136,
Oklahoma,Superintendent of Public Instruction,Larry Huff,IND,550155,0,0,33,33,
Oklahoma,Commissioner of Labor,Leslie Osborn,REP,550155,0,0,245,245,
Oklahoma,Commissioner of Labor,Fred Dorrell,DEM,550155,0,0,152,152,
Oklahoma,Commissioner of Labor,Brandt Dismukes,IND,550155,0,0,28,28,
Oklahoma,Insurance Commissioner,Glen Mulready,REP,550155,0,0,244,244,
Oklahoma,Insurance Commissioner,Kimberly Fobbs,DEM,550155,0,0,182,182,
Oklahoma,Corporation Commissioner,Bob Anthony,REP,550155,0,0,256,256,
Oklahoma,Corporation Commissioner,Ashley Nicole Mccray,DEM,550155,0,0,152,152,
Oklahoma,Corporation Commissioner,Jackie Short,IND,550155,0,0,22,22,
Oklahoma,U.S. House,Steve Russell,REP,550155,0,0,245,245,5
Oklahoma,U.S. House,Kendra Horn,DEM,550155,0,0,187,187,5
Oklahoma,State Senate,John Symcox,REP,550155,0,0,242,242,30
Oklahoma,State Senate,Julia Kirt,DEM,550155,0,0,190,190,30
Oklahoma,State House,Stephen Paulsen,LIB,550155,0,0,10,10,85
Oklahoma,State House,Matt Jackson,REP,550155,0,0,202,202,85
Oklahoma,State House,Cyndi Munson,DEM,550155,0,0,221,221,85
Oklahoma,Governor,Chris Powell,LIB,550156,0,0,45,45,
Oklahoma,Governor,Kevin Stitt,REP,550156,0,0,482,482,
Oklahoma,Governor,Drew Edmondson,DEM,550156,0,0,768,768,
Oklahoma,Lieutenant Governor,Matt Pinnell,REP,550156,0,0,565,565,
Oklahoma,Lieutenant Governor,Anastasia Pittman,DEM,550156,0,0,662,662,
Oklahoma,Lieutenant Governor,Ivan Holmes,IND,550156,0,0,59,59,
Oklahoma,State Auditor,John Yeutter,LIB,550156,0,0,414,414,
Oklahoma,State Auditor,Cindy Byrd,REP,550156,0,0,750,750,
Oklahoma,Attorney General,Mike Hunter,REP,550156,0,0,589,589,
Oklahoma,Attorney General,Mark Myles,DEM,550156,0,0,685,685,
Oklahoma,State Treasurer,Randy Mcdaniel,REP,550156,0,0,639,639,
Oklahoma,State Treasurer,Charles De Coune,IND,550156,0,0,531,531,
Oklahoma,Superintendent of Public Instruction,Joy Hofmeister,REP,550156,0,0,586,586,
Oklahoma,Superintendent of Public Instruction,John Cox,DEM,550156,0,0,577,577,
Oklahoma,Superintendent of Public Instruction,Larry Huff,IND,550156,0,0,116,116,
Oklahoma,Commissioner of Labor,Leslie Osborn,REP,550156,0,0,577,577,
Oklahoma,Commissioner of Labor,Fred Dorrell,DEM,550156,0,0,625,625,
Oklahoma,Commissioner of Labor,Brandt Dismukes,IND,550156,0,0,64,64,
Oklahoma,Insurance Commissioner,Glen Mulready,REP,550156,0,0,558,558,
Oklahoma,Insurance Commissioner,Kimberly Fobbs,DEM,550156,0,0,699,699,
Oklahoma,Corporation Commissioner,Bob Anthony,REP,550156,0,0,562,562,
Oklahoma,Corporation Commissioner,Ashley Nicole Mccray,DEM,550156,0,0,620,620,
Oklahoma,Corporation Commissioner,Jackie Short,IND,550156,0,0,87,87,
Oklahoma,U.S. House,Steve Russell,REP,550156,0,0,527,527,5
Oklahoma,U.S. House,Kendra Horn,DEM,550156,0,0,755,755,5
Oklahoma,State Senate,John Symcox,REP,550156,0,0,533,533,30
Oklahoma,State Senate,Julia Kirt,DEM,550156,0,0,749,749,30
Oklahoma,State House,Stephen Paulsen,LIB,550156,0,0,30,30,85
Oklahoma,State House,Matt Jackson,REP,550156,0,0,453,453,85
Oklahoma,State House,Cyndi Munson,DEM,550156,0,0,793,793,85
Oklahoma,Governor,Chris Powell,LIB,550157,0,0,4,4,
Oklahoma,Governor,Kevin Stitt,REP,550157,0,0,4,4,
Oklahoma,Governor,Drew Edmondson,DEM,550157,0,0,27,27,
Oklahoma,Lieutenant Governor,Matt Pinnell,REP,550157,0,0,5,5,
Oklahoma,Lieutenant Governor,Anastasia Pittman,DEM,550157,0,0,26,26,
Oklahoma,Lieutenant Governor,Ivan Holmes,IND,550157,0,0,4,4,
Oklahoma,State Auditor,John Yeutter,LIB,550157,0,0,19,19,
Oklahoma,State Auditor,Cindy Byrd,REP,550157,0,0,11,11,
Oklahoma,Attorney General,Mike Hunter,REP,550157,0,0,6,6,
Oklahoma,Attorney General,Mark Myles,DEM,550157,0,0,29,29,
Oklahoma,State Treasurer,Randy Mcdaniel,REP,550157,0,0,5,5,
Oklahoma,State Treasurer,Charles De Coune,IND,550157,0,0,25,25,
Oklahoma,Superintendent of Public Instruction,Joy Hofmeister,REP,550157,0,0,5,5,
Oklahoma,Superintendent of Public Instruction,John Cox,DEM,550157,0,0,26,26,
Oklahoma,Superintendent of Public Instruction,Larry Huff,IND,550157,0,0,4,4,
Oklahoma,Commissioner of Labor,Leslie Osborn,REP,550157,0,0,5,5,
Oklahoma,Commissioner of Labor,Fred Dorrell,DEM,550157,0,0,29,29,
Oklahoma,Commissioner of Labor,Brandt Dismukes,IND,550157,0,0,0,0,
Oklahoma,Insurance Commissioner,Glen Mulready,REP,550157,0,0,6,6,
Oklahoma,Insurance Commissioner,Kimberly Fobbs,DEM,550157,0,0,29,29,
Oklahoma,Corporation Commissioner,Bob Anthony,REP,550157,0,0,7,7,
Oklahoma,Corporation Commissioner,Ashley Nicole Mccray,DEM,550157,0,0,28,28,
Oklahoma,Corporation Commissioner,Jackie Short,IND,550157,0,0,0,0,
Oklahoma,U.S. House,Steve Russell,REP,550157,0,0,6,6,5
Oklahoma,U.S. House,Kendra Horn,DEM,550157,0,0,29,29,5
Oklahoma,State Senate,John Symcox,REP,550157,0,0,5,5,30
Oklahoma,State Senate,Julia Kirt,DEM,550157,0,0,30,30,30
Oklahoma,State House,Marilyn Stark,REP,550157,0,0,5,5,10
Oklahoma,State House,Zach Pearson,DEM,550157,0,0,30,30,10
Oklahoma,Governor,Chris Powell,LIB,550158,0,0,29,29,
Oklahoma,Governor,Kevin Stitt,REP,550158,0,0,409,409,
Oklahoma,Governor,Drew Edmondson,DEM,550158,0,0,534,534,
Oklahoma,Lieutenant Governor,Matt Pinnell,REP,550158,0,0,471,471,
Oklahoma,Lieutenant Governor,Anastasia Pittman,DEM,550158,0,0,473,473,
Oklahoma,Lieutenant Governor,Ivan Holmes,IND,550158,0,0,26,26,
Oklahoma,State Auditor,John Yeutter,LIB,550158,0,0,318,318,
Oklahoma,State Auditor,Cindy Byrd,REP,550158,0,0,566,566,
Oklahoma,Attorney General,Mike Hunter,REP,550158,0,0,504,504,
Oklahoma,Attorney General,Mark Myles,DEM,550158,0,0,457,457,
Oklahoma,State Treasurer,Randy Mcdaniel,REP,550158,0,0,505,505,
Oklahoma,State Treasurer,Charles De Coune,IND,550158,0,0,377,377,
Oklahoma,Superintendent of Public Instruction,Joy Hofmeister,REP,550158,0,0,470,470,
Oklahoma,Superintendent of Public Instruction,John Cox,DEM,550158,0,0,427,427,
Oklahoma,Superintendent of Public Instruction,Larry Huff,IND,550158,0,0,68,68,
Oklahoma,Commissioner of Labor,Leslie Osborn,REP,550158,0,0,474,474,
Oklahoma,Commissioner of Labor,Fred Dorrell,DEM,550158,0,0,448,448,
Oklahoma,Commissioner of Labor,Brandt Dismukes,IND,550158,0,0,37,37,
Oklahoma,Insurance Commissioner,Glen Mulready,REP,550158,0,0,462,462,
Oklahoma,Insurance Commissioner,Kimberly Fobbs,DEM,550158,0,0,493,493,
Oklahoma,Corporation Commissioner,Bob Anthony,REP,550158,0,0,454,454,
Oklahoma,Corporation Commissioner,Ashley Nicole Mccray,DEM,550158,0,0,446,446,
Oklahoma,Corporation Commissioner,Jackie Short,IND,550158,0,0,62,62,
Oklahoma,U.S. House,Steve Russell,REP,550158,0,0,448,448,5
Oklahoma,U.S. House,Kendra Horn,DEM,550158,0,0,516,516,5
Oklahoma,State House,Marilyn Stark,REP,550158,0,0,466,466,10
Oklahoma,State House,Zach Pearson,DEM,550158,0,0,489,489,10
Oklahoma,Governor,Chris Powell,LIB,550159,0,0,56,56,
Oklahoma,Governor,Kevin Stitt,REP,550159,0,0,484,484,
Oklahoma,Governor,Drew Edmondson,DEM,550159,0,0,687,687,
Oklahoma,Lieutenant Governor,Matt Pinnell,REP,550159,0,0,597,597,
Oklahoma,Lieutenant Governor,Anastasia Pittman,DEM,550159,0,0,575,575,
Oklahoma,Lieutenant Governor,Ivan Holmes,IND,550159,0,0,51,51,
Oklahoma,State Auditor,John Yeutter,LIB,550159,0,0,391,391,
Oklahoma,State Auditor,Cindy Byrd,REP,550159,0,0,721,721,
Oklahoma,Attorney General,Mike Hunter,REP,550159,0,0,622,622,
Oklahoma,Attorney General,Mark Myles,DEM,550159,0,0,599,599,
Oklahoma,State Treasurer,Randy Mcdaniel,REP,550159,0,0,658,658,
Oklahoma,State Treasurer,Charles De Coune,IND,550159,0,0,450,450,
Oklahoma,Superintendent of Public Instruction,Joy Hofmeister,REP,550159,0,0,591,591,
Oklahoma,Superintendent of Public Instruction,John Cox,DEM,550159,0,0,510,510,
Oklahoma,Superintendent of Public Instruction,Larry Huff,IND,550159,0,0,113,113,
Oklahoma,Commissioner of Labor,Leslie Osborn,REP,550159,0,0,615,615,
Oklahoma,Commissioner of Labor,Fred Dorrell,DEM,550159,0,0,524,524,
Oklahoma,Commissioner of Labor,Brandt Dismukes,IND,550159,0,0,70,70,
Oklahoma,Insurance Commissioner,Glen Mulready,REP,550159,0,0,600,600,
Oklahoma,Insurance Commissioner,Kimberly Fobbs,DEM,550159,0,0,604,604,
Oklahoma,Corporation Commissioner,Bob Anthony,REP,550159,0,0,562,562,
Oklahoma,Corporation Commissioner,Ashley Nicole Mccray,DEM,550159,0,0,562,562,
Oklahoma,Corporation Commissioner,Jackie Short,IND,550159,0,0,85,85,
Oklahoma,U.S. House,Steve Russell,REP,550159,0,0,568,568,5
Oklahoma,U.S. House,Kendra Horn,DEM,550159,0,0,653,653,5
Oklahoma,State House,Marilyn Stark,REP,550159,0,0,597,597,10
Oklahoma,State House,Zach Pearson,DEM,550159,0,0,611,611,10
Oklahoma,Governor,Chris Powell,LIB,550160,0,0,35,35,
Oklahoma,Governor,Kevin Stitt,REP,550160,0,0,665,665,
Oklahoma,Governor,Drew Edmondson,DEM,550160,0,0,405,405,
Oklahoma,Lieutenant Governor,Matt Pinnell,REP,550160,0,0,769,769,
Oklahoma,Lieutenant Governor,Anastasia Pittman,DEM,550160,0,0,302,302,
Oklahoma,Lieutenant Governor,Ivan Holmes,IND,550160,0,0,32,32,
Oklahoma,State Auditor,John Yeutter,LIB,550160,0,0,171,171,
Oklahoma,State Auditor,Cindy Byrd,REP,550160,0,0,849,849,
Oklahoma,Attorney General,Mike Hunter,REP,550160,0,0,798,798,
Oklahoma,Attorney General,Mark Myles,DEM,550160,0,0,297,297,
Oklahoma,State Treasurer,Randy Mcdaniel,REP,550160,0,0,816,816,
Oklahoma,State Treasurer,Charles De Coune,IND,550160,0,0,205,205,
Oklahoma,Superintendent of Public Instruction,Joy Hofmeister,REP,550160,0,0,768,768,
Oklahoma,Superintendent of Public Instruction,John Cox,DEM,550160,0,0,256,256,
Oklahoma,Superintendent of Public Instruction,Larry Huff,IND,550160,0,0,70,70,
Oklahoma,Commissioner of Labor,Leslie Osborn,REP,550160,0,0,796,796,
Oklahoma,Commissioner of Labor,Fred Dorrell,DEM,550160,0,0,250,250,
Oklahoma,Commissioner of Labor,Brandt Dismukes,IND,550160,0,0,33,33,
Oklahoma,Insurance Commissioner,Glen Mulready,REP,550160,0,0,749,749,
Oklahoma,Insurance Commissioner,Kimberly Fobbs,DEM,550160,0,0,335,335,
Oklahoma,Corporation Commissioner,Bob Anthony,REP,550160,0,0,768,768,
Oklahoma,Corporation Commissioner,Ashley Nicole Mccray,DEM,550160,0,0,278,278,
Oklahoma,Corporation Commissioner,Jackie Short,IND,550160,0,0,49,49,
Oklahoma,U.S. House,Steve Russell,REP,550160,0,0,748,748,5
Oklahoma,U.S. House,Kendra Horn,DEM,550160,0,0,353,353,5
Oklahoma,State House,Marilyn Stark,REP,550160,0,0,771,771,10
Oklahoma,State House,Zach Pearson,DEM,550160,0,0,317,317,10
Oklahoma,Governor,Chris Powell,LIB,550161,0,0,29,29,
Oklahoma,Governor,Kevin Stitt,REP,550161,0,0,217,217,
Oklahoma,Governor,Drew Edmondson,DEM,550161,0,0,492,492,
Oklahoma,Lieutenant Governor,Matt Pinnell,REP,550161,0,0,241,241,
Oklahoma,Lieutenant Governor,Anastasia Pittman,DEM,550161,0,0,463,463,
Oklahoma,Lieutenant Governor,Ivan Holmes,IND,550161,0,0,32,32,
Oklahoma,State Auditor,John Yeutter,LIB,550161,0,0,293,293,
Oklahoma,State Auditor,Cindy Byrd,REP,550161,0,0,330,330,
Oklahoma,Attorney General,Mike Hunter,REP,550161,0,0,265,265,
Oklahoma,Attorney General,Mark Myles,DEM,550161,0,0,464,464,
Oklahoma,State Treasurer,Randy Mcdaniel,REP,550161,0,0,290,290,
Oklahoma,State Treasurer,Charles De Coune,IND,550161,0,0,337,337,
Oklahoma,Superintendent of Public Instruction,Joy Hofmeister,REP,550161,0,0,262,262,
Oklahoma,Superintendent of Public Instruction,John Cox,DEM,550161,0,0,419,419,
Oklahoma,Superintendent of Public Instruction,Larry Huff,IND,550161,0,0,49,49,
Oklahoma,Commissioner of Labor,Leslie Osborn,REP,550161,0,0,255,255,
Oklahoma,Commissioner of Labor,Fred Dorrell,DEM,550161,0,0,424,424,
Oklahoma,Commissioner of Labor,Brandt Dismukes,IND,550161,0,0,45,45,
Oklahoma,Insurance Commissioner,Glen Mulready,REP,550161,0,0,252,252,
Oklahoma,Insurance Commissioner,Kimberly Fobbs,DEM,550161,0,0,473,473,
Oklahoma,Corporation Commissioner,Bob Anthony,REP,550161,0,0,250,250,
Oklahoma,Corporation Commissioner,Ashley Nicole Mccray,DEM,550161,0,0,429,429,
Oklahoma,Corporation Commissioner,Jackie Short,IND,550161,0,0,48,48,
Oklahoma,U.S. House,Steve Russell,REP,550161,0,0,242,242,5
Oklahoma,U.S. House,Kendra Horn,DEM,550161,0,0,493,493,5
Oklahoma,State Senate,John Symcox,REP,550161,0,0,233,233,30
Oklahoma,State Senate,Julia Kirt,DEM,550161,0,0,500,500,30
Oklahoma,State House,Marilyn Stark,REP,550161,0,0,258,258,10
Oklahoma,State House,Zach Pearson,DEM,550161,0,0,471,471,10
Oklahoma,Governor,Chris Powell,LIB,550162,0,0,39,39,
Oklahoma,Governor,Kevin Stitt,REP,550162,0,0,381,381,
Oklahoma,Governor,Drew Edmondson,DEM,550162,0,0,325,325,
Oklahoma,Lieutenant Governor,Matt Pinnell,REP,550162,0,0,427,427,
Oklahoma,Lieutenant Governor,Anastasia Pittman,DEM,550162,0,0,282,282,
Oklahoma,Lieutenant Governor,Ivan Holmes,IND,550162,0,0,30,30,
Oklahoma,State Auditor,John Yeutter,LIB,550162,0,0,224,224,
Oklahoma,State Auditor,Cindy Byrd,REP,550162,0,0,461,461,
Oklahoma,Attorney General,Mike Hunter,REP,550162,0,0,432,432,
Oklahoma,Attorney General,Mark Myles,DEM,550162,0,0,304,304,
Oklahoma,State Treasurer,Randy Mcdaniel,REP,550162,0,0,438,438,
Oklahoma,State Treasurer,Charles De Coune,IND,550162,0,0,249,249,
Oklahoma,Superintendent of Public Instruction,Joy Hofmeister,REP,550162,0,0,400,400,
Oklahoma,Superintendent of Public Instruction,John Cox,DEM,550162,0,0,261,261,
Oklahoma,Superintendent of Public Instruction,Larry Huff,IND,550162,0,0,73,73,
Oklahoma,Commissioner of Labor,Leslie Osborn,REP,550162,0,0,425,425,
Oklahoma,Commissioner of Labor,Fred Dorrell,DEM,550162,0,0,261,261,
Oklahoma,Commissioner of Labor,Brandt Dismukes,IND,550162,0,0,44,44,
Oklahoma,Insurance Commissioner,Glen Mulready,REP,550162,0,0,415,415,
Oklahoma,Insurance Commissioner,Kimberly Fobbs,DEM,550162,0,0,310,310,
Oklahoma,Corporation Commissioner,Bob Anthony,REP,550162,0,0,401,401,
Oklahoma,Corporation Commissioner,Ashley Nicole Mccray,DEM,550162,0,0,277,277,
Oklahoma,Corporation Commissioner,Jackie Short,IND,550162,0,0,53,53,
Oklahoma,U.S. House,Steve Russell,REP,550162,0,0,410,410,5
Oklahoma,U.S. House,Kendra Horn,DEM,550162,0,0,327,327,5
Oklahoma,State Senate,John Symcox,REP,550162,0,0,401,401,30
Oklahoma,State Senate,Julia Kirt,DEM,550162,0,0,335,335,30
Oklahoma,State House,Jon Echols,REP,550162,0,0,451,451,90
Oklahoma,State House,Lavelle Compton,DEM,550162,0,0,280,280,90
Oklahoma,Governor,Chris Powell,LIB,550163,0,0,44,44,
Oklahoma,Governor,Kevin Stitt,REP,550163,0,0,338,338,
Oklahoma,Governor,Drew Edmondson,DEM,550163,0,0,451,451,
Oklahoma,Lieutenant Governor,Matt Pinnell,REP,550163,0,0,376,376,
Oklahoma,Lieutenant Governor,Anastasia Pittman,DEM,550163,0,0,409,409,
Oklahoma,Lieutenant Governor,Ivan Holmes,IND,550163,0,0,44,44,
Oklahoma,State Auditor,John Yeutter,LIB,550163,0,0,298,298,
Oklahoma,State Auditor,Cindy Byrd,REP,550163,0,0,435,435,
Oklahoma,Attorney General,Mike Hunter,REP,550163,0,0,409,409,
Oklahoma,Attorney General,Mark Myles,DEM,550163,0,0,417,417,
Oklahoma,State Treasurer,Randy Mcdaniel,REP,550163,0,0,416,416,
Oklahoma,State Treasurer,Charles De Coune,IND,550163,0,0,322,322,
Oklahoma,Superintendent of Public Instruction,Joy Hofmeister,REP,550163,0,0,362,362,
Oklahoma,Superintendent of Public Instruction,John Cox,DEM,550163,0,0,382,382,
Oklahoma,Superintendent of Public Instruction,Larry Huff,IND,550163,0,0,81,81,
Oklahoma,Commissioner of Labor,Leslie Osborn,REP,550163,0,0,396,396,
Oklahoma,Commissioner of Labor,Fred Dorrell,DEM,550163,0,0,374,374,
Oklahoma,Commissioner of Labor,Brandt Dismukes,IND,550163,0,0,47,47,
Oklahoma,Insurance Commissioner,Glen Mulready,REP,550163,0,0,379,379,
Oklahoma,Insurance Commissioner,Kimberly Fobbs,DEM,550163,0,0,430,430,
Oklahoma,Corporation Commissioner,Bob Anthony,REP,550163,0,0,378,378,
Oklahoma,Corporation Commissioner,Ashley Nicole Mccray,DEM,550163,0,0,378,378,
Oklahoma,Corporation Commissioner,Jackie Short,IND,550163,0,0,63,63,
Oklahoma,U.S. House,Steve Russell,REP,550163,0,0,380,380,5
Oklahoma,U.S. House,Kendra Horn,DEM,550163,0,0,448,448,5
Oklahoma,State Senate,John Symcox,REP,550163,0,0,367,367,30
Oklahoma,State Senate,Julia Kirt,DEM,550163,0,0,457,457,30
Oklahoma,State House,Jon Echols,REP,550163,0,0,425,425,90
Oklahoma,State House,Lavelle Compton,DEM,550163,0,0,398,398,90
Oklahoma,Governor,Chris Powell,LIB,550164,0,0,18,18,
Oklahoma,Governor,Kevin Stitt,REP,550164,0,0,293,293,
Oklahoma,Governor,Drew Edmondson,DEM,550164,0,0,278,278,
Oklahoma,Lieutenant Governor,Matt Pinnell,REP,550164,0,0,334,334,
Oklahoma,Lieutenant Governor,Anastasia Pittman,DEM,550164,0,0,232,232,
Oklahoma,Lieutenant Governor,Ivan Holmes,IND,550164,0,0,22,22,
Oklahoma,State Auditor,John Yeutter,LIB,550164,0,0,164,164,
Oklahoma,State Auditor,Cindy Byrd,REP,550164,0,0,384,384,
Oklahoma,Attorney General,Mike Hunter,REP,550164,0,0,350,350,
Oklahoma,Attorney General,Mark Myles,DEM,550164,0,0,239,239,
Oklahoma,State Treasurer,Randy Mcdaniel,REP,550164,0,0,371,371,
Oklahoma,State Treasurer,Charles De Coune,IND,550164,0,0,177,177,
Oklahoma,Superintendent of Public Instruction,Joy Hofmeister,REP,550164,0,0,326,326,
Oklahoma,Superintendent of Public Instruction,John Cox,DEM,550164,0,0,204,204,
Oklahoma,Superintendent of Public Instruction,Larry Huff,IND,550164,0,0,57,57,
Oklahoma,Commissioner of Labor,Leslie Osborn,REP,550164,0,0,352,352,
Oklahoma,Commissioner of Labor,Fred Dorrell,DEM,550164,0,0,207,207,
Oklahoma,Commissioner of Labor,Brandt Dismukes,IND,550164,0,0,21,21,
Oklahoma,Insurance Commissioner,Glen Mulready,REP,550164,0,0,337,337,
Oklahoma,Insurance Commissioner,Kimberly Fobbs,DEM,550164,0,0,243,243,
Oklahoma,Corporation Commissioner,Bob Anthony,REP,550164,0,0,336,336,
Oklahoma,Corporation Commissioner,Ashley Nicole Mccray,DEM,550164,0,0,217,217,
Oklahoma,Corporation Commissioner,Jackie Short,IND,550164,0,0,27,27,
Oklahoma,U.S. House,Steve Russell,REP,550164,0,0,317,317,5
Oklahoma,U.S. House,Kendra Horn,DEM,550164,0,0,271,271,5
Oklahoma,State House,Jon Echols,REP,550164,0,0,366,366,90
Oklahoma,State House,Lavelle Compton,DEM,550164,0,0,219,219,90
Oklahoma,Governor,Chris Powell,LIB,550165,0,0,54,54,
Oklahoma,Governor,Kevin Stitt,REP,550165,0,0,690,690,
Oklahoma,Governor,Drew Edmondson,DEM,550165,0,0,385,385,
Oklahoma,Lieutenant Governor,Matt Pinnell,REP,550165,0,0,746,746,
Oklahoma,Lieutenant Governor,Anastasia Pittman,DEM,550165,0,0,324,324,
Oklahoma,Lieutenant Governor,Ivan Holmes,IND,550165,0,0,49,49,
Oklahoma,State Auditor,John Yeutter,LIB,550165,0,0,245,245,
Oklahoma,State Auditor,Cindy Byrd,REP,550165,0,0,812,812,
Oklahoma,Attorney General,Mike Hunter,REP,550165,0,0,782,782,
Oklahoma,Attorney General,Mark Myles,DEM,550165,0,0,327,327,
Oklahoma,State Treasurer,Randy Mcdaniel,REP,550165,0,0,797,797,
Oklahoma,State Treasurer,Charles De Coune,IND,550165,0,0,262,262,
Oklahoma,Superintendent of Public Instruction,Joy Hofmeister,REP,550165,0,0,709,709,
Oklahoma,Superintendent of Public Instruction,John Cox,DEM,550165,0,0,304,304,
Oklahoma,Superintendent of Public Instruction,Larry Huff,IND,550165,0,0,105,105,
Oklahoma,Commissioner of Labor,Leslie Osborn,REP,550165,0,0,772,772,
Oklahoma,Commissioner of Labor,Fred Dorrell,DEM,550165,0,0,276,276,
Oklahoma,Commissioner of Labor,Brandt Dismukes,IND,550165,0,0,64,64,
Oklahoma,Insurance Commissioner,Glen Mulready,REP,550165,0,0,747,747,
Oklahoma,Insurance Commissioner,Kimberly Fobbs,DEM,550165,0,0,358,358,
Oklahoma,Corporation Commissioner,Bob Anthony,REP,550165,0,0,699,699,
Oklahoma,Corporation Commissioner,Ashley Nicole Mccray,DEM,550165,0,0,328,328,
Oklahoma,Corporation Commissioner,Jackie Short,IND,550165,0,0,83,83,
Oklahoma,U.S. House,Steve Russell,REP,550165,0,0,722,722,5
Oklahoma,U.S. House,Kendra Horn,DEM,550165,0,0,396,396,5
Oklahoma,State House,Jon Echols,REP,550165,0,0,797,797,90
Oklahoma,State House,Lavelle Compton,DEM,550165,0,0,309,309,90
Oklahoma,Governor,Chris Powell,LIB,550166,0,0,9,9,
Oklahoma,Governor,Kevin Stitt,REP,550166,0,0,117,117,
Oklahoma,Governor,Drew Edmondson,DEM,550166,0,0,82,82,
Oklahoma,Lieutenant Governor,Matt Pinnell,REP,550166,0,0,128,128,
Oklahoma,Lieutenant Governor,Anastasia Pittman,DEM,550166,0,0,71,71,
Oklahoma,Lieutenant Governor,Ivan Holmes,IND,550166,0,0,8,8,
Oklahoma,State Auditor,John Yeutter,LIB,550166,0,0,55,55,
Oklahoma,State Auditor,Cindy Byrd,REP,550166,0,0,131,131,
Oklahoma,Attorney General,Mike Hunter,REP,550166,0,0,126,126,
Oklahoma,Attorney General,Mark Myles,DEM,550166,0,0,79,79,
Oklahoma,State Treasurer,Randy Mcdaniel,REP,550166,0,0,127,127,
Oklahoma,State Treasurer,Charles De Coune,IND,550166,0,0,57,57,
Oklahoma,Superintendent of Public Instruction,Joy Hofmeister,REP,550166,0,0,116,116,
Oklahoma,Superintendent of Public Instruction,John Cox,DEM,550166,0,0,59,59,
Oklahoma,Superintendent of Public Instruction,Larry Huff,IND,550166,0,0,27,27,
Oklahoma,Commissioner of Labor,Leslie Osborn,REP,550166,0,0,117,117,
Oklahoma,Commissioner of Labor,Fred Dorrell,DEM,550166,0,0,67,67,
Oklahoma,Commissioner of Labor,Brandt Dismukes,IND,550166,0,0,17,17,
Oklahoma,Insurance Commissioner,Glen Mulready,REP,550166,0,0,123,123,
Oklahoma,Insurance Commissioner,Kimberly Fobbs,DEM,550166,0,0,80,80,
Oklahoma,Corporation Commissioner,Bob Anthony,REP,550166,0,0,118,118,
Oklahoma,Corporation Commissioner,Ashley Nicole Mccray,DEM,550166,0,0,67,67,
Oklahoma,Corporation Commissioner,Jackie Short,IND,550166,0,0,17,17,
Oklahoma,U.S. House,Steve Russell,REP,550166,0,0,121,121,5
Oklahoma,U.S. House,Kendra Horn,DEM,550166,0,0,85,85,5
Oklahoma,State House,Jon Echols,REP,550166,0,0,130,130,90
Oklahoma,State House,Lavelle Compton,DEM,550166,0,0,71,71,90
Oklahoma,Governor,Chris Powell,LIB,550167,0,0,12,12,
Oklahoma,Governor,Kevin Stitt,REP,550167,0,0,130,130,
Oklahoma,Governor,Drew Edmondson,DEM,550167,0,0,207,207,
Oklahoma,Lieutenant Governor,Matt Pinnell,REP,550167,0,0,131,131,
Oklahoma,Lieutenant Governor,Anastasia Pittman,DEM,550167,0,0,192,192,
Oklahoma,Lieutenant Governor,Ivan Holmes,IND,550167,0,0,24,24,
Oklahoma,State Auditor,John Yeutter,LIB,550167,0,0,128,128,
Oklahoma,State Auditor,Cindy Byrd,REP,550167,0,0,171,171,
Oklahoma,Attorney General,Mike Hunter,REP,550167,0,0,141,141,
Oklahoma,Attorney General,Mark Myles,DEM,550167,0,0,203,203,
Oklahoma,State Treasurer,Randy Mcdaniel,REP,550167,0,0,168,168,
Oklahoma,State Treasurer,Charles De Coune,IND,550167,0,0,128,128,
Oklahoma,Superintendent of Public Instruction,Joy Hofmeister,REP,550167,0,0,138,138,
Oklahoma,Superintendent of Public Instruction,John Cox,DEM,550167,0,0,180,180,
Oklahoma,Superintendent of Public Instruction,Larry Huff,IND,550167,0,0,27,27,
Oklahoma,Commissioner of Labor,Leslie Osborn,REP,550167,0,0,139,139,
Oklahoma,Commissioner of Labor,Fred Dorrell,DEM,550167,0,0,185,185,
Oklahoma,Commissioner of Labor,Brandt Dismukes,IND,550167,0,0,21,21,
Oklahoma,Insurance Commissioner,Glen Mulready,REP,550167,0,0,139,139,
Oklahoma,Insurance Commissioner,Kimberly Fobbs,DEM,550167,0,0,203,203,
Oklahoma,Corporation Commissioner,Bob Anthony,REP,550167,0,0,127,127,
Oklahoma,Corporation Commissioner,Ashley Nicole Mccray,DEM,550167,0,0,193,193,
Oklahoma,Corporation Commissioner,Jackie Short,IND,550167,0,0,23,23,
Oklahoma,U.S. House,Steve Russell,REP,550167,0,0,139,139,5
Oklahoma,U.S. House,Kendra Horn,DEM,550167,0,0,208,208,5
Oklahoma,State House,Jon Echols,REP,550167,0,0,166,166,90
Oklahoma,State House,Lavelle Compton,DEM,550167,0,0,180,180,90
Oklahoma,Governor,Chris Powell,LIB,550168,0,0,12,12,
Oklahoma,Governor,Kevin Stitt,REP,550168,0,0,84,84,
Oklahoma,Governor,Drew Edmondson,DEM,550168,0,0,99,99,
Oklahoma,Lieutenant Governor,Matt Pinnell,REP,550168,0,0,87,87,
Oklahoma,Lieutenant Governor,Anastasia Pittman,DEM,550168,0,0,95,95,
Oklahoma,Lieutenant Governor,Ivan Holmes,IND,550168,0,0,12,12,
Oklahoma,State Auditor,John Yeutter,LIB,550168,0,0,68,68,
Oklahoma,State Auditor,Cindy Byrd,REP,550168,0,0,115,115,
Oklahoma,Attorney General,Mike Hunter,REP,550168,0,0,103,103,
Oklahoma,Attorney General,Mark Myles,DEM,550168,0,0,90,90,
Oklahoma,State Treasurer,Randy Mcdaniel,REP,550168,0,0,102,102,
Oklahoma,State Treasurer,Charles De Coune,IND,550168,0,0,81,81,
Oklahoma,Superintendent of Public Instruction,Joy Hofmeister,REP,550168,0,0,96,96,
Oklahoma,Superintendent of Public Instruction,John Cox,DEM,550168,0,0,75,75,
Oklahoma,Superintendent of Public Instruction,Larry Huff,IND,550168,0,0,23,23,
Oklahoma,Commissioner of Labor,Leslie Osborn,REP,550168,0,0,95,95,
Oklahoma,Commissioner of Labor,Fred Dorrell,DEM,550168,0,0,80,80,
Oklahoma,Commissioner of Labor,Brandt Dismukes,IND,550168,0,0,18,18,
Oklahoma,Insurance Commissioner,Glen Mulready,REP,550168,0,0,93,93,
Oklahoma,Insurance Commissioner,Kimberly Fobbs,DEM,550168,0,0,101,101,
Oklahoma,Corporation Commissioner,Bob Anthony,REP,550168,0,0,93,93,
Oklahoma,Corporation Commissioner,Ashley Nicole Mccray,DEM,550168,0,0,81,81,
Oklahoma,Corporation Commissioner,Jackie Short,IND,550168,0,0,20,20,
Oklahoma,U.S. House,Steve Russell,REP,550168,0,0,88,88,5
Oklahoma,U.S. House,Kendra Horn,DEM,550168,0,0,106,106,5
Oklahoma,State Senate,John Symcox,REP,550168,0,0,91,91,30
Oklahoma,State Senate,Julia Kirt,DEM,550168,0,0,104,104,30
Oklahoma,State House,Jon Echols,REP,550168,0,0,106,106,90
Oklahoma,State House,Lavelle Compton,DEM,550168,0,0,87,87,90
Oklahoma,Governor,Chris Powell,LIB,550169,0,0,21,21,
Oklahoma,Governor,Kevin Stitt,REP,550169,0,0,270,270,
Oklahoma,Governor,Drew Edmondson,DEM,550169,0,0,387,387,
Oklahoma,Lieutenant Governor,Matt Pinnell,REP,550169,0,0,296,296,
Oklahoma,Lieutenant Governor,Anastasia Pittman,DEM,550169,0,0,351,351,
Oklahoma,Lieutenant Governor,Ivan Holmes,IND,550169,0,0,21,21,
Oklahoma,State Auditor,John Yeutter,LIB,550169,0,0,245,245,
Oklahoma,State Auditor,Cindy Byrd,REP,550169,0,0,343,343,
Oklahoma,Attorney General,Mike Hunter,REP,550169,0,0,315,315,
Oklahoma,Attorney General,Mark Myles,DEM,550169,0,0,354,354,
Oklahoma,State Treasurer,Randy Mcdaniel,REP,550169,0,0,317,317,
Oklahoma,State Treasurer,Charles De Coune,IND,550169,0,0,266,266,
Oklahoma,Superintendent of Public Instruction,Joy Hofmeister,REP,550169,0,0,285,285,
Oklahoma,Superintendent of Public Instruction,John Cox,DEM,550169,0,0,329,329,
Oklahoma,Superintendent of Public Instruction,Larry Huff,IND,550169,0,0,53,53,
Oklahoma,Commissioner of Labor,Leslie Osborn,REP,550169,0,0,301,301,
Oklahoma,Commissioner of Labor,Fred Dorrell,DEM,550169,0,0,326,326,
Oklahoma,Commissioner of Labor,Brandt Dismukes,IND,550169,0,0,32,32,
Oklahoma,Insurance Commissioner,Glen Mulready,REP,550169,0,0,305,305,
Oklahoma,Insurance Commissioner,Kimberly Fobbs,DEM,550169,0,0,362,362,
Oklahoma,Corporation Commissioner,Bob Anthony,REP,550169,0,0,288,288,
Oklahoma,Corporation Commissioner,Ashley Nicole Mccray,DEM,550169,0,0,339,339,
Oklahoma,Corporation Commissioner,Jackie Short,IND,550169,0,0,40,40,
Oklahoma,U.S. House,Steve Russell,REP,550169,0,0,294,294,5
Oklahoma,U.S. House,Kendra Horn,DEM,550169,0,0,377,377,5
Oklahoma,State Senate,John Symcox,REP,550169,0,0,286,286,30
Oklahoma,State Senate,Julia Kirt,DEM,550169,0,0,383,383,30
Oklahoma,State House,William Cagle,LIB,550169,0,0,25,25,84
Oklahoma,State House,Tammy West,REP,550169,0,0,310,310,84
Oklahoma,State House,Lauren Morris,DEM,550169,0,0,335,335,84
Oklahoma,Governor,Chris Powell,LIB,550170,0,0,31,31,
Oklahoma,Governor,Kevin Stitt,REP,550170,0,0,237,237,
Oklahoma,Governor,Drew Edmondson,DEM,550170,0,0,338,338,
Oklahoma,Lieutenant Governor,Matt Pinnell,REP,550170,0,0,253,253,
Oklahoma,Lieutenant Governor,Anastasia Pittman,DEM,550170,0,0,312,312,
Oklahoma,Lieutenant Governor,Ivan Holmes,IND,550170,0,0,37,37,
Oklahoma,State Auditor,John Yeutter,LIB,550170,0,0,233,233,
Oklahoma,State Auditor,Cindy Byrd,REP,550170,0,0,299,299,
Oklahoma,Attorney General,Mike Hunter,REP,550170,0,0,263,263,
Oklahoma,Attorney General,Mark Myles,DEM,550170,0,0,338,338,
Oklahoma,State Treasurer,Randy Mcdaniel,REP,550170,0,0,284,284,
Oklahoma,State Treasurer,Charles De Coune,IND,550170,0,0,253,253,
Oklahoma,Superintendent of Public Instruction,Joy Hofmeister,REP,550170,0,0,243,243,
Oklahoma,Superintendent of Public Instruction,John Cox,DEM,550170,0,0,301,301,
Oklahoma,Superintendent of Public Instruction,Larry Huff,IND,550170,0,0,55,55,
Oklahoma,Commissioner of Labor,Leslie Osborn,REP,550170,0,0,255,255,
Oklahoma,Commissioner of Labor,Fred Dorrell,DEM,550170,0,0,306,306,
Oklahoma,Commissioner of Labor,Brandt Dismukes,IND,550170,0,0,37,37,
Oklahoma,Insurance Commissioner,Glen Mulready,REP,550170,0,0,254,254,
Oklahoma,Insurance Commissioner,Kimberly Fobbs,DEM,550170,0,0,342,342,
Oklahoma,Corporation Commissioner,Bob Anthony,REP,550170,0,0,249,249,
Oklahoma,Corporation Commissioner,Ashley Nicole Mccray,DEM,550170,0,0,307,307,
Oklahoma,Corporation Commissioner,Jackie Short,IND,550170,0,0,44,44,
Oklahoma,U.S. House,Steve Russell,REP,550170,0,0,253,253,5
Oklahoma,U.S. House,Kendra Horn,DEM,550170,0,0,349,349,5
Oklahoma,State Senate,John Symcox,REP,550170,0,0,246,246,30
Oklahoma,State Senate,Julia Kirt,DEM,550170,0,0,355,355,30
Oklahoma,State House,Jon Echols,REP,550170,0,0,276,276,90
Oklahoma,State House,Lavelle Compton,DEM,550170,0,0,323,323,90
Oklahoma,Governor,Chris Powell,LIB,550171,0,0,42,42,
Oklahoma,Governor,Kevin Stitt,REP,550171,0,0,241,241,
Oklahoma,Governor,Drew Edmondson,DEM,550171,0,0,546,546,
Oklahoma,Lieutenant Governor,Matt Pinnell,REP,550171,0,0,306,306,
Oklahoma,Lieutenant Governor,Anastasia Pittman,DEM,550171,0,0,465,465,
Oklahoma,Lieutenant Governor,Ivan Holmes,IND,550171,0,0,51,51,
Oklahoma,State Auditor,John Yeutter,LIB,550171,0,0,317,317,
Oklahoma,State Auditor,Cindy Byrd,REP,550171,0,0,400,400,
Oklahoma,Attorney General,Mike Hunter,REP,550171,0,0,315,315,
Oklahoma,Attorney General,Mark Myles,DEM,550171,0,0,506,506,
Oklahoma,State Treasurer,Randy Mcdaniel,REP,550171,0,0,333,333,
Oklahoma,State Treasurer,Charles De Coune,IND,550171,0,0,387,387,
Oklahoma,Superintendent of Public Instruction,Joy Hofmeister,REP,550171,0,0,313,313,
Oklahoma,Superintendent of Public Instruction,John Cox,DEM,550171,0,0,431,431,
Oklahoma,Superintendent of Public Instruction,Larry Huff,IND,550171,0,0,80,80,
Oklahoma,Commissioner of Labor,Leslie Osborn,REP,550171,0,0,334,334,
Oklahoma,Commissioner of Labor,Fred Dorrell,DEM,550171,0,0,421,421,
Oklahoma,Commissioner of Labor,Brandt Dismukes,IND,550171,0,0,59,59,
Oklahoma,Insurance Commissioner,Glen Mulready,REP,550171,0,0,292,292,
Oklahoma,Insurance Commissioner,Kimberly Fobbs,DEM,550171,0,0,522,522,
Oklahoma,Corporation Commissioner,Bob Anthony,REP,550171,0,0,296,296,
Oklahoma,Corporation Commissioner,Ashley Nicole Mccray,DEM,550171,0,0,457,457,
Oklahoma,Corporation Commissioner,Jackie Short,IND,550171,0,0,65,65,
Oklahoma,U.S. House,Steve Russell,REP,550171,0,0,272,272,5
Oklahoma,U.S. House,Kendra Horn,DEM,550171,0,0,550,550,5
Oklahoma,State Senate,John Symcox,REP,550171,0,0,285,285,30
Oklahoma,State Senate,Julia Kirt,DEM,550171,0,0,538,538,30
Oklahoma,Governor,Chris Powell,LIB,550172,0,0,53,53,
Oklahoma,Governor,Kevin Stitt,REP,550172,0,0,306,306,
Oklahoma,Governor,Drew Edmondson,DEM,550172,0,0,558,558,
Oklahoma,Lieutenant Governor,Matt Pinnell,REP,550172,0,0,362,362,
Oklahoma,Lieutenant Governor,Anastasia Pittman,DEM,550172,0,0,478,478,
Oklahoma,Lieutenant Governor,Ivan Holmes,IND,550172,0,0,64,64,
Oklahoma,State Auditor,John Yeutter,LIB,550172,0,0,360,360,
Oklahoma,State Auditor,Cindy Byrd,REP,550172,0,0,448,448,
Oklahoma,Attorney General,Mike Hunter,REP,550172,0,0,399,399,
Oklahoma,Attorney General,Mark Myles,DEM,550172,0,0,501,501,
Oklahoma,State Treasurer,Randy Mcdaniel,REP,550172,0,0,416,416,
Oklahoma,State Treasurer,Charles De Coune,IND,550172,0,0,391,391,
Oklahoma,Superintendent of Public Instruction,Joy Hofmeister,REP,550172,0,0,366,366,
Oklahoma,Superintendent of Public Instruction,John Cox,DEM,550172,0,0,426,426,
Oklahoma,Superintendent of Public Instruction,Larry Huff,IND,550172,0,0,104,104,
Oklahoma,Commissioner of Labor,Leslie Osborn,REP,550172,0,0,387,387,
Oklahoma,Commissioner of Labor,Fred Dorrell,DEM,550172,0,0,442,442,
Oklahoma,Commissioner of Labor,Brandt Dismukes,IND,550172,0,0,62,62,
Oklahoma,Insurance Commissioner,Glen Mulready,REP,550172,0,0,375,375,
Oklahoma,Insurance Commissioner,Kimberly Fobbs,DEM,550172,0,0,519,519,
Oklahoma,Corporation Commissioner,Bob Anthony,REP,550172,0,0,367,367,
Oklahoma,Corporation Commissioner,Ashley Nicole Mccray,DEM,550172,0,0,459,459,
Oklahoma,Corporation Commissioner,Jackie Short,IND,550172,0,0,73,73,
Oklahoma,U.S. House,Steve Russell,REP,550172,0,0,365,365,5
Oklahoma,U.S. House,Kendra Horn,DEM,550172,0,0,539,539,5
Oklahoma,State Senate,Joe Howell,REP,550172,0,0,309,309,40
Oklahoma,State Senate,Carri Hicks,DEM,550172,0,0,549,549,40
Oklahoma,State Senate,Christopher Hensley,IND,550172,0,0,44,44,40
Oklahoma,Governor,Chris Powell,LIB,550173,0,0,43,43,
Oklahoma,Governor,Kevin Stitt,REP,550173,0,0,433,433,
Oklahoma,Governor,Drew Edmondson,DEM,550173,0,0,497,497,
Oklahoma,Lieutenant Governor,Matt Pinnell,REP,550173,0,0,502,502,
Oklahoma,Lieutenant Governor,Anastasia Pittman,DEM,550173,0,0,423,423,
Oklahoma,Lieutenant Governor,Ivan Holmes,IND,550173,0,0,40,40,
Oklahoma,State Auditor,John Yeutter,LIB,550173,0,0,278,278,
Oklahoma,State Auditor,Cindy Byrd,REP,550173,0,0,602,602,
Oklahoma,Attorney General,Mike Hunter,REP,550173,0,0,526,526,
Oklahoma,Attorney General,Mark Myles,DEM,550173,0,0,439,439,
Oklahoma,State Treasurer,Randy Mcdaniel,REP,550173,0,0,527,527,
Oklahoma,State Treasurer,Charles De Coune,IND,550173,0,0,359,359,
Oklahoma,Superintendent of Public Instruction,Joy Hofmeister,REP,550173,0,0,488,488,
Oklahoma,Superintendent of Public Instruction,John Cox,DEM,550173,0,0,377,377,
Oklahoma,Superintendent of Public Instruction,Larry Huff,IND,550173,0,0,94,94,
Oklahoma,Commissioner of Labor,Leslie Osborn,REP,550173,0,0,500,500,
Oklahoma,Commissioner of Labor,Fred Dorrell,DEM,550173,0,0,401,401,
Oklahoma,Commissioner of Labor,Brandt Dismukes,IND,550173,0,0,49,49,
Oklahoma,Insurance Commissioner,Glen Mulready,REP,550173,0,0,480,480,
Oklahoma,Insurance Commissioner,Kimberly Fobbs,DEM,550173,0,0,467,467,
Oklahoma,Corporation Commissioner,Bob Anthony,REP,550173,0,0,504,504,
Oklahoma,Corporation Commissioner,Ashley Nicole Mccray,DEM,550173,0,0,391,391,
Oklahoma,Corporation Commissioner,Jackie Short,IND,550173,0,0,61,61,
Oklahoma,U.S. House,Steve Russell,REP,550173,0,0,477,477,5
Oklahoma,U.S. House,Kendra Horn,DEM,550173,0,0,485,485,5
Oklahoma,State Senate,Joe Howell,REP,550173,0,0,430,430,40
Oklahoma,State Senate,Carri Hicks,DEM,550173,0,0,489,489,40
Oklahoma,State Senate,Christopher Hensley,IND,550173,0,0,39,39,40
Oklahoma,State House,William Cagle,LIB,550173,0,0,53,53,84
Oklahoma,State House,Tammy West,REP,550173,0,0,516,516,84
Oklahoma,State House,Lauren Morris,DEM,550173,0,0,390,390,84
Oklahoma,Governor,Chris Powell,LIB,550174,0,0,19,19,
Oklahoma,Governor,Kevin Stitt,REP,550174,0,0,215,215,
Oklahoma,Governor,Drew Edmondson,DEM,550174,0,0,289,289,
Oklahoma,Lieutenant Governor,Matt Pinnell,REP,550174,0,0,238,238,
Oklahoma,Lieutenant Governor,Anastasia Pittman,DEM,550174,0,0,258,258,
Oklahoma,Lieutenant Governor,Ivan Holmes,IND,550174,0,0,21,21,
Oklahoma,State Auditor,John Yeutter,LIB,550174,0,0,157,157,
Oklahoma,State Auditor,Cindy Byrd,REP,550174,0,0,298,298,
Oklahoma,Attorney General,Mike Hunter,REP,550174,0,0,261,261,
Oklahoma,Attorney General,Mark Myles,DEM,550174,0,0,258,258,
Oklahoma,State Treasurer,Randy Mcdaniel,REP,550174,0,0,269,269,
Oklahoma,State Treasurer,Charles De Coune,IND,550174,0,0,193,193,
Oklahoma,Superintendent of Public Instruction,Joy Hofmeister,REP,550174,0,0,258,258,
Oklahoma,Superintendent of Public Instruction,John Cox,DEM,550174,0,0,218,218,
Oklahoma,Superintendent of Public Instruction,Larry Huff,IND,550174,0,0,40,40,
Oklahoma,Commissioner of Labor,Leslie Osborn,REP,550174,0,0,252,252,
Oklahoma,Commissioner of Labor,Fred Dorrell,DEM,550174,0,0,240,240,
Oklahoma,Commissioner of Labor,Brandt Dismukes,IND,550174,0,0,23,23,
Oklahoma,Insurance Commissioner,Glen Mulready,REP,550174,0,0,246,246,
Oklahoma,Insurance Commissioner,Kimberly Fobbs,DEM,550174,0,0,269,269,
Oklahoma,Corporation Commissioner,Bob Anthony,REP,550174,0,0,254,254,
Oklahoma,Corporation Commissioner,Ashley Nicole Mccray,DEM,550174,0,0,231,231,
Oklahoma,Corporation Commissioner,Jackie Short,IND,550174,0,0,32,32,
Oklahoma,U.S. House,Steve Russell,REP,550174,0,0,228,228,5
Oklahoma,U.S. House,Kendra Horn,DEM,550174,0,0,291,291,5
Oklahoma,State Senate,Joe Howell,REP,550174,0,0,220,220,40
Oklahoma,State Senate,Carri Hicks,DEM,550174,0,0,282,282,40
Oklahoma,State Senate,Christopher Hensley,IND,550174,0,0,16,16,40
Oklahoma,State House,William Cagle,LIB,550174,0,0,20,20,84
Oklahoma,State House,Tammy West,REP,550174,0,0,257,257,84
Oklahoma,State House,Lauren Morris,DEM,550174,0,0,244,244,84
Oklahoma,Governor,Chris Powell,LIB,550175,0,0,20,20,
Oklahoma,Governor,Kevin Stitt,REP,550175,0,0,119,119,
Oklahoma,Governor,Drew Edmondson,DEM,550175,0,0,176,176,
Oklahoma,Lieutenant Governor,Matt Pinnell,REP,550175,0,0,135,135,
Oklahoma,Lieutenant Governor,Anastasia Pittman,DEM,550175,0,0,153,153,
Oklahoma,Lieutenant Governor,Ivan Holmes,IND,550175,0,0,24,24,
Oklahoma,State Auditor,John Yeutter,LIB,550175,0,0,126,126,
Oklahoma,State Auditor,Cindy Byrd,REP,550175,0,0,158,158,
Oklahoma,Attorney General,Mike Hunter,REP,550175,0,0,146,146,
Oklahoma,Attorney General,Mark Myles,DEM,550175,0,0,163,163,
Oklahoma,State Treasurer,Randy Mcdaniel,REP,550175,0,0,145,145,
Oklahoma,State Treasurer,Charles De Coune,IND,550175,0,0,138,138,
Oklahoma,Superintendent of Public Instruction,Joy Hofmeister,REP,550175,0,0,131,131,
Oklahoma,Superintendent of Public Instruction,John Cox,DEM,550175,0,0,140,140,
Oklahoma,Superintendent of Public Instruction,Larry Huff,IND,550175,0,0,39,39,
Oklahoma,Commissioner of Labor,Leslie Osborn,REP,550175,0,0,131,131,
Oklahoma,Commissioner of Labor,Fred Dorrell,DEM,550175,0,0,152,152,
Oklahoma,Commissioner of Labor,Brandt Dismukes,IND,550175,0,0,21,21,
Oklahoma,Insurance Commissioner,Glen Mulready,REP,550175,0,0,142,142,
Oklahoma,Insurance Commissioner,Kimberly Fobbs,DEM,550175,0,0,164,164,
Oklahoma,Corporation Commissioner,Bob Anthony,REP,550175,0,0,135,135,
Oklahoma,Corporation Commissioner,Ashley Nicole Mccray,DEM,550175,0,0,145,145,
Oklahoma,Corporation Commissioner,Jackie Short,IND,550175,0,0,27,27,
Oklahoma,U.S. House,Steve Russell,REP,550175,0,0,131,131,5
Oklahoma,U.S. House,Kendra Horn,DEM,550175,0,0,177,177,5
Oklahoma,State Senate,Joe Howell,REP,550175,0,0,125,125,40
Oklahoma,State Senate,Carri Hicks,DEM,550175,0,0,169,169,40
Oklahoma,State Senate,Christopher Hensley,IND,550175,0,0,16,16,40
Oklahoma,State House,William Cagle,LIB,550175,0,0,22,22,84
Oklahoma,State House,Tammy West,REP,550175,0,0,133,133,84
Oklahoma,State House,Lauren Morris,DEM,550175,0,0,154,154,84
Oklahoma,Governor,Chris Powell,LIB,550176,0,0,45,45,
Oklahoma,Governor,Kevin Stitt,REP,550176,0,0,351,351,
Oklahoma,Governor,Drew Edmondson,DEM,550176,0,0,430,430,
Oklahoma,Lieutenant Governor,Matt Pinnell,REP,550176,0,0,408,408,
Oklahoma,Lieutenant Governor,Anastasia Pittman,DEM,550176,0,0,355,355,
Oklahoma,Lieutenant Governor,Ivan Holmes,IND,550176,0,0,52,52,
Oklahoma,State Auditor,John Yeutter,LIB,550176,0,0,265,265,
Oklahoma,State Auditor,Cindy Byrd,REP,550176,0,0,498,498,
Oklahoma,Attorney General,Mike Hunter,REP,550176,0,0,434,434,
Oklahoma,Attorney General,Mark Myles,DEM,550176,0,0,381,381,
Oklahoma,State Treasurer,Randy Mcdaniel,REP,550176,0,0,451,451,
Oklahoma,State Treasurer,Charles De Coune,IND,550176,0,0,310,310,
Oklahoma,Superintendent of Public Instruction,Joy Hofmeister,REP,550176,0,0,416,416,
Oklahoma,Superintendent of Public Instruction,John Cox,DEM,550176,0,0,306,306,
Oklahoma,Superintendent of Public Instruction,Larry Huff,IND,550176,0,0,91,91,
Oklahoma,Commissioner of Labor,Leslie Osborn,REP,550176,0,0,430,430,
Oklahoma,Commissioner of Labor,Fred Dorrell,DEM,550176,0,0,326,326,
Oklahoma,Commissioner of Labor,Brandt Dismukes,IND,550176,0,0,53,53,
Oklahoma,Insurance Commissioner,Glen Mulready,REP,550176,0,0,424,424,
Oklahoma,Insurance Commissioner,Kimberly Fobbs,DEM,550176,0,0,386,386,
Oklahoma,Corporation Commissioner,Bob Anthony,REP,550176,0,0,391,391,
Oklahoma,Corporation Commissioner,Ashley Nicole Mccray,DEM,550176,0,0,342,342,
Oklahoma,Corporation Commissioner,Jackie Short,IND,550176,0,0,79,79,
Oklahoma,U.S. House,Steve Russell,REP,550176,0,0,404,404,5
Oklahoma,U.S. House,Kendra Horn,DEM,550176,0,0,418,418,5
Oklahoma,State Senate,Joe Howell,REP,550176,0,0,373,373,40
Oklahoma,State Senate,Carri Hicks,DEM,550176,0,0,393,393,40
Oklahoma,State Senate,Christopher Hensley,IND,550176,0,0,49,49,40
Oklahoma,Governor,Chris Powell,LIB,550177,0,0,38,38,
Oklahoma,Governor,Kevin Stitt,REP,550177,0,0,357,357,
Oklahoma,Governor,Drew Edmondson,DEM,550177,0,0,490,490,
Oklahoma,Lieutenant Governor,Matt Pinnell,REP,550177,0,0,434,434,
Oklahoma,Lieutenant Governor,Anastasia Pittman,DEM,550177,0,0,407,407,
Oklahoma,Lieutenant Governor,Ivan Holmes,IND,550177,0,0,45,45,
Oklahoma,State Auditor,John Yeutter,LIB,550177,0,0,269,269,
Oklahoma,State Auditor,Cindy Byrd,REP,550177,0,0,552,552,
Oklahoma,Attorney General,Mike Hunter,REP,550177,0,0,472,472,
Oklahoma,Attorney General,Mark Myles,DEM,550177,0,0,413,413,
Oklahoma,State Treasurer,Randy Mcdaniel,REP,550177,0,0,472,472,
Oklahoma,State Treasurer,Charles De Coune,IND,550177,0,0,347,347,
Oklahoma,Superintendent of Public Instruction,Joy Hofmeister,REP,550177,0,0,448,448,
Oklahoma,Superintendent of Public Instruction,John Cox,DEM,550177,0,0,358,358,
Oklahoma,Superintendent of Public Instruction,Larry Huff,IND,550177,0,0,74,74,
Oklahoma,Commissioner of Labor,Leslie Osborn,REP,550177,0,0,444,444,
Oklahoma,Commissioner of Labor,Fred Dorrell,DEM,550177,0,0,376,376,
Oklahoma,Commissioner of Labor,Brandt Dismukes,IND,550177,0,0,60,60,
Oklahoma,Insurance Commissioner,Glen Mulready,REP,550177,0,0,421,421,
Oklahoma,Insurance Commissioner,Kimberly Fobbs,DEM,550177,0,0,457,457,
Oklahoma,Corporation Commissioner,Bob Anthony,REP,550177,0,0,429,429,
Oklahoma,Corporation Commissioner,Ashley Nicole Mccray,DEM,550177,0,0,385,385,
Oklahoma,Corporation Commissioner,Jackie Short,IND,550177,0,0,63,63,
Oklahoma,U.S. House,Steve Russell,REP,550177,0,0,400,400,5
Oklahoma,U.S. House,Kendra Horn,DEM,550177,0,0,486,486,5
Oklahoma,State Senate,Joe Howell,REP,550177,0,0,362,362,40
Oklahoma,State Senate,Carri Hicks,DEM,550177,0,0,475,475,40
Oklahoma,State Senate,Christopher Hensley,IND,550177,0,0,44,44,40
Oklahoma,Governor,Chris Powell,LIB,550178,0,0,30,30,
Oklahoma,Governor,Kevin Stitt,REP,550178,0,0,254,254,
Oklahoma,Governor,Drew Edmondson,DEM,550178,0,0,388,388,
Oklahoma,Lieutenant Governor,Matt Pinnell,REP,550178,0,0,317,317,
Oklahoma,Lieutenant Governor,Anastasia Pittman,DEM,550178,0,0,315,315,
Oklahoma,Lieutenant Governor,Ivan Holmes,IND,550178,0,0,33,33,
Oklahoma,State Auditor,John Yeutter,LIB,550178,0,0,185,185,
Oklahoma,State Auditor,Cindy Byrd,REP,550178,0,0,406,406,
Oklahoma,Attorney General,Mike Hunter,REP,550178,0,0,351,351,
Oklahoma,Attorney General,Mark Myles,DEM,550178,0,0,319,319,
Oklahoma,State Treasurer,Randy Mcdaniel,REP,550178,0,0,361,361,
Oklahoma,State Treasurer,Charles De Coune,IND,550178,0,0,227,227,
Oklahoma,Superintendent of Public Instruction,Joy Hofmeister,REP,550178,0,0,339,339,
Oklahoma,Superintendent of Public Instruction,John Cox,DEM,550178,0,0,262,262,
Oklahoma,Superintendent of Public Instruction,Larry Huff,IND,550178,0,0,64,64,
Oklahoma,Commissioner of Labor,Leslie Osborn,REP,550178,0,0,326,326,
Oklahoma,Commissioner of Labor,Fred Dorrell,DEM,550178,0,0,281,281,
Oklahoma,Commissioner of Labor,Brandt Dismukes,IND,550178,0,0,45,45,
Oklahoma,Insurance Commissioner,Glen Mulready,REP,550178,0,0,310,310,
Oklahoma,Insurance Commissioner,Kimberly Fobbs,DEM,550178,0,0,340,340,
Oklahoma,Corporation Commissioner,Bob Anthony,REP,550178,0,0,304,304,
Oklahoma,Corporation Commissioner,Ashley Nicole Mccray,DEM,550178,0,0,299,299,
Oklahoma,Corporation Commissioner,Jackie Short,IND,550178,0,0,59,59,
Oklahoma,U.S. House,Steve Russell,REP,550178,0,0,291,291,5
Oklahoma,U.S. House,Kendra Horn,DEM,550178,0,0,376,376,5
Oklahoma,State Senate,Joe Howell,REP,550178,0,0,266,266,40
Oklahoma,State Senate,Carri Hicks,DEM,550178,0,0,368,368,40
Oklahoma,State Senate,Christopher Hensley,IND,550178,0,0,29,29,40
Oklahoma,Governor,Chris Powell,LIB,550179,0,0,32,32,
Oklahoma,Governor,Kevin Stitt,REP,550179,0,0,375,375,
Oklahoma,Governor,Drew Edmondson,DEM,550179,0,0,582,582,
Oklahoma,Lieutenant Governor,Matt Pinnell,REP,550179,0,0,483,483,
Oklahoma,Lieutenant Governor,Anastasia Pittman,DEM,550179,0,0,457,457,
Oklahoma,Lieutenant Governor,Ivan Holmes,IND,550179,0,0,39,39,
Oklahoma,State Auditor,John Yeutter,LIB,550179,0,0,284,284,
Oklahoma,State Auditor,Cindy Byrd,REP,550179,0,0,589,589,
Oklahoma,Attorney General,Mike Hunter,REP,550179,0,0,516,516,
Oklahoma,Attorney General,Mark Myles,DEM,550179,0,0,469,469,
Oklahoma,State Treasurer,Randy Mcdaniel,REP,550179,0,0,509,509,
Oklahoma,State Treasurer,Charles De Coune,IND,550179,0,0,366,366,
Oklahoma,Superintendent of Public Instruction,Joy Hofmeister,REP,550179,0,0,482,482,
Oklahoma,Superintendent of Public Instruction,John Cox,DEM,550179,0,0,414,414,
Oklahoma,Superintendent of Public Instruction,Larry Huff,IND,550179,0,0,78,78,
Oklahoma,Commissioner of Labor,Leslie Osborn,REP,550179,0,0,501,501,
Oklahoma,Commissioner of Labor,Fred Dorrell,DEM,550179,0,0,406,406,
Oklahoma,Commissioner of Labor,Brandt Dismukes,IND,550179,0,0,51,51,
Oklahoma,Insurance Commissioner,Glen Mulready,REP,550179,0,0,479,479,
Oklahoma,Insurance Commissioner,Kimberly Fobbs,DEM,550179,0,0,481,481,
Oklahoma,Corporation Commissioner,Bob Anthony,REP,550179,0,0,486,486,
Oklahoma,Corporation Commissioner,Ashley Nicole Mccray,DEM,550179,0,0,425,425,
Oklahoma,Corporation Commissioner,Jackie Short,IND,550179,0,0,62,62,
Oklahoma,U.S. House,Steve Russell,REP,550179,0,0,439,439,5
Oklahoma,U.S. House,Kendra Horn,DEM,550179,0,0,547,547,5
Oklahoma,State Senate,Joe Howell,REP,550179,0,0,413,413,40
Oklahoma,State Senate,Carri Hicks,DEM,550179,0,0,534,534,40
Oklahoma,State Senate,Christopher Hensley,IND,550179,0,0,30,30,40
Oklahoma,State House,Stephen Paulsen,LIB,550179,0,0,20,20,85
Oklahoma,State House,Matt Jackson,REP,550179,0,0,395,395,85
Oklahoma,State House,Cyndi Munson,DEM,550179,0,0,566,566,85
Oklahoma,Governor,Chris Powell,LIB,550180,0,0,22,22,
Oklahoma,Governor,Kevin Stitt,REP,550180,0,0,209,209,
Oklahoma,Governor,Drew Edmondson,DEM,550180,0,0,394,394,
Oklahoma,Lieutenant Governor,Matt Pinnell,REP,550180,0,0,284,284,
Oklahoma,Lieutenant Governor,Anastasia Pittman,DEM,550180,0,0,298,298,
Oklahoma,Lieutenant Governor,Ivan Holmes,IND,550180,0,0,38,38,
Oklahoma,State Auditor,John Yeutter,LIB,550180,0,0,205,205,
Oklahoma,State Auditor,Cindy Byrd,REP,550180,0,0,353,353,
Oklahoma,Attorney General,Mike Hunter,REP,550180,0,0,297,297,
Oklahoma,Attorney General,Mark Myles,DEM,550180,0,0,319,319,
Oklahoma,State Treasurer,Randy Mcdaniel,REP,550180,0,0,314,314,
Oklahoma,State Treasurer,Charles De Coune,IND,550180,0,0,243,243,
Oklahoma,Superintendent of Public Instruction,Joy Hofmeister,REP,550180,0,0,261,261,
Oklahoma,Superintendent of Public Instruction,John Cox,DEM,550180,0,0,290,290,
Oklahoma,Superintendent of Public Instruction,Larry Huff,IND,550180,0,0,64,64,
Oklahoma,Commissioner of Labor,Leslie Osborn,REP,550180,0,0,292,292,
Oklahoma,Commissioner of Labor,Fred Dorrell,DEM,550180,0,0,283,283,
Oklahoma,Commissioner of Labor,Brandt Dismukes,IND,550180,0,0,33,33,
Oklahoma,Insurance Commissioner,Glen Mulready,REP,550180,0,0,277,277,
Oklahoma,Insurance Commissioner,Kimberly Fobbs,DEM,550180,0,0,329,329,
Oklahoma,Corporation Commissioner,Bob Anthony,REP,550180,0,0,268,268,
Oklahoma,Corporation Commissioner,Ashley Nicole Mccray,DEM,550180,0,0,292,292,
Oklahoma,Corporation Commissioner,Jackie Short,IND,550180,0,0,52,52,
Oklahoma,U.S. House,Steve Russell,REP,550180,0,0,251,251,5
Oklahoma,U.S. House,Kendra Horn,DEM,550180,0,0,369,369,5
Oklahoma,State Senate,Joe Howell,REP,550180,0,0,226,226,40
Oklahoma,State Senate,Carri Hicks,DEM,550180,0,0,359,359,40
Oklahoma,State Senate,Christopher Hensley,IND,550180,0,0,30,30,40
Oklahoma,State House,Stephen Paulsen,LIB,550180,0,0,23,23,85
Oklahoma,State House,Matt Jackson,REP,550180,0,0,221,221,85
Oklahoma,State House,Cyndi Munson,DEM,550180,0,0,375,375,85
Oklahoma,Governor,Chris Powell,LIB,550181,0,0,10,10,
Oklahoma,Governor,Kevin Stitt,REP,550181,0,0,150,150,
Oklahoma,Governor,Drew Edmondson,DEM,550181,0,0,261,261,
Oklahoma,Lieutenant Governor,Matt Pinnell,REP,550181,0,0,189,189,
Oklahoma,Lieutenant Governor,Anastasia Pittman,DEM,550181,0,0,209,209,
Oklahoma,Lieutenant Governor,Ivan Holmes,IND,550181,0,0,19,19,
Oklahoma,State Auditor,John Yeutter,LIB,550181,0,0,120,120,
Oklahoma,State Auditor,Cindy Byrd,REP,550181,0,0,254,254,
Oklahoma,Attorney General,Mike Hunter,REP,550181,0,0,191,191,
Oklahoma,Attorney General,Mark Myles,DEM,550181,0,0,220,220,
Oklahoma,State Treasurer,Randy Mcdaniel,REP,550181,0,0,215,215,
Oklahoma,State Treasurer,Charles De Coune,IND,550181,0,0,159,159,
Oklahoma,Superintendent of Public Instruction,Joy Hofmeister,REP,550181,0,0,197,197,
Oklahoma,Superintendent of Public Instruction,John Cox,DEM,550181,0,0,184,184,
Oklahoma,Superintendent of Public Instruction,Larry Huff,IND,550181,0,0,37,37,
Oklahoma,Commissioner of Labor,Leslie Osborn,REP,550181,0,0,206,206,
Oklahoma,Commissioner of Labor,Fred Dorrell,DEM,550181,0,0,188,188,
Oklahoma,Commissioner of Labor,Brandt Dismukes,IND,550181,0,0,19,19,
Oklahoma,Insurance Commissioner,Glen Mulready,REP,550181,0,0,177,177,
Oklahoma,Insurance Commissioner,Kimberly Fobbs,DEM,550181,0,0,232,232,
Oklahoma,Corporation Commissioner,Bob Anthony,REP,550181,0,0,185,185,
Oklahoma,Corporation Commissioner,Ashley Nicole Mccray,DEM,550181,0,0,206,206,
Oklahoma,Corporation Commissioner,Jackie Short,IND,550181,0,0,24,24,
Oklahoma,U.S. House,Steve Russell,REP,550181,0,0,171,171,5
Oklahoma,U.S. House,Kendra Horn,DEM,550181,0,0,247,247,5
Oklahoma,State Senate,Joe Howell,REP,550181,0,0,156,156,40
Oklahoma,State Senate,Carri Hicks,DEM,550181,0,0,242,242,40
Oklahoma,State Senate,Christopher Hensley,IND,550181,0,0,17,17,40
Oklahoma,State House,Stephen Paulsen,LIB,550181,0,0,9,9,85
Oklahoma,State House,Matt Jackson,REP,550181,0,0,155,155,85
Oklahoma,State House,Cyndi Munson,DEM,550181,0,0,252,252,85
Oklahoma,Governor,Chris Powell,LIB,550182,0,0,12,12,
Oklahoma,Governor,Kevin Stitt,REP,550182,0,0,109,109,
Oklahoma,Governor,Drew Edmondson,DEM,550182,0,0,310,310,
Oklahoma,Lieutenant Governor,Matt Pinnell,REP,550182,0,0,124,124,
Oklahoma,Lieutenant Governor,Anastasia Pittman,DEM,550182,0,0,273,273,
Oklahoma,Lieutenant Governor,Ivan Holmes,IND,550182,0,0,31,31,
Oklahoma,State Auditor,John Yeutter,LIB,550182,0,0,195,195,
Oklahoma,State Auditor,Cindy Byrd,REP,550182,0,0,181,181,
Oklahoma,Attorney General,Mike Hunter,REP,550182,0,0,136,136,
Oklahoma,Attorney General,Mark Myles,DEM,550182,0,0,292,292,
Oklahoma,State Treasurer,Randy Mcdaniel,REP,550182,0,0,159,159,
Oklahoma,State Treasurer,Charles De Coune,IND,550182,0,0,214,214,
Oklahoma,Superintendent of Public Instruction,Joy Hofmeister,REP,550182,0,0,144,144,
Oklahoma,Superintendent of Public Instruction,John Cox,DEM,550182,0,0,251,251,
Oklahoma,Superintendent of Public Instruction,Larry Huff,IND,550182,0,0,34,34,
Oklahoma,Commissioner of Labor,Leslie Osborn,REP,550182,0,0,135,135,
Oklahoma,Commissioner of Labor,Fred Dorrell,DEM,550182,0,0,264,264,
Oklahoma,Commissioner of Labor,Brandt Dismukes,IND,550182,0,0,26,26,
Oklahoma,Insurance Commissioner,Glen Mulready,REP,550182,0,0,122,122,
Oklahoma,Insurance Commissioner,Kimberly Fobbs,DEM,550182,0,0,301,301,
Oklahoma,Corporation Commissioner,Bob Anthony,REP,550182,0,0,135,135,
Oklahoma,Corporation Commissioner,Ashley Nicole Mccray,DEM,550182,0,0,267,267,
Oklahoma,Corporation Commissioner,Jackie Short,IND,550182,0,0,23,23,
Oklahoma,U.S. House,Steve Russell,REP,550182,0,0,120,120,5
Oklahoma,U.S. House,Kendra Horn,DEM,550182,0,0,309,309,5
Oklahoma,State Senate,Joe Howell,REP,550182,0,0,108,108,40
Oklahoma,State Senate,Carri Hicks,DEM,550182,0,0,295,295,40
Oklahoma,State Senate,Christopher Hensley,IND,550182,0,0,24,24,40
Oklahoma,Governor,Chris Powell,LIB,550183,0,0,43,43,
Oklahoma,Governor,Kevin Stitt,REP,550183,0,0,294,294,
Oklahoma,Governor,Drew Edmondson,DEM,550183,0,0,506,506,
Oklahoma,Lieutenant Governor,Matt Pinnell,REP,550183,0,0,333,333,
Oklahoma,Lieutenant Governor,Anastasia Pittman,DEM,550183,0,0,445,445,
Oklahoma,Lieutenant Governor,Ivan Holmes,IND,550183,0,0,57,57,
Oklahoma,State Auditor,John Yeutter,LIB,550183,0,0,319,319,
Oklahoma,State Auditor,Cindy Byrd,REP,550183,0,0,427,427,
Oklahoma,Attorney General,Mike Hunter,REP,550183,0,0,368,368,
Oklahoma,Attorney General,Mark Myles,DEM,550183,0,0,465,465,
Oklahoma,State Treasurer,Randy Mcdaniel,REP,550183,0,0,379,379,
Oklahoma,State Treasurer,Charles De Coune,IND,550183,0,0,369,369,
Oklahoma,Superintendent of Public Instruction,Joy Hofmeister,REP,550183,0,0,355,355,
Oklahoma,Superintendent of Public Instruction,John Cox,DEM,550183,0,0,396,396,
Oklahoma,Superintendent of Public Instruction,Larry Huff,IND,550183,0,0,81,81,
Oklahoma,Commissioner of Labor,Leslie Osborn,REP,550183,0,0,368,368,
Oklahoma,Commissioner of Labor,Fred Dorrell,DEM,550183,0,0,400,400,
Oklahoma,Commissioner of Labor,Brandt Dismukes,IND,550183,0,0,55,55,
Oklahoma,Insurance Commissioner,Glen Mulready,REP,550183,0,0,320,320,
Oklahoma,Insurance Commissioner,Kimberly Fobbs,DEM,550183,0,0,494,494,
Oklahoma,Corporation Commissioner,Bob Anthony,REP,550183,0,0,336,336,
Oklahoma,Corporation Commissioner,Ashley Nicole Mccray,DEM,550183,0,0,420,420,
Oklahoma,Corporation Commissioner,Jackie Short,IND,550183,0,0,68,68,
Oklahoma,U.S. House,Steve Russell,REP,550183,0,0,317,317,5
Oklahoma,U.S. House,Kendra Horn,DEM,550183,0,0,517,517,5
Oklahoma,State Senate,Joe Howell,REP,550183,0,0,281,281,40
Oklahoma,State Senate,Carri Hicks,DEM,550183,0,0,514,514,40
Oklahoma,State Senate,Christopher Hensley,IND,550183,0,0,35,35,40
Oklahoma,Governor,Chris Powell,LIB,550184,0,0,42,42,
Oklahoma,Governor,Kevin Stitt,REP,550184,0,0,253,253,
Oklahoma,Governor,Drew Edmondson,DEM,550184,0,0,623,623,
Oklahoma,Lieutenant Governor,Matt Pinnell,REP,550184,0,0,316,316,
Oklahoma,Lieutenant Governor,Anastasia Pittman,DEM,550184,0,0,542,542,
Oklahoma,Lieutenant Governor,Ivan Holmes,IND,550184,0,0,53,53,
Oklahoma,State Auditor,John Yeutter,LIB,550184,0,0,372,372,
Oklahoma,State Auditor,Cindy Byrd,REP,550184,0,0,429,429,
Oklahoma,Attorney General,Mike Hunter,REP,550184,0,0,345,345,
Oklahoma,Attorney General,Mark Myles,DEM,550184,0,0,558,558,
Oklahoma,State Treasurer,Randy Mcdaniel,REP,550184,0,0,360,360,
Oklahoma,State Treasurer,Charles De Coune,IND,550184,0,0,439,439,
Oklahoma,Superintendent of Public Instruction,Joy Hofmeister,REP,550184,0,0,330,330,
Oklahoma,Superintendent of Public Instruction,John Cox,DEM,550184,0,0,487,487,
Oklahoma,Superintendent of Public Instruction,Larry Huff,IND,550184,0,0,87,87,
Oklahoma,Commissioner of Labor,Leslie Osborn,REP,550184,0,0,326,326,
Oklahoma,Commissioner of Labor,Fred Dorrell,DEM,550184,0,0,501,501,
Oklahoma,Commissioner of Labor,Brandt Dismukes,IND,550184,0,0,71,71,
Oklahoma,Insurance Commissioner,Glen Mulready,REP,550184,0,0,326,326,
Oklahoma,Insurance Commissioner,Kimberly Fobbs,DEM,550184,0,0,576,576,
Oklahoma,Corporation Commissioner,Bob Anthony,REP,550184,0,0,304,304,
Oklahoma,Corporation Commissioner,Ashley Nicole Mccray,DEM,550184,0,0,525,525,
Oklahoma,Corporation Commissioner,Jackie Short,IND,550184,0,0,77,77,
Oklahoma,U.S. House,Steve Russell,REP,550184,0,0,295,295,5
Oklahoma,U.S. House,Kendra Horn,DEM,550184,0,0,617,617,5
Oklahoma,State Senate,Joe Howell,REP,550184,0,0,265,265,40
Oklahoma,State Senate,Carri Hicks,DEM,550184,0,0,607,607,40
Oklahoma,State Senate,Christopher Hensley,IND,550184,0,0,39,39,40
Oklahoma,Governor,Chris Powell,LIB,550185,0,0,8,8,
Oklahoma,Governor,Kevin Stitt,REP,550185,0,0,89,89,
Oklahoma,Governor,Drew Edmondson,DEM,550185,0,0,218,218,
Oklahoma,Lieutenant Governor,Matt Pinnell,REP,550185,0,0,106,106,
Oklahoma,Lieutenant Governor,Anastasia Pittman,DEM,550185,0,0,193,193,
Oklahoma,Lieutenant Governor,Ivan Holmes,IND,550185,0,0,14,14,
Oklahoma,State Auditor,John Yeutter,LIB,550185,0,0,125,125,
Oklahoma,State Auditor,Cindy Byrd,REP,550185,0,0,154,154,
Oklahoma,Attorney General,Mike Hunter,REP,550185,0,0,123,123,
Oklahoma,Attorney General,Mark Myles,DEM,550185,0,0,187,187,
Oklahoma,State Treasurer,Randy Mcdaniel,REP,550185,0,0,129,129,
Oklahoma,State Treasurer,Charles De Coune,IND,550185,0,0,157,157,
Oklahoma,Superintendent of Public Instruction,Joy Hofmeister,REP,550185,0,0,124,124,
Oklahoma,Superintendent of Public Instruction,John Cox,DEM,550185,0,0,162,162,
Oklahoma,Superintendent of Public Instruction,Larry Huff,IND,550185,0,0,27,27,
Oklahoma,Commissioner of Labor,Leslie Osborn,REP,550185,0,0,124,124,
Oklahoma,Commissioner of Labor,Fred Dorrell,DEM,550185,0,0,166,166,
Oklahoma,Commissioner of Labor,Brandt Dismukes,IND,550185,0,0,18,18,
Oklahoma,Insurance Commissioner,Glen Mulready,REP,550185,0,0,114,114,
Oklahoma,Insurance Commissioner,Kimberly Fobbs,DEM,550185,0,0,196,196,
Oklahoma,Corporation Commissioner,Bob Anthony,REP,550185,0,0,110,110,
Oklahoma,Corporation Commissioner,Ashley Nicole Mccray,DEM,550185,0,0,178,178,
Oklahoma,Corporation Commissioner,Jackie Short,IND,550185,0,0,20,20,
Oklahoma,U.S. House,Steve Russell,REP,550185,0,0,99,99,5
Oklahoma,U.S. House,Kendra Horn,DEM,550185,0,0,214,214,5
Oklahoma,State Senate,Joe Howell,REP,550185,0,0,92,92,40
Oklahoma,State Senate,Carri Hicks,DEM,550185,0,0,204,204,40
Oklahoma,State Senate,Christopher Hensley,IND,550185,0,0,12,12,40
Oklahoma,Governor,Chris Powell,LIB,550186,0,0,18,18,
Oklahoma,Governor,Kevin Stitt,REP,550186,0,0,131,131,
Oklahoma,Governor,Drew Edmondson,DEM,550186,0,0,374,374,
Oklahoma,Lieutenant Governor,Matt Pinnell,REP,550186,0,0,175,175,
Oklahoma,Lieutenant Governor,Anastasia Pittman,DEM,550186,0,0,306,306,
Oklahoma,Lieutenant Governor,Ivan Holmes,IND,550186,0,0,32,32,
Oklahoma,State Auditor,John Yeutter,LIB,550186,0,0,185,185,
Oklahoma,State Auditor,Cindy Byrd,REP,550186,0,0,260,260,
Oklahoma,Attorney General,Mike Hunter,REP,550186,0,0,203,203,
Oklahoma,Attorney General,Mark Myles,DEM,550186,0,0,308,308,
Oklahoma,State Treasurer,Randy Mcdaniel,REP,550186,0,0,201,201,
Oklahoma,State Treasurer,Charles De Coune,IND,550186,0,0,251,251,
Oklahoma,Superintendent of Public Instruction,Joy Hofmeister,REP,550186,0,0,211,211,
Oklahoma,Superintendent of Public Instruction,John Cox,DEM,550186,0,0,251,251,
Oklahoma,Superintendent of Public Instruction,Larry Huff,IND,550186,0,0,52,52,
Oklahoma,Commissioner of Labor,Leslie Osborn,REP,550186,0,0,200,200,
Oklahoma,Commissioner of Labor,Fred Dorrell,DEM,550186,0,0,266,266,
Oklahoma,Commissioner of Labor,Brandt Dismukes,IND,550186,0,0,29,29,
Oklahoma,Insurance Commissioner,Glen Mulready,REP,550186,0,0,178,178,
Oklahoma,Insurance Commissioner,Kimberly Fobbs,DEM,550186,0,0,320,320,
Oklahoma,Corporation Commissioner,Bob Anthony,REP,550186,0,0,191,191,
Oklahoma,Corporation Commissioner,Ashley Nicole Mccray,DEM,550186,0,0,275,275,
Oklahoma,Corporation Commissioner,Jackie Short,IND,550186,0,0,40,40,
Oklahoma,U.S. House,Steve Russell,REP,550186,0,0,158,158,5
Oklahoma,U.S. House,Kendra Horn,DEM,550186,0,0,355,355,5
Oklahoma,State Senate,John Symcox,REP,550186,0,0,150,150,30
Oklahoma,State Senate,Julia Kirt,DEM,550186,0,0,363,363,30
Oklahoma,Governor,Chris Powell,LIB,550187,0,0,2,2,
Oklahoma,Governor,Kevin Stitt,REP,550187,0,0,34,34,
Oklahoma,Governor,Drew Edmondson,DEM,550187,0,0,56,56,
Oklahoma,Lieutenant Governor,Matt Pinnell,REP,550187,0,0,37,37,
Oklahoma,Lieutenant Governor,Anastasia Pittman,DEM,550187,0,0,47,47,
Oklahoma,Lieutenant Governor,Ivan Holmes,IND,550187,0,0,7,7,
Oklahoma,State Auditor,John Yeutter,LIB,550187,0,0,35,35,
Oklahoma,State Auditor,Cindy Byrd,REP,550187,0,0,48,48,
Oklahoma,Attorney General,Mike Hunter,REP,550187,0,0,35,35,
Oklahoma,Attorney General,Mark Myles,DEM,550187,0,0,56,56,
Oklahoma,State Treasurer,Randy Mcdaniel,REP,550187,0,0,38,38,
Oklahoma,State Treasurer,Charles De Coune,IND,550187,0,0,44,44,
Oklahoma,Superintendent of Public Instruction,Joy Hofmeister,REP,550187,0,0,35,35,
Oklahoma,Superintendent of Public Instruction,John Cox,DEM,550187,0,0,52,52,
Oklahoma,Superintendent of Public Instruction,Larry Huff,IND,550187,0,0,4,4,
Oklahoma,Commissioner of Labor,Leslie Osborn,REP,550187,0,0,35,35,
Oklahoma,Commissioner of Labor,Fred Dorrell,DEM,550187,0,0,53,53,
Oklahoma,Commissioner of Labor,Brandt Dismukes,IND,550187,0,0,3,3,
Oklahoma,Insurance Commissioner,Glen Mulready,REP,550187,0,0,35,35,
Oklahoma,Insurance Commissioner,Kimberly Fobbs,DEM,550187,0,0,55,55,
Oklahoma,Corporation Commissioner,Bob Anthony,REP,550187,0,0,37,37,
Oklahoma,Corporation Commissioner,Ashley Nicole Mccray,DEM,550187,0,0,48,48,
Oklahoma,Corporation Commissioner,Jackie Short,IND,550187,0,0,7,7,
Oklahoma,U.S. House,Steve Russell,REP,550187,0,0,32,32,5
Oklahoma,U.S. House,Kendra Horn,DEM,550187,0,0,59,59,5
Oklahoma,State Senate,John Symcox,REP,550187,0,0,34,34,30
Oklahoma,State Senate,Julia Kirt,DEM,550187,0,0,58,58,30
Oklahoma,Governor,Chris Powell,LIB,550188,0,0,0,0,
Oklahoma,Governor,Kevin Stitt,REP,550188,0,0,0,0,
Oklahoma,Governor,Drew Edmondson,DEM,550188,0,0,3,3,
Oklahoma,Lieutenant Governor,Matt Pinnell,REP,550188,0,0,0,0,
Oklahoma,Lieutenant Governor,Anastasia Pittman,DEM,550188,0,0,3,3,
Oklahoma,Lieutenant Governor,Ivan Holmes,IND,550188,0,0,0,0,
Oklahoma,State Auditor,John Yeutter,LIB,550188,0,0,3,3,
Oklahoma,State Auditor,Cindy Byrd,REP,550188,0,0,0,0,
Oklahoma,Attorney General,Mike Hunter,REP,550188,0,0,0,0,
Oklahoma,Attorney General,Mark Myles,DEM,550188,0,0,3,3,
Oklahoma,State Treasurer,Randy Mcdaniel,REP,550188,0,0,0,0,
Oklahoma,State Treasurer,Charles De Coune,IND,550188,0,0,3,3,
Oklahoma,Superintendent of Public Instruction,Joy Hofmeister,REP,550188,0,0,0,0,
Oklahoma,Superintendent of Public Instruction,John Cox,DEM,550188,0,0,3,3,
Oklahoma,Superintendent of Public Instruction,Larry Huff,IND,550188,0,0,0,0,
Oklahoma,Commissioner of Labor,Leslie Osborn,REP,550188,0,0,0,0,
Oklahoma,Commissioner of Labor,Fred Dorrell,DEM,550188,0,0,3,3,
Oklahoma,Commissioner of Labor,Brandt Dismukes,IND,550188,0,0,0,0,
Oklahoma,Insurance Commissioner,Glen Mulready,REP,550188,0,0,0,0,
Oklahoma,Insurance Commissioner,Kimberly Fobbs,DEM,550188,0,0,3,3,
Oklahoma,Corporation Commissioner,Bob Anthony,REP,550188,0,0,0,0,
Oklahoma,Corporation Commissioner,Ashley Nicole Mccray,DEM,550188,0,0,3,3,
Oklahoma,Corporation Commissioner,Jackie Short,IND,550188,0,0,0,0,
Oklahoma,U.S. House,Steve Russell,REP,550188,0,0,0,0,5
Oklahoma,U.S. House,Kendra Horn,DEM,550188,0,0,3,3,5
Oklahoma,Governor,Chris Powell,LIB,550189,0,0,8,8,
Oklahoma,Governor,Kevin Stitt,REP,550189,0,0,42,42,
Oklahoma,Governor,Drew Edmondson,DEM,550189,0,0,57,57,
Oklahoma,Lieutenant Governor,Matt Pinnell,REP,550189,0,0,41,41,
Oklahoma,Lieutenant Governor,Anastasia Pittman,DEM,550189,0,0,59,59,
Oklahoma,Lieutenant Governor,Ivan Holmes,IND,550189,0,0,7,7,
Oklahoma,State Auditor,John Yeutter,LIB,550189,0,0,35,35,
Oklahoma,State Auditor,Cindy Byrd,REP,550189,0,0,58,58,
Oklahoma,Attorney General,Mike Hunter,REP,550189,0,0,49,49,
Oklahoma,Attorney General,Mark Myles,DEM,550189,0,0,58,58,
Oklahoma,State Treasurer,Randy Mcdaniel,REP,550189,0,0,48,48,
Oklahoma,State Treasurer,Charles De Coune,IND,550189,0,0,48,48,
Oklahoma,Superintendent of Public Instruction,Joy Hofmeister,REP,550189,0,0,43,43,
Oklahoma,Superintendent of Public Instruction,John Cox,DEM,550189,0,0,51,51,
Oklahoma,Superintendent of Public Instruction,Larry Huff,IND,550189,0,0,11,11,
Oklahoma,Commissioner of Labor,Leslie Osborn,REP,550189,0,0,44,44,
Oklahoma,Commissioner of Labor,Fred Dorrell,DEM,550189,0,0,56,56,
Oklahoma,Commissioner of Labor,Brandt Dismukes,IND,550189,0,0,6,6,
Oklahoma,Insurance Commissioner,Glen Mulready,REP,550189,0,0,47,47,
Oklahoma,Insurance Commissioner,Kimberly Fobbs,DEM,550189,0,0,59,59,
Oklahoma,Corporation Commissioner,Bob Anthony,REP,550189,0,0,44,44,
Oklahoma,Corporation Commissioner,Ashley Nicole Mccray,DEM,550189,0,0,53,53,
Oklahoma,Corporation Commissioner,Jackie Short,IND,550189,0,0,9,9,
Oklahoma,U.S. House,Steve Russell,REP,550189,0,0,43,43,5
Oklahoma,U.S. House,Kendra Horn,DEM,550189,0,0,64,64,5
Oklahoma,Governor,Chris Powell,LIB,550190,0,0,18,18,
Oklahoma,Governor,Kevin Stitt,REP,550190,0,0,65,65,
Oklahoma,Governor,Drew Edmondson,DEM,550190,0,0,299,299,
Oklahoma,Lieutenant Governor,Matt Pinnell,REP,550190,0,0,77,77,
Oklahoma,Lieutenant Governor,Anastasia Pittman,DEM,550190,0,0,271,271,
Oklahoma,Lieutenant Governor,Ivan Holmes,IND,550190,0,0,27,27,
Oklahoma,State Auditor,John Yeutter,LIB,550190,0,0,204,204,
Oklahoma,State Auditor,Cindy Byrd,REP,550190,0,0,123,123,
Oklahoma,Attorney General,Mike Hunter,REP,550190,0,0,80,80,
Oklahoma,Attorney General,Mark Myles,DEM,550190,0,0,289,289,
Oklahoma,State Treasurer,Randy Mcdaniel,REP,550190,0,0,92,92,
Oklahoma,State Treasurer,Charles De Coune,IND,550190,0,0,240,240,
Oklahoma,Superintendent of Public Instruction,Joy Hofmeister,REP,550190,0,0,87,87,
Oklahoma,Superintendent of Public Instruction,John Cox,DEM,550190,0,0,254,254,
Oklahoma,Superintendent of Public Instruction,Larry Huff,IND,550190,0,0,35,35,
Oklahoma,Commissioner of Labor,Leslie Osborn,REP,550190,0,0,82,82,
Oklahoma,Commissioner of Labor,Fred Dorrell,DEM,550190,0,0,263,263,
Oklahoma,Commissioner of Labor,Brandt Dismukes,IND,550190,0,0,27,27,
Oklahoma,Insurance Commissioner,Glen Mulready,REP,550190,0,0,79,79,
Oklahoma,Insurance Commissioner,Kimberly Fobbs,DEM,550190,0,0,297,297,
Oklahoma,Corporation Commissioner,Bob Anthony,REP,550190,0,0,80,80,
Oklahoma,Corporation Commissioner,Ashley Nicole Mccray,DEM,550190,0,0,271,271,
Oklahoma,Corporation Commissioner,Jackie Short,IND,550190,0,0,27,27,
Oklahoma,U.S. House,Steve Russell,REP,550190,0,0,72,72,5
Oklahoma,U.S. House,Kendra Horn,DEM,550190,0,0,308,308,5
Oklahoma,Governor,Chris Powell,LIB,550191,0,0,28,28,
Oklahoma,Governor,Kevin Stitt,REP,550191,0,0,137,137,
Oklahoma,Governor,Drew Edmondson,DEM,550191,0,0,414,414,
Oklahoma,Lieutenant Governor,Matt Pinnell,REP,550191,0,0,152,152,
Oklahoma,Lieutenant Governor,Anastasia Pittman,DEM,550191,0,0,378,378,
Oklahoma,Lieutenant Governor,Ivan Holmes,IND,550191,0,0,43,43,
Oklahoma,State Auditor,John Yeutter,LIB,550191,0,0,273,273,
Oklahoma,State Auditor,Cindy Byrd,REP,550191,0,0,234,234,
Oklahoma,Attorney General,Mike Hunter,REP,550191,0,0,181,181,
Oklahoma,Attorney General,Mark Myles,DEM,550191,0,0,390,390,
Oklahoma,State Treasurer,Randy Mcdaniel,REP,550191,0,0,184,184,
Oklahoma,State Treasurer,Charles De Coune,IND,550191,0,0,323,323,
Oklahoma,Superintendent of Public Instruction,Joy Hofmeister,REP,550191,0,0,185,185,
Oklahoma,Superintendent of Public Instruction,John Cox,DEM,550191,0,0,325,325,
Oklahoma,Superintendent of Public Instruction,Larry Huff,IND,550191,0,0,56,56,
Oklahoma,Commissioner of Labor,Leslie Osborn,REP,550191,0,0,186,186,
Oklahoma,Commissioner of Labor,Fred Dorrell,DEM,550191,0,0,339,339,
Oklahoma,Commissioner of Labor,Brandt Dismukes,IND,550191,0,0,36,36,
Oklahoma,Insurance Commissioner,Glen Mulready,REP,550191,0,0,168,168,
Oklahoma,Insurance Commissioner,Kimberly Fobbs,DEM,550191,0,0,393,393,
Oklahoma,Corporation Commissioner,Bob Anthony,REP,550191,0,0,159,159,
Oklahoma,Corporation Commissioner,Ashley Nicole Mccray,DEM,550191,0,0,362,362,
Oklahoma,Corporation Commissioner,Jackie Short,IND,550191,0,0,47,47,
Oklahoma,U.S. House,Steve Russell,REP,550191,0,0,146,146,5
Oklahoma,U.S. House,Kendra Horn,DEM,550191,0,0,428,428,5
Oklahoma,Governor,Chris Powell,LIB,550192,0,0,26,26,
Oklahoma,Governor,Kevin Stitt,REP,550192,0,0,246,246,
Oklahoma,Governor,Drew Edmondson,DEM,550192,0,0,877,877,
Oklahoma,Lieutenant Governor,Matt Pinnell,REP,550192,0,0,330,330,
Oklahoma,Lieutenant Governor,Anastasia Pittman,DEM,550192,0,0,744,744,
Oklahoma,Lieutenant Governor,Ivan Holmes,IND,550192,0,0,67,67,
Oklahoma,State Auditor,John Yeutter,LIB,550192,0,0,462,462,
Oklahoma,State Auditor,Cindy Byrd,REP,550192,0,0,538,538,
Oklahoma,Attorney General,Mike Hunter,REP,550192,0,0,360,360,
Oklahoma,Attorney General,Mark Myles,DEM,550192,0,0,769,769,
Oklahoma,State Treasurer,Randy Mcdaniel,REP,550192,0,0,410,410,
Oklahoma,State Treasurer,Charles De Coune,IND,550192,0,0,602,602,
Oklahoma,Superintendent of Public Instruction,Joy Hofmeister,REP,550192,0,0,408,408,
Oklahoma,Superintendent of Public Instruction,John Cox,DEM,550192,0,0,638,638,
Oklahoma,Superintendent of Public Instruction,Larry Huff,IND,550192,0,0,80,80,
Oklahoma,Commissioner of Labor,Leslie Osborn,REP,550192,0,0,411,411,
Oklahoma,Commissioner of Labor,Fred Dorrell,DEM,550192,0,0,643,643,
Oklahoma,Commissioner of Labor,Brandt Dismukes,IND,550192,0,0,60,60,
Oklahoma,Insurance Commissioner,Glen Mulready,REP,550192,0,0,338,338,
Oklahoma,Insurance Commissioner,Kimberly Fobbs,DEM,550192,0,0,778,778,
Oklahoma,Corporation Commissioner,Bob Anthony,REP,550192,0,0,339,339,
Oklahoma,Corporation Commissioner,Ashley Nicole Mccray,DEM,550192,0,0,716,716,
Oklahoma,Corporation Commissioner,Jackie Short,IND,550192,0,0,64,64,
Oklahoma,U.S. House,Steve Russell,REP,550192,0,0,284,284,5
Oklahoma,U.S. House,Kendra Horn,DEM,550192,0,0,854,854,5
Oklahoma,State Senate,John Symcox,REP,550192,0,0,273,273,30
Oklahoma,State Senate,Julia Kirt,DEM,550192,0,0,865,865,30
Oklahoma,Governor,Chris Powell,LIB,550193,0,0,30,30,
Oklahoma,Governor,Kevin Stitt,REP,550193,0,0,150,150,
Oklahoma,Governor,Drew Edmondson,DEM,550193,0,0,561,561,
Oklahoma,Lieutenant Governor,Matt Pinnell,REP,550193,0,0,209,209,
Oklahoma,Lieutenant Governor,Anastasia Pittman,DEM,550193,0,0,474,474,
Oklahoma,Lieutenant Governor,Ivan Holmes,IND,550193,0,0,51,51,
Oklahoma,State Auditor,John Yeutter,LIB,550193,0,0,306,306,
Oklahoma,State Auditor,Cindy Byrd,REP,550193,0,0,319,319,
Oklahoma,Attorney General,Mike Hunter,REP,550193,0,0,221,221,
Oklahoma,Attorney General,Mark Myles,DEM,550193,0,0,501,501,
Oklahoma,State Treasurer,Randy Mcdaniel,REP,550193,0,0,241,241,
Oklahoma,State Treasurer,Charles De Coune,IND,550193,0,0,388,388,
Oklahoma,Superintendent of Public Instruction,Joy Hofmeister,REP,550193,0,0,245,245,
Oklahoma,Superintendent of Public Instruction,John Cox,DEM,550193,0,0,425,425,
Oklahoma,Superintendent of Public Instruction,Larry Huff,IND,550193,0,0,56,56,
Oklahoma,Commissioner of Labor,Leslie Osborn,REP,550193,0,0,234,234,
Oklahoma,Commissioner of Labor,Fred Dorrell,DEM,550193,0,0,423,423,
Oklahoma,Commissioner of Labor,Brandt Dismukes,IND,550193,0,0,49,49,
Oklahoma,Insurance Commissioner,Glen Mulready,REP,550193,0,0,189,189,
Oklahoma,Insurance Commissioner,Kimberly Fobbs,DEM,550193,0,0,518,518,
Oklahoma,Corporation Commissioner,Bob Anthony,REP,550193,0,0,206,206,
Oklahoma,Corporation Commissioner,Ashley Nicole Mccray,DEM,550193,0,0,455,455,
Oklahoma,Corporation Commissioner,Jackie Short,IND,550193,0,0,55,55,
Oklahoma,U.S. House,Steve Russell,REP,550193,0,0,180,180,5
Oklahoma,U.S. House,Kendra Horn,DEM,550193,0,0,550,550,5
Oklahoma,State Senate,John Symcox,REP,550193,0,0,183,183,30
Oklahoma,State Senate,Julia Kirt,DEM,550193,0,0,547,547,30
Oklahoma,Governor,Chris Powell,LIB,550194,0,0,36,36,
Oklahoma,Governor,Kevin Stitt,REP,550194,0,0,165,165,
Oklahoma,Governor,Drew Edmondson,DEM,550194,0,0,508,508,
Oklahoma,Lieutenant Governor,Matt Pinnell,REP,550194,0,0,203,203,
Oklahoma,Lieutenant Governor,Anastasia Pittman,DEM,550194,0,0,440,440,
Oklahoma,Lieutenant Governor,Ivan Holmes,IND,550194,0,0,61,61,
Oklahoma,State Auditor,John Yeutter,LIB,550194,0,0,294,294,
Oklahoma,State Auditor,Cindy Byrd,REP,550194,0,0,314,314,
Oklahoma,Attorney General,Mike Hunter,REP,550194,0,0,223,223,
Oklahoma,Attorney General,Mark Myles,DEM,550194,0,0,485,485,
Oklahoma,State Treasurer,Randy Mcdaniel,REP,550194,0,0,248,248,
Oklahoma,State Treasurer,Charles De Coune,IND,550194,0,0,374,374,
Oklahoma,Superintendent of Public Instruction,Joy Hofmeister,REP,550194,0,0,228,228,
Oklahoma,Superintendent of Public Instruction,John Cox,DEM,550194,0,0,411,411,
Oklahoma,Superintendent of Public Instruction,Larry Huff,IND,550194,0,0,64,64,
Oklahoma,Commissioner of Labor,Leslie Osborn,REP,550194,0,0,235,235,
Oklahoma,Commissioner of Labor,Fred Dorrell,DEM,550194,0,0,419,419,
Oklahoma,Commissioner of Labor,Brandt Dismukes,IND,550194,0,0,49,49,
Oklahoma,Insurance Commissioner,Glen Mulready,REP,550194,0,0,204,204,
Oklahoma,Insurance Commissioner,Kimberly Fobbs,DEM,550194,0,0,494,494,
Oklahoma,Corporation Commissioner,Bob Anthony,REP,550194,0,0,213,213,
Oklahoma,Corporation Commissioner,Ashley Nicole Mccray,DEM,550194,0,0,430,430,
Oklahoma,Corporation Commissioner,Jackie Short,IND,550194,0,0,58,58,
Oklahoma,U.S. House,Steve Russell,REP,550194,0,0,183,183,5
Oklahoma,U.S. House,Kendra Horn,DEM,550194,0,0,525,525,5
Oklahoma,State Senate,Joe Howell,REP,550194,0,0,166,166,40
Oklahoma,State Senate,Carri Hicks,DEM,550194,0,0,507,507,40
Oklahoma,State Senate,Christopher Hensley,IND,550194,0,0,37,37,40
Oklahoma,Governor,Chris Powell,LIB,550195,0,0,40,40,
Oklahoma,Governor,Kevin Stitt,REP,550195,0,0,375,375,
Oklahoma,Governor,Drew Edmondson,DEM,550195,0,0,836,836,
Oklahoma,Lieutenant Governor,Matt Pinnell,REP,550195,0,0,467,467,
Oklahoma,Lieutenant Governor,Anastasia Pittman,DEM,550195,0,0,699,699,
Oklahoma,Lieutenant Governor,Ivan Holmes,IND,550195,0,0,79,79,
Oklahoma,State Auditor,John Yeutter,LIB,550195,0,0,451,451,
Oklahoma,State Auditor,Cindy Byrd,REP,550195,0,0,644,644,
Oklahoma,Attorney General,Mike Hunter,REP,550195,0,0,504,504,
Oklahoma,Attorney General,Mark Myles,DEM,550195,0,0,737,737,
Oklahoma,State Treasurer,Randy Mcdaniel,REP,550195,0,0,530,530,
Oklahoma,State Treasurer,Charles De Coune,IND,550195,0,0,575,575,
Oklahoma,Superintendent of Public Instruction,Joy Hofmeister,REP,550195,0,0,505,505,
Oklahoma,Superintendent of Public Instruction,John Cox,DEM,550195,0,0,623,623,
Oklahoma,Superintendent of Public Instruction,Larry Huff,IND,550195,0,0,114,114,
Oklahoma,Commissioner of Labor,Leslie Osborn,REP,550195,0,0,518,518,
Oklahoma,Commissioner of Labor,Fred Dorrell,DEM,550195,0,0,636,636,
Oklahoma,Commissioner of Labor,Brandt Dismukes,IND,550195,0,0,72,72,
Oklahoma,Insurance Commissioner,Glen Mulready,REP,550195,0,0,462,462,
Oklahoma,Insurance Commissioner,Kimberly Fobbs,DEM,550195,0,0,765,765,
Oklahoma,Corporation Commissioner,Bob Anthony,REP,550195,0,0,481,481,
Oklahoma,Corporation Commissioner,Ashley Nicole Mccray,DEM,550195,0,0,681,681,
Oklahoma,Corporation Commissioner,Jackie Short,IND,550195,0,0,77,77,
Oklahoma,U.S. House,Steve Russell,REP,550195,0,0,430,430,5
Oklahoma,U.S. House,Kendra Horn,DEM,550195,0,0,815,815,5
Oklahoma,State Senate,Joe Howell,REP,550195,0,0,379,379,40
Oklahoma,State Senate,Carri Hicks,DEM,550195,0,0,819,819,40
Oklahoma,State Senate,Christopher Hensley,IND,550195,0,0,43,43,40
Oklahoma,Governor,Chris Powell,LIB,550196,0,0,26,26,
Oklahoma,Governor,Kevin Stitt,REP,550196,0,0,542,542,
Oklahoma,Governor,Drew Edmondson,DEM,550196,0,0,820,820,
Oklahoma,Lieutenant Governor,Matt Pinnell,REP,550196,0,0,680,680,
Oklahoma,Lieutenant Governor,Anastasia Pittman,DEM,550196,0,0,642,642,
Oklahoma,Lieutenant Governor,Ivan Holmes,IND,550196,0,0,54,54,
Oklahoma,State Auditor,John Yeutter,LIB,550196,0,0,335,335,
Oklahoma,State Auditor,Cindy Byrd,REP,550196,0,0,867,867,
Oklahoma,Attorney General,Mike Hunter,REP,550196,0,0,730,730,
Oklahoma,Attorney General,Mark Myles,DEM,550196,0,0,635,635,
Oklahoma,State Treasurer,Randy Mcdaniel,REP,550196,0,0,790,790,
Oklahoma,State Treasurer,Charles De Coune,IND,550196,0,0,421,421,
Oklahoma,Superintendent of Public Instruction,Joy Hofmeister,REP,550196,0,0,720,720,
Oklahoma,Superintendent of Public Instruction,John Cox,DEM,550196,0,0,563,563,
Oklahoma,Superintendent of Public Instruction,Larry Huff,IND,550196,0,0,86,86,
Oklahoma,Commissioner of Labor,Leslie Osborn,REP,550196,0,0,718,718,
Oklahoma,Commissioner of Labor,Fred Dorrell,DEM,550196,0,0,571,571,
Oklahoma,Commissioner of Labor,Brandt Dismukes,IND,550196,0,0,65,65,
Oklahoma,Insurance Commissioner,Glen Mulready,REP,550196,0,0,673,673,
Oklahoma,Insurance Commissioner,Kimberly Fobbs,DEM,550196,0,0,677,677,
Oklahoma,Corporation Commissioner,Bob Anthony,REP,550196,0,0,717,717,
Oklahoma,Corporation Commissioner,Ashley Nicole Mccray,DEM,550196,0,0,588,588,
Oklahoma,Corporation Commissioner,Jackie Short,IND,550196,0,0,66,66,
Oklahoma,U.S. House,Steve Russell,REP,550196,0,0,607,607,5
Oklahoma,U.S. House,Kendra Horn,DEM,550196,0,0,774,774,5
Oklahoma,State Senate,Joe Howell,REP,550196,0,0,574,574,40
Oklahoma,State Senate,Carri Hicks,DEM,550196,0,0,762,762,40
Oklahoma,State Senate,Christopher Hensley,IND,550196,0,0,36,36,40
Oklahoma,State House,Stephen Paulsen,LIB,550196,0,0,43,43,85
Oklahoma,State House,Matt Jackson,REP,550196,0,0,537,537,85
Oklahoma,State House,Cyndi Munson,DEM,550196,0,0,797,797,85
Oklahoma,Governor,Chris Powell,LIB,550197,0,0,29,29,
Oklahoma,Governor,Kevin Stitt,REP,550197,0,0,165,165,
Oklahoma,Governor,Drew Edmondson,DEM,550197,0,0,576,576,
Oklahoma,Lieutenant Governor,Matt Pinnell,REP,550197,0,0,220,220,
Oklahoma,Lieutenant Governor,Anastasia Pittman,DEM,550197,0,0,489,489,
Oklahoma,Lieutenant Governor,Ivan Holmes,IND,550197,0,0,54,54,
Oklahoma,State Auditor,John Yeutter,LIB,550197,0,0,344,344,
Oklahoma,State Auditor,Cindy Byrd,REP,550197,0,0,332,332,
Oklahoma,Attorney General,Mike Hunter,REP,550197,0,0,233,233,
Oklahoma,Attorney General,Mark Myles,DEM,550197,0,0,528,528,
Oklahoma,State Treasurer,Randy Mcdaniel,REP,550197,0,0,251,251,
Oklahoma,State Treasurer,Charles De Coune,IND,550197,0,0,437,437,
Oklahoma,Superintendent of Public Instruction,Joy Hofmeister,REP,550197,0,0,237,237,
Oklahoma,Superintendent of Public Instruction,John Cox,DEM,550197,0,0,452,452,
Oklahoma,Superintendent of Public Instruction,Larry Huff,IND,550197,0,0,67,67,
Oklahoma,Commissioner of Labor,Leslie Osborn,REP,550197,0,0,226,226,
Oklahoma,Commissioner of Labor,Fred Dorrell,DEM,550197,0,0,478,478,
Oklahoma,Commissioner of Labor,Brandt Dismukes,IND,550197,0,0,46,46,
Oklahoma,Insurance Commissioner,Glen Mulready,REP,550197,0,0,208,208,
Oklahoma,Insurance Commissioner,Kimberly Fobbs,DEM,550197,0,0,540,540,
Oklahoma,Corporation Commissioner,Bob Anthony,REP,550197,0,0,248,248,
Oklahoma,Corporation Commissioner,Ashley Nicole Mccray,DEM,550197,0,0,460,460,
Oklahoma,Corporation Commissioner,Jackie Short,IND,550197,0,0,43,43,
Oklahoma,U.S. House,Steve Russell,REP,550197,0,0,194,194,5
Oklahoma,U.S. House,Kendra Horn,DEM,550197,0,0,565,565,5
Oklahoma,State Senate,Joe Howell,REP,550197,0,0,167,167,40
Oklahoma,State Senate,Carri Hicks,DEM,550197,0,0,574,574,40
Oklahoma,State Senate,Christopher Hensley,IND,550197,0,0,20,20,40
Oklahoma,Governor,Chris Powell,LIB,550198,0,0,23,23,
Oklahoma,Governor,Kevin Stitt,REP,550198,0,0,179,179,
Oklahoma,Governor,Drew Edmondson,DEM,550198,0,0,591,591,
Oklahoma,Lieutenant Governor,Matt Pinnell,REP,550198,0,0,234,234,
Oklahoma,Lieutenant Governor,Anastasia Pittman,DEM,550198,0,0,510,510,
Oklahoma,Lieutenant Governor,Ivan Holmes,IND,550198,0,0,46,46,
Oklahoma,State Auditor,John Yeutter,LIB,550198,0,0,285,285,
Oklahoma,State Auditor,Cindy Byrd,REP,550198,0,0,379,379,
Oklahoma,Attorney General,Mike Hunter,REP,550198,0,0,275,275,
Oklahoma,Attorney General,Mark Myles,DEM,550198,0,0,513,513,
Oklahoma,State Treasurer,Randy Mcdaniel,REP,550198,0,0,274,274,
Oklahoma,State Treasurer,Charles De Coune,IND,550198,0,0,405,405,
Oklahoma,Superintendent of Public Instruction,Joy Hofmeister,REP,550198,0,0,263,263,
Oklahoma,Superintendent of Public Instruction,John Cox,DEM,550198,0,0,448,448,
Oklahoma,Superintendent of Public Instruction,Larry Huff,IND,550198,0,0,69,69,
Oklahoma,Commissioner of Labor,Leslie Osborn,REP,550198,0,0,264,264,
Oklahoma,Commissioner of Labor,Fred Dorrell,DEM,550198,0,0,473,473,
Oklahoma,Commissioner of Labor,Brandt Dismukes,IND,550198,0,0,33,33,
Oklahoma,Insurance Commissioner,Glen Mulready,REP,550198,0,0,220,220,
Oklahoma,Insurance Commissioner,Kimberly Fobbs,DEM,550198,0,0,544,544,
Oklahoma,Corporation Commissioner,Bob Anthony,REP,550198,0,0,252,252,
Oklahoma,Corporation Commissioner,Ashley Nicole Mccray,DEM,550198,0,0,483,483,
Oklahoma,Corporation Commissioner,Jackie Short,IND,550198,0,0,47,47,
Oklahoma,U.S. House,Steve Russell,REP,550198,0,0,208,208,5
Oklahoma,U.S. House,Kendra Horn,DEM,550198,0,0,579,579,5
Oklahoma,State House,Stephen Paulsen,LIB,550198,0,0,28,28,85
Oklahoma,State House,Matt Jackson,REP,550198,0,0,165,165,85
Oklahoma,State House,Cyndi Munson,DEM,550198,0,0,593,593,85
Oklahoma,Governor,Chris Powell,LIB,550199,0,0,18,18,
Oklahoma,Governor,Kevin Stitt,REP,550199,0,0,214,214,
Oklahoma,Governor,Drew Edmondson,DEM,550199,0,0,530,530,
Oklahoma,Lieutenant Governor,Matt Pinnell,REP,550199,0,0,281,281,
Oklahoma,Lieutenant Governor,Anastasia Pittman,DEM,550199,0,0,436,436,
Oklahoma,Lieutenant Governor,Ivan Holmes,IND,550199,0,0,44,44,
Oklahoma,State Auditor,John Yeutter,LIB,550199,0,0,245,245,
Oklahoma,State Auditor,Cindy Byrd,REP,550199,0,0,430,430,
Oklahoma,Attorney General,Mike Hunter,REP,550199,0,0,333,333,
Oklahoma,Attorney General,Mark Myles,DEM,550199,0,0,416,416,
Oklahoma,State Treasurer,Randy Mcdaniel,REP,550199,0,0,359,359,
Oklahoma,State Treasurer,Charles De Coune,IND,550199,0,0,325,325,
Oklahoma,Superintendent of Public Instruction,Joy Hofmeister,REP,550199,0,0,340,340,
Oklahoma,Superintendent of Public Instruction,John Cox,DEM,550199,0,0,350,350,
Oklahoma,Superintendent of Public Instruction,Larry Huff,IND,550199,0,0,56,56,
Oklahoma,Commissioner of Labor,Leslie Osborn,REP,550199,0,0,336,336,
Oklahoma,Commissioner of Labor,Fred Dorrell,DEM,550199,0,0,368,368,
Oklahoma,Commissioner of Labor,Brandt Dismukes,IND,550199,0,0,35,35,
Oklahoma,Insurance Commissioner,Glen Mulready,REP,550199,0,0,282,282,
Oklahoma,Insurance Commissioner,Kimberly Fobbs,DEM,550199,0,0,449,449,
Oklahoma,Corporation Commissioner,Bob Anthony,REP,550199,0,0,321,321,
Oklahoma,Corporation Commissioner,Ashley Nicole Mccray,DEM,550199,0,0,378,378,
Oklahoma,Corporation Commissioner,Jackie Short,IND,550199,0,0,44,44,
Oklahoma,U.S. House,Steve Russell,REP,550199,0,0,256,256,5
Oklahoma,U.S. House,Kendra Horn,DEM,550199,0,0,499,499,5
Oklahoma,State House,Stephen Paulsen,LIB,550199,0,0,20,20,85
Oklahoma,State House,Matt Jackson,REP,550199,0,0,199,199,85
Oklahoma,State House,Cyndi Munson,DEM,550199,0,0,536,536,85
Oklahoma,Governor,Chris Powell,LIB,550200,0,0,45,45,
Oklahoma,Governor,Kevin Stitt,REP,550200,0,0,217,217,
Oklahoma,Governor,Drew Edmondson,DEM,550200,0,0,1064,1064,
Oklahoma,Lieutenant Governor,Matt Pinnell,REP,550200,0,0,281,281,
Oklahoma,Lieutenant Governor,Anastasia Pittman,DEM,550200,0,0,927,927,
Oklahoma,Lieutenant Governor,Ivan Holmes,IND,550200,0,0,98,98,
Oklahoma,State Auditor,John Yeutter,LIB,550200,0,0,553,553,
Oklahoma,State Auditor,Cindy Byrd,REP,550200,0,0,514,514,
Oklahoma,Attorney General,Mike Hunter,REP,550200,0,0,341,341,
Oklahoma,Attorney General,Mark Myles,DEM,550200,0,0,952,952,
Oklahoma,State Treasurer,Randy Mcdaniel,REP,550200,0,0,358,358,
Oklahoma,State Treasurer,Charles De Coune,IND,550200,0,0,725,725,
Oklahoma,Superintendent of Public Instruction,Joy Hofmeister,REP,550200,0,0,366,366,
Oklahoma,Superintendent of Public Instruction,John Cox,DEM,550200,0,0,826,826,
Oklahoma,Superintendent of Public Instruction,Larry Huff,IND,550200,0,0,93,93,
Oklahoma,Commissioner of Labor,Leslie Osborn,REP,550200,0,0,363,363,
Oklahoma,Commissioner of Labor,Fred Dorrell,DEM,550200,0,0,836,836,
Oklahoma,Commissioner of Labor,Brandt Dismukes,IND,550200,0,0,69,69,
Oklahoma,Insurance Commissioner,Glen Mulready,REP,550200,0,0,295,295,
Oklahoma,Insurance Commissioner,Kimberly Fobbs,DEM,550200,0,0,965,965,
Oklahoma,Corporation Commissioner,Bob Anthony,REP,550200,0,0,328,328,
Oklahoma,Corporation Commissioner,Ashley Nicole Mccray,DEM,550200,0,0,858,858,
Oklahoma,Corporation Commissioner,Jackie Short,IND,550200,0,0,88,88,
Oklahoma,U.S. House,Steve Russell,REP,550200,0,0,273,273,5
Oklahoma,U.S. House,Kendra Horn,DEM,550200,0,0,1036,1036,5
Oklahoma,Governor,Chris Powell,LIB,550201,0,0,19,19,
Oklahoma,Governor,Kevin Stitt,REP,550201,0,0,150,150,
Oklahoma,Governor,Drew Edmondson,DEM,550201,0,0,541,541,
Oklahoma,Lieutenant Governor,Matt Pinnell,REP,550201,0,0,180,180,
Oklahoma,Lieutenant Governor,Anastasia Pittman,DEM,550201,0,0,472,472,
Oklahoma,Lieutenant Governor,Ivan Holmes,IND,550201,0,0,52,52,
Oklahoma,State Auditor,John Yeutter,LIB,550201,0,0,329,329,
Oklahoma,State Auditor,Cindy Byrd,REP,550201,0,0,282,282,
Oklahoma,Attorney General,Mike Hunter,REP,550201,0,0,200,200,
Oklahoma,Attorney General,Mark Myles,DEM,550201,0,0,502,502,
Oklahoma,State Treasurer,Randy Mcdaniel,REP,550201,0,0,216,216,
Oklahoma,State Treasurer,Charles De Coune,IND,550201,0,0,401,401,
Oklahoma,Superintendent of Public Instruction,Joy Hofmeister,REP,550201,0,0,214,214,
Oklahoma,Superintendent of Public Instruction,John Cox,DEM,550201,0,0,429,429,
Oklahoma,Superintendent of Public Instruction,Larry Huff,IND,550201,0,0,55,55,
Oklahoma,Commissioner of Labor,Leslie Osborn,REP,550201,0,0,210,210,
Oklahoma,Commissioner of Labor,Fred Dorrell,DEM,550201,0,0,449,449,
Oklahoma,Commissioner of Labor,Brandt Dismukes,IND,550201,0,0,38,38,
Oklahoma,Insurance Commissioner,Glen Mulready,REP,550201,0,0,182,182,
Oklahoma,Insurance Commissioner,Kimberly Fobbs,DEM,550201,0,0,505,505,
Oklahoma,Corporation Commissioner,Bob Anthony,REP,550201,0,0,208,208,
Oklahoma,Corporation Commissioner,Ashley Nicole Mccray,DEM,550201,0,0,445,445,
Oklahoma,Corporation Commissioner,Jackie Short,IND,550201,0,0,43,43,
Oklahoma,U.S. House,Steve Russell,REP,550201,0,0,178,178,5
Oklahoma,U.S. House,Kendra Horn,DEM,550201,0,0,526,526,5
Oklahoma,State Senate,Joe Howell,REP,550201,0,0,149,149,40
Oklahoma,State Senate,Carri Hicks,DEM,550201,0,0,523,523,40
Oklahoma,State Senate,Christopher Hensley,IND,550201,0,0,27,27,40
Oklahoma,Governor,Chris Powell,LIB,550202,0,0,11,11,
Oklahoma,Governor,Kevin Stitt,REP,550202,0,0,129,129,
Oklahoma,Governor,Drew Edmondson,DEM,550202,0,0,462,462,
Oklahoma,Lieutenant Governor,Matt Pinnell,REP,550202,0,0,178,178,
Oklahoma,Lieutenant Governor,Anastasia Pittman,DEM,550202,0,0,381,381,
Oklahoma,Lieutenant Governor,Ivan Holmes,IND,550202,0,0,36,36,
Oklahoma,State Auditor,John Yeutter,LIB,550202,0,0,229,229,
Oklahoma,State Auditor,Cindy Byrd,REP,550202,0,0,264,264,
Oklahoma,Attorney General,Mike Hunter,REP,550202,0,0,181,181,
Oklahoma,Attorney General,Mark Myles,DEM,550202,0,0,410,410,
Oklahoma,State Treasurer,Randy Mcdaniel,REP,550202,0,0,202,202,
Oklahoma,State Treasurer,Charles De Coune,IND,550202,0,0,316,316,
Oklahoma,Superintendent of Public Instruction,Joy Hofmeister,REP,550202,0,0,200,200,
Oklahoma,Superintendent of Public Instruction,John Cox,DEM,550202,0,0,352,352,
Oklahoma,Superintendent of Public Instruction,Larry Huff,IND,550202,0,0,39,39,
Oklahoma,Commissioner of Labor,Leslie Osborn,REP,550202,0,0,182,182,
Oklahoma,Commissioner of Labor,Fred Dorrell,DEM,550202,0,0,363,363,
Oklahoma,Commissioner of Labor,Brandt Dismukes,IND,550202,0,0,35,35,
Oklahoma,Insurance Commissioner,Glen Mulready,REP,550202,0,0,171,171,
Oklahoma,Insurance Commissioner,Kimberly Fobbs,DEM,550202,0,0,408,408,
Oklahoma,Corporation Commissioner,Bob Anthony,REP,550202,0,0,177,177,
Oklahoma,Corporation Commissioner,Ashley Nicole Mccray,DEM,550202,0,0,372,372,
Oklahoma,Corporation Commissioner,Jackie Short,IND,550202,0,0,41,41,
Oklahoma,U.S. House,Steve Russell,REP,550202,0,0,162,162,5
Oklahoma,U.S. House,Kendra Horn,DEM,550202,0,0,435,435,5
Oklahoma,State Senate,Joe Howell,REP,550202,0,0,135,135,40
Oklahoma,State Senate,Carri Hicks,DEM,550202,0,0,445,445,40
Oklahoma,State Senate,Christopher Hensley,IND,550202,0,0,13,13,40
Oklahoma,Governor,Chris Powell,LIB,550203,0,0,28,28,
Oklahoma,Governor,Kevin Stitt,REP,550203,0,0,135,135,
Oklahoma,Governor,Drew Edmondson,DEM,550203,0,0,530,530,
Oklahoma,Lieutenant Governor,Matt Pinnell,REP,550203,0,0,185,185,
Oklahoma,Lieutenant Governor,Anastasia Pittman,DEM,550203,0,0,459,459,
Oklahoma,Lieutenant Governor,Ivan Holmes,IND,550203,0,0,44,44,
Oklahoma,State Auditor,John Yeutter,LIB,550203,0,0,304,304,
Oklahoma,State Auditor,Cindy Byrd,REP,550203,0,0,282,282,
Oklahoma,Attorney General,Mike Hunter,REP,550203,0,0,210,210,
Oklahoma,Attorney General,Mark Myles,DEM,550203,0,0,468,468,
Oklahoma,State Treasurer,Randy Mcdaniel,REP,550203,0,0,208,208,
Oklahoma,State Treasurer,Charles De Coune,IND,550203,0,0,390,390,
Oklahoma,Superintendent of Public Instruction,Joy Hofmeister,REP,550203,0,0,211,211,
Oklahoma,Superintendent of Public Instruction,John Cox,DEM,550203,0,0,422,422,
Oklahoma,Superintendent of Public Instruction,Larry Huff,IND,550203,0,0,52,52,
Oklahoma,Commissioner of Labor,Leslie Osborn,REP,550203,0,0,198,198,
Oklahoma,Commissioner of Labor,Fred Dorrell,DEM,550203,0,0,424,424,
Oklahoma,Commissioner of Labor,Brandt Dismukes,IND,550203,0,0,47,47,
Oklahoma,Insurance Commissioner,Glen Mulready,REP,550203,0,0,183,183,
Oklahoma,Insurance Commissioner,Kimberly Fobbs,DEM,550203,0,0,482,482,
Oklahoma,Corporation Commissioner,Bob Anthony,REP,550203,0,0,171,171,
Oklahoma,Corporation Commissioner,Ashley Nicole Mccray,DEM,550203,0,0,458,458,
Oklahoma,Corporation Commissioner,Jackie Short,IND,550203,0,0,46,46,
Oklahoma,U.S. House,Steve Russell,REP,550203,0,0,161,161,5
Oklahoma,U.S. House,Kendra Horn,DEM,550203,0,0,526,526,5
Oklahoma,Governor,Chris Powell,LIB,550204,0,0,33,33,
Oklahoma,Governor,Kevin Stitt,REP,550204,0,0,352,352,
Oklahoma,Governor,Drew Edmondson,DEM,550204,0,0,1120,1120,
Oklahoma,Lieutenant Governor,Matt Pinnell,REP,550204,0,0,470,470,
Oklahoma,Lieutenant Governor,Anastasia Pittman,DEM,550204,0,0,917,917,
Oklahoma,Lieutenant Governor,Ivan Holmes,IND,550204,0,0,91,91,
Oklahoma,State Auditor,John Yeutter,LIB,550204,0,0,522,522,
Oklahoma,State Auditor,Cindy Byrd,REP,550204,0,0,738,738,
Oklahoma,Attorney General,Mike Hunter,REP,550204,0,0,532,532,
Oklahoma,Attorney General,Mark Myles,DEM,550204,0,0,939,939,
Oklahoma,State Treasurer,Randy Mcdaniel,REP,550204,0,0,564,564,
Oklahoma,State Treasurer,Charles De Coune,IND,550204,0,0,757,757,
Oklahoma,Superintendent of Public Instruction,Joy Hofmeister,REP,550204,0,0,567,567,
Oklahoma,Superintendent of Public Instruction,John Cox,DEM,550204,0,0,791,791,
Oklahoma,Superintendent of Public Instruction,Larry Huff,IND,550204,0,0,110,110,
Oklahoma,Commissioner of Labor,Leslie Osborn,REP,550204,0,0,593,593,
Oklahoma,Commissioner of Labor,Fred Dorrell,DEM,550204,0,0,788,788,
Oklahoma,Commissioner of Labor,Brandt Dismukes,IND,550204,0,0,64,64,
Oklahoma,Insurance Commissioner,Glen Mulready,REP,550204,0,0,465,465,
Oklahoma,Insurance Commissioner,Kimberly Fobbs,DEM,550204,0,0,982,982,
Oklahoma,Corporation Commissioner,Bob Anthony,REP,550204,0,0,538,538,
Oklahoma,Corporation Commissioner,Ashley Nicole Mccray,DEM,550204,0,0,839,839,
Oklahoma,Corporation Commissioner,Jackie Short,IND,550204,0,0,80,80,
Oklahoma,U.S. House,Steve Russell,REP,550204,0,0,420,420,5
Oklahoma,U.S. House,Kendra Horn,DEM,550204,0,0,1072,1072,5
Oklahoma,Governor,Chris Powell,LIB,550205,0,0,18,18,
Oklahoma,Governor,Kevin Stitt,REP,550205,0,0,184,184,
Oklahoma,Governor,Drew Edmondson,DEM,550205,0,0,452,452,
Oklahoma,Lieutenant Governor,Matt Pinnell,REP,550205,0,0,237,237,
Oklahoma,Lieutenant Governor,Anastasia Pittman,DEM,550205,0,0,382,382,
Oklahoma,Lieutenant Governor,Ivan Holmes,IND,550205,0,0,32,32,
Oklahoma,State Auditor,John Yeutter,LIB,550205,0,0,235,235,
Oklahoma,State Auditor,Cindy Byrd,REP,550205,0,0,350,350,
Oklahoma,Attorney General,Mike Hunter,REP,550205,0,0,266,266,
Oklahoma,Attorney General,Mark Myles,DEM,550205,0,0,379,379,
Oklahoma,State Treasurer,Randy Mcdaniel,REP,550205,0,0,280,280,
Oklahoma,State Treasurer,Charles De Coune,IND,550205,0,0,311,311,
Oklahoma,Superintendent of Public Instruction,Joy Hofmeister,REP,550205,0,0,262,262,
Oklahoma,Superintendent of Public Instruction,John Cox,DEM,550205,0,0,347,347,
Oklahoma,Superintendent of Public Instruction,Larry Huff,IND,550205,0,0,37,37,
Oklahoma,Commissioner of Labor,Leslie Osborn,REP,550205,0,0,266,266,
Oklahoma,Commissioner of Labor,Fred Dorrell,DEM,550205,0,0,338,338,
Oklahoma,Commissioner of Labor,Brandt Dismukes,IND,550205,0,0,37,37,
Oklahoma,Insurance Commissioner,Glen Mulready,REP,550205,0,0,239,239,
Oklahoma,Insurance Commissioner,Kimberly Fobbs,DEM,550205,0,0,399,399,
Oklahoma,Corporation Commissioner,Bob Anthony,REP,550205,0,0,251,251,
Oklahoma,Corporation Commissioner,Ashley Nicole Mccray,DEM,550205,0,0,351,351,
Oklahoma,Corporation Commissioner,Jackie Short,IND,550205,0,0,41,41,
Oklahoma,U.S. House,Steve Russell,REP,550205,0,0,221,221,5
Oklahoma,U.S. House,Kendra Horn,DEM,550205,0,0,428,428,5
Oklahoma,Governor,Chris Powell,LIB,550206,0,0,10,10,
Oklahoma,Governor,Kevin Stitt,REP,550206,0,0,56,56,
Oklahoma,Governor,Drew Edmondson,DEM,550206,0,0,138,138,
Oklahoma,Lieutenant Governor,Matt Pinnell,REP,550206,0,0,58,58,
Oklahoma,Lieutenant Governor,Anastasia Pittman,DEM,550206,0,0,132,132,
Oklahoma,Lieutenant Governor,Ivan Holmes,IND,550206,0,0,13,13,
Oklahoma,State Auditor,John Yeutter,LIB,550206,0,0,91,91,
Oklahoma,State Auditor,Cindy Byrd,REP,550206,0,0,75,75,
Oklahoma,Attorney General,Mike Hunter,REP,550206,0,0,66,66,
Oklahoma,Attorney General,Mark Myles,DEM,550206,0,0,135,135,
Oklahoma,State Treasurer,Randy Mcdaniel,REP,550206,0,0,80,80,
Oklahoma,State Treasurer,Charles De Coune,IND,550206,0,0,86,86,
Oklahoma,Superintendent of Public Instruction,Joy Hofmeister,REP,550206,0,0,63,63,
Oklahoma,Superintendent of Public Instruction,John Cox,DEM,550206,0,0,119,119,
Oklahoma,Superintendent of Public Instruction,Larry Huff,IND,550206,0,0,20,20,
Oklahoma,Commissioner of Labor,Leslie Osborn,REP,550206,0,0,66,66,
Oklahoma,Commissioner of Labor,Fred Dorrell,DEM,550206,0,0,123,123,
Oklahoma,Commissioner of Labor,Brandt Dismukes,IND,550206,0,0,14,14,
Oklahoma,Insurance Commissioner,Glen Mulready,REP,550206,0,0,65,65,
Oklahoma,Insurance Commissioner,Kimberly Fobbs,DEM,550206,0,0,137,137,
Oklahoma,Corporation Commissioner,Bob Anthony,REP,550206,0,0,62,62,
Oklahoma,Corporation Commissioner,Ashley Nicole Mccray,DEM,550206,0,0,121,121,
Oklahoma,Corporation Commissioner,Jackie Short,IND,550206,0,0,19,19,
Oklahoma,U.S. House,Steve Russell,REP,550206,0,0,57,57,5
Oklahoma,U.S. House,Kendra Horn,DEM,550206,0,0,145,145,5
Oklahoma,Governor,Chris Powell,LIB,550207,0,0,28,28,
Oklahoma,Governor,Kevin Stitt,REP,550207,0,0,191,191,
Oklahoma,Governor,Drew Edmondson,DEM,550207,0,0,394,394,
Oklahoma,Lieutenant Governor,Matt Pinnell,REP,550207,0,0,204,204,
Oklahoma,Lieutenant Governor,Anastasia Pittman,DEM,550207,0,0,373,373,
Oklahoma,Lieutenant Governor,Ivan Holmes,IND,550207,0,0,33,33,
Oklahoma,State Auditor,John Yeutter,LIB,550207,0,0,280,280,
Oklahoma,State Auditor,Cindy Byrd,REP,550207,0,0,262,262,
Oklahoma,Attorney General,Mike Hunter,REP,550207,0,0,229,229,
Oklahoma,Attorney General,Mark Myles,DEM,550207,0,0,379,379,
Oklahoma,State Treasurer,Randy Mcdaniel,REP,550207,0,0,244,244,
Oklahoma,State Treasurer,Charles De Coune,IND,550207,0,0,295,295,
Oklahoma,Superintendent of Public Instruction,Joy Hofmeister,REP,550207,0,0,215,215,
Oklahoma,Superintendent of Public Instruction,John Cox,DEM,550207,0,0,342,342,
Oklahoma,Superintendent of Public Instruction,Larry Huff,IND,550207,0,0,52,52,
Oklahoma,Commissioner of Labor,Leslie Osborn,REP,550207,0,0,207,207,
Oklahoma,Commissioner of Labor,Fred Dorrell,DEM,550207,0,0,358,358,
Oklahoma,Commissioner of Labor,Brandt Dismukes,IND,550207,0,0,39,39,
Oklahoma,Insurance Commissioner,Glen Mulready,REP,550207,0,0,205,205,
Oklahoma,Insurance Commissioner,Kimberly Fobbs,DEM,550207,0,0,398,398,
Oklahoma,Corporation Commissioner,Bob Anthony,REP,550207,0,0,200,200,
Oklahoma,Corporation Commissioner,Ashley Nicole Mccray,DEM,550207,0,0,358,358,
Oklahoma,Corporation Commissioner,Jackie Short,IND,550207,0,0,47,47,
Oklahoma,U.S. House,Steve Russell,REP,550207,0,0,205,205,5
Oklahoma,U.S. House,Kendra Horn,DEM,550207,0,0,402,402,5
Oklahoma,Governor,Chris Powell,LIB,550208,0,0,0,0,
Oklahoma,Governor,Kevin Stitt,REP,550208,0,0,9,9,
Oklahoma,Governor,Drew Edmondson,DEM,550208,0,0,5,5,
Oklahoma,Lieutenant Governor,Matt Pinnell,REP,550208,0,0,9,9,
Oklahoma,Lieutenant Governor,Anastasia Pittman,DEM,550208,0,0,4,4,
Oklahoma,Lieutenant Governor,Ivan Holmes,IND,550208,0,0,1,1,
Oklahoma,State Auditor,John Yeutter,LIB,550208,0,0,4,4,
Oklahoma,State Auditor,Cindy Byrd,REP,550208,0,0,8,8,
Oklahoma,Attorney General,Mike Hunter,REP,550208,0,0,8,8,
Oklahoma,Attorney General,Mark Myles,DEM,550208,0,0,5,5,
Oklahoma,State Treasurer,Randy Mcdaniel,REP,550208,0,0,9,9,
Oklahoma,State Treasurer,Charles De Coune,IND,550208,0,0,4,4,
Oklahoma,Superintendent of Public Instruction,Joy Hofmeister,REP,550208,0,0,6,6,
Oklahoma,Superintendent of Public Instruction,John Cox,DEM,550208,0,0,6,6,
Oklahoma,Superintendent of Public Instruction,Larry Huff,IND,550208,0,0,1,1,
Oklahoma,Commissioner of Labor,Leslie Osborn,REP,550208,0,0,7,7,
Oklahoma,Commissioner of Labor,Fred Dorrell,DEM,550208,0,0,6,6,
Oklahoma,Commissioner of Labor,Brandt Dismukes,IND,550208,0,0,1,1,
Oklahoma,Insurance Commissioner,Glen Mulready,REP,550208,0,0,8,8,
Oklahoma,Insurance Commissioner,Kimberly Fobbs,DEM,550208,0,0,6,6,
Oklahoma,Corporation Commissioner,Bob Anthony,REP,550208,0,0,8,8,
Oklahoma,Corporation Commissioner,Ashley Nicole Mccray,DEM,550208,0,0,5,5,
Oklahoma,Corporation Commissioner,Jackie Short,IND,550208,0,0,1,1,
Oklahoma,U.S. House,Steve Russell,REP,550208,0,0,10,10,5
Oklahoma,U.S. House,Kendra Horn,DEM,550208,0,0,4,4,5
Oklahoma,Governor,Chris Powell,LIB,550209,0,0,36,36,
Oklahoma,Governor,Kevin Stitt,REP,550209,0,0,160,160,
Oklahoma,Governor,Drew Edmondson,DEM,550209,0,0,357,357,
Oklahoma,Lieutenant Governor,Matt Pinnell,REP,550209,0,0,175,175,
Oklahoma,Lieutenant Governor,Anastasia Pittman,DEM,550209,0,0,350,350,
Oklahoma,Lieutenant Governor,Ivan Holmes,IND,550209,0,0,26,26,
Oklahoma,State Auditor,John Yeutter,LIB,550209,0,0,251,251,
Oklahoma,State Auditor,Cindy Byrd,REP,550209,0,0,245,245,
Oklahoma,Attorney General,Mike Hunter,REP,550209,0,0,185,185,
Oklahoma,Attorney General,Mark Myles,DEM,550209,0,0,364,364,
Oklahoma,State Treasurer,Randy Mcdaniel,REP,550209,0,0,213,213,
Oklahoma,State Treasurer,Charles De Coune,IND,550209,0,0,279,279,
Oklahoma,Superintendent of Public Instruction,Joy Hofmeister,REP,550209,0,0,186,186,
Oklahoma,Superintendent of Public Instruction,John Cox,DEM,550209,0,0,322,322,
Oklahoma,Superintendent of Public Instruction,Larry Huff,IND,550209,0,0,45,45,
Oklahoma,Commissioner of Labor,Leslie Osborn,REP,550209,0,0,189,189,
Oklahoma,Commissioner of Labor,Fred Dorrell,DEM,550209,0,0,325,325,
Oklahoma,Commissioner of Labor,Brandt Dismukes,IND,550209,0,0,35,35,
Oklahoma,Insurance Commissioner,Glen Mulready,REP,550209,0,0,172,172,
Oklahoma,Insurance Commissioner,Kimberly Fobbs,DEM,550209,0,0,375,375,
Oklahoma,Corporation Commissioner,Bob Anthony,REP,550209,0,0,169,169,
Oklahoma,Corporation Commissioner,Ashley Nicole Mccray,DEM,550209,0,0,341,341,
Oklahoma,Corporation Commissioner,Jackie Short,IND,550209,0,0,40,40,
Oklahoma,U.S. House,Steve Russell,REP,550209,0,0,175,175,5
Oklahoma,U.S. House,Kendra Horn,DEM,550209,0,0,378,378,5
Oklahoma,Governor,Chris Powell,LIB,550210,0,0,21,21,
Oklahoma,Governor,Kevin Stitt,REP,550210,0,0,173,173,
Oklahoma,Governor,Drew Edmondson,DEM,550210,0,0,277,277,
Oklahoma,Lieutenant Governor,Matt Pinnell,REP,550210,0,0,186,186,
Oklahoma,Lieutenant Governor,Anastasia Pittman,DEM,550210,0,0,256,256,
Oklahoma,Lieutenant Governor,Ivan Holmes,IND,550210,0,0,25,25,
Oklahoma,State Auditor,John Yeutter,LIB,550210,0,0,197,197,
Oklahoma,State Auditor,Cindy Byrd,REP,550210,0,0,224,224,
Oklahoma,Attorney General,Mike Hunter,REP,550210,0,0,205,205,
Oklahoma,Attorney General,Mark Myles,DEM,550210,0,0,262,262,
Oklahoma,State Treasurer,Randy Mcdaniel,REP,550210,0,0,218,218,
Oklahoma,State Treasurer,Charles De Coune,IND,550210,0,0,206,206,
Oklahoma,Superintendent of Public Instruction,Joy Hofmeister,REP,550210,0,0,185,185,
Oklahoma,Superintendent of Public Instruction,John Cox,DEM,550210,0,0,235,235,
Oklahoma,Superintendent of Public Instruction,Larry Huff,IND,550210,0,0,48,48,
Oklahoma,Commissioner of Labor,Leslie Osborn,REP,550210,0,0,178,178,
Oklahoma,Commissioner of Labor,Fred Dorrell,DEM,550210,0,0,247,247,
Oklahoma,Commissioner of Labor,Brandt Dismukes,IND,550210,0,0,35,35,
Oklahoma,Insurance Commissioner,Glen Mulready,REP,550210,0,0,186,186,
Oklahoma,Insurance Commissioner,Kimberly Fobbs,DEM,550210,0,0,279,279,
Oklahoma,Corporation Commissioner,Bob Anthony,REP,550210,0,0,173,173,
Oklahoma,Corporation Commissioner,Ashley Nicole Mccray,DEM,550210,0,0,247,247,
Oklahoma,Corporation Commissioner,Jackie Short,IND,550210,0,0,48,48,
Oklahoma,U.S. House,Steve Russell,REP,550210,0,0,182,182,5
Oklahoma,U.S. House,Kendra Horn,DEM,550210,0,0,287,287,5
Oklahoma,Governor,Chris Powell,LIB,550211,0,0,16,16,
Oklahoma,Governor,Kevin Stitt,REP,550211,0,0,128,128,
Oklahoma,Governor,Drew Edmondson,DEM,550211,0,0,260,260,
Oklahoma,Lieutenant Governor,Matt Pinnell,REP,550211,0,0,141,141,
Oklahoma,Lieutenant Governor,Anastasia Pittman,DEM,550211,0,0,246,246,
Oklahoma,Lieutenant Governor,Ivan Holmes,IND,550211,0,0,17,17,
Oklahoma,State Auditor,John Yeutter,LIB,550211,0,0,166,166,
Oklahoma,State Auditor,Cindy Byrd,REP,550211,0,0,187,187,
Oklahoma,Attorney General,Mike Hunter,REP,550211,0,0,151,151,
Oklahoma,Attorney General,Mark Myles,DEM,550211,0,0,250,250,
Oklahoma,State Treasurer,Randy Mcdaniel,REP,550211,0,0,181,181,
Oklahoma,State Treasurer,Charles De Coune,IND,550211,0,0,174,174,
Oklahoma,Superintendent of Public Instruction,Joy Hofmeister,REP,550211,0,0,143,143,
Oklahoma,Superintendent of Public Instruction,John Cox,DEM,550211,0,0,222,222,
Oklahoma,Superintendent of Public Instruction,Larry Huff,IND,550211,0,0,38,38,
Oklahoma,Commissioner of Labor,Leslie Osborn,REP,550211,0,0,142,142,
Oklahoma,Commissioner of Labor,Fred Dorrell,DEM,550211,0,0,227,227,
Oklahoma,Commissioner of Labor,Brandt Dismukes,IND,550211,0,0,33,33,
Oklahoma,Insurance Commissioner,Glen Mulready,REP,550211,0,0,144,144,
Oklahoma,Insurance Commissioner,Kimberly Fobbs,DEM,550211,0,0,256,256,
Oklahoma,Corporation Commissioner,Bob Anthony,REP,550211,0,0,142,142,
Oklahoma,Corporation Commissioner,Ashley Nicole Mccray,DEM,550211,0,0,232,232,
Oklahoma,Corporation Commissioner,Jackie Short,IND,550211,0,0,30,30,
Oklahoma,U.S. House,Steve Russell,REP,550211,0,0,141,141,5
Oklahoma,U.S. House,Kendra Horn,DEM,550211,0,0,263,263,5
Oklahoma,Governor,Chris Powell,LIB,550212,0,0,13,13,
Oklahoma,Governor,Kevin Stitt,REP,550212,0,0,128,128,
Oklahoma,Governor,Drew Edmondson,DEM,550212,0,0,218,218,
Oklahoma,Lieutenant Governor,Matt Pinnell,REP,550212,0,0,144,144,
Oklahoma,Lieutenant Governor,Anastasia Pittman,DEM,550212,0,0,198,198,
Oklahoma,Lieutenant Governor,Ivan Holmes,IND,550212,0,0,14,14,
Oklahoma,State Auditor,John Yeutter,LIB,550212,0,0,122,122,
Oklahoma,State Auditor,Cindy Byrd,REP,550212,0,0,178,178,
Oklahoma,Attorney General,Mike Hunter,REP,550212,0,0,159,159,
Oklahoma,Attorney General,Mark Myles,DEM,550212,0,0,198,198,
Oklahoma,State Treasurer,Randy Mcdaniel,REP,550212,0,0,169,169,
Oklahoma,State Treasurer,Charles De Coune,IND,550212,0,0,135,135,
Oklahoma,Superintendent of Public Instruction,Joy Hofmeister,REP,550212,0,0,143,143,
Oklahoma,Superintendent of Public Instruction,John Cox,DEM,550212,0,0,185,185,
Oklahoma,Superintendent of Public Instruction,Larry Huff,IND,550212,0,0,29,29,
Oklahoma,Commissioner of Labor,Leslie Osborn,REP,550212,0,0,144,144,
Oklahoma,Commissioner of Labor,Fred Dorrell,DEM,550212,0,0,194,194,
Oklahoma,Commissioner of Labor,Brandt Dismukes,IND,550212,0,0,19,19,
Oklahoma,Insurance Commissioner,Glen Mulready,REP,550212,0,0,143,143,
Oklahoma,Insurance Commissioner,Kimberly Fobbs,DEM,550212,0,0,213,213,
Oklahoma,Corporation Commissioner,Bob Anthony,REP,550212,0,0,146,146,
Oklahoma,Corporation Commissioner,Ashley Nicole Mccray,DEM,550212,0,0,190,190,
Oklahoma,Corporation Commissioner,Jackie Short,IND,550212,0,0,21,21,
Oklahoma,U.S. House,Steve Russell,REP,550212,0,0,137,137,5
Oklahoma,U.S. House,Kendra Horn,DEM,550212,0,0,220,220,5
Oklahoma,Governor,Chris Powell,LIB,550213,0,0,21,21,
Oklahoma,Governor,Kevin Stitt,REP,550213,0,0,64,64,
Oklahoma,Governor,Drew Edmondson,DEM,550213,0,0,155,155,
Oklahoma,Lieutenant Governor,Matt Pinnell,REP,550213,0,0,69,69,
Oklahoma,Lieutenant Governor,Anastasia Pittman,DEM,550213,0,0,157,157,
Oklahoma,Lieutenant Governor,Ivan Holmes,IND,550213,0,0,14,14,
Oklahoma,State Auditor,John Yeutter,LIB,550213,0,0,134,134,
Oklahoma,State Auditor,Cindy Byrd,REP,550213,0,0,89,89,
Oklahoma,Attorney General,Mike Hunter,REP,550213,0,0,80,80,
Oklahoma,Attorney General,Mark Myles,DEM,550213,0,0,160,160,
Oklahoma,State Treasurer,Randy Mcdaniel,REP,550213,0,0,82,82,
Oklahoma,State Treasurer,Charles De Coune,IND,550213,0,0,140,140,
Oklahoma,Superintendent of Public Instruction,Joy Hofmeister,REP,550213,0,0,73,73,
Oklahoma,Superintendent of Public Instruction,John Cox,DEM,550213,0,0,128,128,
Oklahoma,Superintendent of Public Instruction,Larry Huff,IND,550213,0,0,37,37,
Oklahoma,Commissioner of Labor,Leslie Osborn,REP,550213,0,0,72,72,
Oklahoma,Commissioner of Labor,Fred Dorrell,DEM,550213,0,0,145,145,
Oklahoma,Commissioner of Labor,Brandt Dismukes,IND,550213,0,0,19,19,
Oklahoma,Insurance Commissioner,Glen Mulready,REP,550213,0,0,74,74,
Oklahoma,Insurance Commissioner,Kimberly Fobbs,DEM,550213,0,0,163,163,
Oklahoma,Corporation Commissioner,Bob Anthony,REP,550213,0,0,70,70,
Oklahoma,Corporation Commissioner,Ashley Nicole Mccray,DEM,550213,0,0,145,145,
Oklahoma,Corporation Commissioner,Jackie Short,IND,550213,0,0,23,23,
Oklahoma,U.S. House,Steve Russell,REP,550213,0,0,70,70,5
Oklahoma,U.S. House,Kendra Horn,DEM,550213,0,0,168,168,5
Oklahoma,Governor,Chris Powell,LIB,550214,0,0,18,18,
Oklahoma,Governor,Kevin Stitt,REP,550214,0,0,127,127,
Oklahoma,Governor,Drew Edmondson,DEM,550214,0,0,168,168,
Oklahoma,Lieutenant Governor,Matt Pinnell,REP,550214,0,0,144,144,
Oklahoma,Lieutenant Governor,Anastasia Pittman,DEM,550214,0,0,144,144,
Oklahoma,Lieutenant Governor,Ivan Holmes,IND,550214,0,0,23,23,
Oklahoma,State Auditor,John Yeutter,LIB,550214,0,0,104,104,
Oklahoma,State Auditor,Cindy Byrd,REP,550214,0,0,173,173,
Oklahoma,Attorney General,Mike Hunter,REP,550214,0,0,149,149,
Oklahoma,Attorney General,Mark Myles,DEM,550214,0,0,160,160,
Oklahoma,State Treasurer,Randy Mcdaniel,REP,550214,0,0,157,157,
Oklahoma,State Treasurer,Charles De Coune,IND,550214,0,0,121,121,
Oklahoma,Superintendent of Public Instruction,Joy Hofmeister,REP,550214,0,0,131,131,
Oklahoma,Superintendent of Public Instruction,John Cox,DEM,550214,0,0,148,148,
Oklahoma,Superintendent of Public Instruction,Larry Huff,IND,550214,0,0,34,34,
Oklahoma,Commissioner of Labor,Leslie Osborn,REP,550214,0,0,143,143,
Oklahoma,Commissioner of Labor,Fred Dorrell,DEM,550214,0,0,146,146,
Oklahoma,Commissioner of Labor,Brandt Dismukes,IND,550214,0,0,20,20,
Oklahoma,Insurance Commissioner,Glen Mulready,REP,550214,0,0,142,142,
Oklahoma,Insurance Commissioner,Kimberly Fobbs,DEM,550214,0,0,170,170,
Oklahoma,Corporation Commissioner,Bob Anthony,REP,550214,0,0,138,138,
Oklahoma,Corporation Commissioner,Ashley Nicole Mccray,DEM,550214,0,0,150,150,
Oklahoma,Corporation Commissioner,Jackie Short,IND,550214,0,0,24,24,
Oklahoma,U.S. House,Steve Russell,REP,550214,0,0,139,139,5
Oklahoma,U.S. House,Kendra Horn,DEM,550214,0,0,174,174,5
Oklahoma,Governor,Chris Powell,LIB,550215,0,0,24,24,
Oklahoma,Governor,Kevin Stitt,REP,550215,0,0,155,155,
Oklahoma,Governor,Drew Edmondson,DEM,550215,0,0,250,250,
Oklahoma,Lieutenant Governor,Matt Pinnell,REP,550215,0,0,163,163,
Oklahoma,Lieutenant Governor,Anastasia Pittman,DEM,550215,0,0,232,232,
Oklahoma,Lieutenant Governor,Ivan Holmes,IND,550215,0,0,34,34,
Oklahoma,State Auditor,John Yeutter,LIB,550215,0,0,186,186,
Oklahoma,State Auditor,Cindy Byrd,REP,550215,0,0,204,204,
Oklahoma,Attorney General,Mike Hunter,REP,550215,0,0,181,181,
Oklahoma,Attorney General,Mark Myles,DEM,550215,0,0,245,245,
Oklahoma,State Treasurer,Randy Mcdaniel,REP,550215,0,0,199,199,
Oklahoma,State Treasurer,Charles De Coune,IND,550215,0,0,191,191,
Oklahoma,Superintendent of Public Instruction,Joy Hofmeister,REP,550215,0,0,172,172,
Oklahoma,Superintendent of Public Instruction,John Cox,DEM,550215,0,0,218,218,
Oklahoma,Superintendent of Public Instruction,Larry Huff,IND,550215,0,0,38,38,
Oklahoma,Commissioner of Labor,Leslie Osborn,REP,550215,0,0,175,175,
Oklahoma,Commissioner of Labor,Fred Dorrell,DEM,550215,0,0,223,223,
Oklahoma,Commissioner of Labor,Brandt Dismukes,IND,550215,0,0,27,27,
Oklahoma,Insurance Commissioner,Glen Mulready,REP,550215,0,0,173,173,
Oklahoma,Insurance Commissioner,Kimberly Fobbs,DEM,550215,0,0,250,250,
Oklahoma,Corporation Commissioner,Bob Anthony,REP,550215,0,0,166,166,
Oklahoma,Corporation Commissioner,Ashley Nicole Mccray,DEM,550215,0,0,228,228,
Oklahoma,Corporation Commissioner,Jackie Short,IND,550215,0,0,31,31,
Oklahoma,U.S. House,Steve Russell,REP,550215,0,0,164,164,5
Oklahoma,U.S. House,Kendra Horn,DEM,550215,0,0,263,263,5
Oklahoma,Governor,Chris Powell,LIB,550216,0,0,1,1,
Oklahoma,Governor,Kevin Stitt,REP,550216,0,0,2,2,
Oklahoma,Governor,Drew Edmondson,DEM,550216,0,0,20,20,
Oklahoma,Lieutenant Governor,Matt Pinnell,REP,550216,0,0,2,2,
Oklahoma,Lieutenant Governor,Anastasia Pittman,DEM,550216,0,0,19,19,
Oklahoma,Lieutenant Governor,Ivan Holmes,IND,550216,0,0,2,2,
Oklahoma,State Auditor,John Yeutter,LIB,550216,0,0,15,15,
Oklahoma,State Auditor,Cindy Byrd,REP,550216,0,0,4,4,
Oklahoma,Attorney General,Mike Hunter,REP,550216,0,0,2,2,
Oklahoma,Attorney General,Mark Myles,DEM,550216,0,0,21,21,
Oklahoma,State Treasurer,Randy Mcdaniel,REP,550216,0,0,5,5,
Oklahoma,State Treasurer,Charles De Coune,IND,550216,0,0,14,14,
Oklahoma,Superintendent of Public Instruction,Joy Hofmeister,REP,550216,0,0,2,2,
Oklahoma,Superintendent of Public Instruction,John Cox,DEM,550216,0,0,21,21,
Oklahoma,Superintendent of Public Instruction,Larry Huff,IND,550216,0,0,0,0,
Oklahoma,Commissioner of Labor,Leslie Osborn,REP,550216,0,0,3,3,
Oklahoma,Commissioner of Labor,Fred Dorrell,DEM,550216,0,0,18,18,
Oklahoma,Commissioner of Labor,Brandt Dismukes,IND,550216,0,0,2,2,
Oklahoma,Insurance Commissioner,Glen Mulready,REP,550216,0,0,1,1,
Oklahoma,Insurance Commissioner,Kimberly Fobbs,DEM,550216,0,0,22,22,
Oklahoma,Corporation Commissioner,Bob Anthony,REP,550216,0,0,2,2,
Oklahoma,Corporation Commissioner,Ashley Nicole Mccray,DEM,550216,0,0,20,20,
Oklahoma,Corporation Commissioner,Jackie Short,IND,550216,0,0,1,1,
Oklahoma,U.S. House,Steve Russell,REP,550216,0,0,2,2,5
Oklahoma,U.S. House,Kendra Horn,DEM,550216,0,0,21,21,5
Oklahoma,Governor,Chris Powell,LIB,550217,0,0,33,33,
Oklahoma,Governor,Kevin Stitt,REP,550217,0,0,192,192,
Oklahoma,Governor,Drew Edmondson,DEM,550217,0,0,308,308,
Oklahoma,Lieutenant Governor,Matt Pinnell,REP,550217,0,0,226,226,
Oklahoma,Lieutenant Governor,Anastasia Pittman,DEM,550217,0,0,269,269,
Oklahoma,Lieutenant Governor,Ivan Holmes,IND,550217,0,0,32,32,
Oklahoma,State Auditor,John Yeutter,LIB,550217,0,0,208,208,
Oklahoma,State Auditor,Cindy Byrd,REP,550217,0,0,271,271,
Oklahoma,Attorney General,Mike Hunter,REP,550217,0,0,234,234,
Oklahoma,Attorney General,Mark Myles,DEM,550217,0,0,293,293,
Oklahoma,State Treasurer,Randy Mcdaniel,REP,550217,0,0,244,244,
Oklahoma,State Treasurer,Charles De Coune,IND,550217,0,0,240,240,
Oklahoma,Superintendent of Public Instruction,Joy Hofmeister,REP,550217,0,0,212,212,
Oklahoma,Superintendent of Public Instruction,John Cox,DEM,550217,0,0,249,249,
Oklahoma,Superintendent of Public Instruction,Larry Huff,IND,550217,0,0,64,64,
Oklahoma,Commissioner of Labor,Leslie Osborn,REP,550217,0,0,226,226,
Oklahoma,Commissioner of Labor,Fred Dorrell,DEM,550217,0,0,258,258,
Oklahoma,Commissioner of Labor,Brandt Dismukes,IND,550217,0,0,39,39,
Oklahoma,Insurance Commissioner,Glen Mulready,REP,550217,0,0,222,222,
Oklahoma,Insurance Commissioner,Kimberly Fobbs,DEM,550217,0,0,299,299,
Oklahoma,Corporation Commissioner,Bob Anthony,REP,550217,0,0,218,218,
Oklahoma,Corporation Commissioner,Ashley Nicole Mccray,DEM,550217,0,0,259,259,
Oklahoma,Corporation Commissioner,Jackie Short,IND,550217,0,0,51,51,
Oklahoma,U.S. House,Steve Russell,REP,550217,0,0,218,218,5
Oklahoma,U.S. House,Kendra Horn,DEM,550217,0,0,313,313,5
Oklahoma,Governor,Chris Powell,LIB,550218,0,0,26,26,
Oklahoma,Governor,Kevin Stitt,REP,550218,0,0,338,338,
Oklahoma,Governor,Drew Edmondson,DEM,550218,0,0,341,341,
Oklahoma,Lieutenant Governor,Matt Pinnell,REP,550218,0,0,359,359,
Oklahoma,Lieutenant Governor,Anastasia Pittman,DEM,550218,0,0,311,311,
Oklahoma,Lieutenant Governor,Ivan Holmes,IND,550218,0,0,31,31,
Oklahoma,State Auditor,John Yeutter,LIB,550218,0,0,215,215,
Oklahoma,State Auditor,Cindy Byrd,REP,550218,0,0,423,423,
Oklahoma,Attorney General,Mike Hunter,REP,550218,0,0,371,371,
Oklahoma,Attorney General,Mark Myles,DEM,550218,0,0,325,325,
Oklahoma,State Treasurer,Randy Mcdaniel,REP,550218,0,0,395,395,
Oklahoma,State Treasurer,Charles De Coune,IND,550218,0,0,244,244,
Oklahoma,Superintendent of Public Instruction,Joy Hofmeister,REP,550218,0,0,341,341,
Oklahoma,Superintendent of Public Instruction,John Cox,DEM,550218,0,0,278,278,
Oklahoma,Superintendent of Public Instruction,Larry Huff,IND,550218,0,0,79,79,
Oklahoma,Commissioner of Labor,Leslie Osborn,REP,550218,0,0,358,358,
Oklahoma,Commissioner of Labor,Fred Dorrell,DEM,550218,0,0,296,296,
Oklahoma,Commissioner of Labor,Brandt Dismukes,IND,550218,0,0,36,36,
Oklahoma,Insurance Commissioner,Glen Mulready,REP,550218,0,0,368,368,
Oklahoma,Insurance Commissioner,Kimberly Fobbs,DEM,550218,0,0,328,328,
Oklahoma,Corporation Commissioner,Bob Anthony,REP,550218,0,0,356,356,
Oklahoma,Corporation Commissioner,Ashley Nicole Mccray,DEM,550218,0,0,292,292,
Oklahoma,Corporation Commissioner,Jackie Short,IND,550218,0,0,49,49,
Oklahoma,U.S. House,Steve Russell,REP,550218,0,0,352,352,5
Oklahoma,U.S. House,Kendra Horn,DEM,550218,0,0,351,351,5
Oklahoma,Governor,Chris Powell,LIB,550219,0,0,19,19,
Oklahoma,Governor,Kevin Stitt,REP,550219,0,0,151,151,
Oklahoma,Governor,Drew Edmondson,DEM,550219,0,0,237,237,
Oklahoma,Lieutenant Governor,Matt Pinnell,REP,550219,0,0,169,169,
Oklahoma,Lieutenant Governor,Anastasia Pittman,DEM,550219,0,0,224,224,
Oklahoma,Lieutenant Governor,Ivan Holmes,IND,550219,0,0,15,15,
Oklahoma,State Auditor,John Yeutter,LIB,550219,0,0,168,168,
Oklahoma,State Auditor,Cindy Byrd,REP,550219,0,0,207,207,
Oklahoma,Attorney General,Mike Hunter,REP,550219,0,0,180,180,
Oklahoma,Attorney General,Mark Myles,DEM,550219,0,0,228,228,
Oklahoma,State Treasurer,Randy Mcdaniel,REP,550219,0,0,183,183,
Oklahoma,State Treasurer,Charles De Coune,IND,550219,0,0,196,196,
Oklahoma,Superintendent of Public Instruction,Joy Hofmeister,REP,550219,0,0,152,152,
Oklahoma,Superintendent of Public Instruction,John Cox,DEM,550219,0,0,195,195,
Oklahoma,Superintendent of Public Instruction,Larry Huff,IND,550219,0,0,59,59,
Oklahoma,Commissioner of Labor,Leslie Osborn,REP,550219,0,0,168,168,
Oklahoma,Commissioner of Labor,Fred Dorrell,DEM,550219,0,0,215,215,
Oklahoma,Commissioner of Labor,Brandt Dismukes,IND,550219,0,0,24,24,
Oklahoma,Insurance Commissioner,Glen Mulready,REP,550219,0,0,174,174,
Oklahoma,Insurance Commissioner,Kimberly Fobbs,DEM,550219,0,0,232,232,
Oklahoma,Corporation Commissioner,Bob Anthony,REP,550219,0,0,170,170,
Oklahoma,Corporation Commissioner,Ashley Nicole Mccray,DEM,550219,0,0,207,207,
Oklahoma,Corporation Commissioner,Jackie Short,IND,550219,0,0,30,30,
Oklahoma,U.S. House,Steve Russell,REP,550219,0,0,167,167,5
Oklahoma,U.S. House,Kendra Horn,DEM,550219,0,0,241,241,5
Oklahoma,Governor,Chris Powell,LIB,550220,0,0,39,39,
Oklahoma,Governor,Kevin Stitt,REP,550220,0,0,294,294,
Oklahoma,Governor,Drew Edmondson,DEM,550220,0,0,416,416,
Oklahoma,Lieutenant Governor,Matt Pinnell,REP,550220,0,0,307,307,
Oklahoma,Lieutenant Governor,Anastasia Pittman,DEM,550220,0,0,403,403,
Oklahoma,Lieutenant Governor,Ivan Holmes,IND,550220,0,0,30,30,
Oklahoma,State Auditor,John Yeutter,LIB,550220,0,0,276,276,
Oklahoma,State Auditor,Cindy Byrd,REP,550220,0,0,384,384,
Oklahoma,Attorney General,Mike Hunter,REP,550220,0,0,346,346,
Oklahoma,Attorney General,Mark Myles,DEM,550220,0,0,395,395,
Oklahoma,State Treasurer,Randy Mcdaniel,REP,550220,0,0,364,364,
Oklahoma,State Treasurer,Charles De Coune,IND,550220,0,0,296,296,
Oklahoma,Superintendent of Public Instruction,Joy Hofmeister,REP,550220,0,0,303,303,
Oklahoma,Superintendent of Public Instruction,John Cox,DEM,550220,0,0,374,374,
Oklahoma,Superintendent of Public Instruction,Larry Huff,IND,550220,0,0,62,62,
Oklahoma,Commissioner of Labor,Leslie Osborn,REP,550220,0,0,325,325,
Oklahoma,Commissioner of Labor,Fred Dorrell,DEM,550220,0,0,367,367,
Oklahoma,Commissioner of Labor,Brandt Dismukes,IND,550220,0,0,47,47,
Oklahoma,Insurance Commissioner,Glen Mulready,REP,550220,0,0,318,318,
Oklahoma,Insurance Commissioner,Kimberly Fobbs,DEM,550220,0,0,421,421,
Oklahoma,Corporation Commissioner,Bob Anthony,REP,550220,0,0,312,312,
Oklahoma,Corporation Commissioner,Ashley Nicole Mccray,DEM,550220,0,0,386,386,
Oklahoma,Corporation Commissioner,Jackie Short,IND,550220,0,0,45,45,
Oklahoma,U.S. House,Steve Russell,REP,550220,0,0,314,314,5
Oklahoma,U.S. House,Kendra Horn,DEM,550220,0,0,430,430,5
Oklahoma,Governor,Chris Powell,LIB,550221,0,0,31,31,
Oklahoma,Governor,Kevin Stitt,REP,550221,0,0,348,348,
Oklahoma,Governor,Drew Edmondson,DEM,550221,0,0,396,396,
Oklahoma,Lieutenant Governor,Matt Pinnell,REP,550221,0,0,382,382,
Oklahoma,Lieutenant Governor,Anastasia Pittman,DEM,550221,0,0,361,361,
Oklahoma,Lieutenant Governor,Ivan Holmes,IND,550221,0,0,27,27,
Oklahoma,State Auditor,John Yeutter,LIB,550221,0,0,245,245,
Oklahoma,State Auditor,Cindy Byrd,REP,550221,0,0,425,425,
Oklahoma,Attorney General,Mike Hunter,REP,550221,0,0,392,392,
Oklahoma,Attorney General,Mark Myles,DEM,550221,0,0,377,377,
Oklahoma,State Treasurer,Randy Mcdaniel,REP,550221,0,0,412,412,
Oklahoma,State Treasurer,Charles De Coune,IND,550221,0,0,266,266,
Oklahoma,Superintendent of Public Instruction,Joy Hofmeister,REP,550221,0,0,360,360,
Oklahoma,Superintendent of Public Instruction,John Cox,DEM,550221,0,0,345,345,
Oklahoma,Superintendent of Public Instruction,Larry Huff,IND,550221,0,0,65,65,
Oklahoma,Commissioner of Labor,Leslie Osborn,REP,550221,0,0,374,374,
Oklahoma,Commissioner of Labor,Fred Dorrell,DEM,550221,0,0,351,351,
Oklahoma,Commissioner of Labor,Brandt Dismukes,IND,550221,0,0,38,38,
Oklahoma,Insurance Commissioner,Glen Mulready,REP,550221,0,0,386,386,
Oklahoma,Insurance Commissioner,Kimberly Fobbs,DEM,550221,0,0,381,381,
Oklahoma,Corporation Commissioner,Bob Anthony,REP,550221,0,0,383,383,
Oklahoma,Corporation Commissioner,Ashley Nicole Mccray,DEM,550221,0,0,336,336,
Oklahoma,Corporation Commissioner,Jackie Short,IND,550221,0,0,51,51,
Oklahoma,U.S. House,Steve Russell,REP,550221,0,0,387,387,5
Oklahoma,U.S. House,Kendra Horn,DEM,550221,0,0,386,386,5
Oklahoma,Governor,Chris Powell,LIB,550222,0,0,19,19,
Oklahoma,Governor,Kevin Stitt,REP,550222,0,0,193,193,
Oklahoma,Governor,Drew Edmondson,DEM,550222,0,0,252,252,
Oklahoma,Lieutenant Governor,Matt Pinnell,REP,550222,0,0,197,197,
Oklahoma,Lieutenant Governor,Anastasia Pittman,DEM,550222,0,0,242,242,
Oklahoma,Lieutenant Governor,Ivan Holmes,IND,550222,0,0,23,23,
Oklahoma,State Auditor,John Yeutter,LIB,550222,0,0,175,175,
Oklahoma,State Auditor,Cindy Byrd,REP,550222,0,0,247,247,
Oklahoma,Attorney General,Mike Hunter,REP,550222,0,0,218,218,
Oklahoma,Attorney General,Mark Myles,DEM,550222,0,0,245,245,
Oklahoma,State Treasurer,Randy Mcdaniel,REP,550222,0,0,231,231,
Oklahoma,State Treasurer,Charles De Coune,IND,550222,0,0,188,188,
Oklahoma,Superintendent of Public Instruction,Joy Hofmeister,REP,550222,0,0,209,209,
Oklahoma,Superintendent of Public Instruction,John Cox,DEM,550222,0,0,213,213,
Oklahoma,Superintendent of Public Instruction,Larry Huff,IND,550222,0,0,33,33,
Oklahoma,Commissioner of Labor,Leslie Osborn,REP,550222,0,0,216,216,
Oklahoma,Commissioner of Labor,Fred Dorrell,DEM,550222,0,0,217,217,
Oklahoma,Commissioner of Labor,Brandt Dismukes,IND,550222,0,0,28,28,
Oklahoma,Insurance Commissioner,Glen Mulready,REP,550222,0,0,202,202,
Oklahoma,Insurance Commissioner,Kimberly Fobbs,DEM,550222,0,0,253,253,
Oklahoma,Corporation Commissioner,Bob Anthony,REP,550222,0,0,195,195,
Oklahoma,Corporation Commissioner,Ashley Nicole Mccray,DEM,550222,0,0,227,227,
Oklahoma,Corporation Commissioner,Jackie Short,IND,550222,0,0,35,35,
Oklahoma,U.S. House,Steve Russell,REP,550222,0,0,204,204,5
Oklahoma,U.S. House,Kendra Horn,DEM,550222,0,0,258,258,5
Oklahoma,Governor,Chris Powell,LIB,550223,0,0,15,15,
Oklahoma,Governor,Kevin Stitt,REP,550223,0,0,124,124,
Oklahoma,Governor,Drew Edmondson,DEM,550223,0,0,209,209,
Oklahoma,Lieutenant Governor,Matt Pinnell,REP,550223,0,0,141,141,
Oklahoma,Lieutenant Governor,Anastasia Pittman,DEM,550223,0,0,185,185,
Oklahoma,Lieutenant Governor,Ivan Holmes,IND,550223,0,0,23,23,
Oklahoma,State Auditor,John Yeutter,LIB,550223,0,0,137,137,
Oklahoma,State Auditor,Cindy Byrd,REP,550223,0,0,179,179,
Oklahoma,Attorney General,Mike Hunter,REP,550223,0,0,157,157,
Oklahoma,Attorney General,Mark Myles,DEM,550223,0,0,186,186,
Oklahoma,State Treasurer,Randy Mcdaniel,REP,550223,0,0,166,166,
Oklahoma,State Treasurer,Charles De Coune,IND,550223,0,0,144,144,
Oklahoma,Superintendent of Public Instruction,Joy Hofmeister,REP,550223,0,0,140,140,
Oklahoma,Superintendent of Public Instruction,John Cox,DEM,550223,0,0,182,182,
Oklahoma,Superintendent of Public Instruction,Larry Huff,IND,550223,0,0,26,26,
Oklahoma,Commissioner of Labor,Leslie Osborn,REP,550223,0,0,146,146,
Oklahoma,Commissioner of Labor,Fred Dorrell,DEM,550223,0,0,181,181,
Oklahoma,Commissioner of Labor,Brandt Dismukes,IND,550223,0,0,14,14,
Oklahoma,Insurance Commissioner,Glen Mulready,REP,550223,0,0,145,145,
Oklahoma,Insurance Commissioner,Kimberly Fobbs,DEM,550223,0,0,198,198,
Oklahoma,Corporation Commissioner,Bob Anthony,REP,550223,0,0,153,153,
Oklahoma,Corporation Commissioner,Ashley Nicole Mccray,DEM,550223,0,0,173,173,
Oklahoma,Corporation Commissioner,Jackie Short,IND,550223,0,0,19,19,
Oklahoma,U.S. House,Steve Russell,REP,550223,0,0,140,140,5
Oklahoma,U.S. House,Kendra Horn,DEM,550223,0,0,207,207,5
Oklahoma,State House,Jon Echols,REP,550223,0,0,154,154,90
Oklahoma,State House,Lavelle Compton,DEM,550223,0,0,190,190,90
Oklahoma,Governor,Chris Powell,LIB,550224,0,0,27,27,
Oklahoma,Governor,Kevin Stitt,REP,550224,0,0,180,180,
Oklahoma,Governor,Drew Edmondson,DEM,550224,0,0,276,276,
Oklahoma,Lieutenant Governor,Matt Pinnell,REP,550224,0,0,189,189,
Oklahoma,Lieutenant Governor,Anastasia Pittman,DEM,550224,0,0,258,258,
Oklahoma,Lieutenant Governor,Ivan Holmes,IND,550224,0,0,33,33,
Oklahoma,State Auditor,John Yeutter,LIB,550224,0,0,183,183,
Oklahoma,State Auditor,Cindy Byrd,REP,550224,0,0,244,244,
Oklahoma,Attorney General,Mike Hunter,REP,550224,0,0,209,209,
Oklahoma,Attorney General,Mark Myles,DEM,550224,0,0,269,269,
Oklahoma,State Treasurer,Randy Mcdaniel,REP,550224,0,0,219,219,
Oklahoma,State Treasurer,Charles De Coune,IND,550224,0,0,215,215,
Oklahoma,Superintendent of Public Instruction,Joy Hofmeister,REP,550224,0,0,187,187,
Oklahoma,Superintendent of Public Instruction,John Cox,DEM,550224,0,0,244,244,
Oklahoma,Superintendent of Public Instruction,Larry Huff,IND,550224,0,0,47,47,
Oklahoma,Commissioner of Labor,Leslie Osborn,REP,550224,0,0,193,193,
Oklahoma,Commissioner of Labor,Fred Dorrell,DEM,550224,0,0,254,254,
Oklahoma,Commissioner of Labor,Brandt Dismukes,IND,550224,0,0,28,28,
Oklahoma,Insurance Commissioner,Glen Mulready,REP,550224,0,0,194,194,
Oklahoma,Insurance Commissioner,Kimberly Fobbs,DEM,550224,0,0,278,278,
Oklahoma,Corporation Commissioner,Bob Anthony,REP,550224,0,0,181,181,
Oklahoma,Corporation Commissioner,Ashley Nicole Mccray,DEM,550224,0,0,258,258,
Oklahoma,Corporation Commissioner,Jackie Short,IND,550224,0,0,37,37,
Oklahoma,U.S. House,Steve Russell,REP,550224,0,0,186,186,5
Oklahoma,U.S. House,Kendra Horn,DEM,550224,0,0,294,294,5
Oklahoma,Governor,Chris Powell,LIB,550225,0,0,4,4,
Oklahoma,Governor,Kevin Stitt,REP,550225,0,0,38,38,
Oklahoma,Governor,Drew Edmondson,DEM,550225,0,0,44,44,
Oklahoma,Lieutenant Governor,Matt Pinnell,REP,550225,0,0,40,40,
Oklahoma,Lieutenant Governor,Anastasia Pittman,DEM,550225,0,0,43,43,
Oklahoma,Lieutenant Governor,Ivan Holmes,IND,550225,0,0,3,3,
Oklahoma,State Auditor,John Yeutter,LIB,550225,0,0,39,39,
Oklahoma,State Auditor,Cindy Byrd,REP,550225,0,0,40,40,
Oklahoma,Attorney General,Mike Hunter,REP,550225,0,0,41,41,
Oklahoma,Attorney General,Mark Myles,DEM,550225,0,0,44,44,
Oklahoma,State Treasurer,Randy Mcdaniel,REP,550225,0,0,46,46,
Oklahoma,State Treasurer,Charles De Coune,IND,550225,0,0,32,32,
Oklahoma,Superintendent of Public Instruction,Joy Hofmeister,REP,550225,0,0,42,42,
Oklahoma,Superintendent of Public Instruction,John Cox,DEM,550225,0,0,38,38,
Oklahoma,Superintendent of Public Instruction,Larry Huff,IND,550225,0,0,6,6,
Oklahoma,Commissioner of Labor,Leslie Osborn,REP,550225,0,0,37,37,
Oklahoma,Commissioner of Labor,Fred Dorrell,DEM,550225,0,0,43,43,
Oklahoma,Commissioner of Labor,Brandt Dismukes,IND,550225,0,0,5,5,
Oklahoma,Insurance Commissioner,Glen Mulready,REP,550225,0,0,38,38,
Oklahoma,Insurance Commissioner,Kimberly Fobbs,DEM,550225,0,0,47,47,
Oklahoma,Corporation Commissioner,Bob Anthony,REP,550225,0,0,39,39,
Oklahoma,Corporation Commissioner,Ashley Nicole Mccray,DEM,550225,0,0,40,40,
Oklahoma,Corporation Commissioner,Jackie Short,IND,550225,0,0,6,6,
Oklahoma,U.S. House,Steve Russell,REP,550225,0,0,42,42,5
Oklahoma,U.S. House,Kendra Horn,DEM,550225,0,0,44,44,5
Oklahoma,Governor,Chris Powell,LIB,550226,0,0,28,28,
Oklahoma,Governor,Kevin Stitt,REP,550226,0,0,197,197,
Oklahoma,Governor,Drew Edmondson,DEM,550226,0,0,281,281,
Oklahoma,Lieutenant Governor,Matt Pinnell,REP,550226,0,0,235,235,
Oklahoma,Lieutenant Governor,Anastasia Pittman,DEM,550226,0,0,241,241,
Oklahoma,Lieutenant Governor,Ivan Holmes,IND,550226,0,0,28,28,
Oklahoma,State Auditor,John Yeutter,LIB,550226,0,0,193,193,
Oklahoma,State Auditor,Cindy Byrd,REP,550226,0,0,262,262,
Oklahoma,Attorney General,Mike Hunter,REP,550226,0,0,244,244,
Oklahoma,Attorney General,Mark Myles,DEM,550226,0,0,260,260,
Oklahoma,State Treasurer,Randy Mcdaniel,REP,550226,0,0,258,258,
Oklahoma,State Treasurer,Charles De Coune,IND,550226,0,0,197,197,
Oklahoma,Superintendent of Public Instruction,Joy Hofmeister,REP,550226,0,0,221,221,
Oklahoma,Superintendent of Public Instruction,John Cox,DEM,550226,0,0,218,218,
Oklahoma,Superintendent of Public Instruction,Larry Huff,IND,550226,0,0,63,63,
Oklahoma,Commissioner of Labor,Leslie Osborn,REP,550226,0,0,240,240,
Oklahoma,Commissioner of Labor,Fred Dorrell,DEM,550226,0,0,226,226,
Oklahoma,Commissioner of Labor,Brandt Dismukes,IND,550226,0,0,36,36,
Oklahoma,Insurance Commissioner,Glen Mulready,REP,550226,0,0,234,234,
Oklahoma,Insurance Commissioner,Kimberly Fobbs,DEM,550226,0,0,269,269,
Oklahoma,Corporation Commissioner,Bob Anthony,REP,550226,0,0,213,213,
Oklahoma,Corporation Commissioner,Ashley Nicole Mccray,DEM,550226,0,0,243,243,
Oklahoma,Corporation Commissioner,Jackie Short,IND,550226,0,0,44,44,
Oklahoma,U.S. House,Steve Russell,REP,550226,0,0,222,222,5
Oklahoma,U.S. House,Kendra Horn,DEM,550226,0,0,282,282,5
Oklahoma,State House,Jon Echols,REP,550226,0,0,245,245,90
Oklahoma,State House,Lavelle Compton,DEM,550226,0,0,260,260,90
Oklahoma,Governor,Chris Powell,LIB,550227,0,0,30,30,
Oklahoma,Governor,Kevin Stitt,REP,550227,0,0,178,178,
Oklahoma,Governor,Drew Edmondson,DEM,550227,0,0,213,213,
Oklahoma,Lieutenant Governor,Matt Pinnell,REP,550227,0,0,197,197,
Oklahoma,Lieutenant Governor,Anastasia Pittman,DEM,550227,0,0,197,197,
Oklahoma,Lieutenant Governor,Ivan Holmes,IND,550227,0,0,23,23,
Oklahoma,State Auditor,John Yeutter,LIB,550227,0,0,136,136,
Oklahoma,State Auditor,Cindy Byrd,REP,550227,0,0,235,235,
Oklahoma,Attorney General,Mike Hunter,REP,550227,0,0,219,219,
Oklahoma,Attorney General,Mark Myles,DEM,550227,0,0,191,191,
Oklahoma,State Treasurer,Randy Mcdaniel,REP,550227,0,0,225,225,
Oklahoma,State Treasurer,Charles De Coune,IND,550227,0,0,155,155,
Oklahoma,Superintendent of Public Instruction,Joy Hofmeister,REP,550227,0,0,193,193,
Oklahoma,Superintendent of Public Instruction,John Cox,DEM,550227,0,0,168,168,
Oklahoma,Superintendent of Public Instruction,Larry Huff,IND,550227,0,0,51,51,
Oklahoma,Commissioner of Labor,Leslie Osborn,REP,550227,0,0,215,215,
Oklahoma,Commissioner of Labor,Fred Dorrell,DEM,550227,0,0,166,166,
Oklahoma,Commissioner of Labor,Brandt Dismukes,IND,550227,0,0,28,28,
Oklahoma,Insurance Commissioner,Glen Mulready,REP,550227,0,0,206,206,
Oklahoma,Insurance Commissioner,Kimberly Fobbs,DEM,550227,0,0,200,200,
Oklahoma,Corporation Commissioner,Bob Anthony,REP,550227,0,0,191,191,
Oklahoma,Corporation Commissioner,Ashley Nicole Mccray,DEM,550227,0,0,182,182,
Oklahoma,Corporation Commissioner,Jackie Short,IND,550227,0,0,35,35,
Oklahoma,U.S. House,Steve Russell,REP,550227,0,0,194,194,5
Oklahoma,U.S. House,Kendra Horn,DEM,550227,0,0,221,221,5
Oklahoma,State House,Jon Echols,REP,550227,0,0,236,236,90
Oklahoma,State House,Lavelle Compton,DEM,550227,0,0,174,174,90
Oklahoma,Governor,Chris Powell,LIB,550228,0,0,31,31,
Oklahoma,Governor,Kevin Stitt,REP,550228,0,0,186,186,
Oklahoma,Governor,Drew Edmondson,DEM,550228,0,0,255,255,
Oklahoma,Lieutenant Governor,Matt Pinnell,REP,550228,0,0,200,200,
Oklahoma,Lieutenant Governor,Anastasia Pittman,DEM,550228,0,0,239,239,
Oklahoma,Lieutenant Governor,Ivan Holmes,IND,550228,0,0,31,31,
Oklahoma,State Auditor,John Yeutter,LIB,550228,0,0,177,177,
Oklahoma,State Auditor,Cindy Byrd,REP,550228,0,0,242,242,
Oklahoma,Attorney General,Mike Hunter,REP,550228,0,0,219,219,
Oklahoma,Attorney General,Mark Myles,DEM,550228,0,0,249,249,
Oklahoma,State Treasurer,Randy Mcdaniel,REP,550228,0,0,220,220,
Oklahoma,State Treasurer,Charles De Coune,IND,550228,0,0,206,206,
Oklahoma,Superintendent of Public Instruction,Joy Hofmeister,REP,550228,0,0,196,196,
Oklahoma,Superintendent of Public Instruction,John Cox,DEM,550228,0,0,216,216,
Oklahoma,Superintendent of Public Instruction,Larry Huff,IND,550228,0,0,54,54,
Oklahoma,Commissioner of Labor,Leslie Osborn,REP,550228,0,0,206,206,
Oklahoma,Commissioner of Labor,Fred Dorrell,DEM,550228,0,0,217,217,
Oklahoma,Commissioner of Labor,Brandt Dismukes,IND,550228,0,0,34,34,
Oklahoma,Insurance Commissioner,Glen Mulready,REP,550228,0,0,196,196,
Oklahoma,Insurance Commissioner,Kimberly Fobbs,DEM,550228,0,0,266,266,
Oklahoma,Corporation Commissioner,Bob Anthony,REP,550228,0,0,191,191,
Oklahoma,Corporation Commissioner,Ashley Nicole Mccray,DEM,550228,0,0,229,229,
Oklahoma,Corporation Commissioner,Jackie Short,IND,550228,0,0,42,42,
Oklahoma,U.S. House,Steve Russell,REP,550228,0,0,207,207,5
Oklahoma,U.S. House,Kendra Horn,DEM,550228,0,0,262,262,5
Oklahoma,State House,Jon Echols,REP,550228,0,0,214,214,90
Oklahoma,State House,Lavelle Compton,DEM,550228,0,0,252,252,90
Oklahoma,Governor,Chris Powell,LIB,550229,0,0,25,25,
Oklahoma,Governor,Kevin Stitt,REP,550229,0,0,314,314,
Oklahoma,Governor,Drew Edmondson,DEM,550229,0,0,325,325,
Oklahoma,Lieutenant Governor,Matt Pinnell,REP,550229,0,0,354,354,
Oklahoma,Lieutenant Governor,Anastasia Pittman,DEM,550229,0,0,281,281,
Oklahoma,Lieutenant Governor,Ivan Holmes,IND,550229,0,0,27,27,
Oklahoma,State Auditor,John Yeutter,LIB,550229,0,0,191,191,
Oklahoma,State Auditor,Cindy Byrd,REP,550229,0,0,423,423,
Oklahoma,Attorney General,Mike Hunter,REP,550229,0,0,373,373,
Oklahoma,Attorney General,Mark Myles,DEM,550229,0,0,286,286,
Oklahoma,State Treasurer,Randy Mcdaniel,REP,550229,0,0,389,389,
Oklahoma,State Treasurer,Charles De Coune,IND,550229,0,0,227,227,
Oklahoma,Superintendent of Public Instruction,Joy Hofmeister,REP,550229,0,0,357,357,
Oklahoma,Superintendent of Public Instruction,John Cox,DEM,550229,0,0,256,256,
Oklahoma,Superintendent of Public Instruction,Larry Huff,IND,550229,0,0,49,49,
Oklahoma,Commissioner of Labor,Leslie Osborn,REP,550229,0,0,374,374,
Oklahoma,Commissioner of Labor,Fred Dorrell,DEM,550229,0,0,254,254,
Oklahoma,Commissioner of Labor,Brandt Dismukes,IND,550229,0,0,25,25,
Oklahoma,Insurance Commissioner,Glen Mulready,REP,550229,0,0,344,344,
Oklahoma,Insurance Commissioner,Kimberly Fobbs,DEM,550229,0,0,308,308,
Oklahoma,Corporation Commissioner,Bob Anthony,REP,550229,0,0,344,344,
Oklahoma,Corporation Commissioner,Ashley Nicole Mccray,DEM,550229,0,0,278,278,
Oklahoma,Corporation Commissioner,Jackie Short,IND,550229,0,0,37,37,
Oklahoma,U.S. House,Steve Russell,REP,550229,0,0,339,339,5
Oklahoma,U.S. House,Kendra Horn,DEM,550229,0,0,323,323,5
Oklahoma,Governor,Chris Powell,LIB,550230,0,0,27,27,
Oklahoma,Governor,Kevin Stitt,REP,550230,0,0,361,361,
Oklahoma,Governor,Drew Edmondson,DEM,550230,0,0,338,338,
Oklahoma,Lieutenant Governor,Matt Pinnell,REP,550230,0,0,415,415,
Oklahoma,Lieutenant Governor,Anastasia Pittman,DEM,550230,0,0,278,278,
Oklahoma,Lieutenant Governor,Ivan Holmes,IND,550230,0,0,23,23,
Oklahoma,State Auditor,John Yeutter,LIB,550230,0,0,176,176,
Oklahoma,State Auditor,Cindy Byrd,REP,550230,0,0,475,475,
Oklahoma,Attorney General,Mike Hunter,REP,550230,0,0,429,429,
Oklahoma,Attorney General,Mark Myles,DEM,550230,0,0,279,279,
Oklahoma,State Treasurer,Randy Mcdaniel,REP,550230,0,0,447,447,
Oklahoma,State Treasurer,Charles De Coune,IND,550230,0,0,199,199,
Oklahoma,Superintendent of Public Instruction,Joy Hofmeister,REP,550230,0,0,408,408,
Oklahoma,Superintendent of Public Instruction,John Cox,DEM,550230,0,0,251,251,
Oklahoma,Superintendent of Public Instruction,Larry Huff,IND,550230,0,0,54,54,
Oklahoma,Commissioner of Labor,Leslie Osborn,REP,550230,0,0,415,415,
Oklahoma,Commissioner of Labor,Fred Dorrell,DEM,550230,0,0,265,265,
Oklahoma,Commissioner of Labor,Brandt Dismukes,IND,550230,0,0,24,24,
Oklahoma,Insurance Commissioner,Glen Mulready,REP,550230,0,0,405,405,
Oklahoma,Insurance Commissioner,Kimberly Fobbs,DEM,550230,0,0,300,300,
Oklahoma,Corporation Commissioner,Bob Anthony,REP,550230,0,0,392,392,
Oklahoma,Corporation Commissioner,Ashley Nicole Mccray,DEM,550230,0,0,274,274,
Oklahoma,Corporation Commissioner,Jackie Short,IND,550230,0,0,46,46,
Oklahoma,U.S. House,Steve Russell,REP,550230,0,0,401,401,5
Oklahoma,U.S. House,Kendra Horn,DEM,550230,0,0,319,319,5
Oklahoma,Governor,Chris Powell,LIB,550231,0,0,24,24,
Oklahoma,Governor,Kevin Stitt,REP,550231,0,0,233,233,
Oklahoma,Governor,Drew Edmondson,DEM,550231,0,0,232,232,
Oklahoma,Lieutenant Governor,Matt Pinnell,REP,550231,0,0,269,269,
Oklahoma,Lieutenant Governor,Anastasia Pittman,DEM,550231,0,0,203,203,
Oklahoma,Lieutenant Governor,Ivan Holmes,IND,550231,0,0,16,16,
Oklahoma,State Auditor,John Yeutter,LIB,550231,0,0,160,160,
Oklahoma,State Auditor,Cindy Byrd,REP,550231,0,0,286,286,
Oklahoma,Attorney General,Mike Hunter,REP,550231,0,0,266,266,
Oklahoma,Attorney General,Mark Myles,DEM,550231,0,0,220,220,
Oklahoma,State Treasurer,Randy Mcdaniel,REP,550231,0,0,271,271,
Oklahoma,State Treasurer,Charles De Coune,IND,550231,0,0,172,172,
Oklahoma,Superintendent of Public Instruction,Joy Hofmeister,REP,550231,0,0,246,246,
Oklahoma,Superintendent of Public Instruction,John Cox,DEM,550231,0,0,197,197,
Oklahoma,Superintendent of Public Instruction,Larry Huff,IND,550231,0,0,41,41,
Oklahoma,Commissioner of Labor,Leslie Osborn,REP,550231,0,0,249,249,
Oklahoma,Commissioner of Labor,Fred Dorrell,DEM,550231,0,0,198,198,
Oklahoma,Commissioner of Labor,Brandt Dismukes,IND,550231,0,0,29,29,
Oklahoma,Insurance Commissioner,Glen Mulready,REP,550231,0,0,259,259,
Oklahoma,Insurance Commissioner,Kimberly Fobbs,DEM,550231,0,0,221,221,
Oklahoma,Corporation Commissioner,Bob Anthony,REP,550231,0,0,244,244,
Oklahoma,Corporation Commissioner,Ashley Nicole Mccray,DEM,550231,0,0,205,205,
Oklahoma,Corporation Commissioner,Jackie Short,IND,550231,0,0,34,34,
Oklahoma,U.S. House,Steve Russell,REP,550231,0,0,258,258,5
Oklahoma,U.S. House,Kendra Horn,DEM,550231,0,0,230,230,5
Oklahoma,Governor,Chris Powell,LIB,550232,0,0,28,28,
Oklahoma,Governor,Kevin Stitt,REP,550232,0,0,375,375,
Oklahoma,Governor,Drew Edmondson,DEM,550232,0,0,307,307,
Oklahoma,Lieutenant Governor,Matt Pinnell,REP,550232,0,0,405,405,
Oklahoma,Lieutenant Governor,Anastasia Pittman,DEM,550232,0,0,276,276,
Oklahoma,Lieutenant Governor,Ivan Holmes,IND,550232,0,0,25,25,
Oklahoma,State Auditor,John Yeutter,LIB,550232,0,0,193,193,
Oklahoma,State Auditor,Cindy Byrd,REP,550232,0,0,443,443,
Oklahoma,Attorney General,Mike Hunter,REP,550232,0,0,408,408,
Oklahoma,Attorney General,Mark Myles,DEM,550232,0,0,294,294,
Oklahoma,State Treasurer,Randy Mcdaniel,REP,550232,0,0,413,413,
Oklahoma,State Treasurer,Charles De Coune,IND,550232,0,0,228,228,
Oklahoma,Superintendent of Public Instruction,Joy Hofmeister,REP,550232,0,0,381,381,
Oklahoma,Superintendent of Public Instruction,John Cox,DEM,550232,0,0,263,263,
Oklahoma,Superintendent of Public Instruction,Larry Huff,IND,550232,0,0,59,59,
Oklahoma,Commissioner of Labor,Leslie Osborn,REP,550232,0,0,404,404,
Oklahoma,Commissioner of Labor,Fred Dorrell,DEM,550232,0,0,254,254,
Oklahoma,Commissioner of Labor,Brandt Dismukes,IND,550232,0,0,41,41,
Oklahoma,Insurance Commissioner,Glen Mulready,REP,550232,0,0,400,400,
Oklahoma,Insurance Commissioner,Kimberly Fobbs,DEM,550232,0,0,294,294,
Oklahoma,Corporation Commissioner,Bob Anthony,REP,550232,0,0,388,388,
Oklahoma,Corporation Commissioner,Ashley Nicole Mccray,DEM,550232,0,0,267,267,
Oklahoma,Corporation Commissioner,Jackie Short,IND,550232,0,0,49,49,
Oklahoma,U.S. House,Steve Russell,REP,550232,0,0,401,401,5
Oklahoma,U.S. House,Kendra Horn,DEM,550232,0,0,308,308,5
Oklahoma,State House,Kevin West,REP,550232,0,0,411,411,54
Oklahoma,State House,Katelyn Dockery,DEM,550232,0,0,294,294,54
Oklahoma,Governor,Chris Powell,LIB,550233,0,0,19,19,
Oklahoma,Governor,Kevin Stitt,REP,550233,0,0,106,106,
Oklahoma,Governor,Drew Edmondson,DEM,550233,0,0,88,88,
Oklahoma,Lieutenant Governor,Matt Pinnell,REP,550233,0,0,109,109,
Oklahoma,Lieutenant Governor,Anastasia Pittman,DEM,550233,0,0,85,85,
Oklahoma,Lieutenant Governor,Ivan Holmes,IND,550233,0,0,18,18,
Oklahoma,State Auditor,John Yeutter,LIB,550233,0,0,63,63,
Oklahoma,State Auditor,Cindy Byrd,REP,550233,0,0,130,130,
Oklahoma,Attorney General,Mike Hunter,REP,550233,0,0,119,119,
Oklahoma,Attorney General,Mark Myles,DEM,550233,0,0,92,92,
Oklahoma,State Treasurer,Randy Mcdaniel,REP,550233,0,0,117,117,
Oklahoma,State Treasurer,Charles De Coune,IND,550233,0,0,76,76,
Oklahoma,Superintendent of Public Instruction,Joy Hofmeister,REP,550233,0,0,105,105,
Oklahoma,Superintendent of Public Instruction,John Cox,DEM,550233,0,0,75,75,
Oklahoma,Superintendent of Public Instruction,Larry Huff,IND,550233,0,0,33,33,
Oklahoma,Commissioner of Labor,Leslie Osborn,REP,550233,0,0,106,106,
Oklahoma,Commissioner of Labor,Fred Dorrell,DEM,550233,0,0,76,76,
Oklahoma,Commissioner of Labor,Brandt Dismukes,IND,550233,0,0,26,26,
Oklahoma,Insurance Commissioner,Glen Mulready,REP,550233,0,0,112,112,
Oklahoma,Insurance Commissioner,Kimberly Fobbs,DEM,550233,0,0,96,96,
Oklahoma,Corporation Commissioner,Bob Anthony,REP,550233,0,0,101,101,
Oklahoma,Corporation Commissioner,Ashley Nicole Mccray,DEM,550233,0,0,84,84,
Oklahoma,Corporation Commissioner,Jackie Short,IND,550233,0,0,25,25,
Oklahoma,U.S. House,Steve Russell,REP,550233,0,0,106,106,5
Oklahoma,U.S. House,Kendra Horn,DEM,550233,0,0,106,106,5
Oklahoma,State House,Kevin West,REP,550233,0,0,115,115,54
Oklahoma,State House,Katelyn Dockery,DEM,550233,0,0,97,97,54
Oklahoma,Governor,Chris Powell,LIB,550234,0,0,24,24,
Oklahoma,Governor,Kevin Stitt,REP,550234,0,0,190,190,
Oklahoma,Governor,Drew Edmondson,DEM,550234,0,0,266,266,
Oklahoma,Lieutenant Governor,Matt Pinnell,REP,550234,0,0,220,220,
Oklahoma,Lieutenant Governor,Anastasia Pittman,DEM,550234,0,0,231,231,
Oklahoma,Lieutenant Governor,Ivan Holmes,IND,550234,0,0,24,24,
Oklahoma,State Auditor,John Yeutter,LIB,550234,0,0,174,174,
Oklahoma,State Auditor,Cindy Byrd,REP,550234,0,0,255,255,
Oklahoma,Attorney General,Mike Hunter,REP,550234,0,0,226,226,
Oklahoma,Attorney General,Mark Myles,DEM,550234,0,0,248,248,
Oklahoma,State Treasurer,Randy Mcdaniel,REP,550234,0,0,253,253,
Oklahoma,State Treasurer,Charles De Coune,IND,550234,0,0,174,174,
Oklahoma,Superintendent of Public Instruction,Joy Hofmeister,REP,550234,0,0,223,223,
Oklahoma,Superintendent of Public Instruction,John Cox,DEM,550234,0,0,206,206,
Oklahoma,Superintendent of Public Instruction,Larry Huff,IND,550234,0,0,46,46,
Oklahoma,Commissioner of Labor,Leslie Osborn,REP,550234,0,0,219,219,
Oklahoma,Commissioner of Labor,Fred Dorrell,DEM,550234,0,0,227,227,
Oklahoma,Commissioner of Labor,Brandt Dismukes,IND,550234,0,0,25,25,
Oklahoma,Insurance Commissioner,Glen Mulready,REP,550234,0,0,210,210,
Oklahoma,Insurance Commissioner,Kimberly Fobbs,DEM,550234,0,0,260,260,
Oklahoma,Corporation Commissioner,Bob Anthony,REP,550234,0,0,210,210,
Oklahoma,Corporation Commissioner,Ashley Nicole Mccray,DEM,550234,0,0,239,239,
Oklahoma,Corporation Commissioner,Jackie Short,IND,550234,0,0,28,28,
Oklahoma,U.S. House,Steve Russell,REP,550234,0,0,196,196,5
Oklahoma,U.S. House,Kendra Horn,DEM,550234,0,0,280,280,5
Oklahoma,Governor,Chris Powell,LIB,550235,0,0,17,17,
Oklahoma,Governor,Kevin Stitt,REP,550235,0,0,117,117,
Oklahoma,Governor,Drew Edmondson,DEM,550235,0,0,293,293,
Oklahoma,Lieutenant Governor,Matt Pinnell,REP,550235,0,0,125,125,
Oklahoma,Lieutenant Governor,Anastasia Pittman,DEM,550235,0,0,283,283,
Oklahoma,Lieutenant Governor,Ivan Holmes,IND,550235,0,0,17,17,
Oklahoma,State Auditor,John Yeutter,LIB,550235,0,0,182,182,
Oklahoma,State Auditor,Cindy Byrd,REP,550235,0,0,173,173,
Oklahoma,Attorney General,Mike Hunter,REP,550235,0,0,139,139,
Oklahoma,Attorney General,Mark Myles,DEM,550235,0,0,286,286,
Oklahoma,State Treasurer,Randy Mcdaniel,REP,550235,0,0,163,163,
Oklahoma,State Treasurer,Charles De Coune,IND,550235,0,0,196,196,
Oklahoma,Superintendent of Public Instruction,Joy Hofmeister,REP,550235,0,0,134,134,
Oklahoma,Superintendent of Public Instruction,John Cox,DEM,550235,0,0,254,254,
Oklahoma,Superintendent of Public Instruction,Larry Huff,IND,550235,0,0,35,35,
Oklahoma,Commissioner of Labor,Leslie Osborn,REP,550235,0,0,129,129,
Oklahoma,Commissioner of Labor,Fred Dorrell,DEM,550235,0,0,262,262,
Oklahoma,Commissioner of Labor,Brandt Dismukes,IND,550235,0,0,29,29,
Oklahoma,Insurance Commissioner,Glen Mulready,REP,550235,0,0,126,126,
Oklahoma,Insurance Commissioner,Kimberly Fobbs,DEM,550235,0,0,294,294,
Oklahoma,Corporation Commissioner,Bob Anthony,REP,550235,0,0,132,132,
Oklahoma,Corporation Commissioner,Ashley Nicole Mccray,DEM,550235,0,0,262,262,
Oklahoma,Corporation Commissioner,Jackie Short,IND,550235,0,0,27,27,
Oklahoma,U.S. House,Steve Russell,REP,550235,0,0,129,129,5
Oklahoma,U.S. House,Kendra Horn,DEM,550235,0,0,291,291,5
Oklahoma,Governor,Chris Powell,LIB,550236,0,0,0,0,
Oklahoma,Governor,Kevin Stitt,REP,550236,0,0,0,0,
Oklahoma,Governor,Drew Edmondson,DEM,550236,0,0,0,0,
Oklahoma,Lieutenant Governor,Matt Pinnell,REP,550236,0,0,0,0,
Oklahoma,Lieutenant Governor,Anastasia Pittman,DEM,550236,0,0,0,0,
Oklahoma,Lieutenant Governor,Ivan Holmes,IND,550236,0,0,0,0,
Oklahoma,State Auditor,John Yeutter,LIB,550236,0,0,0,0,
Oklahoma,State Auditor,Cindy Byrd,REP,550236,0,0,0,0,
Oklahoma,Attorney General,Mike Hunter,REP,550236,0,0,0,0,
Oklahoma,Attorney General,Mark Myles,DEM,550236,0,0,0,0,
Oklahoma,State Treasurer,Randy Mcdaniel,REP,550236,0,0,0,0,
Oklahoma,State Treasurer,Charles De Coune,IND,550236,0,0,0,0,
Oklahoma,Superintendent of Public Instruction,Joy Hofmeister,REP,550236,0,0,0,0,
Oklahoma,Superintendent of Public Instruction,John Cox,DEM,550236,0,0,0,0,
Oklahoma,Superintendent of Public Instruction,Larry Huff,IND,550236,0,0,0,0,
Oklahoma,Commissioner of Labor,Leslie Osborn,REP,550236,0,0,0,0,
Oklahoma,Commissioner of Labor,Fred Dorrell,DEM,550236,0,0,0,0,
Oklahoma,Commissioner of Labor,Brandt Dismukes,IND,550236,0,0,0,0,
Oklahoma,Insurance Commissioner,Glen Mulready,REP,550236,0,0,0,0,
Oklahoma,Insurance Commissioner,Kimberly Fobbs,DEM,550236,0,0,0,0,
Oklahoma,Corporation Commissioner,Bob Anthony,REP,550236,0,0,0,0,
Oklahoma,Corporation Commissioner,Ashley Nicole Mccray,DEM,550236,0,0,0,0,
Oklahoma,Corporation Commissioner,Jackie Short,IND,550236,0,0,0,0,
Oklahoma,U.S. House,Steve Russell,REP,550236,0,0,0,0,5
Oklahoma,U.S. House,Kendra Horn,DEM,550236,0,0,0,0,5
Oklahoma,Governor,Chris Powell,LIB,550237,0,0,0,0,
Oklahoma,Governor,Kevin Stitt,REP,550237,0,0,0,0,
Oklahoma,Governor,Drew Edmondson,DEM,550237,0,0,1,1,
Oklahoma,Lieutenant Governor,Matt Pinnell,REP,550237,0,0,0,0,
Oklahoma,Lieutenant Governor,Anastasia Pittman,DEM,550237,0,0,1,1,
Oklahoma,Lieutenant Governor,Ivan Holmes,IND,550237,0,0,0,0,
Oklahoma,State Auditor,John Yeutter,LIB,550237,0,0,0,0,
Oklahoma,State Auditor,Cindy Byrd,REP,550237,0,0,0,0,
Oklahoma,Attorney General,Mike Hunter,REP,550237,0,0,0,0,
Oklahoma,Attorney General,Mark Myles,DEM,550237,0,0,1,1,
Oklahoma,State Treasurer,Randy Mcdaniel,REP,550237,0,0,0,0,
Oklahoma,State Treasurer,Charles De Coune,IND,550237,0,0,0,0,
Oklahoma,Superintendent of Public Instruction,Joy Hofmeister,REP,550237,0,0,0,0,
Oklahoma,Superintendent of Public Instruction,John Cox,DEM,550237,0,0,1,1,
Oklahoma,Superintendent of Public Instruction,Larry Huff,IND,550237,0,0,0,0,
Oklahoma,Commissioner of Labor,Leslie Osborn,REP,550237,0,0,0,0,
Oklahoma,Commissioner of Labor,Fred Dorrell,DEM,550237,0,0,1,1,
Oklahoma,Commissioner of Labor,Brandt Dismukes,IND,550237,0,0,0,0,
Oklahoma,Insurance Commissioner,Glen Mulready,REP,550237,0,0,0,0,
Oklahoma,Insurance Commissioner,Kimberly Fobbs,DEM,550237,0,0,1,1,
Oklahoma,Corporation Commissioner,Bob Anthony,REP,550237,0,0,0,0,
Oklahoma,Corporation Commissioner,Ashley Nicole Mccray,DEM,550237,0,0,1,1,
Oklahoma,Corporation Commissioner,Jackie Short,IND,550237,0,0,0,0,
Oklahoma,U.S. House,Steve Russell,REP,550237,0,0,0,0,5
Oklahoma,U.S. House,Kendra Horn,DEM,550237,0,0,1,1,5
Oklahoma,Governor,Chris Powell,LIB,550238,0,0,0,0,
Oklahoma,Governor,Kevin Stitt,REP,550238,0,0,1,1,
Oklahoma,Governor,Drew Edmondson,DEM,550238,0,0,0,0,
Oklahoma,Lieutenant Governor,Matt Pinnell,REP,550238,0,0,1,1,
Oklahoma,Lieutenant Governor,Anastasia Pittman,DEM,550238,0,0,0,0,
Oklahoma,Lieutenant Governor,Ivan Holmes,IND,550238,0,0,0,0,
Oklahoma,State Auditor,John Yeutter,LIB,550238,0,0,0,0,
Oklahoma,State Auditor,Cindy Byrd,REP,550238,0,0,1,1,
Oklahoma,Attorney General,Mike Hunter,REP,550238,0,0,1,1,
Oklahoma,Attorney General,Mark Myles,DEM,550238,0,0,0,0,
Oklahoma,State Treasurer,Randy Mcdaniel,REP,550238,0,0,1,1,
Oklahoma,State Treasurer,Charles De Coune,IND,550238,0,0,0,0,
Oklahoma,Superintendent of Public Instruction,Joy Hofmeister,REP,550238,0,0,1,1,
Oklahoma,Superintendent of Public Instruction,John Cox,DEM,550238,0,0,0,0,
Oklahoma,Superintendent of Public Instruction,Larry Huff,IND,550238,0,0,0,0,
Oklahoma,Commissioner of Labor,Leslie Osborn,REP,550238,0,0,1,1,
Oklahoma,Commissioner of Labor,Fred Dorrell,DEM,550238,0,0,0,0,
Oklahoma,Commissioner of Labor,Brandt Dismukes,IND,550238,0,0,0,0,
Oklahoma,Insurance Commissioner,Glen Mulready,REP,550238,0,0,1,1,
Oklahoma,Insurance Commissioner,Kimberly Fobbs,DEM,550238,0,0,0,0,
Oklahoma,Corporation Commissioner,Bob Anthony,REP,550238,0,0,1,1,
Oklahoma,Corporation Commissioner,Ashley Nicole Mccray,DEM,550238,0,0,0,0,
Oklahoma,Corporation Commissioner,Jackie Short,IND,550238,0,0,0,0,
Oklahoma,U.S. House,Steve Russell,REP,550238,0,0,1,1,5
Oklahoma,U.S. House,Kendra Horn,DEM,550238,0,0,0,0,5
Oklahoma,Governor,Chris Powell,LIB,550239,0,0,29,29,
Oklahoma,Governor,Kevin Stitt,REP,550239,0,0,171,171,
Oklahoma,Governor,Drew Edmondson,DEM,550239,0,0,717,717,
Oklahoma,Lieutenant Governor,Matt Pinnell,REP,550239,0,0,226,226,
Oklahoma,Lieutenant Governor,Anastasia Pittman,DEM,550239,0,0,642,642,
Oklahoma,Lieutenant Governor,Ivan Holmes,IND,550239,0,0,35,35,
Oklahoma,State Auditor,John Yeutter,LIB,550239,0,0,458,458,
Oklahoma,State Auditor,Cindy Byrd,REP,550239,0,0,350,350,
Oklahoma,Attorney General,Mike Hunter,REP,550239,0,0,249,249,
Oklahoma,Attorney General,Mark Myles,DEM,550239,0,0,659,659,
Oklahoma,State Treasurer,Randy Mcdaniel,REP,550239,0,0,297,297,
Oklahoma,State Treasurer,Charles De Coune,IND,550239,0,0,507,507,
Oklahoma,Superintendent of Public Instruction,Joy Hofmeister,REP,550239,0,0,254,254,
Oklahoma,Superintendent of Public Instruction,John Cox,DEM,550239,0,0,601,601,
Oklahoma,Superintendent of Public Instruction,Larry Huff,IND,550239,0,0,49,49,
Oklahoma,Commissioner of Labor,Leslie Osborn,REP,550239,0,0,258,258,
Oklahoma,Commissioner of Labor,Fred Dorrell,DEM,550239,0,0,594,594,
Oklahoma,Commissioner of Labor,Brandt Dismukes,IND,550239,0,0,43,43,
Oklahoma,Insurance Commissioner,Glen Mulready,REP,550239,0,0,236,236,
Oklahoma,Insurance Commissioner,Kimberly Fobbs,DEM,550239,0,0,653,653,
Oklahoma,Corporation Commissioner,Bob Anthony,REP,550239,0,0,233,233,
Oklahoma,Corporation Commissioner,Ashley Nicole Mccray,DEM,550239,0,0,618,618,
Oklahoma,Corporation Commissioner,Jackie Short,IND,550239,0,0,37,37,
Oklahoma,U.S. House,Steve Russell,REP,550239,0,0,208,208,5
Oklahoma,U.S. House,Kendra Horn,DEM,550239,0,0,698,698,5
Oklahoma,State Senate,Willard Linzy,REP,550239,0,0,199,199,48
Oklahoma,State Senate,George Young,DEM,550239,0,0,698,698,48
Oklahoma,Governor,Chris Powell,LIB,550240,0,0,19,19,
Oklahoma,Governor,Kevin Stitt,REP,550240,0,0,28,28,
Oklahoma,Governor,Drew Edmondson,DEM,550240,0,0,548,548,
Oklahoma,Lieutenant Governor,Matt Pinnell,REP,550240,0,0,35,35,
Oklahoma,Lieutenant Governor,Anastasia Pittman,DEM,550240,0,0,545,545,
Oklahoma,Lieutenant Governor,Ivan Holmes,IND,550240,0,0,13,13,
Oklahoma,State Auditor,John Yeutter,LIB,550240,0,0,355,355,
Oklahoma,State Auditor,Cindy Byrd,REP,550240,0,0,137,137,
Oklahoma,Attorney General,Mike Hunter,REP,550240,0,0,53,53,
Oklahoma,Attorney General,Mark Myles,DEM,550240,0,0,538,538,
Oklahoma,State Treasurer,Randy Mcdaniel,REP,550240,0,0,87,87,
Oklahoma,State Treasurer,Charles De Coune,IND,550240,0,0,411,411,
Oklahoma,Superintendent of Public Instruction,Joy Hofmeister,REP,550240,0,0,74,74,
Oklahoma,Superintendent of Public Instruction,John Cox,DEM,550240,0,0,478,478,
Oklahoma,Superintendent of Public Instruction,Larry Huff,IND,550240,0,0,41,41,
Oklahoma,Commissioner of Labor,Leslie Osborn,REP,550240,0,0,55,55,
Oklahoma,Commissioner of Labor,Fred Dorrell,DEM,550240,0,0,513,513,
Oklahoma,Commissioner of Labor,Brandt Dismukes,IND,550240,0,0,22,22,
Oklahoma,Insurance Commissioner,Glen Mulready,REP,550240,0,0,38,38,
Oklahoma,Insurance Commissioner,Kimberly Fobbs,DEM,550240,0,0,548,548,
Oklahoma,Corporation Commissioner,Bob Anthony,REP,550240,0,0,66,66,
Oklahoma,Corporation Commissioner,Ashley Nicole Mccray,DEM,550240,0,0,500,500,
Oklahoma,Corporation Commissioner,Jackie Short,IND,550240,0,0,28,28,
Oklahoma,U.S. House,Steve Russell,REP,550240,0,0,38,38,5
Oklahoma,U.S. House,Kendra Horn,DEM,550240,0,0,557,557,5
Oklahoma,State Senate,Willard Linzy,REP,550240,0,0,41,41,48
Oklahoma,State Senate,George Young,DEM,550240,0,0,550,550,48
Oklahoma,Governor,Chris Powell,LIB,550241,0,0,7,7,
Oklahoma,Governor,Kevin Stitt,REP,550241,0,0,59,59,
Oklahoma,Governor,Drew Edmondson,DEM,550241,0,0,482,482,
Oklahoma,Lieutenant Governor,Matt Pinnell,REP,550241,0,0,86,86,
Oklahoma,Lieutenant Governor,Anastasia Pittman,DEM,550241,0,0,441,441,
Oklahoma,Lieutenant Governor,Ivan Holmes,IND,550241,0,0,16,16,
Oklahoma,State Auditor,John Yeutter,LIB,550241,0,0,272,272,
Oklahoma,State Auditor,Cindy Byrd,REP,550241,0,0,175,175,
Oklahoma,Attorney General,Mike Hunter,REP,550241,0,0,90,90,
Oklahoma,Attorney General,Mark Myles,DEM,550241,0,0,452,452,
Oklahoma,State Treasurer,Randy Mcdaniel,REP,550241,0,0,125,125,
Oklahoma,State Treasurer,Charles De Coune,IND,550241,0,0,335,335,
Oklahoma,Superintendent of Public Instruction,Joy Hofmeister,REP,550241,0,0,108,108,
Oklahoma,Superintendent of Public Instruction,John Cox,DEM,550241,0,0,409,409,
Oklahoma,Superintendent of Public Instruction,Larry Huff,IND,550241,0,0,24,24,
Oklahoma,Commissioner of Labor,Leslie Osborn,REP,550241,0,0,109,109,
Oklahoma,Commissioner of Labor,Fred Dorrell,DEM,550241,0,0,401,401,
Oklahoma,Commissioner of Labor,Brandt Dismukes,IND,550241,0,0,24,24,
Oklahoma,Insurance Commissioner,Glen Mulready,REP,550241,0,0,80,80,
Oklahoma,Insurance Commissioner,Kimberly Fobbs,DEM,550241,0,0,452,452,
Oklahoma,Corporation Commissioner,Bob Anthony,REP,550241,0,0,84,84,
Oklahoma,Corporation Commissioner,Ashley Nicole Mccray,DEM,550241,0,0,425,425,
Oklahoma,Corporation Commissioner,Jackie Short,IND,550241,0,0,27,27,
Oklahoma,U.S. House,Steve Russell,REP,550241,0,0,71,71,5
Oklahoma,U.S. House,Kendra Horn,DEM,550241,0,0,474,474,5
Oklahoma,State Senate,Willard Linzy,REP,550241,0,0,65,65,48
Oklahoma,State Senate,George Young,DEM,550241,0,0,475,475,48
Oklahoma,Governor,Chris Powell,LIB,550242,0,0,10,10,
Oklahoma,Governor,Kevin Stitt,REP,550242,0,0,11,11,
Oklahoma,Governor,Drew Edmondson,DEM,550242,0,0,420,420,
Oklahoma,Lieutenant Governor,Matt Pinnell,REP,550242,0,0,11,11,
Oklahoma,Lieutenant Governor,Anastasia Pittman,DEM,550242,0,0,418,418,
Oklahoma,Lieutenant Governor,Ivan Holmes,IND,550242,0,0,12,12,
Oklahoma,State Auditor,John Yeutter,LIB,550242,0,0,259,259,
Oklahoma,State Auditor,Cindy Byrd,REP,550242,0,0,102,102,
Oklahoma,Attorney General,Mike Hunter,REP,550242,0,0,26,26,
Oklahoma,Attorney General,Mark Myles,DEM,550242,0,0,415,415,
Oklahoma,State Treasurer,Randy Mcdaniel,REP,550242,0,0,42,42,
Oklahoma,State Treasurer,Charles De Coune,IND,550242,0,0,314,314,
Oklahoma,Superintendent of Public Instruction,Joy Hofmeister,REP,550242,0,0,39,39,
Oklahoma,Superintendent of Public Instruction,John Cox,DEM,550242,0,0,386,386,
Oklahoma,Superintendent of Public Instruction,Larry Huff,IND,550242,0,0,16,16,
Oklahoma,Commissioner of Labor,Leslie Osborn,REP,550242,0,0,21,21,
Oklahoma,Commissioner of Labor,Fred Dorrell,DEM,550242,0,0,403,403,
Oklahoma,Commissioner of Labor,Brandt Dismukes,IND,550242,0,0,18,18,
Oklahoma,Insurance Commissioner,Glen Mulready,REP,550242,0,0,17,17,
Oklahoma,Insurance Commissioner,Kimberly Fobbs,DEM,550242,0,0,423,423,
Oklahoma,Corporation Commissioner,Bob Anthony,REP,550242,0,0,23,23,
Oklahoma,Corporation Commissioner,Ashley Nicole Mccray,DEM,550242,0,0,403,403,
Oklahoma,Corporation Commissioner,Jackie Short,IND,550242,0,0,14,14,
Oklahoma,U.S. House,Steve Russell,REP,550242,0,0,15,15,5
Oklahoma,U.S. House,Kendra Horn,DEM,550242,0,0,427,427,5
Oklahoma,State Senate,Willard Linzy,REP,550242,0,0,15,15,48
Oklahoma,State Senate,George Young,DEM,550242,0,0,427,427,48
Oklahoma,Governor,Chris Powell,LIB,550243,0,0,19,19,
Oklahoma,Governor,Kevin Stitt,REP,550243,0,0,21,21,
Oklahoma,Governor,Drew Edmondson,DEM,550243,0,0,568,568,
Oklahoma,Lieutenant Governor,Matt Pinnell,REP,550243,0,0,23,23,
Oklahoma,Lieutenant Governor,Anastasia Pittman,DEM,550243,0,0,566,566,
Oklahoma,Lieutenant Governor,Ivan Holmes,IND,550243,0,0,17,17,
Oklahoma,State Auditor,John Yeutter,LIB,550243,0,0,392,392,
Oklahoma,State Auditor,Cindy Byrd,REP,550243,0,0,96,96,
Oklahoma,Attorney General,Mike Hunter,REP,550243,0,0,40,40,
Oklahoma,Attorney General,Mark Myles,DEM,550243,0,0,567,567,
Oklahoma,State Treasurer,Randy Mcdaniel,REP,550243,0,0,63,63,
Oklahoma,State Treasurer,Charles De Coune,IND,550243,0,0,429,429,
Oklahoma,Superintendent of Public Instruction,Joy Hofmeister,REP,550243,0,0,51,51,
Oklahoma,Superintendent of Public Instruction,John Cox,DEM,550243,0,0,510,510,
Oklahoma,Superintendent of Public Instruction,Larry Huff,IND,550243,0,0,39,39,
Oklahoma,Commissioner of Labor,Leslie Osborn,REP,550243,0,0,32,32,
Oklahoma,Commissioner of Labor,Fred Dorrell,DEM,550243,0,0,532,532,
Oklahoma,Commissioner of Labor,Brandt Dismukes,IND,550243,0,0,35,35,
Oklahoma,Insurance Commissioner,Glen Mulready,REP,550243,0,0,35,35,
Oklahoma,Insurance Commissioner,Kimberly Fobbs,DEM,550243,0,0,565,565,
Oklahoma,Corporation Commissioner,Bob Anthony,REP,550243,0,0,39,39,
Oklahoma,Corporation Commissioner,Ashley Nicole Mccray,DEM,550243,0,0,542,542,
Oklahoma,Corporation Commissioner,Jackie Short,IND,550243,0,0,22,22,
Oklahoma,U.S. House,Steve Russell,REP,550243,0,0,29,29,5
Oklahoma,U.S. House,Kendra Horn,DEM,550243,0,0,573,573,5
Oklahoma,State Senate,Willard Linzy,REP,550243,0,0,33,33,48
Oklahoma,State Senate,George Young,DEM,550243,0,0,572,572,48
Oklahoma,Governor,Chris Powell,LIB,550244,0,0,10,10,
Oklahoma,Governor,Kevin Stitt,REP,550244,0,0,13,13,
Oklahoma,Governor,Drew Edmondson,DEM,550244,0,0,566,566,
Oklahoma,Lieutenant Governor,Matt Pinnell,REP,550244,0,0,13,13,
Oklahoma,Lieutenant Governor,Anastasia Pittman,DEM,550244,0,0,566,566,
Oklahoma,Lieutenant Governor,Ivan Holmes,IND,550244,0,0,12,12,
Oklahoma,State Auditor,John Yeutter,LIB,550244,0,0,368,368,
Oklahoma,State Auditor,Cindy Byrd,REP,550244,0,0,104,104,
Oklahoma,Attorney General,Mike Hunter,REP,550244,0,0,26,26,
Oklahoma,Attorney General,Mark Myles,DEM,550244,0,0,561,561,
Oklahoma,State Treasurer,Randy Mcdaniel,REP,550244,0,0,56,56,
Oklahoma,State Treasurer,Charles De Coune,IND,550244,0,0,407,407,
Oklahoma,Superintendent of Public Instruction,Joy Hofmeister,REP,550244,0,0,51,51,
Oklahoma,Superintendent of Public Instruction,John Cox,DEM,550244,0,0,503,503,
Oklahoma,Superintendent of Public Instruction,Larry Huff,IND,550244,0,0,30,30,
Oklahoma,Commissioner of Labor,Leslie Osborn,REP,550244,0,0,26,26,
Oklahoma,Commissioner of Labor,Fred Dorrell,DEM,550244,0,0,530,530,
Oklahoma,Commissioner of Labor,Brandt Dismukes,IND,550244,0,0,30,30,
Oklahoma,Insurance Commissioner,Glen Mulready,REP,550244,0,0,22,22,
Oklahoma,Insurance Commissioner,Kimberly Fobbs,DEM,550244,0,0,564,564,
Oklahoma,Corporation Commissioner,Bob Anthony,REP,550244,0,0,34,34,
Oklahoma,Corporation Commissioner,Ashley Nicole Mccray,DEM,550244,0,0,535,535,
Oklahoma,Corporation Commissioner,Jackie Short,IND,550244,0,0,16,16,
Oklahoma,U.S. House,Steve Russell,REP,550244,0,0,20,20,5
Oklahoma,U.S. House,Kendra Horn,DEM,550244,0,0,568,568,5
Oklahoma,State Senate,Willard Linzy,REP,550244,0,0,19,19,48
Oklahoma,State Senate,George Young,DEM,550244,0,0,568,568,48
Oklahoma,Governor,Chris Powell,LIB,550245,0,0,18,18,
Oklahoma,Governor,Kevin Stitt,REP,550245,0,0,17,17,
Oklahoma,Governor,Drew Edmondson,DEM,550245,0,0,665,665,
Oklahoma,Lieutenant Governor,Matt Pinnell,REP,550245,0,0,14,14,
Oklahoma,Lieutenant Governor,Anastasia Pittman,DEM,550245,0,0,660,660,
Oklahoma,Lieutenant Governor,Ivan Holmes,IND,550245,0,0,25,25,
Oklahoma,State Auditor,John Yeutter,LIB,550245,0,0,430,430,
Oklahoma,State Auditor,Cindy Byrd,REP,550245,0,0,128,128,
Oklahoma,Attorney General,Mike Hunter,REP,550245,0,0,30,30,
Oklahoma,Attorney General,Mark Myles,DEM,550245,0,0,667,667,
Oklahoma,State Treasurer,Randy Mcdaniel,REP,550245,0,0,79,79,
Oklahoma,State Treasurer,Charles De Coune,IND,550245,0,0,483,483,
Oklahoma,Superintendent of Public Instruction,Joy Hofmeister,REP,550245,0,0,61,61,
Oklahoma,Superintendent of Public Instruction,John Cox,DEM,550245,0,0,599,599,
Oklahoma,Superintendent of Public Instruction,Larry Huff,IND,550245,0,0,38,38,
Oklahoma,Commissioner of Labor,Leslie Osborn,REP,550245,0,0,36,36,
Oklahoma,Commissioner of Labor,Fred Dorrell,DEM,550245,0,0,627,627,
Oklahoma,Commissioner of Labor,Brandt Dismukes,IND,550245,0,0,31,31,
Oklahoma,Insurance Commissioner,Glen Mulready,REP,550245,0,0,22,22,
Oklahoma,Insurance Commissioner,Kimberly Fobbs,DEM,550245,0,0,672,672,
Oklahoma,Corporation Commissioner,Bob Anthony,REP,550245,0,0,38,38,
Oklahoma,Corporation Commissioner,Ashley Nicole Mccray,DEM,550245,0,0,629,629,
Oklahoma,Corporation Commissioner,Jackie Short,IND,550245,0,0,26,26,
Oklahoma,U.S. House,Steve Russell,REP,550245,0,0,20,20,5
Oklahoma,U.S. House,Kendra Horn,DEM,550245,0,0,678,678,5
Oklahoma,State Senate,Willard Linzy,REP,550245,0,0,22,22,48
Oklahoma,State Senate,George Young,DEM,550245,0,0,675,675,48
Oklahoma,Governor,Chris Powell,LIB,550246,0,0,10,10,
Oklahoma,Governor,Kevin Stitt,REP,550246,0,0,75,75,
Oklahoma,Governor,Drew Edmondson,DEM,550246,0,0,97,97,
Oklahoma,Lieutenant Governor,Matt Pinnell,REP,550246,0,0,77,77,
Oklahoma,Lieutenant Governor,Anastasia Pittman,DEM,550246,0,0,89,89,
Oklahoma,Lieutenant Governor,Ivan Holmes,IND,550246,0,0,14,14,
Oklahoma,State Auditor,John Yeutter,LIB,550246,0,0,56,56,
Oklahoma,State Auditor,Cindy Byrd,REP,550246,0,0,97,97,
Oklahoma,Attorney General,Mike Hunter,REP,550246,0,0,87,87,
Oklahoma,Attorney General,Mark Myles,DEM,550246,0,0,90,90,
Oklahoma,State Treasurer,Randy Mcdaniel,REP,550246,0,0,90,90,
Oklahoma,State Treasurer,Charles De Coune,IND,550246,0,0,66,66,
Oklahoma,Superintendent of Public Instruction,Joy Hofmeister,REP,550246,0,0,75,75,
Oklahoma,Superintendent of Public Instruction,John Cox,DEM,550246,0,0,83,83,
Oklahoma,Superintendent of Public Instruction,Larry Huff,IND,550246,0,0,20,20,
Oklahoma,Commissioner of Labor,Leslie Osborn,REP,550246,0,0,81,81,
Oklahoma,Commissioner of Labor,Fred Dorrell,DEM,550246,0,0,85,85,
Oklahoma,Commissioner of Labor,Brandt Dismukes,IND,550246,0,0,9,9,
Oklahoma,Insurance Commissioner,Glen Mulready,REP,550246,0,0,84,84,
Oklahoma,Insurance Commissioner,Kimberly Fobbs,DEM,550246,0,0,92,92,
Oklahoma,Corporation Commissioner,Bob Anthony,REP,550246,0,0,71,71,
Oklahoma,Corporation Commissioner,Ashley Nicole Mccray,DEM,550246,0,0,89,89,
Oklahoma,Corporation Commissioner,Jackie Short,IND,550246,0,0,16,16,
Oklahoma,U.S. House,Steve Russell,REP,550246,0,0,81,81,5
Oklahoma,U.S. House,Kendra Horn,DEM,550246,0,0,98,98,5
Oklahoma,State House,Jason Sansone,REP,550246,0,0,81,81,94
Oklahoma,State House,Andy Fugate,DEM,550246,0,0,97,97,94
Oklahoma,Governor,Chris Powell,LIB,550247,0,0,21,21,
Oklahoma,Governor,Kevin Stitt,REP,550247,0,0,121,121,
Oklahoma,Governor,Drew Edmondson,DEM,550247,0,0,293,293,
Oklahoma,Lieutenant Governor,Matt Pinnell,REP,550247,0,0,130,130,
Oklahoma,Lieutenant Governor,Anastasia Pittman,DEM,550247,0,0,283,283,
Oklahoma,Lieutenant Governor,Ivan Holmes,IND,550247,0,0,21,21,
Oklahoma,State Auditor,John Yeutter,LIB,550247,0,0,207,207,
Oklahoma,State Auditor,Cindy Byrd,REP,550247,0,0,171,171,
Oklahoma,Attorney General,Mike Hunter,REP,550247,0,0,147,147,
Oklahoma,Attorney General,Mark Myles,DEM,550247,0,0,282,282,
Oklahoma,State Treasurer,Randy Mcdaniel,REP,550247,0,0,163,163,
Oklahoma,State Treasurer,Charles De Coune,IND,550247,0,0,221,221,
Oklahoma,Superintendent of Public Instruction,Joy Hofmeister,REP,550247,0,0,141,141,
Oklahoma,Superintendent of Public Instruction,John Cox,DEM,550247,0,0,251,251,
Oklahoma,Superintendent of Public Instruction,Larry Huff,IND,550247,0,0,40,40,
Oklahoma,Commissioner of Labor,Leslie Osborn,REP,550247,0,0,137,137,
Oklahoma,Commissioner of Labor,Fred Dorrell,DEM,550247,0,0,277,277,
Oklahoma,Commissioner of Labor,Brandt Dismukes,IND,550247,0,0,18,18,
Oklahoma,Insurance Commissioner,Glen Mulready,REP,550247,0,0,141,141,
Oklahoma,Insurance Commissioner,Kimberly Fobbs,DEM,550247,0,0,292,292,
Oklahoma,Corporation Commissioner,Bob Anthony,REP,550247,0,0,127,127,
Oklahoma,Corporation Commissioner,Ashley Nicole Mccray,DEM,550247,0,0,274,274,
Oklahoma,Corporation Commissioner,Jackie Short,IND,550247,0,0,28,28,
Oklahoma,U.S. House,Steve Russell,REP,550247,0,0,125,125,5
Oklahoma,U.S. House,Kendra Horn,DEM,550247,0,0,308,308,5
Oklahoma,Governor,Chris Powell,LIB,550248,0,0,33,33,
Oklahoma,Governor,Kevin Stitt,REP,550248,0,0,248,248,
Oklahoma,Governor,Drew Edmondson,DEM,550248,0,0,718,718,
Oklahoma,Lieutenant Governor,Matt Pinnell,REP,550248,0,0,284,284,
Oklahoma,Lieutenant Governor,Anastasia Pittman,DEM,550248,0,0,682,682,
Oklahoma,Lieutenant Governor,Ivan Holmes,IND,550248,0,0,31,31,
Oklahoma,State Auditor,John Yeutter,LIB,550248,0,0,488,488,
Oklahoma,State Auditor,Cindy Byrd,REP,550248,0,0,387,387,
Oklahoma,Attorney General,Mike Hunter,REP,550248,0,0,319,319,
Oklahoma,Attorney General,Mark Myles,DEM,550248,0,0,673,673,
Oklahoma,State Treasurer,Randy Mcdaniel,REP,550248,0,0,357,357,
Oklahoma,State Treasurer,Charles De Coune,IND,550248,0,0,517,517,
Oklahoma,Superintendent of Public Instruction,Joy Hofmeister,REP,550248,0,0,290,290,
Oklahoma,Superintendent of Public Instruction,John Cox,DEM,550248,0,0,617,617,
Oklahoma,Superintendent of Public Instruction,Larry Huff,IND,550248,0,0,87,87,
Oklahoma,Commissioner of Labor,Leslie Osborn,REP,550248,0,0,298,298,
Oklahoma,Commissioner of Labor,Fred Dorrell,DEM,550248,0,0,629,629,
Oklahoma,Commissioner of Labor,Brandt Dismukes,IND,550248,0,0,62,62,
Oklahoma,Insurance Commissioner,Glen Mulready,REP,550248,0,0,287,287,
Oklahoma,Insurance Commissioner,Kimberly Fobbs,DEM,550248,0,0,702,702,
Oklahoma,Corporation Commissioner,Bob Anthony,REP,550248,0,0,286,286,
Oklahoma,Corporation Commissioner,Ashley Nicole Mccray,DEM,550248,0,0,648,648,
Oklahoma,Corporation Commissioner,Jackie Short,IND,550248,0,0,59,59,
Oklahoma,U.S. House,Steve Russell,REP,550248,0,0,277,277,5
Oklahoma,U.S. House,Kendra Horn,DEM,550248,0,0,717,717,5
Oklahoma,State House,Jason Sansone,REP,550248,0,0,264,264,94
Oklahoma,State House,Andy Fugate,DEM,550248,0,0,727,727,94
Oklahoma,Governor,Chris Powell,LIB,550249,0,0,68,68,
Oklahoma,Governor,Kevin Stitt,REP,550249,0,0,467,467,
Oklahoma,Governor,Drew Edmondson,DEM,550249,0,0,759,759,
Oklahoma,Lieutenant Governor,Matt Pinnell,REP,550249,0,0,536,536,
Oklahoma,Lieutenant Governor,Anastasia Pittman,DEM,550249,0,0,701,701,
Oklahoma,Lieutenant Governor,Ivan Holmes,IND,550249,0,0,53,53,
Oklahoma,State Auditor,John Yeutter,LIB,550249,0,0,521,521,
Oklahoma,State Auditor,Cindy Byrd,REP,550249,0,0,646,646,
Oklahoma,Attorney General,Mike Hunter,REP,550249,0,0,583,583,
Oklahoma,Attorney General,Mark Myles,DEM,550249,0,0,701,701,
Oklahoma,State Treasurer,Randy Mcdaniel,REP,550249,0,0,604,604,
Oklahoma,State Treasurer,Charles De Coune,IND,550249,0,0,557,557,
Oklahoma,Superintendent of Public Instruction,Joy Hofmeister,REP,550249,0,0,528,528,
Oklahoma,Superintendent of Public Instruction,John Cox,DEM,550249,0,0,648,648,
Oklahoma,Superintendent of Public Instruction,Larry Huff,IND,550249,0,0,111,111,
Oklahoma,Commissioner of Labor,Leslie Osborn,REP,550249,0,0,557,557,
Oklahoma,Commissioner of Labor,Fred Dorrell,DEM,550249,0,0,653,653,
Oklahoma,Commissioner of Labor,Brandt Dismukes,IND,550249,0,0,70,70,
Oklahoma,Insurance Commissioner,Glen Mulready,REP,550249,0,0,557,557,
Oklahoma,Insurance Commissioner,Kimberly Fobbs,DEM,550249,0,0,715,715,
Oklahoma,Corporation Commissioner,Bob Anthony,REP,550249,0,0,542,542,
Oklahoma,Corporation Commissioner,Ashley Nicole Mccray,DEM,550249,0,0,662,662,
Oklahoma,Corporation Commissioner,Jackie Short,IND,550249,0,0,82,82,
Oklahoma,U.S. House,Steve Russell,REP,550249,0,0,550,550,5
Oklahoma,U.S. House,Kendra Horn,DEM,550249,0,0,740,740,5
Oklahoma,State House,Jason Sansone,REP,550249,0,0,444,444,94
Oklahoma,State House,Andy Fugate,DEM,550249,0,0,841,841,94
Oklahoma,Governor,Chris Powell,LIB,550250,0,0,45,45,
Oklahoma,Governor,Kevin Stitt,REP,550250,0,0,388,388,
Oklahoma,Governor,Drew Edmondson,DEM,550250,0,0,559,559,
Oklahoma,Lieutenant Governor,Matt Pinnell,REP,550250,0,0,436,436,
Oklahoma,Lieutenant Governor,Anastasia Pittman,DEM,550250,0,0,498,498,
Oklahoma,Lieutenant Governor,Ivan Holmes,IND,550250,0,0,49,49,
Oklahoma,State Auditor,John Yeutter,LIB,550250,0,0,361,361,
Oklahoma,State Auditor,Cindy Byrd,REP,550250,0,0,534,534,
Oklahoma,Attorney General,Mike Hunter,REP,550250,0,0,468,468,
Oklahoma,Attorney General,Mark Myles,DEM,550250,0,0,507,507,
Oklahoma,State Treasurer,Randy Mcdaniel,REP,550250,0,0,470,470,
Oklahoma,State Treasurer,Charles De Coune,IND,550250,0,0,423,423,
Oklahoma,Superintendent of Public Instruction,Joy Hofmeister,REP,550250,0,0,436,436,
Oklahoma,Superintendent of Public Instruction,John Cox,DEM,550250,0,0,459,459,
Oklahoma,Superintendent of Public Instruction,Larry Huff,IND,550250,0,0,85,85,
Oklahoma,Commissioner of Labor,Leslie Osborn,REP,550250,0,0,449,449,
Oklahoma,Commissioner of Labor,Fred Dorrell,DEM,550250,0,0,472,472,
Oklahoma,Commissioner of Labor,Brandt Dismukes,IND,550250,0,0,57,57,
Oklahoma,Insurance Commissioner,Glen Mulready,REP,550250,0,0,436,436,
Oklahoma,Insurance Commissioner,Kimberly Fobbs,DEM,550250,0,0,536,536,
Oklahoma,Corporation Commissioner,Bob Anthony,REP,550250,0,0,418,418,
Oklahoma,Corporation Commissioner,Ashley Nicole Mccray,DEM,550250,0,0,481,481,
Oklahoma,Corporation Commissioner,Jackie Short,IND,550250,0,0,80,80,
Oklahoma,U.S. House,Steve Russell,REP,550250,0,0,447,447,5
Oklahoma,U.S. House,Kendra Horn,DEM,550250,0,0,533,533,5
Oklahoma,State House,Jason Sansone,REP,550250,0,0,417,417,94
Oklahoma,State House,Andy Fugate,DEM,550250,0,0,560,560,94
Oklahoma,Governor,Chris Powell,LIB,550251,0,0,45,45,
Oklahoma,Governor,Kevin Stitt,REP,550251,0,0,458,458,
Oklahoma,Governor,Drew Edmondson,DEM,550251,0,0,749,749,
Oklahoma,Lieutenant Governor,Matt Pinnell,REP,550251,0,0,535,535,
Oklahoma,Lieutenant Governor,Anastasia Pittman,DEM,550251,0,0,677,677,
Oklahoma,Lieutenant Governor,Ivan Holmes,IND,550251,0,0,39,39,
Oklahoma,State Auditor,John Yeutter,LIB,550251,0,0,462,462,
Oklahoma,State Auditor,Cindy Byrd,REP,550251,0,0,650,650,
Oklahoma,Attorney General,Mike Hunter,REP,550251,0,0,539,539,
Oklahoma,Attorney General,Mark Myles,DEM,550251,0,0,703,703,
Oklahoma,State Treasurer,Randy Mcdaniel,REP,550251,0,0,573,573,
Oklahoma,State Treasurer,Charles De Coune,IND,550251,0,0,538,538,
Oklahoma,Superintendent of Public Instruction,Joy Hofmeister,REP,550251,0,0,514,514,
Oklahoma,Superintendent of Public Instruction,John Cox,DEM,550251,0,0,627,627,
Oklahoma,Superintendent of Public Instruction,Larry Huff,IND,550251,0,0,103,103,
Oklahoma,Commissioner of Labor,Leslie Osborn,REP,550251,0,0,538,538,
Oklahoma,Commissioner of Labor,Fred Dorrell,DEM,550251,0,0,635,635,
Oklahoma,Commissioner of Labor,Brandt Dismukes,IND,550251,0,0,59,59,
Oklahoma,Insurance Commissioner,Glen Mulready,REP,550251,0,0,529,529,
Oklahoma,Insurance Commissioner,Kimberly Fobbs,DEM,550251,0,0,701,701,
Oklahoma,Corporation Commissioner,Bob Anthony,REP,550251,0,0,514,514,
Oklahoma,Corporation Commissioner,Ashley Nicole Mccray,DEM,550251,0,0,651,651,
Oklahoma,Corporation Commissioner,Jackie Short,IND,550251,0,0,66,66,
Oklahoma,U.S. House,Tom Cole,REP,550251,0,0,548,548,4
Oklahoma,U.S. House,Mary Brannon,DEM,550251,0,0,656,656,4
Oklahoma,U.S. House,Ruby Peters,IND,550251,0,0,44,44,4
Oklahoma,State Senate,Brenda Stanley,REP,550251,0,0,512,512,42
Oklahoma,State Senate,Linda Wade,DEM,550251,0,0,684,684,42
Oklahoma,State Senate,Matt Campbell,IND,550251,0,0,47,47,42
Oklahoma,State House,Paul Brewbaker,LIB,550251,0,0,32,32,95
Oklahoma,State House,Jack Beall Jr,REP,550251,0,0,451,451,95
Oklahoma,State House,Kelly Albright,DEM,550251,0,0,712,712,95
Oklahoma,State House,Rashard Bickham,IND,550251,0,0,51,51,95
Oklahoma,Governor,Chris Powell,LIB,550252,0,0,42,42,
Oklahoma,Governor,Kevin Stitt,REP,550252,0,0,769,769,
Oklahoma,Governor,Drew Edmondson,DEM,550252,0,0,419,419,
Oklahoma,Lieutenant Governor,Matt Pinnell,REP,550252,0,0,867,867,
Oklahoma,Lieutenant Governor,Anastasia Pittman,DEM,550252,0,0,329,329,
Oklahoma,Lieutenant Governor,Ivan Holmes,IND,550252,0,0,33,33,
Oklahoma,State Auditor,John Yeutter,LIB,550252,0,0,209,209,
Oklahoma,State Auditor,Cindy Byrd,REP,550252,0,0,944,944,
Oklahoma,Attorney General,Mike Hunter,REP,550252,0,0,892,892,
Oklahoma,Attorney General,Mark Myles,DEM,550252,0,0,331,331,
Oklahoma,State Treasurer,Randy Mcdaniel,REP,550252,0,0,883,883,
Oklahoma,State Treasurer,Charles De Coune,IND,550252,0,0,280,280,
Oklahoma,Superintendent of Public Instruction,Joy Hofmeister,REP,550252,0,0,785,785,
Oklahoma,Superintendent of Public Instruction,John Cox,DEM,550252,0,0,327,327,
Oklahoma,Superintendent of Public Instruction,Larry Huff,IND,550252,0,0,111,111,
Oklahoma,Commissioner of Labor,Leslie Osborn,REP,550252,0,0,835,835,
Oklahoma,Commissioner of Labor,Fred Dorrell,DEM,550252,0,0,309,309,
Oklahoma,Commissioner of Labor,Brandt Dismukes,IND,550252,0,0,65,65,
Oklahoma,Insurance Commissioner,Glen Mulready,REP,550252,0,0,858,858,
Oklahoma,Insurance Commissioner,Kimberly Fobbs,DEM,550252,0,0,352,352,
Oklahoma,Corporation Commissioner,Bob Anthony,REP,550252,0,0,819,819,
Oklahoma,Corporation Commissioner,Ashley Nicole Mccray,DEM,550252,0,0,317,317,
Oklahoma,Corporation Commissioner,Jackie Short,IND,550252,0,0,85,85,
Oklahoma,U.S. House,Tom Cole,REP,550252,0,0,863,863,4
Oklahoma,U.S. House,Mary Brannon,DEM,550252,0,0,317,317,4
Oklahoma,U.S. House,Ruby Peters,IND,550252,0,0,45,45,4
Oklahoma,State Senate,Brenda Stanley,REP,550252,0,0,859,859,42
Oklahoma,State Senate,Linda Wade,DEM,550252,0,0,299,299,42
Oklahoma,State Senate,Matt Campbell,IND,550252,0,0,64,64,42
Oklahoma,State House,Paul Brewbaker,LIB,550252,0,0,34,34,95
Oklahoma,State House,Jack Beall Jr,REP,550252,0,0,801,801,95
Oklahoma,State House,Kelly Albright,DEM,550252,0,0,355,355,95
Oklahoma,State House,Rashard Bickham,IND,550252,0,0,33,33,95
Oklahoma,Governor,Chris Powell,LIB,550253,0,0,27,27,
Oklahoma,Governor,Kevin Stitt,REP,550253,0,0,255,255,
Oklahoma,Governor,Drew Edmondson,DEM,550253,0,0,101,101,
Oklahoma,Lieutenant Governor,Matt Pinnell,REP,550253,0,0,279,279,
Oklahoma,Lieutenant Governor,Anastasia Pittman,DEM,550253,0,0,85,85,
Oklahoma,Lieutenant Governor,Ivan Holmes,IND,550253,0,0,17,17,
Oklahoma,State Auditor,John Yeutter,LIB,550253,0,0,59,59,
Oklahoma,State Auditor,Cindy Byrd,REP,550253,0,0,298,298,
Oklahoma,Attorney General,Mike Hunter,REP,550253,0,0,291,291,
Oklahoma,Attorney General,Mark Myles,DEM,550253,0,0,89,89,
Oklahoma,State Treasurer,Randy Mcdaniel,REP,550253,0,0,297,297,
Oklahoma,State Treasurer,Charles De Coune,IND,550253,0,0,61,61,
Oklahoma,Superintendent of Public Instruction,Joy Hofmeister,REP,550253,0,0,255,255,
Oklahoma,Superintendent of Public Instruction,John Cox,DEM,550253,0,0,78,78,
Oklahoma,Superintendent of Public Instruction,Larry Huff,IND,550253,0,0,45,45,
Oklahoma,Commissioner of Labor,Leslie Osborn,REP,550253,0,0,282,282,
Oklahoma,Commissioner of Labor,Fred Dorrell,DEM,550253,0,0,64,64,
Oklahoma,Commissioner of Labor,Brandt Dismukes,IND,550253,0,0,23,23,
Oklahoma,Insurance Commissioner,Glen Mulready,REP,550253,0,0,276,276,
Oklahoma,Insurance Commissioner,Kimberly Fobbs,DEM,550253,0,0,93,93,
Oklahoma,Corporation Commissioner,Bob Anthony,REP,550253,0,0,262,262,
Oklahoma,Corporation Commissioner,Ashley Nicole Mccray,DEM,550253,0,0,77,77,
Oklahoma,Corporation Commissioner,Jackie Short,IND,550253,0,0,33,33,
Oklahoma,U.S. House,Steve Russell,REP,550253,0,0,277,277,5
Oklahoma,U.S. House,Kendra Horn,DEM,550253,0,0,102,102,5
Oklahoma,State Senate,Brenda Stanley,REP,550253,0,0,276,276,42
Oklahoma,State Senate,Linda Wade,DEM,550253,0,0,73,73,42
Oklahoma,State Senate,Matt Campbell,IND,550253,0,0,25,25,42
Oklahoma,State House,Robert Manger,REP,550253,0,0,270,270,10
Oklahoma,State House,John Carpenter,DEM,550253,0,0,101,101,10
Oklahoma,Governor,Chris Powell,LIB,550254,0,0,40,40,
Oklahoma,Governor,Kevin Stitt,REP,550254,0,0,809,809,
Oklahoma,Governor,Drew Edmondson,DEM,550254,0,0,446,446,
Oklahoma,Lieutenant Governor,Matt Pinnell,REP,550254,0,0,922,922,
Oklahoma,Lieutenant Governor,Anastasia Pittman,DEM,550254,0,0,326,326,
Oklahoma,Lieutenant Governor,Ivan Holmes,IND,550254,0,0,36,36,
Oklahoma,State Auditor,John Yeutter,LIB,550254,0,0,230,230,
Oklahoma,State Auditor,Cindy Byrd,REP,550254,0,0,971,971,
Oklahoma,Attorney General,Mike Hunter,REP,550254,0,0,924,924,
Oklahoma,Attorney General,Mark Myles,DEM,550254,0,0,358,358,
Oklahoma,State Treasurer,Randy Mcdaniel,REP,550254,0,0,922,922,
Oklahoma,State Treasurer,Charles De Coune,IND,550254,0,0,280,280,
Oklahoma,Superintendent of Public Instruction,Joy Hofmeister,REP,550254,0,0,830,830,
Oklahoma,Superintendent of Public Instruction,John Cox,DEM,550254,0,0,321,321,
Oklahoma,Superintendent of Public Instruction,Larry Huff,IND,550254,0,0,122,122,
Oklahoma,Commissioner of Labor,Leslie Osborn,REP,550254,0,0,891,891,
Oklahoma,Commissioner of Labor,Fred Dorrell,DEM,550254,0,0,304,304,
Oklahoma,Commissioner of Labor,Brandt Dismukes,IND,550254,0,0,60,60,
Oklahoma,Insurance Commissioner,Glen Mulready,REP,550254,0,0,902,902,
Oklahoma,Insurance Commissioner,Kimberly Fobbs,DEM,550254,0,0,358,358,
Oklahoma,Corporation Commissioner,Bob Anthony,REP,550254,0,0,855,855,
Oklahoma,Corporation Commissioner,Ashley Nicole Mccray,DEM,550254,0,0,334,334,
Oklahoma,Corporation Commissioner,Jackie Short,IND,550254,0,0,80,80,
Oklahoma,U.S. House,Steve Russell,REP,550254,0,0,892,892,5
Oklahoma,U.S. House,Kendra Horn,DEM,550254,0,0,390,390,5
Oklahoma,State House,Robert Manger,REP,550254,0,0,904,904,10
Oklahoma,State House,John Carpenter,DEM,550254,0,0,372,372,10
Oklahoma,Governor,Chris Powell,LIB,550255,0,0,0,0,
Oklahoma,Governor,Kevin Stitt,REP,550255,0,0,0,0,
Oklahoma,Governor,Drew Edmondson,DEM,550255,0,0,0,0,
Oklahoma,Lieutenant Governor,Matt Pinnell,REP,550255,0,0,0,0,
Oklahoma,Lieutenant Governor,Anastasia Pittman,DEM,550255,0,0,0,0,
Oklahoma,Lieutenant Governor,Ivan Holmes,IND,550255,0,0,0,0,
Oklahoma,State Auditor,John Yeutter,LIB,550255,0,0,0,0,
Oklahoma,State Auditor,Cindy Byrd,REP,550255,0,0,0,0,
Oklahoma,Attorney General,Mike Hunter,REP,550255,0,0,0,0,
Oklahoma,Attorney General,Mark Myles,DEM,550255,0,0,0,0,
Oklahoma,State Treasurer,Randy Mcdaniel,REP,550255,0,0,0,0,
Oklahoma,State Treasurer,Charles De Coune,IND,550255,0,0,0,0,
Oklahoma,Superintendent of Public Instruction,Joy Hofmeister,REP,550255,0,0,0,0,
Oklahoma,Superintendent of Public Instruction,John Cox,DEM,550255,0,0,0,0,
Oklahoma,Superintendent of Public Instruction,Larry Huff,IND,550255,0,0,0,0,
Oklahoma,Commissioner of Labor,Leslie Osborn,REP,550255,0,0,0,0,
Oklahoma,Commissioner of Labor,Fred Dorrell,DEM,550255,0,0,0,0,
Oklahoma,Commissioner of Labor,Brandt Dismukes,IND,550255,0,0,0,0,
Oklahoma,Insurance Commissioner,Glen Mulready,REP,550255,0,0,0,0,
Oklahoma,Insurance Commissioner,Kimberly Fobbs,DEM,550255,0,0,0,0,
Oklahoma,Corporation Commissioner,Bob Anthony,REP,550255,0,0,0,0,
Oklahoma,Corporation Commissioner,Ashley Nicole Mccray,DEM,550255,0,0,0,0,
Oklahoma,Corporation Commissioner,Jackie Short,IND,550255,0,0,0,0,
Oklahoma,U.S. House,Tom Cole,REP,550255,0,0,0,0,4
Oklahoma,U.S. House,Mary Brannon,DEM,550255,0,0,0,0,4
Oklahoma,U.S. House,Ruby Peters,IND,550255,0,0,0,0,4
Oklahoma,State Senate,Brenda Stanley,REP,550255,0,0,0,0,42
Oklahoma,State Senate,Linda Wade,DEM,550255,0,0,0,0,42
Oklahoma,State Senate,Matt Campbell,IND,550255,0,0,0,0,42
Oklahoma,State House,Paul Brewbaker,LIB,550255,0,0,0,0,95
Oklahoma,State House,Jack Beall Jr,REP,550255,0,0,0,0,95
Oklahoma,State House,Kelly Albright,DEM,550255,0,0,0,0,95
Oklahoma,State House,Rashard Bickham,IND,550255,0,0,0,0,95
Oklahoma,Governor,Chris Powell,LIB,550256,0,0,0,0,
Oklahoma,Governor,Kevin Stitt,REP,550256,0,0,0,0,
Oklahoma,Governor,Drew Edmondson,DEM,550256,0,0,0,0,
Oklahoma,Lieutenant Governor,Matt Pinnell,REP,550256,0,0,0,0,
Oklahoma,Lieutenant Governor,Anastasia Pittman,DEM,550256,0,0,0,0,
Oklahoma,Lieutenant Governor,Ivan Holmes,IND,550256,0,0,0,0,
Oklahoma,State Auditor,John Yeutter,LIB,550256,0,0,0,0,
Oklahoma,State Auditor,Cindy Byrd,REP,550256,0,0,0,0,
Oklahoma,Attorney General,Mike Hunter,REP,550256,0,0,0,0,
Oklahoma,Attorney General,Mark Myles,DEM,550256,0,0,0,0,
Oklahoma,State Treasurer,Randy Mcdaniel,REP,550256,0,0,0,0,
Oklahoma,State Treasurer,Charles De Coune,IND,550256,0,0,0,0,
Oklahoma,Superintendent of Public Instruction,Joy Hofmeister,REP,550256,0,0,0,0,
Oklahoma,Superintendent of Public Instruction,John Cox,DEM,550256,0,0,0,0,
Oklahoma,Superintendent of Public Instruction,Larry Huff,IND,550256,0,0,0,0,
Oklahoma,Commissioner of Labor,Leslie Osborn,REP,550256,0,0,0,0,
Oklahoma,Commissioner of Labor,Fred Dorrell,DEM,550256,0,0,0,0,
Oklahoma,Commissioner of Labor,Brandt Dismukes,IND,550256,0,0,0,0,
Oklahoma,Insurance Commissioner,Glen Mulready,REP,550256,0,0,0,0,
Oklahoma,Insurance Commissioner,Kimberly Fobbs,DEM,550256,0,0,0,0,
Oklahoma,Corporation Commissioner,Bob Anthony,REP,550256,0,0,0,0,
Oklahoma,Corporation Commissioner,Ashley Nicole Mccray,DEM,550256,0,0,0,0,
Oklahoma,Corporation Commissioner,Jackie Short,IND,550256,0,0,0,0,
Oklahoma,U.S. House,Steve Russell,REP,550256,0,0,0,0,5
Oklahoma,U.S. House,Kendra Horn,DEM,550256,0,0,0,0,5
Oklahoma,State Senate,Stephanie Bice,REP,550256,0,0,0,0,22
Oklahoma,State Senate,William Andrews,DEM,550256,0,0,0,0,22
Oklahoma,State House,Garry Mize,REP,550256,0,0,0,0,31
Oklahoma,State House,Kara Sawyer,DEM,550256,0,0,0,0,31
Oklahoma,Governor,Chris Powell,LIB,550257,0,0,1,1,
Oklahoma,Governor,Kevin Stitt,REP,550257,0,0,27,27,
Oklahoma,Governor,Drew Edmondson,DEM,550257,0,0,77,77,
Oklahoma,Lieutenant Governor,Matt Pinnell,REP,550257,0,0,28,28,
Oklahoma,Lieutenant Governor,Anastasia Pittman,DEM,550257,0,0,72,72,
Oklahoma,Lieutenant Governor,Ivan Holmes,IND,550257,0,0,5,5,
Oklahoma,State Auditor,John Yeutter,LIB,550257,0,0,41,41,
Oklahoma,State Auditor,Cindy Byrd,REP,550257,0,0,42,42,
Oklahoma,Attorney General,Mike Hunter,REP,550257,0,0,33,33,
Oklahoma,Attorney General,Mark Myles,DEM,550257,0,0,71,71,
Oklahoma,State Treasurer,Randy Mcdaniel,REP,550257,0,0,41,41,
Oklahoma,State Treasurer,Charles De Coune,IND,550257,0,0,40,40,
Oklahoma,Superintendent of Public Instruction,Joy Hofmeister,REP,550257,0,0,36,36,
Oklahoma,Superintendent of Public Instruction,John Cox,DEM,550257,0,0,63,63,
Oklahoma,Superintendent of Public Instruction,Larry Huff,IND,550257,0,0,6,6,
Oklahoma,Commissioner of Labor,Leslie Osborn,REP,550257,0,0,33,33,
Oklahoma,Commissioner of Labor,Fred Dorrell,DEM,550257,0,0,69,69,
Oklahoma,Commissioner of Labor,Brandt Dismukes,IND,550257,0,0,2,2,
Oklahoma,Insurance Commissioner,Glen Mulready,REP,550257,0,0,29,29,
Oklahoma,Insurance Commissioner,Kimberly Fobbs,DEM,550257,0,0,74,74,
Oklahoma,Corporation Commissioner,Bob Anthony,REP,550257,0,0,32,32,
Oklahoma,Corporation Commissioner,Ashley Nicole Mccray,DEM,550257,0,0,68,68,
Oklahoma,Corporation Commissioner,Jackie Short,IND,550257,0,0,3,3,
Oklahoma,U.S. House,Steve Russell,REP,550257,0,0,30,30,5
Oklahoma,U.S. House,Kendra Horn,DEM,550257,0,0,75,75,5
Oklahoma,State Senate,Willard Linzy,REP,550257,0,0,27,27,48
Oklahoma,State Senate,George Young,DEM,550257,0,0,76,76,48
Oklahoma,Governor,Chris Powell,LIB,559999,584,297,0,881,
Oklahoma,Governor,Kevin Stitt,REP,559999,9008,5567,0,14575,
Oklahoma,Governor,Drew Edmondson,DEM,559999,13018,10013,0,23031,
Oklahoma,Lieutenant Governor,Matt Pinnell,REP,559999,10648,6535,1,17184,
Oklahoma,Lieutenant Governor,Anastasia Pittman,DEM,559999,11061,8760,0,19821,
Oklahoma,Lieutenant Governor,Ivan Holmes,IND,559999,735,493,0,1228,
Oklahoma,State Auditor,John Yeutter,LIB,559999,5772,5037,0,10809,
Oklahoma,State Auditor,Cindy Byrd,REP,559999,13696,8516,1,22213,
Oklahoma,Attorney General,Mike Hunter,REP,559999,11251,6953,1,18205,
Oklahoma,Attorney General,Mark Myles,DEM,559999,11104,8822,0,19926,
Oklahoma,State Treasurer,Randy Mcdaniel,REP,559999,12204,7338,1,19543,
Oklahoma,State Treasurer,Charles De Coune,IND,559999,7454,6435,0,13889,
Oklahoma,Superintendent of Public Instruction,Joy Hofmeister,REP,559999,11168,7006,1,18175,
Oklahoma,Superintendent of Public Instruction,John Cox,DEM,559999,9837,7870,0,17707,
Oklahoma,Superintendent of Public Instruction,Larry Huff,IND,559999,1330,887,0,2217,
Oklahoma,Commissioner of Labor,Leslie Osborn,REP,559999,11628,6978,1,18607,
Oklahoma,Commissioner of Labor,Fred Dorrell,DEM,559999,9772,8150,0,17922,
Oklahoma,Commissioner of Labor,Brandt Dismukes,IND,559999,771,530,0,1301,
Oklahoma,Insurance Commissioner,Glen Mulready,REP,559999,10606,6504,1,17111,
Oklahoma,Insurance Commissioner,Kimberly Fobbs,DEM,559999,11452,9134,0,20586,
Oklahoma,Corporation Commissioner,Bob Anthony,REP,559999,11104,6714,1,17819,
Oklahoma,Corporation Commissioner,Ashley Nicole Mccray,DEM,559999,10121,8390,0,18511,
Oklahoma,Corporation Commissioner,Jackie Short,IND,559999,1068,612,0,1680,
Oklahoma,U.S. House,Tom Cole,REP,559999,793,295,0,1088,4
Oklahoma,U.S. House,Mary Brannon,DEM,559999,578,479,0,1057,4
Oklahoma,U.S. House,Ruby Peters,IND,559999,41,20,0,61,4
Oklahoma,U.S. House,Steve Russell,REP,559999,9772,5994,1,15767,5
Oklahoma,U.S. House,Kendra Horn,DEM,559999,11326,9053,0,20379,5
Oklahoma,State Senate,Stephanie Bice,REP,559999,1150,813,1,1964,22
Oklahoma,State Senate,William Andrews,DEM,559999,784,652,0,1436,22
Oklahoma,State Senate,John Symcox,REP,559999,831,319,0,1150,30
Oklahoma,State Senate,Julia Kirt,DEM,559999,1222,648,0,1870,30
Oklahoma,State Senate,Joe Howell,REP,559999,944,489,0,1433,40
Oklahoma,State Senate,Carri Hicks,DEM,559999,1680,1062,0,2742,40
Oklahoma,State Senate,Christopher Hensley,IND,559999,58,30,0,88,40
Oklahoma,State Senate,Brenda Stanley,REP,559999,863,305,0,1168,42
Oklahoma,State Senate,Linda Wade,DEM,559999,759,583,0,1342,42
Oklahoma,State Senate,Matt Campbell,IND,559999,89,29,0,118,42
Oklahoma,State Senate,Willard Linzy,REP,559999,355,245,0,600,48
Oklahoma,State Senate,George Young,DEM,559999,1356,2293,0,3649,48
Oklahoma,State House,Garry Mize,REP,559999,200,186,1,387,31
Oklahoma,State House,Kara Sawyer,DEM,559999,124,56,0,180,31
Oklahoma,State House,Ryan Martinez,REP,559999,1114,1018,0,2132,39
Oklahoma,State House,Devyn Denton,DEM,559999,811,652,0,1463,39
Oklahoma,State House,Richard Prawdzienski,IND,559999,57,47,0,104,39
Oklahoma,State House,Denise Crosswhite Hader,REP,559999,224,64,0,288,41
Oklahoma,State House,Jennie Scott,DEM,559999,150,84,0,234,41
Oklahoma,State House,Kevin West,REP,559999,40,9,0,49,54
Oklahoma,State House,Katelyn Dockery,DEM,559999,32,18,0,50,54
Oklahoma,State House,Mike Osburn,REP,559999,744,912,0,1656,81
Oklahoma,State House,Jackie Phillips,DEM,559999,763,723,0,1486,81
Oklahoma,State House,Nicole Miller,REP,559999,1501,801,0,2302,82
Oklahoma,State House,Oraynab Jwayyed,DEM,559999,962,665,0,1627,82
Oklahoma,State House,Jason Reese,REP,559999,830,488,0,1318,83
Oklahoma,State House,Chelsey Branham,DEM,559999,1076,818,0,1894,83
Oklahoma,State House,William Cagle,LIB,559999,33,7,0,40,84
Oklahoma,State House,Tammy West,REP,559999,374,145,0,519,84
Oklahoma,State House,Lauren Morris,DEM,559999,350,154,0,504,84
Oklahoma,State House,Stephen Paulsen,LIB,559999,25,12,0,37,85
Oklahoma,State House,Matt Jackson,REP,559999,781,364,0,1145,85
Oklahoma,State House,Cyndi Munson,DEM,559999,1388,794,0,2182,85
Oklahoma,State House,Jon Echols,REP,559999,231,79,0,310,90
Oklahoma,State House,Lavelle Compton,DEM,559999,195,106,0,301,90
Oklahoma,State House,Jason Sansone,REP,559999,279,118,0,397,94
Oklahoma,State House,Andy Fugate,DEM,559999,488,317,0,805,94
Oklahoma,State House,Paul Brewbaker,LIB,559999,13,3,0,16,95
Oklahoma,State House,Jack Beall Jr,REP,559999,283,134,0,417,95
Oklahoma,State House,Kelly Albright,DEM,559999,333,296,0,629,95
Oklahoma,State House,Rashard Bickham,IND,559999,21,16,0,37,95
Oklahoma,State House,Lewis Moore,REP,559999,983,795,0,1778,96
Oklahoma,State House,Kathy Wallis,DEM,559999,914,531,0,1445,96
Oklahoma,State House,Marilyn Stark,REP,559999,722,253,0,975,10
Oklahoma,State House,Zach Pearson,DEM,559999,639,353,0,992,10
Oklahoma,State House,Robert Manger,REP,559999,633,188,0,821,10
Oklahoma,State House,John Carpenter,DEM,559999,487,263,0,750,10
Okmulgee,Governor,Chris Powell,LIB,560004,1,0,0,1,
Okmulgee,Governor,Kevin Stitt,REP,560004,1,2,39,42,
Okmulgee,Governor,Drew Edmondson,DEM,560004,0,4,37,41,
Okmulgee,Lieutenant Governor,Matt Pinnell,REP,560004,1,3,41,45,
Okmulgee,Lieutenant Governor,Anastasia Pittman,DEM,560004,0,3,30,33,
Okmulgee,Lieutenant Governor,Ivan Holmes,IND,560004,0,0,4,4,
Okmulgee,State Auditor,John Yeutter,LIB,560004,0,1,16,17,
Okmulgee,State Auditor,Cindy Byrd,REP,560004,2,4,49,55,
Okmulgee,Attorney General,Mike Hunter,REP,560004,2,4,40,46,
Okmulgee,Attorney General,Mark Myles,DEM,560004,0,2,35,37,
Okmulgee,State Treasurer,Randy Mcdaniel,REP,560004,1,4,42,47,
Okmulgee,State Treasurer,Charles De Coune,IND,560004,0,1,21,22,
Okmulgee,Superintendent of Public Instruction,Joy Hofmeister,REP,560004,1,3,37,41,
Okmulgee,Superintendent of Public Instruction,John Cox,DEM,560004,0,2,34,36,
Okmulgee,Superintendent of Public Instruction,Larry Huff,IND,560004,1,1,4,6,
Okmulgee,Commissioner of Labor,Leslie Osborn,REP,560004,1,3,39,43,
Okmulgee,Commissioner of Labor,Fred Dorrell,DEM,560004,0,3,33,36,
Okmulgee,Commissioner of Labor,Brandt Dismukes,IND,560004,0,0,3,3,
Okmulgee,Insurance Commissioner,Glen Mulready,REP,560004,1,3,42,46,
Okmulgee,Insurance Commissioner,Kimberly Fobbs,DEM,560004,0,3,33,36,
Okmulgee,Corporation Commissioner,Bob Anthony,REP,560004,2,4,36,42,
Okmulgee,Corporation Commissioner,Ashley Nicole Mccray,DEM,560004,0,2,34,36,
Okmulgee,Corporation Commissioner,Jackie Short,IND,560004,0,0,4,4,
Okmulgee,U.S. House,Richard Castaldo,LIB,560004,0,0,0,0,2
Okmulgee,U.S. House,Markwayne Mullin,REP,560004,1,5,43,49,2
Okmulgee,U.S. House,Jason Nichols,DEM,560004,0,1,32,33,2
Okmulgee,U.S. House,John Foreman,IND,560004,1,0,1,2,2
Okmulgee,State Senate,Roger Thompson,REP,560004,2,5,39,46,8
Okmulgee,State Senate,Shannan Tucker,DEM,560004,0,1,35,36,8
Okmulgee,State Senate,Marlena Nobles,IND,560004,0,0,2,2,8
Okmulgee,State House,Scott Fetgatter,REP,560004,2,3,42,47,16
Okmulgee,State House,Chandler Torbett,DEM,560004,0,3,31,34,16
Okmulgee,State House,James Delso,IND,560004,0,0,3,3,16
Okmulgee,Governor,Chris Powell,LIB,560007,0,1,10,11,
Okmulgee,Governor,Kevin Stitt,REP,560007,4,21,138,163,
Okmulgee,Governor,Drew Edmondson,DEM,560007,6,37,112,155,
Okmulgee,Lieutenant Governor,Matt Pinnell,REP,560007,4,28,150,182,
Okmulgee,Lieutenant Governor,Anastasia Pittman,DEM,560007,6,30,101,137,
Okmulgee,Lieutenant Governor,Ivan Holmes,IND,560007,0,0,8,8,
Okmulgee,State Auditor,John Yeutter,LIB,560007,0,16,68,84,
Okmulgee,State Auditor,Cindy Byrd,REP,560007,6,38,173,217,
Okmulgee,Attorney General,Mike Hunter,REP,560007,4,29,164,197,
Okmulgee,Attorney General,Mark Myles,DEM,560007,6,27,94,127,
Okmulgee,State Treasurer,Randy Mcdaniel,REP,560007,3,31,171,205,
Okmulgee,State Treasurer,Charles De Coune,IND,560007,4,21,71,96,
Okmulgee,Superintendent of Public Instruction,Joy Hofmeister,REP,560007,3,26,159,188,
Okmulgee,Superintendent of Public Instruction,John Cox,DEM,560007,6,29,81,116,
Okmulgee,Superintendent of Public Instruction,Larry Huff,IND,560007,1,3,17,21,
Okmulgee,Commissioner of Labor,Leslie Osborn,REP,560007,3,29,150,182,
Okmulgee,Commissioner of Labor,Fred Dorrell,DEM,560007,5,24,99,128,
Okmulgee,Commissioner of Labor,Brandt Dismukes,IND,560007,2,3,7,12,
Okmulgee,Insurance Commissioner,Glen Mulready,REP,560007,4,29,156,189,
Okmulgee,Insurance Commissioner,Kimberly Fobbs,DEM,560007,6,27,98,131,
Okmulgee,Corporation Commissioner,Bob Anthony,REP,560007,3,31,155,189,
Okmulgee,Corporation Commissioner,Ashley Nicole Mccray,DEM,560007,6,24,87,117,
Okmulgee,Corporation Commissioner,Jackie Short,IND,560007,1,1,14,16,
Okmulgee,U.S. House,Richard Castaldo,LIB,560007,0,1,3,4,2
Okmulgee,U.S. House,Markwayne Mullin,REP,560007,3,27,145,175,2
Okmulgee,U.S. House,Jason Nichols,DEM,560007,6,30,104,140,2
Okmulgee,U.S. House,John Foreman,IND,560007,1,0,6,7,2
Okmulgee,State Senate,Roger Thompson,REP,560007,3,27,153,183,8
Okmulgee,State Senate,Shannan Tucker,DEM,560007,6,29,92,127,8
Okmulgee,State Senate,Marlena Nobles,IND,560007,1,1,11,13,8
Okmulgee,State House,Scott Fetgatter,REP,560007,1,23,150,174,16
Okmulgee,State House,Chandler Torbett,DEM,560007,8,33,107,148,16
Okmulgee,State House,James Delso,IND,560007,1,1,3,5,16
Okmulgee,Governor,Chris Powell,LIB,560008,1,2,26,29,
Okmulgee,Governor,Kevin Stitt,REP,560008,9,62,256,327,
Okmulgee,Governor,Drew Edmondson,DEM,560008,9,36,282,327,
Okmulgee,Lieutenant Governor,Matt Pinnell,REP,560008,9,65,297,371,
Okmulgee,Lieutenant Governor,Anastasia Pittman,DEM,560008,9,31,240,280,
Okmulgee,Lieutenant Governor,Ivan Holmes,IND,560008,1,5,26,32,
Okmulgee,State Auditor,John Yeutter,LIB,560008,4,30,179,213,
Okmulgee,State Auditor,Cindy Byrd,REP,560008,14,62,341,417,
Okmulgee,Attorney General,Mike Hunter,REP,560008,10,63,301,374,
Okmulgee,Attorney General,Mark Myles,DEM,560008,9,38,262,309,
Okmulgee,State Treasurer,Randy Mcdaniel,REP,560008,12,63,332,407,
Okmulgee,State Treasurer,Charles De Coune,IND,560008,7,31,187,225,
Okmulgee,Superintendent of Public Instruction,Joy Hofmeister,REP,560008,11,59,279,349,
Okmulgee,Superintendent of Public Instruction,John Cox,DEM,560008,7,33,241,281,
Okmulgee,Superintendent of Public Instruction,Larry Huff,IND,560008,1,8,43,52,
Okmulgee,Commissioner of Labor,Leslie Osborn,REP,560008,11,60,274,345,
Okmulgee,Commissioner of Labor,Fred Dorrell,DEM,560008,8,34,258,300,
Okmulgee,Commissioner of Labor,Brandt Dismukes,IND,560008,0,7,29,36,
Okmulgee,Insurance Commissioner,Glen Mulready,REP,560008,10,61,285,356,
Okmulgee,Insurance Commissioner,Kimberly Fobbs,DEM,560008,9,40,273,322,
Okmulgee,Corporation Commissioner,Bob Anthony,REP,560008,9,62,272,343,
Okmulgee,Corporation Commissioner,Ashley Nicole Mccray,DEM,560008,8,30,259,297,
Okmulgee,Corporation Commissioner,Jackie Short,IND,560008,2,9,29,40,
Okmulgee,U.S. House,Richard Castaldo,LIB,560008,0,2,11,13,2
Okmulgee,U.S. House,Markwayne Mullin,REP,560008,12,60,288,360,2
Okmulgee,U.S. House,Jason Nichols,DEM,560008,7,36,243,286,2
Okmulgee,U.S. House,John Foreman,IND,560008,0,3,23,26,2
Okmulgee,State Senate,Roger Thompson,REP,560008,11,61,283,355,8
Okmulgee,State Senate,Shannan Tucker,DEM,560008,8,36,254,298,8
Okmulgee,State Senate,Marlena Nobles,IND,560008,0,4,27,31,8
Okmulgee,State House,Scott Fetgatter,REP,560008,12,62,269,343,16
Okmulgee,State House,Chandler Torbett,DEM,560008,7,38,273,318,16
Okmulgee,State House,James Delso,IND,560008,0,1,24,25,16
Okmulgee,Governor,Chris Powell,LIB,560009,0,3,14,17,
Okmulgee,Governor,Kevin Stitt,REP,560009,6,34,114,154,
Okmulgee,Governor,Drew Edmondson,DEM,560009,26,127,404,557,
Okmulgee,Lieutenant Governor,Matt Pinnell,REP,560009,7,40,117,164,
Okmulgee,Lieutenant Governor,Anastasia Pittman,DEM,560009,16,120,393,529,
Okmulgee,Lieutenant Governor,Ivan Holmes,IND,560009,9,3,24,36,
Okmulgee,State Auditor,John Yeutter,LIB,560009,17,71,301,389,
Okmulgee,State Auditor,Cindy Byrd,REP,560009,9,61,158,228,
Okmulgee,Attorney General,Mike Hunter,REP,560009,8,46,129,183,
Okmulgee,Attorney General,Mark Myles,DEM,560009,24,117,403,544,
Okmulgee,State Treasurer,Randy Mcdaniel,REP,560009,8,49,152,209,
Okmulgee,State Treasurer,Charles De Coune,IND,560009,19,84,306,409,
Okmulgee,Superintendent of Public Instruction,Joy Hofmeister,REP,560009,6,36,121,163,
Okmulgee,Superintendent of Public Instruction,John Cox,DEM,560009,25,119,377,521,
Okmulgee,Superintendent of Public Instruction,Larry Huff,IND,560009,1,9,34,44,
Okmulgee,Commissioner of Labor,Leslie Osborn,REP,560009,8,37,120,165,
Okmulgee,Commissioner of Labor,Fred Dorrell,DEM,560009,23,124,393,540,
Okmulgee,Commissioner of Labor,Brandt Dismukes,IND,560009,1,3,19,23,
Okmulgee,Insurance Commissioner,Glen Mulready,REP,560009,6,42,129,177,
Okmulgee,Insurance Commissioner,Kimberly Fobbs,DEM,560009,26,118,402,546,
Okmulgee,Corporation Commissioner,Bob Anthony,REP,560009,7,37,124,168,
Okmulgee,Corporation Commissioner,Ashley Nicole Mccray,DEM,560009,23,122,390,535,
Okmulgee,Corporation Commissioner,Jackie Short,IND,560009,2,5,17,24,
Okmulgee,U.S. House,Richard Castaldo,LIB,560009,1,1,10,12,2
Okmulgee,U.S. House,Markwayne Mullin,REP,560009,6,37,121,164,2
Okmulgee,U.S. House,Jason Nichols,DEM,560009,24,120,387,531,2
Okmulgee,U.S. House,John Foreman,IND,560009,1,6,15,22,2
Okmulgee,State Senate,Roger Thompson,REP,560009,6,41,123,170,8
Okmulgee,State Senate,Shannan Tucker,DEM,560009,24,118,394,536,8
Okmulgee,State Senate,Marlena Nobles,IND,560009,2,5,16,23,8
Okmulgee,State House,Scott Fetgatter,REP,560009,6,48,118,172,16
Okmulgee,State House,Chandler Torbett,DEM,560009,25,113,401,539,16
Okmulgee,State House,James Delso,IND,560009,1,3,14,18,16
Okmulgee,Governor,Chris Powell,LIB,560010,0,0,5,5,
Okmulgee,Governor,Kevin Stitt,REP,560010,2,11,113,126,
Okmulgee,Governor,Drew Edmondson,DEM,560010,2,9,58,69,
Okmulgee,Lieutenant Governor,Matt Pinnell,REP,560010,2,12,122,136,
Okmulgee,Lieutenant Governor,Anastasia Pittman,DEM,560010,2,7,44,53,
Okmulgee,Lieutenant Governor,Ivan Holmes,IND,560010,0,1,7,8,
Okmulgee,State Auditor,John Yeutter,LIB,560010,1,3,29,33,
Okmulgee,State Auditor,Cindy Byrd,REP,560010,2,16,130,148,
Okmulgee,Attorney General,Mike Hunter,REP,560010,2,16,125,143,
Okmulgee,Attorney General,Mark Myles,DEM,560010,2,4,46,52,
Okmulgee,State Treasurer,Randy Mcdaniel,REP,560010,2,17,129,148,
Okmulgee,State Treasurer,Charles De Coune,IND,560010,1,2,29,32,
Okmulgee,Superintendent of Public Instruction,Joy Hofmeister,REP,560010,2,12,111,125,
Okmulgee,Superintendent of Public Instruction,John Cox,DEM,560010,2,5,50,57,
Okmulgee,Superintendent of Public Instruction,Larry Huff,IND,560010,0,3,14,17,
Okmulgee,Commissioner of Labor,Leslie Osborn,REP,560010,2,15,113,130,
Okmulgee,Commissioner of Labor,Fred Dorrell,DEM,560010,2,5,51,58,
Okmulgee,Commissioner of Labor,Brandt Dismukes,IND,560010,0,0,8,8,
Okmulgee,Insurance Commissioner,Glen Mulready,REP,560010,2,15,126,143,
Okmulgee,Insurance Commissioner,Kimberly Fobbs,DEM,560010,2,5,45,52,
Okmulgee,Corporation Commissioner,Bob Anthony,REP,560010,2,12,119,133,
Okmulgee,Corporation Commissioner,Ashley Nicole Mccray,DEM,560010,2,6,42,50,
Okmulgee,Corporation Commissioner,Jackie Short,IND,560010,0,1,11,12,
Okmulgee,U.S. House,Richard Castaldo,LIB,560010,0,0,1,1,2
Okmulgee,U.S. House,Markwayne Mullin,REP,560010,2,13,124,139,2
Okmulgee,U.S. House,Jason Nichols,DEM,560010,2,7,45,54,2
Okmulgee,U.S. House,John Foreman,IND,560010,0,0,6,6,2
Okmulgee,State Senate,Roger Thompson,REP,560010,2,15,130,147,8
Okmulgee,State Senate,Shannan Tucker,DEM,560010,2,4,40,46,8
Okmulgee,State Senate,Marlena Nobles,IND,560010,0,1,5,6,8
Okmulgee,State House,Logan Phillips,REP,560010,2,13,100,115,24
Okmulgee,State House,Steve Kouplen,DEM,560010,2,7,71,80,24
Okmulgee,Governor,Chris Powell,LIB,560011,1,6,24,31,
Okmulgee,Governor,Kevin Stitt,REP,560011,24,103,419,546,
Okmulgee,Governor,Drew Edmondson,DEM,560011,15,78,409,502,
Okmulgee,Lieutenant Governor,Matt Pinnell,REP,560011,26,109,470,605,
Okmulgee,Lieutenant Governor,Anastasia Pittman,DEM,560011,13,72,346,431,
Okmulgee,Lieutenant Governor,Ivan Holmes,IND,560011,1,2,31,34,
Okmulgee,State Auditor,John Yeutter,LIB,560011,6,53,244,303,
Okmulgee,State Auditor,Cindy Byrd,REP,560011,27,116,523,666,
Okmulgee,Attorney General,Mike Hunter,REP,560011,24,109,490,623,
Okmulgee,Attorney General,Mark Myles,DEM,560011,16,73,357,446,
Okmulgee,State Treasurer,Randy Mcdaniel,REP,560011,26,122,512,660,
Okmulgee,State Treasurer,Charles De Coune,IND,560011,8,47,259,314,
Okmulgee,Superintendent of Public Instruction,Joy Hofmeister,REP,560011,23,100,444,567,
Okmulgee,Superintendent of Public Instruction,John Cox,DEM,560011,15,76,343,434,
Okmulgee,Superintendent of Public Instruction,Larry Huff,IND,560011,1,7,61,69,
Okmulgee,Commissioner of Labor,Leslie Osborn,REP,560011,25,106,443,574,
Okmulgee,Commissioner of Labor,Fred Dorrell,DEM,560011,14,67,351,432,
Okmulgee,Commissioner of Labor,Brandt Dismukes,IND,560011,0,7,41,48,
Okmulgee,Insurance Commissioner,Glen Mulready,REP,560011,26,104,462,592,
Okmulgee,Insurance Commissioner,Kimberly Fobbs,DEM,560011,14,81,374,469,
Okmulgee,Corporation Commissioner,Bob Anthony,REP,560011,25,109,449,583,
Okmulgee,Corporation Commissioner,Ashley Nicole Mccray,DEM,560011,14,69,353,436,
Okmulgee,Corporation Commissioner,Jackie Short,IND,560011,1,5,37,43,
Okmulgee,U.S. House,Richard Castaldo,LIB,560011,1,1,15,17,2
Okmulgee,U.S. House,Markwayne Mullin,REP,560011,24,108,464,596,2
Okmulgee,U.S. House,Jason Nichols,DEM,560011,14,74,344,432,2
Okmulgee,U.S. House,John Foreman,IND,560011,1,3,28,32,2
Okmulgee,State Senate,Roger Thompson,REP,560011,25,112,470,607,8
Okmulgee,State Senate,Shannan Tucker,DEM,560011,13,69,349,431,8
Okmulgee,State Senate,Marlena Nobles,IND,560011,2,5,29,36,8
Okmulgee,State House,Scott Fetgatter,REP,560011,21,94,408,523,16
Okmulgee,State House,Chandler Torbett,DEM,560011,17,85,421,523,16
Okmulgee,State House,James Delso,IND,560011,2,5,23,30,16
Okmulgee,Governor,Chris Powell,LIB,560013,0,0,11,11,
Okmulgee,Governor,Kevin Stitt,REP,560013,1,4,135,140,
Okmulgee,Governor,Drew Edmondson,DEM,560013,2,2,136,140,
Okmulgee,Lieutenant Governor,Matt Pinnell,REP,560013,1,5,152,158,
Okmulgee,Lieutenant Governor,Anastasia Pittman,DEM,560013,2,1,116,119,
Okmulgee,Lieutenant Governor,Ivan Holmes,IND,560013,0,0,10,10,
Okmulgee,State Auditor,John Yeutter,LIB,560013,0,1,67,68,
Okmulgee,State Auditor,Cindy Byrd,REP,560013,2,5,181,188,
Okmulgee,Attorney General,Mike Hunter,REP,560013,1,4,161,166,
Okmulgee,Attorney General,Mark Myles,DEM,560013,1,2,119,122,
Okmulgee,State Treasurer,Randy Mcdaniel,REP,560013,1,4,180,185,
Okmulgee,State Treasurer,Charles De Coune,IND,560013,0,1,66,67,
Okmulgee,Superintendent of Public Instruction,Joy Hofmeister,REP,560013,3,3,145,151,
Okmulgee,Superintendent of Public Instruction,John Cox,DEM,560013,0,3,117,120,
Okmulgee,Superintendent of Public Instruction,Larry Huff,IND,560013,0,0,19,19,
Okmulgee,Commissioner of Labor,Leslie Osborn,REP,560013,1,4,146,151,
Okmulgee,Commissioner of Labor,Fred Dorrell,DEM,560013,1,1,122,124,
Okmulgee,Commissioner of Labor,Brandt Dismukes,IND,560013,0,1,10,11,
Okmulgee,Insurance Commissioner,Glen Mulready,REP,560013,1,4,149,154,
Okmulgee,Insurance Commissioner,Kimberly Fobbs,DEM,560013,1,1,129,131,
Okmulgee,Corporation Commissioner,Bob Anthony,REP,560013,2,4,138,144,
Okmulgee,Corporation Commissioner,Ashley Nicole Mccray,DEM,560013,0,0,127,127,
Okmulgee,Corporation Commissioner,Jackie Short,IND,560013,0,1,12,13,
Okmulgee,U.S. House,Richard Castaldo,LIB,560013,0,0,5,5,2
Okmulgee,U.S. House,Markwayne Mullin,REP,560013,1,4,145,150,2
Okmulgee,U.S. House,Jason Nichols,DEM,560013,2,1,125,128,2
Okmulgee,U.S. House,John Foreman,IND,560013,0,1,5,6,2
Okmulgee,State Senate,Roger Thompson,REP,560013,1,5,150,156,8
Okmulgee,State Senate,Shannan Tucker,DEM,560013,1,1,119,121,8
Okmulgee,State Senate,Marlena Nobles,IND,560013,0,0,12,12,8
Okmulgee,State House,Scott Fetgatter,REP,560013,2,4,133,139,16
Okmulgee,State House,Chandler Torbett,DEM,560013,0,2,129,131,16
Okmulgee,State House,James Delso,IND,560013,0,0,17,17,16
Okmulgee,Governor,Chris Powell,LIB,560014,1,0,14,15,
Okmulgee,Governor,Kevin Stitt,REP,560014,3,2,89,94,
Okmulgee,Governor,Drew Edmondson,DEM,560014,5,2,97,104,
Okmulgee,Lieutenant Governor,Matt Pinnell,REP,560014,5,2,98,105,
Okmulgee,Lieutenant Governor,Anastasia Pittman,DEM,560014,3,2,89,94,
Okmulgee,Lieutenant Governor,Ivan Holmes,IND,560014,1,0,12,13,
Okmulgee,State Auditor,John Yeutter,LIB,560014,2,2,67,71,
Okmulgee,State Auditor,Cindy Byrd,REP,560014,5,2,122,129,
Okmulgee,Attorney General,Mike Hunter,REP,560014,4,2,106,112,
Okmulgee,Attorney General,Mark Myles,DEM,560014,5,2,93,100,
Okmulgee,State Treasurer,Randy Mcdaniel,REP,560014,5,2,123,130,
Okmulgee,State Treasurer,Charles De Coune,IND,560014,2,2,64,68,
Okmulgee,Superintendent of Public Instruction,Joy Hofmeister,REP,560014,4,1,94,99,
Okmulgee,Superintendent of Public Instruction,John Cox,DEM,560014,4,3,82,89,
Okmulgee,Superintendent of Public Instruction,Larry Huff,IND,560014,1,0,23,24,
Okmulgee,Commissioner of Labor,Leslie Osborn,REP,560014,5,1,95,101,
Okmulgee,Commissioner of Labor,Fred Dorrell,DEM,560014,3,2,92,97,
Okmulgee,Commissioner of Labor,Brandt Dismukes,IND,560014,1,0,12,13,
Okmulgee,Insurance Commissioner,Glen Mulready,REP,560014,3,1,102,106,
Okmulgee,Insurance Commissioner,Kimberly Fobbs,DEM,560014,6,3,97,106,
Okmulgee,Corporation Commissioner,Bob Anthony,REP,560014,5,2,98,105,
Okmulgee,Corporation Commissioner,Ashley Nicole Mccray,DEM,560014,4,2,89,95,
Okmulgee,Corporation Commissioner,Jackie Short,IND,560014,0,0,11,11,
Okmulgee,U.S. House,Richard Castaldo,LIB,560014,0,0,6,6,2
Okmulgee,U.S. House,Markwayne Mullin,REP,560014,4,2,108,114,2
Okmulgee,U.S. House,Jason Nichols,DEM,560014,4,2,76,82,2
Okmulgee,U.S. House,John Foreman,IND,560014,1,0,7,8,2
Okmulgee,State Senate,Roger Thompson,REP,560014,4,2,100,106,8
Okmulgee,State Senate,Shannan Tucker,DEM,560014,3,2,87,92,8
Okmulgee,State Senate,Marlena Nobles,IND,560014,2,0,11,13,8
Okmulgee,State House,Scott Fetgatter,REP,560014,4,2,91,97,16
Okmulgee,State House,Chandler Torbett,DEM,560014,3,2,92,97,16
Okmulgee,State House,James Delso,IND,560014,2,0,14,16,16
Okmulgee,Governor,Chris Powell,LIB,560015,0,1,12,13,
Okmulgee,Governor,Kevin Stitt,REP,560015,15,11,262,288,
Okmulgee,Governor,Drew Edmondson,DEM,560015,8,16,282,306,
Okmulgee,Lieutenant Governor,Matt Pinnell,REP,560015,17,11,312,340,
Okmulgee,Lieutenant Governor,Anastasia Pittman,DEM,560015,5,14,225,244,
Okmulgee,Lieutenant Governor,Ivan Holmes,IND,560015,1,2,18,21,
Okmulgee,State Auditor,John Yeutter,LIB,560015,2,8,154,164,
Okmulgee,State Auditor,Cindy Byrd,REP,560015,17,14,361,392,
Okmulgee,Attorney General,Mike Hunter,REP,560015,15,15,314,344,
Okmulgee,Attorney General,Mark Myles,DEM,560015,8,13,233,254,
Okmulgee,State Treasurer,Randy Mcdaniel,REP,560015,17,12,342,371,
Okmulgee,State Treasurer,Charles De Coune,IND,560015,3,11,169,183,
Okmulgee,Superintendent of Public Instruction,Joy Hofmeister,REP,560015,12,13,300,325,
Okmulgee,Superintendent of Public Instruction,John Cox,DEM,560015,9,12,220,241,
Okmulgee,Superintendent of Public Instruction,Larry Huff,IND,560015,2,2,32,36,
Okmulgee,Commissioner of Labor,Leslie Osborn,REP,560015,16,12,289,317,
Okmulgee,Commissioner of Labor,Fred Dorrell,DEM,560015,6,13,224,243,
Okmulgee,Commissioner of Labor,Brandt Dismukes,IND,560015,1,1,29,31,
Okmulgee,Insurance Commissioner,Glen Mulready,REP,560015,13,11,301,325,
Okmulgee,Insurance Commissioner,Kimberly Fobbs,DEM,560015,9,15,246,270,
Okmulgee,Corporation Commissioner,Bob Anthony,REP,560015,16,8,285,309,
Okmulgee,Corporation Commissioner,Ashley Nicole Mccray,DEM,560015,6,14,238,258,
Okmulgee,Corporation Commissioner,Jackie Short,IND,560015,1,4,28,33,
Okmulgee,U.S. House,Richard Castaldo,LIB,560015,0,1,9,10,2
Okmulgee,U.S. House,Markwayne Mullin,REP,560015,17,12,302,331,2
Okmulgee,U.S. House,Jason Nichols,DEM,560015,6,13,233,252,2
Okmulgee,U.S. House,John Foreman,IND,560015,0,1,10,11,2
Okmulgee,State Senate,Roger Thompson,REP,560015,16,14,303,333,8
Okmulgee,State Senate,Shannan Tucker,DEM,560015,7,13,229,249,8
Okmulgee,State Senate,Marlena Nobles,IND,560015,0,0,21,21,8
Okmulgee,State House,Scott Fetgatter,REP,560015,15,12,270,297,16
Okmulgee,State House,Chandler Torbett,DEM,560015,6,15,263,284,16
Okmulgee,State House,James Delso,IND,560015,2,0,18,20,16
Okmulgee,Governor,Chris Powell,LIB,560016,0,4,11,15,
Okmulgee,Governor,Kevin Stitt,REP,560016,9,16,172,197,
Okmulgee,Governor,Drew Edmondson,DEM,560016,5,16,157,178,
Okmulgee,Lieutenant Governor,Matt Pinnell,REP,560016,9,19,197,225,
Okmulgee,Lieutenant Governor,Anastasia Pittman,DEM,560016,5,15,122,142,
Okmulgee,Lieutenant Governor,Ivan Holmes,IND,560016,0,2,18,20,
Okmulgee,State Auditor,John Yeutter,LIB,560016,3,11,84,98,
Okmulgee,State Auditor,Cindy Byrd,REP,560016,10,22,226,258,
Okmulgee,Attorney General,Mike Hunter,REP,560016,9,19,211,239,
Okmulgee,Attorney General,Mark Myles,DEM,560016,5,17,128,150,
Okmulgee,State Treasurer,Randy Mcdaniel,REP,560016,9,20,226,255,
Okmulgee,State Treasurer,Charles De Coune,IND,560016,4,13,88,105,
Okmulgee,Superintendent of Public Instruction,Joy Hofmeister,REP,560016,8,13,172,193,
Okmulgee,Superintendent of Public Instruction,John Cox,DEM,560016,6,17,142,165,
Okmulgee,Superintendent of Public Instruction,Larry Huff,IND,560016,0,6,27,33,
Okmulgee,Commissioner of Labor,Leslie Osborn,REP,560016,9,14,184,207,
Okmulgee,Commissioner of Labor,Fred Dorrell,DEM,560016,5,20,127,152,
Okmulgee,Commissioner of Labor,Brandt Dismukes,IND,560016,0,2,20,22,
Okmulgee,Insurance Commissioner,Glen Mulready,REP,560016,9,19,197,225,
Okmulgee,Insurance Commissioner,Kimberly Fobbs,DEM,560016,5,17,140,162,
Okmulgee,Corporation Commissioner,Bob Anthony,REP,560016,8,18,191,217,
Okmulgee,Corporation Commissioner,Ashley Nicole Mccray,DEM,560016,6,15,125,146,
Okmulgee,Corporation Commissioner,Jackie Short,IND,560016,0,3,20,23,
Okmulgee,U.S. House,Richard Castaldo,LIB,560016,0,1,8,9,2
Okmulgee,U.S. House,Markwayne Mullin,REP,560016,9,21,195,225,2
Okmulgee,U.S. House,Jason Nichols,DEM,560016,5,13,126,144,2
Okmulgee,U.S. House,John Foreman,IND,560016,0,1,9,10,2
Okmulgee,State Senate,Roger Thompson,REP,560016,9,21,197,227,8
Okmulgee,State Senate,Shannan Tucker,DEM,560016,5,12,129,146,8
Okmulgee,State Senate,Marlena Nobles,IND,560016,0,1,12,13,8
Okmulgee,State House,Logan Phillips,REP,560016,9,13,175,197,24
Okmulgee,State House,Steve Kouplen,DEM,560016,5,23,161,189,24
Okmulgee,Governor,Chris Powell,LIB,560018,0,0,10,10,
Okmulgee,Governor,Kevin Stitt,REP,560018,3,3,146,152,
Okmulgee,Governor,Drew Edmondson,DEM,560018,13,9,141,163,
Okmulgee,Lieutenant Governor,Matt Pinnell,REP,560018,4,7,163,174,
Okmulgee,Lieutenant Governor,Anastasia Pittman,DEM,560018,9,5,120,134,
Okmulgee,Lieutenant Governor,Ivan Holmes,IND,560018,2,0,10,12,
Okmulgee,State Auditor,John Yeutter,LIB,560018,2,4,75,81,
Okmulgee,State Auditor,Cindy Byrd,REP,560018,5,7,183,195,
Okmulgee,Attorney General,Mike Hunter,REP,560018,3,7,161,171,
Okmulgee,Attorney General,Mark Myles,DEM,560018,12,5,130,147,
Okmulgee,State Treasurer,Randy Mcdaniel,REP,560018,4,5,181,190,
Okmulgee,State Treasurer,Charles De Coune,IND,560018,3,6,77,86,
Okmulgee,Superintendent of Public Instruction,Joy Hofmeister,REP,560018,3,5,155,163,
Okmulgee,Superintendent of Public Instruction,John Cox,DEM,560018,11,6,119,136,
Okmulgee,Superintendent of Public Instruction,Larry Huff,IND,560018,1,1,22,24,
Okmulgee,Commissioner of Labor,Leslie Osborn,REP,560018,4,5,155,164,
Okmulgee,Commissioner of Labor,Fred Dorrell,DEM,560018,10,7,123,140,
Okmulgee,Commissioner of Labor,Brandt Dismukes,IND,560018,1,0,13,14,
Okmulgee,Insurance Commissioner,Glen Mulready,REP,560018,4,7,151,162,
Okmulgee,Insurance Commissioner,Kimberly Fobbs,DEM,560018,11,5,137,153,
Okmulgee,Corporation Commissioner,Bob Anthony,REP,560018,3,3,154,160,
Okmulgee,Corporation Commissioner,Ashley Nicole Mccray,DEM,560018,10,8,119,137,
Okmulgee,Corporation Commissioner,Jackie Short,IND,560018,2,1,19,22,
Okmulgee,U.S. House,Richard Castaldo,LIB,560018,0,0,9,9,2
Okmulgee,U.S. House,Markwayne Mullin,REP,560018,4,7,159,170,2
Okmulgee,U.S. House,Jason Nichols,DEM,560018,10,5,119,134,2
Okmulgee,U.S. House,John Foreman,IND,560018,1,0,8,9,2
Okmulgee,State Senate,Roger Thompson,REP,560018,5,6,167,178,8
Okmulgee,State Senate,Shannan Tucker,DEM,560018,10,6,118,134,8
Okmulgee,State Senate,Marlena Nobles,IND,560018,1,0,10,11,8
Okmulgee,State House,Scott Fetgatter,REP,560018,4,3,158,165,16
Okmulgee,State House,Chandler Torbett,DEM,560018,11,9,127,147,16
Okmulgee,State House,James Delso,IND,560018,0,0,11,11,16
Okmulgee,Governor,Chris Powell,LIB,560019,0,0,5,5,
Okmulgee,Governor,Kevin Stitt,REP,560019,5,5,134,144,
Okmulgee,Governor,Drew Edmondson,DEM,560019,2,8,127,137,
Okmulgee,Lieutenant Governor,Matt Pinnell,REP,560019,5,5,161,171,
Okmulgee,Lieutenant Governor,Anastasia Pittman,DEM,560019,2,7,95,104,
Okmulgee,Lieutenant Governor,Ivan Holmes,IND,560019,0,1,9,10,
Okmulgee,State Auditor,John Yeutter,LIB,560019,2,3,55,60,
Okmulgee,State Auditor,Cindy Byrd,REP,560019,5,8,183,196,
Okmulgee,Attorney General,Mike Hunter,REP,560019,5,6,174,185,
Okmulgee,Attorney General,Mark Myles,DEM,560019,2,7,91,100,
Okmulgee,State Treasurer,Randy Mcdaniel,REP,560019,5,6,173,184,
Okmulgee,State Treasurer,Charles De Coune,IND,560019,2,5,62,69,
Okmulgee,Superintendent of Public Instruction,Joy Hofmeister,REP,560019,5,5,140,150,
Okmulgee,Superintendent of Public Instruction,John Cox,DEM,560019,2,8,106,116,
Okmulgee,Superintendent of Public Instruction,Larry Huff,IND,560019,0,0,20,20,
Okmulgee,Commissioner of Labor,Leslie Osborn,REP,560019,5,5,154,164,
Okmulgee,Commissioner of Labor,Fred Dorrell,DEM,560019,2,8,99,109,
Okmulgee,Commissioner of Labor,Brandt Dismukes,IND,560019,0,0,12,12,
Okmulgee,Insurance Commissioner,Glen Mulready,REP,560019,5,5,154,164,
Okmulgee,Insurance Commissioner,Kimberly Fobbs,DEM,560019,2,8,111,121,
Okmulgee,Corporation Commissioner,Bob Anthony,REP,560019,5,5,156,166,
Okmulgee,Corporation Commissioner,Ashley Nicole Mccray,DEM,560019,2,8,93,103,
Okmulgee,Corporation Commissioner,Jackie Short,IND,560019,0,0,16,16,
Okmulgee,U.S. House,Richard Castaldo,LIB,560019,0,0,4,4,2
Okmulgee,U.S. House,Markwayne Mullin,REP,560019,5,5,149,159,2
Okmulgee,U.S. House,Jason Nichols,DEM,560019,2,8,100,110,2
Okmulgee,U.S. House,John Foreman,IND,560019,0,0,13,13,2
Okmulgee,State Senate,Roger Thompson,REP,560019,5,6,149,160,8
Okmulgee,State Senate,Shannan Tucker,DEM,560019,2,7,102,111,8
Okmulgee,State Senate,Marlena Nobles,IND,560019,0,0,14,14,8
Okmulgee,State House,Logan Phillips,REP,560019,5,5,144,154,24
Okmulgee,State House,Steve Kouplen,DEM,560019,2,8,121,131,24
Okmulgee,Governor,Chris Powell,LIB,560020,0,2,35,37,
Okmulgee,Governor,Kevin Stitt,REP,560020,29,24,599,652,
Okmulgee,Governor,Drew Edmondson,DEM,560020,7,24,395,426,
Okmulgee,Lieutenant Governor,Matt Pinnell,REP,560020,30,28,657,715,
Okmulgee,Lieutenant Governor,Anastasia Pittman,DEM,560020,6,20,332,358,
Okmulgee,Lieutenant Governor,Ivan Holmes,IND,560020,0,2,33,35,
Okmulgee,State Auditor,John Yeutter,LIB,560020,5,18,222,245,
Okmulgee,State Auditor,Cindy Byrd,REP,560020,31,28,740,799,
Okmulgee,Attorney General,Mike Hunter,REP,560020,29,26,676,731,
Okmulgee,Attorney General,Mark Myles,DEM,560020,7,24,345,376,
Okmulgee,State Treasurer,Randy Mcdaniel,REP,560020,31,29,714,774,
Okmulgee,State Treasurer,Charles De Coune,IND,560020,4,16,252,272,
Okmulgee,Superintendent of Public Instruction,Joy Hofmeister,REP,560020,27,22,574,623,
Okmulgee,Superintendent of Public Instruction,John Cox,DEM,560020,8,24,362,394,
Okmulgee,Superintendent of Public Instruction,Larry Huff,IND,560020,1,3,86,90,
Okmulgee,Commissioner of Labor,Leslie Osborn,REP,560020,27,27,612,666,
Okmulgee,Commissioner of Labor,Fred Dorrell,DEM,560020,8,21,358,387,
Okmulgee,Commissioner of Labor,Brandt Dismukes,IND,560020,1,1,34,36,
Okmulgee,Insurance Commissioner,Glen Mulready,REP,560020,31,26,626,683,
Okmulgee,Insurance Commissioner,Kimberly Fobbs,DEM,560020,5,24,384,413,
Okmulgee,Corporation Commissioner,Bob Anthony,REP,560020,26,24,627,677,
Okmulgee,Corporation Commissioner,Ashley Nicole Mccray,DEM,560020,8,24,342,374,
Okmulgee,Corporation Commissioner,Jackie Short,IND,560020,2,2,49,53,
Okmulgee,U.S. House,Richard Castaldo,LIB,560020,0,1,23,24,2
Okmulgee,U.S. House,Markwayne Mullin,REP,560020,27,25,637,689,2
Okmulgee,U.S. House,Jason Nichols,DEM,560020,8,24,329,361,2
Okmulgee,U.S. House,John Foreman,IND,560020,1,0,37,38,2
Okmulgee,State Senate,Roger Thompson,REP,560020,30,25,623,678,8
Okmulgee,State Senate,Shannan Tucker,DEM,560020,5,25,361,391,8
Okmulgee,State Senate,Marlena Nobles,IND,560020,1,0,32,33,8
Okmulgee,State House,Logan Phillips,REP,560020,25,24,510,559,24
Okmulgee,State House,Steve Kouplen,DEM,560020,11,26,510,547,24
Okmulgee,Governor,Chris Powell,LIB,560021,0,0,9,9,
Okmulgee,Governor,Kevin Stitt,REP,560021,1,3,90,94,
Okmulgee,Governor,Drew Edmondson,DEM,560021,1,13,135,149,
Okmulgee,Lieutenant Governor,Matt Pinnell,REP,560021,1,7,107,115,
Okmulgee,Lieutenant Governor,Anastasia Pittman,DEM,560021,1,9,114,124,
Okmulgee,Lieutenant Governor,Ivan Holmes,IND,560021,0,0,13,13,
Okmulgee,State Auditor,John Yeutter,LIB,560021,0,6,74,80,
Okmulgee,State Auditor,Cindy Byrd,REP,560021,2,6,142,150,
Okmulgee,Attorney General,Mike Hunter,REP,560021,2,5,120,127,
Okmulgee,Attorney General,Mark Myles,DEM,560021,0,11,114,125,
Okmulgee,State Treasurer,Randy Mcdaniel,REP,560021,2,5,133,140,
Okmulgee,State Treasurer,Charles De Coune,IND,560021,0,8,83,91,
Okmulgee,Superintendent of Public Instruction,Joy Hofmeister,REP,560021,2,4,95,101,
Okmulgee,Superintendent of Public Instruction,John Cox,DEM,560021,0,11,119,130,
Okmulgee,Superintendent of Public Instruction,Larry Huff,IND,560021,0,0,19,19,
Okmulgee,Commissioner of Labor,Leslie Osborn,REP,560021,2,6,108,116,
Okmulgee,Commissioner of Labor,Fred Dorrell,DEM,560021,0,9,116,125,
Okmulgee,Commissioner of Labor,Brandt Dismukes,IND,560021,0,0,10,10,
Okmulgee,Insurance Commissioner,Glen Mulready,REP,560021,1,4,109,114,
Okmulgee,Insurance Commissioner,Kimberly Fobbs,DEM,560021,1,11,124,136,
Okmulgee,Corporation Commissioner,Bob Anthony,REP,560021,2,3,104,109,
Okmulgee,Corporation Commissioner,Ashley Nicole Mccray,DEM,560021,0,13,115,128,
Okmulgee,Corporation Commissioner,Jackie Short,IND,560021,0,0,15,15,
Okmulgee,U.S. House,Richard Castaldo,LIB,560021,0,0,2,2,2
Okmulgee,U.S. House,Markwayne Mullin,REP,560021,2,3,110,115,2
Okmulgee,U.S. House,Jason Nichols,DEM,560021,0,13,116,129,2
Okmulgee,U.S. House,John Foreman,IND,560021,0,0,7,7,2
Okmulgee,State Senate,Roger Thompson,REP,560021,2,5,110,117,8
Okmulgee,State Senate,Shannan Tucker,DEM,560021,0,11,115,126,8
Okmulgee,State Senate,Marlena Nobles,IND,560021,0,0,10,10,8
Okmulgee,State House,Scott Fetgatter,REP,560021,1,3,79,83,16
Okmulgee,State House,Chandler Torbett,DEM,560021,1,13,140,154,16
Okmulgee,State House,James Delso,IND,560021,0,0,15,15,16
Okmulgee,Governor,Chris Powell,LIB,560026,0,1,17,18,
Okmulgee,Governor,Kevin Stitt,REP,560026,4,33,324,361,
Okmulgee,Governor,Drew Edmondson,DEM,560026,1,18,258,277,
Okmulgee,Lieutenant Governor,Matt Pinnell,REP,560026,5,36,398,439,
Okmulgee,Lieutenant Governor,Anastasia Pittman,DEM,560026,0,15,177,192,
Okmulgee,Lieutenant Governor,Ivan Holmes,IND,560026,0,1,21,22,
Okmulgee,State Auditor,John Yeutter,LIB,560026,0,12,138,150,
Okmulgee,State Auditor,Cindy Byrd,REP,560026,5,38,420,463,
Okmulgee,Attorney General,Mike Hunter,REP,560026,4,36,406,446,
Okmulgee,Attorney General,Mark Myles,DEM,560026,1,16,181,198,
Okmulgee,State Treasurer,Randy Mcdaniel,REP,560026,5,36,420,461,
Okmulgee,State Treasurer,Charles De Coune,IND,560026,0,13,134,147,
Okmulgee,Superintendent of Public Instruction,Joy Hofmeister,REP,560026,4,35,330,369,
Okmulgee,Superintendent of Public Instruction,John Cox,DEM,560026,1,15,208,224,
Okmulgee,Superintendent of Public Instruction,Larry Huff,IND,560026,0,2,55,57,
Okmulgee,Commissioner of Labor,Leslie Osborn,REP,560026,3,37,368,408,
Okmulgee,Commissioner of Labor,Fred Dorrell,DEM,560026,1,15,192,208,
Okmulgee,Commissioner of Labor,Brandt Dismukes,IND,560026,1,0,29,30,
Okmulgee,Insurance Commissioner,Glen Mulready,REP,560026,5,32,383,420,
Okmulgee,Insurance Commissioner,Kimberly Fobbs,DEM,560026,0,20,205,225,
Okmulgee,Corporation Commissioner,Bob Anthony,REP,560026,4,35,384,423,
Okmulgee,Corporation Commissioner,Ashley Nicole Mccray,DEM,560026,1,17,186,204,
Okmulgee,Corporation Commissioner,Jackie Short,IND,560026,0,0,26,26,
Okmulgee,U.S. House,Richard Castaldo,LIB,560026,0,1,8,9,2
Okmulgee,U.S. House,Markwayne Mullin,REP,560026,5,35,379,419,2
Okmulgee,U.S. House,Jason Nichols,DEM,560026,0,16,196,212,2
Okmulgee,U.S. House,John Foreman,IND,560026,0,0,17,17,2
Okmulgee,State Senate,Roger Thompson,REP,560026,5,36,401,442,8
Okmulgee,State Senate,Shannan Tucker,DEM,560026,0,16,176,192,8
Okmulgee,State Senate,Marlena Nobles,IND,560026,0,0,22,22,8
Okmulgee,State House,Scott Fetgatter,REP,560026,4,26,292,322,16
Okmulgee,State House,Chandler Torbett,DEM,560026,1,23,296,320,16
Okmulgee,State House,James Delso,IND,560026,0,3,12,15,16
Okmulgee,Governor,Chris Powell,LIB,560027,1,0,15,16,
Okmulgee,Governor,Kevin Stitt,REP,560027,30,14,226,270,
Okmulgee,Governor,Drew Edmondson,DEM,560027,8,6,133,147,
Okmulgee,Lieutenant Governor,Matt Pinnell,REP,560027,31,13,239,283,
Okmulgee,Lieutenant Governor,Anastasia Pittman,DEM,560027,7,7,119,133,
Okmulgee,Lieutenant Governor,Ivan Holmes,IND,560027,1,0,13,14,
Okmulgee,State Auditor,John Yeutter,LIB,560027,8,3,72,83,
Okmulgee,State Auditor,Cindy Byrd,REP,560027,31,14,275,320,
Okmulgee,Attorney General,Mike Hunter,REP,560027,29,13,257,299,
Okmulgee,Attorney General,Mark Myles,DEM,560027,10,6,115,131,
Okmulgee,State Treasurer,Randy Mcdaniel,REP,560027,33,12,275,320,
Okmulgee,State Treasurer,Charles De Coune,IND,560027,6,3,74,83,
Okmulgee,Superintendent of Public Instruction,Joy Hofmeister,REP,560027,29,10,207,246,
Okmulgee,Superintendent of Public Instruction,John Cox,DEM,560027,8,6,136,150,
Okmulgee,Superintendent of Public Instruction,Larry Huff,IND,560027,2,3,29,34,
Okmulgee,Commissioner of Labor,Leslie Osborn,REP,560027,30,13,239,282,
Okmulgee,Commissioner of Labor,Fred Dorrell,DEM,560027,6,5,115,126,
Okmulgee,Commissioner of Labor,Brandt Dismukes,IND,560027,3,1,16,20,
Okmulgee,Insurance Commissioner,Glen Mulready,REP,560027,31,13,246,290,
Okmulgee,Insurance Commissioner,Kimberly Fobbs,DEM,560027,8,6,120,134,
Okmulgee,Corporation Commissioner,Bob Anthony,REP,560027,30,13,240,283,
Okmulgee,Corporation Commissioner,Ashley Nicole Mccray,DEM,560027,8,5,113,126,
Okmulgee,Corporation Commissioner,Jackie Short,IND,560027,1,0,17,18,
Okmulgee,U.S. House,Richard Castaldo,LIB,560027,0,0,10,10,2
Okmulgee,U.S. House,Markwayne Mullin,REP,560027,31,13,247,291,2
Okmulgee,U.S. House,Jason Nichols,DEM,560027,8,7,106,121,2
Okmulgee,U.S. House,John Foreman,IND,560027,0,0,11,11,2
Okmulgee,State Senate,Roger Thompson,REP,560027,32,13,247,292,8
Okmulgee,State Senate,Shannan Tucker,DEM,560027,7,7,111,125,8
Okmulgee,State Senate,Marlena Nobles,IND,560027,0,0,13,13,8
Okmulgee,State House,Scott Fetgatter,REP,560027,30,14,224,268,16
Okmulgee,State House,Chandler Torbett,DEM,560027,8,5,138,151,16
Okmulgee,State House,James Delso,IND,560027,0,1,11,12,16
Okmulgee,Governor,Chris Powell,LIB,560029,0,3,23,26,
Okmulgee,Governor,Kevin Stitt,REP,560029,43,37,661,741,
Okmulgee,Governor,Drew Edmondson,DEM,560029,17,26,296,339,
Okmulgee,Lieutenant Governor,Matt Pinnell,REP,560029,45,40,721,806,
Okmulgee,Lieutenant Governor,Anastasia Pittman,DEM,560029,15,22,225,262,
Okmulgee,Lieutenant Governor,Ivan Holmes,IND,560029,0,3,32,35,
Okmulgee,State Auditor,John Yeutter,LIB,560029,13,17,191,221,
Okmulgee,State Auditor,Cindy Byrd,REP,560029,41,44,736,821,
Okmulgee,Attorney General,Mike Hunter,REP,560029,43,41,721,805,
Okmulgee,Attorney General,Mark Myles,DEM,560029,17,24,257,298,
Okmulgee,State Treasurer,Randy Mcdaniel,REP,560029,38,44,735,817,
Okmulgee,State Treasurer,Charles De Coune,IND,560029,15,17,190,222,
Okmulgee,Superintendent of Public Instruction,Joy Hofmeister,REP,560029,37,32,631,700,
Okmulgee,Superintendent of Public Instruction,John Cox,DEM,560029,18,30,260,308,
Okmulgee,Superintendent of Public Instruction,Larry Huff,IND,560029,5,3,84,92,
Okmulgee,Commissioner of Labor,Leslie Osborn,REP,560029,39,38,690,767,
Okmulgee,Commissioner of Labor,Fred Dorrell,DEM,560029,17,26,244,287,
Okmulgee,Commissioner of Labor,Brandt Dismukes,IND,560029,3,1,38,42,
Okmulgee,Insurance Commissioner,Glen Mulready,REP,560029,41,41,717,799,
Okmulgee,Insurance Commissioner,Kimberly Fobbs,DEM,560029,18,24,256,298,
Okmulgee,Corporation Commissioner,Bob Anthony,REP,560029,40,40,683,763,
Okmulgee,Corporation Commissioner,Ashley Nicole Mccray,DEM,560029,16,21,240,277,
Okmulgee,Corporation Commissioner,Jackie Short,IND,560029,4,4,50,58,
Okmulgee,U.S. House,Richard Castaldo,LIB,560029,0,0,14,14,2
Okmulgee,U.S. House,Markwayne Mullin,REP,560029,42,41,712,795,2
Okmulgee,U.S. House,Jason Nichols,DEM,560029,16,23,233,272,2
Okmulgee,U.S. House,John Foreman,IND,560029,2,1,18,21,2
Okmulgee,State Senate,Roger Thompson,REP,560029,42,41,686,769,8
Okmulgee,State Senate,Shannan Tucker,DEM,560029,15,23,252,290,8
Okmulgee,State Senate,Marlena Nobles,IND,560029,1,1,38,40,8
Okmulgee,State House,Logan Phillips,REP,560029,41,37,651,729,24
Okmulgee,State House,Steve Kouplen,DEM,560029,17,28,326,371,24
Okmulgee,Governor,Chris Powell,LIB,560031,0,0,9,9,
Okmulgee,Governor,Kevin Stitt,REP,560031,2,8,114,124,
Okmulgee,Governor,Drew Edmondson,DEM,560031,1,3,60,64,
Okmulgee,Lieutenant Governor,Matt Pinnell,REP,560031,2,9,130,141,
Okmulgee,Lieutenant Governor,Anastasia Pittman,DEM,560031,1,2,48,51,
Okmulgee,Lieutenant Governor,Ivan Holmes,IND,560031,0,0,5,5,
Okmulgee,State Auditor,John Yeutter,LIB,560031,1,1,29,31,
Okmulgee,State Auditor,Cindy Byrd,REP,560031,2,10,146,158,
Okmulgee,Attorney General,Mike Hunter,REP,560031,2,10,135,147,
Okmulgee,Attorney General,Mark Myles,DEM,560031,1,1,48,50,
Okmulgee,State Treasurer,Randy Mcdaniel,REP,560031,2,10,142,154,
Okmulgee,State Treasurer,Charles De Coune,IND,560031,1,0,34,35,
Okmulgee,Superintendent of Public Instruction,Joy Hofmeister,REP,560031,1,7,110,118,
Okmulgee,Superintendent of Public Instruction,John Cox,DEM,560031,2,3,48,53,
Okmulgee,Superintendent of Public Instruction,Larry Huff,IND,560031,0,1,23,24,
Okmulgee,Commissioner of Labor,Leslie Osborn,REP,560031,2,8,120,130,
Okmulgee,Commissioner of Labor,Fred Dorrell,DEM,560031,1,3,52,56,
Okmulgee,Commissioner of Labor,Brandt Dismukes,IND,560031,0,0,10,10,
Okmulgee,Insurance Commissioner,Glen Mulready,REP,560031,2,8,127,137,
Okmulgee,Insurance Commissioner,Kimberly Fobbs,DEM,560031,1,3,56,60,
Okmulgee,Corporation Commissioner,Bob Anthony,REP,560031,2,9,120,131,
Okmulgee,Corporation Commissioner,Ashley Nicole Mccray,DEM,560031,1,2,50,53,
Okmulgee,Corporation Commissioner,Jackie Short,IND,560031,0,0,13,13,
Okmulgee,U.S. House,Richard Castaldo,LIB,560031,1,0,4,5,2
Okmulgee,U.S. House,Markwayne Mullin,REP,560031,1,9,128,138,2
Okmulgee,U.S. House,Jason Nichols,DEM,560031,1,2,47,50,2
Okmulgee,U.S. House,John Foreman,IND,560031,0,0,4,4,2
Okmulgee,State Senate,Roger Thompson,REP,560031,1,9,113,123,8
Okmulgee,State Senate,Shannan Tucker,DEM,560031,1,2,62,65,8
Okmulgee,State Senate,Marlena Nobles,IND,560031,1,0,8,9,8
Okmulgee,State House,Logan Phillips,REP,560031,2,5,96,103,24
Okmulgee,State House,Steve Kouplen,DEM,560031,1,6,86,93,24
Okmulgee,Governor,Chris Powell,LIB,560032,0,2,5,7,
Okmulgee,Governor,Kevin Stitt,REP,560032,5,21,149,175,
Okmulgee,Governor,Drew Edmondson,DEM,560032,6,10,127,143,
Okmulgee,Lieutenant Governor,Matt Pinnell,REP,560032,6,20,150,176,
Okmulgee,Lieutenant Governor,Anastasia Pittman,DEM,560032,5,12,121,138,
Okmulgee,Lieutenant Governor,Ivan Holmes,IND,560032,0,1,9,10,
Okmulgee,State Auditor,John Yeutter,LIB,560032,3,9,68,80,
Okmulgee,State Auditor,Cindy Byrd,REP,560032,5,21,170,196,
Okmulgee,Attorney General,Mike Hunter,REP,560032,4,20,159,183,
Okmulgee,Attorney General,Mark Myles,DEM,560032,7,12,119,138,
Okmulgee,State Treasurer,Randy Mcdaniel,REP,560032,6,21,165,192,
Okmulgee,State Treasurer,Charles De Coune,IND,560032,2,9,72,83,
Okmulgee,Superintendent of Public Instruction,Joy Hofmeister,REP,560032,5,18,146,169,
Okmulgee,Superintendent of Public Instruction,John Cox,DEM,560032,6,12,114,132,
Okmulgee,Superintendent of Public Instruction,Larry Huff,IND,560032,0,2,19,21,
Okmulgee,Commissioner of Labor,Leslie Osborn,REP,560032,6,19,146,171,
Okmulgee,Commissioner of Labor,Fred Dorrell,DEM,560032,5,12,118,135,
Okmulgee,Commissioner of Labor,Brandt Dismukes,IND,560032,0,0,14,14,
Okmulgee,Insurance Commissioner,Glen Mulready,REP,560032,6,21,153,180,
Okmulgee,Insurance Commissioner,Kimberly Fobbs,DEM,560032,5,12,126,143,
Okmulgee,Corporation Commissioner,Bob Anthony,REP,560032,7,20,153,180,
Okmulgee,Corporation Commissioner,Ashley Nicole Mccray,DEM,560032,4,12,110,126,
Okmulgee,Corporation Commissioner,Jackie Short,IND,560032,0,1,16,17,
Okmulgee,U.S. House,Richard Castaldo,LIB,560032,0,0,2,2,2
Okmulgee,U.S. House,Markwayne Mullin,REP,560032,5,22,161,188,2
Okmulgee,U.S. House,Jason Nichols,DEM,560032,6,11,110,127,2
Okmulgee,U.S. House,John Foreman,IND,560032,0,0,7,7,2
Okmulgee,State Senate,Roger Thompson,REP,560032,7,22,155,184,8
Okmulgee,State Senate,Shannan Tucker,DEM,560032,4,10,111,125,8
Okmulgee,State Senate,Marlena Nobles,IND,560032,0,0,13,13,8
Okmulgee,State House,Logan Phillips,REP,560032,4,17,134,155,24
Okmulgee,State House,Steve Kouplen,DEM,560032,7,15,141,163,24
Okmulgee,Governor,Chris Powell,LIB,560033,0,0,12,12,
Okmulgee,Governor,Kevin Stitt,REP,560033,10,11,172,193,
Okmulgee,Governor,Drew Edmondson,DEM,560033,2,13,122,137,
Okmulgee,Lieutenant Governor,Matt Pinnell,REP,560033,12,14,172,198,
Okmulgee,Lieutenant Governor,Anastasia Pittman,DEM,560033,0,9,119,128,
Okmulgee,Lieutenant Governor,Ivan Holmes,IND,560033,0,1,14,15,
Okmulgee,State Auditor,John Yeutter,LIB,560033,0,7,77,84,
Okmulgee,State Auditor,Cindy Byrd,REP,560033,12,16,199,227,
Okmulgee,Attorney General,Mike Hunter,REP,560033,12,11,196,219,
Okmulgee,Attorney General,Mark Myles,DEM,560033,0,13,106,119,
Okmulgee,State Treasurer,Randy Mcdaniel,REP,560033,12,12,200,224,
Okmulgee,State Treasurer,Charles De Coune,IND,560033,0,10,78,88,
Okmulgee,Superintendent of Public Instruction,Joy Hofmeister,REP,560033,12,14,166,192,
Okmulgee,Superintendent of Public Instruction,John Cox,DEM,560033,0,8,113,121,
Okmulgee,Superintendent of Public Instruction,Larry Huff,IND,560033,0,2,24,26,
Okmulgee,Commissioner of Labor,Leslie Osborn,REP,560033,10,12,172,194,
Okmulgee,Commissioner of Labor,Fred Dorrell,DEM,560033,2,12,118,132,
Okmulgee,Commissioner of Labor,Brandt Dismukes,IND,560033,0,0,10,10,
Okmulgee,Insurance Commissioner,Glen Mulready,REP,560033,12,12,178,202,
Okmulgee,Insurance Commissioner,Kimberly Fobbs,DEM,560033,0,11,120,131,
Okmulgee,Corporation Commissioner,Bob Anthony,REP,560033,12,11,175,198,
Okmulgee,Corporation Commissioner,Ashley Nicole Mccray,DEM,560033,0,12,110,122,
Okmulgee,Corporation Commissioner,Jackie Short,IND,560033,0,0,15,15,
Okmulgee,U.S. House,Richard Castaldo,LIB,560033,0,0,3,3,2
Okmulgee,U.S. House,Markwayne Mullin,REP,560033,12,10,176,198,2
Okmulgee,U.S. House,Jason Nichols,DEM,560033,0,14,110,124,2
Okmulgee,U.S. House,John Foreman,IND,560033,0,0,15,15,2
Okmulgee,State Senate,Roger Thompson,REP,560033,10,12,177,199,8
Okmulgee,State Senate,Shannan Tucker,DEM,560033,2,11,112,125,8
Okmulgee,State Senate,Marlena Nobles,IND,560033,0,1,15,16,8
Okmulgee,State House,Logan Phillips,REP,560033,10,9,152,171,24
Okmulgee,State House,Steve Kouplen,DEM,560033,2,15,149,166,24
Okmulgee,Governor,Chris Powell,LIB,560034,0,0,6,6,
Okmulgee,Governor,Kevin Stitt,REP,560034,3,14,189,206,
Okmulgee,Governor,Drew Edmondson,DEM,560034,2,2,66,70,
Okmulgee,Lieutenant Governor,Matt Pinnell,REP,560034,4,14,199,217,
Okmulgee,Lieutenant Governor,Anastasia Pittman,DEM,560034,1,2,53,56,
Okmulgee,Lieutenant Governor,Ivan Holmes,IND,560034,0,0,8,8,
Okmulgee,State Auditor,John Yeutter,LIB,560034,0,3,43,46,
Okmulgee,State Auditor,Cindy Byrd,REP,560034,5,12,206,223,
Okmulgee,Attorney General,Mike Hunter,REP,560034,4,14,198,216,
Okmulgee,Attorney General,Mark Myles,DEM,560034,1,2,62,65,
Okmulgee,State Treasurer,Randy Mcdaniel,REP,560034,5,14,209,228,
Okmulgee,State Treasurer,Charles De Coune,IND,560034,0,2,35,37,
Okmulgee,Superintendent of Public Instruction,Joy Hofmeister,REP,560034,3,14,160,177,
Okmulgee,Superintendent of Public Instruction,John Cox,DEM,560034,1,2,76,79,
Okmulgee,Superintendent of Public Instruction,Larry Huff,IND,560034,1,0,22,23,
Okmulgee,Commissioner of Labor,Leslie Osborn,REP,560034,3,14,174,191,
Okmulgee,Commissioner of Labor,Fred Dorrell,DEM,560034,2,2,71,75,
Okmulgee,Commissioner of Labor,Brandt Dismukes,IND,560034,0,0,10,10,
Okmulgee,Insurance Commissioner,Glen Mulready,REP,560034,3,14,193,210,
Okmulgee,Insurance Commissioner,Kimberly Fobbs,DEM,560034,2,2,64,68,
Okmulgee,Corporation Commissioner,Bob Anthony,REP,560034,4,14,179,197,
Okmulgee,Corporation Commissioner,Ashley Nicole Mccray,DEM,560034,0,2,67,69,
Okmulgee,Corporation Commissioner,Jackie Short,IND,560034,1,0,14,15,
Okmulgee,U.S. House,Richard Castaldo,LIB,560034,0,0,4,4,2
Okmulgee,U.S. House,Markwayne Mullin,REP,560034,4,14,190,208,2
Okmulgee,U.S. House,Jason Nichols,DEM,560034,1,2,58,61,2
Okmulgee,U.S. House,John Foreman,IND,560034,0,0,7,7,2
Okmulgee,State Senate,Roger Thompson,REP,560034,4,14,193,211,8
Okmulgee,State Senate,Shannan Tucker,DEM,560034,1,2,62,65,8
Okmulgee,State Senate,Marlena Nobles,IND,560034,0,0,5,5,8
Okmulgee,State House,Scott Fetgatter,REP,560034,2,12,153,167,16
Okmulgee,State House,Chandler Torbett,DEM,560034,3,4,98,105,16
Okmulgee,State House,James Delso,IND,560034,0,0,9,9,16
Okmulgee,Governor,Chris Powell,LIB,560035,0,0,12,12,
Okmulgee,Governor,Kevin Stitt,REP,560035,6,6,137,149,
Okmulgee,Governor,Drew Edmondson,DEM,560035,0,0,111,111,
Okmulgee,Lieutenant Governor,Matt Pinnell,REP,560035,6,6,149,161,
Okmulgee,Lieutenant Governor,Anastasia Pittman,DEM,560035,0,0,99,99,
Okmulgee,Lieutenant Governor,Ivan Holmes,IND,560035,0,0,9,9,
Okmulgee,State Auditor,John Yeutter,LIB,560035,1,1,66,68,
Okmulgee,State Auditor,Cindy Byrd,REP,560035,5,5,168,178,
Okmulgee,Attorney General,Mike Hunter,REP,560035,6,6,156,168,
Okmulgee,Attorney General,Mark Myles,DEM,560035,0,0,102,102,
Okmulgee,State Treasurer,Randy Mcdaniel,REP,560035,5,5,173,183,
Okmulgee,State Treasurer,Charles De Coune,IND,560035,1,1,64,66,
Okmulgee,Superintendent of Public Instruction,Joy Hofmeister,REP,560035,6,2,137,145,
Okmulgee,Superintendent of Public Instruction,John Cox,DEM,560035,0,2,102,104,
Okmulgee,Superintendent of Public Instruction,Larry Huff,IND,560035,0,2,20,22,
Okmulgee,Commissioner of Labor,Leslie Osborn,REP,560035,6,3,139,148,
Okmulgee,Commissioner of Labor,Fred Dorrell,DEM,560035,0,0,108,108,
Okmulgee,Commissioner of Labor,Brandt Dismukes,IND,560035,0,3,8,11,
Okmulgee,Insurance Commissioner,Glen Mulready,REP,560035,6,6,147,159,
Okmulgee,Insurance Commissioner,Kimberly Fobbs,DEM,560035,0,0,110,110,
Okmulgee,Corporation Commissioner,Bob Anthony,REP,560035,6,5,152,163,
Okmulgee,Corporation Commissioner,Ashley Nicole Mccray,DEM,560035,0,0,91,91,
Okmulgee,Corporation Commissioner,Jackie Short,IND,560035,0,1,16,17,
Okmulgee,U.S. House,Richard Castaldo,LIB,560035,0,0,7,7,2
Okmulgee,U.S. House,Markwayne Mullin,REP,560035,6,6,150,162,2
Okmulgee,U.S. House,Jason Nichols,DEM,560035,0,0,88,88,2
Okmulgee,U.S. House,John Foreman,IND,560035,0,0,13,13,2
Okmulgee,State Senate,Roger Thompson,REP,560035,6,5,149,160,8
Okmulgee,State Senate,Shannan Tucker,DEM,560035,0,0,101,101,8
Okmulgee,State Senate,Marlena Nobles,IND,560035,0,1,8,9,8
Okmulgee,State House,Scott Fetgatter,REP,560035,6,4,130,140,16
Okmulgee,State House,Chandler Torbett,DEM,560035,0,2,111,113,16
Okmulgee,State House,James Delso,IND,560035,0,0,18,18,16
Okmulgee,Governor,Chris Powell,LIB,560036,0,1,20,21,
Okmulgee,Governor,Kevin Stitt,REP,560036,10,30,318,358,
Okmulgee,Governor,Drew Edmondson,DEM,560036,9,28,189,226,
Okmulgee,Lieutenant Governor,Matt Pinnell,REP,560036,9,35,354,398,
Okmulgee,Lieutenant Governor,Anastasia Pittman,DEM,560036,10,22,154,186,
Okmulgee,Lieutenant Governor,Ivan Holmes,IND,560036,0,2,19,21,
Okmulgee,State Auditor,John Yeutter,LIB,560036,6,17,127,150,
Okmulgee,State Auditor,Cindy Byrd,REP,560036,12,39,373,424,
Okmulgee,Attorney General,Mike Hunter,REP,560036,11,30,360,401,
Okmulgee,Attorney General,Mark Myles,DEM,560036,8,28,165,201,
Okmulgee,State Treasurer,Randy Mcdaniel,REP,560036,12,37,377,426,
Okmulgee,State Treasurer,Charles De Coune,IND,560036,5,20,124,149,
Okmulgee,Superintendent of Public Instruction,Joy Hofmeister,REP,560036,8,29,324,361,
Okmulgee,Superintendent of Public Instruction,John Cox,DEM,560036,10,22,166,198,
Okmulgee,Superintendent of Public Instruction,Larry Huff,IND,560036,1,7,38,46,
Okmulgee,Commissioner of Labor,Leslie Osborn,REP,560036,10,32,334,376,
Okmulgee,Commissioner of Labor,Fred Dorrell,DEM,560036,8,22,163,193,
Okmulgee,Commissioner of Labor,Brandt Dismukes,IND,560036,1,4,24,29,
Okmulgee,Insurance Commissioner,Glen Mulready,REP,560036,11,32,353,396,
Okmulgee,Insurance Commissioner,Kimberly Fobbs,DEM,560036,8,26,168,202,
Okmulgee,Corporation Commissioner,Bob Anthony,REP,560036,9,32,335,376,
Okmulgee,Corporation Commissioner,Ashley Nicole Mccray,DEM,560036,10,24,161,195,
Okmulgee,Corporation Commissioner,Jackie Short,IND,560036,0,3,29,32,
Okmulgee,U.S. House,Richard Castaldo,LIB,560036,0,1,9,10,2
Okmulgee,U.S. House,Markwayne Mullin,REP,560036,11,33,345,389,2
Okmulgee,U.S. House,Jason Nichols,DEM,560036,8,23,159,190,2
Okmulgee,U.S. House,John Foreman,IND,560036,0,2,13,15,2
Okmulgee,State Senate,Roger Thompson,REP,560036,10,32,348,390,8
Okmulgee,State Senate,Shannan Tucker,DEM,560036,8,24,158,190,8
Okmulgee,State Senate,Marlena Nobles,IND,560036,0,3,19,22,8
Okmulgee,State House,Scott Fetgatter,REP,560036,8,29,298,335,16
Okmulgee,State House,Chandler Torbett,DEM,560036,9,28,216,253,16
Okmulgee,State House,James Delso,IND,560036,1,1,13,15,16
Okmulgee,Governor,Chris Powell,LIB,560038,0,0,7,7,
Okmulgee,Governor,Kevin Stitt,REP,560038,4,8,138,150,
Okmulgee,Governor,Drew Edmondson,DEM,560038,3,6,72,81,
Okmulgee,Lieutenant Governor,Matt Pinnell,REP,560038,4,8,150,162,
Okmulgee,Lieutenant Governor,Anastasia Pittman,DEM,560038,3,4,64,71,
Okmulgee,Lieutenant Governor,Ivan Holmes,IND,560038,0,2,4,6,
Okmulgee,State Auditor,John Yeutter,LIB,560038,2,2,45,49,
Okmulgee,State Auditor,Cindy Byrd,REP,560038,4,10,156,170,
Okmulgee,Attorney General,Mike Hunter,REP,560038,4,6,151,161,
Okmulgee,Attorney General,Mark Myles,DEM,560038,3,6,65,74,
Okmulgee,State Treasurer,Randy Mcdaniel,REP,560038,4,8,161,173,
Okmulgee,State Treasurer,Charles De Coune,IND,560038,2,4,43,49,
Okmulgee,Superintendent of Public Instruction,Joy Hofmeister,REP,560038,3,7,122,132,
Okmulgee,Superintendent of Public Instruction,John Cox,DEM,560038,3,4,68,75,
Okmulgee,Superintendent of Public Instruction,Larry Huff,IND,560038,1,1,26,28,
Okmulgee,Commissioner of Labor,Leslie Osborn,REP,560038,4,5,144,153,
Okmulgee,Commissioner of Labor,Fred Dorrell,DEM,560038,3,6,60,69,
Okmulgee,Commissioner of Labor,Brandt Dismukes,IND,560038,0,1,9,10,
Okmulgee,Insurance Commissioner,Glen Mulready,REP,560038,4,8,134,146,
Okmulgee,Insurance Commissioner,Kimberly Fobbs,DEM,560038,3,6,79,88,
Okmulgee,Corporation Commissioner,Bob Anthony,REP,560038,4,9,128,141,
Okmulgee,Corporation Commissioner,Ashley Nicole Mccray,DEM,560038,3,3,69,75,
Okmulgee,Corporation Commissioner,Jackie Short,IND,560038,0,2,14,16,
Okmulgee,U.S. House,Richard Castaldo,LIB,560038,0,0,4,4,2
Okmulgee,U.S. House,Markwayne Mullin,REP,560038,4,8,140,152,2
Okmulgee,U.S. House,Jason Nichols,DEM,560038,3,5,67,75,2
Okmulgee,U.S. House,John Foreman,IND,560038,0,1,6,7,2
Okmulgee,State Senate,Roger Thompson,REP,560038,4,9,128,141,8
Okmulgee,State Senate,Shannan Tucker,DEM,560038,2,5,78,85,8
Okmulgee,State Senate,Marlena Nobles,IND,560038,0,0,9,9,8
Okmulgee,State House,Logan Phillips,REP,560038,4,8,126,138,24
Okmulgee,State House,Steve Kouplen,DEM,560038,3,6,90,99,24
Osage,Governor,Chris Powell,LIB,570101,0,0,10,10,
Osage,Governor,Kevin Stitt,REP,570101,1,4,95,100,
Osage,Governor,Drew Edmondson,DEM,570101,2,1,24,27,
Osage,Lieutenant Governor,Matt Pinnell,REP,570101,1,4,102,107,
Osage,Lieutenant Governor,Anastasia Pittman,DEM,570101,3,0,19,22,
Osage,Lieutenant Governor,Ivan Holmes,IND,570101,0,1,6,7,
Osage,State Auditor,John Yeutter,LIB,570101,1,1,15,17,
Osage,State Auditor,Cindy Byrd,REP,570101,3,4,101,108,
Osage,Attorney General,Mike Hunter,REP,570101,1,5,110,116,
Osage,Attorney General,Mark Myles,DEM,570101,3,0,17,20,
Osage,State Treasurer,Randy Mcdaniel,REP,570101,2,4,102,108,
Osage,State Treasurer,Charles De Coune,IND,570101,2,1,17,20,
Osage,Superintendent of Public Instruction,Joy Hofmeister,REP,570101,0,4,94,98,
Osage,Superintendent of Public Instruction,John Cox,DEM,570101,4,1,21,26,
Osage,Superintendent of Public Instruction,Larry Huff,IND,570101,0,0,12,12,
Osage,Commissioner of Labor,Leslie Osborn,REP,570101,1,4,100,105,
Osage,Commissioner of Labor,Fred Dorrell,DEM,570101,3,0,19,22,
Osage,Commissioner of Labor,Brandt Dismukes,IND,570101,0,1,5,6,
Osage,Insurance Commissioner,Glen Mulready,REP,570101,0,4,96,100,
Osage,Insurance Commissioner,Kimberly Fobbs,DEM,570101,4,1,24,29,
Osage,Corporation Commissioner,Bob Anthony,REP,570101,1,5,99,105,
Osage,Corporation Commissioner,Ashley Nicole Mccray,DEM,570101,3,0,17,20,
Osage,Corporation Commissioner,Jackie Short,IND,570101,0,0,7,7,
Osage,U.S. House,Frank Lucas,REP,570101,1,4,108,113,3
Osage,U.S. House,Frankie Robbins,DEM,570101,3,1,16,20,3
Osage,State House,Judd Strom,REP,570101,4,5,125,134,10
Osage,State House,Kevin Stacy,DEM,570101,0,0,6,6,10
Osage,Governor,Chris Powell,LIB,570102,0,0,4,4,
Osage,Governor,Kevin Stitt,REP,570102,2,4,86,92,
Osage,Governor,Drew Edmondson,DEM,570102,6,4,35,45,
Osage,Lieutenant Governor,Matt Pinnell,REP,570102,4,6,93,103,
Osage,Lieutenant Governor,Anastasia Pittman,DEM,570102,4,2,30,36,
Osage,Lieutenant Governor,Ivan Holmes,IND,570102,0,0,3,3,
Osage,State Auditor,John Yeutter,LIB,570102,3,1,21,25,
Osage,State Auditor,Cindy Byrd,REP,570102,5,7,97,109,
Osage,Attorney General,Mike Hunter,REP,570102,4,6,93,103,
Osage,Attorney General,Mark Myles,DEM,570102,4,2,33,39,
Osage,State Treasurer,Randy Mcdaniel,REP,570102,5,8,96,109,
Osage,State Treasurer,Charles De Coune,IND,570102,3,0,20,23,
Osage,Superintendent of Public Instruction,Joy Hofmeister,REP,570102,5,7,84,96,
Osage,Superintendent of Public Instruction,John Cox,DEM,570102,3,1,28,32,
Osage,Superintendent of Public Instruction,Larry Huff,IND,570102,0,0,13,13,
Osage,Commissioner of Labor,Leslie Osborn,REP,570102,3,5,89,97,
Osage,Commissioner of Labor,Fred Dorrell,DEM,570102,5,2,29,36,
Osage,Commissioner of Labor,Brandt Dismukes,IND,570102,0,1,5,6,
Osage,Insurance Commissioner,Glen Mulready,REP,570102,3,6,89,98,
Osage,Insurance Commissioner,Kimberly Fobbs,DEM,570102,5,2,33,40,
Osage,Corporation Commissioner,Bob Anthony,REP,570102,4,7,89,100,
Osage,Corporation Commissioner,Ashley Nicole Mccray,DEM,570102,4,0,28,32,
Osage,Corporation Commissioner,Jackie Short,IND,570102,0,1,7,8,
Osage,U.S. House,Frank Lucas,REP,570102,3,6,94,103,3
Osage,U.S. House,Frankie Robbins,DEM,570102,4,2,31,37,3
Osage,Governor,Chris Powell,LIB,570103,0,0,13,13,
Osage,Governor,Kevin Stitt,REP,570103,4,2,137,143,
Osage,Governor,Drew Edmondson,DEM,570103,2,0,50,52,
Osage,Lieutenant Governor,Matt Pinnell,REP,570103,4,2,146,152,
Osage,Lieutenant Governor,Anastasia Pittman,DEM,570103,1,0,43,44,
Osage,Lieutenant Governor,Ivan Holmes,IND,570103,0,0,11,11,
Osage,State Auditor,John Yeutter,LIB,570103,1,0,37,38,
Osage,State Auditor,Cindy Byrd,REP,570103,3,2,153,158,
Osage,Attorney General,Mike Hunter,REP,570103,4,2,152,158,
Osage,Attorney General,Mark Myles,DEM,570103,1,0,47,48,
Osage,State Treasurer,Randy Mcdaniel,REP,570103,3,2,151,156,
Osage,State Treasurer,Charles De Coune,IND,570103,1,0,41,42,
Osage,Superintendent of Public Instruction,Joy Hofmeister,REP,570103,3,2,129,134,
Osage,Superintendent of Public Instruction,John Cox,DEM,570103,1,0,46,47,
Osage,Superintendent of Public Instruction,Larry Huff,IND,570103,1,0,24,25,
Osage,Commissioner of Labor,Leslie Osborn,REP,570103,4,1,129,134,
Osage,Commissioner of Labor,Fred Dorrell,DEM,570103,1,0,52,53,
Osage,Commissioner of Labor,Brandt Dismukes,IND,570103,0,0,16,16,
Osage,Insurance Commissioner,Glen Mulready,REP,570103,4,1,142,147,
Osage,Insurance Commissioner,Kimberly Fobbs,DEM,570103,1,0,55,56,
Osage,Corporation Commissioner,Bob Anthony,REP,570103,4,2,141,147,
Osage,Corporation Commissioner,Ashley Nicole Mccray,DEM,570103,1,0,42,43,
Osage,Corporation Commissioner,Jackie Short,IND,570103,1,0,15,16,
Osage,U.S. House,Frank Lucas,REP,570103,4,2,157,163,3
Osage,U.S. House,Frankie Robbins,DEM,570103,1,0,43,44,3
Osage,Governor,Chris Powell,LIB,570105,2,1,29,32,
Osage,Governor,Kevin Stitt,REP,570105,24,0,397,421,
Osage,Governor,Drew Edmondson,DEM,570105,11,2,215,228,
Osage,Lieutenant Governor,Matt Pinnell,REP,570105,24,1,436,461,
Osage,Lieutenant Governor,Anastasia Pittman,DEM,570105,10,2,166,178,
Osage,Lieutenant Governor,Ivan Holmes,IND,570105,2,0,37,39,
Osage,State Auditor,John Yeutter,LIB,570105,6,0,127,133,
Osage,State Auditor,Cindy Byrd,REP,570105,25,1,464,490,
Osage,Attorney General,Mike Hunter,REP,570105,26,1,452,479,
Osage,Attorney General,Mark Myles,DEM,570105,11,2,185,198,
Osage,State Treasurer,Randy Mcdaniel,REP,570105,23,1,460,484,
Osage,State Treasurer,Charles De Coune,IND,570105,6,0,127,133,
Osage,Superintendent of Public Instruction,Joy Hofmeister,REP,570105,21,1,401,423,
Osage,Superintendent of Public Instruction,John Cox,DEM,570105,13,2,173,188,
Osage,Superintendent of Public Instruction,Larry Huff,IND,570105,2,0,59,61,
Osage,Commissioner of Labor,Leslie Osborn,REP,570105,23,1,429,453,
Osage,Commissioner of Labor,Fred Dorrell,DEM,570105,11,2,175,188,
Osage,Commissioner of Labor,Brandt Dismukes,IND,570105,2,0,29,31,
Osage,Insurance Commissioner,Glen Mulready,REP,570105,22,1,426,449,
Osage,Insurance Commissioner,Kimberly Fobbs,DEM,570105,14,2,202,218,
Osage,Corporation Commissioner,Bob Anthony,REP,570105,25,1,405,431,
Osage,Corporation Commissioner,Ashley Nicole Mccray,DEM,570105,8,2,192,202,
Osage,Corporation Commissioner,Jackie Short,IND,570105,3,0,36,39,
Osage,U.S. House,Frank Lucas,REP,570105,27,1,457,485,3
Osage,U.S. House,Frankie Robbins,DEM,570105,10,2,181,193,3
Osage,Governor,Chris Powell,LIB,570106,0,0,3,3,
Osage,Governor,Kevin Stitt,REP,570106,1,0,42,43,
Osage,Governor,Drew Edmondson,DEM,570106,0,0,11,11,
Osage,Lieutenant Governor,Matt Pinnell,REP,570106,1,0,43,44,
Osage,Lieutenant Governor,Anastasia Pittman,DEM,570106,0,0,11,11,
Osage,Lieutenant Governor,Ivan Holmes,IND,570106,0,0,2,2,
Osage,State Auditor,John Yeutter,LIB,570106,0,0,7,7,
Osage,State Auditor,Cindy Byrd,REP,570106,1,0,49,50,
Osage,Attorney General,Mike Hunter,REP,570106,1,0,44,45,
Osage,Attorney General,Mark Myles,DEM,570106,0,0,11,11,
Osage,State Treasurer,Randy Mcdaniel,REP,570106,1,0,44,45,
Osage,State Treasurer,Charles De Coune,IND,570106,0,0,10,10,
Osage,Superintendent of Public Instruction,Joy Hofmeister,REP,570106,1,0,40,41,
Osage,Superintendent of Public Instruction,John Cox,DEM,570106,0,0,11,11,
Osage,Superintendent of Public Instruction,Larry Huff,IND,570106,0,0,4,4,
Osage,Commissioner of Labor,Leslie Osborn,REP,570106,1,0,44,45,
Osage,Commissioner of Labor,Fred Dorrell,DEM,570106,0,0,9,9,
Osage,Commissioner of Labor,Brandt Dismukes,IND,570106,0,0,2,2,
Osage,Insurance Commissioner,Glen Mulready,REP,570106,1,0,42,43,
Osage,Insurance Commissioner,Kimberly Fobbs,DEM,570106,0,0,12,12,
Osage,Corporation Commissioner,Bob Anthony,REP,570106,1,0,45,46,
Osage,Corporation Commissioner,Ashley Nicole Mccray,DEM,570106,0,0,9,9,
Osage,Corporation Commissioner,Jackie Short,IND,570106,0,0,0,0,
Osage,U.S. House,Frank Lucas,REP,570106,1,0,46,47,3
Osage,U.S. House,Frankie Robbins,DEM,570106,0,0,10,10,3
Osage,Governor,Chris Powell,LIB,570107,1,2,37,40,
Osage,Governor,Kevin Stitt,REP,570107,26,77,337,440,
Osage,Governor,Drew Edmondson,DEM,570107,19,86,288,393,
Osage,Lieutenant Governor,Matt Pinnell,REP,570107,28,97,393,518,
Osage,Lieutenant Governor,Anastasia Pittman,DEM,570107,17,67,237,321,
Osage,Lieutenant Governor,Ivan Holmes,IND,570107,1,1,28,30,
Osage,State Auditor,John Yeutter,LIB,570107,8,23,128,159,
Osage,State Auditor,Cindy Byrd,REP,570107,35,115,475,625,
Osage,Attorney General,Mike Hunter,REP,570107,30,95,432,557,
Osage,Attorney General,Mark Myles,DEM,570107,17,70,226,313,
Osage,State Treasurer,Randy Mcdaniel,REP,570107,30,109,457,596,
Osage,State Treasurer,Charles De Coune,IND,570107,11,28,142,181,
Osage,Superintendent of Public Instruction,Joy Hofmeister,REP,570107,29,93,371,493,
Osage,Superintendent of Public Instruction,John Cox,DEM,570107,16,63,227,306,
Osage,Superintendent of Public Instruction,Larry Huff,IND,570107,2,9,58,69,
Osage,Commissioner of Labor,Leslie Osborn,REP,570107,30,93,385,508,
Osage,Commissioner of Labor,Fred Dorrell,DEM,570107,14,69,219,302,
Osage,Commissioner of Labor,Brandt Dismukes,IND,570107,1,1,40,42,
Osage,Insurance Commissioner,Glen Mulready,REP,570107,28,91,387,506,
Osage,Insurance Commissioner,Kimberly Fobbs,DEM,570107,17,71,262,350,
Osage,Corporation Commissioner,Bob Anthony,REP,570107,27,98,377,502,
Osage,Corporation Commissioner,Ashley Nicole Mccray,DEM,570107,16,61,226,303,
Osage,Corporation Commissioner,Jackie Short,IND,570107,1,4,48,53,
Osage,U.S. House,Frank Lucas,REP,570107,32,97,414,543,3
Osage,U.S. House,Frankie Robbins,DEM,570107,15,68,240,323,3
Osage,Governor,Chris Powell,LIB,570108,0,3,23,26,
Osage,Governor,Kevin Stitt,REP,570108,6,39,214,259,
Osage,Governor,Drew Edmondson,DEM,570108,14,43,193,250,
Osage,Lieutenant Governor,Matt Pinnell,REP,570108,8,48,244,300,
Osage,Lieutenant Governor,Anastasia Pittman,DEM,570108,12,32,166,210,
Osage,Lieutenant Governor,Ivan Holmes,IND,570108,0,3,16,19,
Osage,State Auditor,John Yeutter,LIB,570108,4,19,104,127,
Osage,State Auditor,Cindy Byrd,REP,570108,10,59,289,358,
Osage,Attorney General,Mike Hunter,REP,570108,10,51,262,323,
Osage,Attorney General,Mark Myles,DEM,570108,10,33,166,209,
Osage,State Treasurer,Randy Mcdaniel,REP,570108,9,59,285,353,
Osage,State Treasurer,Charles De Coune,IND,570108,5,17,109,131,
Osage,Superintendent of Public Instruction,Joy Hofmeister,REP,570108,9,50,232,291,
Osage,Superintendent of Public Instruction,John Cox,DEM,570108,9,29,153,191,
Osage,Superintendent of Public Instruction,Larry Huff,IND,570108,2,5,44,51,
Osage,Commissioner of Labor,Leslie Osborn,REP,570108,9,47,238,294,
Osage,Commissioner of Labor,Fred Dorrell,DEM,570108,9,33,155,197,
Osage,Commissioner of Labor,Brandt Dismukes,IND,570108,2,3,26,31,
Osage,Insurance Commissioner,Glen Mulready,REP,570108,8,44,238,290,
Osage,Insurance Commissioner,Kimberly Fobbs,DEM,570108,12,39,182,233,
Osage,Corporation Commissioner,Bob Anthony,REP,570108,9,50,240,299,
Osage,Corporation Commissioner,Ashley Nicole Mccray,DEM,570108,11,30,154,195,
Osage,Corporation Commissioner,Jackie Short,IND,570108,0,3,29,32,
Osage,U.S. House,Frank Lucas,REP,570108,8,49,257,314,3
Osage,U.S. House,Frankie Robbins,DEM,570108,12,34,169,215,3
Osage,Governor,Chris Powell,LIB,570109,1,1,27,29,
Osage,Governor,Kevin Stitt,REP,570109,19,25,440,484,
Osage,Governor,Drew Edmondson,DEM,570109,13,7,148,168,
Osage,Lieutenant Governor,Matt Pinnell,REP,570109,21,28,475,524,
Osage,Lieutenant Governor,Anastasia Pittman,DEM,570109,11,5,113,129,
Osage,Lieutenant Governor,Ivan Holmes,IND,570109,1,0,22,23,
Osage,State Auditor,John Yeutter,LIB,570109,8,2,77,87,
Osage,State Auditor,Cindy Byrd,REP,570109,25,28,499,552,
Osage,Attorney General,Mike Hunter,REP,570109,23,28,480,531,
Osage,Attorney General,Mark Myles,DEM,570109,10,5,126,141,
Osage,State Treasurer,Randy Mcdaniel,REP,570109,24,28,487,539,
Osage,State Treasurer,Charles De Coune,IND,570109,9,2,88,99,
Osage,Superintendent of Public Instruction,Joy Hofmeister,REP,570109,20,25,437,482,
Osage,Superintendent of Public Instruction,John Cox,DEM,570109,11,6,122,139,
Osage,Superintendent of Public Instruction,Larry Huff,IND,570109,2,2,45,49,
Osage,Commissioner of Labor,Leslie Osborn,REP,570109,24,28,455,507,
Osage,Commissioner of Labor,Fred Dorrell,DEM,570109,9,5,124,138,
Osage,Commissioner of Labor,Brandt Dismukes,IND,570109,0,0,20,20,
Osage,Insurance Commissioner,Glen Mulready,REP,570109,21,27,469,517,
Osage,Insurance Commissioner,Kimberly Fobbs,DEM,570109,12,6,135,153,
Osage,Corporation Commissioner,Bob Anthony,REP,570109,23,28,457,508,
Osage,Corporation Commissioner,Ashley Nicole Mccray,DEM,570109,7,5,114,126,
Osage,Corporation Commissioner,Jackie Short,IND,570109,3,0,34,37,
Osage,U.S. House,Frank Lucas,REP,570109,23,28,483,534,3
Osage,U.S. House,Frankie Robbins,DEM,570109,10,5,123,138,3
Osage,State House,Judd Strom,REP,570109,22,28,490,540,10
Osage,State House,Kevin Stacy,DEM,570109,11,5,119,135,10
Osage,Governor,Chris Powell,LIB,570110,2,0,18,20,
Osage,Governor,Kevin Stitt,REP,570110,16,12,374,402,
Osage,Governor,Drew Edmondson,DEM,570110,7,7,122,136,
Osage,Lieutenant Governor,Matt Pinnell,REP,570110,20,13,424,457,
Osage,Lieutenant Governor,Anastasia Pittman,DEM,570110,4,6,82,92,
Osage,Lieutenant Governor,Ivan Holmes,IND,570110,1,0,8,9,
Osage,State Auditor,John Yeutter,LIB,570110,3,1,64,68,
Osage,State Auditor,Cindy Byrd,REP,570110,19,15,430,464,
Osage,Attorney General,Mike Hunter,REP,570110,20,12,419,451,
Osage,Attorney General,Mark Myles,DEM,570110,4,7,92,103,
Osage,State Treasurer,Randy Mcdaniel,REP,570110,18,13,431,462,
Osage,State Treasurer,Charles De Coune,IND,570110,3,2,62,67,
Osage,Superintendent of Public Instruction,Joy Hofmeister,REP,570110,19,12,353,384,
Osage,Superintendent of Public Instruction,John Cox,DEM,570110,7,7,117,131,
Osage,Superintendent of Public Instruction,Larry Huff,IND,570110,0,0,40,40,
Osage,Commissioner of Labor,Leslie Osborn,REP,570110,18,12,387,417,
Osage,Commissioner of Labor,Fred Dorrell,DEM,570110,6,7,103,116,
Osage,Commissioner of Labor,Brandt Dismukes,IND,570110,0,0,16,16,
Osage,Insurance Commissioner,Glen Mulready,REP,570110,18,11,396,425,
Osage,Insurance Commissioner,Kimberly Fobbs,DEM,570110,7,8,112,127,
Osage,Corporation Commissioner,Bob Anthony,REP,570110,17,14,391,422,
Osage,Corporation Commissioner,Ashley Nicole Mccray,DEM,570110,7,5,96,108,
Osage,Corporation Commissioner,Jackie Short,IND,570110,1,0,24,25,
Osage,U.S. House,Frank Lucas,REP,570110,20,13,420,453,3
Osage,U.S. House,Frankie Robbins,DEM,570110,5,6,92,103,3
Osage,Governor,Chris Powell,LIB,570111,2,0,6,8,
Osage,Governor,Kevin Stitt,REP,570111,4,10,125,139,
Osage,Governor,Drew Edmondson,DEM,570111,0,3,50,53,
Osage,Lieutenant Governor,Matt Pinnell,REP,570111,4,10,132,146,
Osage,Lieutenant Governor,Anastasia Pittman,DEM,570111,0,3,45,48,
Osage,Lieutenant Governor,Ivan Holmes,IND,570111,2,0,0,2,
Osage,State Auditor,John Yeutter,LIB,570111,2,1,22,25,
Osage,State Auditor,Cindy Byrd,REP,570111,4,11,145,160,
Osage,Attorney General,Mike Hunter,REP,570111,4,11,132,147,
Osage,Attorney General,Mark Myles,DEM,570111,2,2,45,49,
Osage,State Treasurer,Randy Mcdaniel,REP,570111,4,11,138,153,
Osage,State Treasurer,Charles De Coune,IND,570111,2,1,27,30,
Osage,Superintendent of Public Instruction,Joy Hofmeister,REP,570111,4,9,113,126,
Osage,Superintendent of Public Instruction,John Cox,DEM,570111,0,4,54,58,
Osage,Superintendent of Public Instruction,Larry Huff,IND,570111,2,0,12,14,
Osage,Commissioner of Labor,Leslie Osborn,REP,570111,4,11,119,134,
Osage,Commissioner of Labor,Fred Dorrell,DEM,570111,0,2,50,52,
Osage,Commissioner of Labor,Brandt Dismukes,IND,570111,2,0,6,8,
Osage,Insurance Commissioner,Glen Mulready,REP,570111,4,10,124,138,
Osage,Insurance Commissioner,Kimberly Fobbs,DEM,570111,2,3,52,57,
Osage,Corporation Commissioner,Bob Anthony,REP,570111,4,10,135,149,
Osage,Corporation Commissioner,Ashley Nicole Mccray,DEM,570111,0,3,37,40,
Osage,Corporation Commissioner,Jackie Short,IND,570111,2,0,6,8,
Osage,U.S. House,Frank Lucas,REP,570111,6,11,133,150,3
Osage,U.S. House,Frankie Robbins,DEM,570111,0,2,47,49,3
Osage,Governor,Chris Powell,LIB,570112,0,0,13,13,
Osage,Governor,Kevin Stitt,REP,570112,17,19,228,264,
Osage,Governor,Drew Edmondson,DEM,570112,9,3,92,104,
Osage,Lieutenant Governor,Matt Pinnell,REP,570112,16,19,248,283,
Osage,Lieutenant Governor,Anastasia Pittman,DEM,570112,10,3,71,84,
Osage,Lieutenant Governor,Ivan Holmes,IND,570112,0,0,8,8,
Osage,State Auditor,John Yeutter,LIB,570112,5,2,48,55,
Osage,State Auditor,Cindy Byrd,REP,570112,19,18,261,298,
Osage,Attorney General,Mike Hunter,REP,570112,18,20,252,290,
Osage,Attorney General,Mark Myles,DEM,570112,8,2,75,85,
Osage,State Treasurer,Randy Mcdaniel,REP,570112,18,20,256,294,
Osage,State Treasurer,Charles De Coune,IND,570112,6,1,55,62,
Osage,Superintendent of Public Instruction,Joy Hofmeister,REP,570112,17,19,210,246,
Osage,Superintendent of Public Instruction,John Cox,DEM,570112,6,2,85,93,
Osage,Superintendent of Public Instruction,Larry Huff,IND,570112,3,1,33,37,
Osage,Commissioner of Labor,Leslie Osborn,REP,570112,18,18,226,262,
Osage,Commissioner of Labor,Fred Dorrell,DEM,570112,8,3,80,91,
Osage,Commissioner of Labor,Brandt Dismukes,IND,570112,0,1,19,20,
Osage,Insurance Commissioner,Glen Mulready,REP,570112,16,18,241,275,
Osage,Insurance Commissioner,Kimberly Fobbs,DEM,570112,10,3,86,99,
Osage,Corporation Commissioner,Bob Anthony,REP,570112,16,20,241,277,
Osage,Corporation Commissioner,Ashley Nicole Mccray,DEM,570112,6,2,63,71,
Osage,Corporation Commissioner,Jackie Short,IND,570112,4,0,23,27,
Osage,U.S. House,Frank Lucas,REP,570112,16,20,244,280,3
Osage,U.S. House,Frankie Robbins,DEM,570112,10,2,83,95,3
Osage,Governor,Chris Powell,LIB,570113,0,0,0,0,
Osage,Governor,Kevin Stitt,REP,570113,0,0,18,18,
Osage,Governor,Drew Edmondson,DEM,570113,2,2,19,23,
Osage,Lieutenant Governor,Matt Pinnell,REP,570113,0,0,22,22,
Osage,Lieutenant Governor,Anastasia Pittman,DEM,570113,2,2,15,19,
Osage,Lieutenant Governor,Ivan Holmes,IND,570113,0,0,0,0,
Osage,State Auditor,John Yeutter,LIB,570113,0,0,9,9,
Osage,State Auditor,Cindy Byrd,REP,570113,0,1,24,25,
Osage,Attorney General,Mike Hunter,REP,570113,0,0,24,24,
Osage,Attorney General,Mark Myles,DEM,570113,2,2,12,16,
Osage,State Treasurer,Randy Mcdaniel,REP,570113,0,1,23,24,
Osage,State Treasurer,Charles De Coune,IND,570113,0,0,9,9,
Osage,Superintendent of Public Instruction,Joy Hofmeister,REP,570113,0,0,21,21,
Osage,Superintendent of Public Instruction,John Cox,DEM,570113,2,3,12,17,
Osage,Superintendent of Public Instruction,Larry Huff,IND,570113,0,0,4,4,
Osage,Commissioner of Labor,Leslie Osborn,REP,570113,0,0,21,21,
Osage,Commissioner of Labor,Fred Dorrell,DEM,570113,2,3,13,18,
Osage,Commissioner of Labor,Brandt Dismukes,IND,570113,0,0,2,2,
Osage,Insurance Commissioner,Glen Mulready,REP,570113,0,0,20,20,
Osage,Insurance Commissioner,Kimberly Fobbs,DEM,570113,2,3,16,21,
Osage,Corporation Commissioner,Bob Anthony,REP,570113,0,0,19,19,
Osage,Corporation Commissioner,Ashley Nicole Mccray,DEM,570113,2,2,15,19,
Osage,Corporation Commissioner,Jackie Short,IND,570113,0,0,2,2,
Osage,U.S. House,Frank Lucas,REP,570113,0,1,24,25,3
Osage,U.S. House,Frankie Robbins,DEM,570113,2,1,13,16,3
Osage,Governor,Chris Powell,LIB,570201,2,4,62,68,
Osage,Governor,Kevin Stitt,REP,570201,36,112,911,1059,
Osage,Governor,Drew Edmondson,DEM,570201,21,49,399,469,
Osage,Lieutenant Governor,Matt Pinnell,REP,570201,40,123,994,1157,
Osage,Lieutenant Governor,Anastasia Pittman,DEM,570201,17,38,310,365,
Osage,Lieutenant Governor,Ivan Holmes,IND,570201,2,2,62,66,
Osage,State Auditor,John Yeutter,LIB,570201,6,23,269,298,
Osage,State Auditor,Cindy Byrd,REP,570201,43,130,1008,1181,
Osage,Attorney General,Mike Hunter,REP,570201,40,126,1008,1174,
Osage,Attorney General,Mark Myles,DEM,570201,19,37,342,398,
Osage,State Treasurer,Randy Mcdaniel,REP,570201,40,122,1010,1172,
Osage,State Treasurer,Charles De Coune,IND,570201,13,31,270,314,
Osage,Superintendent of Public Instruction,Joy Hofmeister,REP,570201,36,102,878,1016,
Osage,Superintendent of Public Instruction,John Cox,DEM,570201,18,44,365,427,
Osage,Superintendent of Public Instruction,Larry Huff,IND,570201,5,17,111,133,
Osage,Commissioner of Labor,Leslie Osborn,REP,570201,39,127,941,1107,
Osage,Commissioner of Labor,Fred Dorrell,DEM,570201,17,31,331,379,
Osage,Commissioner of Labor,Brandt Dismukes,IND,570201,3,3,71,77,
Osage,Insurance Commissioner,Glen Mulready,REP,570201,40,122,970,1132,
Osage,Insurance Commissioner,Kimberly Fobbs,DEM,570201,18,40,373,431,
Osage,Corporation Commissioner,Bob Anthony,REP,570201,38,121,941,1100,
Osage,Corporation Commissioner,Ashley Nicole Mccray,DEM,570201,16,36,323,375,
Osage,Corporation Commissioner,Jackie Short,IND,570201,5,6,90,101,
Osage,U.S. House,Frank Lucas,REP,570201,40,122,998,1160,3
Osage,U.S. House,Frankie Robbins,DEM,570201,19,40,353,412,3
Osage,Governor,Chris Powell,LIB,570202,2,0,24,26,
Osage,Governor,Kevin Stitt,REP,570202,21,7,111,139,
Osage,Governor,Drew Edmondson,DEM,570202,112,85,1006,1203,
Osage,Lieutenant Governor,Matt Pinnell,REP,570202,23,8,123,154,
Osage,Lieutenant Governor,Anastasia Pittman,DEM,570202,107,83,980,1170,
Osage,Lieutenant Governor,Ivan Holmes,IND,570202,5,1,33,39,
Osage,State Auditor,John Yeutter,LIB,570202,63,47,640,750,
Osage,State Auditor,Cindy Byrd,REP,570202,45,22,265,332,
Osage,Attorney General,Mike Hunter,REP,570202,23,9,140,172,
Osage,Attorney General,Mark Myles,DEM,570202,113,83,995,1191,
Osage,State Treasurer,Randy Mcdaniel,REP,570202,35,12,194,241,
Osage,State Treasurer,Charles De Coune,IND,570202,74,56,721,851,
Osage,Superintendent of Public Instruction,Joy Hofmeister,REP,570202,42,14,192,248,
Osage,Superintendent of Public Instruction,John Cox,DEM,570202,92,75,891,1058,
Osage,Superintendent of Public Instruction,Larry Huff,IND,570202,1,3,53,57,
Osage,Commissioner of Labor,Leslie Osborn,REP,570202,27,9,137,173,
Osage,Commissioner of Labor,Fred Dorrell,DEM,570202,107,81,971,1159,
Osage,Commissioner of Labor,Brandt Dismukes,IND,570202,2,0,26,28,
Osage,Insurance Commissioner,Glen Mulready,REP,570202,24,8,127,159,
Osage,Insurance Commissioner,Kimberly Fobbs,DEM,570202,112,83,1008,1203,
Osage,Corporation Commissioner,Bob Anthony,REP,570202,27,9,138,174,
Osage,Corporation Commissioner,Ashley Nicole Mccray,DEM,570202,104,80,955,1139,
Osage,Corporation Commissioner,Jackie Short,IND,570202,5,1,39,45,
Osage,U.S. House,Frank Lucas,REP,570202,25,8,134,167,3
Osage,U.S. House,Frankie Robbins,DEM,570202,111,84,999,1194,3
Osage,Governor,Chris Powell,LIB,570203,5,4,49,58,
Osage,Governor,Kevin Stitt,REP,570203,68,233,1150,1451,
Osage,Governor,Drew Edmondson,DEM,570203,51,96,438,585,
Osage,Lieutenant Governor,Matt Pinnell,REP,570203,84,256,1254,1594,
Osage,Lieutenant Governor,Anastasia Pittman,DEM,570203,36,73,324,433,
Osage,Lieutenant Governor,Ivan Holmes,IND,570203,4,4,53,61,
Osage,State Auditor,John Yeutter,LIB,570203,22,43,252,317,
Osage,State Auditor,Cindy Byrd,REP,570203,92,261,1301,1654,
Osage,Attorney General,Mike Hunter,REP,570203,88,258,1277,1623,
Osage,Attorney General,Mark Myles,DEM,570203,35,73,343,451,
Osage,State Treasurer,Randy Mcdaniel,REP,570203,90,250,1273,1613,
Osage,State Treasurer,Charles De Coune,IND,570203,26,56,279,361,
Osage,Superintendent of Public Instruction,Joy Hofmeister,REP,570203,73,232,1117,1422,
Osage,Superintendent of Public Instruction,John Cox,DEM,570203,40,81,371,492,
Osage,Superintendent of Public Instruction,Larry Huff,IND,570203,10,17,135,162,
Osage,Commissioner of Labor,Leslie Osborn,REP,570203,81,250,1198,1529,
Osage,Commissioner of Labor,Fred Dorrell,DEM,570203,33,69,338,440,
Osage,Commissioner of Labor,Brandt Dismukes,IND,570203,7,12,73,92,
Osage,Insurance Commissioner,Glen Mulready,REP,570203,79,256,1225,1560,
Osage,Insurance Commissioner,Kimberly Fobbs,DEM,570203,43,75,389,507,
Osage,Corporation Commissioner,Bob Anthony,REP,570203,79,249,1192,1520,
Osage,Corporation Commissioner,Ashley Nicole Mccray,DEM,570203,31,71,340,442,
Osage,Corporation Commissioner,Jackie Short,IND,570203,13,13,83,109,
Osage,U.S. House,Frank Lucas,REP,570203,83,252,1269,1604,3
Osage,U.S. House,Frankie Robbins,DEM,570203,40,79,355,474,3
Osage,Governor,Chris Powell,LIB,570204,0,3,14,17,
Osage,Governor,Kevin Stitt,REP,570204,17,21,307,345,
Osage,Governor,Drew Edmondson,DEM,570204,20,12,181,213,
Osage,Lieutenant Governor,Matt Pinnell,REP,570204,21,23,345,389,
Osage,Lieutenant Governor,Anastasia Pittman,DEM,570204,16,11,143,170,
Osage,Lieutenant Governor,Ivan Holmes,IND,570204,0,1,14,15,
Osage,State Auditor,John Yeutter,LIB,570204,10,9,77,96,
Osage,State Auditor,Cindy Byrd,REP,570204,23,23,375,421,
Osage,Attorney General,Mike Hunter,REP,570204,24,25,331,380,
Osage,Attorney General,Mark Myles,DEM,570204,13,11,167,191,
Osage,State Treasurer,Randy Mcdaniel,REP,570204,19,24,364,407,
Osage,State Treasurer,Charles De Coune,IND,570204,11,8,97,116,
Osage,Superintendent of Public Instruction,Joy Hofmeister,REP,570204,20,23,293,336,
Osage,Superintendent of Public Instruction,John Cox,DEM,570204,13,12,161,186,
Osage,Superintendent of Public Instruction,Larry Huff,IND,570204,4,1,43,48,
Osage,Commissioner of Labor,Leslie Osborn,REP,570204,20,24,312,356,
Osage,Commissioner of Labor,Fred Dorrell,DEM,570204,15,11,163,189,
Osage,Commissioner of Labor,Brandt Dismukes,IND,570204,1,1,20,22,
Osage,Insurance Commissioner,Glen Mulready,REP,570204,15,25,333,373,
Osage,Insurance Commissioner,Kimberly Fobbs,DEM,570204,21,11,161,193,
Osage,Corporation Commissioner,Bob Anthony,REP,570204,19,24,319,362,
Osage,Corporation Commissioner,Ashley Nicole Mccray,DEM,570204,16,10,153,179,
Osage,Corporation Commissioner,Jackie Short,IND,570204,2,2,23,27,
Osage,U.S. House,Frank Lucas,REP,570204,22,25,341,388,3
Osage,U.S. House,Frankie Robbins,DEM,570204,15,11,156,182,3
Osage,Governor,Chris Powell,LIB,570205,0,0,6,6,
Osage,Governor,Kevin Stitt,REP,570205,6,0,110,116,
Osage,Governor,Drew Edmondson,DEM,570205,6,2,55,63,
Osage,Lieutenant Governor,Matt Pinnell,REP,570205,6,0,118,124,
Osage,Lieutenant Governor,Anastasia Pittman,DEM,570205,6,2,51,59,
Osage,Lieutenant Governor,Ivan Holmes,IND,570205,0,0,3,3,
Osage,State Auditor,John Yeutter,LIB,570205,2,1,38,41,
Osage,State Auditor,Cindy Byrd,REP,570205,7,0,124,131,
Osage,Attorney General,Mike Hunter,REP,570205,6,0,120,126,
Osage,Attorney General,Mark Myles,DEM,570205,6,2,51,59,
Osage,State Treasurer,Randy Mcdaniel,REP,570205,7,0,117,124,
Osage,State Treasurer,Charles De Coune,IND,570205,2,1,46,49,
Osage,Superintendent of Public Instruction,Joy Hofmeister,REP,570205,4,0,114,118,
Osage,Superintendent of Public Instruction,John Cox,DEM,570205,7,2,44,53,
Osage,Superintendent of Public Instruction,Larry Huff,IND,570205,0,0,13,13,
Osage,Commissioner of Labor,Leslie Osborn,REP,570205,7,0,109,116,
Osage,Commissioner of Labor,Fred Dorrell,DEM,570205,5,2,51,58,
Osage,Commissioner of Labor,Brandt Dismukes,IND,570205,0,0,8,8,
Osage,Insurance Commissioner,Glen Mulready,REP,570205,6,0,114,120,
Osage,Insurance Commissioner,Kimberly Fobbs,DEM,570205,6,2,53,61,
Osage,Corporation Commissioner,Bob Anthony,REP,570205,5,0,110,115,
Osage,Corporation Commissioner,Ashley Nicole Mccray,DEM,570205,7,2,53,62,
Osage,Corporation Commissioner,Jackie Short,IND,570205,0,0,8,8,
Osage,U.S. House,Frank Lucas,REP,570205,6,0,120,126,3
Osage,U.S. House,Frankie Robbins,DEM,570205,6,2,52,60,3
Osage,Governor,Chris Powell,LIB,570301,0,0,12,12,
Osage,Governor,Kevin Stitt,REP,570301,9,2,231,242,
Osage,Governor,Drew Edmondson,DEM,570301,18,4,203,225,
Osage,Lieutenant Governor,Matt Pinnell,REP,570301,9,4,267,280,
Osage,Lieutenant Governor,Anastasia Pittman,DEM,570301,18,2,156,176,
Osage,Lieutenant Governor,Ivan Holmes,IND,570301,0,0,18,18,
Osage,State Auditor,John Yeutter,LIB,570301,3,0,97,100,
Osage,State Auditor,Cindy Byrd,REP,570301,12,5,306,323,
Osage,Attorney General,Mike Hunter,REP,570301,11,4,276,291,
Osage,Attorney General,Mark Myles,DEM,570301,16,2,161,179,
Osage,State Treasurer,Randy Mcdaniel,REP,570301,12,5,291,308,
Osage,State Treasurer,Charles De Coune,IND,570301,3,0,104,107,
Osage,Superintendent of Public Instruction,Joy Hofmeister,REP,570301,11,2,240,253,
Osage,Superintendent of Public Instruction,John Cox,DEM,570301,16,3,160,179,
Osage,Superintendent of Public Instruction,Larry Huff,IND,570301,0,1,41,42,
Osage,Commissioner of Labor,Leslie Osborn,REP,570301,10,2,251,263,
Osage,Commissioner of Labor,Fred Dorrell,DEM,570301,17,3,151,171,
Osage,Commissioner of Labor,Brandt Dismukes,IND,570301,0,1,33,34,
Osage,Insurance Commissioner,Glen Mulready,REP,570301,9,3,254,266,
Osage,Insurance Commissioner,Kimberly Fobbs,DEM,570301,18,3,182,203,
Osage,Corporation Commissioner,Bob Anthony,REP,570301,11,3,268,282,
Osage,Corporation Commissioner,Ashley Nicole Mccray,DEM,570301,16,2,143,161,
Osage,Corporation Commissioner,Jackie Short,IND,570301,0,1,27,28,
Osage,U.S. House,Frank Lucas,REP,570301,12,4,289,305,3
Osage,U.S. House,Frankie Robbins,DEM,570301,15,2,151,168,3
Osage,Governor,Chris Powell,LIB,570302,0,0,4,4,
Osage,Governor,Kevin Stitt,REP,570302,4,1,50,55,
Osage,Governor,Drew Edmondson,DEM,570302,3,0,40,43,
Osage,Lieutenant Governor,Matt Pinnell,REP,570302,4,1,55,60,
Osage,Lieutenant Governor,Anastasia Pittman,DEM,570302,3,0,35,38,
Osage,Lieutenant Governor,Ivan Holmes,IND,570302,0,0,4,4,
Osage,State Auditor,John Yeutter,LIB,570302,0,0,19,19,
Osage,State Auditor,Cindy Byrd,REP,570302,7,1,64,72,
Osage,Attorney General,Mike Hunter,REP,570302,6,1,62,69,
Osage,Attorney General,Mark Myles,DEM,570302,1,0,32,33,
Osage,State Treasurer,Randy Mcdaniel,REP,570302,3,1,57,61,
Osage,State Treasurer,Charles De Coune,IND,570302,4,0,28,32,
Osage,Superintendent of Public Instruction,Joy Hofmeister,REP,570302,6,1,48,55,
Osage,Superintendent of Public Instruction,John Cox,DEM,570302,0,0,36,36,
Osage,Superintendent of Public Instruction,Larry Huff,IND,570302,1,0,10,11,
Osage,Commissioner of Labor,Leslie Osborn,REP,570302,4,1,50,55,
Osage,Commissioner of Labor,Fred Dorrell,DEM,570302,2,0,38,40,
Osage,Commissioner of Labor,Brandt Dismukes,IND,570302,1,0,5,6,
Osage,Insurance Commissioner,Glen Mulready,REP,570302,4,1,61,66,
Osage,Insurance Commissioner,Kimberly Fobbs,DEM,570302,3,0,32,35,
Osage,Corporation Commissioner,Bob Anthony,REP,570302,5,1,59,65,
Osage,Corporation Commissioner,Ashley Nicole Mccray,DEM,570302,2,0,26,28,
Osage,Corporation Commissioner,Jackie Short,IND,570302,0,0,9,9,
Osage,U.S. House,Frank Lucas,REP,570302,4,1,64,69,3
Osage,U.S. House,Frankie Robbins,DEM,570302,3,0,30,33,3
Osage,Governor,Chris Powell,LIB,570303,0,0,14,14,
Osage,Governor,Kevin Stitt,REP,570303,8,5,188,201,
Osage,Governor,Drew Edmondson,DEM,570303,10,2,90,102,
Osage,Lieutenant Governor,Matt Pinnell,REP,570303,8,5,211,224,
Osage,Lieutenant Governor,Anastasia Pittman,DEM,570303,9,2,73,84,
Osage,Lieutenant Governor,Ivan Holmes,IND,570303,1,0,8,9,
Osage,State Auditor,John Yeutter,LIB,570303,4,1,48,53,
Osage,State Auditor,Cindy Byrd,REP,570303,11,6,231,248,
Osage,Attorney General,Mike Hunter,REP,570303,11,5,214,230,
Osage,Attorney General,Mark Myles,DEM,570303,7,2,78,87,
Osage,State Treasurer,Randy Mcdaniel,REP,570303,11,4,228,243,
Osage,State Treasurer,Charles De Coune,IND,570303,4,2,51,57,
Osage,Superintendent of Public Instruction,Joy Hofmeister,REP,570303,10,5,198,213,
Osage,Superintendent of Public Instruction,John Cox,DEM,570303,7,2,72,81,
Osage,Superintendent of Public Instruction,Larry Huff,IND,570303,1,0,22,23,
Osage,Commissioner of Labor,Leslie Osborn,REP,570303,10,5,199,214,
Osage,Commissioner of Labor,Fred Dorrell,DEM,570303,8,2,76,86,
Osage,Commissioner of Labor,Brandt Dismukes,IND,570303,0,0,14,14,
Osage,Insurance Commissioner,Glen Mulready,REP,570303,7,5,203,215,
Osage,Insurance Commissioner,Kimberly Fobbs,DEM,570303,11,2,85,98,
Osage,Corporation Commissioner,Bob Anthony,REP,570303,8,5,184,197,
Osage,Corporation Commissioner,Ashley Nicole Mccray,DEM,570303,7,2,85,94,
Osage,Corporation Commissioner,Jackie Short,IND,570303,2,0,20,22,
Osage,U.S. House,Frank Lucas,REP,570303,11,5,227,243,3
Osage,U.S. House,Frankie Robbins,DEM,570303,7,2,67,76,3
Osage,Governor,Chris Powell,LIB,570305,3,0,15,18,
Osage,Governor,Kevin Stitt,REP,570305,17,8,206,231,
Osage,Governor,Drew Edmondson,DEM,570305,10,2,95,107,
Osage,Lieutenant Governor,Matt Pinnell,REP,570305,18,8,219,245,
Osage,Lieutenant Governor,Anastasia Pittman,DEM,570305,12,2,84,98,
Osage,Lieutenant Governor,Ivan Holmes,IND,570305,0,0,12,12,
Osage,State Auditor,John Yeutter,LIB,570305,1,2,52,55,
Osage,State Auditor,Cindy Byrd,REP,570305,27,8,241,276,
Osage,Attorney General,Mike Hunter,REP,570305,17,7,223,247,
Osage,Attorney General,Mark Myles,DEM,570305,13,3,90,106,
Osage,State Treasurer,Randy Mcdaniel,REP,570305,23,8,239,270,
Osage,State Treasurer,Charles De Coune,IND,570305,5,2,50,57,
Osage,Superintendent of Public Instruction,Joy Hofmeister,REP,570305,17,7,198,222,
Osage,Superintendent of Public Instruction,John Cox,DEM,570305,11,2,86,99,
Osage,Superintendent of Public Instruction,Larry Huff,IND,570305,2,1,29,32,
Osage,Commissioner of Labor,Leslie Osborn,REP,570305,16,7,214,237,
Osage,Commissioner of Labor,Fred Dorrell,DEM,570305,14,2,86,102,
Osage,Commissioner of Labor,Brandt Dismukes,IND,570305,0,1,14,15,
Osage,Insurance Commissioner,Glen Mulready,REP,570305,14,8,218,240,
Osage,Insurance Commissioner,Kimberly Fobbs,DEM,570305,16,2,95,113,
Osage,Corporation Commissioner,Bob Anthony,REP,570305,18,8,216,242,
Osage,Corporation Commissioner,Ashley Nicole Mccray,DEM,570305,12,2,80,94,
Osage,Corporation Commissioner,Jackie Short,IND,570305,0,0,18,18,
Osage,U.S. House,Frank Lucas,REP,570305,20,8,231,259,3
Osage,U.S. House,Frankie Robbins,DEM,570305,10,2,83,95,3
Osage,State House,Ty Burns,REP,570305,20,8,220,248,35
Osage,State House,Jasha Lyons Echo-Hawk,DEM,570305,10,2,94,106,35
Osage,Governor,Chris Powell,LIB,570306,1,0,9,10,
Osage,Governor,Kevin Stitt,REP,570306,4,12,272,288,
Osage,Governor,Drew Edmondson,DEM,570306,5,1,104,110,
Osage,Lieutenant Governor,Matt Pinnell,REP,570306,7,13,281,301,
Osage,Lieutenant Governor,Anastasia Pittman,DEM,570306,3,0,91,94,
Osage,Lieutenant Governor,Ivan Holmes,IND,570306,0,0,10,10,
Osage,State Auditor,John Yeutter,LIB,570306,1,1,63,65,
Osage,State Auditor,Cindy Byrd,REP,570306,8,12,298,318,
Osage,Attorney General,Mike Hunter,REP,570306,5,12,280,297,
Osage,Attorney General,Mark Myles,DEM,570306,5,1,102,108,
Osage,State Treasurer,Randy Mcdaniel,REP,570306,7,13,293,313,
Osage,State Treasurer,Charles De Coune,IND,570306,3,0,67,70,
Osage,Superintendent of Public Instruction,Joy Hofmeister,REP,570306,8,12,247,267,
Osage,Superintendent of Public Instruction,John Cox,DEM,570306,2,0,98,100,
Osage,Superintendent of Public Instruction,Larry Huff,IND,570306,0,1,38,39,
Osage,Commissioner of Labor,Leslie Osborn,REP,570306,5,13,268,286,
Osage,Commissioner of Labor,Fred Dorrell,DEM,570306,5,0,90,95,
Osage,Commissioner of Labor,Brandt Dismukes,IND,570306,0,0,21,21,
Osage,Insurance Commissioner,Glen Mulready,REP,570306,8,13,272,293,
Osage,Insurance Commissioner,Kimberly Fobbs,DEM,570306,2,0,109,111,
Osage,Corporation Commissioner,Bob Anthony,REP,570306,5,13,270,288,
Osage,Corporation Commissioner,Ashley Nicole Mccray,DEM,570306,5,0,92,97,
Osage,Corporation Commissioner,Jackie Short,IND,570306,0,0,18,18,
Osage,U.S. House,Frank Lucas,REP,570306,7,13,284,304,3
Osage,U.S. House,Frankie Robbins,DEM,570306,3,0,98,101,3
Osage,Governor,Chris Powell,LIB,570307,0,0,11,11,
Osage,Governor,Kevin Stitt,REP,570307,4,8,254,266,
Osage,Governor,Drew Edmondson,DEM,570307,8,11,207,226,
Osage,Lieutenant Governor,Matt Pinnell,REP,570307,5,8,283,296,
Osage,Lieutenant Governor,Anastasia Pittman,DEM,570307,7,10,171,188,
Osage,Lieutenant Governor,Ivan Holmes,IND,570307,0,1,13,14,
Osage,State Auditor,John Yeutter,LIB,570307,3,2,123,128,
Osage,State Auditor,Cindy Byrd,REP,570307,7,14,309,330,
Osage,Attorney General,Mike Hunter,REP,570307,6,9,279,294,
Osage,Attorney General,Mark Myles,DEM,570307,6,10,185,201,
Osage,State Treasurer,Randy Mcdaniel,REP,570307,6,12,305,323,
Osage,State Treasurer,Charles De Coune,IND,570307,4,4,123,131,
Osage,Superintendent of Public Instruction,Joy Hofmeister,REP,570307,5,12,242,259,
Osage,Superintendent of Public Instruction,John Cox,DEM,570307,7,7,189,203,
Osage,Superintendent of Public Instruction,Larry Huff,IND,570307,0,0,34,34,
Osage,Commissioner of Labor,Leslie Osborn,REP,570307,4,10,254,268,
Osage,Commissioner of Labor,Fred Dorrell,DEM,570307,8,9,190,207,
Osage,Commissioner of Labor,Brandt Dismukes,IND,570307,0,0,19,19,
Osage,Insurance Commissioner,Glen Mulready,REP,570307,3,9,261,273,
Osage,Insurance Commissioner,Kimberly Fobbs,DEM,570307,9,10,201,220,
Osage,Corporation Commissioner,Bob Anthony,REP,570307,3,11,263,277,
Osage,Corporation Commissioner,Ashley Nicole Mccray,DEM,570307,8,8,178,194,
Osage,Corporation Commissioner,Jackie Short,IND,570307,0,0,21,21,
Osage,U.S. House,Frank Lucas,REP,570307,5,9,277,291,3
Osage,U.S. House,Frankie Robbins,DEM,570307,7,10,189,206,3
Osage,Governor,Chris Powell,LIB,570308,5,0,32,37,
Osage,Governor,Kevin Stitt,REP,570308,27,16,570,613,
Osage,Governor,Drew Edmondson,DEM,570308,27,14,263,304,
Osage,Lieutenant Governor,Matt Pinnell,REP,570308,30,16,626,672,
Osage,Lieutenant Governor,Anastasia Pittman,DEM,570308,24,12,202,238,
Osage,Lieutenant Governor,Ivan Holmes,IND,570308,3,2,33,38,
Osage,State Auditor,John Yeutter,LIB,570308,12,5,157,174,
Osage,State Auditor,Cindy Byrd,REP,570308,38,21,653,712,
Osage,Attorney General,Mike Hunter,REP,570308,29,17,641,687,
Osage,Attorney General,Mark Myles,DEM,570308,25,13,217,255,
Osage,State Treasurer,Randy Mcdaniel,REP,570308,30,18,628,676,
Osage,State Treasurer,Charles De Coune,IND,570308,20,8,177,205,
Osage,Superintendent of Public Instruction,Joy Hofmeister,REP,570308,36,20,555,611,
Osage,Superintendent of Public Instruction,John Cox,DEM,570308,19,9,219,247,
Osage,Superintendent of Public Instruction,Larry Huff,IND,570308,1,1,84,86,
Osage,Commissioner of Labor,Leslie Osborn,REP,570308,32,20,578,630,
Osage,Commissioner of Labor,Fred Dorrell,DEM,570308,18,10,228,256,
Osage,Commissioner of Labor,Brandt Dismukes,IND,570308,3,0,47,50,
Osage,Insurance Commissioner,Glen Mulready,REP,570308,32,16,628,676,
Osage,Insurance Commissioner,Kimberly Fobbs,DEM,570308,23,13,229,265,
Osage,Corporation Commissioner,Bob Anthony,REP,570308,34,18,605,657,
Osage,Corporation Commissioner,Ashley Nicole Mccray,DEM,570308,21,11,210,242,
Osage,Corporation Commissioner,Jackie Short,IND,570308,1,1,46,48,
Osage,U.S. House,Frank Lucas,REP,570308,35,16,636,687,3
Osage,U.S. House,Frankie Robbins,DEM,570308,21,14,225,260,3
Osage,Governor,Chris Powell,LIB,570309,0,0,10,10,
Osage,Governor,Kevin Stitt,REP,570309,18,6,348,372,
Osage,Governor,Drew Edmondson,DEM,570309,5,3,93,101,
Osage,Lieutenant Governor,Matt Pinnell,REP,570309,21,7,363,391,
Osage,Lieutenant Governor,Anastasia Pittman,DEM,570309,4,2,77,83,
Osage,Lieutenant Governor,Ivan Holmes,IND,570309,0,0,9,9,
Osage,State Auditor,John Yeutter,LIB,570309,3,2,63,68,
Osage,State Auditor,Cindy Byrd,REP,570309,22,7,375,404,
Osage,Attorney General,Mike Hunter,REP,570309,21,7,372,400,
Osage,Attorney General,Mark Myles,DEM,570309,4,2,77,83,
Osage,State Treasurer,Randy Mcdaniel,REP,570309,20,7,368,395,
Osage,State Treasurer,Charles De Coune,IND,570309,4,2,68,74,
Osage,Superintendent of Public Instruction,Joy Hofmeister,REP,570309,18,6,323,347,
Osage,Superintendent of Public Instruction,John Cox,DEM,570309,2,3,82,87,
Osage,Superintendent of Public Instruction,Larry Huff,IND,570309,5,0,43,48,
Osage,Commissioner of Labor,Leslie Osborn,REP,570309,22,6,348,376,
Osage,Commissioner of Labor,Fred Dorrell,DEM,570309,3,3,75,81,
Osage,Commissioner of Labor,Brandt Dismukes,IND,570309,0,0,19,19,
Osage,Insurance Commissioner,Glen Mulready,REP,570309,20,6,354,380,
Osage,Insurance Commissioner,Kimberly Fobbs,DEM,570309,5,3,89,97,
Osage,Corporation Commissioner,Bob Anthony,REP,570309,22,6,344,372,
Osage,Corporation Commissioner,Ashley Nicole Mccray,DEM,570309,3,2,78,83,
Osage,Corporation Commissioner,Jackie Short,IND,570309,0,1,25,26,
Osage,U.S. House,Frank Lucas,REP,570309,23,6,372,401,3
Osage,U.S. House,Frankie Robbins,DEM,570309,2,3,77,82,3
Osage,Governor,Chris Powell,LIB,570310,1,0,20,21,
Osage,Governor,Kevin Stitt,REP,570310,6,4,59,69,
Osage,Governor,Drew Edmondson,DEM,570310,43,23,659,725,
Osage,Lieutenant Governor,Matt Pinnell,REP,570310,6,4,67,77,
Osage,Lieutenant Governor,Anastasia Pittman,DEM,570310,42,21,652,715,
Osage,Lieutenant Governor,Ivan Holmes,IND,570310,2,2,19,23,
Osage,State Auditor,John Yeutter,LIB,570310,23,14,440,477,
Osage,State Auditor,Cindy Byrd,REP,570310,14,8,156,178,
Osage,Attorney General,Mike Hunter,REP,570310,6,6,74,86,
Osage,Attorney General,Mark Myles,DEM,570310,43,21,663,727,
Osage,State Treasurer,Randy Mcdaniel,REP,570310,7,7,99,113,
Osage,State Treasurer,Charles De Coune,IND,570310,29,15,497,541,
Osage,Superintendent of Public Instruction,Joy Hofmeister,REP,570310,8,6,102,116,
Osage,Superintendent of Public Instruction,John Cox,DEM,570310,40,20,604,664,
Osage,Superintendent of Public Instruction,Larry Huff,IND,570310,2,1,31,34,
Osage,Commissioner of Labor,Leslie Osborn,REP,570310,7,6,63,76,
Osage,Commissioner of Labor,Fred Dorrell,DEM,570310,42,21,650,713,
Osage,Commissioner of Labor,Brandt Dismukes,IND,570310,1,0,19,20,
Osage,Insurance Commissioner,Glen Mulready,REP,570310,7,4,72,83,
Osage,Insurance Commissioner,Kimberly Fobbs,DEM,570310,43,23,662,728,
Osage,Corporation Commissioner,Bob Anthony,REP,570310,8,5,71,84,
Osage,Corporation Commissioner,Ashley Nicole Mccray,DEM,570310,41,22,638,701,
Osage,Corporation Commissioner,Jackie Short,IND,570310,1,0,24,25,
Osage,U.S. House,Frank Lucas,REP,570310,7,5,75,87,3
Osage,U.S. House,Frankie Robbins,DEM,570310,43,22,661,726,3
Osage,Governor,Chris Powell,LIB,570311,0,0,1,1,
Osage,Governor,Kevin Stitt,REP,570311,12,3,33,48,
Osage,Governor,Drew Edmondson,DEM,570311,9,0,37,46,
Osage,Lieutenant Governor,Matt Pinnell,REP,570311,14,3,39,56,
Osage,Lieutenant Governor,Anastasia Pittman,DEM,570311,7,0,31,38,
Osage,Lieutenant Governor,Ivan Holmes,IND,570311,0,0,0,0,
Osage,State Auditor,John Yeutter,LIB,570311,3,0,17,20,
Osage,State Auditor,Cindy Byrd,REP,570311,16,3,44,63,
Osage,Attorney General,Mike Hunter,REP,570311,15,3,40,58,
Osage,Attorney General,Mark Myles,DEM,570311,6,0,30,36,
Osage,State Treasurer,Randy Mcdaniel,REP,570311,15,3,40,58,
Osage,State Treasurer,Charles De Coune,IND,570311,4,0,22,26,
Osage,Superintendent of Public Instruction,Joy Hofmeister,REP,570311,17,3,37,57,
Osage,Superintendent of Public Instruction,John Cox,DEM,570311,4,0,29,33,
Osage,Superintendent of Public Instruction,Larry Huff,IND,570311,0,0,4,4,
Osage,Commissioner of Labor,Leslie Osborn,REP,570311,15,3,40,58,
Osage,Commissioner of Labor,Fred Dorrell,DEM,570311,5,0,28,33,
Osage,Commissioner of Labor,Brandt Dismukes,IND,570311,1,0,2,3,
Osage,Insurance Commissioner,Glen Mulready,REP,570311,14,3,37,54,
Osage,Insurance Commissioner,Kimberly Fobbs,DEM,570311,7,0,33,40,
Osage,Corporation Commissioner,Bob Anthony,REP,570311,17,3,36,56,
Osage,Corporation Commissioner,Ashley Nicole Mccray,DEM,570311,4,0,32,36,
Osage,Corporation Commissioner,Jackie Short,IND,570311,0,0,2,2,
Osage,U.S. House,Frank Lucas,REP,570311,16,3,41,60,3
Osage,U.S. House,Frankie Robbins,DEM,570311,5,0,29,34,3
Osage,State House,Jadine Nollan,REP,570311,16,3,37,56,66
Osage,State House,Angela Graham,DEM,570311,5,0,33,38,66
Osage,Governor,Chris Powell,LIB,570312,1,0,12,13,
Osage,Governor,Kevin Stitt,REP,570312,32,6,291,329,
Osage,Governor,Drew Edmondson,DEM,570312,14,7,169,190,
Osage,Lieutenant Governor,Matt Pinnell,REP,570312,30,6,315,351,
Osage,Lieutenant Governor,Anastasia Pittman,DEM,570312,13,7,144,164,
Osage,Lieutenant Governor,Ivan Holmes,IND,570312,4,0,13,17,
Osage,State Auditor,John Yeutter,LIB,570312,10,5,91,106,
Osage,State Auditor,Cindy Byrd,REP,570312,34,8,350,392,
Osage,Attorney General,Mike Hunter,REP,570312,34,6,320,360,
Osage,Attorney General,Mark Myles,DEM,570312,13,7,151,171,
Osage,State Treasurer,Randy Mcdaniel,REP,570312,31,7,340,378,
Osage,State Treasurer,Charles De Coune,IND,570312,14,6,100,120,
Osage,Superintendent of Public Instruction,Joy Hofmeister,REP,570312,31,7,298,336,
Osage,Superintendent of Public Instruction,John Cox,DEM,570312,11,6,146,163,
Osage,Superintendent of Public Instruction,Larry Huff,IND,570312,5,0,28,33,
Osage,Commissioner of Labor,Leslie Osborn,REP,570312,31,7,305,343,
Osage,Commissioner of Labor,Fred Dorrell,DEM,570312,11,6,147,164,
Osage,Commissioner of Labor,Brandt Dismukes,IND,570312,3,0,17,20,
Osage,Insurance Commissioner,Glen Mulready,REP,570312,32,7,324,363,
Osage,Insurance Commissioner,Kimberly Fobbs,DEM,570312,15,6,147,168,
Osage,Corporation Commissioner,Bob Anthony,REP,570312,32,7,292,331,
Osage,Corporation Commissioner,Ashley Nicole Mccray,DEM,570312,12,6,148,166,
Osage,Corporation Commissioner,Jackie Short,IND,570312,3,0,30,33,
Osage,U.S. House,Frank Lucas,REP,570312,32,6,324,362,3
Osage,U.S. House,Frankie Robbins,DEM,570312,15,7,146,168,3
Osage,State House,Jadine Nollan,REP,570312,33,6,321,360,66
Osage,State House,Angela Graham,DEM,570312,14,7,147,168,66
Ottawa,Governor,Chris Powell,LIB,580002,0,2,15,17,
Ottawa,Governor,Kevin Stitt,REP,580002,12,35,186,233,
Ottawa,Governor,Drew Edmondson,DEM,580002,4,25,179,208,
Ottawa,Lieutenant Governor,Matt Pinnell,REP,580002,11,39,229,279,
Ottawa,Lieutenant Governor,Anastasia Pittman,DEM,580002,4,21,128,153,
Ottawa,Lieutenant Governor,Ivan Holmes,IND,580002,0,2,18,20,
Ottawa,State Auditor,John Yeutter,LIB,580002,4,13,88,105,
Ottawa,State Auditor,Cindy Byrd,REP,580002,12,43,273,328,
Ottawa,Attorney General,Mike Hunter,REP,580002,11,42,240,293,
Ottawa,Attorney General,Mark Myles,DEM,580002,5,20,137,162,
Ottawa,State Treasurer,Randy Mcdaniel,REP,580002,10,40,270,320,
Ottawa,State Treasurer,Charles De Coune,IND,580002,5,16,95,116,
Ottawa,Superintendent of Public Instruction,Joy Hofmeister,REP,580002,9,40,201,250,
Ottawa,Superintendent of Public Instruction,John Cox,DEM,580002,5,21,155,181,
Ottawa,Superintendent of Public Instruction,Larry Huff,IND,580002,2,1,24,27,
Ottawa,Commissioner of Labor,Leslie Osborn,REP,580002,10,38,236,284,
Ottawa,Commissioner of Labor,Fred Dorrell,DEM,580002,6,19,125,150,
Ottawa,Commissioner of Labor,Brandt Dismukes,IND,580002,0,3,17,20,
Ottawa,Insurance Commissioner,Glen Mulready,REP,580002,11,39,228,278,
Ottawa,Insurance Commissioner,Kimberly Fobbs,DEM,580002,5,22,149,176,
Ottawa,Corporation Commissioner,Bob Anthony,REP,580002,11,37,207,255,
Ottawa,Corporation Commissioner,Ashley Nicole Mccray,DEM,580002,5,23,146,174,
Ottawa,Corporation Commissioner,Jackie Short,IND,580002,0,1,23,24,
Ottawa,U.S. House,Richard Castaldo,LIB,580002,0,1,10,11,2
Ottawa,U.S. House,Markwayne Mullin,REP,580002,12,37,221,270,2
Ottawa,U.S. House,Jason Nichols,DEM,580002,4,22,132,158,2
Ottawa,U.S. House,John Foreman,IND,580002,0,2,18,20,2
Ottawa,State House,William Leonard,REP,580002,7,26,133,166,7
Ottawa,State House,Ben Loring,DEM,580002,9,36,249,294,7
Ottawa,Governor,Chris Powell,LIB,580003,1,0,13,14,
Ottawa,Governor,Kevin Stitt,REP,580003,9,36,242,287,
Ottawa,Governor,Drew Edmondson,DEM,580003,8,42,252,302,
Ottawa,Lieutenant Governor,Matt Pinnell,REP,580003,9,36,312,357,
Ottawa,Lieutenant Governor,Anastasia Pittman,DEM,580003,6,39,171,216,
Ottawa,Lieutenant Governor,Ivan Holmes,IND,580003,2,2,19,23,
Ottawa,State Auditor,John Yeutter,LIB,580003,5,12,108,125,
Ottawa,State Auditor,Cindy Byrd,REP,580003,11,52,360,423,
Ottawa,Attorney General,Mike Hunter,REP,580003,11,35,314,360,
Ottawa,Attorney General,Mark Myles,DEM,580003,6,41,187,234,
Ottawa,State Treasurer,Randy Mcdaniel,REP,580003,9,40,344,393,
Ottawa,State Treasurer,Charles De Coune,IND,580003,6,23,128,157,
Ottawa,Superintendent of Public Instruction,Joy Hofmeister,REP,580003,11,35,250,296,
Ottawa,Superintendent of Public Instruction,John Cox,DEM,580003,6,39,221,266,
Ottawa,Superintendent of Public Instruction,Larry Huff,IND,580003,0,2,33,35,
Ottawa,Commissioner of Labor,Leslie Osborn,REP,580003,9,41,312,362,
Ottawa,Commissioner of Labor,Fred Dorrell,DEM,580003,6,35,166,207,
Ottawa,Commissioner of Labor,Brandt Dismukes,IND,580003,2,0,20,22,
Ottawa,Insurance Commissioner,Glen Mulready,REP,580003,9,36,299,344,
Ottawa,Insurance Commissioner,Kimberly Fobbs,DEM,580003,7,40,201,248,
Ottawa,Corporation Commissioner,Bob Anthony,REP,580003,9,37,281,327,
Ottawa,Corporation Commissioner,Ashley Nicole Mccray,DEM,580003,6,39,190,235,
Ottawa,Corporation Commissioner,Jackie Short,IND,580003,1,2,29,32,
Ottawa,U.S. House,Richard Castaldo,LIB,580003,1,2,11,14,2
Ottawa,U.S. House,Markwayne Mullin,REP,580003,9,35,278,322,2
Ottawa,U.S. House,Jason Nichols,DEM,580003,6,38,193,237,2
Ottawa,U.S. House,John Foreman,IND,580003,1,2,23,26,2
Ottawa,State House,William Leonard,REP,580003,9,26,183,218,7
Ottawa,State House,Ben Loring,DEM,580003,8,52,322,382,7
Ottawa,Governor,Chris Powell,LIB,580004,0,0,9,9,
Ottawa,Governor,Kevin Stitt,REP,580004,10,30,119,159,
Ottawa,Governor,Drew Edmondson,DEM,580004,14,14,127,155,
Ottawa,Lieutenant Governor,Matt Pinnell,REP,580004,12,32,134,178,
Ottawa,Lieutenant Governor,Anastasia Pittman,DEM,580004,11,10,105,126,
Ottawa,Lieutenant Governor,Ivan Holmes,IND,580004,1,2,14,17,
Ottawa,State Auditor,John Yeutter,LIB,580004,5,8,56,69,
Ottawa,State Auditor,Cindy Byrd,REP,580004,13,35,174,222,
Ottawa,Attorney General,Mike Hunter,REP,580004,11,31,146,188,
Ottawa,Attorney General,Mark Myles,DEM,580004,12,13,104,129,
Ottawa,State Treasurer,Randy Mcdaniel,REP,580004,12,34,165,211,
Ottawa,State Treasurer,Charles De Coune,IND,580004,6,9,62,77,
Ottawa,Superintendent of Public Instruction,Joy Hofmeister,REP,580004,10,31,110,151,
Ottawa,Superintendent of Public Instruction,John Cox,DEM,580004,12,11,118,141,
Ottawa,Superintendent of Public Instruction,Larry Huff,IND,580004,1,2,20,23,
Ottawa,Commissioner of Labor,Leslie Osborn,REP,580004,11,29,133,173,
Ottawa,Commissioner of Labor,Fred Dorrell,DEM,580004,11,15,98,124,
Ottawa,Commissioner of Labor,Brandt Dismukes,IND,580004,1,0,12,13,
Ottawa,Insurance Commissioner,Glen Mulready,REP,580004,12,30,138,180,
Ottawa,Insurance Commissioner,Kimberly Fobbs,DEM,580004,11,14,107,132,
Ottawa,Corporation Commissioner,Bob Anthony,REP,580004,10,27,126,163,
Ottawa,Corporation Commissioner,Ashley Nicole Mccray,DEM,580004,13,14,107,134,
Ottawa,Corporation Commissioner,Jackie Short,IND,580004,0,2,15,17,
Ottawa,U.S. House,Richard Castaldo,LIB,580004,0,0,4,4,2
Ottawa,U.S. House,Markwayne Mullin,REP,580004,11,27,124,162,2
Ottawa,U.S. House,Jason Nichols,DEM,580004,12,16,113,141,2
Ottawa,U.S. House,John Foreman,IND,580004,0,1,10,11,2
Ottawa,State House,William Leonard,REP,580004,7,14,77,98,7
Ottawa,State House,Ben Loring,DEM,580004,16,30,177,223,7
Ottawa,Governor,Chris Powell,LIB,580005,0,1,14,15,
Ottawa,Governor,Kevin Stitt,REP,580005,2,16,121,139,
Ottawa,Governor,Drew Edmondson,DEM,580005,4,20,119,143,
Ottawa,Lieutenant Governor,Matt Pinnell,REP,580005,2,15,141,158,
Ottawa,Lieutenant Governor,Anastasia Pittman,DEM,580005,4,19,95,118,
Ottawa,Lieutenant Governor,Ivan Holmes,IND,580005,0,2,15,17,
Ottawa,State Auditor,John Yeutter,LIB,580005,3,8,60,71,
Ottawa,State Auditor,Cindy Byrd,REP,580005,2,21,170,193,
Ottawa,Attorney General,Mike Hunter,REP,580005,3,17,148,168,
Ottawa,Attorney General,Mark Myles,DEM,580005,3,19,102,124,
Ottawa,State Treasurer,Randy Mcdaniel,REP,580005,2,18,155,175,
Ottawa,State Treasurer,Charles De Coune,IND,580005,3,12,76,91,
Ottawa,Superintendent of Public Instruction,Joy Hofmeister,REP,580005,2,12,125,139,
Ottawa,Superintendent of Public Instruction,John Cox,DEM,580005,3,20,104,127,
Ottawa,Superintendent of Public Instruction,Larry Huff,IND,580005,0,3,21,24,
Ottawa,Commissioner of Labor,Leslie Osborn,REP,580005,2,13,146,161,
Ottawa,Commissioner of Labor,Fred Dorrell,DEM,580005,3,18,94,115,
Ottawa,Commissioner of Labor,Brandt Dismukes,IND,580005,0,5,11,16,
Ottawa,Insurance Commissioner,Glen Mulready,REP,580005,2,15,136,153,
Ottawa,Insurance Commissioner,Kimberly Fobbs,DEM,580005,3,21,113,137,
Ottawa,Corporation Commissioner,Bob Anthony,REP,580005,2,15,132,149,
Ottawa,Corporation Commissioner,Ashley Nicole Mccray,DEM,580005,3,15,108,126,
Ottawa,Corporation Commissioner,Jackie Short,IND,580005,0,6,13,19,
Ottawa,U.S. House,Richard Castaldo,LIB,580005,1,1,7,9,2
Ottawa,U.S. House,Markwayne Mullin,REP,580005,2,16,142,160,2
Ottawa,U.S. House,Jason Nichols,DEM,580005,2,17,93,112,2
Ottawa,U.S. House,John Foreman,IND,580005,0,2,9,11,2
Ottawa,State House,William Leonard,REP,580005,0,15,95,110,7
Ottawa,State House,Ben Loring,DEM,580005,5,21,158,184,7
Ottawa,Governor,Chris Powell,LIB,580007,0,1,17,18,
Ottawa,Governor,Kevin Stitt,REP,580007,9,53,374,436,
Ottawa,Governor,Drew Edmondson,DEM,580007,12,43,331,386,
Ottawa,Lieutenant Governor,Matt Pinnell,REP,580007,8,64,436,508,
Ottawa,Lieutenant Governor,Anastasia Pittman,DEM,580007,12,32,248,292,
Ottawa,Lieutenant Governor,Ivan Holmes,IND,580007,1,1,31,33,
Ottawa,State Auditor,John Yeutter,LIB,580007,5,14,168,187,
Ottawa,State Auditor,Cindy Byrd,REP,580007,10,78,513,601,
Ottawa,Attorney General,Mike Hunter,REP,580007,9,60,460,529,
Ottawa,Attorney General,Mark Myles,DEM,580007,11,36,252,299,
Ottawa,State Treasurer,Randy Mcdaniel,REP,580007,10,74,497,581,
Ottawa,State Treasurer,Charles De Coune,IND,580007,7,18,179,204,
Ottawa,Superintendent of Public Instruction,Joy Hofmeister,REP,580007,10,52,391,453,
Ottawa,Superintendent of Public Instruction,John Cox,DEM,580007,11,40,277,328,
Ottawa,Superintendent of Public Instruction,Larry Huff,IND,580007,0,4,47,51,
Ottawa,Commissioner of Labor,Leslie Osborn,REP,580007,10,59,435,504,
Ottawa,Commissioner of Labor,Fred Dorrell,DEM,580007,11,35,243,289,
Ottawa,Commissioner of Labor,Brandt Dismukes,IND,580007,0,1,29,30,
Ottawa,Insurance Commissioner,Glen Mulready,REP,580007,9,59,447,515,
Ottawa,Insurance Commissioner,Kimberly Fobbs,DEM,580007,12,36,262,310,
Ottawa,Corporation Commissioner,Bob Anthony,REP,580007,9,57,401,467,
Ottawa,Corporation Commissioner,Ashley Nicole Mccray,DEM,580007,12,35,273,320,
Ottawa,Corporation Commissioner,Jackie Short,IND,580007,0,3,35,38,
Ottawa,U.S. House,Richard Castaldo,LIB,580007,1,2,10,13,2
Ottawa,U.S. House,Markwayne Mullin,REP,580007,11,62,430,503,2
Ottawa,U.S. House,Jason Nichols,DEM,580007,9,30,250,289,2
Ottawa,U.S. House,John Foreman,IND,580007,0,2,25,27,2
Ottawa,State House,William Leonard,REP,580007,7,37,272,316,7
Ottawa,State House,Ben Loring,DEM,580007,14,59,454,527,7
Ottawa,Governor,Chris Powell,LIB,580008,1,0,14,15,
Ottawa,Governor,Kevin Stitt,REP,580008,1,12,85,98,
Ottawa,Governor,Drew Edmondson,DEM,580008,3,9,62,74,
Ottawa,Lieutenant Governor,Matt Pinnell,REP,580008,1,11,97,109,
Ottawa,Lieutenant Governor,Anastasia Pittman,DEM,580008,3,9,53,65,
Ottawa,Lieutenant Governor,Ivan Holmes,IND,580008,1,1,7,9,
Ottawa,State Auditor,John Yeutter,LIB,580008,4,3,35,42,
Ottawa,State Auditor,Cindy Byrd,REP,580008,1,15,110,126,
Ottawa,Attorney General,Mike Hunter,REP,580008,1,13,98,112,
Ottawa,Attorney General,Mark Myles,DEM,580008,4,8,60,72,
Ottawa,State Treasurer,Randy Mcdaniel,REP,580008,1,13,107,121,
Ottawa,State Treasurer,Charles De Coune,IND,580008,4,5,38,47,
Ottawa,Superintendent of Public Instruction,Joy Hofmeister,REP,580008,1,12,94,107,
Ottawa,Superintendent of Public Instruction,John Cox,DEM,580008,4,8,60,72,
Ottawa,Superintendent of Public Instruction,Larry Huff,IND,580008,0,1,6,7,
Ottawa,Commissioner of Labor,Leslie Osborn,REP,580008,3,12,99,114,
Ottawa,Commissioner of Labor,Fred Dorrell,DEM,580008,2,9,54,65,
Ottawa,Commissioner of Labor,Brandt Dismukes,IND,580008,0,0,5,5,
Ottawa,Insurance Commissioner,Glen Mulready,REP,580008,1,12,101,114,
Ottawa,Insurance Commissioner,Kimberly Fobbs,DEM,580008,4,9,59,72,
Ottawa,Corporation Commissioner,Bob Anthony,REP,580008,1,12,97,110,
Ottawa,Corporation Commissioner,Ashley Nicole Mccray,DEM,580008,4,8,58,70,
Ottawa,Corporation Commissioner,Jackie Short,IND,580008,0,1,3,4,
Ottawa,U.S. House,Richard Castaldo,LIB,580008,0,1,2,3,2
Ottawa,U.S. House,Markwayne Mullin,REP,580008,1,11,94,106,2
Ottawa,U.S. House,Jason Nichols,DEM,580008,4,9,57,70,2
Ottawa,U.S. House,John Foreman,IND,580008,0,0,7,7,2
Ottawa,State House,William Leonard,REP,580008,2,10,64,76,7
Ottawa,State House,Ben Loring,DEM,580008,3,11,95,109,7
Ottawa,Governor,Chris Powell,LIB,580009,0,1,17,18,
Ottawa,Governor,Kevin Stitt,REP,580009,6,12,126,144,
Ottawa,Governor,Drew Edmondson,DEM,580009,7,14,128,149,
Ottawa,Lieutenant Governor,Matt Pinnell,REP,580009,6,14,148,168,
Ottawa,Lieutenant Governor,Anastasia Pittman,DEM,580009,7,13,101,121,
Ottawa,Lieutenant Governor,Ivan Holmes,IND,580009,0,0,20,20,
Ottawa,State Auditor,John Yeutter,LIB,580009,4,6,72,82,
Ottawa,State Auditor,Cindy Byrd,REP,580009,8,17,161,186,
Ottawa,Attorney General,Mike Hunter,REP,580009,6,13,151,170,
Ottawa,Attorney General,Mark Myles,DEM,580009,7,14,119,140,
Ottawa,State Treasurer,Randy Mcdaniel,REP,580009,6,12,159,177,
Ottawa,State Treasurer,Charles De Coune,IND,580009,5,12,76,93,
Ottawa,Superintendent of Public Instruction,Joy Hofmeister,REP,580009,6,15,125,146,
Ottawa,Superintendent of Public Instruction,John Cox,DEM,580009,6,10,124,140,
Ottawa,Superintendent of Public Instruction,Larry Huff,IND,580009,1,1,21,23,
Ottawa,Commissioner of Labor,Leslie Osborn,REP,580009,6,13,141,160,
Ottawa,Commissioner of Labor,Fred Dorrell,DEM,580009,5,11,109,125,
Ottawa,Commissioner of Labor,Brandt Dismukes,IND,580009,2,2,15,19,
Ottawa,Insurance Commissioner,Glen Mulready,REP,580009,6,12,148,166,
Ottawa,Insurance Commissioner,Kimberly Fobbs,DEM,580009,7,14,117,138,
Ottawa,Corporation Commissioner,Bob Anthony,REP,580009,6,13,130,149,
Ottawa,Corporation Commissioner,Ashley Nicole Mccray,DEM,580009,6,12,114,132,
Ottawa,Corporation Commissioner,Jackie Short,IND,580009,1,1,21,23,
Ottawa,U.S. House,Richard Castaldo,LIB,580009,0,0,8,8,2
Ottawa,U.S. House,Markwayne Mullin,REP,580009,6,12,141,159,2
Ottawa,U.S. House,Jason Nichols,DEM,580009,7,13,106,126,2
Ottawa,U.S. House,John Foreman,IND,580009,0,1,16,17,2
Ottawa,State House,William Leonard,REP,580009,6,9,100,115,7
Ottawa,State House,Ben Loring,DEM,580009,7,18,170,195,7
Ottawa,Governor,Chris Powell,LIB,580011,1,4,14,19,
Ottawa,Governor,Kevin Stitt,REP,580011,6,26,160,192,
Ottawa,Governor,Drew Edmondson,DEM,580011,9,25,178,212,
Ottawa,Lieutenant Governor,Matt Pinnell,REP,580011,9,33,179,221,
Ottawa,Lieutenant Governor,Anastasia Pittman,DEM,580011,7,18,141,166,
Ottawa,Lieutenant Governor,Ivan Holmes,IND,580011,0,3,28,31,
Ottawa,State Auditor,John Yeutter,LIB,580011,5,13,84,102,
Ottawa,State Auditor,Cindy Byrd,REP,580011,11,33,193,237,
Ottawa,Attorney General,Mike Hunter,REP,580011,9,33,192,234,
Ottawa,Attorney General,Mark Myles,DEM,580011,7,21,155,183,
Ottawa,State Treasurer,Randy Mcdaniel,REP,580011,11,34,193,238,
Ottawa,State Treasurer,Charles De Coune,IND,580011,5,13,85,103,
Ottawa,Superintendent of Public Instruction,Joy Hofmeister,REP,580011,8,33,159,200,
Ottawa,Superintendent of Public Instruction,John Cox,DEM,580011,7,18,166,191,
Ottawa,Superintendent of Public Instruction,Larry Huff,IND,580011,1,3,24,28,
Ottawa,Commissioner of Labor,Leslie Osborn,REP,580011,9,33,177,219,
Ottawa,Commissioner of Labor,Fred Dorrell,DEM,580011,7,17,148,172,
Ottawa,Commissioner of Labor,Brandt Dismukes,IND,580011,0,4,22,26,
Ottawa,Insurance Commissioner,Glen Mulready,REP,580011,9,32,186,227,
Ottawa,Insurance Commissioner,Kimberly Fobbs,DEM,580011,7,21,160,188,
Ottawa,Corporation Commissioner,Bob Anthony,REP,580011,9,28,171,208,
Ottawa,Corporation Commissioner,Ashley Nicole Mccray,DEM,580011,7,23,154,184,
Ottawa,Corporation Commissioner,Jackie Short,IND,580011,0,4,21,25,
Ottawa,U.S. House,Richard Castaldo,LIB,580011,0,0,11,11,2
Ottawa,U.S. House,Markwayne Mullin,REP,580011,6,30,172,208,2
Ottawa,U.S. House,Jason Nichols,DEM,580011,9,22,150,181,2
Ottawa,U.S. House,John Foreman,IND,580011,0,3,18,21,2
Ottawa,State House,William Leonard,REP,580011,5,23,136,164,7
Ottawa,State House,Ben Loring,DEM,580011,11,32,216,259,7
Ottawa,Governor,Chris Powell,LIB,580012,0,0,6,6,
Ottawa,Governor,Kevin Stitt,REP,580012,7,12,153,172,
Ottawa,Governor,Drew Edmondson,DEM,580012,6,22,152,180,
Ottawa,Lieutenant Governor,Matt Pinnell,REP,580012,6,16,181,203,
Ottawa,Lieutenant Governor,Anastasia Pittman,DEM,580012,6,17,112,135,
Ottawa,Lieutenant Governor,Ivan Holmes,IND,580012,1,0,13,14,
Ottawa,State Auditor,John Yeutter,LIB,580012,4,8,64,76,
Ottawa,State Auditor,Cindy Byrd,REP,580012,9,21,223,253,
Ottawa,Attorney General,Mike Hunter,REP,580012,7,15,187,209,
Ottawa,Attorney General,Mark Myles,DEM,580012,6,18,116,140,
Ottawa,State Treasurer,Randy Mcdaniel,REP,580012,8,19,208,235,
Ottawa,State Treasurer,Charles De Coune,IND,580012,5,10,76,91,
Ottawa,Superintendent of Public Instruction,Joy Hofmeister,REP,580012,8,15,151,174,
Ottawa,Superintendent of Public Instruction,John Cox,DEM,580012,5,15,131,151,
Ottawa,Superintendent of Public Instruction,Larry Huff,IND,580012,0,3,24,27,
Ottawa,Commissioner of Labor,Leslie Osborn,REP,580012,7,15,183,205,
Ottawa,Commissioner of Labor,Fred Dorrell,DEM,580012,5,17,106,128,
Ottawa,Commissioner of Labor,Brandt Dismukes,IND,580012,1,1,13,15,
Ottawa,Insurance Commissioner,Glen Mulready,REP,580012,5,14,177,196,
Ottawa,Insurance Commissioner,Kimberly Fobbs,DEM,580012,8,19,125,152,
Ottawa,Corporation Commissioner,Bob Anthony,REP,580012,5,13,166,184,
Ottawa,Corporation Commissioner,Ashley Nicole Mccray,DEM,580012,7,20,116,143,
Ottawa,Corporation Commissioner,Jackie Short,IND,580012,1,0,24,25,
Ottawa,U.S. House,Richard Castaldo,LIB,580012,0,0,5,5,2
Ottawa,U.S. House,Markwayne Mullin,REP,580012,6,12,166,184,2
Ottawa,U.S. House,Jason Nichols,DEM,580012,6,20,116,142,2
Ottawa,U.S. House,John Foreman,IND,580012,1,0,24,25,2
Ottawa,State House,William Leonard,REP,580012,3,10,124,137,7
Ottawa,State House,Ben Loring,DEM,580012,10,24,188,222,7
Ottawa,Governor,Chris Powell,LIB,580014,0,2,23,25,
Ottawa,Governor,Kevin Stitt,REP,580014,2,21,338,361,
Ottawa,Governor,Drew Edmondson,DEM,580014,3,15,296,314,
Ottawa,Lieutenant Governor,Matt Pinnell,REP,580014,1,21,389,411,
Ottawa,Lieutenant Governor,Anastasia Pittman,DEM,580014,2,16,236,254,
Ottawa,Lieutenant Governor,Ivan Holmes,IND,580014,2,1,29,32,
Ottawa,State Auditor,John Yeutter,LIB,580014,2,10,148,160,
Ottawa,State Auditor,Cindy Byrd,REP,580014,3,27,467,497,
Ottawa,Attorney General,Mike Hunter,REP,580014,2,19,409,430,
Ottawa,Attorney General,Mark Myles,DEM,580014,3,18,241,262,
Ottawa,State Treasurer,Randy Mcdaniel,REP,580014,2,25,451,478,
Ottawa,State Treasurer,Charles De Coune,IND,580014,2,12,155,169,
Ottawa,Superintendent of Public Instruction,Joy Hofmeister,REP,580014,3,20,322,345,
Ottawa,Superintendent of Public Instruction,John Cox,DEM,580014,2,17,276,295,
Ottawa,Superintendent of Public Instruction,Larry Huff,IND,580014,0,1,54,55,
Ottawa,Commissioner of Labor,Leslie Osborn,REP,580014,1,19,375,395,
Ottawa,Commissioner of Labor,Fred Dorrell,DEM,580014,3,17,242,262,
Ottawa,Commissioner of Labor,Brandt Dismukes,IND,580014,1,2,32,35,
Ottawa,Insurance Commissioner,Glen Mulready,REP,580014,1,21,379,401,
Ottawa,Insurance Commissioner,Kimberly Fobbs,DEM,580014,4,16,265,285,
Ottawa,Corporation Commissioner,Bob Anthony,REP,580014,1,22,354,377,
Ottawa,Corporation Commissioner,Ashley Nicole Mccray,DEM,580014,3,16,243,262,
Ottawa,Corporation Commissioner,Jackie Short,IND,580014,1,0,48,49,
Ottawa,U.S. House,Richard Castaldo,LIB,580014,0,0,14,14,2
Ottawa,U.S. House,Markwayne Mullin,REP,580014,2,20,381,403,2
Ottawa,U.S. House,Jason Nichols,DEM,580014,3,16,225,244,2
Ottawa,U.S. House,John Foreman,IND,580014,0,2,33,35,2
Ottawa,State House,William Leonard,REP,580014,1,17,291,309,7
Ottawa,State House,Ben Loring,DEM,580014,4,21,366,391,7
Ottawa,Governor,Chris Powell,LIB,580023,0,0,23,23,
Ottawa,Governor,Kevin Stitt,REP,580023,17,23,320,360,
Ottawa,Governor,Drew Edmondson,DEM,580023,1,8,311,320,
Ottawa,Lieutenant Governor,Matt Pinnell,REP,580023,17,21,361,399,
Ottawa,Lieutenant Governor,Anastasia Pittman,DEM,580023,0,7,258,265,
Ottawa,Lieutenant Governor,Ivan Holmes,IND,580023,1,3,30,34,
Ottawa,State Auditor,John Yeutter,LIB,580023,2,3,177,182,
Ottawa,State Auditor,Cindy Byrd,REP,580023,16,24,413,453,
Ottawa,Attorney General,Mike Hunter,REP,580023,17,23,380,420,
Ottawa,Attorney General,Mark Myles,DEM,580023,1,8,264,273,
Ottawa,State Treasurer,Randy Mcdaniel,REP,580023,18,24,409,451,
Ottawa,State Treasurer,Charles De Coune,IND,580023,0,4,179,183,
Ottawa,Superintendent of Public Instruction,Joy Hofmeister,REP,580023,17,18,307,342,
Ottawa,Superintendent of Public Instruction,John Cox,DEM,580023,1,11,294,306,
Ottawa,Superintendent of Public Instruction,Larry Huff,IND,580023,0,2,49,51,
Ottawa,Commissioner of Labor,Leslie Osborn,REP,580023,18,24,356,398,
Ottawa,Commissioner of Labor,Fred Dorrell,DEM,580023,0,7,252,259,
Ottawa,Commissioner of Labor,Brandt Dismukes,IND,580023,0,0,34,34,
Ottawa,Insurance Commissioner,Glen Mulready,REP,580023,17,18,362,397,
Ottawa,Insurance Commissioner,Kimberly Fobbs,DEM,580023,1,12,279,292,
Ottawa,Corporation Commissioner,Bob Anthony,REP,580023,18,21,331,370,
Ottawa,Corporation Commissioner,Ashley Nicole Mccray,DEM,580023,0,7,274,281,
Ottawa,Corporation Commissioner,Jackie Short,IND,580023,0,2,35,37,
Ottawa,U.S. House,Richard Castaldo,LIB,580023,2,0,14,16,2
Ottawa,U.S. House,Markwayne Mullin,REP,580023,16,21,345,382,2
Ottawa,U.S. House,Jason Nichols,DEM,580023,0,7,257,264,2
Ottawa,U.S. House,John Foreman,IND,580023,0,2,28,30,2
Ottawa,State House,William Leonard,REP,580023,16,18,278,312,7
Ottawa,State House,Ben Loring,DEM,580023,2,13,374,389,7
Ottawa,Governor,Chris Powell,LIB,580025,0,1,7,8,
Ottawa,Governor,Kevin Stitt,REP,580025,4,13,313,330,
Ottawa,Governor,Drew Edmondson,DEM,580025,5,4,129,138,
Ottawa,Lieutenant Governor,Matt Pinnell,REP,580025,5,13,317,335,
Ottawa,Lieutenant Governor,Anastasia Pittman,DEM,580025,4,4,122,130,
Ottawa,Lieutenant Governor,Ivan Holmes,IND,580025,0,1,8,9,
Ottawa,State Auditor,John Yeutter,LIB,580025,1,2,71,74,
Ottawa,State Auditor,Cindy Byrd,REP,580025,7,16,350,373,
Ottawa,Attorney General,Mike Hunter,REP,580025,6,13,322,341,
Ottawa,Attorney General,Mark Myles,DEM,580025,3,4,123,130,
Ottawa,State Treasurer,Randy Mcdaniel,REP,580025,4,16,341,361,
Ottawa,State Treasurer,Charles De Coune,IND,580025,3,2,78,83,
Ottawa,Superintendent of Public Instruction,Joy Hofmeister,REP,580025,4,12,292,308,
Ottawa,Superintendent of Public Instruction,John Cox,DEM,580025,3,3,134,140,
Ottawa,Superintendent of Public Instruction,Larry Huff,IND,580025,1,2,23,26,
Ottawa,Commissioner of Labor,Leslie Osborn,REP,580025,5,14,312,331,
Ottawa,Commissioner of Labor,Fred Dorrell,DEM,580025,3,3,118,124,
Ottawa,Commissioner of Labor,Brandt Dismukes,IND,580025,0,1,15,16,
Ottawa,Insurance Commissioner,Glen Mulready,REP,580025,5,11,317,333,
Ottawa,Insurance Commissioner,Kimberly Fobbs,DEM,580025,3,6,126,135,
Ottawa,Corporation Commissioner,Bob Anthony,REP,580025,6,13,305,324,
Ottawa,Corporation Commissioner,Ashley Nicole Mccray,DEM,580025,3,4,126,133,
Ottawa,Corporation Commissioner,Jackie Short,IND,580025,0,1,15,16,
Ottawa,U.S. House,Richard Castaldo,LIB,580025,0,0,4,4,2
Ottawa,U.S. House,Markwayne Mullin,REP,580025,5,13,321,339,2
Ottawa,U.S. House,Jason Nichols,DEM,580025,4,4,112,120,2
Ottawa,U.S. House,John Foreman,IND,580025,0,1,11,12,2
Ottawa,State House,William Leonard,REP,580025,3,11,255,269,7
Ottawa,State House,Ben Loring,DEM,580025,6,6,193,205,7
Ottawa,Governor,Chris Powell,LIB,580026,0,0,22,22,
Ottawa,Governor,Kevin Stitt,REP,580026,18,11,459,488,
Ottawa,Governor,Drew Edmondson,DEM,580026,9,11,184,204,
Ottawa,Lieutenant Governor,Matt Pinnell,REP,580026,19,13,483,515,
Ottawa,Lieutenant Governor,Anastasia Pittman,DEM,580026,8,8,161,177,
Ottawa,Lieutenant Governor,Ivan Holmes,IND,580026,0,1,20,21,
Ottawa,State Auditor,John Yeutter,LIB,580026,5,2,99,106,
Ottawa,State Auditor,Cindy Byrd,REP,580026,20,16,509,545,
Ottawa,Attorney General,Mike Hunter,REP,580026,21,14,491,526,
Ottawa,Attorney General,Mark Myles,DEM,580026,6,7,172,185,
Ottawa,State Treasurer,Randy Mcdaniel,REP,580026,21,15,492,528,
Ottawa,State Treasurer,Charles De Coune,IND,580026,4,3,121,128,
Ottawa,Superintendent of Public Instruction,Joy Hofmeister,REP,580026,18,11,435,464,
Ottawa,Superintendent of Public Instruction,John Cox,DEM,580026,8,9,186,203,
Ottawa,Superintendent of Public Instruction,Larry Huff,IND,580026,1,1,42,44,
Ottawa,Commissioner of Labor,Leslie Osborn,REP,580026,20,14,461,495,
Ottawa,Commissioner of Labor,Fred Dorrell,DEM,580026,7,7,171,185,
Ottawa,Commissioner of Labor,Brandt Dismukes,IND,580026,0,0,28,28,
Ottawa,Insurance Commissioner,Glen Mulready,REP,580026,19,12,483,514,
Ottawa,Insurance Commissioner,Kimberly Fobbs,DEM,580026,7,8,177,192,
Ottawa,Corporation Commissioner,Bob Anthony,REP,580026,21,11,457,489,
Ottawa,Corporation Commissioner,Ashley Nicole Mccray,DEM,580026,6,10,171,187,
Ottawa,Corporation Commissioner,Jackie Short,IND,580026,0,1,31,32,
Ottawa,U.S. House,Richard Castaldo,LIB,580026,0,0,14,14,2
Ottawa,U.S. House,Markwayne Mullin,REP,580026,20,12,464,496,2
Ottawa,U.S. House,Jason Nichols,DEM,580026,7,10,166,183,2
Ottawa,U.S. House,John Foreman,IND,580026,0,0,19,19,2
Ottawa,State House,William Leonard,REP,580026,18,10,431,459,7
Ottawa,State House,Ben Loring,DEM,580026,9,12,233,254,7
Ottawa,Governor,Chris Powell,LIB,580028,0,1,25,26,
Ottawa,Governor,Kevin Stitt,REP,580028,16,24,540,580,
Ottawa,Governor,Drew Edmondson,DEM,580028,7,25,283,315,
Ottawa,Lieutenant Governor,Matt Pinnell,REP,580028,15,23,574,612,
Ottawa,Lieutenant Governor,Anastasia Pittman,DEM,580028,8,25,239,272,
Ottawa,Lieutenant Governor,Ivan Holmes,IND,580028,0,1,30,31,
Ottawa,State Auditor,John Yeutter,LIB,580028,3,6,163,172,
Ottawa,State Auditor,Cindy Byrd,REP,580028,17,40,638,695,
Ottawa,Attorney General,Mike Hunter,REP,580028,15,30,585,630,
Ottawa,Attorney General,Mark Myles,DEM,580028,8,20,248,276,
Ottawa,State Treasurer,Randy Mcdaniel,REP,580028,16,35,622,673,
Ottawa,State Treasurer,Charles De Coune,IND,580028,5,11,176,192,
Ottawa,Superintendent of Public Instruction,Joy Hofmeister,REP,580028,13,30,519,562,
Ottawa,Superintendent of Public Instruction,John Cox,DEM,580028,9,19,247,275,
Ottawa,Superintendent of Public Instruction,Larry Huff,IND,580028,1,1,76,78,
Ottawa,Commissioner of Labor,Leslie Osborn,REP,580028,17,31,567,615,
Ottawa,Commissioner of Labor,Fred Dorrell,DEM,580028,6,17,230,253,
Ottawa,Commissioner of Labor,Brandt Dismukes,IND,580028,0,1,33,34,
Ottawa,Insurance Commissioner,Glen Mulready,REP,580028,17,29,567,613,
Ottawa,Insurance Commissioner,Kimberly Fobbs,DEM,580028,6,21,266,293,
Ottawa,Corporation Commissioner,Bob Anthony,REP,580028,15,26,544,585,
Ottawa,Corporation Commissioner,Ashley Nicole Mccray,DEM,580028,8,21,243,272,
Ottawa,Corporation Commissioner,Jackie Short,IND,580028,0,3,45,48,
Ottawa,U.S. House,Richard Castaldo,LIB,580028,0,0,21,21,2
Ottawa,U.S. House,Markwayne Mullin,REP,580028,17,28,565,610,2
Ottawa,U.S. House,Jason Nichols,DEM,580028,6,20,223,249,2
Ottawa,U.S. House,John Foreman,IND,580028,0,2,31,33,2
Ottawa,State House,William Leonard,REP,580028,14,19,458,491,7
Ottawa,State House,Ben Loring,DEM,580028,9,31,388,428,7
Ottawa,Governor,Chris Powell,LIB,580031,0,0,20,20,
Ottawa,Governor,Kevin Stitt,REP,580031,7,46,414,467,
Ottawa,Governor,Drew Edmondson,DEM,580031,15,32,233,280,
Ottawa,Lieutenant Governor,Matt Pinnell,REP,580031,12,50,457,519,
Ottawa,Lieutenant Governor,Anastasia Pittman,DEM,580031,10,24,189,223,
Ottawa,Lieutenant Governor,Ivan Holmes,IND,580031,0,2,21,23,
Ottawa,State Auditor,John Yeutter,LIB,580031,5,10,113,128,
Ottawa,State Auditor,Cindy Byrd,REP,580031,13,59,511,583,
Ottawa,Attorney General,Mike Hunter,REP,580031,9,51,470,530,
Ottawa,Attorney General,Mark Myles,DEM,580031,13,24,195,232,
Ottawa,State Treasurer,Randy Mcdaniel,REP,580031,12,51,502,565,
Ottawa,State Treasurer,Charles De Coune,IND,580031,7,17,118,142,
Ottawa,Superintendent of Public Instruction,Joy Hofmeister,REP,580031,9,44,393,446,
Ottawa,Superintendent of Public Instruction,John Cox,DEM,580031,13,24,236,273,
Ottawa,Superintendent of Public Instruction,Larry Huff,IND,580031,0,6,36,42,
Ottawa,Commissioner of Labor,Leslie Osborn,REP,580031,9,46,440,495,
Ottawa,Commissioner of Labor,Fred Dorrell,DEM,580031,13,20,198,231,
Ottawa,Commissioner of Labor,Brandt Dismukes,IND,580031,0,9,24,33,
Ottawa,Insurance Commissioner,Glen Mulready,REP,580031,10,54,434,498,
Ottawa,Insurance Commissioner,Kimberly Fobbs,DEM,580031,12,22,225,259,
Ottawa,Corporation Commissioner,Bob Anthony,REP,580031,8,47,433,488,
Ottawa,Corporation Commissioner,Ashley Nicole Mccray,DEM,580031,14,25,207,246,
Ottawa,Corporation Commissioner,Jackie Short,IND,580031,0,3,26,29,
Ottawa,U.S. House,Richard Castaldo,LIB,580031,0,2,18,20,2
Ottawa,U.S. House,Markwayne Mullin,REP,580031,11,48,437,496,2
Ottawa,U.S. House,Jason Nichols,DEM,580031,11,23,193,227,2
Ottawa,U.S. House,John Foreman,IND,580031,0,4,21,25,2
Ottawa,State House,William Leonard,REP,580031,8,30,311,349,7
Ottawa,State House,Ben Loring,DEM,580031,14,48,358,420,7
Ottawa,Governor,Chris Powell,LIB,580034,0,1,15,16,
Ottawa,Governor,Kevin Stitt,REP,580034,6,20,280,306,
Ottawa,Governor,Drew Edmondson,DEM,580034,6,9,107,122,
Ottawa,Lieutenant Governor,Matt Pinnell,REP,580034,7,21,290,318,
Ottawa,Lieutenant Governor,Anastasia Pittman,DEM,580034,5,8,92,105,
Ottawa,Lieutenant Governor,Ivan Holmes,IND,580034,0,0,19,19,
Ottawa,State Auditor,John Yeutter,LIB,580034,1,4,79,84,
Ottawa,State Auditor,Cindy Byrd,REP,580034,10,22,301,333,
Ottawa,Attorney General,Mike Hunter,REP,580034,9,20,282,311,
Ottawa,Attorney General,Mark Myles,DEM,580034,3,9,117,129,
Ottawa,State Treasurer,Randy Mcdaniel,REP,580034,7,21,298,326,
Ottawa,State Treasurer,Charles De Coune,IND,580034,4,5,79,88,
Ottawa,Superintendent of Public Instruction,Joy Hofmeister,REP,580034,6,20,241,267,
Ottawa,Superintendent of Public Instruction,John Cox,DEM,580034,5,8,129,142,
Ottawa,Superintendent of Public Instruction,Larry Huff,IND,580034,1,2,32,35,
Ottawa,Commissioner of Labor,Leslie Osborn,REP,580034,8,21,270,299,
Ottawa,Commissioner of Labor,Fred Dorrell,DEM,580034,4,8,109,121,
Ottawa,Commissioner of Labor,Brandt Dismukes,IND,580034,0,0,22,22,
Ottawa,Insurance Commissioner,Glen Mulready,REP,580034,6,17,277,300,
Ottawa,Insurance Commissioner,Kimberly Fobbs,DEM,580034,6,12,122,140,
Ottawa,Corporation Commissioner,Bob Anthony,REP,580034,4,21,270,295,
Ottawa,Corporation Commissioner,Ashley Nicole Mccray,DEM,580034,7,8,104,119,
Ottawa,Corporation Commissioner,Jackie Short,IND,580034,0,1,24,25,
Ottawa,U.S. House,Richard Castaldo,LIB,580034,0,1,7,8,2
Ottawa,U.S. House,Markwayne Mullin,REP,580034,6,20,290,316,2
Ottawa,U.S. House,Jason Nichols,DEM,580034,6,8,93,107,2
Ottawa,U.S. House,John Foreman,IND,580034,0,1,13,14,2
Ottawa,State House,William Leonard,REP,580034,4,19,239,262,7
Ottawa,State House,Ben Loring,DEM,580034,8,11,163,182,7
Pawnee,Governor,Chris Powell,LIB,590104,0,4,15,19,
Pawnee,Governor,Kevin Stitt,REP,590104,5,45,296,346,
Pawnee,Governor,Drew Edmondson,DEM,590104,5,38,123,166,
Pawnee,Lieutenant Governor,Matt Pinnell,REP,590104,5,57,301,363,
Pawnee,Lieutenant Governor,Anastasia Pittman,DEM,590104,4,25,110,139,
Pawnee,Lieutenant Governor,Ivan Holmes,IND,590104,1,4,17,22,
Pawnee,State Auditor,John Yeutter,LIB,590104,2,15,68,85,
Pawnee,State Auditor,Cindy Byrd,REP,590104,5,68,333,406,
Pawnee,Attorney General,Mike Hunter,REP,590104,5,63,322,390,
Pawnee,Attorney General,Mark Myles,DEM,590104,5,22,106,133,
Pawnee,State Treasurer,Randy Mcdaniel,REP,590104,6,61,321,388,
Pawnee,State Treasurer,Charles De Coune,IND,590104,1,21,79,101,
Pawnee,Superintendent of Public Instruction,Joy Hofmeister,REP,590104,4,52,282,338,
Pawnee,Superintendent of Public Instruction,John Cox,DEM,590104,5,25,105,135,
Pawnee,Superintendent of Public Instruction,Larry Huff,IND,590104,1,8,42,51,
Pawnee,Commissioner of Labor,Leslie Osborn,REP,590104,5,60,298,363,
Pawnee,Commissioner of Labor,Fred Dorrell,DEM,590104,5,20,111,136,
Pawnee,Commissioner of Labor,Brandt Dismukes,IND,590104,0,5,15,20,
Pawnee,Insurance Commissioner,Glen Mulready,REP,590104,5,55,296,356,
Pawnee,Insurance Commissioner,Kimberly Fobbs,DEM,590104,5,31,128,164,
Pawnee,Corporation Commissioner,Bob Anthony,REP,590104,5,53,292,350,
Pawnee,Corporation Commissioner,Ashley Nicole Mccray,DEM,590104,4,30,107,141,
Pawnee,Corporation Commissioner,Jackie Short,IND,590104,1,3,27,31,
Pawnee,U.S. House,Frank Lucas,REP,590104,5,60,313,378,3
Pawnee,U.S. House,Frankie Robbins,DEM,590104,5,26,114,145,3
Pawnee,State Senate,Chuck Hall,REP,590104,6,63,308,377,20
Pawnee,State Senate,Heady Coleman,DEM,590104,4,23,118,145,20
Pawnee,State House,Ty Burns,REP,590104,4,66,336,406,35
Pawnee,State House,Jasha Lyons Echo-Hawk,DEM,590104,6,21,97,124,35
Pawnee,Governor,Chris Powell,LIB,590111,0,1,13,14,
Pawnee,Governor,Kevin Stitt,REP,590111,1,8,156,165,
Pawnee,Governor,Drew Edmondson,DEM,590111,0,3,70,73,
Pawnee,Lieutenant Governor,Matt Pinnell,REP,590111,1,9,171,181,
Pawnee,Lieutenant Governor,Anastasia Pittman,DEM,590111,0,3,55,58,
Pawnee,Lieutenant Governor,Ivan Holmes,IND,590111,0,0,12,12,
Pawnee,State Auditor,John Yeutter,LIB,590111,0,1,43,44,
Pawnee,State Auditor,Cindy Byrd,REP,590111,1,11,180,192,
Pawnee,Attorney General,Mike Hunter,REP,590111,1,9,168,178,
Pawnee,Attorney General,Mark Myles,DEM,590111,0,3,65,68,
Pawnee,State Treasurer,Randy Mcdaniel,REP,590111,1,11,178,190,
Pawnee,State Treasurer,Charles De Coune,IND,590111,0,1,44,45,
Pawnee,Superintendent of Public Instruction,Joy Hofmeister,REP,590111,1,8,154,163,
Pawnee,Superintendent of Public Instruction,John Cox,DEM,590111,0,3,54,57,
Pawnee,Superintendent of Public Instruction,Larry Huff,IND,590111,0,1,30,31,
Pawnee,Commissioner of Labor,Leslie Osborn,REP,590111,1,8,161,170,
Pawnee,Commissioner of Labor,Fred Dorrell,DEM,590111,0,4,60,64,
Pawnee,Commissioner of Labor,Brandt Dismukes,IND,590111,0,0,14,14,
Pawnee,Insurance Commissioner,Glen Mulready,REP,590111,1,9,166,176,
Pawnee,Insurance Commissioner,Kimberly Fobbs,DEM,590111,0,3,69,72,
Pawnee,Corporation Commissioner,Bob Anthony,REP,590111,1,8,165,174,
Pawnee,Corporation Commissioner,Ashley Nicole Mccray,DEM,590111,0,3,55,58,
Pawnee,Corporation Commissioner,Jackie Short,IND,590111,0,1,17,18,
Pawnee,U.S. House,Frank Lucas,REP,590111,1,10,177,188,3
Pawnee,U.S. House,Frankie Robbins,DEM,590111,0,2,59,61,3
Pawnee,State Senate,Chuck Hall,REP,590111,1,9,174,184,20
Pawnee,State Senate,Heady Coleman,DEM,590111,0,3,62,65,20
Pawnee,State House,Ty Burns,REP,590111,1,9,173,183,35
Pawnee,State House,Jasha Lyons Echo-Hawk,DEM,590111,0,3,64,67,35
Pawnee,Governor,Chris Powell,LIB,590112,0,0,6,6,
Pawnee,Governor,Kevin Stitt,REP,590112,4,2,116,122,
Pawnee,Governor,Drew Edmondson,DEM,590112,1,2,47,50,
Pawnee,Lieutenant Governor,Matt Pinnell,REP,590112,5,3,122,130,
Pawnee,Lieutenant Governor,Anastasia Pittman,DEM,590112,0,1,43,44,
Pawnee,Lieutenant Governor,Ivan Holmes,IND,590112,0,0,3,3,
Pawnee,State Auditor,John Yeutter,LIB,590112,0,1,38,39,
Pawnee,State Auditor,Cindy Byrd,REP,590112,5,2,121,128,
Pawnee,Attorney General,Mike Hunter,REP,590112,5,3,121,129,
Pawnee,Attorney General,Mark Myles,DEM,590112,0,1,46,47,
Pawnee,State Treasurer,Randy Mcdaniel,REP,590112,5,3,122,130,
Pawnee,State Treasurer,Charles De Coune,IND,590112,0,0,37,37,
Pawnee,Superintendent of Public Instruction,Joy Hofmeister,REP,590112,4,1,108,113,
Pawnee,Superintendent of Public Instruction,John Cox,DEM,590112,1,1,42,44,
Pawnee,Superintendent of Public Instruction,Larry Huff,IND,590112,0,2,17,19,
Pawnee,Commissioner of Labor,Leslie Osborn,REP,590112,4,2,115,121,
Pawnee,Commissioner of Labor,Fred Dorrell,DEM,590112,1,2,43,46,
Pawnee,Commissioner of Labor,Brandt Dismukes,IND,590112,0,0,9,9,
Pawnee,Insurance Commissioner,Glen Mulready,REP,590112,5,2,115,122,
Pawnee,Insurance Commissioner,Kimberly Fobbs,DEM,590112,0,2,50,52,
Pawnee,Corporation Commissioner,Bob Anthony,REP,590112,5,3,121,129,
Pawnee,Corporation Commissioner,Ashley Nicole Mccray,DEM,590112,0,1,37,38,
Pawnee,Corporation Commissioner,Jackie Short,IND,590112,0,0,8,8,
Pawnee,U.S. House,Frank Lucas,REP,590112,5,2,117,124,3
Pawnee,U.S. House,Frankie Robbins,DEM,590112,0,2,48,50,3
Pawnee,State Senate,Chuck Hall,REP,590112,5,3,124,132,20
Pawnee,State Senate,Heady Coleman,DEM,590112,0,1,43,44,20
Pawnee,State House,Ty Burns,REP,590112,5,3,119,127,35
Pawnee,State House,Jasha Lyons Echo-Hawk,DEM,590112,0,1,47,48,35
Pawnee,Governor,Chris Powell,LIB,590118,0,0,16,16,
Pawnee,Governor,Kevin Stitt,REP,590118,13,14,397,424,
Pawnee,Governor,Drew Edmondson,DEM,590118,12,8,184,204,
Pawnee,Lieutenant Governor,Matt Pinnell,REP,590118,16,15,432,463,
Pawnee,Lieutenant Governor,Anastasia Pittman,DEM,590118,9,6,138,153,
Pawnee,Lieutenant Governor,Ivan Holmes,IND,590118,0,1,22,23,
Pawnee,State Auditor,John Yeutter,LIB,590118,3,3,94,100,
Pawnee,State Auditor,Cindy Byrd,REP,590118,21,14,457,492,
Pawnee,Attorney General,Mike Hunter,REP,590118,15,13,436,464,
Pawnee,Attorney General,Mark Myles,DEM,590118,10,9,154,173,
Pawnee,State Treasurer,Randy Mcdaniel,REP,590118,17,15,432,464,
Pawnee,State Treasurer,Charles De Coune,IND,590118,6,2,118,126,
Pawnee,Superintendent of Public Instruction,Joy Hofmeister,REP,590118,13,13,362,388,
Pawnee,Superintendent of Public Instruction,John Cox,DEM,590118,11,9,167,187,
Pawnee,Superintendent of Public Instruction,Larry Huff,IND,590118,0,0,61,61,
Pawnee,Commissioner of Labor,Leslie Osborn,REP,590118,13,16,398,427,
Pawnee,Commissioner of Labor,Fred Dorrell,DEM,590118,12,5,154,171,
Pawnee,Commissioner of Labor,Brandt Dismukes,IND,590118,0,0,33,33,
Pawnee,Insurance Commissioner,Glen Mulready,REP,590118,14,14,423,451,
Pawnee,Insurance Commissioner,Kimberly Fobbs,DEM,590118,11,7,156,174,
Pawnee,Corporation Commissioner,Bob Anthony,REP,590118,14,14,409,437,
Pawnee,Corporation Commissioner,Ashley Nicole Mccray,DEM,590118,9,7,155,171,
Pawnee,Corporation Commissioner,Jackie Short,IND,590118,2,1,24,27,
Pawnee,U.S. House,Frank Lucas,REP,590118,14,15,433,462,3
Pawnee,U.S. House,Frankie Robbins,DEM,590118,11,7,155,173,3
Pawnee,State Senate,Chuck Hall,REP,590118,16,14,424,454,20
Pawnee,State Senate,Heady Coleman,DEM,590118,9,7,162,178,20
Pawnee,State House,Ty Burns,REP,590118,14,15,408,437,35
Pawnee,State House,Jasha Lyons Echo-Hawk,DEM,590118,11,7,185,203,35
Pawnee,Governor,Chris Powell,LIB,590202,1,13,36,50,
Pawnee,Governor,Kevin Stitt,REP,590202,15,83,396,494,
Pawnee,Governor,Drew Edmondson,DEM,590202,19,75,354,448,
Pawnee,Lieutenant Governor,Matt Pinnell,REP,590202,18,92,459,569,
Pawnee,Lieutenant Governor,Anastasia Pittman,DEM,590202,13,70,285,368,
Pawnee,Lieutenant Governor,Ivan Holmes,IND,590202,4,6,34,44,
Pawnee,State Auditor,John Yeutter,LIB,590202,7,29,196,232,
Pawnee,State Auditor,Cindy Byrd,REP,590202,23,117,544,684,
Pawnee,Attorney General,Mike Hunter,REP,590202,16,103,481,600,
Pawnee,Attorney General,Mark Myles,DEM,590202,19,66,299,384,
Pawnee,State Treasurer,Randy Mcdaniel,REP,590202,20,110,512,642,
Pawnee,State Treasurer,Charles De Coune,IND,590202,10,36,225,271,
Pawnee,Superintendent of Public Instruction,Joy Hofmeister,REP,590202,20,91,408,519,
Pawnee,Superintendent of Public Instruction,John Cox,DEM,590202,13,62,305,380,
Pawnee,Superintendent of Public Instruction,Larry Huff,IND,590202,2,15,66,83,
Pawnee,Commissioner of Labor,Leslie Osborn,REP,590202,18,98,447,563,
Pawnee,Commissioner of Labor,Fred Dorrell,DEM,590202,14,61,282,357,
Pawnee,Commissioner of Labor,Brandt Dismukes,IND,590202,3,7,42,52,
Pawnee,Insurance Commissioner,Glen Mulready,REP,590202,16,98,431,545,
Pawnee,Insurance Commissioner,Kimberly Fobbs,DEM,590202,19,68,336,423,
Pawnee,Corporation Commissioner,Bob Anthony,REP,590202,16,85,424,525,
Pawnee,Corporation Commissioner,Ashley Nicole Mccray,DEM,590202,16,70,321,407,
Pawnee,Corporation Commissioner,Jackie Short,IND,590202,3,11,35,49,
Pawnee,U.S. House,Frank Lucas,REP,590202,16,105,491,612,3
Pawnee,U.S. House,Frankie Robbins,DEM,590202,19,63,289,371,3
Pawnee,State Senate,Chuck Hall,REP,590202,16,108,469,593,20
Pawnee,State Senate,Heady Coleman,DEM,590202,19,59,305,383,20
Pawnee,State House,Ty Burns,REP,590202,21,106,494,621,35
Pawnee,State House,Jasha Lyons Echo-Hawk,DEM,590202,14,62,288,364,35
Pawnee,Governor,Chris Powell,LIB,590215,0,0,5,5,
Pawnee,Governor,Kevin Stitt,REP,590215,0,5,49,54,
Pawnee,Governor,Drew Edmondson,DEM,590215,0,3,49,52,
Pawnee,Lieutenant Governor,Matt Pinnell,REP,590215,0,7,57,64,
Pawnee,Lieutenant Governor,Anastasia Pittman,DEM,590215,0,1,41,42,
Pawnee,Lieutenant Governor,Ivan Holmes,IND,590215,0,0,3,3,
Pawnee,State Auditor,John Yeutter,LIB,590215,0,0,20,20,
Pawnee,State Auditor,Cindy Byrd,REP,590215,0,8,68,76,
Pawnee,Attorney General,Mike Hunter,REP,590215,0,4,54,58,
Pawnee,Attorney General,Mark Myles,DEM,590215,0,4,48,52,
Pawnee,State Treasurer,Randy Mcdaniel,REP,590215,0,7,58,65,
Pawnee,State Treasurer,Charles De Coune,IND,590215,0,1,31,32,
Pawnee,Superintendent of Public Instruction,Joy Hofmeister,REP,590215,0,3,48,51,
Pawnee,Superintendent of Public Instruction,John Cox,DEM,590215,0,5,46,51,
Pawnee,Superintendent of Public Instruction,Larry Huff,IND,590215,0,0,8,8,
Pawnee,Commissioner of Labor,Leslie Osborn,REP,590215,0,6,48,54,
Pawnee,Commissioner of Labor,Fred Dorrell,DEM,590215,0,2,43,45,
Pawnee,Commissioner of Labor,Brandt Dismukes,IND,590215,0,0,6,6,
Pawnee,Insurance Commissioner,Glen Mulready,REP,590215,0,5,54,59,
Pawnee,Insurance Commissioner,Kimberly Fobbs,DEM,590215,0,3,46,49,
Pawnee,Corporation Commissioner,Bob Anthony,REP,590215,0,5,57,62,
Pawnee,Corporation Commissioner,Ashley Nicole Mccray,DEM,590215,0,3,43,46,
Pawnee,Corporation Commissioner,Jackie Short,IND,590215,0,0,2,2,
Pawnee,U.S. House,Frank Lucas,REP,590215,0,6,62,68,3
Pawnee,U.S. House,Frankie Robbins,DEM,590215,0,2,41,43,3
Pawnee,State Senate,Chuck Hall,REP,590215,0,5,56,61,20
Pawnee,State Senate,Heady Coleman,DEM,590215,0,3,44,47,20
Pawnee,State House,Ty Burns,REP,590215,0,6,61,67,35
Pawnee,State House,Jasha Lyons Echo-Hawk,DEM,590215,0,2,39,41,35
Pawnee,Governor,Chris Powell,LIB,590217,0,0,23,23,
Pawnee,Governor,Kevin Stitt,REP,590217,14,15,312,341,
Pawnee,Governor,Drew Edmondson,DEM,590217,9,3,197,209,
Pawnee,Lieutenant Governor,Matt Pinnell,REP,590217,17,16,360,393,
Pawnee,Lieutenant Governor,Anastasia Pittman,DEM,590217,6,2,151,159,
Pawnee,Lieutenant Governor,Ivan Holmes,IND,590217,0,0,17,17,
Pawnee,State Auditor,John Yeutter,LIB,590217,5,1,104,110,
Pawnee,State Auditor,Cindy Byrd,REP,590217,17,16,392,425,
Pawnee,Attorney General,Mike Hunter,REP,590217,16,16,377,409,
Pawnee,Attorney General,Mark Myles,DEM,590217,7,2,149,158,
Pawnee,State Treasurer,Randy Mcdaniel,REP,590217,17,16,398,431,
Pawnee,State Treasurer,Charles De Coune,IND,590217,4,1,98,103,
Pawnee,Superintendent of Public Instruction,Joy Hofmeister,REP,590217,15,15,326,356,
Pawnee,Superintendent of Public Instruction,John Cox,DEM,590217,7,3,161,171,
Pawnee,Superintendent of Public Instruction,Larry Huff,IND,590217,1,0,43,44,
Pawnee,Commissioner of Labor,Leslie Osborn,REP,590217,15,15,344,374,
Pawnee,Commissioner of Labor,Fred Dorrell,DEM,590217,7,3,151,161,
Pawnee,Commissioner of Labor,Brandt Dismukes,IND,590217,0,0,27,27,
Pawnee,Insurance Commissioner,Glen Mulready,REP,590217,14,14,356,384,
Pawnee,Insurance Commissioner,Kimberly Fobbs,DEM,590217,8,4,168,180,
Pawnee,Corporation Commissioner,Bob Anthony,REP,590217,16,16,353,385,
Pawnee,Corporation Commissioner,Ashley Nicole Mccray,DEM,590217,6,2,152,160,
Pawnee,Corporation Commissioner,Jackie Short,IND,590217,0,0,22,22,
Pawnee,U.S. House,Frank Lucas,REP,590217,17,15,380,412,3
Pawnee,U.S. House,Frankie Robbins,DEM,590217,5,3,150,158,3
Pawnee,State Senate,Chuck Hall,REP,590217,16,14,368,398,20
Pawnee,State Senate,Heady Coleman,DEM,590217,6,4,159,169,20
Pawnee,State House,Ty Burns,REP,590217,16,11,359,386,35
Pawnee,State House,Jasha Lyons Echo-Hawk,DEM,590217,6,6,170,182,35
Pawnee,Governor,Chris Powell,LIB,590307,1,0,42,43,
Pawnee,Governor,Kevin Stitt,REP,590307,34,21,532,587,
Pawnee,Governor,Drew Edmondson,DEM,590307,7,16,213,236,
Pawnee,Lieutenant Governor,Matt Pinnell,REP,590307,32,21,580,633,
Pawnee,Lieutenant Governor,Anastasia Pittman,DEM,590307,7,15,174,196,
Pawnee,Lieutenant Governor,Ivan Holmes,IND,590307,3,1,29,33,
Pawnee,State Auditor,John Yeutter,LIB,590307,8,7,136,151,
Pawnee,State Auditor,Cindy Byrd,REP,590307,32,25,593,650,
Pawnee,Attorney General,Mike Hunter,REP,590307,33,22,602,657,
Pawnee,Attorney General,Mark Myles,DEM,590307,9,15,180,204,
Pawnee,State Treasurer,Randy Mcdaniel,REP,590307,34,21,593,648,
Pawnee,State Treasurer,Charles De Coune,IND,590307,7,11,134,152,
Pawnee,Superintendent of Public Instruction,Joy Hofmeister,REP,590307,26,20,510,556,
Pawnee,Superintendent of Public Instruction,John Cox,DEM,590307,13,13,190,216,
Pawnee,Superintendent of Public Instruction,Larry Huff,IND,590307,3,3,77,83,
Pawnee,Commissioner of Labor,Leslie Osborn,REP,590307,32,21,541,594,
Pawnee,Commissioner of Labor,Fred Dorrell,DEM,590307,5,14,182,201,
Pawnee,Commissioner of Labor,Brandt Dismukes,IND,590307,5,2,40,47,
Pawnee,Insurance Commissioner,Glen Mulready,REP,590307,31,21,565,617,
Pawnee,Insurance Commissioner,Kimberly Fobbs,DEM,590307,11,15,201,227,
Pawnee,Corporation Commissioner,Bob Anthony,REP,590307,26,20,556,602,
Pawnee,Corporation Commissioner,Ashley Nicole Mccray,DEM,590307,13,16,164,193,
Pawnee,Corporation Commissioner,Jackie Short,IND,590307,3,0,55,58,
Pawnee,U.S. House,Frank Lucas,REP,590307,33,21,584,638,3
Pawnee,U.S. House,Frankie Robbins,DEM,590307,9,15,190,214,3
Pawnee,State Senate,Chuck Hall,REP,590307,35,21,577,633,20
Pawnee,State Senate,Heady Coleman,DEM,590307,7,15,191,213,20
Pawnee,State House,Ty Burns,REP,590307,31,21,563,615,35
Pawnee,State House,Jasha Lyons Echo-Hawk,DEM,590307,11,15,209,235,35
Pawnee,Governor,Chris Powell,LIB,590309,0,0,10,10,
Pawnee,Governor,Kevin Stitt,REP,590309,8,2,141,151,
Pawnee,Governor,Drew Edmondson,DEM,590309,1,0,49,50,
Pawnee,Lieutenant Governor,Matt Pinnell,REP,590309,8,2,150,160,
Pawnee,Lieutenant Governor,Anastasia Pittman,DEM,590309,1,0,41,42,
Pawnee,Lieutenant Governor,Ivan Holmes,IND,590309,0,0,9,9,
Pawnee,State Auditor,John Yeutter,LIB,590309,0,0,39,39,
Pawnee,State Auditor,Cindy Byrd,REP,590309,8,2,151,161,
Pawnee,Attorney General,Mike Hunter,REP,590309,8,2,159,169,
Pawnee,Attorney General,Mark Myles,DEM,590309,1,0,40,41,
Pawnee,State Treasurer,Randy Mcdaniel,REP,590309,8,2,157,167,
Pawnee,State Treasurer,Charles De Coune,IND,590309,0,0,31,31,
Pawnee,Superintendent of Public Instruction,Joy Hofmeister,REP,590309,8,2,128,138,
Pawnee,Superintendent of Public Instruction,John Cox,DEM,590309,1,0,46,47,
Pawnee,Superintendent of Public Instruction,Larry Huff,IND,590309,0,0,23,23,
Pawnee,Commissioner of Labor,Leslie Osborn,REP,590309,8,2,139,149,
Pawnee,Commissioner of Labor,Fred Dorrell,DEM,590309,1,0,42,43,
Pawnee,Commissioner of Labor,Brandt Dismukes,IND,590309,0,0,16,16,
Pawnee,Insurance Commissioner,Glen Mulready,REP,590309,8,2,155,165,
Pawnee,Insurance Commissioner,Kimberly Fobbs,DEM,590309,1,0,45,46,
Pawnee,Corporation Commissioner,Bob Anthony,REP,590309,8,2,144,154,
Pawnee,Corporation Commissioner,Ashley Nicole Mccray,DEM,590309,1,0,45,46,
Pawnee,Corporation Commissioner,Jackie Short,IND,590309,0,0,11,11,
Pawnee,U.S. House,Frank Lucas,REP,590309,8,2,156,166,3
Pawnee,U.S. House,Frankie Robbins,DEM,590309,1,0,42,43,3
Pawnee,State Senate,Chuck Hall,REP,590309,8,2,153,163,20
Pawnee,State Senate,Heady Coleman,DEM,590309,1,0,46,47,20
Pawnee,State House,Ty Burns,REP,590309,8,2,153,163,35
Pawnee,State House,Jasha Lyons Echo-Hawk,DEM,590309,1,0,46,47,35
Pawnee,Governor,Chris Powell,LIB,590314,1,0,20,21,
Pawnee,Governor,Kevin Stitt,REP,590314,3,12,377,392,
Pawnee,Governor,Drew Edmondson,DEM,590314,8,1,148,157,
Pawnee,Lieutenant Governor,Matt Pinnell,REP,590314,1,12,409,422,
Pawnee,Lieutenant Governor,Anastasia Pittman,DEM,590314,9,1,118,128,
Pawnee,Lieutenant Governor,Ivan Holmes,IND,590314,0,0,17,17,
Pawnee,State Auditor,John Yeutter,LIB,590314,6,0,85,91,
Pawnee,State Auditor,Cindy Byrd,REP,590314,2,13,425,440,
Pawnee,Attorney General,Mike Hunter,REP,590314,2,11,417,430,
Pawnee,Attorney General,Mark Myles,DEM,590314,9,2,124,135,
Pawnee,State Treasurer,Randy Mcdaniel,REP,590314,1,13,421,435,
Pawnee,State Treasurer,Charles De Coune,IND,590314,7,0,92,99,
Pawnee,Superintendent of Public Instruction,Joy Hofmeister,REP,590314,1,11,372,384,
Pawnee,Superintendent of Public Instruction,John Cox,DEM,590314,8,2,118,128,
Pawnee,Superintendent of Public Instruction,Larry Huff,IND,590314,3,0,52,55,
Pawnee,Commissioner of Labor,Leslie Osborn,REP,590314,1,12,403,416,
Pawnee,Commissioner of Labor,Fred Dorrell,DEM,590314,8,1,120,129,
Pawnee,Commissioner of Labor,Brandt Dismukes,IND,590314,1,0,20,21,
Pawnee,Insurance Commissioner,Glen Mulready,REP,590314,1,12,410,423,
Pawnee,Insurance Commissioner,Kimberly Fobbs,DEM,590314,9,1,133,143,
Pawnee,Corporation Commissioner,Bob Anthony,REP,590314,4,10,399,413,
Pawnee,Corporation Commissioner,Ashley Nicole Mccray,DEM,590314,6,2,111,119,
Pawnee,Corporation Commissioner,Jackie Short,IND,590314,0,1,34,35,
Pawnee,U.S. House,Frank Lucas,REP,590314,4,12,411,427,3
Pawnee,U.S. House,Frankie Robbins,DEM,590314,8,1,130,139,3
Pawnee,State Senate,Chuck Hall,REP,590314,1,11,412,424,20
Pawnee,State Senate,Heady Coleman,DEM,590314,9,1,132,142,20
Pawnee,State House,Ty Burns,REP,590314,1,13,412,426,35
Pawnee,State House,Jasha Lyons Echo-Hawk,DEM,590314,9,0,132,141,35
Payne,Governor,Chris Powell,LIB,600001,0,3,22,25,
Payne,Governor,Kevin Stitt,REP,600001,3,2,97,102,
Payne,Governor,Drew Edmondson,DEM,600001,12,13,145,170,
Payne,Lieutenant Governor,Matt Pinnell,REP,600001,4,5,115,124,
Payne,Lieutenant Governor,Anastasia Pittman,DEM,600001,12,9,125,146,
Payne,Lieutenant Governor,Ivan Holmes,IND,600001,0,3,18,21,
Payne,State Auditor,John Yeutter,LIB,600001,9,9,104,122,
Payne,State Auditor,Cindy Byrd,REP,600001,6,7,130,143,
Payne,Attorney General,Mike Hunter,REP,600001,4,5,119,128,
Payne,Attorney General,Mark Myles,DEM,600001,12,11,136,159,
Payne,State Treasurer,Randy Mcdaniel,REP,600001,6,7,118,131,
Payne,State Treasurer,Charles De Coune,IND,600001,9,9,116,134,
Payne,Superintendent of Public Instruction,Joy Hofmeister,REP,600001,4,6,103,113,
Payne,Superintendent of Public Instruction,John Cox,DEM,600001,10,8,118,136,
Payne,Superintendent of Public Instruction,Larry Huff,IND,600001,2,2,33,37,
Payne,Commissioner of Labor,Leslie Osborn,REP,600001,5,5,116,126,
Payne,Commissioner of Labor,Fred Dorrell,DEM,600001,9,10,119,138,
Payne,Commissioner of Labor,Brandt Dismukes,IND,600001,2,1,18,21,
Payne,Insurance Commissioner,Glen Mulready,REP,600001,5,4,113,122,
Payne,Insurance Commissioner,Kimberly Fobbs,DEM,600001,11,12,141,164,
Payne,Corporation Commissioner,Bob Anthony,REP,600001,5,4,98,107,
Payne,Corporation Commissioner,Ashley Nicole Mccray,DEM,600001,11,11,126,148,
Payne,Corporation Commissioner,Jackie Short,IND,600001,0,1,29,30,
Payne,U.S. House,Frank Lucas,REP,600001,5,5,123,133,3
Payne,U.S. House,Frankie Robbins,DEM,600001,11,12,133,156,3
Payne,State House,Aaron Means,REP,600001,4,4,110,118,34
Payne,State House,Trish Ranson,DEM,600001,12,13,149,174,34
Payne,Governor,Chris Powell,LIB,600002,0,3,42,45,
Payne,Governor,Kevin Stitt,REP,600002,13,22,242,277,
Payne,Governor,Drew Edmondson,DEM,600002,18,52,343,413,
Payne,Lieutenant Governor,Matt Pinnell,REP,600002,14,25,297,336,
Payne,Lieutenant Governor,Anastasia Pittman,DEM,600002,16,48,279,343,
Payne,Lieutenant Governor,Ivan Holmes,IND,600002,1,1,45,47,
Payne,State Auditor,John Yeutter,LIB,600002,10,28,223,261,
Payne,State Auditor,Cindy Byrd,REP,600002,19,36,350,405,
Payne,Attorney General,Mike Hunter,REP,600002,14,31,302,347,
Payne,Attorney General,Mark Myles,DEM,600002,17,46,309,372,
Payne,State Treasurer,Randy Mcdaniel,REP,600002,16,37,302,355,
Payne,State Treasurer,Charles De Coune,IND,600002,13,29,266,308,
Payne,Superintendent of Public Instruction,Joy Hofmeister,REP,600002,15,31,277,323,
Payne,Superintendent of Public Instruction,John Cox,DEM,600002,15,41,269,325,
Payne,Superintendent of Public Instruction,Larry Huff,IND,600002,1,5,74,80,
Payne,Commissioner of Labor,Leslie Osborn,REP,600002,14,31,282,327,
Payne,Commissioner of Labor,Fred Dorrell,DEM,600002,15,43,286,344,
Payne,Commissioner of Labor,Brandt Dismukes,IND,600002,2,2,41,45,
Payne,Insurance Commissioner,Glen Mulready,REP,600002,16,31,292,339,
Payne,Insurance Commissioner,Kimberly Fobbs,DEM,600002,15,45,315,375,
Payne,Corporation Commissioner,Bob Anthony,REP,600002,15,28,282,325,
Payne,Corporation Commissioner,Ashley Nicole Mccray,DEM,600002,15,47,272,334,
Payne,Corporation Commissioner,Jackie Short,IND,600002,1,2,58,61,
Payne,U.S. House,Frank Lucas,REP,600002,14,28,317,359,3
Payne,U.S. House,Frankie Robbins,DEM,600002,17,49,299,365,3
Payne,State House,Aaron Means,REP,600002,13,30,282,325,34
Payne,State House,Trish Ranson,DEM,600002,18,47,339,404,34
Payne,Governor,Chris Powell,LIB,600003,0,3,16,19,
Payne,Governor,Kevin Stitt,REP,600003,2,19,143,164,
Payne,Governor,Drew Edmondson,DEM,600003,7,26,172,205,
Payne,Lieutenant Governor,Matt Pinnell,REP,600003,2,23,169,194,
Payne,Lieutenant Governor,Anastasia Pittman,DEM,600003,5,23,140,168,
Payne,Lieutenant Governor,Ivan Holmes,IND,600003,2,2,21,25,
Payne,State Auditor,John Yeutter,LIB,600003,4,18,109,131,
Payne,State Auditor,Cindy Byrd,REP,600003,4,27,200,231,
Payne,Attorney General,Mike Hunter,REP,600003,2,23,170,195,
Payne,Attorney General,Mark Myles,DEM,600003,7,25,156,188,
Payne,State Treasurer,Randy Mcdaniel,REP,600003,1,26,185,212,
Payne,State Treasurer,Charles De Coune,IND,600003,7,20,123,150,
Payne,Superintendent of Public Instruction,Joy Hofmeister,REP,600003,1,24,152,177,
Payne,Superintendent of Public Instruction,John Cox,DEM,600003,7,19,135,161,
Payne,Superintendent of Public Instruction,Larry Huff,IND,600003,1,5,39,45,
Payne,Commissioner of Labor,Leslie Osborn,REP,600003,2,26,168,196,
Payne,Commissioner of Labor,Fred Dorrell,DEM,600003,7,20,125,152,
Payne,Commissioner of Labor,Brandt Dismukes,IND,600003,0,1,32,33,
Payne,Insurance Commissioner,Glen Mulready,REP,600003,2,25,167,194,
Payne,Insurance Commissioner,Kimberly Fobbs,DEM,600003,7,23,158,188,
Payne,Corporation Commissioner,Bob Anthony,REP,600003,2,22,155,179,
Payne,Corporation Commissioner,Ashley Nicole Mccray,DEM,600003,7,21,141,169,
Payne,Corporation Commissioner,Jackie Short,IND,600003,0,5,30,35,
Payne,U.S. House,Frank Lucas,REP,600003,4,23,178,205,3
Payne,U.S. House,Frankie Robbins,DEM,600003,5,25,149,179,3
Payne,Governor,Chris Powell,LIB,600004,4,6,40,50,
Payne,Governor,Kevin Stitt,REP,600004,16,55,317,388,
Payne,Governor,Drew Edmondson,DEM,600004,22,133,442,597,
Payne,Lieutenant Governor,Matt Pinnell,REP,600004,20,77,403,500,
Payne,Lieutenant Governor,Anastasia Pittman,DEM,600004,20,101,347,468,
Payne,Lieutenant Governor,Ivan Holmes,IND,600004,2,16,36,54,
Payne,State Auditor,John Yeutter,LIB,600004,11,52,222,285,
Payne,State Auditor,Cindy Byrd,REP,600004,28,111,500,639,
Payne,Attorney General,Mike Hunter,REP,600004,22,81,410,513,
Payne,Attorney General,Mark Myles,DEM,600004,20,111,370,501,
Payne,State Treasurer,Randy Mcdaniel,REP,600004,23,89,439,551,
Payne,State Treasurer,Charles De Coune,IND,600004,17,76,287,380,
Payne,Superintendent of Public Instruction,Joy Hofmeister,REP,600004,21,98,408,527,
Payne,Superintendent of Public Instruction,John Cox,DEM,600004,20,84,322,426,
Payne,Superintendent of Public Instruction,Larry Huff,IND,600004,1,12,54,67,
Payne,Commissioner of Labor,Leslie Osborn,REP,600004,24,73,419,516,
Payne,Commissioner of Labor,Fred Dorrell,DEM,600004,17,106,312,435,
Payne,Commissioner of Labor,Brandt Dismukes,IND,600004,1,14,41,56,
Payne,Insurance Commissioner,Glen Mulready,REP,600004,22,80,397,499,
Payne,Insurance Commissioner,Kimberly Fobbs,DEM,600004,20,110,370,500,
Payne,Corporation Commissioner,Bob Anthony,REP,600004,21,75,370,466,
Payne,Corporation Commissioner,Ashley Nicole Mccray,DEM,600004,19,103,360,482,
Payne,Corporation Commissioner,Jackie Short,IND,600004,2,16,45,63,
Payne,U.S. House,Frank Lucas,REP,600004,20,84,434,538,3
Payne,U.S. House,Frankie Robbins,DEM,600004,22,110,351,483,3
Payne,State House,Aaron Means,REP,600004,17,62,361,440,34
Payne,State House,Trish Ranson,DEM,600004,25,132,421,578,34
Payne,Governor,Chris Powell,LIB,600005,0,0,7,7,
Payne,Governor,Kevin Stitt,REP,600005,8,8,107,123,
Payne,Governor,Drew Edmondson,DEM,600005,2,17,105,124,
Payne,Lieutenant Governor,Matt Pinnell,REP,600005,8,13,127,148,
Payne,Lieutenant Governor,Anastasia Pittman,DEM,600005,1,11,84,96,
Payne,Lieutenant Governor,Ivan Holmes,IND,600005,1,1,7,9,
Payne,State Auditor,John Yeutter,LIB,600005,2,10,59,71,
Payne,State Auditor,Cindy Byrd,REP,600005,8,14,149,171,
Payne,Attorney General,Mike Hunter,REP,600005,9,12,133,154,
Payne,Attorney General,Mark Myles,DEM,600005,1,13,80,94,
Payne,State Treasurer,Randy Mcdaniel,REP,600005,8,10,139,157,
Payne,State Treasurer,Charles De Coune,IND,600005,2,14,67,83,
Payne,Superintendent of Public Instruction,Joy Hofmeister,REP,600005,8,14,123,145,
Payne,Superintendent of Public Instruction,John Cox,DEM,600005,2,10,71,83,
Payne,Superintendent of Public Instruction,Larry Huff,IND,600005,0,1,22,23,
Payne,Commissioner of Labor,Leslie Osborn,REP,600005,9,14,135,158,
Payne,Commissioner of Labor,Fred Dorrell,DEM,600005,1,10,74,85,
Payne,Commissioner of Labor,Brandt Dismukes,IND,600005,0,1,5,6,
Payne,Insurance Commissioner,Glen Mulready,REP,600005,7,11,127,145,
Payne,Insurance Commissioner,Kimberly Fobbs,DEM,600005,3,14,85,102,
Payne,Corporation Commissioner,Bob Anthony,REP,600005,8,12,123,143,
Payne,Corporation Commissioner,Ashley Nicole Mccray,DEM,600005,1,13,78,92,
Payne,Corporation Commissioner,Jackie Short,IND,600005,1,0,14,15,
Payne,U.S. House,Frank Lucas,REP,600005,8,11,135,154,3
Payne,U.S. House,Frankie Robbins,DEM,600005,2,14,83,99,3
Payne,State House,Ty Burns,REP,600005,10,10,126,146,35
Payne,State House,Jasha Lyons Echo-Hawk,DEM,600005,0,15,90,105,35
Payne,Governor,Chris Powell,LIB,600006,1,5,41,47,
Payne,Governor,Kevin Stitt,REP,600006,10,50,379,439,
Payne,Governor,Drew Edmondson,DEM,600006,35,106,541,682,
Payne,Lieutenant Governor,Matt Pinnell,REP,600006,16,65,451,532,
Payne,Lieutenant Governor,Anastasia Pittman,DEM,600006,30,92,451,573,
Payne,Lieutenant Governor,Ivan Holmes,IND,600006,0,4,44,48,
Payne,State Auditor,John Yeutter,LIB,600006,16,59,295,370,
Payne,State Auditor,Cindy Byrd,REP,600006,20,90,575,685,
Payne,Attorney General,Mike Hunter,REP,600006,14,74,492,580,
Payne,Attorney General,Mark Myles,DEM,600006,32,87,444,563,
Payne,State Treasurer,Randy Mcdaniel,REP,600006,13,76,513,602,
Payne,State Treasurer,Charles De Coune,IND,600006,23,76,361,460,
Payne,Superintendent of Public Instruction,Joy Hofmeister,REP,600006,15,72,463,550,
Payne,Superintendent of Public Instruction,John Cox,DEM,600006,30,85,402,517,
Payne,Superintendent of Public Instruction,Larry Huff,IND,600006,1,4,80,85,
Payne,Commissioner of Labor,Leslie Osborn,REP,600006,15,64,453,532,
Payne,Commissioner of Labor,Fred Dorrell,DEM,600006,29,90,412,531,
Payne,Commissioner of Labor,Brandt Dismukes,IND,600006,1,4,70,75,
Payne,Insurance Commissioner,Glen Mulready,REP,600006,17,69,470,556,
Payne,Insurance Commissioner,Kimberly Fobbs,DEM,600006,27,88,465,580,
Payne,Corporation Commissioner,Bob Anthony,REP,600006,15,67,451,533,
Payne,Corporation Commissioner,Ashley Nicole Mccray,DEM,600006,28,87,416,531,
Payne,Corporation Commissioner,Jackie Short,IND,600006,2,4,70,76,
Payne,U.S. House,Frank Lucas,REP,600006,15,67,514,596,3
Payne,U.S. House,Frankie Robbins,DEM,600006,31,92,436,559,3
Payne,State House,Aaron Means,REP,600006,10,61,423,494,34
Payne,State House,Trish Ranson,DEM,600006,36,99,534,669,34
Payne,Governor,Chris Powell,LIB,600007,0,3,18,21,
Payne,Governor,Kevin Stitt,REP,600007,4,5,79,88,
Payne,Governor,Drew Edmondson,DEM,600007,14,27,222,263,
Payne,Lieutenant Governor,Matt Pinnell,REP,600007,4,7,97,108,
Payne,Lieutenant Governor,Anastasia Pittman,DEM,600007,14,24,196,234,
Payne,Lieutenant Governor,Ivan Holmes,IND,600007,0,4,23,27,
Payne,State Auditor,John Yeutter,LIB,600007,9,14,173,196,
Payne,State Auditor,Cindy Byrd,REP,600007,7,15,114,136,
Payne,Attorney General,Mike Hunter,REP,600007,4,13,104,121,
Payne,Attorney General,Mark Myles,DEM,600007,14,22,208,244,
Payne,State Treasurer,Randy Mcdaniel,REP,600007,4,11,118,133,
Payne,State Treasurer,Charles De Coune,IND,600007,12,18,171,201,
Payne,Superintendent of Public Instruction,Joy Hofmeister,REP,600007,4,10,94,108,
Payne,Superintendent of Public Instruction,John Cox,DEM,600007,14,22,188,224,
Payne,Superintendent of Public Instruction,Larry Huff,IND,600007,0,3,29,32,
Payne,Commissioner of Labor,Leslie Osborn,REP,600007,3,12,106,121,
Payne,Commissioner of Labor,Fred Dorrell,DEM,600007,14,20,181,215,
Payne,Commissioner of Labor,Brandt Dismukes,IND,600007,0,2,25,27,
Payne,Insurance Commissioner,Glen Mulready,REP,600007,4,10,104,118,
Payne,Insurance Commissioner,Kimberly Fobbs,DEM,600007,14,24,207,245,
Payne,Corporation Commissioner,Bob Anthony,REP,600007,3,7,95,105,
Payne,Corporation Commissioner,Ashley Nicole Mccray,DEM,600007,15,24,185,224,
Payne,Corporation Commissioner,Jackie Short,IND,600007,0,4,34,38,
Payne,U.S. House,Frank Lucas,REP,600007,5,10,108,123,3
Payne,U.S. House,Frankie Robbins,DEM,600007,13,25,206,244,3
Payne,State House,Aaron Means,REP,600007,4,9,100,113,34
Payne,State House,Trish Ranson,DEM,600007,14,26,214,254,34
Payne,Governor,Chris Powell,LIB,600008,1,2,20,23,
Payne,Governor,Kevin Stitt,REP,600008,13,28,139,180,
Payne,Governor,Drew Edmondson,DEM,600008,28,53,331,412,
Payne,Lieutenant Governor,Matt Pinnell,REP,600008,16,34,188,238,
Payne,Lieutenant Governor,Anastasia Pittman,DEM,600008,25,46,273,344,
Payne,Lieutenant Governor,Ivan Holmes,IND,600008,1,3,27,31,
Payne,State Auditor,John Yeutter,LIB,600008,10,28,197,235,
Payne,State Auditor,Cindy Byrd,REP,600008,21,46,243,310,
Payne,Attorney General,Mike Hunter,REP,600008,15,33,185,233,
Payne,Attorney General,Mark Myles,DEM,600008,27,49,300,376,
Payne,State Treasurer,Randy Mcdaniel,REP,600008,21,35,203,259,
Payne,State Treasurer,Charles De Coune,IND,600008,13,37,240,290,
Payne,Superintendent of Public Instruction,Joy Hofmeister,REP,600008,19,36,187,242,
Payne,Superintendent of Public Instruction,John Cox,DEM,600008,21,41,248,310,
Payne,Superintendent of Public Instruction,Larry Huff,IND,600008,1,4,49,54,
Payne,Commissioner of Labor,Leslie Osborn,REP,600008,17,37,190,244,
Payne,Commissioner of Labor,Fred Dorrell,DEM,600008,24,41,259,324,
Payne,Commissioner of Labor,Brandt Dismukes,IND,600008,0,3,29,32,
Payne,Insurance Commissioner,Glen Mulready,REP,600008,15,32,192,239,
Payne,Insurance Commissioner,Kimberly Fobbs,DEM,600008,26,48,288,362,
Payne,Corporation Commissioner,Bob Anthony,REP,600008,15,33,188,236,
Payne,Corporation Commissioner,Ashley Nicole Mccray,DEM,600008,26,46,265,337,
Payne,Corporation Commissioner,Jackie Short,IND,600008,0,3,31,34,
Payne,U.S. House,Frank Lucas,REP,600008,16,33,191,240,3
Payne,U.S. House,Frankie Robbins,DEM,600008,26,50,295,371,3
Payne,State House,Aaron Means,REP,600008,13,30,176,219,34
Payne,State House,Trish Ranson,DEM,600008,29,53,314,396,34
Payne,Governor,Chris Powell,LIB,600009,1,3,35,39,
Payne,Governor,Kevin Stitt,REP,600009,19,88,424,531,
Payne,Governor,Drew Edmondson,DEM,600009,36,123,525,684,
Payne,Lieutenant Governor,Matt Pinnell,REP,600009,25,103,520,648,
Payne,Lieutenant Governor,Anastasia Pittman,DEM,600009,29,102,421,552,
Payne,Lieutenant Governor,Ivan Holmes,IND,600009,2,8,34,44,
Payne,State Auditor,John Yeutter,LIB,600009,18,47,297,362,
Payne,State Auditor,Cindy Byrd,REP,600009,30,146,608,784,
Payne,Attorney General,Mike Hunter,REP,600009,22,118,550,690,
Payne,Attorney General,Mark Myles,DEM,600009,33,92,419,544,
Payne,State Treasurer,Randy Mcdaniel,REP,600009,21,110,578,709,
Payne,State Treasurer,Charles De Coune,IND,600009,30,87,326,443,
Payne,Superintendent of Public Instruction,Joy Hofmeister,REP,600009,26,121,543,690,
Payne,Superintendent of Public Instruction,John Cox,DEM,600009,27,77,380,484,
Payne,Superintendent of Public Instruction,Larry Huff,IND,600009,3,12,52,67,
Payne,Commissioner of Labor,Leslie Osborn,REP,600009,23,112,535,670,
Payne,Commissioner of Labor,Fred Dorrell,DEM,600009,27,84,380,491,
Payne,Commissioner of Labor,Brandt Dismukes,IND,600009,4,9,44,57,
Payne,Insurance Commissioner,Glen Mulready,REP,600009,22,105,509,636,
Payne,Insurance Commissioner,Kimberly Fobbs,DEM,600009,34,98,451,583,
Payne,Corporation Commissioner,Bob Anthony,REP,600009,22,110,505,637,
Payne,Corporation Commissioner,Ashley Nicole Mccray,DEM,600009,32,88,394,514,
Payne,Corporation Commissioner,Jackie Short,IND,600009,2,11,70,83,
Payne,U.S. House,Frank Lucas,REP,600009,24,123,561,708,3
Payne,U.S. House,Frankie Robbins,DEM,600009,31,90,415,536,3
Payne,Governor,Chris Powell,LIB,600010,0,0,12,12,
Payne,Governor,Kevin Stitt,REP,600010,6,12,119,137,
Payne,Governor,Drew Edmondson,DEM,600010,24,27,244,295,
Payne,Lieutenant Governor,Matt Pinnell,REP,600010,8,12,138,158,
Payne,Lieutenant Governor,Anastasia Pittman,DEM,600010,22,27,214,263,
Payne,Lieutenant Governor,Ivan Holmes,IND,600010,0,0,18,18,
Payne,State Auditor,John Yeutter,LIB,600010,7,14,131,152,
Payne,State Auditor,Cindy Byrd,REP,600010,16,21,192,229,
Payne,Attorney General,Mike Hunter,REP,600010,10,14,152,176,
Payne,Attorney General,Mark Myles,DEM,600010,20,25,216,261,
Payne,State Treasurer,Randy Mcdaniel,REP,600010,9,16,165,190,
Payne,State Treasurer,Charles De Coune,IND,600010,12,19,165,196,
Payne,Superintendent of Public Instruction,Joy Hofmeister,REP,600010,10,21,147,178,
Payne,Superintendent of Public Instruction,John Cox,DEM,600010,17,17,198,232,
Payne,Superintendent of Public Instruction,Larry Huff,IND,600010,1,1,23,25,
Payne,Commissioner of Labor,Leslie Osborn,REP,600010,11,15,156,182,
Payne,Commissioner of Labor,Fred Dorrell,DEM,600010,18,21,183,222,
Payne,Commissioner of Labor,Brandt Dismukes,IND,600010,0,3,26,29,
Payne,Insurance Commissioner,Glen Mulready,REP,600010,8,12,152,172,
Payne,Insurance Commissioner,Kimberly Fobbs,DEM,600010,20,26,212,258,
Payne,Corporation Commissioner,Bob Anthony,REP,600010,9,17,152,178,
Payne,Corporation Commissioner,Ashley Nicole Mccray,DEM,600010,18,19,197,234,
Payne,Corporation Commissioner,Jackie Short,IND,600010,1,2,17,20,
Payne,U.S. House,Frank Lucas,REP,600010,9,15,162,186,3
Payne,U.S. House,Frankie Robbins,DEM,600010,20,24,204,248,3
Payne,State House,Aaron Means,REP,600010,8,11,141,160,34
Payne,State House,Trish Ranson,DEM,600010,21,28,227,276,34
Payne,Governor,Chris Powell,LIB,600011,0,1,8,9,
Payne,Governor,Kevin Stitt,REP,600011,3,12,63,78,
Payne,Governor,Drew Edmondson,DEM,600011,9,22,118,149,
Payne,Lieutenant Governor,Matt Pinnell,REP,600011,5,18,91,114,
Payne,Lieutenant Governor,Anastasia Pittman,DEM,600011,7,16,86,109,
Payne,Lieutenant Governor,Ivan Holmes,IND,600011,0,1,7,8,
Payne,State Auditor,John Yeutter,LIB,600011,3,10,47,60,
Payne,State Auditor,Cindy Byrd,REP,600011,7,20,115,142,
Payne,Attorney General,Mike Hunter,REP,600011,7,17,90,114,
Payne,Attorney General,Mark Myles,DEM,600011,5,18,92,115,
Payne,State Treasurer,Randy Mcdaniel,REP,600011,6,17,99,122,
Payne,State Treasurer,Charles De Coune,IND,600011,4,15,68,87,
Payne,Superintendent of Public Instruction,Joy Hofmeister,REP,600011,6,20,93,119,
Payne,Superintendent of Public Instruction,John Cox,DEM,600011,5,13,80,98,
Payne,Superintendent of Public Instruction,Larry Huff,IND,600011,0,2,11,13,
Payne,Commissioner of Labor,Leslie Osborn,REP,600011,6,15,87,108,
Payne,Commissioner of Labor,Fred Dorrell,DEM,600011,5,15,85,105,
Payne,Commissioner of Labor,Brandt Dismukes,IND,600011,1,4,7,12,
Payne,Insurance Commissioner,Glen Mulready,REP,600011,6,17,94,117,
Payne,Insurance Commissioner,Kimberly Fobbs,DEM,600011,6,16,87,109,
Payne,Corporation Commissioner,Bob Anthony,REP,600011,6,15,88,109,
Payne,Corporation Commissioner,Ashley Nicole Mccray,DEM,600011,5,18,82,105,
Payne,Corporation Commissioner,Jackie Short,IND,600011,1,1,8,10,
Payne,U.S. House,Frank Lucas,REP,600011,6,17,96,119,3
Payne,U.S. House,Frankie Robbins,DEM,600011,6,18,88,112,3
Payne,State House,Aaron Means,REP,600011,5,6,83,94,34
Payne,State House,Trish Ranson,DEM,600011,6,28,100,134,34
Payne,Governor,Chris Powell,LIB,600012,0,0,16,16,
Payne,Governor,Kevin Stitt,REP,600012,1,3,61,65,
Payne,Governor,Drew Edmondson,DEM,600012,7,25,152,184,
Payne,Lieutenant Governor,Matt Pinnell,REP,600012,2,3,77,82,
Payne,Lieutenant Governor,Anastasia Pittman,DEM,600012,6,24,139,169,
Payne,Lieutenant Governor,Ivan Holmes,IND,600012,0,1,13,14,
Payne,State Auditor,John Yeutter,LIB,600012,3,12,100,115,
Payne,State Auditor,Cindy Byrd,REP,600012,5,12,104,121,
Payne,Attorney General,Mike Hunter,REP,600012,2,7,83,92,
Payne,Attorney General,Mark Myles,DEM,600012,6,21,143,170,
Payne,State Treasurer,Randy Mcdaniel,REP,600012,2,7,87,96,
Payne,State Treasurer,Charles De Coune,IND,600012,5,18,117,140,
Payne,Superintendent of Public Instruction,Joy Hofmeister,REP,600012,2,7,76,85,
Payne,Superintendent of Public Instruction,John Cox,DEM,600012,6,18,133,157,
Payne,Superintendent of Public Instruction,Larry Huff,IND,600012,0,3,18,21,
Payne,Commissioner of Labor,Leslie Osborn,REP,600012,1,8,89,98,
Payne,Commissioner of Labor,Fred Dorrell,DEM,600012,6,19,119,144,
Payne,Commissioner of Labor,Brandt Dismukes,IND,600012,1,1,17,19,
Payne,Insurance Commissioner,Glen Mulready,REP,600012,2,7,84,93,
Payne,Insurance Commissioner,Kimberly Fobbs,DEM,600012,6,21,141,168,
Payne,Corporation Commissioner,Bob Anthony,REP,600012,3,10,79,92,
Payne,Corporation Commissioner,Ashley Nicole Mccray,DEM,600012,5,17,128,150,
Payne,Corporation Commissioner,Jackie Short,IND,600012,0,1,18,19,
Payne,U.S. House,Frank Lucas,REP,600012,2,6,87,95,3
Payne,U.S. House,Frankie Robbins,DEM,600012,6,22,139,167,3
Payne,State House,Aaron Means,REP,600012,2,4,76,82,34
Payne,State House,Trish Ranson,DEM,600012,6,23,151,180,34
Payne,Governor,Chris Powell,LIB,600013,2,6,37,45,
Payne,Governor,Kevin Stitt,REP,600013,15,63,455,533,
Payne,Governor,Drew Edmondson,DEM,600013,37,89,505,631,
Payne,Lieutenant Governor,Matt Pinnell,REP,600013,22,79,550,651,
Payne,Lieutenant Governor,Anastasia Pittman,DEM,600013,31,74,393,498,
Payne,Lieutenant Governor,Ivan Holmes,IND,600013,1,6,45,52,
Payne,State Auditor,John Yeutter,LIB,600013,15,52,279,346,
Payne,State Auditor,Cindy Byrd,REP,600013,28,88,643,759,
Payne,Attorney General,Mike Hunter,REP,600013,17,79,560,656,
Payne,Attorney General,Mark Myles,DEM,600013,37,78,418,533,
Payne,State Treasurer,Randy Mcdaniel,REP,600013,23,81,586,690,
Payne,State Treasurer,Charles De Coune,IND,600013,22,60,340,422,
Payne,Superintendent of Public Instruction,Joy Hofmeister,REP,600013,19,78,530,627,
Payne,Superintendent of Public Instruction,John Cox,DEM,600013,32,67,382,481,
Payne,Superintendent of Public Instruction,Larry Huff,IND,600013,3,14,69,86,
Payne,Commissioner of Labor,Leslie Osborn,REP,600013,21,80,560,661,
Payne,Commissioner of Labor,Fred Dorrell,DEM,600013,32,67,364,463,
Payne,Commissioner of Labor,Brandt Dismukes,IND,600013,1,11,49,61,
Payne,Insurance Commissioner,Glen Mulready,REP,600013,18,74,561,653,
Payne,Insurance Commissioner,Kimberly Fobbs,DEM,600013,35,83,413,531,
Payne,Corporation Commissioner,Bob Anthony,REP,600013,17,73,537,627,
Payne,Corporation Commissioner,Ashley Nicole Mccray,DEM,600013,34,70,388,492,
Payne,Corporation Commissioner,Jackie Short,IND,600013,3,14,48,65,
Payne,U.S. House,Frank Lucas,REP,600013,18,82,580,680,3
Payne,U.S. House,Frankie Robbins,DEM,600013,36,75,401,512,3
Payne,State House,Aaron Means,REP,600013,18,69,500,587,34
Payne,State House,Trish Ranson,DEM,600013,36,88,492,616,34
Payne,Governor,Chris Powell,LIB,600014,0,1,0,1,
Payne,Governor,Kevin Stitt,REP,600014,0,2,7,9,
Payne,Governor,Drew Edmondson,DEM,600014,0,0,25,25,
Payne,Lieutenant Governor,Matt Pinnell,REP,600014,0,3,12,15,
Payne,Lieutenant Governor,Anastasia Pittman,DEM,600014,0,0,17,17,
Payne,Lieutenant Governor,Ivan Holmes,IND,600014,0,0,3,3,
Payne,State Auditor,John Yeutter,LIB,600014,0,0,9,9,
Payne,State Auditor,Cindy Byrd,REP,600014,0,3,17,20,
Payne,Attorney General,Mike Hunter,REP,600014,0,3,13,16,
Payne,Attorney General,Mark Myles,DEM,600014,0,0,19,19,
Payne,State Treasurer,Randy Mcdaniel,REP,600014,0,3,13,16,
Payne,State Treasurer,Charles De Coune,IND,600014,0,0,14,14,
Payne,Superintendent of Public Instruction,Joy Hofmeister,REP,600014,0,3,11,14,
Payne,Superintendent of Public Instruction,John Cox,DEM,600014,0,0,20,20,
Payne,Superintendent of Public Instruction,Larry Huff,IND,600014,0,0,1,1,
Payne,Commissioner of Labor,Leslie Osborn,REP,600014,0,3,14,17,
Payne,Commissioner of Labor,Fred Dorrell,DEM,600014,0,0,15,15,
Payne,Commissioner of Labor,Brandt Dismukes,IND,600014,0,0,2,2,
Payne,Insurance Commissioner,Glen Mulready,REP,600014,0,3,10,13,
Payne,Insurance Commissioner,Kimberly Fobbs,DEM,600014,0,0,20,20,
Payne,Corporation Commissioner,Bob Anthony,REP,600014,0,3,12,15,
Payne,Corporation Commissioner,Ashley Nicole Mccray,DEM,600014,0,0,14,14,
Payne,Corporation Commissioner,Jackie Short,IND,600014,0,0,4,4,
Payne,U.S. House,Frank Lucas,REP,600014,0,3,11,14,3
Payne,U.S. House,Frankie Robbins,DEM,600014,0,0,21,21,3
Payne,Governor,Chris Powell,LIB,600015,0,5,19,24,
Payne,Governor,Kevin Stitt,REP,600015,8,26,170,204,
Payne,Governor,Drew Edmondson,DEM,600015,31,83,321,435,
Payne,Lieutenant Governor,Matt Pinnell,REP,600015,10,45,218,273,
Payne,Lieutenant Governor,Anastasia Pittman,DEM,600015,28,65,263,356,
Payne,Lieutenant Governor,Ivan Holmes,IND,600015,1,3,30,34,
Payne,State Auditor,John Yeutter,LIB,600015,13,35,179,227,
Payne,State Auditor,Cindy Byrd,REP,600015,18,64,272,354,
Payne,Attorney General,Mike Hunter,REP,600015,11,49,221,281,
Payne,Attorney General,Mark Myles,DEM,600015,27,64,284,375,
Payne,State Treasurer,Randy Mcdaniel,REP,600015,15,54,243,312,
Payne,State Treasurer,Charles De Coune,IND,600015,16,46,207,269,
Payne,Superintendent of Public Instruction,Joy Hofmeister,REP,600015,12,49,224,285,
Payne,Superintendent of Public Instruction,John Cox,DEM,600015,25,58,252,335,
Payne,Superintendent of Public Instruction,Larry Huff,IND,600015,0,5,32,37,
Payne,Commissioner of Labor,Leslie Osborn,REP,600015,13,48,234,295,
Payne,Commissioner of Labor,Fred Dorrell,DEM,600015,24,59,239,322,
Payne,Commissioner of Labor,Brandt Dismukes,IND,600015,0,4,28,32,
Payne,Insurance Commissioner,Glen Mulready,REP,600015,11,44,220,275,
Payne,Insurance Commissioner,Kimberly Fobbs,DEM,600015,25,66,275,366,
Payne,Corporation Commissioner,Bob Anthony,REP,600015,12,46,210,268,
Payne,Corporation Commissioner,Ashley Nicole Mccray,DEM,600015,24,63,253,340,
Payne,Corporation Commissioner,Jackie Short,IND,600015,1,3,38,42,
Payne,U.S. House,Frank Lucas,REP,600015,15,50,239,304,3
Payne,U.S. House,Frankie Robbins,DEM,600015,24,62,267,353,3
Payne,State House,Aaron Means,REP,600015,8,43,198,249,34
Payne,State House,Trish Ranson,DEM,600015,31,71,307,409,34
Payne,Governor,Chris Powell,LIB,600016,6,11,44,61,
Payne,Governor,Kevin Stitt,REP,600016,39,223,650,912,
Payne,Governor,Drew Edmondson,DEM,600016,58,278,718,1054,
Payne,Lieutenant Governor,Matt Pinnell,REP,600016,44,281,814,1139,
Payne,Lieutenant Governor,Anastasia Pittman,DEM,600016,53,216,527,796,
Payne,Lieutenant Governor,Ivan Holmes,IND,600016,5,12,53,70,
Payne,State Auditor,John Yeutter,LIB,600016,21,116,343,480,
Payne,State Auditor,Cindy Byrd,REP,600016,65,343,944,1352,
Payne,Attorney General,Mike Hunter,REP,600016,47,290,846,1183,
Payne,Attorney General,Mark Myles,DEM,600016,54,214,541,809,
Payne,State Treasurer,Randy Mcdaniel,REP,600016,47,300,869,1216,
Payne,State Treasurer,Charles De Coune,IND,600016,38,166,424,628,
Payne,Superintendent of Public Instruction,Joy Hofmeister,REP,600016,48,303,806,1157,
Payne,Superintendent of Public Instruction,John Cox,DEM,600016,44,176,491,711,
Payne,Superintendent of Public Instruction,Larry Huff,IND,600016,9,27,92,128,
Payne,Commissioner of Labor,Leslie Osborn,REP,600016,54,283,838,1175,
Payne,Commissioner of Labor,Fred Dorrell,DEM,600016,40,201,469,710,
Payne,Commissioner of Labor,Brandt Dismukes,IND,600016,5,18,66,89,
Payne,Insurance Commissioner,Glen Mulready,REP,600016,53,279,800,1132,
Payne,Insurance Commissioner,Kimberly Fobbs,DEM,600016,45,221,568,834,
Payne,Corporation Commissioner,Bob Anthony,REP,600016,47,294,801,1142,
Payne,Corporation Commissioner,Ashley Nicole Mccray,DEM,600016,44,199,498,741,
Payne,Corporation Commissioner,Jackie Short,IND,600016,7,10,78,95,
Payne,U.S. House,Frank Lucas,REP,600016,53,287,852,1192,3
Payne,U.S. House,Frankie Robbins,DEM,600016,51,222,551,824,3
Payne,State House,Aaron Means,REP,600016,45,218,664,927,34
Payne,State House,Trish Ranson,DEM,600016,56,290,738,1084,34
Payne,Governor,Chris Powell,LIB,600101,1,2,23,26,
Payne,Governor,Kevin Stitt,REP,600101,9,15,401,425,
Payne,Governor,Drew Edmondson,DEM,600101,16,19,193,228,
Payne,Lieutenant Governor,Matt Pinnell,REP,600101,10,16,439,465,
Payne,Lieutenant Governor,Anastasia Pittman,DEM,600101,14,17,149,180,
Payne,Lieutenant Governor,Ivan Holmes,IND,600101,2,3,29,34,
Payne,State Auditor,John Yeutter,LIB,600101,3,14,98,115,
Payne,State Auditor,Cindy Byrd,REP,600101,19,19,472,510,
Payne,Attorney General,Mike Hunter,REP,600101,13,19,447,479,
Payne,Attorney General,Mark Myles,DEM,600101,13,17,165,195,
Payne,State Treasurer,Randy Mcdaniel,REP,600101,11,15,459,485,
Payne,State Treasurer,Charles De Coune,IND,600101,9,19,110,138,
Payne,Superintendent of Public Instruction,Joy Hofmeister,REP,600101,11,13,399,423,
Payne,Superintendent of Public Instruction,John Cox,DEM,600101,11,13,144,168,
Payne,Superintendent of Public Instruction,Larry Huff,IND,600101,4,10,69,83,
Payne,Commissioner of Labor,Leslie Osborn,REP,600101,13,19,427,459,
Payne,Commissioner of Labor,Fred Dorrell,DEM,600101,11,15,142,168,
Payne,Commissioner of Labor,Brandt Dismukes,IND,600101,1,2,38,41,
Payne,Insurance Commissioner,Glen Mulready,REP,600101,10,18,435,463,
Payne,Insurance Commissioner,Kimberly Fobbs,DEM,600101,16,18,176,210,
Payne,Corporation Commissioner,Bob Anthony,REP,600101,9,16,416,441,
Payne,Corporation Commissioner,Ashley Nicole Mccray,DEM,600101,13,18,153,184,
Payne,Corporation Commissioner,Jackie Short,IND,600101,4,2,43,49,
Payne,U.S. House,Frank Lucas,REP,600101,12,16,452,480,3
Payne,U.S. House,Frankie Robbins,DEM,600101,14,20,163,197,3
Payne,Governor,Chris Powell,LIB,600102,1,0,34,35,
Payne,Governor,Kevin Stitt,REP,600102,15,12,412,439,
Payne,Governor,Drew Edmondson,DEM,600102,16,8,225,249,
Payne,Lieutenant Governor,Matt Pinnell,REP,600102,16,12,474,502,
Payne,Lieutenant Governor,Anastasia Pittman,DEM,600102,14,8,171,193,
Payne,Lieutenant Governor,Ivan Holmes,IND,600102,1,0,24,25,
Payne,State Auditor,John Yeutter,LIB,600102,4,5,113,122,
Payne,State Auditor,Cindy Byrd,REP,600102,21,15,515,551,
Payne,Attorney General,Mike Hunter,REP,600102,17,13,475,505,
Payne,Attorney General,Mark Myles,DEM,600102,15,7,193,215,
Payne,State Treasurer,Randy Mcdaniel,REP,600102,20,13,517,550,
Payne,State Treasurer,Charles De Coune,IND,600102,5,7,117,129,
Payne,Superintendent of Public Instruction,Joy Hofmeister,REP,600102,17,9,446,472,
Payne,Superintendent of Public Instruction,John Cox,DEM,600102,14,9,165,188,
Payne,Superintendent of Public Instruction,Larry Huff,IND,600102,0,2,57,59,
Payne,Commissioner of Labor,Leslie Osborn,REP,600102,18,12,478,508,
Payne,Commissioner of Labor,Fred Dorrell,DEM,600102,14,7,154,175,
Payne,Commissioner of Labor,Brandt Dismukes,IND,600102,0,1,31,32,
Payne,Insurance Commissioner,Glen Mulready,REP,600102,17,11,457,485,
Payne,Insurance Commissioner,Kimberly Fobbs,DEM,600102,14,9,203,226,
Payne,Corporation Commissioner,Bob Anthony,REP,600102,16,12,444,472,
Payne,Corporation Commissioner,Ashley Nicole Mccray,DEM,600102,14,8,178,200,
Payne,Corporation Commissioner,Jackie Short,IND,600102,2,0,42,44,
Payne,U.S. House,Frank Lucas,REP,600102,17,12,486,515,3
Payne,U.S. House,Frankie Robbins,DEM,600102,14,8,182,204,3
Payne,Governor,Chris Powell,LIB,600103,1,0,32,33,
Payne,Governor,Kevin Stitt,REP,600103,17,11,343,371,
Payne,Governor,Drew Edmondson,DEM,600103,6,11,219,236,
Payne,Lieutenant Governor,Matt Pinnell,REP,600103,17,11,385,413,
Payne,Lieutenant Governor,Anastasia Pittman,DEM,600103,7,11,178,196,
Payne,Lieutenant Governor,Ivan Holmes,IND,600103,0,0,29,29,
Payne,State Auditor,John Yeutter,LIB,600103,3,5,129,137,
Payne,State Auditor,Cindy Byrd,REP,600103,18,13,432,463,
Payne,Attorney General,Mike Hunter,REP,600103,16,12,408,436,
Payne,Attorney General,Mark Myles,DEM,600103,8,10,182,200,
Payne,State Treasurer,Randy Mcdaniel,REP,600103,18,13,414,445,
Payne,State Treasurer,Charles De Coune,IND,600103,3,5,150,158,
Payne,Superintendent of Public Instruction,Joy Hofmeister,REP,600103,16,11,353,380,
Payne,Superintendent of Public Instruction,John Cox,DEM,600103,7,10,176,193,
Payne,Superintendent of Public Instruction,Larry Huff,IND,600103,0,1,61,62,
Payne,Commissioner of Labor,Leslie Osborn,REP,600103,18,10,380,408,
Payne,Commissioner of Labor,Fred Dorrell,DEM,600103,6,12,168,186,
Payne,Commissioner of Labor,Brandt Dismukes,IND,600103,0,0,39,39,
Payne,Insurance Commissioner,Glen Mulready,REP,600103,17,12,379,408,
Payne,Insurance Commissioner,Kimberly Fobbs,DEM,600103,7,10,206,223,
Payne,Corporation Commissioner,Bob Anthony,REP,600103,17,10,366,393,
Payne,Corporation Commissioner,Ashley Nicole Mccray,DEM,600103,7,10,172,189,
Payne,Corporation Commissioner,Jackie Short,IND,600103,0,2,52,54,
Payne,U.S. House,Frank Lucas,REP,600103,17,12,410,439,3
Payne,U.S. House,Frankie Robbins,DEM,600103,7,10,181,198,3
Payne,Governor,Chris Powell,LIB,600104,0,1,28,29,
Payne,Governor,Kevin Stitt,REP,600104,12,11,488,511,
Payne,Governor,Drew Edmondson,DEM,600104,8,9,167,184,
Payne,Lieutenant Governor,Matt Pinnell,REP,600104,14,17,525,556,
Payne,Lieutenant Governor,Anastasia Pittman,DEM,600104,6,4,131,141,
Payne,Lieutenant Governor,Ivan Holmes,IND,600104,0,0,20,20,
Payne,State Auditor,John Yeutter,LIB,600104,6,4,97,107,
Payne,State Auditor,Cindy Byrd,REP,600104,13,17,549,579,
Payne,Attorney General,Mike Hunter,REP,600104,13,17,539,569,
Payne,Attorney General,Mark Myles,DEM,600104,7,4,136,147,
Payne,State Treasurer,Randy Mcdaniel,REP,600104,13,18,550,581,
Payne,State Treasurer,Charles De Coune,IND,600104,6,3,95,104,
Payne,Superintendent of Public Instruction,Joy Hofmeister,REP,600104,13,14,483,510,
Payne,Superintendent of Public Instruction,John Cox,DEM,600104,6,6,143,155,
Payne,Superintendent of Public Instruction,Larry Huff,IND,600104,1,1,50,52,
Payne,Commissioner of Labor,Leslie Osborn,REP,600104,11,17,520,548,
Payne,Commissioner of Labor,Fred Dorrell,DEM,600104,7,3,128,138,
Payne,Commissioner of Labor,Brandt Dismukes,IND,600104,2,1,23,26,
Payne,Insurance Commissioner,Glen Mulready,REP,600104,13,18,521,552,
Payne,Insurance Commissioner,Kimberly Fobbs,DEM,600104,7,3,151,161,
Payne,Corporation Commissioner,Bob Anthony,REP,600104,14,17,515,546,
Payne,Corporation Commissioner,Ashley Nicole Mccray,DEM,600104,4,3,123,130,
Payne,Corporation Commissioner,Jackie Short,IND,600104,2,1,36,39,
Payne,U.S. House,Frank Lucas,REP,600104,13,16,551,580,3
Payne,U.S. House,Frankie Robbins,DEM,600104,7,5,127,139,3
Payne,Governor,Chris Powell,LIB,600201,1,0,22,23,
Payne,Governor,Kevin Stitt,REP,600201,16,17,410,443,
Payne,Governor,Drew Edmondson,DEM,600201,8,10,232,250,
Payne,Lieutenant Governor,Matt Pinnell,REP,600201,21,17,458,496,
Payne,Lieutenant Governor,Anastasia Pittman,DEM,600201,4,9,178,191,
Payne,Lieutenant Governor,Ivan Holmes,IND,600201,0,1,26,27,
Payne,State Auditor,John Yeutter,LIB,600201,4,7,124,135,
Payne,State Auditor,Cindy Byrd,REP,600201,17,17,488,522,
Payne,Attorney General,Mike Hunter,REP,600201,17,20,476,513,
Payne,Attorney General,Mark Myles,DEM,600201,6,7,186,199,
Payne,State Treasurer,Randy Mcdaniel,REP,600201,19,16,493,528,
Payne,State Treasurer,Charles De Coune,IND,600201,3,8,120,131,
Payne,Superintendent of Public Instruction,Joy Hofmeister,REP,600201,17,14,399,430,
Payne,Superintendent of Public Instruction,John Cox,DEM,600201,6,11,197,214,
Payne,Superintendent of Public Instruction,Larry Huff,IND,600201,2,2,65,69,
Payne,Commissioner of Labor,Leslie Osborn,REP,600201,17,17,458,492,
Payne,Commissioner of Labor,Fred Dorrell,DEM,600201,5,10,176,191,
Payne,Commissioner of Labor,Brandt Dismukes,IND,600201,1,0,21,22,
Payne,Insurance Commissioner,Glen Mulready,REP,600201,18,19,436,473,
Payne,Insurance Commissioner,Kimberly Fobbs,DEM,600201,6,8,215,229,
Payne,Corporation Commissioner,Bob Anthony,REP,600201,16,18,428,462,
Payne,Corporation Commissioner,Ashley Nicole Mccray,DEM,600201,8,8,182,198,
Payne,Corporation Commissioner,Jackie Short,IND,600201,1,1,49,51,
Payne,U.S. House,Frank Lucas,REP,600201,19,19,467,505,3
Payne,U.S. House,Frankie Robbins,DEM,600201,6,8,193,207,3
Payne,Governor,Chris Powell,LIB,600301,0,2,57,59,
Payne,Governor,Kevin Stitt,REP,600301,31,75,889,995,
Payne,Governor,Drew Edmondson,DEM,600301,30,46,497,573,
Payne,Lieutenant Governor,Matt Pinnell,REP,600301,35,83,1016,1134,
Payne,Lieutenant Governor,Anastasia Pittman,DEM,600301,26,37,366,429,
Payne,Lieutenant Governor,Ivan Holmes,IND,600301,0,3,52,55,
Payne,State Auditor,John Yeutter,LIB,600301,18,25,257,300,
Payne,State Auditor,Cindy Byrd,REP,600301,40,88,1129,1257,
Payne,Attorney General,Mike Hunter,REP,600301,35,81,1015,1131,
Payne,Attorney General,Mark Myles,DEM,600301,27,42,408,477,
Payne,State Treasurer,Randy Mcdaniel,REP,600301,38,82,1068,1188,
Payne,State Treasurer,Charles De Coune,IND,600301,22,32,314,368,
Payne,Superintendent of Public Instruction,Joy Hofmeister,REP,600301,30,80,951,1061,
Payne,Superintendent of Public Instruction,John Cox,DEM,600301,27,33,343,403,
Payne,Superintendent of Public Instruction,Larry Huff,IND,600301,4,9,138,151,
Payne,Commissioner of Labor,Leslie Osborn,REP,600301,30,80,1013,1123,
Payne,Commissioner of Labor,Fred Dorrell,DEM,600301,29,38,332,399,
Payne,Commissioner of Labor,Brandt Dismukes,IND,600301,3,3,68,74,
Payne,Insurance Commissioner,Glen Mulready,REP,600301,36,86,999,1121,
Payne,Insurance Commissioner,Kimberly Fobbs,DEM,600301,26,36,415,477,
Payne,Corporation Commissioner,Bob Anthony,REP,600301,35,76,971,1082,
Payne,Corporation Commissioner,Ashley Nicole Mccray,DEM,600301,24,39,348,411,
Payne,Corporation Commissioner,Jackie Short,IND,600301,3,6,106,115,
Payne,U.S. House,Frank Lucas,REP,600301,37,81,1070,1188,3
Payne,U.S. House,Frankie Robbins,DEM,600301,25,42,361,428,3
Payne,Governor,Chris Powell,LIB,600401,4,6,53,63,
Payne,Governor,Kevin Stitt,REP,600401,32,120,720,872,
Payne,Governor,Drew Edmondson,DEM,600401,47,153,636,836,
Payne,Lieutenant Governor,Matt Pinnell,REP,600401,39,153,875,1067,
Payne,Lieutenant Governor,Anastasia Pittman,DEM,600401,36,114,463,613,
Payne,Lieutenant Governor,Ivan Holmes,IND,600401,6,12,54,72,
Payne,State Auditor,John Yeutter,LIB,600401,25,64,279,368,
Payne,State Auditor,Cindy Byrd,REP,600401,49,191,1021,1261,
Payne,Attorney General,Mike Hunter,REP,600401,36,157,896,1089,
Payne,Attorney General,Mark Myles,DEM,600401,44,121,478,643,
Payne,State Treasurer,Randy Mcdaniel,REP,600401,45,158,902,1105,
Payne,State Treasurer,Charles De Coune,IND,600401,28,101,398,527,
Payne,Superintendent of Public Instruction,Joy Hofmeister,REP,600401,45,152,858,1055,
Payne,Superintendent of Public Instruction,John Cox,DEM,600401,36,107,424,567,
Payne,Superintendent of Public Instruction,Larry Huff,IND,600401,1,18,114,133,
Payne,Commissioner of Labor,Leslie Osborn,REP,600401,36,162,883,1081,
Payne,Commissioner of Labor,Fred Dorrell,DEM,600401,39,99,413,551,
Payne,Commissioner of Labor,Brandt Dismukes,IND,600401,2,12,67,81,
Payne,Insurance Commissioner,Glen Mulready,REP,600401,39,150,849,1038,
Payne,Insurance Commissioner,Kimberly Fobbs,DEM,600401,40,123,511,674,
Payne,Corporation Commissioner,Bob Anthony,REP,600401,42,151,838,1031,
Payne,Corporation Commissioner,Ashley Nicole Mccray,DEM,600401,33,109,446,588,
Payne,Corporation Commissioner,Jackie Short,IND,600401,4,14,83,101,
Payne,U.S. House,Frank Lucas,REP,600401,38,159,922,1119,3
Payne,U.S. House,Frankie Robbins,DEM,600401,42,118,475,635,3
Payne,Governor,Chris Powell,LIB,600402,0,2,16,18,
Payne,Governor,Kevin Stitt,REP,600402,17,57,316,390,
Payne,Governor,Drew Edmondson,DEM,600402,16,52,229,297,
Payne,Lieutenant Governor,Matt Pinnell,REP,600402,17,68,358,443,
Payne,Lieutenant Governor,Anastasia Pittman,DEM,600402,15,42,172,229,
Payne,Lieutenant Governor,Ivan Holmes,IND,600402,1,1,28,30,
Payne,State Auditor,John Yeutter,LIB,600402,3,26,126,155,
Payne,State Auditor,Cindy Byrd,REP,600402,26,75,397,498,
Payne,Attorney General,Mike Hunter,REP,600402,20,68,372,460,
Payne,Attorney General,Mark Myles,DEM,600402,13,42,182,237,
Payne,State Treasurer,Randy Mcdaniel,REP,600402,21,70,374,465,
Payne,State Treasurer,Charles De Coune,IND,600402,7,32,148,187,
Payne,Superintendent of Public Instruction,Joy Hofmeister,REP,600402,22,68,352,442,
Payne,Superintendent of Public Instruction,John Cox,DEM,600402,11,35,159,205,
Payne,Superintendent of Public Instruction,Larry Huff,IND,600402,0,8,43,51,
Payne,Commissioner of Labor,Leslie Osborn,REP,600402,20,72,367,459,
Payne,Commissioner of Labor,Fred Dorrell,DEM,600402,13,35,155,203,
Payne,Commissioner of Labor,Brandt Dismukes,IND,600402,0,3,25,28,
Payne,Insurance Commissioner,Glen Mulready,REP,600402,18,68,360,446,
Payne,Insurance Commissioner,Kimberly Fobbs,DEM,600402,15,42,190,247,
Payne,Corporation Commissioner,Bob Anthony,REP,600402,20,66,360,446,
Payne,Corporation Commissioner,Ashley Nicole Mccray,DEM,600402,11,39,163,213,
Payne,Corporation Commissioner,Jackie Short,IND,600402,2,5,27,34,
Payne,U.S. House,Frank Lucas,REP,600402,18,73,369,460,3
Payne,U.S. House,Frankie Robbins,DEM,600402,15,38,188,241,3
Payne,Governor,Chris Powell,LIB,600403,1,4,18,23,
Payne,Governor,Kevin Stitt,REP,600403,9,54,296,359,
Payne,Governor,Drew Edmondson,DEM,600403,14,29,210,253,
Payne,Lieutenant Governor,Matt Pinnell,REP,600403,12,61,358,431,
Payne,Lieutenant Governor,Anastasia Pittman,DEM,600403,11,25,146,182,
Payne,Lieutenant Governor,Ivan Holmes,IND,600403,0,3,15,18,
Payne,State Auditor,John Yeutter,LIB,600403,10,20,91,121,
Payne,State Auditor,Cindy Byrd,REP,600403,13,64,400,477,
Payne,Attorney General,Mike Hunter,REP,600403,11,62,360,433,
Payne,Attorney General,Mark Myles,DEM,600403,12,26,152,190,
Payne,State Treasurer,Randy Mcdaniel,REP,600403,11,58,376,445,
Payne,State Treasurer,Charles De Coune,IND,600403,11,27,118,156,
Payne,Superintendent of Public Instruction,Joy Hofmeister,REP,600403,13,65,335,413,
Payne,Superintendent of Public Instruction,John Cox,DEM,600403,8,21,136,165,
Payne,Superintendent of Public Instruction,Larry Huff,IND,600403,3,3,41,47,
Payne,Commissioner of Labor,Leslie Osborn,REP,600403,12,64,366,442,
Payne,Commissioner of Labor,Fred Dorrell,DEM,600403,9,21,119,149,
Payne,Commissioner of Labor,Brandt Dismukes,IND,600403,1,3,21,25,
Payne,Insurance Commissioner,Glen Mulready,REP,600403,12,59,346,417,
Payne,Insurance Commissioner,Kimberly Fobbs,DEM,600403,11,29,163,203,
Payne,Corporation Commissioner,Bob Anthony,REP,600403,12,61,332,405,
Payne,Corporation Commissioner,Ashley Nicole Mccray,DEM,600403,9,22,152,183,
Payne,Corporation Commissioner,Jackie Short,IND,600403,3,6,26,35,
Payne,U.S. House,Frank Lucas,REP,600403,14,66,376,456,3
Payne,U.S. House,Frankie Robbins,DEM,600403,10,23,139,172,3
Payne,State House,Ty Burns,REP,600403,11,59,348,418,35
Payne,State House,Jasha Lyons Echo-Hawk,DEM,600403,13,27,167,207,35
Payne,Governor,Chris Powell,LIB,600404,0,0,6,6,
Payne,Governor,Kevin Stitt,REP,600404,2,10,61,73,
Payne,Governor,Drew Edmondson,DEM,600404,6,12,39,57,
Payne,Lieutenant Governor,Matt Pinnell,REP,600404,3,11,67,81,
Payne,Lieutenant Governor,Anastasia Pittman,DEM,600404,5,10,28,43,
Payne,Lieutenant Governor,Ivan Holmes,IND,600404,0,1,9,10,
Payne,State Auditor,John Yeutter,LIB,600404,6,4,23,33,
Payne,State Auditor,Cindy Byrd,REP,600404,2,18,75,95,
Payne,Attorney General,Mike Hunter,REP,600404,2,16,73,91,
Payne,Attorney General,Mark Myles,DEM,600404,6,6,30,42,
Payne,State Treasurer,Randy Mcdaniel,REP,600404,4,19,73,96,
Payne,State Treasurer,Charles De Coune,IND,600404,4,3,26,33,
Payne,Superintendent of Public Instruction,Joy Hofmeister,REP,600404,2,15,64,81,
Payne,Superintendent of Public Instruction,John Cox,DEM,600404,6,5,26,37,
Payne,Superintendent of Public Instruction,Larry Huff,IND,600404,0,2,14,16,
Payne,Commissioner of Labor,Leslie Osborn,REP,600404,3,14,65,82,
Payne,Commissioner of Labor,Fred Dorrell,DEM,600404,5,8,26,39,
Payne,Commissioner of Labor,Brandt Dismukes,IND,600404,0,0,9,9,
Payne,Insurance Commissioner,Glen Mulready,REP,600404,3,13,66,82,
Payne,Insurance Commissioner,Kimberly Fobbs,DEM,600404,5,9,34,48,
Payne,Corporation Commissioner,Bob Anthony,REP,600404,3,13,69,85,
Payne,Corporation Commissioner,Ashley Nicole Mccray,DEM,600404,5,7,22,34,
Payne,Corporation Commissioner,Jackie Short,IND,600404,0,2,11,13,
Payne,U.S. House,Frank Lucas,REP,600404,3,16,81,100,3
Payne,U.S. House,Frankie Robbins,DEM,600404,5,6,23,34,3
Payne,State House,Aaron Means,REP,600404,2,9,65,76,34
Payne,State House,Trish Ranson,DEM,600404,6,13,38,57,34
Payne,Governor,Chris Powell,LIB,600405,2,5,34,41,
Payne,Governor,Kevin Stitt,REP,600405,27,81,483,591,
Payne,Governor,Drew Edmondson,DEM,600405,10,70,252,332,
Payne,Lieutenant Governor,Matt Pinnell,REP,600405,29,95,551,675,
Payne,Lieutenant Governor,Anastasia Pittman,DEM,600405,8,53,184,245,
Payne,Lieutenant Governor,Ivan Holmes,IND,600405,1,5,29,35,
Payne,State Auditor,John Yeutter,LIB,600405,4,30,150,184,
Payne,State Auditor,Cindy Byrd,REP,600405,33,115,588,736,
Payne,Attorney General,Mike Hunter,REP,600405,28,103,562,693,
Payne,Attorney General,Mark Myles,DEM,600405,10,51,199,260,
Payne,State Treasurer,Randy Mcdaniel,REP,600405,29,106,563,698,
Payne,State Treasurer,Charles De Coune,IND,600405,8,36,170,214,
Payne,Superintendent of Public Instruction,Joy Hofmeister,REP,600405,27,101,504,632,
Payne,Superintendent of Public Instruction,John Cox,DEM,600405,11,37,171,219,
Payne,Superintendent of Public Instruction,Larry Huff,IND,600405,0,16,93,109,
Payne,Commissioner of Labor,Leslie Osborn,REP,600405,30,102,543,675,
Payne,Commissioner of Labor,Fred Dorrell,DEM,600405,8,44,168,220,
Payne,Commissioner of Labor,Brandt Dismukes,IND,600405,0,4,44,48,
Payne,Insurance Commissioner,Glen Mulready,REP,600405,32,98,550,680,
Payne,Insurance Commissioner,Kimberly Fobbs,DEM,600405,5,51,209,265,
Payne,Corporation Commissioner,Bob Anthony,REP,600405,31,103,521,655,
Payne,Corporation Commissioner,Ashley Nicole Mccray,DEM,600405,5,42,176,223,
Payne,Corporation Commissioner,Jackie Short,IND,600405,2,9,65,76,
Payne,U.S. House,Frank Lucas,REP,600405,31,101,569,701,3
Payne,U.S. House,Frankie Robbins,DEM,600405,7,51,191,249,3
Payne,Governor,Chris Powell,LIB,600406,1,2,23,26,
Payne,Governor,Kevin Stitt,REP,600406,12,33,382,427,
Payne,Governor,Drew Edmondson,DEM,600406,14,8,168,190,
Payne,Lieutenant Governor,Matt Pinnell,REP,600406,16,34,432,482,
Payne,Lieutenant Governor,Anastasia Pittman,DEM,600406,9,8,121,138,
Payne,Lieutenant Governor,Ivan Holmes,IND,600406,1,2,16,19,
Payne,State Auditor,John Yeutter,LIB,600406,9,12,121,142,
Payne,State Auditor,Cindy Byrd,REP,600406,16,32,426,474,
Payne,Attorney General,Mike Hunter,REP,600406,17,36,425,478,
Payne,Attorney General,Mark Myles,DEM,600406,9,8,139,156,
Payne,State Treasurer,Randy Mcdaniel,REP,600406,16,36,437,489,
Payne,State Treasurer,Charles De Coune,IND,600406,8,8,111,127,
Payne,Superintendent of Public Instruction,Joy Hofmeister,REP,600406,11,27,365,403,
Payne,Superintendent of Public Instruction,John Cox,DEM,600406,14,11,139,164,
Payne,Superintendent of Public Instruction,Larry Huff,IND,600406,0,6,64,70,
Payne,Commissioner of Labor,Leslie Osborn,REP,600406,18,33,407,458,
Payne,Commissioner of Labor,Fred Dorrell,DEM,600406,8,6,127,141,
Payne,Commissioner of Labor,Brandt Dismukes,IND,600406,0,3,25,28,
Payne,Insurance Commissioner,Glen Mulready,REP,600406,17,35,411,463,
Payne,Insurance Commissioner,Kimberly Fobbs,DEM,600406,9,8,148,165,
Payne,Corporation Commissioner,Bob Anthony,REP,600406,16,34,399,449,
Payne,Corporation Commissioner,Ashley Nicole Mccray,DEM,600406,10,7,128,145,
Payne,Corporation Commissioner,Jackie Short,IND,600406,0,3,38,41,
Payne,U.S. House,Frank Lucas,REP,600406,18,37,436,491,3
Payne,U.S. House,Frankie Robbins,DEM,600406,8,6,129,143,3
Payne,State House,Ty Burns,REP,600406,18,31,430,479,35
Payne,State House,Jasha Lyons Echo-Hawk,DEM,600406,8,12,138,158,35
Payne,Governor,Chris Powell,LIB,600407,0,5,28,33,
Payne,Governor,Kevin Stitt,REP,600407,11,52,433,496,
Payne,Governor,Drew Edmondson,DEM,600407,12,49,245,306,
Payne,Lieutenant Governor,Matt Pinnell,REP,600407,13,62,503,578,
Payne,Lieutenant Governor,Anastasia Pittman,DEM,600407,10,41,170,221,
Payne,Lieutenant Governor,Ivan Holmes,IND,600407,0,4,28,32,
Payne,State Auditor,John Yeutter,LIB,600407,7,22,141,170,
Payne,State Auditor,Cindy Byrd,REP,600407,15,80,535,630,
Payne,Attorney General,Mike Hunter,REP,600407,14,64,519,597,
Payne,Attorney General,Mark Myles,DEM,600407,9,43,178,230,
Payne,State Treasurer,Randy Mcdaniel,REP,600407,13,69,514,596,
Payne,State Treasurer,Charles De Coune,IND,600407,8,35,159,202,
Payne,Superintendent of Public Instruction,Joy Hofmeister,REP,600407,12,67,466,545,
Payne,Superintendent of Public Instruction,John Cox,DEM,600407,9,36,169,214,
Payne,Superintendent of Public Instruction,Larry Huff,IND,600407,1,4,65,70,
Payne,Commissioner of Labor,Leslie Osborn,REP,600407,13,65,492,570,
Payne,Commissioner of Labor,Fred Dorrell,DEM,600407,6,36,159,201,
Payne,Commissioner of Labor,Brandt Dismukes,IND,600407,2,6,41,49,
Payne,Insurance Commissioner,Glen Mulready,REP,600407,14,65,503,582,
Payne,Insurance Commissioner,Kimberly Fobbs,DEM,600407,8,41,190,239,
Payne,Corporation Commissioner,Bob Anthony,REP,600407,13,67,468,548,
Payne,Corporation Commissioner,Ashley Nicole Mccray,DEM,600407,7,34,172,213,
Payne,Corporation Commissioner,Jackie Short,IND,600407,2,5,55,62,
Payne,U.S. House,Frank Lucas,REP,600407,14,68,525,607,3
Payne,U.S. House,Frankie Robbins,DEM,600407,8,38,177,223,3
Payne,Governor,Chris Powell,LIB,600408,1,2,12,15,
Payne,Governor,Kevin Stitt,REP,600408,0,13,118,131,
Payne,Governor,Drew Edmondson,DEM,600408,6,5,91,102,
Payne,Lieutenant Governor,Matt Pinnell,REP,600408,5,15,138,158,
Payne,Lieutenant Governor,Anastasia Pittman,DEM,600408,2,5,66,73,
Payne,Lieutenant Governor,Ivan Holmes,IND,600408,0,0,16,16,
Payne,State Auditor,John Yeutter,LIB,600408,3,3,44,50,
Payne,State Auditor,Cindy Byrd,REP,600408,3,16,167,186,
Payne,Attorney General,Mike Hunter,REP,600408,4,15,143,162,
Payne,Attorney General,Mark Myles,DEM,600408,3,5,77,85,
Payne,State Treasurer,Randy Mcdaniel,REP,600408,4,16,149,169,
Payne,State Treasurer,Charles De Coune,IND,600408,2,3,61,66,
Payne,Superintendent of Public Instruction,Joy Hofmeister,REP,600408,2,14,126,142,
Payne,Superintendent of Public Instruction,John Cox,DEM,600408,2,5,70,77,
Payne,Superintendent of Public Instruction,Larry Huff,IND,600408,3,1,25,29,
Payne,Commissioner of Labor,Leslie Osborn,REP,600408,3,13,146,162,
Payne,Commissioner of Labor,Fred Dorrell,DEM,600408,1,5,60,66,
Payne,Commissioner of Labor,Brandt Dismukes,IND,600408,3,2,11,16,
Payne,Insurance Commissioner,Glen Mulready,REP,600408,4,15,146,165,
Payne,Insurance Commissioner,Kimberly Fobbs,DEM,600408,3,5,72,80,
Payne,Corporation Commissioner,Bob Anthony,REP,600408,4,14,139,157,
Payne,Corporation Commissioner,Ashley Nicole Mccray,DEM,600408,2,5,68,75,
Payne,Corporation Commissioner,Jackie Short,IND,600408,1,1,13,15,
Payne,U.S. House,Frank Lucas,REP,600408,6,16,157,179,3
Payne,U.S. House,Frankie Robbins,DEM,600408,1,4,63,68,3
Payne,Governor,Chris Powell,LIB,600409,0,2,38,40,
Payne,Governor,Kevin Stitt,REP,600409,13,38,389,440,
Payne,Governor,Drew Edmondson,DEM,600409,4,26,204,234,
Payne,Lieutenant Governor,Matt Pinnell,REP,600409,13,45,435,493,
Payne,Lieutenant Governor,Anastasia Pittman,DEM,600409,4,20,148,172,
Payne,Lieutenant Governor,Ivan Holmes,IND,600409,0,1,40,41,
Payne,State Auditor,John Yeutter,LIB,600409,6,12,116,134,
Payne,State Auditor,Cindy Byrd,REP,600409,10,48,484,542,
Payne,Attorney General,Mike Hunter,REP,600409,13,46,458,517,
Payne,Attorney General,Mark Myles,DEM,600409,4,20,161,185,
Payne,State Treasurer,Randy Mcdaniel,REP,600409,12,47,462,521,
Payne,State Treasurer,Charles De Coune,IND,600409,4,12,138,154,
Payne,Superintendent of Public Instruction,Joy Hofmeister,REP,600409,10,39,391,440,
Payne,Superintendent of Public Instruction,John Cox,DEM,600409,6,18,154,178,
Payne,Superintendent of Public Instruction,Larry Huff,IND,600409,1,9,81,91,
Payne,Commissioner of Labor,Leslie Osborn,REP,600409,11,43,440,494,
Payne,Commissioner of Labor,Fred Dorrell,DEM,600409,5,17,138,160,
Payne,Commissioner of Labor,Brandt Dismukes,IND,600409,1,6,42,49,
Payne,Insurance Commissioner,Glen Mulready,REP,600409,13,42,446,501,
Payne,Insurance Commissioner,Kimberly Fobbs,DEM,600409,4,24,165,193,
Payne,Corporation Commissioner,Bob Anthony,REP,600409,13,39,431,483,
Payne,Corporation Commissioner,Ashley Nicole Mccray,DEM,600409,4,19,142,165,
Payne,Corporation Commissioner,Jackie Short,IND,600409,0,8,51,59,
Payne,U.S. House,Frank Lucas,REP,600409,13,48,466,527,3
Payne,U.S. House,Frankie Robbins,DEM,600409,4,18,158,180,3
Pittsburg,Governor,Chris Powell,LIB,610001,0,0,3,3,
Pittsburg,Governor,Kevin Stitt,REP,610001,0,0,17,17,
Pittsburg,Governor,Drew Edmondson,DEM,610001,1,3,38,42,
Pittsburg,Lieutenant Governor,Matt Pinnell,REP,610001,0,0,21,21,
Pittsburg,Lieutenant Governor,Anastasia Pittman,DEM,610001,1,2,32,35,
Pittsburg,Lieutenant Governor,Ivan Holmes,IND,610001,0,1,5,6,
Pittsburg,State Auditor,John Yeutter,LIB,610001,0,3,22,25,
Pittsburg,State Auditor,Cindy Byrd,REP,610001,0,0,30,30,
Pittsburg,Attorney General,Mike Hunter,REP,610001,0,0,24,24,
Pittsburg,Attorney General,Mark Myles,DEM,610001,1,3,32,36,
Pittsburg,State Treasurer,Randy Mcdaniel,REP,610001,0,0,22,22,
Pittsburg,State Treasurer,Charles De Coune,IND,610001,0,3,29,32,
Pittsburg,Superintendent of Public Instruction,Joy Hofmeister,REP,610001,0,0,20,20,
Pittsburg,Superintendent of Public Instruction,John Cox,DEM,610001,1,3,30,34,
Pittsburg,Superintendent of Public Instruction,Larry Huff,IND,610001,0,0,6,6,
Pittsburg,Commissioner of Labor,Leslie Osborn,REP,610001,0,1,18,19,
Pittsburg,Commissioner of Labor,Fred Dorrell,DEM,610001,1,2,33,36,
Pittsburg,Commissioner of Labor,Brandt Dismukes,IND,610001,0,0,6,6,
Pittsburg,Insurance Commissioner,Glen Mulready,REP,610001,0,1,22,23,
Pittsburg,Insurance Commissioner,Kimberly Fobbs,DEM,610001,1,2,35,38,
Pittsburg,Corporation Commissioner,Bob Anthony,REP,610001,0,0,18,18,
Pittsburg,Corporation Commissioner,Ashley Nicole Mccray,DEM,610001,1,3,33,37,
Pittsburg,Corporation Commissioner,Jackie Short,IND,610001,0,0,7,7,
Pittsburg,U.S. House,Richard Castaldo,LIB,610001,0,0,0,0,2
Pittsburg,U.S. House,Markwayne Mullin,REP,610001,0,0,21,21,2
Pittsburg,U.S. House,Jason Nichols,DEM,610001,1,2,31,34,2
Pittsburg,U.S. House,John Foreman,IND,610001,0,1,5,6,2
Pittsburg,State House,Jim Grego,REP,610001,0,1,17,18,17
Pittsburg,State House,Peggy Defrange,DEM,610001,1,2,40,43,17
Pittsburg,Governor,Chris Powell,LIB,610003,1,1,18,20,
Pittsburg,Governor,Kevin Stitt,REP,610003,7,33,203,243,
Pittsburg,Governor,Drew Edmondson,DEM,610003,12,27,162,201,
Pittsburg,Lieutenant Governor,Matt Pinnell,REP,610003,7,35,216,258,
Pittsburg,Lieutenant Governor,Anastasia Pittman,DEM,610003,10,23,148,181,
Pittsburg,Lieutenant Governor,Ivan Holmes,IND,610003,3,3,16,22,
Pittsburg,State Auditor,John Yeutter,LIB,610003,6,14,86,106,
Pittsburg,State Auditor,Cindy Byrd,REP,610003,12,42,262,316,
Pittsburg,Attorney General,Mike Hunter,REP,610003,7,35,229,271,
Pittsburg,Attorney General,Mark Myles,DEM,610003,13,26,151,190,
Pittsburg,State Treasurer,Randy Mcdaniel,REP,610003,8,38,253,299,
Pittsburg,State Treasurer,Charles De Coune,IND,610003,9,17,99,125,
Pittsburg,Superintendent of Public Instruction,Joy Hofmeister,REP,610003,7,25,206,238,
Pittsburg,Superintendent of Public Instruction,John Cox,DEM,610003,11,30,140,181,
Pittsburg,Superintendent of Public Instruction,Larry Huff,IND,610003,2,5,34,41,
Pittsburg,Commissioner of Labor,Leslie Osborn,REP,610003,8,35,218,261,
Pittsburg,Commissioner of Labor,Fred Dorrell,DEM,610003,10,25,133,168,
Pittsburg,Commissioner of Labor,Brandt Dismukes,IND,610003,2,1,27,30,
Pittsburg,Insurance Commissioner,Glen Mulready,REP,610003,6,33,225,264,
Pittsburg,Insurance Commissioner,Kimberly Fobbs,DEM,610003,14,28,153,195,
Pittsburg,Corporation Commissioner,Bob Anthony,REP,610003,6,28,213,247,
Pittsburg,Corporation Commissioner,Ashley Nicole Mccray,DEM,610003,12,29,143,184,
Pittsburg,Corporation Commissioner,Jackie Short,IND,610003,2,4,23,29,
Pittsburg,U.S. House,Richard Castaldo,LIB,610003,1,1,9,11,2
Pittsburg,U.S. House,Markwayne Mullin,REP,610003,8,33,233,274,2
Pittsburg,U.S. House,Jason Nichols,DEM,610003,10,27,119,156,2
Pittsburg,U.S. House,John Foreman,IND,610003,1,0,20,21,2
Pittsburg,State House,Jim Grego,REP,610003,6,27,205,238,17
Pittsburg,State House,Peggy Defrange,DEM,610003,14,33,174,221,17
Pittsburg,Governor,Chris Powell,LIB,610004,0,1,23,24,
Pittsburg,Governor,Kevin Stitt,REP,610004,5,52,356,413,
Pittsburg,Governor,Drew Edmondson,DEM,610004,9,47,266,322,
Pittsburg,Lieutenant Governor,Matt Pinnell,REP,610004,5,60,408,473,
Pittsburg,Lieutenant Governor,Anastasia Pittman,DEM,610004,9,39,212,260,
Pittsburg,Lieutenant Governor,Ivan Holmes,IND,610004,0,0,23,23,
Pittsburg,State Auditor,John Yeutter,LIB,610004,3,23,138,164,
Pittsburg,State Auditor,Cindy Byrd,REP,610004,8,68,457,533,
Pittsburg,Attorney General,Mike Hunter,REP,610004,4,58,439,501,
Pittsburg,Attorney General,Mark Myles,DEM,610004,10,42,204,256,
Pittsburg,State Treasurer,Randy Mcdaniel,REP,610004,6,69,442,517,
Pittsburg,State Treasurer,Charles De Coune,IND,610004,5,21,151,177,
Pittsburg,Superintendent of Public Instruction,Joy Hofmeister,REP,610004,2,55,378,435,
Pittsburg,Superintendent of Public Instruction,John Cox,DEM,610004,11,42,221,274,
Pittsburg,Superintendent of Public Instruction,Larry Huff,IND,610004,1,2,44,47,
Pittsburg,Commissioner of Labor,Leslie Osborn,REP,610004,3,52,395,450,
Pittsburg,Commissioner of Labor,Fred Dorrell,DEM,610004,10,42,210,262,
Pittsburg,Commissioner of Labor,Brandt Dismukes,IND,610004,1,4,33,38,
Pittsburg,Insurance Commissioner,Glen Mulready,REP,610004,5,51,410,466,
Pittsburg,Insurance Commissioner,Kimberly Fobbs,DEM,610004,9,46,223,278,
Pittsburg,Corporation Commissioner,Bob Anthony,REP,610004,4,56,385,445,
Pittsburg,Corporation Commissioner,Ashley Nicole Mccray,DEM,610004,10,41,212,263,
Pittsburg,Corporation Commissioner,Jackie Short,IND,610004,0,1,41,42,
Pittsburg,U.S. House,Richard Castaldo,LIB,610004,0,3,11,14,2
Pittsburg,U.S. House,Markwayne Mullin,REP,610004,5,57,422,484,2
Pittsburg,U.S. House,Jason Nichols,DEM,610004,9,38,198,245,2
Pittsburg,U.S. House,John Foreman,IND,610004,0,1,12,13,2
Pittsburg,State House,David Smith,REP,610004,4,38,300,342,18
Pittsburg,State House,Donnie Condit,DEM,610004,10,61,341,412,18
Pittsburg,Governor,Chris Powell,LIB,610005,0,0,18,18,
Pittsburg,Governor,Kevin Stitt,REP,610005,3,17,159,179,
Pittsburg,Governor,Drew Edmondson,DEM,610005,7,24,128,159,
Pittsburg,Lieutenant Governor,Matt Pinnell,REP,610005,4,21,192,217,
Pittsburg,Lieutenant Governor,Anastasia Pittman,DEM,610005,6,19,97,122,
Pittsburg,Lieutenant Governor,Ivan Holmes,IND,610005,0,1,15,16,
Pittsburg,State Auditor,John Yeutter,LIB,610005,3,13,63,79,
Pittsburg,State Auditor,Cindy Byrd,REP,610005,4,26,203,233,
Pittsburg,Attorney General,Mike Hunter,REP,610005,3,20,199,222,
Pittsburg,Attorney General,Mark Myles,DEM,610005,7,21,104,132,
Pittsburg,State Treasurer,Randy Mcdaniel,REP,610005,4,22,202,228,
Pittsburg,State Treasurer,Charles De Coune,IND,610005,3,16,71,90,
Pittsburg,Superintendent of Public Instruction,Joy Hofmeister,REP,610005,4,21,164,189,
Pittsburg,Superintendent of Public Instruction,John Cox,DEM,610005,5,19,113,137,
Pittsburg,Superintendent of Public Instruction,Larry Huff,IND,610005,1,1,27,29,
Pittsburg,Commissioner of Labor,Leslie Osborn,REP,610005,3,25,172,200,
Pittsburg,Commissioner of Labor,Fred Dorrell,DEM,610005,7,16,102,125,
Pittsburg,Commissioner of Labor,Brandt Dismukes,IND,610005,0,0,27,27,
Pittsburg,Insurance Commissioner,Glen Mulready,REP,610005,3,20,182,205,
Pittsburg,Insurance Commissioner,Kimberly Fobbs,DEM,610005,7,21,122,150,
Pittsburg,Corporation Commissioner,Bob Anthony,REP,610005,4,20,176,200,
Pittsburg,Corporation Commissioner,Ashley Nicole Mccray,DEM,610005,4,19,101,124,
Pittsburg,Corporation Commissioner,Jackie Short,IND,610005,2,2,26,30,
Pittsburg,U.S. House,Richard Castaldo,LIB,610005,0,2,8,10,2
Pittsburg,U.S. House,Markwayne Mullin,REP,610005,3,18,183,204,2
Pittsburg,U.S. House,Jason Nichols,DEM,610005,6,19,100,125,2
Pittsburg,U.S. House,John Foreman,IND,610005,1,2,14,17,2
Pittsburg,State House,David Smith,REP,610005,2,15,137,154,18
Pittsburg,State House,Donnie Condit,DEM,610005,8,26,165,199,18
Pittsburg,Governor,Chris Powell,LIB,610006,0,1,14,15,
Pittsburg,Governor,Kevin Stitt,REP,610006,4,23,197,224,
Pittsburg,Governor,Drew Edmondson,DEM,610006,7,18,145,170,
Pittsburg,Lieutenant Governor,Matt Pinnell,REP,610006,5,25,240,270,
Pittsburg,Lieutenant Governor,Anastasia Pittman,DEM,610006,6,16,103,125,
Pittsburg,Lieutenant Governor,Ivan Holmes,IND,610006,0,1,12,13,
Pittsburg,State Auditor,John Yeutter,LIB,610006,2,2,60,64,
Pittsburg,State Auditor,Cindy Byrd,REP,610006,6,36,273,315,
Pittsburg,Attorney General,Mike Hunter,REP,610006,5,30,244,279,
Pittsburg,Attorney General,Mark Myles,DEM,610006,6,12,104,122,
Pittsburg,State Treasurer,Randy Mcdaniel,REP,610006,5,32,253,290,
Pittsburg,State Treasurer,Charles De Coune,IND,610006,3,6,82,91,
Pittsburg,Superintendent of Public Instruction,Joy Hofmeister,REP,610006,6,30,215,251,
Pittsburg,Superintendent of Public Instruction,John Cox,DEM,610006,5,11,116,132,
Pittsburg,Superintendent of Public Instruction,Larry Huff,IND,610006,0,1,18,19,
Pittsburg,Commissioner of Labor,Leslie Osborn,REP,610006,6,27,226,259,
Pittsburg,Commissioner of Labor,Fred Dorrell,DEM,610006,5,13,104,122,
Pittsburg,Commissioner of Labor,Brandt Dismukes,IND,610006,0,2,20,22,
Pittsburg,Insurance Commissioner,Glen Mulready,REP,610006,5,28,232,265,
Pittsburg,Insurance Commissioner,Kimberly Fobbs,DEM,610006,6,14,114,134,
Pittsburg,Corporation Commissioner,Bob Anthony,REP,610006,4,24,225,253,
Pittsburg,Corporation Commissioner,Ashley Nicole Mccray,DEM,610006,6,14,100,120,
Pittsburg,Corporation Commissioner,Jackie Short,IND,610006,1,3,26,30,
Pittsburg,U.S. House,Richard Castaldo,LIB,610006,0,1,10,11,2
Pittsburg,U.S. House,Markwayne Mullin,REP,610006,4,25,226,255,2
Pittsburg,U.S. House,Jason Nichols,DEM,610006,6,15,107,128,2
Pittsburg,U.S. House,John Foreman,IND,610006,1,1,13,15,2
Pittsburg,State House,David Smith,REP,610006,3,18,150,171,18
Pittsburg,State House,Donnie Condit,DEM,610006,8,24,207,239,18
Pittsburg,Governor,Chris Powell,LIB,610007,0,0,14,14,
Pittsburg,Governor,Kevin Stitt,REP,610007,10,22,204,236,
Pittsburg,Governor,Drew Edmondson,DEM,610007,6,20,144,170,
Pittsburg,Lieutenant Governor,Matt Pinnell,REP,610007,9,25,238,272,
Pittsburg,Lieutenant Governor,Anastasia Pittman,DEM,610007,7,15,102,124,
Pittsburg,Lieutenant Governor,Ivan Holmes,IND,610007,0,2,19,21,
Pittsburg,State Auditor,John Yeutter,LIB,610007,5,8,72,85,
Pittsburg,State Auditor,Cindy Byrd,REP,610007,9,29,267,305,
Pittsburg,Attorney General,Mike Hunter,REP,610007,11,24,242,277,
Pittsburg,Attorney General,Mark Myles,DEM,610007,5,18,114,137,
Pittsburg,State Treasurer,Randy Mcdaniel,REP,610007,12,27,251,290,
Pittsburg,State Treasurer,Charles De Coune,IND,610007,2,9,88,99,
Pittsburg,Superintendent of Public Instruction,Joy Hofmeister,REP,610007,9,23,218,250,
Pittsburg,Superintendent of Public Instruction,John Cox,DEM,610007,7,16,120,143,
Pittsburg,Superintendent of Public Instruction,Larry Huff,IND,610007,0,3,19,22,
Pittsburg,Commissioner of Labor,Leslie Osborn,REP,610007,10,24,223,257,
Pittsburg,Commissioner of Labor,Fred Dorrell,DEM,610007,6,16,117,139,
Pittsburg,Commissioner of Labor,Brandt Dismukes,IND,610007,0,2,15,17,
Pittsburg,Insurance Commissioner,Glen Mulready,REP,610007,12,25,233,270,
Pittsburg,Insurance Commissioner,Kimberly Fobbs,DEM,610007,4,17,117,138,
Pittsburg,Corporation Commissioner,Bob Anthony,REP,610007,12,23,225,260,
Pittsburg,Corporation Commissioner,Ashley Nicole Mccray,DEM,610007,4,18,105,127,
Pittsburg,Corporation Commissioner,Jackie Short,IND,610007,0,1,25,26,
Pittsburg,U.S. House,Richard Castaldo,LIB,610007,0,0,5,5,2
Pittsburg,U.S. House,Markwayne Mullin,REP,610007,11,25,235,271,2
Pittsburg,U.S. House,Jason Nichols,DEM,610007,5,15,106,126,2
Pittsburg,U.S. House,John Foreman,IND,610007,0,1,12,13,2
Pittsburg,State House,Jim Grego,REP,610007,8,25,194,227,17
Pittsburg,State House,Peggy Defrange,DEM,610007,8,17,166,191,17
Pittsburg,Governor,Chris Powell,LIB,610008,0,1,13,14,
Pittsburg,Governor,Kevin Stitt,REP,610008,3,9,149,161,
Pittsburg,Governor,Drew Edmondson,DEM,610008,1,13,115,129,
Pittsburg,Lieutenant Governor,Matt Pinnell,REP,610008,3,9,148,160,
Pittsburg,Lieutenant Governor,Anastasia Pittman,DEM,610008,1,12,112,125,
Pittsburg,Lieutenant Governor,Ivan Holmes,IND,610008,0,2,16,18,
Pittsburg,State Auditor,John Yeutter,LIB,610008,1,12,86,99,
Pittsburg,State Auditor,Cindy Byrd,REP,610008,3,11,167,181,
Pittsburg,Attorney General,Mike Hunter,REP,610008,3,10,159,172,
Pittsburg,Attorney General,Mark Myles,DEM,610008,1,13,118,132,
Pittsburg,State Treasurer,Randy Mcdaniel,REP,610008,1,6,178,185,
Pittsburg,State Treasurer,Charles De Coune,IND,610008,3,17,75,95,
Pittsburg,Superintendent of Public Instruction,Joy Hofmeister,REP,610008,3,4,137,144,
Pittsburg,Superintendent of Public Instruction,John Cox,DEM,610008,1,14,110,125,
Pittsburg,Superintendent of Public Instruction,Larry Huff,IND,610008,0,5,29,34,
Pittsburg,Commissioner of Labor,Leslie Osborn,REP,610008,3,9,144,156,
Pittsburg,Commissioner of Labor,Fred Dorrell,DEM,610008,1,11,106,118,
Pittsburg,Commissioner of Labor,Brandt Dismukes,IND,610008,0,3,25,28,
Pittsburg,Insurance Commissioner,Glen Mulready,REP,610008,3,10,145,158,
Pittsburg,Insurance Commissioner,Kimberly Fobbs,DEM,610008,1,13,130,144,
Pittsburg,Corporation Commissioner,Bob Anthony,REP,610008,3,6,148,157,
Pittsburg,Corporation Commissioner,Ashley Nicole Mccray,DEM,610008,1,16,97,114,
Pittsburg,Corporation Commissioner,Jackie Short,IND,610008,0,1,28,29,
Pittsburg,U.S. House,Richard Castaldo,LIB,610008,0,2,1,3,2
Pittsburg,U.S. House,Markwayne Mullin,REP,610008,3,8,161,172,2
Pittsburg,U.S. House,Jason Nichols,DEM,610008,1,13,99,113,2
Pittsburg,U.S. House,John Foreman,IND,610008,0,0,15,15,2
Pittsburg,State House,David Smith,REP,610008,2,7,126,135,18
Pittsburg,State House,Donnie Condit,DEM,610008,2,16,148,166,18
Pittsburg,Governor,Chris Powell,LIB,610011,0,0,31,31,
Pittsburg,Governor,Kevin Stitt,REP,610011,17,36,296,349,
Pittsburg,Governor,Drew Edmondson,DEM,610011,8,31,240,279,
Pittsburg,Lieutenant Governor,Matt Pinnell,REP,610011,17,37,348,402,
Pittsburg,Lieutenant Governor,Anastasia Pittman,DEM,610011,8,29,190,227,
Pittsburg,Lieutenant Governor,Ivan Holmes,IND,610011,0,1,27,28,
Pittsburg,State Auditor,John Yeutter,LIB,610011,4,20,132,156,
Pittsburg,State Auditor,Cindy Byrd,REP,610011,18,43,389,450,
Pittsburg,Attorney General,Mike Hunter,REP,610011,18,42,359,419,
Pittsburg,Attorney General,Mark Myles,DEM,610011,7,24,203,234,
Pittsburg,State Treasurer,Randy Mcdaniel,REP,610011,17,41,374,432,
Pittsburg,State Treasurer,Charles De Coune,IND,610011,5,22,151,178,
Pittsburg,Superintendent of Public Instruction,Joy Hofmeister,REP,610011,17,31,316,364,
Pittsburg,Superintendent of Public Instruction,John Cox,DEM,610011,7,34,194,235,
Pittsburg,Superintendent of Public Instruction,Larry Huff,IND,610011,1,2,54,57,
Pittsburg,Commissioner of Labor,Leslie Osborn,REP,610011,17,36,335,388,
Pittsburg,Commissioner of Labor,Fred Dorrell,DEM,610011,8,28,191,227,
Pittsburg,Commissioner of Labor,Brandt Dismukes,IND,610011,0,3,35,38,
Pittsburg,Insurance Commissioner,Glen Mulready,REP,610011,18,36,351,405,
Pittsburg,Insurance Commissioner,Kimberly Fobbs,DEM,610011,7,31,208,246,
Pittsburg,Corporation Commissioner,Bob Anthony,REP,610011,18,38,326,382,
Pittsburg,Corporation Commissioner,Ashley Nicole Mccray,DEM,610011,7,25,203,235,
Pittsburg,Corporation Commissioner,Jackie Short,IND,610011,0,3,32,35,
Pittsburg,U.S. House,Richard Castaldo,LIB,610011,1,0,17,18,2
Pittsburg,U.S. House,Markwayne Mullin,REP,610011,16,41,346,403,2
Pittsburg,U.S. House,Jason Nichols,DEM,610011,8,25,187,220,2
Pittsburg,U.S. House,John Foreman,IND,610011,0,1,16,17,2
Pittsburg,State House,David Smith,REP,610011,14,26,258,298,18
Pittsburg,State House,Donnie Condit,DEM,610011,11,41,308,360,18
Pittsburg,Governor,Chris Powell,LIB,610014,0,2,18,20,
Pittsburg,Governor,Kevin Stitt,REP,610014,10,33,313,356,
Pittsburg,Governor,Drew Edmondson,DEM,610014,11,38,225,274,
Pittsburg,Lieutenant Governor,Matt Pinnell,REP,610014,11,40,346,397,
Pittsburg,Lieutenant Governor,Anastasia Pittman,DEM,610014,10,30,182,222,
Pittsburg,Lieutenant Governor,Ivan Holmes,IND,610014,0,1,23,24,
Pittsburg,State Auditor,John Yeutter,LIB,610014,3,18,132,153,
Pittsburg,State Auditor,Cindy Byrd,REP,610014,13,51,379,443,
Pittsburg,Attorney General,Mike Hunter,REP,610014,11,38,361,410,
Pittsburg,Attorney General,Mark Myles,DEM,610014,10,34,189,233,
Pittsburg,State Treasurer,Randy Mcdaniel,REP,610014,11,43,370,424,
Pittsburg,State Treasurer,Charles De Coune,IND,610014,5,26,141,172,
Pittsburg,Superintendent of Public Instruction,Joy Hofmeister,REP,610014,10,33,298,341,
Pittsburg,Superintendent of Public Instruction,John Cox,DEM,610014,11,34,216,261,
Pittsburg,Superintendent of Public Instruction,Larry Huff,IND,610014,0,4,41,45,
Pittsburg,Commissioner of Labor,Leslie Osborn,REP,610014,10,35,313,358,
Pittsburg,Commissioner of Labor,Fred Dorrell,DEM,610014,11,32,197,240,
Pittsburg,Commissioner of Labor,Brandt Dismukes,IND,610014,0,4,38,42,
Pittsburg,Insurance Commissioner,Glen Mulready,REP,610014,10,38,345,393,
Pittsburg,Insurance Commissioner,Kimberly Fobbs,DEM,610014,11,33,203,247,
Pittsburg,Corporation Commissioner,Bob Anthony,REP,610014,10,36,329,375,
Pittsburg,Corporation Commissioner,Ashley Nicole Mccray,DEM,610014,11,29,193,233,
Pittsburg,Corporation Commissioner,Jackie Short,IND,610014,0,6,29,35,
Pittsburg,U.S. House,Richard Castaldo,LIB,610014,0,1,10,11,2
Pittsburg,U.S. House,Markwayne Mullin,REP,610014,10,37,359,406,2
Pittsburg,U.S. House,Jason Nichols,DEM,610014,11,31,164,206,2
Pittsburg,U.S. House,John Foreman,IND,610014,0,2,22,24,2
Pittsburg,State House,Jim Grego,REP,610014,10,29,293,332,17
Pittsburg,State House,Peggy Defrange,DEM,610014,11,44,261,316,17
Pittsburg,Governor,Chris Powell,LIB,610015,0,0,6,6,
Pittsburg,Governor,Kevin Stitt,REP,610015,0,5,37,42,
Pittsburg,Governor,Drew Edmondson,DEM,610015,3,9,60,72,
Pittsburg,Lieutenant Governor,Matt Pinnell,REP,610015,0,5,38,43,
Pittsburg,Lieutenant Governor,Anastasia Pittman,DEM,610015,3,9,54,66,
Pittsburg,Lieutenant Governor,Ivan Holmes,IND,610015,0,0,9,9,
Pittsburg,State Auditor,John Yeutter,LIB,610015,2,2,35,39,
Pittsburg,State Auditor,Cindy Byrd,REP,610015,0,10,49,59,
Pittsburg,Attorney General,Mike Hunter,REP,610015,0,6,45,51,
Pittsburg,Attorney General,Mark Myles,DEM,610015,3,8,57,68,
Pittsburg,State Treasurer,Randy Mcdaniel,REP,610015,0,5,48,53,
Pittsburg,State Treasurer,Charles De Coune,IND,610015,2,8,38,48,
Pittsburg,Superintendent of Public Instruction,Joy Hofmeister,REP,610015,0,6,36,42,
Pittsburg,Superintendent of Public Instruction,John Cox,DEM,610015,3,8,60,71,
Pittsburg,Superintendent of Public Instruction,Larry Huff,IND,610015,0,0,5,5,
Pittsburg,Commissioner of Labor,Leslie Osborn,REP,610015,0,4,39,43,
Pittsburg,Commissioner of Labor,Fred Dorrell,DEM,610015,3,9,53,65,
Pittsburg,Commissioner of Labor,Brandt Dismukes,IND,610015,0,1,10,11,
Pittsburg,Insurance Commissioner,Glen Mulready,REP,610015,0,5,42,47,
Pittsburg,Insurance Commissioner,Kimberly Fobbs,DEM,610015,3,9,59,71,
Pittsburg,Corporation Commissioner,Bob Anthony,REP,610015,0,4,38,42,
Pittsburg,Corporation Commissioner,Ashley Nicole Mccray,DEM,610015,3,9,56,68,
Pittsburg,Corporation Commissioner,Jackie Short,IND,610015,0,1,7,8,
Pittsburg,U.S. House,Richard Castaldo,LIB,610015,0,0,1,1,2
Pittsburg,U.S. House,Markwayne Mullin,REP,610015,0,5,43,48,2
Pittsburg,U.S. House,Jason Nichols,DEM,610015,3,9,54,66,2
Pittsburg,U.S. House,John Foreman,IND,610015,0,0,5,5,2
Pittsburg,State House,David Smith,REP,610015,0,5,31,36,18
Pittsburg,State House,Donnie Condit,DEM,610015,3,9,72,84,18
Pittsburg,Governor,Chris Powell,LIB,610019,0,0,6,6,
Pittsburg,Governor,Kevin Stitt,REP,610019,4,10,106,120,
Pittsburg,Governor,Drew Edmondson,DEM,610019,1,3,56,60,
Pittsburg,Lieutenant Governor,Matt Pinnell,REP,610019,4,10,103,117,
Pittsburg,Lieutenant Governor,Anastasia Pittman,DEM,610019,1,3,54,58,
Pittsburg,Lieutenant Governor,Ivan Holmes,IND,610019,0,0,9,9,
Pittsburg,State Auditor,John Yeutter,LIB,610019,0,1,35,36,
Pittsburg,State Auditor,Cindy Byrd,REP,610019,5,12,121,138,
Pittsburg,Attorney General,Mike Hunter,REP,610019,4,10,113,127,
Pittsburg,Attorney General,Mark Myles,DEM,610019,1,3,54,58,
Pittsburg,State Treasurer,Randy Mcdaniel,REP,610019,5,9,115,129,
Pittsburg,State Treasurer,Charles De Coune,IND,610019,0,4,41,45,
Pittsburg,Superintendent of Public Instruction,Joy Hofmeister,REP,610019,5,7,97,109,
Pittsburg,Superintendent of Public Instruction,John Cox,DEM,610019,0,5,56,61,
Pittsburg,Superintendent of Public Instruction,Larry Huff,IND,610019,0,1,14,15,
Pittsburg,Commissioner of Labor,Leslie Osborn,REP,610019,4,10,101,115,
Pittsburg,Commissioner of Labor,Fred Dorrell,DEM,610019,1,3,58,62,
Pittsburg,Commissioner of Labor,Brandt Dismukes,IND,610019,0,0,8,8,
Pittsburg,Insurance Commissioner,Glen Mulready,REP,610019,4,10,113,127,
Pittsburg,Insurance Commissioner,Kimberly Fobbs,DEM,610019,1,3,54,58,
Pittsburg,Corporation Commissioner,Bob Anthony,REP,610019,4,11,110,125,
Pittsburg,Corporation Commissioner,Ashley Nicole Mccray,DEM,610019,1,2,43,46,
Pittsburg,Corporation Commissioner,Jackie Short,IND,610019,0,0,12,12,
Pittsburg,U.S. House,Richard Castaldo,LIB,610019,0,0,3,3,2
Pittsburg,U.S. House,Markwayne Mullin,REP,610019,4,10,113,127,2
Pittsburg,U.S. House,Jason Nichols,DEM,610019,1,4,48,53,2
Pittsburg,U.S. House,John Foreman,IND,610019,0,0,4,4,2
Pittsburg,State House,Jim Grego,REP,610019,4,11,107,122,17
Pittsburg,State House,Peggy Defrange,DEM,610019,1,3,61,65,17
Pittsburg,Governor,Chris Powell,LIB,610020,0,0,1,1,
Pittsburg,Governor,Kevin Stitt,REP,610020,2,5,51,58,
Pittsburg,Governor,Drew Edmondson,DEM,610020,0,4,15,19,
Pittsburg,Lieutenant Governor,Matt Pinnell,REP,610020,2,8,45,55,
Pittsburg,Lieutenant Governor,Anastasia Pittman,DEM,610020,0,1,17,18,
Pittsburg,Lieutenant Governor,Ivan Holmes,IND,610020,0,1,5,6,
Pittsburg,State Auditor,John Yeutter,LIB,610020,0,2,9,11,
Pittsburg,State Auditor,Cindy Byrd,REP,610020,2,8,55,65,
Pittsburg,Attorney General,Mike Hunter,REP,610020,2,8,53,63,
Pittsburg,Attorney General,Mark Myles,DEM,610020,0,2,14,16,
Pittsburg,State Treasurer,Randy Mcdaniel,REP,610020,2,7,55,64,
Pittsburg,State Treasurer,Charles De Coune,IND,610020,0,2,9,11,
Pittsburg,Superintendent of Public Instruction,Joy Hofmeister,REP,610020,2,5,47,54,
Pittsburg,Superintendent of Public Instruction,John Cox,DEM,610020,0,4,15,19,
Pittsburg,Superintendent of Public Instruction,Larry Huff,IND,610020,0,0,5,5,
Pittsburg,Commissioner of Labor,Leslie Osborn,REP,610020,2,8,46,56,
Pittsburg,Commissioner of Labor,Fred Dorrell,DEM,610020,0,2,16,18,
Pittsburg,Commissioner of Labor,Brandt Dismukes,IND,610020,0,0,4,4,
Pittsburg,Insurance Commissioner,Glen Mulready,REP,610020,2,7,50,59,
Pittsburg,Insurance Commissioner,Kimberly Fobbs,DEM,610020,0,3,16,19,
Pittsburg,Corporation Commissioner,Bob Anthony,REP,610020,2,6,46,54,
Pittsburg,Corporation Commissioner,Ashley Nicole Mccray,DEM,610020,0,3,16,19,
Pittsburg,Corporation Commissioner,Jackie Short,IND,610020,0,1,5,6,
Pittsburg,U.S. House,Richard Castaldo,LIB,610020,1,0,2,3,2
Pittsburg,U.S. House,Markwayne Mullin,REP,610020,1,6,50,57,2
Pittsburg,U.S. House,Jason Nichols,DEM,610020,0,4,13,17,2
Pittsburg,U.S. House,John Foreman,IND,610020,0,0,2,2,2
Pittsburg,State House,Jim Grego,REP,610020,2,6,48,56,17
Pittsburg,State House,Peggy Defrange,DEM,610020,0,4,19,23,17
Pittsburg,Governor,Chris Powell,LIB,610021,0,1,23,24,
Pittsburg,Governor,Kevin Stitt,REP,610021,5,35,318,358,
Pittsburg,Governor,Drew Edmondson,DEM,610021,6,24,101,131,
Pittsburg,Lieutenant Governor,Matt Pinnell,REP,610021,8,40,325,373,
Pittsburg,Lieutenant Governor,Anastasia Pittman,DEM,610021,3,19,94,116,
Pittsburg,Lieutenant Governor,Ivan Holmes,IND,610021,0,1,19,20,
Pittsburg,State Auditor,John Yeutter,LIB,610021,2,11,75,88,
Pittsburg,State Auditor,Cindy Byrd,REP,610021,9,45,342,396,
Pittsburg,Attorney General,Mike Hunter,REP,610021,6,41,329,376,
Pittsburg,Attorney General,Mark Myles,DEM,610021,5,19,109,133,
Pittsburg,State Treasurer,Randy Mcdaniel,REP,610021,9,44,348,401,
Pittsburg,State Treasurer,Charles De Coune,IND,610021,2,11,72,85,
Pittsburg,Superintendent of Public Instruction,Joy Hofmeister,REP,610021,4,35,257,296,
Pittsburg,Superintendent of Public Instruction,John Cox,DEM,610021,4,23,135,162,
Pittsburg,Superintendent of Public Instruction,Larry Huff,IND,610021,3,2,44,49,
Pittsburg,Commissioner of Labor,Leslie Osborn,REP,610021,6,38,294,338,
Pittsburg,Commissioner of Labor,Fred Dorrell,DEM,610021,5,20,109,134,
Pittsburg,Commissioner of Labor,Brandt Dismukes,IND,610021,0,1,29,30,
Pittsburg,Insurance Commissioner,Glen Mulready,REP,610021,9,38,311,358,
Pittsburg,Insurance Commissioner,Kimberly Fobbs,DEM,610021,2,22,119,143,
Pittsburg,Corporation Commissioner,Bob Anthony,REP,610021,6,39,295,340,
Pittsburg,Corporation Commissioner,Ashley Nicole Mccray,DEM,610021,5,19,110,134,
Pittsburg,Corporation Commissioner,Jackie Short,IND,610021,0,1,28,29,
Pittsburg,U.S. House,Richard Castaldo,LIB,610021,0,0,7,7,2
Pittsburg,U.S. House,Markwayne Mullin,REP,610021,6,41,330,377,2
Pittsburg,U.S. House,Jason Nichols,DEM,610021,5,19,89,113,2
Pittsburg,U.S. House,John Foreman,IND,610021,0,0,16,16,2
Pittsburg,State House,David Smith,REP,610021,5,34,242,281,18
Pittsburg,State House,Donnie Condit,DEM,610021,6,27,198,231,18
Pittsburg,Governor,Chris Powell,LIB,610023,0,0,3,3,
Pittsburg,Governor,Kevin Stitt,REP,610023,1,0,57,58,
Pittsburg,Governor,Drew Edmondson,DEM,610023,0,2,36,38,
Pittsburg,Lieutenant Governor,Matt Pinnell,REP,610023,1,0,70,71,
Pittsburg,Lieutenant Governor,Anastasia Pittman,DEM,610023,0,2,23,25,
Pittsburg,Lieutenant Governor,Ivan Holmes,IND,610023,0,0,3,3,
Pittsburg,State Auditor,John Yeutter,LIB,610023,0,2,11,13,
Pittsburg,State Auditor,Cindy Byrd,REP,610023,1,0,80,81,
Pittsburg,Attorney General,Mike Hunter,REP,610023,1,0,70,71,
Pittsburg,Attorney General,Mark Myles,DEM,610023,0,2,25,27,
Pittsburg,State Treasurer,Randy Mcdaniel,REP,610023,1,0,75,76,
Pittsburg,State Treasurer,Charles De Coune,IND,610023,0,2,15,17,
Pittsburg,Superintendent of Public Instruction,Joy Hofmeister,REP,610023,0,0,58,58,
Pittsburg,Superintendent of Public Instruction,John Cox,DEM,610023,1,2,34,37,
Pittsburg,Superintendent of Public Instruction,Larry Huff,IND,610023,0,0,2,2,
Pittsburg,Commissioner of Labor,Leslie Osborn,REP,610023,1,0,64,65,
Pittsburg,Commissioner of Labor,Fred Dorrell,DEM,610023,0,2,27,29,
Pittsburg,Commissioner of Labor,Brandt Dismukes,IND,610023,0,0,4,4,
Pittsburg,Insurance Commissioner,Glen Mulready,REP,610023,1,0,68,69,
Pittsburg,Insurance Commissioner,Kimberly Fobbs,DEM,610023,0,2,27,29,
Pittsburg,Corporation Commissioner,Bob Anthony,REP,610023,1,0,71,72,
Pittsburg,Corporation Commissioner,Ashley Nicole Mccray,DEM,610023,0,2,23,25,
Pittsburg,Corporation Commissioner,Jackie Short,IND,610023,0,0,2,2,
Pittsburg,U.S. House,Richard Castaldo,LIB,610023,0,0,0,0,2
Pittsburg,U.S. House,Markwayne Mullin,REP,610023,1,0,68,69,2
Pittsburg,U.S. House,Jason Nichols,DEM,610023,0,2,25,27,2
Pittsburg,U.S. House,John Foreman,IND,610023,0,0,3,3,2
Pittsburg,State House,David Smith,REP,610023,1,0,51,52,18
Pittsburg,State House,Donnie Condit,DEM,610023,0,2,45,47,18
Pittsburg,Governor,Chris Powell,LIB,610026,0,1,10,11,
Pittsburg,Governor,Kevin Stitt,REP,610026,8,12,200,220,
Pittsburg,Governor,Drew Edmondson,DEM,610026,0,7,89,96,
Pittsburg,Lieutenant Governor,Matt Pinnell,REP,610026,8,11,214,233,
Pittsburg,Lieutenant Governor,Anastasia Pittman,DEM,610026,0,8,76,84,
Pittsburg,Lieutenant Governor,Ivan Holmes,IND,610026,0,1,7,8,
Pittsburg,State Auditor,John Yeutter,LIB,610026,0,6,51,57,
Pittsburg,State Auditor,Cindy Byrd,REP,610026,7,12,224,243,
Pittsburg,Attorney General,Mike Hunter,REP,610026,8,13,220,241,
Pittsburg,Attorney General,Mark Myles,DEM,610026,0,7,76,83,
Pittsburg,State Treasurer,Randy Mcdaniel,REP,610026,8,13,215,236,
Pittsburg,State Treasurer,Charles De Coune,IND,610026,0,5,58,63,
Pittsburg,Superintendent of Public Instruction,Joy Hofmeister,REP,610026,8,12,175,195,
Pittsburg,Superintendent of Public Instruction,John Cox,DEM,610026,0,5,101,106,
Pittsburg,Superintendent of Public Instruction,Larry Huff,IND,610026,0,2,22,24,
Pittsburg,Commissioner of Labor,Leslie Osborn,REP,610026,8,12,197,217,
Pittsburg,Commissioner of Labor,Fred Dorrell,DEM,610026,0,7,83,90,
Pittsburg,Commissioner of Labor,Brandt Dismukes,IND,610026,0,1,16,17,
Pittsburg,Insurance Commissioner,Glen Mulready,REP,610026,8,13,211,232,
Pittsburg,Insurance Commissioner,Kimberly Fobbs,DEM,610026,0,7,86,93,
Pittsburg,Corporation Commissioner,Bob Anthony,REP,610026,6,10,194,210,
Pittsburg,Corporation Commissioner,Ashley Nicole Mccray,DEM,610026,0,7,83,90,
Pittsburg,Corporation Commissioner,Jackie Short,IND,610026,2,3,20,25,
Pittsburg,U.S. House,Richard Castaldo,LIB,610026,0,2,3,5,2
Pittsburg,U.S. House,Markwayne Mullin,REP,610026,8,11,213,232,2
Pittsburg,U.S. House,Jason Nichols,DEM,610026,0,7,72,79,2
Pittsburg,U.S. House,John Foreman,IND,610026,0,0,8,8,2
Pittsburg,State House,Jim Grego,REP,610026,7,10,195,212,17
Pittsburg,State House,Peggy Defrange,DEM,610026,1,10,104,115,17
Pittsburg,Governor,Chris Powell,LIB,610027,2,0,23,25,
Pittsburg,Governor,Kevin Stitt,REP,610027,26,30,484,540,
Pittsburg,Governor,Drew Edmondson,DEM,610027,14,11,233,258,
Pittsburg,Lieutenant Governor,Matt Pinnell,REP,610027,31,32,538,601,
Pittsburg,Lieutenant Governor,Anastasia Pittman,DEM,610027,11,6,184,201,
Pittsburg,Lieutenant Governor,Ivan Holmes,IND,610027,0,3,15,18,
Pittsburg,State Auditor,John Yeutter,LIB,610027,5,5,115,125,
Pittsburg,State Auditor,Cindy Byrd,REP,610027,35,34,577,646,
Pittsburg,Attorney General,Mike Hunter,REP,610027,31,27,534,592,
Pittsburg,Attorney General,Mark Myles,DEM,610027,11,13,201,225,
Pittsburg,State Treasurer,Randy Mcdaniel,REP,610027,32,29,567,628,
Pittsburg,State Treasurer,Charles De Coune,IND,610027,8,9,129,146,
Pittsburg,Superintendent of Public Instruction,Joy Hofmeister,REP,610027,27,25,472,524,
Pittsburg,Superintendent of Public Instruction,John Cox,DEM,610027,12,13,191,216,
Pittsburg,Superintendent of Public Instruction,Larry Huff,IND,610027,3,3,74,80,
Pittsburg,Commissioner of Labor,Leslie Osborn,REP,610027,33,26,498,557,
Pittsburg,Commissioner of Labor,Fred Dorrell,DEM,610027,8,13,192,213,
Pittsburg,Commissioner of Labor,Brandt Dismukes,IND,610027,1,2,35,38,
Pittsburg,Insurance Commissioner,Glen Mulready,REP,610027,32,31,512,575,
Pittsburg,Insurance Commissioner,Kimberly Fobbs,DEM,610027,9,10,219,238,
Pittsburg,Corporation Commissioner,Bob Anthony,REP,610027,32,30,504,566,
Pittsburg,Corporation Commissioner,Ashley Nicole Mccray,DEM,610027,8,10,202,220,
Pittsburg,Corporation Commissioner,Jackie Short,IND,610027,2,1,27,30,
Pittsburg,U.S. House,Richard Castaldo,LIB,610027,2,2,11,15,2
Pittsburg,U.S. House,Markwayne Mullin,REP,610027,30,29,537,596,2
Pittsburg,U.S. House,Jason Nichols,DEM,610027,10,9,177,196,2
Pittsburg,U.S. House,John Foreman,IND,610027,0,0,17,17,2
Pittsburg,State House,Randy Randleman,REP,610027,31,32,525,588,15
Pittsburg,State House,Judy Ross Moore,DEM,610027,11,8,215,234,15
Pittsburg,Governor,Chris Powell,LIB,610028,0,0,6,6,
Pittsburg,Governor,Kevin Stitt,REP,610028,3,0,95,98,
Pittsburg,Governor,Drew Edmondson,DEM,610028,4,0,62,66,
Pittsburg,Lieutenant Governor,Matt Pinnell,REP,610028,3,0,102,105,
Pittsburg,Lieutenant Governor,Anastasia Pittman,DEM,610028,4,0,52,56,
Pittsburg,Lieutenant Governor,Ivan Holmes,IND,610028,0,0,8,8,
Pittsburg,State Auditor,John Yeutter,LIB,610028,1,0,30,31,
Pittsburg,State Auditor,Cindy Byrd,REP,610028,4,0,120,124,
Pittsburg,Attorney General,Mike Hunter,REP,610028,3,0,108,111,
Pittsburg,Attorney General,Mark Myles,DEM,610028,4,0,53,57,
Pittsburg,State Treasurer,Randy Mcdaniel,REP,610028,3,0,116,119,
Pittsburg,State Treasurer,Charles De Coune,IND,610028,2,0,30,32,
Pittsburg,Superintendent of Public Instruction,Joy Hofmeister,REP,610028,3,0,81,84,
Pittsburg,Superintendent of Public Instruction,John Cox,DEM,610028,4,0,67,71,
Pittsburg,Superintendent of Public Instruction,Larry Huff,IND,610028,0,0,14,14,
Pittsburg,Commissioner of Labor,Leslie Osborn,REP,610028,3,0,98,101,
Pittsburg,Commissioner of Labor,Fred Dorrell,DEM,610028,4,0,55,59,
Pittsburg,Commissioner of Labor,Brandt Dismukes,IND,610028,0,0,8,8,
Pittsburg,Insurance Commissioner,Glen Mulready,REP,610028,2,0,100,102,
Pittsburg,Insurance Commissioner,Kimberly Fobbs,DEM,610028,5,0,60,65,
Pittsburg,Corporation Commissioner,Bob Anthony,REP,610028,3,0,97,100,
Pittsburg,Corporation Commissioner,Ashley Nicole Mccray,DEM,610028,4,0,57,61,
Pittsburg,Corporation Commissioner,Jackie Short,IND,610028,0,0,7,7,
Pittsburg,U.S. House,Richard Castaldo,LIB,610028,1,0,3,4,2
Pittsburg,U.S. House,Markwayne Mullin,REP,610028,3,0,106,109,2
Pittsburg,U.S. House,Jason Nichols,DEM,610028,3,0,48,51,2
Pittsburg,U.S. House,John Foreman,IND,610028,0,0,6,6,2
Pittsburg,State House,David Smith,REP,610028,3,0,73,76,18
Pittsburg,State House,Donnie Condit,DEM,610028,4,0,88,92,18
Pittsburg,Governor,Chris Powell,LIB,610029,0,1,7,8,
Pittsburg,Governor,Kevin Stitt,REP,610029,2,4,130,136,
Pittsburg,Governor,Drew Edmondson,DEM,610029,1,4,77,82,
Pittsburg,Lieutenant Governor,Matt Pinnell,REP,610029,2,5,146,153,
Pittsburg,Lieutenant Governor,Anastasia Pittman,DEM,610029,1,3,60,64,
Pittsburg,Lieutenant Governor,Ivan Holmes,IND,610029,0,1,6,7,
Pittsburg,State Auditor,John Yeutter,LIB,610029,0,1,43,44,
Pittsburg,State Auditor,Cindy Byrd,REP,610029,3,7,160,170,
Pittsburg,Attorney General,Mike Hunter,REP,610029,2,5,148,155,
Pittsburg,Attorney General,Mark Myles,DEM,610029,1,4,64,69,
Pittsburg,State Treasurer,Randy Mcdaniel,REP,610029,1,3,162,166,
Pittsburg,State Treasurer,Charles De Coune,IND,610029,2,6,41,49,
Pittsburg,Superintendent of Public Instruction,Joy Hofmeister,REP,610029,1,1,123,125,
Pittsburg,Superintendent of Public Instruction,John Cox,DEM,610029,1,5,64,70,
Pittsburg,Superintendent of Public Instruction,Larry Huff,IND,610029,1,3,25,29,
Pittsburg,Commissioner of Labor,Leslie Osborn,REP,610029,2,4,128,134,
Pittsburg,Commissioner of Labor,Fred Dorrell,DEM,610029,1,5,69,75,
Pittsburg,Commissioner of Labor,Brandt Dismukes,IND,610029,0,0,13,13,
Pittsburg,Insurance Commissioner,Glen Mulready,REP,610029,2,5,139,146,
Pittsburg,Insurance Commissioner,Kimberly Fobbs,DEM,610029,1,4,72,77,
Pittsburg,Corporation Commissioner,Bob Anthony,REP,610029,1,4,144,149,
Pittsburg,Corporation Commissioner,Ashley Nicole Mccray,DEM,610029,2,4,54,60,
Pittsburg,Corporation Commissioner,Jackie Short,IND,610029,0,1,13,14,
Pittsburg,U.S. House,Richard Castaldo,LIB,610029,0,0,4,4,2
Pittsburg,U.S. House,Markwayne Mullin,REP,610029,2,5,144,151,2
Pittsburg,U.S. House,Jason Nichols,DEM,610029,1,4,57,62,2
Pittsburg,U.S. House,John Foreman,IND,610029,0,0,9,9,2
Pittsburg,State House,Jim Grego,REP,610029,1,5,136,142,17
Pittsburg,State House,Peggy Defrange,DEM,610029,2,4,78,84,17
Pittsburg,Governor,Chris Powell,LIB,610030,0,0,6,6,
Pittsburg,Governor,Kevin Stitt,REP,610030,0,8,122,130,
Pittsburg,Governor,Drew Edmondson,DEM,610030,4,2,40,46,
Pittsburg,Lieutenant Governor,Matt Pinnell,REP,610030,0,8,121,129,
Pittsburg,Lieutenant Governor,Anastasia Pittman,DEM,610030,4,2,39,45,
Pittsburg,Lieutenant Governor,Ivan Holmes,IND,610030,0,0,6,6,
Pittsburg,State Auditor,John Yeutter,LIB,610030,4,0,24,28,
Pittsburg,State Auditor,Cindy Byrd,REP,610030,0,8,129,137,
Pittsburg,Attorney General,Mike Hunter,REP,610030,0,7,118,125,
Pittsburg,Attorney General,Mark Myles,DEM,610030,4,3,44,51,
Pittsburg,State Treasurer,Randy Mcdaniel,REP,610030,0,8,124,132,
Pittsburg,State Treasurer,Charles De Coune,IND,610030,4,0,28,32,
Pittsburg,Superintendent of Public Instruction,Joy Hofmeister,REP,610030,1,6,103,110,
Pittsburg,Superintendent of Public Instruction,John Cox,DEM,610030,3,3,55,61,
Pittsburg,Superintendent of Public Instruction,Larry Huff,IND,610030,0,1,11,12,
Pittsburg,Commissioner of Labor,Leslie Osborn,REP,610030,0,8,108,116,
Pittsburg,Commissioner of Labor,Fred Dorrell,DEM,610030,4,2,48,54,
Pittsburg,Commissioner of Labor,Brandt Dismukes,IND,610030,0,0,9,9,
Pittsburg,Insurance Commissioner,Glen Mulready,REP,610030,0,7,123,130,
Pittsburg,Insurance Commissioner,Kimberly Fobbs,DEM,610030,4,3,44,51,
Pittsburg,Corporation Commissioner,Bob Anthony,REP,610030,1,6,111,118,
Pittsburg,Corporation Commissioner,Ashley Nicole Mccray,DEM,610030,3,3,46,52,
Pittsburg,Corporation Commissioner,Jackie Short,IND,610030,0,1,8,9,
Pittsburg,U.S. House,Richard Castaldo,LIB,610030,0,0,1,1,2
Pittsburg,U.S. House,Markwayne Mullin,REP,610030,0,7,126,133,2
Pittsburg,U.S. House,Jason Nichols,DEM,610030,4,3,36,43,2
Pittsburg,U.S. House,John Foreman,IND,610030,0,0,4,4,2
Pittsburg,State House,Jim Grego,REP,610030,1,7,110,118,17
Pittsburg,State House,Peggy Defrange,DEM,610030,3,3,61,67,17
Pittsburg,Governor,Chris Powell,LIB,610031,0,0,25,25,
Pittsburg,Governor,Kevin Stitt,REP,610031,12,10,210,232,
Pittsburg,Governor,Drew Edmondson,DEM,610031,9,8,94,111,
Pittsburg,Lieutenant Governor,Matt Pinnell,REP,610031,14,13,246,273,
Pittsburg,Lieutenant Governor,Anastasia Pittman,DEM,610031,7,4,72,83,
Pittsburg,Lieutenant Governor,Ivan Holmes,IND,610031,0,1,9,10,
Pittsburg,State Auditor,John Yeutter,LIB,610031,2,4,46,52,
Pittsburg,State Auditor,Cindy Byrd,REP,610031,14,14,251,279,
Pittsburg,Attorney General,Mike Hunter,REP,610031,14,14,249,277,
Pittsburg,Attorney General,Mark Myles,DEM,610031,7,4,78,89,
Pittsburg,State Treasurer,Randy Mcdaniel,REP,610031,14,14,237,265,
Pittsburg,State Treasurer,Charles De Coune,IND,610031,2,3,56,61,
Pittsburg,Superintendent of Public Instruction,Joy Hofmeister,REP,610031,12,12,213,237,
Pittsburg,Superintendent of Public Instruction,John Cox,DEM,610031,7,5,79,91,
Pittsburg,Superintendent of Public Instruction,Larry Huff,IND,610031,2,0,35,37,
Pittsburg,Commissioner of Labor,Leslie Osborn,REP,610031,13,14,218,245,
Pittsburg,Commissioner of Labor,Fred Dorrell,DEM,610031,7,4,86,97,
Pittsburg,Commissioner of Labor,Brandt Dismukes,IND,610031,1,0,16,17,
Pittsburg,Insurance Commissioner,Glen Mulready,REP,610031,14,13,239,266,
Pittsburg,Insurance Commissioner,Kimberly Fobbs,DEM,610031,7,5,83,95,
Pittsburg,Corporation Commissioner,Bob Anthony,REP,610031,12,13,218,243,
Pittsburg,Corporation Commissioner,Ashley Nicole Mccray,DEM,610031,7,4,83,94,
Pittsburg,Corporation Commissioner,Jackie Short,IND,610031,2,1,22,25,
Pittsburg,U.S. House,Richard Castaldo,LIB,610031,1,0,5,6,2
Pittsburg,U.S. House,Markwayne Mullin,REP,610031,13,11,244,268,2
Pittsburg,U.S. House,Jason Nichols,DEM,610031,7,6,71,84,2
Pittsburg,U.S. House,John Foreman,IND,610031,0,1,8,9,2
Pittsburg,State House,Jim Grego,REP,610031,13,11,206,230,17
Pittsburg,State House,Peggy Defrange,DEM,610031,8,7,123,138,17
Pittsburg,Governor,Chris Powell,LIB,610032,1,1,19,21,
Pittsburg,Governor,Kevin Stitt,REP,610032,20,67,423,510,
Pittsburg,Governor,Drew Edmondson,DEM,610032,12,68,193,273,
Pittsburg,Lieutenant Governor,Matt Pinnell,REP,610032,22,70,459,551,
Pittsburg,Lieutenant Governor,Anastasia Pittman,DEM,610032,11,63,145,219,
Pittsburg,Lieutenant Governor,Ivan Holmes,IND,610032,0,3,20,23,
Pittsburg,State Auditor,John Yeutter,LIB,610032,9,35,97,141,
Pittsburg,State Auditor,Cindy Byrd,REP,610032,24,88,499,611,
Pittsburg,Attorney General,Mike Hunter,REP,610032,23,72,477,572,
Pittsburg,Attorney General,Mark Myles,DEM,610032,11,62,146,219,
Pittsburg,State Treasurer,Randy Mcdaniel,REP,610032,23,79,480,582,
Pittsburg,State Treasurer,Charles De Coune,IND,610032,10,44,120,174,
Pittsburg,Superintendent of Public Instruction,Joy Hofmeister,REP,610032,24,71,397,492,
Pittsburg,Superintendent of Public Instruction,John Cox,DEM,610032,9,58,163,230,
Pittsburg,Superintendent of Public Instruction,Larry Huff,IND,610032,1,7,63,71,
Pittsburg,Commissioner of Labor,Leslie Osborn,REP,610032,22,70,431,523,
Pittsburg,Commissioner of Labor,Fred Dorrell,DEM,610032,9,59,143,211,
Pittsburg,Commissioner of Labor,Brandt Dismukes,IND,610032,1,5,42,48,
Pittsburg,Insurance Commissioner,Glen Mulready,REP,610032,22,66,441,529,
Pittsburg,Insurance Commissioner,Kimberly Fobbs,DEM,610032,11,69,176,256,
Pittsburg,Corporation Commissioner,Bob Anthony,REP,610032,23,66,430,519,
Pittsburg,Corporation Commissioner,Ashley Nicole Mccray,DEM,610032,10,63,146,219,
Pittsburg,Corporation Commissioner,Jackie Short,IND,610032,1,6,41,48,
Pittsburg,U.S. House,Richard Castaldo,LIB,610032,2,2,11,15,2
Pittsburg,U.S. House,Markwayne Mullin,REP,610032,22,71,465,558,2
Pittsburg,U.S. House,Jason Nichols,DEM,610032,10,62,142,214,2
Pittsburg,U.S. House,John Foreman,IND,610032,0,1,13,14,2
Pittsburg,State House,Jim Grego,REP,610032,22,61,430,513,17
Pittsburg,State House,Peggy Defrange,DEM,610032,12,74,204,290,17
Pittsburg,Governor,Chris Powell,LIB,610033,0,2,13,15,
Pittsburg,Governor,Kevin Stitt,REP,610033,1,8,139,148,
Pittsburg,Governor,Drew Edmondson,DEM,610033,1,7,93,101,
Pittsburg,Lieutenant Governor,Matt Pinnell,REP,610033,0,9,150,159,
Pittsburg,Lieutenant Governor,Anastasia Pittman,DEM,610033,1,8,79,88,
Pittsburg,Lieutenant Governor,Ivan Holmes,IND,610033,0,0,13,13,
Pittsburg,State Auditor,John Yeutter,LIB,610033,1,3,50,54,
Pittsburg,State Auditor,Cindy Byrd,REP,610033,0,13,180,193,
Pittsburg,Attorney General,Mike Hunter,REP,610033,1,9,162,172,
Pittsburg,Attorney General,Mark Myles,DEM,610033,0,8,77,85,
Pittsburg,State Treasurer,Randy Mcdaniel,REP,610033,1,9,176,186,
Pittsburg,State Treasurer,Charles De Coune,IND,610033,0,7,54,61,
Pittsburg,Superintendent of Public Instruction,Joy Hofmeister,REP,610033,1,7,144,152,
Pittsburg,Superintendent of Public Instruction,John Cox,DEM,610033,0,8,75,83,
Pittsburg,Superintendent of Public Instruction,Larry Huff,IND,610033,0,2,21,23,
Pittsburg,Commissioner of Labor,Leslie Osborn,REP,610033,1,6,148,155,
Pittsburg,Commissioner of Labor,Fred Dorrell,DEM,610033,0,8,76,84,
Pittsburg,Commissioner of Labor,Brandt Dismukes,IND,610033,0,3,14,17,
Pittsburg,Insurance Commissioner,Glen Mulready,REP,610033,1,9,164,174,
Pittsburg,Insurance Commissioner,Kimberly Fobbs,DEM,610033,0,8,74,82,
Pittsburg,Corporation Commissioner,Bob Anthony,REP,610033,1,9,147,157,
Pittsburg,Corporation Commissioner,Ashley Nicole Mccray,DEM,610033,1,8,79,88,
Pittsburg,Corporation Commissioner,Jackie Short,IND,610033,0,0,15,15,
Pittsburg,U.S. House,Richard Castaldo,LIB,610033,0,0,2,2,2
Pittsburg,U.S. House,Markwayne Mullin,REP,610033,1,10,170,181,2
Pittsburg,U.S. House,Jason Nichols,DEM,610033,0,7,59,66,2
Pittsburg,U.S. House,John Foreman,IND,610033,0,0,11,11,2
Pittsburg,State House,Jim Grego,REP,610033,0,8,155,163,17
Pittsburg,State House,Peggy Defrange,DEM,610033,2,9,90,101,17
Pittsburg,Governor,Chris Powell,LIB,610034,0,0,28,28,
Pittsburg,Governor,Kevin Stitt,REP,610034,6,9,247,262,
Pittsburg,Governor,Drew Edmondson,DEM,610034,5,13,213,231,
Pittsburg,Lieutenant Governor,Matt Pinnell,REP,610034,7,12,281,300,
Pittsburg,Lieutenant Governor,Anastasia Pittman,DEM,610034,4,9,182,195,
Pittsburg,Lieutenant Governor,Ivan Holmes,IND,610034,0,0,20,20,
Pittsburg,State Auditor,John Yeutter,LIB,610034,1,5,123,129,
Pittsburg,State Auditor,Cindy Byrd,REP,610034,9,14,316,339,
Pittsburg,Attorney General,Mike Hunter,REP,610034,7,12,288,307,
Pittsburg,Attorney General,Mark Myles,DEM,610034,4,10,194,208,
Pittsburg,State Treasurer,Randy Mcdaniel,REP,610034,8,15,313,336,
Pittsburg,State Treasurer,Charles De Coune,IND,610034,2,4,125,131,
Pittsburg,Superintendent of Public Instruction,Joy Hofmeister,REP,610034,8,12,251,271,
Pittsburg,Superintendent of Public Instruction,John Cox,DEM,610034,2,9,190,201,
Pittsburg,Superintendent of Public Instruction,Larry Huff,IND,610034,1,1,44,46,
Pittsburg,Commissioner of Labor,Leslie Osborn,REP,610034,8,9,271,288,
Pittsburg,Commissioner of Labor,Fred Dorrell,DEM,610034,3,12,185,200,
Pittsburg,Commissioner of Labor,Brandt Dismukes,IND,610034,0,1,27,28,
Pittsburg,Insurance Commissioner,Glen Mulready,REP,610034,8,12,275,295,
Pittsburg,Insurance Commissioner,Kimberly Fobbs,DEM,610034,3,10,201,214,
Pittsburg,Corporation Commissioner,Bob Anthony,REP,610034,8,10,261,279,
Pittsburg,Corporation Commissioner,Ashley Nicole Mccray,DEM,610034,3,12,185,200,
Pittsburg,Corporation Commissioner,Jackie Short,IND,610034,0,0,32,32,
Pittsburg,U.S. House,Richard Castaldo,LIB,610034,0,0,12,12,2
Pittsburg,U.S. House,Markwayne Mullin,REP,610034,8,10,291,309,2
Pittsburg,U.S. House,Jason Nichols,DEM,610034,3,12,166,181,2
Pittsburg,U.S. House,John Foreman,IND,610034,0,0,15,15,2
Pittsburg,State House,Jim Grego,REP,610034,8,11,274,293,17
Pittsburg,State House,Peggy Defrange,DEM,610034,3,12,213,228,17
Pittsburg,Governor,Chris Powell,LIB,610035,2,1,13,16,
Pittsburg,Governor,Kevin Stitt,REP,610035,0,1,152,153,
Pittsburg,Governor,Drew Edmondson,DEM,610035,7,6,144,157,
Pittsburg,Lieutenant Governor,Matt Pinnell,REP,610035,0,1,178,179,
Pittsburg,Lieutenant Governor,Anastasia Pittman,DEM,610035,7,6,119,132,
Pittsburg,Lieutenant Governor,Ivan Holmes,IND,610035,2,1,10,13,
Pittsburg,State Auditor,John Yeutter,LIB,610035,5,4,67,76,
Pittsburg,State Auditor,Cindy Byrd,REP,610035,0,3,212,215,
Pittsburg,Attorney General,Mike Hunter,REP,610035,1,2,186,189,
Pittsburg,Attorney General,Mark Myles,DEM,610035,8,6,119,133,
Pittsburg,State Treasurer,Randy Mcdaniel,REP,610035,0,1,203,204,
Pittsburg,State Treasurer,Charles De Coune,IND,610035,5,6,78,89,
Pittsburg,Superintendent of Public Instruction,Joy Hofmeister,REP,610035,0,1,156,157,
Pittsburg,Superintendent of Public Instruction,John Cox,DEM,610035,6,6,134,146,
Pittsburg,Superintendent of Public Instruction,Larry Huff,IND,610035,3,1,16,20,
Pittsburg,Commissioner of Labor,Leslie Osborn,REP,610035,0,2,165,167,
Pittsburg,Commissioner of Labor,Fred Dorrell,DEM,610035,6,6,126,138,
Pittsburg,Commissioner of Labor,Brandt Dismukes,IND,610035,3,0,12,15,
Pittsburg,Insurance Commissioner,Glen Mulready,REP,610035,1,2,168,171,
Pittsburg,Insurance Commissioner,Kimberly Fobbs,DEM,610035,8,6,135,149,
Pittsburg,Corporation Commissioner,Bob Anthony,REP,610035,0,2,174,176,
Pittsburg,Corporation Commissioner,Ashley Nicole Mccray,DEM,610035,7,6,118,131,
Pittsburg,Corporation Commissioner,Jackie Short,IND,610035,2,0,10,12,
Pittsburg,U.S. House,Richard Castaldo,LIB,610035,0,0,1,1,2
Pittsburg,U.S. House,Markwayne Mullin,REP,610035,2,2,193,197,2
Pittsburg,U.S. House,Jason Nichols,DEM,610035,7,6,103,116,2
Pittsburg,U.S. House,John Foreman,IND,610035,0,0,10,10,2
Pittsburg,State House,Jim Grego,REP,610035,1,3,167,171,17
Pittsburg,State House,Peggy Defrange,DEM,610035,8,5,139,152,17
Pittsburg,Governor,Chris Powell,LIB,610036,0,0,7,7,
Pittsburg,Governor,Kevin Stitt,REP,610036,0,16,77,93,
Pittsburg,Governor,Drew Edmondson,DEM,610036,2,11,41,54,
Pittsburg,Lieutenant Governor,Matt Pinnell,REP,610036,0,17,88,105,
Pittsburg,Lieutenant Governor,Anastasia Pittman,DEM,610036,2,9,29,40,
Pittsburg,Lieutenant Governor,Ivan Holmes,IND,610036,0,0,6,6,
Pittsburg,State Auditor,John Yeutter,LIB,610036,2,6,26,34,
Pittsburg,State Auditor,Cindy Byrd,REP,610036,0,19,93,112,
Pittsburg,Attorney General,Mike Hunter,REP,610036,0,18,87,105,
Pittsburg,Attorney General,Mark Myles,DEM,610036,2,8,35,45,
Pittsburg,State Treasurer,Randy Mcdaniel,REP,610036,0,20,89,109,
Pittsburg,State Treasurer,Charles De Coune,IND,610036,2,5,29,36,
Pittsburg,Superintendent of Public Instruction,Joy Hofmeister,REP,610036,0,15,66,81,
Pittsburg,Superintendent of Public Instruction,John Cox,DEM,610036,1,11,39,51,
Pittsburg,Superintendent of Public Instruction,Larry Huff,IND,610036,1,1,20,22,
Pittsburg,Commissioner of Labor,Leslie Osborn,REP,610036,0,15,79,94,
Pittsburg,Commissioner of Labor,Fred Dorrell,DEM,610036,1,12,36,49,
Pittsburg,Commissioner of Labor,Brandt Dismukes,IND,610036,1,0,10,11,
Pittsburg,Insurance Commissioner,Glen Mulready,REP,610036,0,15,81,96,
Pittsburg,Insurance Commissioner,Kimberly Fobbs,DEM,610036,2,12,42,56,
Pittsburg,Corporation Commissioner,Bob Anthony,REP,610036,0,16,78,94,
Pittsburg,Corporation Commissioner,Ashley Nicole Mccray,DEM,610036,1,9,35,45,
Pittsburg,Corporation Commissioner,Jackie Short,IND,610036,1,0,11,12,
Pittsburg,U.S. House,Richard Castaldo,LIB,610036,0,0,2,2,2
Pittsburg,U.S. House,Markwayne Mullin,REP,610036,0,18,85,103,2
Pittsburg,U.S. House,Jason Nichols,DEM,610036,1,9,33,43,2
Pittsburg,U.S. House,John Foreman,IND,610036,1,0,4,5,2
Pittsburg,State House,David Smith,REP,610036,0,13,72,85,18
Pittsburg,State House,Donnie Condit,DEM,610036,2,14,53,69,18
Pittsburg,Governor,Chris Powell,LIB,610037,0,0,23,23,
Pittsburg,Governor,Kevin Stitt,REP,610037,5,23,371,399,
Pittsburg,Governor,Drew Edmondson,DEM,610037,2,18,108,128,
Pittsburg,Lieutenant Governor,Matt Pinnell,REP,610037,5,24,392,421,
Pittsburg,Lieutenant Governor,Anastasia Pittman,DEM,610037,1,15,94,110,
Pittsburg,Lieutenant Governor,Ivan Holmes,IND,610037,1,1,14,16,
Pittsburg,State Auditor,John Yeutter,LIB,610037,0,6,69,75,
Pittsburg,State Auditor,Cindy Byrd,REP,610037,6,33,407,446,
Pittsburg,Attorney General,Mike Hunter,REP,610037,6,31,394,431,
Pittsburg,Attorney General,Mark Myles,DEM,610037,1,9,104,114,
Pittsburg,State Treasurer,Randy Mcdaniel,REP,610037,5,30,393,428,
Pittsburg,State Treasurer,Charles De Coune,IND,610037,1,8,83,92,
Pittsburg,Superintendent of Public Instruction,Joy Hofmeister,REP,610037,6,30,321,357,
Pittsburg,Superintendent of Public Instruction,John Cox,DEM,610037,1,9,141,151,
Pittsburg,Superintendent of Public Instruction,Larry Huff,IND,610037,0,1,35,36,
Pittsburg,Commissioner of Labor,Leslie Osborn,REP,610037,6,27,342,375,
Pittsburg,Commissioner of Labor,Fred Dorrell,DEM,610037,1,14,135,150,
Pittsburg,Commissioner of Labor,Brandt Dismukes,IND,610037,0,0,21,21,
Pittsburg,Insurance Commissioner,Glen Mulready,REP,610037,5,27,392,424,
Pittsburg,Insurance Commissioner,Kimberly Fobbs,DEM,610037,2,14,107,123,
Pittsburg,Corporation Commissioner,Bob Anthony,REP,610037,6,28,379,413,
Pittsburg,Corporation Commissioner,Ashley Nicole Mccray,DEM,610037,1,11,100,112,
Pittsburg,Corporation Commissioner,Jackie Short,IND,610037,0,1,22,23,
Pittsburg,U.S. House,Richard Castaldo,LIB,610037,0,0,3,3,2
Pittsburg,U.S. House,Markwayne Mullin,REP,610037,6,31,385,422,2
Pittsburg,U.S. House,Jason Nichols,DEM,610037,1,10,98,109,2
Pittsburg,U.S. House,John Foreman,IND,610037,0,0,14,14,2
Pittsburg,State House,David Smith,REP,610037,4,16,299,319,18
Pittsburg,State House,Donnie Condit,DEM,610037,3,25,200,228,18
Pittsburg,Governor,Chris Powell,LIB,610038,0,1,2,3,
Pittsburg,Governor,Kevin Stitt,REP,610038,0,1,20,21,
Pittsburg,Governor,Drew Edmondson,DEM,610038,2,0,6,8,
Pittsburg,Lieutenant Governor,Matt Pinnell,REP,610038,0,2,19,21,
Pittsburg,Lieutenant Governor,Anastasia Pittman,DEM,610038,2,0,7,9,
Pittsburg,Lieutenant Governor,Ivan Holmes,IND,610038,0,0,1,1,
Pittsburg,State Auditor,John Yeutter,LIB,610038,2,1,2,5,
Pittsburg,State Auditor,Cindy Byrd,REP,610038,0,1,22,23,
Pittsburg,Attorney General,Mike Hunter,REP,610038,0,2,21,23,
Pittsburg,Attorney General,Mark Myles,DEM,610038,2,0,5,7,
Pittsburg,State Treasurer,Randy Mcdaniel,REP,610038,0,2,23,25,
Pittsburg,State Treasurer,Charles De Coune,IND,610038,2,0,1,3,
Pittsburg,Superintendent of Public Instruction,Joy Hofmeister,REP,610038,0,1,20,21,
Pittsburg,Superintendent of Public Instruction,John Cox,DEM,610038,2,0,5,7,
Pittsburg,Superintendent of Public Instruction,Larry Huff,IND,610038,0,1,1,2,
Pittsburg,Commissioner of Labor,Leslie Osborn,REP,610038,0,2,20,22,
Pittsburg,Commissioner of Labor,Fred Dorrell,DEM,610038,2,0,5,7,
Pittsburg,Commissioner of Labor,Brandt Dismukes,IND,610038,0,0,1,1,
Pittsburg,Insurance Commissioner,Glen Mulready,REP,610038,0,2,20,22,
Pittsburg,Insurance Commissioner,Kimberly Fobbs,DEM,610038,2,0,7,9,
Pittsburg,Corporation Commissioner,Bob Anthony,REP,610038,0,2,22,24,
Pittsburg,Corporation Commissioner,Ashley Nicole Mccray,DEM,610038,2,0,4,6,
Pittsburg,Corporation Commissioner,Jackie Short,IND,610038,0,0,0,0,
Pittsburg,U.S. House,Richard Castaldo,LIB,610038,0,1,1,2,2
Pittsburg,U.S. House,Markwayne Mullin,REP,610038,0,1,22,23,2
Pittsburg,U.S. House,Jason Nichols,DEM,610038,2,0,5,7,2
Pittsburg,U.S. House,John Foreman,IND,610038,0,0,0,0,2
Pittsburg,State House,Jim Grego,REP,610038,0,2,23,25,17
Pittsburg,State House,Peggy Defrange,DEM,610038,2,0,5,7,17
Pittsburg,Governor,Chris Powell,LIB,610039,0,2,12,14,
Pittsburg,Governor,Kevin Stitt,REP,610039,3,3,214,220,
Pittsburg,Governor,Drew Edmondson,DEM,610039,3,3,76,82,
Pittsburg,Lieutenant Governor,Matt Pinnell,REP,610039,3,7,227,237,
Pittsburg,Lieutenant Governor,Anastasia Pittman,DEM,610039,3,1,59,63,
Pittsburg,Lieutenant Governor,Ivan Holmes,IND,610039,0,0,14,14,
Pittsburg,State Auditor,John Yeutter,LIB,610039,0,2,42,44,
Pittsburg,State Auditor,Cindy Byrd,REP,610039,4,6,245,255,
Pittsburg,Attorney General,Mike Hunter,REP,610039,4,7,245,256,
Pittsburg,Attorney General,Mark Myles,DEM,610039,2,1,53,56,
Pittsburg,State Treasurer,Randy Mcdaniel,REP,610039,4,5,239,248,
Pittsburg,State Treasurer,Charles De Coune,IND,610039,0,3,45,48,
Pittsburg,Superintendent of Public Instruction,Joy Hofmeister,REP,610039,3,7,191,201,
Pittsburg,Superintendent of Public Instruction,John Cox,DEM,610039,3,1,82,86,
Pittsburg,Superintendent of Public Instruction,Larry Huff,IND,610039,0,0,27,27,
Pittsburg,Commissioner of Labor,Leslie Osborn,REP,610039,4,6,216,226,
Pittsburg,Commissioner of Labor,Fred Dorrell,DEM,610039,2,2,59,63,
Pittsburg,Commissioner of Labor,Brandt Dismukes,IND,610039,0,0,20,20,
Pittsburg,Insurance Commissioner,Glen Mulready,REP,610039,3,6,228,237,
Pittsburg,Insurance Commissioner,Kimberly Fobbs,DEM,610039,3,2,69,74,
Pittsburg,Corporation Commissioner,Bob Anthony,REP,610039,3,4,208,215,
Pittsburg,Corporation Commissioner,Ashley Nicole Mccray,DEM,610039,3,4,68,75,
Pittsburg,Corporation Commissioner,Jackie Short,IND,610039,0,0,22,22,
Pittsburg,U.S. House,Richard Castaldo,LIB,610039,0,0,6,6,2
Pittsburg,U.S. House,Markwayne Mullin,REP,610039,4,6,234,244,2
Pittsburg,U.S. House,Jason Nichols,DEM,610039,2,2,49,53,2
Pittsburg,U.S. House,John Foreman,IND,610039,0,0,11,11,2
Pittsburg,State House,David Smith,REP,610039,2,4,184,190,18
Pittsburg,State House,Donnie Condit,DEM,610039,4,4,117,125,18
Pittsburg,Governor,Chris Powell,LIB,610040,0,0,11,11,
Pittsburg,Governor,Kevin Stitt,REP,610040,2,6,185,193,
Pittsburg,Governor,Drew Edmondson,DEM,610040,3,7,92,102,
Pittsburg,Lieutenant Governor,Matt Pinnell,REP,610040,5,9,208,222,
Pittsburg,Lieutenant Governor,Anastasia Pittman,DEM,610040,0,3,71,74,
Pittsburg,Lieutenant Governor,Ivan Holmes,IND,610040,0,1,8,9,
Pittsburg,State Auditor,John Yeutter,LIB,610040,1,2,45,48,
Pittsburg,State Auditor,Cindy Byrd,REP,610040,3,9,230,242,
Pittsburg,Attorney General,Mike Hunter,REP,610040,3,8,207,218,
Pittsburg,Attorney General,Mark Myles,DEM,610040,2,5,78,85,
Pittsburg,State Treasurer,Randy Mcdaniel,REP,610040,4,6,228,238,
Pittsburg,State Treasurer,Charles De Coune,IND,610040,1,5,47,53,
Pittsburg,Superintendent of Public Instruction,Joy Hofmeister,REP,610040,2,5,181,188,
Pittsburg,Superintendent of Public Instruction,John Cox,DEM,610040,3,7,82,92,
Pittsburg,Superintendent of Public Instruction,Larry Huff,IND,610040,0,1,23,24,
Pittsburg,Commissioner of Labor,Leslie Osborn,REP,610040,2,9,192,203,
Pittsburg,Commissioner of Labor,Fred Dorrell,DEM,610040,3,4,75,82,
Pittsburg,Commissioner of Labor,Brandt Dismukes,IND,610040,0,0,17,17,
Pittsburg,Insurance Commissioner,Glen Mulready,REP,610040,2,9,210,221,
Pittsburg,Insurance Commissioner,Kimberly Fobbs,DEM,610040,3,4,74,81,
Pittsburg,Corporation Commissioner,Bob Anthony,REP,610040,2,8,198,208,
Pittsburg,Corporation Commissioner,Ashley Nicole Mccray,DEM,610040,3,4,70,77,
Pittsburg,Corporation Commissioner,Jackie Short,IND,610040,0,1,15,16,
Pittsburg,U.S. House,Richard Castaldo,LIB,610040,0,0,2,2,2
Pittsburg,U.S. House,Markwayne Mullin,REP,610040,2,8,212,222,2
Pittsburg,U.S. House,Jason Nichols,DEM,610040,3,5,66,74,2
Pittsburg,U.S. House,John Foreman,IND,610040,0,0,8,8,2
Pittsburg,State House,Jim Grego,REP,610040,0,9,186,195,17
Pittsburg,State House,Peggy Defrange,DEM,610040,5,4,100,109,17
Pittsburg,Governor,Chris Powell,LIB,610041,1,2,35,38,
Pittsburg,Governor,Kevin Stitt,REP,610041,3,16,307,326,
Pittsburg,Governor,Drew Edmondson,DEM,610041,15,17,196,228,
Pittsburg,Lieutenant Governor,Matt Pinnell,REP,610041,2,16,341,359,
Pittsburg,Lieutenant Governor,Anastasia Pittman,DEM,610041,16,17,167,200,
Pittsburg,Lieutenant Governor,Ivan Holmes,IND,610041,1,2,27,30,
Pittsburg,State Auditor,John Yeutter,LIB,610041,8,9,128,145,
Pittsburg,State Auditor,Cindy Byrd,REP,610041,4,23,364,391,
Pittsburg,Attorney General,Mike Hunter,REP,610041,2,19,358,379,
Pittsburg,Attorney General,Mark Myles,DEM,610041,17,16,173,206,
Pittsburg,State Treasurer,Randy Mcdaniel,REP,610041,3,20,365,388,
Pittsburg,State Treasurer,Charles De Coune,IND,610041,9,12,129,150,
Pittsburg,Superintendent of Public Instruction,Joy Hofmeister,REP,610041,2,12,285,299,
Pittsburg,Superintendent of Public Instruction,John Cox,DEM,610041,16,17,187,220,
Pittsburg,Superintendent of Public Instruction,Larry Huff,IND,610041,1,5,59,65,
Pittsburg,Commissioner of Labor,Leslie Osborn,REP,610041,2,15,314,331,
Pittsburg,Commissioner of Labor,Fred Dorrell,DEM,610041,15,18,185,218,
Pittsburg,Commissioner of Labor,Brandt Dismukes,IND,610041,1,1,32,34,
Pittsburg,Insurance Commissioner,Glen Mulready,REP,610041,1,13,331,345,
Pittsburg,Insurance Commissioner,Kimberly Fobbs,DEM,610041,17,20,200,237,
Pittsburg,Corporation Commissioner,Bob Anthony,REP,610041,1,16,303,320,
Pittsburg,Corporation Commissioner,Ashley Nicole Mccray,DEM,610041,15,13,187,215,
Pittsburg,Corporation Commissioner,Jackie Short,IND,610041,2,5,41,48,
Pittsburg,U.S. House,Richard Castaldo,LIB,610041,1,0,7,8,2
Pittsburg,U.S. House,Markwayne Mullin,REP,610041,3,20,346,369,2
Pittsburg,U.S. House,Jason Nichols,DEM,610041,14,15,162,191,2
Pittsburg,U.S. House,John Foreman,IND,610041,0,0,20,20,2
Pittsburg,State House,Jim Grego,REP,610041,2,20,322,344,17
Pittsburg,State House,Peggy Defrange,DEM,610041,17,14,217,248,17
Pittsburg,Governor,Chris Powell,LIB,610042,0,3,13,16,
Pittsburg,Governor,Kevin Stitt,REP,610042,7,43,220,270,
Pittsburg,Governor,Drew Edmondson,DEM,610042,4,36,106,146,
Pittsburg,Lieutenant Governor,Matt Pinnell,REP,610042,7,52,239,298,
Pittsburg,Lieutenant Governor,Anastasia Pittman,DEM,610042,4,29,85,118,
Pittsburg,Lieutenant Governor,Ivan Holmes,IND,610042,0,1,14,15,
Pittsburg,State Auditor,John Yeutter,LIB,610042,1,17,65,83,
Pittsburg,State Auditor,Cindy Byrd,REP,610042,6,55,263,324,
Pittsburg,Attorney General,Mike Hunter,REP,610042,7,51,245,303,
Pittsburg,Attorney General,Mark Myles,DEM,610042,4,31,90,125,
Pittsburg,State Treasurer,Randy Mcdaniel,REP,610042,7,53,253,313,
Pittsburg,State Treasurer,Charles De Coune,IND,610042,1,20,73,94,
Pittsburg,Superintendent of Public Instruction,Joy Hofmeister,REP,610042,6,42,201,249,
Pittsburg,Superintendent of Public Instruction,John Cox,DEM,610042,5,38,109,152,
Pittsburg,Superintendent of Public Instruction,Larry Huff,IND,610042,0,2,28,30,
Pittsburg,Commissioner of Labor,Leslie Osborn,REP,610042,6,43,219,268,
Pittsburg,Commissioner of Labor,Fred Dorrell,DEM,610042,5,36,91,132,
Pittsburg,Commissioner of Labor,Brandt Dismukes,IND,610042,0,2,25,27,
Pittsburg,Insurance Commissioner,Glen Mulready,REP,610042,7,48,243,298,
Pittsburg,Insurance Commissioner,Kimberly Fobbs,DEM,610042,4,33,93,130,
Pittsburg,Corporation Commissioner,Bob Anthony,REP,610042,4,50,232,286,
Pittsburg,Corporation Commissioner,Ashley Nicole Mccray,DEM,610042,5,30,82,117,
Pittsburg,Corporation Commissioner,Jackie Short,IND,610042,2,2,22,26,
Pittsburg,U.S. House,Richard Castaldo,LIB,610042,0,1,1,2,2
Pittsburg,U.S. House,Markwayne Mullin,REP,610042,7,51,246,304,2
Pittsburg,U.S. House,Jason Nichols,DEM,610042,4,30,78,112,2
Pittsburg,U.S. House,John Foreman,IND,610042,0,0,12,12,2
Pittsburg,State House,Jim Grego,REP,610042,7,45,220,272,17
Pittsburg,State House,Peggy Defrange,DEM,610042,4,38,118,160,17
Pittsburg,Governor,Chris Powell,LIB,610043,0,0,16,16,
Pittsburg,Governor,Kevin Stitt,REP,610043,3,7,145,155,
Pittsburg,Governor,Drew Edmondson,DEM,610043,3,2,73,78,
Pittsburg,Lieutenant Governor,Matt Pinnell,REP,610043,2,7,159,168,
Pittsburg,Lieutenant Governor,Anastasia Pittman,DEM,610043,4,2,61,67,
Pittsburg,Lieutenant Governor,Ivan Holmes,IND,610043,0,0,14,14,
Pittsburg,State Auditor,John Yeutter,LIB,610043,2,1,44,47,
Pittsburg,State Auditor,Cindy Byrd,REP,610043,3,7,169,179,
Pittsburg,Attorney General,Mike Hunter,REP,610043,2,4,161,167,
Pittsburg,Attorney General,Mark Myles,DEM,610043,4,5,71,80,
Pittsburg,State Treasurer,Randy Mcdaniel,REP,610043,3,6,164,173,
Pittsburg,State Treasurer,Charles De Coune,IND,610043,2,2,49,53,
Pittsburg,Superintendent of Public Instruction,Joy Hofmeister,REP,610043,2,2,118,122,
Pittsburg,Superintendent of Public Instruction,John Cox,DEM,610043,4,4,89,97,
Pittsburg,Superintendent of Public Instruction,Larry Huff,IND,610043,0,2,25,27,
Pittsburg,Commissioner of Labor,Leslie Osborn,REP,610043,2,5,139,146,
Pittsburg,Commissioner of Labor,Fred Dorrell,DEM,610043,4,2,77,83,
Pittsburg,Commissioner of Labor,Brandt Dismukes,IND,610043,0,0,12,12,
Pittsburg,Insurance Commissioner,Glen Mulready,REP,610043,2,5,148,155,
Pittsburg,Insurance Commissioner,Kimberly Fobbs,DEM,610043,4,2,78,84,
Pittsburg,Corporation Commissioner,Bob Anthony,REP,610043,2,6,152,160,
Pittsburg,Corporation Commissioner,Ashley Nicole Mccray,DEM,610043,4,2,58,64,
Pittsburg,Corporation Commissioner,Jackie Short,IND,610043,0,1,18,19,
Pittsburg,U.S. House,Richard Castaldo,LIB,610043,0,0,1,1,2
Pittsburg,U.S. House,Markwayne Mullin,REP,610043,2,7,172,181,2
Pittsburg,U.S. House,Jason Nichols,DEM,610043,4,2,54,60,2
Pittsburg,U.S. House,John Foreman,IND,610043,0,0,10,10,2
Pittsburg,State House,Jim Grego,REP,610043,4,5,154,163,17
Pittsburg,State House,Peggy Defrange,DEM,610043,2,4,79,85,17
Pittsburg,Governor,Chris Powell,LIB,610044,0,0,20,20,
Pittsburg,Governor,Kevin Stitt,REP,610044,5,4,227,236,
Pittsburg,Governor,Drew Edmondson,DEM,610044,10,1,115,126,
Pittsburg,Lieutenant Governor,Matt Pinnell,REP,610044,5,4,257,266,
Pittsburg,Lieutenant Governor,Anastasia Pittman,DEM,610044,10,1,96,107,
Pittsburg,Lieutenant Governor,Ivan Holmes,IND,610044,0,0,9,9,
Pittsburg,State Auditor,John Yeutter,LIB,610044,6,0,68,74,
Pittsburg,State Auditor,Cindy Byrd,REP,610044,5,5,275,285,
Pittsburg,Attorney General,Mike Hunter,REP,610044,5,4,257,266,
Pittsburg,Attorney General,Mark Myles,DEM,610044,10,1,103,114,
Pittsburg,State Treasurer,Randy Mcdaniel,REP,610044,5,5,281,291,
Pittsburg,State Treasurer,Charles De Coune,IND,610044,6,0,64,70,
Pittsburg,Superintendent of Public Instruction,Joy Hofmeister,REP,610044,5,4,190,199,
Pittsburg,Superintendent of Public Instruction,John Cox,DEM,610044,10,1,135,146,
Pittsburg,Superintendent of Public Instruction,Larry Huff,IND,610044,0,0,35,35,
Pittsburg,Commissioner of Labor,Leslie Osborn,REP,610044,7,4,231,242,
Pittsburg,Commissioner of Labor,Fred Dorrell,DEM,610044,8,1,105,114,
Pittsburg,Commissioner of Labor,Brandt Dismukes,IND,610044,0,0,23,23,
Pittsburg,Insurance Commissioner,Glen Mulready,REP,610044,5,4,248,257,
Pittsburg,Insurance Commissioner,Kimberly Fobbs,DEM,610044,10,1,110,121,
Pittsburg,Corporation Commissioner,Bob Anthony,REP,610044,4,3,236,243,
Pittsburg,Corporation Commissioner,Ashley Nicole Mccray,DEM,610044,10,2,100,112,
Pittsburg,Corporation Commissioner,Jackie Short,IND,610044,1,0,20,21,
Pittsburg,U.S. House,Richard Castaldo,LIB,610044,0,0,1,1,2
Pittsburg,U.S. House,Markwayne Mullin,REP,610044,5,4,259,268,2
Pittsburg,U.S. House,Jason Nichols,DEM,610044,10,1,87,98,2
Pittsburg,U.S. House,John Foreman,IND,610044,0,0,14,14,2
Pittsburg,State House,Jim Grego,REP,610044,3,4,219,226,17
Pittsburg,State House,Peggy Defrange,DEM,610044,12,1,140,153,17
Pittsburg,Governor,Chris Powell,LIB,610045,0,0,2,2,
Pittsburg,Governor,Kevin Stitt,REP,610045,0,0,2,2,
Pittsburg,Governor,Drew Edmondson,DEM,610045,0,2,3,5,
Pittsburg,Lieutenant Governor,Matt Pinnell,REP,610045,0,0,5,5,
Pittsburg,Lieutenant Governor,Anastasia Pittman,DEM,610045,0,2,2,4,
Pittsburg,Lieutenant Governor,Ivan Holmes,IND,610045,0,0,0,0,
Pittsburg,State Auditor,John Yeutter,LIB,610045,0,2,1,3,
Pittsburg,State Auditor,Cindy Byrd,REP,610045,0,0,5,5,
Pittsburg,Attorney General,Mike Hunter,REP,610045,0,0,6,6,
Pittsburg,Attorney General,Mark Myles,DEM,610045,0,2,1,3,
Pittsburg,State Treasurer,Randy Mcdaniel,REP,610045,0,0,6,6,
Pittsburg,State Treasurer,Charles De Coune,IND,610045,0,2,0,2,
Pittsburg,Superintendent of Public Instruction,Joy Hofmeister,REP,610045,0,0,1,1,
Pittsburg,Superintendent of Public Instruction,John Cox,DEM,610045,0,2,5,7,
Pittsburg,Superintendent of Public Instruction,Larry Huff,IND,610045,0,0,1,1,
Pittsburg,Commissioner of Labor,Leslie Osborn,REP,610045,0,0,5,5,
Pittsburg,Commissioner of Labor,Fred Dorrell,DEM,610045,0,2,2,4,
Pittsburg,Commissioner of Labor,Brandt Dismukes,IND,610045,0,0,0,0,
Pittsburg,Insurance Commissioner,Glen Mulready,REP,610045,0,0,6,6,
Pittsburg,Insurance Commissioner,Kimberly Fobbs,DEM,610045,0,2,1,3,
Pittsburg,Corporation Commissioner,Bob Anthony,REP,610045,0,0,7,7,
Pittsburg,Corporation Commissioner,Ashley Nicole Mccray,DEM,610045,0,2,0,2,
Pittsburg,Corporation Commissioner,Jackie Short,IND,610045,0,0,0,0,
Pittsburg,U.S. House,Richard Castaldo,LIB,610045,0,0,0,0,2
Pittsburg,U.S. House,Markwayne Mullin,REP,610045,0,0,6,6,2
Pittsburg,U.S. House,Jason Nichols,DEM,610045,0,2,1,3,2
Pittsburg,U.S. House,John Foreman,IND,610045,0,0,0,0,2
Pittsburg,State House,Jim Grego,REP,610045,0,0,5,5,17
Pittsburg,State House,Peggy Defrange,DEM,610045,0,2,2,4,17
Pittsburg,Governor,Chris Powell,LIB,610046,0,1,6,7,
Pittsburg,Governor,Kevin Stitt,REP,610046,3,19,106,128,
Pittsburg,Governor,Drew Edmondson,DEM,610046,0,12,45,57,
Pittsburg,Lieutenant Governor,Matt Pinnell,REP,610046,3,21,116,140,
Pittsburg,Lieutenant Governor,Anastasia Pittman,DEM,610046,0,10,35,45,
Pittsburg,Lieutenant Governor,Ivan Holmes,IND,610046,0,0,4,4,
Pittsburg,State Auditor,John Yeutter,LIB,610046,0,9,26,35,
Pittsburg,State Auditor,Cindy Byrd,REP,610046,3,23,121,147,
Pittsburg,Attorney General,Mike Hunter,REP,610046,3,20,116,139,
Pittsburg,Attorney General,Mark Myles,DEM,610046,0,11,39,50,
Pittsburg,State Treasurer,Randy Mcdaniel,REP,610046,3,22,114,139,
Pittsburg,State Treasurer,Charles De Coune,IND,610046,0,9,31,40,
Pittsburg,Superintendent of Public Instruction,Joy Hofmeister,REP,610046,3,12,89,104,
Pittsburg,Superintendent of Public Instruction,John Cox,DEM,610046,0,16,51,67,
Pittsburg,Superintendent of Public Instruction,Larry Huff,IND,610046,0,3,15,18,
Pittsburg,Commissioner of Labor,Leslie Osborn,REP,610046,3,17,104,124,
Pittsburg,Commissioner of Labor,Fred Dorrell,DEM,610046,0,13,42,55,
Pittsburg,Commissioner of Labor,Brandt Dismukes,IND,610046,0,1,9,10,
Pittsburg,Insurance Commissioner,Glen Mulready,REP,610046,3,19,110,132,
Pittsburg,Insurance Commissioner,Kimberly Fobbs,DEM,610046,0,11,45,56,
Pittsburg,Corporation Commissioner,Bob Anthony,REP,610046,3,20,107,130,
Pittsburg,Corporation Commissioner,Ashley Nicole Mccray,DEM,610046,0,10,41,51,
Pittsburg,Corporation Commissioner,Jackie Short,IND,610046,0,1,8,9,
Pittsburg,U.S. House,Richard Castaldo,LIB,610046,0,0,1,1,2
Pittsburg,U.S. House,Markwayne Mullin,REP,610046,3,20,119,142,2
Pittsburg,U.S. House,Jason Nichols,DEM,610046,0,9,33,42,2
Pittsburg,U.S. House,John Foreman,IND,610046,0,1,4,5,2
Pittsburg,State House,David Smith,REP,610046,1,14,81,96,18
Pittsburg,State House,Donnie Condit,DEM,610046,2,18,74,94,18
Pittsburg,Governor,Chris Powell,LIB,610047,1,0,11,12,
Pittsburg,Governor,Kevin Stitt,REP,610047,5,3,191,199,
Pittsburg,Governor,Drew Edmondson,DEM,610047,2,13,107,122,
Pittsburg,Lieutenant Governor,Matt Pinnell,REP,610047,4,7,194,205,
Pittsburg,Lieutenant Governor,Anastasia Pittman,DEM,610047,1,7,102,110,
Pittsburg,Lieutenant Governor,Ivan Holmes,IND,610047,3,1,12,16,
Pittsburg,State Auditor,John Yeutter,LIB,610047,1,5,57,63,
Pittsburg,State Auditor,Cindy Byrd,REP,610047,6,11,234,251,
Pittsburg,Attorney General,Mike Hunter,REP,610047,2,9,214,225,
Pittsburg,Attorney General,Mark Myles,DEM,610047,6,6,93,105,
Pittsburg,State Treasurer,Randy Mcdaniel,REP,610047,2,8,229,239,
Pittsburg,State Treasurer,Charles De Coune,IND,610047,5,8,60,73,
Pittsburg,Superintendent of Public Instruction,Joy Hofmeister,REP,610047,2,8,171,181,
Pittsburg,Superintendent of Public Instruction,John Cox,DEM,610047,6,8,108,122,
Pittsburg,Superintendent of Public Instruction,Larry Huff,IND,610047,0,0,30,30,
Pittsburg,Commissioner of Labor,Leslie Osborn,REP,610047,2,6,191,199,
Pittsburg,Commissioner of Labor,Fred Dorrell,DEM,610047,5,10,100,115,
Pittsburg,Commissioner of Labor,Brandt Dismukes,IND,610047,1,0,15,16,
Pittsburg,Insurance Commissioner,Glen Mulready,REP,610047,4,6,195,205,
Pittsburg,Insurance Commissioner,Kimberly Fobbs,DEM,610047,4,10,109,123,
Pittsburg,Corporation Commissioner,Bob Anthony,REP,610047,4,9,186,199,
Pittsburg,Corporation Commissioner,Ashley Nicole Mccray,DEM,610047,3,7,102,112,
Pittsburg,Corporation Commissioner,Jackie Short,IND,610047,1,0,18,19,
Pittsburg,U.S. House,Richard Castaldo,LIB,610047,0,0,3,3,2
Pittsburg,U.S. House,Markwayne Mullin,REP,610047,5,9,214,228,2
Pittsburg,U.S. House,Jason Nichols,DEM,610047,3,7,88,98,2
Pittsburg,U.S. House,John Foreman,IND,610047,0,0,4,4,2
Pittsburg,State House,Jim Grego,REP,610047,5,6,186,197,17
Pittsburg,State House,Peggy Defrange,DEM,610047,3,10,126,139,17
Pittsburg,Governor,Chris Powell,LIB,610048,0,0,1,1,
Pittsburg,Governor,Kevin Stitt,REP,610048,0,3,68,71,
Pittsburg,Governor,Drew Edmondson,DEM,610048,0,3,25,28,
Pittsburg,Lieutenant Governor,Matt Pinnell,REP,610048,0,3,67,70,
Pittsburg,Lieutenant Governor,Anastasia Pittman,DEM,610048,0,3,23,26,
Pittsburg,Lieutenant Governor,Ivan Holmes,IND,610048,0,0,4,4,
Pittsburg,State Auditor,John Yeutter,LIB,610048,0,0,13,13,
Pittsburg,State Auditor,Cindy Byrd,REP,610048,0,3,73,76,
Pittsburg,Attorney General,Mike Hunter,REP,610048,0,3,70,73,
Pittsburg,Attorney General,Mark Myles,DEM,610048,0,3,23,26,
Pittsburg,State Treasurer,Randy Mcdaniel,REP,610048,0,3,73,76,
Pittsburg,State Treasurer,Charles De Coune,IND,610048,0,0,13,13,
Pittsburg,Superintendent of Public Instruction,Joy Hofmeister,REP,610048,0,2,57,59,
Pittsburg,Superintendent of Public Instruction,John Cox,DEM,610048,0,4,30,34,
Pittsburg,Superintendent of Public Instruction,Larry Huff,IND,610048,0,0,6,6,
Pittsburg,Commissioner of Labor,Leslie Osborn,REP,610048,0,2,61,63,
Pittsburg,Commissioner of Labor,Fred Dorrell,DEM,610048,0,3,27,30,
Pittsburg,Commissioner of Labor,Brandt Dismukes,IND,610048,0,1,5,6,
Pittsburg,Insurance Commissioner,Glen Mulready,REP,610048,0,2,68,70,
Pittsburg,Insurance Commissioner,Kimberly Fobbs,DEM,610048,0,4,25,29,
Pittsburg,Corporation Commissioner,Bob Anthony,REP,610048,0,1,65,66,
Pittsburg,Corporation Commissioner,Ashley Nicole Mccray,DEM,610048,0,4,24,28,
Pittsburg,Corporation Commissioner,Jackie Short,IND,610048,0,1,5,6,
Pittsburg,U.S. House,Richard Castaldo,LIB,610048,0,0,3,3,2
Pittsburg,U.S. House,Markwayne Mullin,REP,610048,0,1,67,68,2
Pittsburg,U.S. House,Jason Nichols,DEM,610048,0,4,21,25,2
Pittsburg,U.S. House,John Foreman,IND,610048,0,1,3,4,2
Pittsburg,State House,David Smith,REP,610048,0,3,53,56,18
Pittsburg,State House,Donnie Condit,DEM,610048,0,3,41,44,18
Pittsburg,Governor,Chris Powell,LIB,610049,0,0,16,16,
Pittsburg,Governor,Kevin Stitt,REP,610049,4,19,228,251,
Pittsburg,Governor,Drew Edmondson,DEM,610049,6,23,97,126,
Pittsburg,Lieutenant Governor,Matt Pinnell,REP,610049,3,23,260,286,
Pittsburg,Lieutenant Governor,Anastasia Pittman,DEM,610049,7,18,64,89,
Pittsburg,Lieutenant Governor,Ivan Holmes,IND,610049,0,0,12,12,
Pittsburg,State Auditor,John Yeutter,LIB,610049,4,5,54,63,
Pittsburg,State Auditor,Cindy Byrd,REP,610049,5,30,269,304,
Pittsburg,Attorney General,Mike Hunter,REP,610049,6,24,258,288,
Pittsburg,Attorney General,Mark Myles,DEM,610049,4,16,76,96,
Pittsburg,State Treasurer,Randy Mcdaniel,REP,610049,5,25,266,296,
Pittsburg,State Treasurer,Charles De Coune,IND,610049,4,10,58,72,
Pittsburg,Superintendent of Public Instruction,Joy Hofmeister,REP,610049,4,21,204,229,
Pittsburg,Superintendent of Public Instruction,John Cox,DEM,610049,5,20,100,125,
Pittsburg,Superintendent of Public Instruction,Larry Huff,IND,610049,1,1,34,36,
Pittsburg,Commissioner of Labor,Leslie Osborn,REP,610049,4,21,241,266,
Pittsburg,Commissioner of Labor,Fred Dorrell,DEM,610049,5,17,74,96,
Pittsburg,Commissioner of Labor,Brandt Dismukes,IND,610049,1,1,18,20,
Pittsburg,Insurance Commissioner,Glen Mulready,REP,610049,6,26,253,285,
Pittsburg,Insurance Commissioner,Kimberly Fobbs,DEM,610049,4,16,80,100,
Pittsburg,Corporation Commissioner,Bob Anthony,REP,610049,6,20,234,260,
Pittsburg,Corporation Commissioner,Ashley Nicole Mccray,DEM,610049,4,18,70,92,
Pittsburg,Corporation Commissioner,Jackie Short,IND,610049,0,1,28,29,
Pittsburg,U.S. House,Richard Castaldo,LIB,610049,0,0,3,3,2
Pittsburg,U.S. House,Markwayne Mullin,REP,610049,6,24,254,284,2
Pittsburg,U.S. House,Jason Nichols,DEM,610049,3,17,66,86,2
Pittsburg,U.S. House,John Foreman,IND,610049,1,1,15,17,2
Pittsburg,State House,David Smith,REP,610049,4,20,192,216,18
Pittsburg,State House,Donnie Condit,DEM,610049,6,23,142,171,18
Pittsburg,Governor,Chris Powell,LIB,610051,0,0,8,8,
Pittsburg,Governor,Kevin Stitt,REP,610051,0,5,122,127,
Pittsburg,Governor,Drew Edmondson,DEM,610051,4,0,47,51,
Pittsburg,Lieutenant Governor,Matt Pinnell,REP,610051,0,5,132,137,
Pittsburg,Lieutenant Governor,Anastasia Pittman,DEM,610051,4,0,40,44,
Pittsburg,Lieutenant Governor,Ivan Holmes,IND,610051,0,0,5,5,
Pittsburg,State Auditor,John Yeutter,LIB,610051,0,1,27,28,
Pittsburg,State Auditor,Cindy Byrd,REP,610051,1,4,136,141,
Pittsburg,Attorney General,Mike Hunter,REP,610051,0,5,128,133,
Pittsburg,Attorney General,Mark Myles,DEM,610051,4,0,47,51,
Pittsburg,State Treasurer,Randy Mcdaniel,REP,610051,0,5,134,139,
Pittsburg,State Treasurer,Charles De Coune,IND,610051,1,0,30,31,
Pittsburg,Superintendent of Public Instruction,Joy Hofmeister,REP,610051,0,4,120,124,
Pittsburg,Superintendent of Public Instruction,John Cox,DEM,610051,4,1,44,49,
Pittsburg,Superintendent of Public Instruction,Larry Huff,IND,610051,0,0,13,13,
Pittsburg,Commissioner of Labor,Leslie Osborn,REP,610051,0,5,114,119,
Pittsburg,Commissioner of Labor,Fred Dorrell,DEM,610051,4,0,48,52,
Pittsburg,Commissioner of Labor,Brandt Dismukes,IND,610051,0,0,15,15,
Pittsburg,Insurance Commissioner,Glen Mulready,REP,610051,0,5,123,128,
Pittsburg,Insurance Commissioner,Kimberly Fobbs,DEM,610051,4,0,54,58,
Pittsburg,Corporation Commissioner,Bob Anthony,REP,610051,0,5,125,130,
Pittsburg,Corporation Commissioner,Ashley Nicole Mccray,DEM,610051,4,0,42,46,
Pittsburg,Corporation Commissioner,Jackie Short,IND,610051,0,0,9,9,
Pittsburg,U.S. House,Richard Castaldo,LIB,610051,0,0,3,3,2
Pittsburg,U.S. House,Markwayne Mullin,REP,610051,0,5,127,132,2
Pittsburg,U.S. House,Jason Nichols,DEM,610051,4,0,38,42,2
Pittsburg,U.S. House,John Foreman,IND,610051,0,0,8,8,2
Pittsburg,State House,Jim Grego,REP,610051,0,5,115,120,17
Pittsburg,State House,Peggy Defrange,DEM,610051,4,0,61,65,17
Pittsburg,Governor,Chris Powell,LIB,610052,0,0,0,0,
Pittsburg,Governor,Kevin Stitt,REP,610052,0,1,10,11,
Pittsburg,Governor,Drew Edmondson,DEM,610052,0,0,2,2,
Pittsburg,Lieutenant Governor,Matt Pinnell,REP,610052,0,1,11,12,
Pittsburg,Lieutenant Governor,Anastasia Pittman,DEM,610052,0,0,1,1,
Pittsburg,Lieutenant Governor,Ivan Holmes,IND,610052,0,0,0,0,
Pittsburg,State Auditor,John Yeutter,LIB,610052,0,0,1,1,
Pittsburg,State Auditor,Cindy Byrd,REP,610052,0,1,11,12,
Pittsburg,Attorney General,Mike Hunter,REP,610052,0,1,11,12,
Pittsburg,Attorney General,Mark Myles,DEM,610052,0,0,1,1,
Pittsburg,State Treasurer,Randy Mcdaniel,REP,610052,0,1,11,12,
Pittsburg,State Treasurer,Charles De Coune,IND,610052,0,0,1,1,
Pittsburg,Superintendent of Public Instruction,Joy Hofmeister,REP,610052,0,1,10,11,
Pittsburg,Superintendent of Public Instruction,John Cox,DEM,610052,0,0,2,2,
Pittsburg,Superintendent of Public Instruction,Larry Huff,IND,610052,0,0,0,0,
Pittsburg,Commissioner of Labor,Leslie Osborn,REP,610052,0,1,11,12,
Pittsburg,Commissioner of Labor,Fred Dorrell,DEM,610052,0,0,1,1,
Pittsburg,Commissioner of Labor,Brandt Dismukes,IND,610052,0,0,0,0,
Pittsburg,Insurance Commissioner,Glen Mulready,REP,610052,0,1,11,12,
Pittsburg,Insurance Commissioner,Kimberly Fobbs,DEM,610052,0,0,1,1,
Pittsburg,Corporation Commissioner,Bob Anthony,REP,610052,0,1,11,12,
Pittsburg,Corporation Commissioner,Ashley Nicole Mccray,DEM,610052,0,0,1,1,
Pittsburg,Corporation Commissioner,Jackie Short,IND,610052,0,0,0,0,
Pittsburg,U.S. House,Richard Castaldo,LIB,610052,0,0,0,0,2
Pittsburg,U.S. House,Markwayne Mullin,REP,610052,0,1,11,12,2
Pittsburg,U.S. House,Jason Nichols,DEM,610052,0,0,1,1,2
Pittsburg,U.S. House,John Foreman,IND,610052,0,0,0,0,2
Pittsburg,State House,Randy Randleman,REP,610052,0,1,10,11,15
Pittsburg,State House,Judy Ross Moore,DEM,610052,0,0,2,2,15
Pittsburg,Governor,Chris Powell,LIB,610053,0,0,3,3,
Pittsburg,Governor,Kevin Stitt,REP,610053,0,0,41,41,
Pittsburg,Governor,Drew Edmondson,DEM,610053,0,0,12,12,
Pittsburg,Lieutenant Governor,Matt Pinnell,REP,610053,0,0,45,45,
Pittsburg,Lieutenant Governor,Anastasia Pittman,DEM,610053,0,0,11,11,
Pittsburg,Lieutenant Governor,Ivan Holmes,IND,610053,0,0,0,0,
Pittsburg,State Auditor,John Yeutter,LIB,610053,0,0,13,13,
Pittsburg,State Auditor,Cindy Byrd,REP,610053,0,0,42,42,
Pittsburg,Attorney General,Mike Hunter,REP,610053,0,0,42,42,
Pittsburg,Attorney General,Mark Myles,DEM,610053,0,0,14,14,
Pittsburg,State Treasurer,Randy Mcdaniel,REP,610053,0,0,44,44,
Pittsburg,State Treasurer,Charles De Coune,IND,610053,0,0,9,9,
Pittsburg,Superintendent of Public Instruction,Joy Hofmeister,REP,610053,0,0,39,39,
Pittsburg,Superintendent of Public Instruction,John Cox,DEM,610053,0,0,12,12,
Pittsburg,Superintendent of Public Instruction,Larry Huff,IND,610053,0,0,5,5,
Pittsburg,Commissioner of Labor,Leslie Osborn,REP,610053,0,0,43,43,
Pittsburg,Commissioner of Labor,Fred Dorrell,DEM,610053,0,0,12,12,
Pittsburg,Commissioner of Labor,Brandt Dismukes,IND,610053,0,0,1,1,
Pittsburg,Insurance Commissioner,Glen Mulready,REP,610053,0,0,40,40,
Pittsburg,Insurance Commissioner,Kimberly Fobbs,DEM,610053,0,0,16,16,
Pittsburg,Corporation Commissioner,Bob Anthony,REP,610053,0,0,38,38,
Pittsburg,Corporation Commissioner,Ashley Nicole Mccray,DEM,610053,0,0,12,12,
Pittsburg,Corporation Commissioner,Jackie Short,IND,610053,0,0,5,5,
Pittsburg,U.S. House,Richard Castaldo,LIB,610053,0,0,0,0,2
Pittsburg,U.S. House,Markwayne Mullin,REP,610053,0,0,44,44,2
Pittsburg,U.S. House,Jason Nichols,DEM,610053,0,0,10,10,2
Pittsburg,U.S. House,John Foreman,IND,610053,0,0,2,2,2
Pittsburg,State House,David Smith,REP,610053,0,0,34,34,18
Pittsburg,State House,Donnie Condit,DEM,610053,0,0,22,22,18
Pontotoc,Governor,Chris Powell,LIB,620013,0,2,24,26,
Pontotoc,Governor,Kevin Stitt,REP,620013,11,83,289,383,
Pontotoc,Governor,Drew Edmondson,DEM,620013,23,101,329,453,
Pontotoc,Lieutenant Governor,Matt Pinnell,REP,620013,14,102,340,456,
Pontotoc,Lieutenant Governor,Anastasia Pittman,DEM,620013,18,81,272,371,
Pontotoc,Lieutenant Governor,Ivan Holmes,IND,620013,1,2,25,28,
Pontotoc,State Auditor,John Yeutter,LIB,620013,7,27,146,180,
Pontotoc,State Auditor,Cindy Byrd,REP,620013,25,139,451,615,
Pontotoc,Attorney General,Mike Hunter,REP,620013,15,108,384,507,
Pontotoc,Attorney General,Mark Myles,DEM,620013,19,77,252,348,
Pontotoc,State Treasurer,Randy Mcdaniel,REP,620013,20,126,426,572,
Pontotoc,State Treasurer,Charles De Coune,IND,620013,13,38,165,216,
Pontotoc,Superintendent of Public Instruction,Joy Hofmeister,REP,620013,16,114,348,478,
Pontotoc,Superintendent of Public Instruction,John Cox,DEM,620013,16,65,237,318,
Pontotoc,Superintendent of Public Instruction,Larry Huff,IND,620013,2,8,52,62,
Pontotoc,Commissioner of Labor,Leslie Osborn,REP,620013,15,103,356,474,
Pontotoc,Commissioner of Labor,Fred Dorrell,DEM,620013,18,71,231,320,
Pontotoc,Commissioner of Labor,Brandt Dismukes,IND,620013,1,6,37,44,
Pontotoc,Insurance Commissioner,Glen Mulready,REP,620013,15,101,350,466,
Pontotoc,Insurance Commissioner,Kimberly Fobbs,DEM,620013,18,80,277,375,
Pontotoc,Corporation Commissioner,Bob Anthony,REP,620013,14,108,346,468,
Pontotoc,Corporation Commissioner,Ashley Nicole Mccray,DEM,620013,19,71,244,334,
Pontotoc,Corporation Commissioner,Jackie Short,IND,620013,0,4,39,43,
Pontotoc,U.S. House,Tom Cole,REP,620013,14,119,398,531,4
Pontotoc,U.S. House,Mary Brannon,DEM,620013,19,64,215,298,4
Pontotoc,U.S. House,Ruby Peters,IND,620013,1,4,25,30,4
Pontotoc,State House,Ronny Johns,REP,620013,13,78,310,401,25
Pontotoc,State House,Daniel Manuel,DEM,620013,20,101,299,420,25
Pontotoc,State House,Gary Rhynes,IND,620013,1,8,32,41,25
Pontotoc,Governor,Chris Powell,LIB,620016,1,2,26,29,
Pontotoc,Governor,Kevin Stitt,REP,620016,19,149,428,596,
Pontotoc,Governor,Drew Edmondson,DEM,620016,23,129,399,551,
Pontotoc,Lieutenant Governor,Matt Pinnell,REP,620016,24,167,523,714,
Pontotoc,Lieutenant Governor,Anastasia Pittman,DEM,620016,18,106,290,414,
Pontotoc,Lieutenant Governor,Ivan Holmes,IND,620016,1,1,31,33,
Pontotoc,State Auditor,John Yeutter,LIB,620016,8,43,137,188,
Pontotoc,State Auditor,Cindy Byrd,REP,620016,29,213,656,898,
Pontotoc,Attorney General,Mike Hunter,REP,620016,25,179,558,762,
Pontotoc,Attorney General,Mark Myles,DEM,620016,16,96,280,392,
Pontotoc,State Treasurer,Randy Mcdaniel,REP,620016,26,192,624,842,
Pontotoc,State Treasurer,Charles De Coune,IND,620016,10,64,174,248,
Pontotoc,Superintendent of Public Instruction,Joy Hofmeister,REP,620016,24,166,531,721,
Pontotoc,Superintendent of Public Instruction,John Cox,DEM,620016,16,93,256,365,
Pontotoc,Superintendent of Public Instruction,Larry Huff,IND,620016,2,15,56,73,
Pontotoc,Commissioner of Labor,Leslie Osborn,REP,620016,23,167,517,707,
Pontotoc,Commissioner of Labor,Fred Dorrell,DEM,620016,15,96,276,387,
Pontotoc,Commissioner of Labor,Brandt Dismukes,IND,620016,3,7,33,43,
Pontotoc,Insurance Commissioner,Glen Mulready,REP,620016,22,162,512,696,
Pontotoc,Insurance Commissioner,Kimberly Fobbs,DEM,620016,20,108,310,438,
Pontotoc,Corporation Commissioner,Bob Anthony,REP,620016,27,168,499,694,
Pontotoc,Corporation Commissioner,Ashley Nicole Mccray,DEM,620016,16,91,286,393,
Pontotoc,Corporation Commissioner,Jackie Short,IND,620016,0,11,41,52,
Pontotoc,U.S. House,Tom Cole,REP,620016,28,184,588,800,4
Pontotoc,U.S. House,Mary Brannon,DEM,620016,15,87,231,333,4
Pontotoc,U.S. House,Ruby Peters,IND,620016,0,3,27,30,4
Pontotoc,State House,Ronny Johns,REP,620016,22,149,451,622,25
Pontotoc,State House,Daniel Manuel,DEM,620016,19,121,366,506,25
Pontotoc,State House,Gary Rhynes,IND,620016,2,9,36,47,25
Pontotoc,Governor,Chris Powell,LIB,620022,0,1,13,14,
Pontotoc,Governor,Kevin Stitt,REP,620022,14,40,219,273,
Pontotoc,Governor,Drew Edmondson,DEM,620022,17,60,297,374,
Pontotoc,Lieutenant Governor,Matt Pinnell,REP,620022,16,45,264,325,
Pontotoc,Lieutenant Governor,Anastasia Pittman,DEM,620022,15,51,234,300,
Pontotoc,Lieutenant Governor,Ivan Holmes,IND,620022,0,4,25,29,
Pontotoc,State Auditor,John Yeutter,LIB,620022,7,17,119,143,
Pontotoc,State Auditor,Cindy Byrd,REP,620022,20,76,367,463,
Pontotoc,Attorney General,Mike Hunter,REP,620022,13,54,281,348,
Pontotoc,Attorney General,Mark Myles,DEM,620022,17,46,241,304,
Pontotoc,State Treasurer,Randy Mcdaniel,REP,620022,19,60,339,418,
Pontotoc,State Treasurer,Charles De Coune,IND,620022,8,30,144,182,
Pontotoc,Superintendent of Public Instruction,Joy Hofmeister,REP,620022,15,55,282,352,
Pontotoc,Superintendent of Public Instruction,John Cox,DEM,620022,15,43,213,271,
Pontotoc,Superintendent of Public Instruction,Larry Huff,IND,620022,0,3,30,33,
Pontotoc,Commissioner of Labor,Leslie Osborn,REP,620022,16,50,277,343,
Pontotoc,Commissioner of Labor,Fred Dorrell,DEM,620022,13,47,213,273,
Pontotoc,Commissioner of Labor,Brandt Dismukes,IND,620022,1,2,18,21,
Pontotoc,Insurance Commissioner,Glen Mulready,REP,620022,15,45,265,325,
Pontotoc,Insurance Commissioner,Kimberly Fobbs,DEM,620022,15,53,244,312,
Pontotoc,Corporation Commissioner,Bob Anthony,REP,620022,16,54,279,349,
Pontotoc,Corporation Commissioner,Ashley Nicole Mccray,DEM,620022,13,43,209,265,
Pontotoc,Corporation Commissioner,Jackie Short,IND,620022,1,2,28,31,
Pontotoc,U.S. House,Tom Cole,REP,620022,17,53,309,379,4
Pontotoc,U.S. House,Mary Brannon,DEM,620022,14,43,201,258,4
Pontotoc,U.S. House,Ruby Peters,IND,620022,0,4,16,20,4
Pontotoc,State House,Ronny Johns,REP,620022,12,38,223,273,25
Pontotoc,State House,Daniel Manuel,DEM,620022,16,61,278,355,25
Pontotoc,State House,Gary Rhynes,IND,620022,2,3,26,31,25
Pontotoc,Governor,Chris Powell,LIB,620025,1,4,27,32,
Pontotoc,Governor,Kevin Stitt,REP,620025,14,101,473,588,
Pontotoc,Governor,Drew Edmondson,DEM,620025,14,83,377,474,
Pontotoc,Lieutenant Governor,Matt Pinnell,REP,620025,16,122,557,695,
Pontotoc,Lieutenant Governor,Anastasia Pittman,DEM,620025,12,56,282,350,
Pontotoc,Lieutenant Governor,Ivan Holmes,IND,620025,0,7,30,37,
Pontotoc,State Auditor,John Yeutter,LIB,620025,7,23,134,164,
Pontotoc,State Auditor,Cindy Byrd,REP,620025,17,148,688,853,
Pontotoc,Attorney General,Mike Hunter,REP,620025,14,131,584,729,
Pontotoc,Attorney General,Mark Myles,DEM,620025,14,56,282,352,
Pontotoc,State Treasurer,Randy Mcdaniel,REP,620025,17,141,649,807,
Pontotoc,State Treasurer,Charles De Coune,IND,620025,8,30,167,205,
Pontotoc,Superintendent of Public Instruction,Joy Hofmeister,REP,620025,16,119,573,708,
Pontotoc,Superintendent of Public Instruction,John Cox,DEM,620025,11,60,242,313,
Pontotoc,Superintendent of Public Instruction,Larry Huff,IND,620025,1,9,53,63,
Pontotoc,Commissioner of Labor,Leslie Osborn,REP,620025,15,125,551,691,
Pontotoc,Commissioner of Labor,Fred Dorrell,DEM,620025,12,56,268,336,
Pontotoc,Commissioner of Labor,Brandt Dismukes,IND,620025,1,6,37,44,
Pontotoc,Insurance Commissioner,Glen Mulready,REP,620025,13,122,541,676,
Pontotoc,Insurance Commissioner,Kimberly Fobbs,DEM,620025,15,64,319,398,
Pontotoc,Corporation Commissioner,Bob Anthony,REP,620025,15,125,546,686,
Pontotoc,Corporation Commissioner,Ashley Nicole Mccray,DEM,620025,11,56,273,340,
Pontotoc,Corporation Commissioner,Jackie Short,IND,620025,2,6,45,53,
Pontotoc,U.S. House,Tom Cole,REP,620025,14,135,618,767,4
Pontotoc,U.S. House,Mary Brannon,DEM,620025,13,49,228,290,4
Pontotoc,U.S. House,Ruby Peters,IND,620025,1,3,25,29,4
Pontotoc,State House,Ronny Johns,REP,620025,14,89,402,505,25
Pontotoc,State House,Daniel Manuel,DEM,620025,14,90,429,533,25
Pontotoc,State House,Gary Rhynes,IND,620025,0,9,40,49,25
Pontotoc,Governor,Chris Powell,LIB,620031,0,3,45,48,
Pontotoc,Governor,Kevin Stitt,REP,620031,3,67,304,374,
Pontotoc,Governor,Drew Edmondson,DEM,620031,13,95,399,507,
Pontotoc,Lieutenant Governor,Matt Pinnell,REP,620031,5,75,340,420,
Pontotoc,Lieutenant Governor,Anastasia Pittman,DEM,620031,10,79,354,443,
Pontotoc,Lieutenant Governor,Ivan Holmes,IND,620031,1,7,43,51,
Pontotoc,State Auditor,John Yeutter,LIB,620031,6,36,217,259,
Pontotoc,State Auditor,Cindy Byrd,REP,620031,7,105,459,571,
Pontotoc,Attorney General,Mike Hunter,REP,620031,7,86,378,471,
Pontotoc,Attorney General,Mark Myles,DEM,620031,8,75,358,441,
Pontotoc,State Treasurer,Randy Mcdaniel,REP,620031,6,104,418,528,
Pontotoc,State Treasurer,Charles De Coune,IND,620031,7,40,253,300,
Pontotoc,Superintendent of Public Instruction,Joy Hofmeister,REP,620031,8,84,332,424,
Pontotoc,Superintendent of Public Instruction,John Cox,DEM,620031,7,69,323,399,
Pontotoc,Superintendent of Public Instruction,Larry Huff,IND,620031,1,10,82,93,
Pontotoc,Commissioner of Labor,Leslie Osborn,REP,620031,9,79,350,438,
Pontotoc,Commissioner of Labor,Fred Dorrell,DEM,620031,7,76,331,414,
Pontotoc,Commissioner of Labor,Brandt Dismukes,IND,620031,0,5,53,58,
Pontotoc,Insurance Commissioner,Glen Mulready,REP,620031,5,74,340,419,
Pontotoc,Insurance Commissioner,Kimberly Fobbs,DEM,620031,10,87,392,489,
Pontotoc,Corporation Commissioner,Bob Anthony,REP,620031,6,73,331,410,
Pontotoc,Corporation Commissioner,Ashley Nicole Mccray,DEM,620031,9,80,347,436,
Pontotoc,Corporation Commissioner,Jackie Short,IND,620031,1,8,60,69,
Pontotoc,U.S. House,Tom Cole,REP,620031,7,95,379,481,4
Pontotoc,U.S. House,Mary Brannon,DEM,620031,9,63,324,396,4
Pontotoc,U.S. House,Ruby Peters,IND,620031,0,3,40,43,4
Pontotoc,State House,Ronny Johns,REP,620031,5,62,339,406,25
Pontotoc,State House,Daniel Manuel,DEM,620031,11,91,363,465,25
Pontotoc,State House,Gary Rhynes,IND,620031,0,10,47,57,25
Pontotoc,Governor,Chris Powell,LIB,620051,0,0,7,7,
Pontotoc,Governor,Kevin Stitt,REP,620051,3,7,183,193,
Pontotoc,Governor,Drew Edmondson,DEM,620051,0,5,114,119,
Pontotoc,Lieutenant Governor,Matt Pinnell,REP,620051,3,9,208,220,
Pontotoc,Lieutenant Governor,Anastasia Pittman,DEM,620051,0,3,84,87,
Pontotoc,Lieutenant Governor,Ivan Holmes,IND,620051,0,0,6,6,
Pontotoc,State Auditor,John Yeutter,LIB,620051,0,4,39,43,
Pontotoc,State Auditor,Cindy Byrd,REP,620051,3,8,247,258,
Pontotoc,Attorney General,Mike Hunter,REP,620051,3,9,214,226,
Pontotoc,Attorney General,Mark Myles,DEM,620051,0,3,87,90,
Pontotoc,State Treasurer,Randy Mcdaniel,REP,620051,3,8,238,249,
Pontotoc,State Treasurer,Charles De Coune,IND,620051,0,4,46,50,
Pontotoc,Superintendent of Public Instruction,Joy Hofmeister,REP,620051,2,9,205,216,
Pontotoc,Superintendent of Public Instruction,John Cox,DEM,620051,1,3,73,77,
Pontotoc,Superintendent of Public Instruction,Larry Huff,IND,620051,0,0,21,21,
Pontotoc,Commissioner of Labor,Leslie Osborn,REP,620051,2,10,210,222,
Pontotoc,Commissioner of Labor,Fred Dorrell,DEM,620051,1,2,74,77,
Pontotoc,Commissioner of Labor,Brandt Dismukes,IND,620051,0,0,14,14,
Pontotoc,Insurance Commissioner,Glen Mulready,REP,620051,3,8,202,213,
Pontotoc,Insurance Commissioner,Kimberly Fobbs,DEM,620051,0,3,94,97,
Pontotoc,Corporation Commissioner,Bob Anthony,REP,620051,2,8,202,212,
Pontotoc,Corporation Commissioner,Ashley Nicole Mccray,DEM,620051,0,3,78,81,
Pontotoc,Corporation Commissioner,Jackie Short,IND,620051,1,1,18,20,
Pontotoc,U.S. House,Tom Cole,REP,620051,3,9,234,246,4
Pontotoc,U.S. House,Mary Brannon,DEM,620051,0,3,63,66,4
Pontotoc,U.S. House,Ruby Peters,IND,620051,0,0,6,6,4
Pontotoc,State House,Ronny Johns,REP,620051,2,7,160,169,25
Pontotoc,State House,Daniel Manuel,DEM,620051,1,5,125,131,25
Pontotoc,State House,Gary Rhynes,IND,620051,0,0,20,20,25
Pontotoc,Governor,Chris Powell,LIB,620052,0,1,14,15,
Pontotoc,Governor,Kevin Stitt,REP,620052,4,26,185,215,
Pontotoc,Governor,Drew Edmondson,DEM,620052,10,40,196,246,
Pontotoc,Lieutenant Governor,Matt Pinnell,REP,620052,7,30,212,249,
Pontotoc,Lieutenant Governor,Anastasia Pittman,DEM,620052,6,31,157,194,
Pontotoc,Lieutenant Governor,Ivan Holmes,IND,620052,1,3,17,21,
Pontotoc,State Auditor,John Yeutter,LIB,620052,3,11,94,108,
Pontotoc,State Auditor,Cindy Byrd,REP,620052,9,48,274,331,
Pontotoc,Attorney General,Mike Hunter,REP,620052,9,38,225,272,
Pontotoc,Attorney General,Mark Myles,DEM,620052,5,27,166,198,
Pontotoc,State Treasurer,Randy Mcdaniel,REP,620052,7,42,254,303,
Pontotoc,State Treasurer,Charles De Coune,IND,620052,5,16,112,133,
Pontotoc,Superintendent of Public Instruction,Joy Hofmeister,REP,620052,6,37,222,265,
Pontotoc,Superintendent of Public Instruction,John Cox,DEM,620052,6,26,145,177,
Pontotoc,Superintendent of Public Instruction,Larry Huff,IND,620052,2,3,23,28,
Pontotoc,Commissioner of Labor,Leslie Osborn,REP,620052,7,34,212,253,
Pontotoc,Commissioner of Labor,Fred Dorrell,DEM,620052,6,29,154,189,
Pontotoc,Commissioner of Labor,Brandt Dismukes,IND,620052,1,2,15,18,
Pontotoc,Insurance Commissioner,Glen Mulready,REP,620052,7,32,212,251,
Pontotoc,Insurance Commissioner,Kimberly Fobbs,DEM,620052,7,33,171,211,
Pontotoc,Corporation Commissioner,Bob Anthony,REP,620052,7,32,214,253,
Pontotoc,Corporation Commissioner,Ashley Nicole Mccray,DEM,620052,5,30,152,187,
Pontotoc,Corporation Commissioner,Jackie Short,IND,620052,2,4,18,24,
Pontotoc,U.S. House,Tom Cole,REP,620052,8,37,234,279,4
Pontotoc,U.S. House,Mary Brannon,DEM,620052,5,28,140,173,4
Pontotoc,U.S. House,Ruby Peters,IND,620052,1,2,16,19,4
Pontotoc,State House,Ronny Johns,REP,620052,5,30,174,209,25
Pontotoc,State House,Daniel Manuel,DEM,620052,7,34,209,250,25
Pontotoc,State House,Gary Rhynes,IND,620052,2,3,12,17,25
Pontotoc,Governor,Chris Powell,LIB,620053,0,2,20,22,
Pontotoc,Governor,Kevin Stitt,REP,620053,23,119,437,579,
Pontotoc,Governor,Drew Edmondson,DEM,620053,21,145,372,538,
Pontotoc,Lieutenant Governor,Matt Pinnell,REP,620053,28,145,536,709,
Pontotoc,Lieutenant Governor,Anastasia Pittman,DEM,620053,16,112,263,391,
Pontotoc,Lieutenant Governor,Ivan Holmes,IND,620053,1,8,21,30,
Pontotoc,State Auditor,John Yeutter,LIB,620053,5,41,129,175,
Pontotoc,State Auditor,Cindy Byrd,REP,620053,37,200,656,893,
Pontotoc,Attorney General,Mike Hunter,REP,620053,27,161,576,764,
Pontotoc,Attorney General,Mark Myles,DEM,620053,17,103,245,365,
Pontotoc,State Treasurer,Randy Mcdaniel,REP,620053,32,179,610,821,
Pontotoc,State Treasurer,Charles De Coune,IND,620053,9,59,161,229,
Pontotoc,Superintendent of Public Instruction,Joy Hofmeister,REP,620053,28,161,537,726,
Pontotoc,Superintendent of Public Instruction,John Cox,DEM,620053,13,90,239,342,
Pontotoc,Superintendent of Public Instruction,Larry Huff,IND,620053,2,9,45,56,
Pontotoc,Commissioner of Labor,Leslie Osborn,REP,620053,26,155,535,716,
Pontotoc,Commissioner of Labor,Fred Dorrell,DEM,620053,16,93,233,342,
Pontotoc,Commissioner of Labor,Brandt Dismukes,IND,620053,2,11,36,49,
Pontotoc,Insurance Commissioner,Glen Mulready,REP,620053,25,144,527,696,
Pontotoc,Insurance Commissioner,Kimberly Fobbs,DEM,620053,18,114,284,416,
Pontotoc,Corporation Commissioner,Bob Anthony,REP,620053,26,147,536,709,
Pontotoc,Corporation Commissioner,Ashley Nicole Mccray,DEM,620053,14,103,239,356,
Pontotoc,Corporation Commissioner,Jackie Short,IND,620053,4,11,38,53,
Pontotoc,U.S. House,Tom Cole,REP,620053,32,163,596,791,4
Pontotoc,U.S. House,Mary Brannon,DEM,620053,11,97,211,319,4
Pontotoc,U.S. House,Ruby Peters,IND,620053,1,7,20,28,4
Pontotoc,State House,Ronny Johns,REP,620053,18,114,446,578,25
Pontotoc,State House,Daniel Manuel,DEM,620053,19,134,356,509,25
Pontotoc,State House,Gary Rhynes,IND,620053,8,16,27,51,25
Pontotoc,Governor,Chris Powell,LIB,620054,1,0,8,9,
Pontotoc,Governor,Kevin Stitt,REP,620054,0,7,81,88,
Pontotoc,Governor,Drew Edmondson,DEM,620054,2,3,33,38,
Pontotoc,Lieutenant Governor,Matt Pinnell,REP,620054,1,8,89,98,
Pontotoc,Lieutenant Governor,Anastasia Pittman,DEM,620054,2,2,27,31,
Pontotoc,Lieutenant Governor,Ivan Holmes,IND,620054,0,0,3,3,
Pontotoc,State Auditor,John Yeutter,LIB,620054,0,1,16,17,
Pontotoc,State Auditor,Cindy Byrd,REP,620054,1,9,98,108,
Pontotoc,Attorney General,Mike Hunter,REP,620054,1,8,87,96,
Pontotoc,Attorney General,Mark Myles,DEM,620054,2,2,30,34,
Pontotoc,State Treasurer,Randy Mcdaniel,REP,620054,1,8,97,106,
Pontotoc,State Treasurer,Charles De Coune,IND,620054,0,2,15,17,
Pontotoc,Superintendent of Public Instruction,Joy Hofmeister,REP,620054,1,8,79,88,
Pontotoc,Superintendent of Public Instruction,John Cox,DEM,620054,2,2,28,32,
Pontotoc,Superintendent of Public Instruction,Larry Huff,IND,620054,0,0,11,11,
Pontotoc,Commissioner of Labor,Leslie Osborn,REP,620054,1,9,83,93,
Pontotoc,Commissioner of Labor,Fred Dorrell,DEM,620054,2,1,27,30,
Pontotoc,Commissioner of Labor,Brandt Dismukes,IND,620054,0,0,5,5,
Pontotoc,Insurance Commissioner,Glen Mulready,REP,620054,1,8,87,96,
Pontotoc,Insurance Commissioner,Kimberly Fobbs,DEM,620054,2,2,30,34,
Pontotoc,Corporation Commissioner,Bob Anthony,REP,620054,0,8,83,91,
Pontotoc,Corporation Commissioner,Ashley Nicole Mccray,DEM,620054,2,2,26,30,
Pontotoc,Corporation Commissioner,Jackie Short,IND,620054,1,0,11,12,
Pontotoc,U.S. House,Tom Cole,REP,620054,1,9,99,109,4
Pontotoc,U.S. House,Mary Brannon,DEM,620054,2,1,18,21,4
Pontotoc,U.S. House,Ruby Peters,IND,620054,0,0,4,4,4
Pontotoc,State House,Ronny Johns,REP,620054,1,7,62,70,25
Pontotoc,State House,Daniel Manuel,DEM,620054,2,3,51,56,25
Pontotoc,State House,Gary Rhynes,IND,620054,0,0,9,9,25
Pontotoc,Governor,Chris Powell,LIB,620055,0,2,3,5,
Pontotoc,Governor,Kevin Stitt,REP,620055,3,17,90,110,
Pontotoc,Governor,Drew Edmondson,DEM,620055,3,19,48,70,
Pontotoc,Lieutenant Governor,Matt Pinnell,REP,620055,3,23,103,129,
Pontotoc,Lieutenant Governor,Anastasia Pittman,DEM,620055,2,13,34,49,
Pontotoc,Lieutenant Governor,Ivan Holmes,IND,620055,1,2,3,6,
Pontotoc,State Auditor,John Yeutter,LIB,620055,1,5,17,23,
Pontotoc,State Auditor,Cindy Byrd,REP,620055,5,28,121,154,
Pontotoc,Attorney General,Mike Hunter,REP,620055,3,21,110,134,
Pontotoc,Attorney General,Mark Myles,DEM,620055,3,16,30,49,
Pontotoc,State Treasurer,Randy Mcdaniel,REP,620055,3,25,123,151,
Pontotoc,State Treasurer,Charles De Coune,IND,620055,3,8,15,26,
Pontotoc,Superintendent of Public Instruction,Joy Hofmeister,REP,620055,3,20,97,120,
Pontotoc,Superintendent of Public Instruction,John Cox,DEM,620055,3,16,31,50,
Pontotoc,Superintendent of Public Instruction,Larry Huff,IND,620055,0,1,12,13,
Pontotoc,Commissioner of Labor,Leslie Osborn,REP,620055,3,21,101,125,
Pontotoc,Commissioner of Labor,Fred Dorrell,DEM,620055,2,15,33,50,
Pontotoc,Commissioner of Labor,Brandt Dismukes,IND,620055,1,1,5,7,
Pontotoc,Insurance Commissioner,Glen Mulready,REP,620055,3,23,102,128,
Pontotoc,Insurance Commissioner,Kimberly Fobbs,DEM,620055,3,14,36,53,
Pontotoc,Corporation Commissioner,Bob Anthony,REP,620055,3,19,107,129,
Pontotoc,Corporation Commissioner,Ashley Nicole Mccray,DEM,620055,2,15,30,47,
Pontotoc,Corporation Commissioner,Jackie Short,IND,620055,1,3,4,8,
Pontotoc,U.S. House,Tom Cole,REP,620055,4,26,112,142,4
Pontotoc,U.S. House,Mary Brannon,DEM,620055,2,12,25,39,4
Pontotoc,U.S. House,Ruby Peters,IND,620055,0,0,3,3,4
Pontotoc,State House,Ronny Johns,REP,620055,3,23,81,107,25
Pontotoc,State House,Daniel Manuel,DEM,620055,0,14,49,63,25
Pontotoc,State House,Gary Rhynes,IND,620055,1,1,10,12,25
Pontotoc,Governor,Chris Powell,LIB,620056,0,0,9,9,
Pontotoc,Governor,Kevin Stitt,REP,620056,2,7,129,138,
Pontotoc,Governor,Drew Edmondson,DEM,620056,4,8,91,103,
Pontotoc,Lieutenant Governor,Matt Pinnell,REP,620056,3,11,143,157,
Pontotoc,Lieutenant Governor,Anastasia Pittman,DEM,620056,3,4,72,79,
Pontotoc,Lieutenant Governor,Ivan Holmes,IND,620056,0,0,12,12,
Pontotoc,State Auditor,John Yeutter,LIB,620056,1,2,42,45,
Pontotoc,State Auditor,Cindy Byrd,REP,620056,5,11,169,185,
Pontotoc,Attorney General,Mike Hunter,REP,620056,3,10,146,159,
Pontotoc,Attorney General,Mark Myles,DEM,620056,3,5,80,88,
Pontotoc,State Treasurer,Randy Mcdaniel,REP,620056,3,12,173,188,
Pontotoc,State Treasurer,Charles De Coune,IND,620056,3,1,38,42,
Pontotoc,Superintendent of Public Instruction,Joy Hofmeister,REP,620056,4,9,137,150,
Pontotoc,Superintendent of Public Instruction,John Cox,DEM,620056,2,5,74,81,
Pontotoc,Superintendent of Public Instruction,Larry Huff,IND,620056,0,0,15,15,
Pontotoc,Commissioner of Labor,Leslie Osborn,REP,620056,3,7,147,157,
Pontotoc,Commissioner of Labor,Fred Dorrell,DEM,620056,3,8,65,76,
Pontotoc,Commissioner of Labor,Brandt Dismukes,IND,620056,0,0,12,12,
Pontotoc,Insurance Commissioner,Glen Mulready,REP,620056,3,10,148,161,
Pontotoc,Insurance Commissioner,Kimberly Fobbs,DEM,620056,3,5,78,86,
Pontotoc,Corporation Commissioner,Bob Anthony,REP,620056,3,10,135,148,
Pontotoc,Corporation Commissioner,Ashley Nicole Mccray,DEM,620056,3,5,79,87,
Pontotoc,Corporation Commissioner,Jackie Short,IND,620056,0,0,13,13,
Pontotoc,U.S. House,Tom Cole,REP,620056,2,11,164,177,4
Pontotoc,U.S. House,Mary Brannon,DEM,620056,4,4,56,64,4
Pontotoc,U.S. House,Ruby Peters,IND,620056,0,0,9,9,4
Pontotoc,State House,Ronny Johns,REP,620056,4,3,100,107,25
Pontotoc,State House,Daniel Manuel,DEM,620056,2,11,116,129,25
Pontotoc,State House,Gary Rhynes,IND,620056,0,1,13,14,25
Pontotoc,Governor,Chris Powell,LIB,620058,0,2,27,29,
Pontotoc,Governor,Kevin Stitt,REP,620058,9,30,327,366,
Pontotoc,Governor,Drew Edmondson,DEM,620058,8,40,295,343,
Pontotoc,Lieutenant Governor,Matt Pinnell,REP,620058,11,40,412,463,
Pontotoc,Lieutenant Governor,Anastasia Pittman,DEM,620058,6,29,212,247,
Pontotoc,Lieutenant Governor,Ivan Holmes,IND,620058,0,2,22,24,
Pontotoc,State Auditor,John Yeutter,LIB,620058,2,7,109,118,
Pontotoc,State Auditor,Cindy Byrd,REP,620058,12,57,511,580,
Pontotoc,Attorney General,Mike Hunter,REP,620058,12,44,428,484,
Pontotoc,Attorney General,Mark Myles,DEM,620058,5,26,211,242,
Pontotoc,State Treasurer,Randy Mcdaniel,REP,620058,12,48,487,547,
Pontotoc,State Treasurer,Charles De Coune,IND,620058,2,15,130,147,
Pontotoc,Superintendent of Public Instruction,Joy Hofmeister,REP,620058,11,44,412,467,
Pontotoc,Superintendent of Public Instruction,John Cox,DEM,620058,6,21,189,216,
Pontotoc,Superintendent of Public Instruction,Larry Huff,IND,620058,0,6,45,51,
Pontotoc,Commissioner of Labor,Leslie Osborn,REP,620058,10,42,395,447,
Pontotoc,Commissioner of Labor,Fred Dorrell,DEM,620058,6,25,203,234,
Pontotoc,Commissioner of Labor,Brandt Dismukes,IND,620058,0,2,35,37,
Pontotoc,Insurance Commissioner,Glen Mulready,REP,620058,10,40,399,449,
Pontotoc,Insurance Commissioner,Kimberly Fobbs,DEM,620058,6,30,240,276,
Pontotoc,Corporation Commissioner,Bob Anthony,REP,620058,12,42,390,444,
Pontotoc,Corporation Commissioner,Ashley Nicole Mccray,DEM,620058,5,29,211,245,
Pontotoc,Corporation Commissioner,Jackie Short,IND,620058,0,0,42,42,
Pontotoc,U.S. House,Tom Cole,REP,620058,11,52,443,506,4
Pontotoc,U.S. House,Mary Brannon,DEM,620058,5,20,173,198,4
Pontotoc,U.S. House,Ruby Peters,IND,620058,0,0,33,33,4
Pontotoc,State House,Ronny Johns,REP,620058,8,36,321,365,25
Pontotoc,State House,Daniel Manuel,DEM,620058,8,34,301,343,25
Pontotoc,State House,Gary Rhynes,IND,620058,1,2,27,30,25
Pontotoc,Governor,Chris Powell,LIB,620059,0,0,8,8,
Pontotoc,Governor,Kevin Stitt,REP,620059,6,15,256,277,
Pontotoc,Governor,Drew Edmondson,DEM,620059,6,17,146,169,
Pontotoc,Lieutenant Governor,Matt Pinnell,REP,620059,6,18,287,311,
Pontotoc,Lieutenant Governor,Anastasia Pittman,DEM,620059,5,11,98,114,
Pontotoc,Lieutenant Governor,Ivan Holmes,IND,620059,0,1,21,22,
Pontotoc,State Auditor,John Yeutter,LIB,620059,2,2,66,70,
Pontotoc,State Auditor,Cindy Byrd,REP,620059,6,24,325,355,
Pontotoc,Attorney General,Mike Hunter,REP,620059,7,19,295,321,
Pontotoc,Attorney General,Mark Myles,DEM,620059,5,12,109,126,
Pontotoc,State Treasurer,Randy Mcdaniel,REP,620059,6,20,323,349,
Pontotoc,State Treasurer,Charles De Coune,IND,620059,2,5,65,72,
Pontotoc,Superintendent of Public Instruction,Joy Hofmeister,REP,620059,6,21,267,294,
Pontotoc,Superintendent of Public Instruction,John Cox,DEM,620059,5,8,99,112,
Pontotoc,Superintendent of Public Instruction,Larry Huff,IND,620059,0,2,40,42,
Pontotoc,Commissioner of Labor,Leslie Osborn,REP,620059,6,19,290,315,
Pontotoc,Commissioner of Labor,Fred Dorrell,DEM,620059,5,10,92,107,
Pontotoc,Commissioner of Labor,Brandt Dismukes,IND,620059,0,1,20,21,
Pontotoc,Insurance Commissioner,Glen Mulready,REP,620059,6,19,287,312,
Pontotoc,Insurance Commissioner,Kimberly Fobbs,DEM,620059,5,11,116,132,
Pontotoc,Corporation Commissioner,Bob Anthony,REP,620059,6,20,285,311,
Pontotoc,Corporation Commissioner,Ashley Nicole Mccray,DEM,620059,5,10,100,115,
Pontotoc,Corporation Commissioner,Jackie Short,IND,620059,0,1,19,20,
Pontotoc,U.S. House,Tom Cole,REP,620059,7,22,300,329,4
Pontotoc,U.S. House,Mary Brannon,DEM,620059,5,9,95,109,4
Pontotoc,U.S. House,Ruby Peters,IND,620059,0,0,13,13,4
Pontotoc,State House,Ronny Johns,REP,620059,6,16,220,242,25
Pontotoc,State House,Daniel Manuel,DEM,620059,5,16,154,175,25
Pontotoc,State House,Gary Rhynes,IND,620059,0,0,29,29,25
Pontotoc,Governor,Chris Powell,LIB,620060,0,1,21,22,
Pontotoc,Governor,Kevin Stitt,REP,620060,6,35,304,345,
Pontotoc,Governor,Drew Edmondson,DEM,620060,13,39,297,349,
Pontotoc,Lieutenant Governor,Matt Pinnell,REP,620060,9,45,393,447,
Pontotoc,Lieutenant Governor,Anastasia Pittman,DEM,620060,9,27,198,234,
Pontotoc,Lieutenant Governor,Ivan Holmes,IND,620060,0,4,27,31,
Pontotoc,State Auditor,John Yeutter,LIB,620060,1,8,109,118,
Pontotoc,State Auditor,Cindy Byrd,REP,620060,15,63,489,567,
Pontotoc,Attorney General,Mike Hunter,REP,620060,11,53,407,471,
Pontotoc,Attorney General,Mark Myles,DEM,620060,7,23,201,231,
Pontotoc,State Treasurer,Randy Mcdaniel,REP,620060,14,57,459,530,
Pontotoc,State Treasurer,Charles De Coune,IND,620060,2,15,136,153,
Pontotoc,Superintendent of Public Instruction,Joy Hofmeister,REP,620060,15,50,389,454,
Pontotoc,Superintendent of Public Instruction,John Cox,DEM,620060,3,20,181,204,
Pontotoc,Superintendent of Public Instruction,Larry Huff,IND,620060,1,6,46,53,
Pontotoc,Commissioner of Labor,Leslie Osborn,REP,620060,11,49,392,452,
Pontotoc,Commissioner of Labor,Fred Dorrell,DEM,620060,6,26,189,221,
Pontotoc,Commissioner of Labor,Brandt Dismukes,IND,620060,0,1,31,32,
Pontotoc,Insurance Commissioner,Glen Mulready,REP,620060,11,45,380,436,
Pontotoc,Insurance Commissioner,Kimberly Fobbs,DEM,620060,5,30,228,263,
Pontotoc,Corporation Commissioner,Bob Anthony,REP,620060,9,47,375,431,
Pontotoc,Corporation Commissioner,Ashley Nicole Mccray,DEM,620060,7,24,203,234,
Pontotoc,Corporation Commissioner,Jackie Short,IND,620060,0,4,38,42,
Pontotoc,U.S. House,Tom Cole,REP,620060,10,53,430,493,4
Pontotoc,U.S. House,Mary Brannon,DEM,620060,8,22,174,204,4
Pontotoc,U.S. House,Ruby Peters,IND,620060,1,0,16,17,4
Pontotoc,State House,Ronny Johns,REP,620060,8,32,284,324,25
Pontotoc,State House,Daniel Manuel,DEM,620060,11,41,305,357,25
Pontotoc,State House,Gary Rhynes,IND,620060,0,1,35,36,25
Pontotoc,Governor,Chris Powell,LIB,620061,0,2,5,7,
Pontotoc,Governor,Kevin Stitt,REP,620061,1,24,116,141,
Pontotoc,Governor,Drew Edmondson,DEM,620061,0,7,61,68,
Pontotoc,Lieutenant Governor,Matt Pinnell,REP,620061,1,30,135,166,
Pontotoc,Lieutenant Governor,Anastasia Pittman,DEM,620061,0,3,42,45,
Pontotoc,Lieutenant Governor,Ivan Holmes,IND,620061,0,1,1,2,
Pontotoc,State Auditor,John Yeutter,LIB,620061,0,5,23,28,
Pontotoc,State Auditor,Cindy Byrd,REP,620061,1,28,146,175,
Pontotoc,Attorney General,Mike Hunter,REP,620061,1,29,138,168,
Pontotoc,Attorney General,Mark Myles,DEM,620061,0,4,41,45,
Pontotoc,State Treasurer,Randy Mcdaniel,REP,620061,1,28,144,173,
Pontotoc,State Treasurer,Charles De Coune,IND,620061,0,5,25,30,
Pontotoc,Superintendent of Public Instruction,Joy Hofmeister,REP,620061,1,24,123,148,
Pontotoc,Superintendent of Public Instruction,John Cox,DEM,620061,0,7,43,50,
Pontotoc,Superintendent of Public Instruction,Larry Huff,IND,620061,0,3,15,18,
Pontotoc,Commissioner of Labor,Leslie Osborn,REP,620061,1,28,124,153,
Pontotoc,Commissioner of Labor,Fred Dorrell,DEM,620061,0,3,46,49,
Pontotoc,Commissioner of Labor,Brandt Dismukes,IND,620061,0,2,7,9,
Pontotoc,Insurance Commissioner,Glen Mulready,REP,620061,1,28,125,154,
Pontotoc,Insurance Commissioner,Kimberly Fobbs,DEM,620061,0,6,50,56,
Pontotoc,Corporation Commissioner,Bob Anthony,REP,620061,1,28,127,156,
Pontotoc,Corporation Commissioner,Ashley Nicole Mccray,DEM,620061,0,5,43,48,
Pontotoc,Corporation Commissioner,Jackie Short,IND,620061,0,1,6,7,
Pontotoc,U.S. House,Tom Cole,REP,620061,1,30,135,166,4
Pontotoc,U.S. House,Mary Brannon,DEM,620061,0,4,37,41,4
Pontotoc,U.S. House,Ruby Peters,IND,620061,0,0,8,8,4
Pontotoc,State House,Ronny Johns,REP,620061,1,22,96,119,25
Pontotoc,State House,Daniel Manuel,DEM,620061,0,11,77,88,25
Pontotoc,State House,Gary Rhynes,IND,620061,0,1,8,9,25
Pontotoc,Governor,Chris Powell,LIB,620062,2,1,9,12,
Pontotoc,Governor,Kevin Stitt,REP,620062,7,35,298,340,
Pontotoc,Governor,Drew Edmondson,DEM,620062,2,28,158,188,
Pontotoc,Lieutenant Governor,Matt Pinnell,REP,620062,9,36,328,373,
Pontotoc,Lieutenant Governor,Anastasia Pittman,DEM,620062,1,25,129,155,
Pontotoc,Lieutenant Governor,Ivan Holmes,IND,620062,1,3,8,12,
Pontotoc,State Auditor,John Yeutter,LIB,620062,2,8,68,78,
Pontotoc,State Auditor,Cindy Byrd,REP,620062,9,48,372,429,
Pontotoc,Attorney General,Mike Hunter,REP,620062,7,41,338,386,
Pontotoc,Attorney General,Mark Myles,DEM,620062,4,22,125,151,
Pontotoc,State Treasurer,Randy Mcdaniel,REP,620062,9,47,371,427,
Pontotoc,State Treasurer,Charles De Coune,IND,620062,2,13,64,79,
Pontotoc,Superintendent of Public Instruction,Joy Hofmeister,REP,620062,7,31,314,352,
Pontotoc,Superintendent of Public Instruction,John Cox,DEM,620062,4,22,122,148,
Pontotoc,Superintendent of Public Instruction,Larry Huff,IND,620062,0,9,26,35,
Pontotoc,Commissioner of Labor,Leslie Osborn,REP,620062,8,39,319,366,
Pontotoc,Commissioner of Labor,Fred Dorrell,DEM,620062,3,18,117,138,
Pontotoc,Commissioner of Labor,Brandt Dismukes,IND,620062,0,5,22,27,
Pontotoc,Insurance Commissioner,Glen Mulready,REP,620062,7,41,317,365,
Pontotoc,Insurance Commissioner,Kimberly Fobbs,DEM,620062,4,23,143,170,
Pontotoc,Corporation Commissioner,Bob Anthony,REP,620062,7,36,323,366,
Pontotoc,Corporation Commissioner,Ashley Nicole Mccray,DEM,620062,4,22,120,146,
Pontotoc,Corporation Commissioner,Jackie Short,IND,620062,0,6,20,26,
Pontotoc,U.S. House,Tom Cole,REP,620062,9,41,357,407,4
Pontotoc,U.S. House,Mary Brannon,DEM,620062,2,19,99,120,4
Pontotoc,U.S. House,Ruby Peters,IND,620062,0,4,12,16,4
Pontotoc,State House,Ronny Johns,REP,620062,6,28,261,295,25
Pontotoc,State House,Daniel Manuel,DEM,620062,5,30,183,218,25
Pontotoc,State House,Gary Rhynes,IND,620062,0,5,22,27,25
Pontotoc,Governor,Chris Powell,LIB,620063,0,0,5,5,
Pontotoc,Governor,Kevin Stitt,REP,620063,6,8,155,169,
Pontotoc,Governor,Drew Edmondson,DEM,620063,2,3,117,122,
Pontotoc,Lieutenant Governor,Matt Pinnell,REP,620063,5,9,182,196,
Pontotoc,Lieutenant Governor,Anastasia Pittman,DEM,620063,2,2,78,82,
Pontotoc,Lieutenant Governor,Ivan Holmes,IND,620063,0,0,13,13,
Pontotoc,State Auditor,John Yeutter,LIB,620063,1,0,42,43,
Pontotoc,State Auditor,Cindy Byrd,REP,620063,5,10,220,235,
Pontotoc,Attorney General,Mike Hunter,REP,620063,5,9,196,210,
Pontotoc,Attorney General,Mark Myles,DEM,620063,2,2,74,78,
Pontotoc,State Treasurer,Randy Mcdaniel,REP,620063,5,10,217,232,
Pontotoc,State Treasurer,Charles De Coune,IND,620063,1,1,47,49,
Pontotoc,Superintendent of Public Instruction,Joy Hofmeister,REP,620063,6,11,171,188,
Pontotoc,Superintendent of Public Instruction,John Cox,DEM,620063,2,0,72,74,
Pontotoc,Superintendent of Public Instruction,Larry Huff,IND,620063,0,0,31,31,
Pontotoc,Commissioner of Labor,Leslie Osborn,REP,620063,3,8,177,188,
Pontotoc,Commissioner of Labor,Fred Dorrell,DEM,620063,4,3,78,85,
Pontotoc,Commissioner of Labor,Brandt Dismukes,IND,620063,0,0,15,15,
Pontotoc,Insurance Commissioner,Glen Mulready,REP,620063,2,9,183,194,
Pontotoc,Insurance Commissioner,Kimberly Fobbs,DEM,620063,5,2,87,94,
Pontotoc,Corporation Commissioner,Bob Anthony,REP,620063,5,9,168,182,
Pontotoc,Corporation Commissioner,Ashley Nicole Mccray,DEM,620063,3,2,82,87,
Pontotoc,Corporation Commissioner,Jackie Short,IND,620063,0,0,19,19,
Pontotoc,U.S. House,Tom Cole,REP,620063,5,9,197,211,4
Pontotoc,U.S. House,Mary Brannon,DEM,620063,2,2,63,67,4
Pontotoc,U.S. House,Ruby Peters,IND,620063,0,0,15,15,4
Pontotoc,State House,Ronny Johns,REP,620063,4,8,133,145,25
Pontotoc,State House,Daniel Manuel,DEM,620063,3,3,128,134,25
Pontotoc,State House,Gary Rhynes,IND,620063,0,0,16,16,25
Pontotoc,Governor,Chris Powell,LIB,620064,0,0,14,14,
Pontotoc,Governor,Kevin Stitt,REP,620064,4,29,271,304,
Pontotoc,Governor,Drew Edmondson,DEM,620064,5,27,145,177,
Pontotoc,Lieutenant Governor,Matt Pinnell,REP,620064,4,35,300,339,
Pontotoc,Lieutenant Governor,Anastasia Pittman,DEM,620064,5,21,114,140,
Pontotoc,Lieutenant Governor,Ivan Holmes,IND,620064,0,0,15,15,
Pontotoc,State Auditor,John Yeutter,LIB,620064,4,6,65,75,
Pontotoc,State Auditor,Cindy Byrd,REP,620064,5,49,350,404,
Pontotoc,Attorney General,Mike Hunter,REP,620064,4,40,326,370,
Pontotoc,Attorney General,Mark Myles,DEM,620064,5,16,101,122,
Pontotoc,State Treasurer,Randy Mcdaniel,REP,620064,5,44,347,396,
Pontotoc,State Treasurer,Charles De Coune,IND,620064,4,11,66,81,
Pontotoc,Superintendent of Public Instruction,Joy Hofmeister,REP,620064,4,36,283,323,
Pontotoc,Superintendent of Public Instruction,John Cox,DEM,620064,5,15,111,131,
Pontotoc,Superintendent of Public Instruction,Larry Huff,IND,620064,0,5,35,40,
Pontotoc,Commissioner of Labor,Leslie Osborn,REP,620064,5,37,299,341,
Pontotoc,Commissioner of Labor,Fred Dorrell,DEM,620064,2,16,111,129,
Pontotoc,Commissioner of Labor,Brandt Dismukes,IND,620064,2,2,15,19,
Pontotoc,Insurance Commissioner,Glen Mulready,REP,620064,4,33,304,341,
Pontotoc,Insurance Commissioner,Kimberly Fobbs,DEM,620064,5,23,121,149,
Pontotoc,Corporation Commissioner,Bob Anthony,REP,620064,4,42,295,341,
Pontotoc,Corporation Commissioner,Ashley Nicole Mccray,DEM,620064,3,14,112,129,
Pontotoc,Corporation Commissioner,Jackie Short,IND,620064,2,0,20,22,
Pontotoc,U.S. House,Tom Cole,REP,620064,4,41,323,368,4
Pontotoc,U.S. House,Mary Brannon,DEM,620064,5,15,92,112,4
Pontotoc,U.S. House,Ruby Peters,IND,620064,0,0,14,14,4
Pontotoc,State House,Ronny Johns,REP,620064,5,29,225,259,25
Pontotoc,State House,Daniel Manuel,DEM,620064,4,26,186,216,25
Pontotoc,State House,Gary Rhynes,IND,620064,0,1,19,20,25
Pontotoc,Governor,Chris Powell,LIB,620065,0,0,13,13,
Pontotoc,Governor,Kevin Stitt,REP,620065,5,16,245,266,
Pontotoc,Governor,Drew Edmondson,DEM,620065,2,10,116,128,
Pontotoc,Lieutenant Governor,Matt Pinnell,REP,620065,5,19,262,286,
Pontotoc,Lieutenant Governor,Anastasia Pittman,DEM,620065,2,7,95,104,
Pontotoc,Lieutenant Governor,Ivan Holmes,IND,620065,0,0,15,15,
Pontotoc,State Auditor,John Yeutter,LIB,620065,1,3,44,48,
Pontotoc,State Auditor,Cindy Byrd,REP,620065,6,19,314,339,
Pontotoc,Attorney General,Mike Hunter,REP,620065,5,18,284,307,
Pontotoc,Attorney General,Mark Myles,DEM,620065,2,7,86,95,
Pontotoc,State Treasurer,Randy Mcdaniel,REP,620065,6,20,295,321,
Pontotoc,State Treasurer,Charles De Coune,IND,620065,1,2,56,59,
Pontotoc,Superintendent of Public Instruction,Joy Hofmeister,REP,620065,6,17,253,276,
Pontotoc,Superintendent of Public Instruction,John Cox,DEM,620065,1,7,92,100,
Pontotoc,Superintendent of Public Instruction,Larry Huff,IND,620065,0,1,29,30,
Pontotoc,Commissioner of Labor,Leslie Osborn,REP,620065,5,19,259,283,
Pontotoc,Commissioner of Labor,Fred Dorrell,DEM,620065,1,6,92,99,
Pontotoc,Commissioner of Labor,Brandt Dismukes,IND,620065,0,0,16,16,
Pontotoc,Insurance Commissioner,Glen Mulready,REP,620065,5,17,258,280,
Pontotoc,Insurance Commissioner,Kimberly Fobbs,DEM,620065,2,8,110,120,
Pontotoc,Corporation Commissioner,Bob Anthony,REP,620065,5,15,246,266,
Pontotoc,Corporation Commissioner,Ashley Nicole Mccray,DEM,620065,2,8,97,107,
Pontotoc,Corporation Commissioner,Jackie Short,IND,620065,0,2,25,27,
Pontotoc,U.S. House,Tom Cole,REP,620065,5,20,279,304,4
Pontotoc,U.S. House,Mary Brannon,DEM,620065,2,4,76,82,4
Pontotoc,U.S. House,Ruby Peters,IND,620065,0,2,18,20,4
Pontotoc,State House,Ronny Johns,REP,620065,6,14,194,214,25
Pontotoc,State House,Daniel Manuel,DEM,620065,1,10,156,167,25
Pontotoc,State House,Gary Rhynes,IND,620065,0,2,24,26,25
Pontotoc,Governor,Chris Powell,LIB,620066,0,1,23,24,
Pontotoc,Governor,Kevin Stitt,REP,620066,8,28,245,281,
Pontotoc,Governor,Drew Edmondson,DEM,620066,3,22,169,194,
Pontotoc,Lieutenant Governor,Matt Pinnell,REP,620066,7,36,288,331,
Pontotoc,Lieutenant Governor,Anastasia Pittman,DEM,620066,4,14,125,143,
Pontotoc,Lieutenant Governor,Ivan Holmes,IND,620066,0,0,14,14,
Pontotoc,State Auditor,John Yeutter,LIB,620066,1,5,56,62,
Pontotoc,State Auditor,Cindy Byrd,REP,620066,9,43,362,414,
Pontotoc,Attorney General,Mike Hunter,REP,620066,7,38,312,357,
Pontotoc,Attorney General,Mark Myles,DEM,620066,4,11,118,133,
Pontotoc,State Treasurer,Randy Mcdaniel,REP,620066,8,36,348,392,
Pontotoc,State Treasurer,Charles De Coune,IND,620066,2,9,69,80,
Pontotoc,Superintendent of Public Instruction,Joy Hofmeister,REP,620066,8,38,304,350,
Pontotoc,Superintendent of Public Instruction,John Cox,DEM,620066,3,11,101,115,
Pontotoc,Superintendent of Public Instruction,Larry Huff,IND,620066,0,0,28,28,
Pontotoc,Commissioner of Labor,Leslie Osborn,REP,620066,8,37,296,341,
Pontotoc,Commissioner of Labor,Fred Dorrell,DEM,620066,3,11,121,135,
Pontotoc,Commissioner of Labor,Brandt Dismukes,IND,620066,0,1,10,11,
Pontotoc,Insurance Commissioner,Glen Mulready,REP,620066,8,35,288,331,
Pontotoc,Insurance Commissioner,Kimberly Fobbs,DEM,620066,3,13,140,156,
Pontotoc,Corporation Commissioner,Bob Anthony,REP,620066,7,34,294,335,
Pontotoc,Corporation Commissioner,Ashley Nicole Mccray,DEM,620066,3,10,115,128,
Pontotoc,Corporation Commissioner,Jackie Short,IND,620066,1,4,19,24,
Pontotoc,U.S. House,Tom Cole,REP,620066,8,40,329,377,4
Pontotoc,U.S. House,Mary Brannon,DEM,620066,3,9,97,109,4
Pontotoc,U.S. House,Ruby Peters,IND,620066,0,1,8,9,4
Pontotoc,State House,Ronny Johns,REP,620066,2,31,237,270,25
Pontotoc,State House,Daniel Manuel,DEM,620066,8,18,187,213,25
Pontotoc,State House,Gary Rhynes,IND,620066,1,2,12,15,25
Pontotoc,Governor,Chris Powell,LIB,620067,2,1,10,13,
Pontotoc,Governor,Kevin Stitt,REP,620067,5,13,189,207,
Pontotoc,Governor,Drew Edmondson,DEM,620067,4,7,71,82,
Pontotoc,Lieutenant Governor,Matt Pinnell,REP,620067,9,15,198,222,
Pontotoc,Lieutenant Governor,Anastasia Pittman,DEM,620067,2,5,56,63,
Pontotoc,Lieutenant Governor,Ivan Holmes,IND,620067,0,1,9,10,
Pontotoc,State Auditor,John Yeutter,LIB,620067,3,6,37,46,
Pontotoc,State Auditor,Cindy Byrd,REP,620067,8,15,223,246,
Pontotoc,Attorney General,Mike Hunter,REP,620067,9,18,217,244,
Pontotoc,Attorney General,Mark Myles,DEM,620067,2,3,48,53,
Pontotoc,State Treasurer,Randy Mcdaniel,REP,620067,7,18,221,246,
Pontotoc,State Treasurer,Charles De Coune,IND,620067,4,3,36,43,
Pontotoc,Superintendent of Public Instruction,Joy Hofmeister,REP,620067,6,15,192,213,
Pontotoc,Superintendent of Public Instruction,John Cox,DEM,620067,5,4,59,68,
Pontotoc,Superintendent of Public Instruction,Larry Huff,IND,620067,0,2,15,17,
Pontotoc,Commissioner of Labor,Leslie Osborn,REP,620067,8,17,202,227,
Pontotoc,Commissioner of Labor,Fred Dorrell,DEM,620067,3,3,53,59,
Pontotoc,Commissioner of Labor,Brandt Dismukes,IND,620067,0,1,7,8,
Pontotoc,Insurance Commissioner,Glen Mulready,REP,620067,8,13,206,227,
Pontotoc,Insurance Commissioner,Kimberly Fobbs,DEM,620067,3,8,56,67,
Pontotoc,Corporation Commissioner,Bob Anthony,REP,620067,8,13,198,219,
Pontotoc,Corporation Commissioner,Ashley Nicole Mccray,DEM,620067,2,7,54,63,
Pontotoc,Corporation Commissioner,Jackie Short,IND,620067,1,1,12,14,
Pontotoc,U.S. House,Tom Cole,REP,620067,8,17,214,239,4
Pontotoc,U.S. House,Mary Brannon,DEM,620067,3,4,46,53,4
Pontotoc,U.S. House,Ruby Peters,IND,620067,0,0,7,7,4
Pontotoc,State House,Ronny Johns,REP,620067,7,11,152,170,25
Pontotoc,State House,Daniel Manuel,DEM,620067,4,9,102,115,25
Pontotoc,State House,Gary Rhynes,IND,620067,0,1,16,17,25
Pottawatomie,Governor,Chris Powell,LIB,630001,0,2,14,16,
Pottawatomie,Governor,Kevin Stitt,REP,630001,12,28,202,242,
Pottawatomie,Governor,Drew Edmondson,DEM,630001,15,12,113,140,
Pottawatomie,Lieutenant Governor,Matt Pinnell,REP,630001,15,31,226,272,
Pottawatomie,Lieutenant Governor,Anastasia Pittman,DEM,630001,11,11,90,112,
Pottawatomie,Lieutenant Governor,Ivan Holmes,IND,630001,1,0,13,14,
Pottawatomie,State Auditor,John Yeutter,LIB,630001,10,9,55,74,
Pottawatomie,State Auditor,Cindy Byrd,REP,630001,14,31,260,305,
Pottawatomie,Attorney General,Mike Hunter,REP,630001,15,30,246,291,
Pottawatomie,Attorney General,Mark Myles,DEM,630001,10,12,81,103,
Pottawatomie,State Treasurer,Randy Mcdaniel,REP,630001,15,31,252,298,
Pottawatomie,State Treasurer,Charles De Coune,IND,630001,9,9,64,82,
Pottawatomie,Superintendent of Public Instruction,Joy Hofmeister,REP,630001,15,25,226,266,
Pottawatomie,Superintendent of Public Instruction,John Cox,DEM,630001,11,12,76,99,
Pottawatomie,Superintendent of Public Instruction,Larry Huff,IND,630001,1,5,25,31,
Pottawatomie,Commissioner of Labor,Leslie Osborn,REP,630001,14,31,229,274,
Pottawatomie,Commissioner of Labor,Fred Dorrell,DEM,630001,11,10,80,101,
Pottawatomie,Commissioner of Labor,Brandt Dismukes,IND,630001,0,1,15,16,
Pottawatomie,Insurance Commissioner,Glen Mulready,REP,630001,13,31,226,270,
Pottawatomie,Insurance Commissioner,Kimberly Fobbs,DEM,630001,12,11,98,121,
Pottawatomie,Corporation Commissioner,Bob Anthony,REP,630001,14,28,226,268,
Pottawatomie,Corporation Commissioner,Ashley Nicole Mccray,DEM,630001,11,9,82,102,
Pottawatomie,Corporation Commissioner,Jackie Short,IND,630001,0,5,19,24,
Pottawatomie,U.S. House,Steve Russell,REP,630001,13,29,214,256,5
Pottawatomie,U.S. House,Kendra Horn,DEM,630001,14,13,113,140,5
Pottawatomie,State Senate,Jason Smalley,REP,630001,14,31,232,277,28
Pottawatomie,State Senate,Stephanie Sanders,IND,630001,10,9,79,98,28
Pottawatomie,State House,Dell Kerbs,REP,630001,13,31,207,251,26
Pottawatomie,State House,Terry Hopkins,DEM,630001,14,11,120,145,26
Pottawatomie,Governor,Chris Powell,LIB,630002,1,0,20,21,
Pottawatomie,Governor,Kevin Stitt,REP,630002,10,17,208,235,
Pottawatomie,Governor,Drew Edmondson,DEM,630002,15,15,185,215,
Pottawatomie,Lieutenant Governor,Matt Pinnell,REP,630002,11,20,219,250,
Pottawatomie,Lieutenant Governor,Anastasia Pittman,DEM,630002,15,11,176,202,
Pottawatomie,Lieutenant Governor,Ivan Holmes,IND,630002,0,1,13,14,
Pottawatomie,State Auditor,John Yeutter,LIB,630002,11,6,117,134,
Pottawatomie,State Auditor,Cindy Byrd,REP,630002,13,23,255,291,
Pottawatomie,Attorney General,Mike Hunter,REP,630002,9,21,233,263,
Pottawatomie,Attorney General,Mark Myles,DEM,630002,17,11,175,203,
Pottawatomie,State Treasurer,Randy Mcdaniel,REP,630002,12,23,249,284,
Pottawatomie,State Treasurer,Charles De Coune,IND,630002,12,6,128,146,
Pottawatomie,Superintendent of Public Instruction,Joy Hofmeister,REP,630002,11,20,210,241,
Pottawatomie,Superintendent of Public Instruction,John Cox,DEM,630002,12,9,161,182,
Pottawatomie,Superintendent of Public Instruction,Larry Huff,IND,630002,3,3,35,41,
Pottawatomie,Commissioner of Labor,Leslie Osborn,REP,630002,11,22,224,257,
Pottawatomie,Commissioner of Labor,Fred Dorrell,DEM,630002,14,10,159,183,
Pottawatomie,Commissioner of Labor,Brandt Dismukes,IND,630002,1,0,16,17,
Pottawatomie,Insurance Commissioner,Glen Mulready,REP,630002,10,17,217,244,
Pottawatomie,Insurance Commissioner,Kimberly Fobbs,DEM,630002,16,15,183,214,
Pottawatomie,Corporation Commissioner,Bob Anthony,REP,630002,10,17,215,242,
Pottawatomie,Corporation Commissioner,Ashley Nicole Mccray,DEM,630002,14,14,171,199,
Pottawatomie,Corporation Commissioner,Jackie Short,IND,630002,2,1,20,23,
Pottawatomie,U.S. House,Steve Russell,REP,630002,12,19,217,248,5
Pottawatomie,U.S. House,Kendra Horn,DEM,630002,14,13,191,218,5
Pottawatomie,State House,Dell Kerbs,REP,630002,11,17,216,244,26
Pottawatomie,State House,Terry Hopkins,DEM,630002,15,15,193,223,26
Pottawatomie,Governor,Chris Powell,LIB,630003,2,0,38,40,
Pottawatomie,Governor,Kevin Stitt,REP,630003,13,37,307,357,
Pottawatomie,Governor,Drew Edmondson,DEM,630003,31,40,343,414,
Pottawatomie,Lieutenant Governor,Matt Pinnell,REP,630003,14,39,335,388,
Pottawatomie,Lieutenant Governor,Anastasia Pittman,DEM,630003,30,35,297,362,
Pottawatomie,Lieutenant Governor,Ivan Holmes,IND,630003,2,2,51,55,
Pottawatomie,State Auditor,John Yeutter,LIB,630003,20,20,217,257,
Pottawatomie,State Auditor,Cindy Byrd,REP,630003,21,45,417,483,
Pottawatomie,Attorney General,Mike Hunter,REP,630003,15,39,366,420,
Pottawatomie,Attorney General,Mark Myles,DEM,630003,31,36,306,373,
Pottawatomie,State Treasurer,Randy Mcdaniel,REP,630003,17,44,381,442,
Pottawatomie,State Treasurer,Charles De Coune,IND,630003,23,20,240,283,
Pottawatomie,Superintendent of Public Instruction,Joy Hofmeister,REP,630003,16,35,338,389,
Pottawatomie,Superintendent of Public Instruction,John Cox,DEM,630003,25,35,260,320,
Pottawatomie,Superintendent of Public Instruction,Larry Huff,IND,630003,5,6,81,92,
Pottawatomie,Commissioner of Labor,Leslie Osborn,REP,630003,16,40,348,404,
Pottawatomie,Commissioner of Labor,Fred Dorrell,DEM,630003,26,31,264,321,
Pottawatomie,Commissioner of Labor,Brandt Dismukes,IND,630003,3,3,58,64,
Pottawatomie,Insurance Commissioner,Glen Mulready,REP,630003,14,37,330,381,
Pottawatomie,Insurance Commissioner,Kimberly Fobbs,DEM,630003,31,38,335,404,
Pottawatomie,Corporation Commissioner,Bob Anthony,REP,630003,20,32,315,367,
Pottawatomie,Corporation Commissioner,Ashley Nicole Mccray,DEM,630003,21,36,301,358,
Pottawatomie,Corporation Commissioner,Jackie Short,IND,630003,5,7,57,69,
Pottawatomie,U.S. House,Steve Russell,REP,630003,15,37,316,368,5
Pottawatomie,U.S. House,Kendra Horn,DEM,630003,31,40,359,430,5
Pottawatomie,State House,Dell Kerbs,REP,630003,13,37,327,377,26
Pottawatomie,State House,Terry Hopkins,DEM,630003,32,39,354,425,26
Pottawatomie,Governor,Chris Powell,LIB,630006,0,4,34,38,
Pottawatomie,Governor,Kevin Stitt,REP,630006,15,32,258,305,
Pottawatomie,Governor,Drew Edmondson,DEM,630006,26,44,213,283,
Pottawatomie,Lieutenant Governor,Matt Pinnell,REP,630006,19,42,301,362,
Pottawatomie,Lieutenant Governor,Anastasia Pittman,DEM,630006,21,33,171,225,
Pottawatomie,Lieutenant Governor,Ivan Holmes,IND,630006,0,3,24,27,
Pottawatomie,State Auditor,John Yeutter,LIB,630006,13,25,135,173,
Pottawatomie,State Auditor,Cindy Byrd,REP,630006,22,48,336,406,
Pottawatomie,Attorney General,Mike Hunter,REP,630006,18,45,327,390,
Pottawatomie,Attorney General,Mark Myles,DEM,630006,22,31,168,221,
Pottawatomie,State Treasurer,Randy Mcdaniel,REP,630006,19,44,328,391,
Pottawatomie,State Treasurer,Charles De Coune,IND,630006,18,28,143,189,
Pottawatomie,Superintendent of Public Instruction,Joy Hofmeister,REP,630006,18,49,280,347,
Pottawatomie,Superintendent of Public Instruction,John Cox,DEM,630006,21,23,160,204,
Pottawatomie,Superintendent of Public Instruction,Larry Huff,IND,630006,1,5,59,65,
Pottawatomie,Commissioner of Labor,Leslie Osborn,REP,630006,17,43,300,360,
Pottawatomie,Commissioner of Labor,Fred Dorrell,DEM,630006,22,29,160,211,
Pottawatomie,Commissioner of Labor,Brandt Dismukes,IND,630006,0,4,30,34,
Pottawatomie,Insurance Commissioner,Glen Mulready,REP,630006,16,47,295,358,
Pottawatomie,Insurance Commissioner,Kimberly Fobbs,DEM,630006,22,30,196,248,
Pottawatomie,Corporation Commissioner,Bob Anthony,REP,630006,17,44,279,340,
Pottawatomie,Corporation Commissioner,Ashley Nicole Mccray,DEM,630006,21,29,168,218,
Pottawatomie,Corporation Commissioner,Jackie Short,IND,630006,1,3,46,50,
Pottawatomie,U.S. House,Steve Russell,REP,630006,13,41,290,344,5
Pottawatomie,U.S. House,Kendra Horn,DEM,630006,27,38,208,273,5
Pottawatomie,State House,Dell Kerbs,REP,630006,15,37,280,332,26
Pottawatomie,State House,Terry Hopkins,DEM,630006,26,41,219,286,26
Pottawatomie,Governor,Chris Powell,LIB,630007,3,3,24,30,
Pottawatomie,Governor,Kevin Stitt,REP,630007,27,44,325,396,
Pottawatomie,Governor,Drew Edmondson,DEM,630007,30,59,309,398,
Pottawatomie,Lieutenant Governor,Matt Pinnell,REP,630007,31,60,380,471,
Pottawatomie,Lieutenant Governor,Anastasia Pittman,DEM,630007,28,43,248,319,
Pottawatomie,Lieutenant Governor,Ivan Holmes,IND,630007,0,3,22,25,
Pottawatomie,State Auditor,John Yeutter,LIB,630007,20,22,161,203,
Pottawatomie,State Auditor,Cindy Byrd,REP,630007,33,72,451,556,
Pottawatomie,Attorney General,Mike Hunter,REP,630007,31,62,416,509,
Pottawatomie,Attorney General,Mark Myles,DEM,630007,28,44,233,305,
Pottawatomie,State Treasurer,Randy Mcdaniel,REP,630007,35,70,410,515,
Pottawatomie,State Treasurer,Charles De Coune,IND,630007,16,25,197,238,
Pottawatomie,Superintendent of Public Instruction,Joy Hofmeister,REP,630007,32,58,369,459,
Pottawatomie,Superintendent of Public Instruction,John Cox,DEM,630007,22,36,221,279,
Pottawatomie,Superintendent of Public Instruction,Larry Huff,IND,630007,5,12,54,71,
Pottawatomie,Commissioner of Labor,Leslie Osborn,REP,630007,30,58,373,461,
Pottawatomie,Commissioner of Labor,Fred Dorrell,DEM,630007,24,44,235,303,
Pottawatomie,Commissioner of Labor,Brandt Dismukes,IND,630007,4,3,29,36,
Pottawatomie,Insurance Commissioner,Glen Mulready,REP,630007,28,59,373,460,
Pottawatomie,Insurance Commissioner,Kimberly Fobbs,DEM,630007,30,47,266,343,
Pottawatomie,Corporation Commissioner,Bob Anthony,REP,630007,30,56,341,427,
Pottawatomie,Corporation Commissioner,Ashley Nicole Mccray,DEM,630007,24,46,250,320,
Pottawatomie,Corporation Commissioner,Jackie Short,IND,630007,4,4,54,62,
Pottawatomie,U.S. House,Steve Russell,REP,630007,29,55,347,431,5
Pottawatomie,U.S. House,Kendra Horn,DEM,630007,29,51,305,385,5
Pottawatomie,State House,Dell Kerbs,REP,630007,26,52,349,427,26
Pottawatomie,State House,Terry Hopkins,DEM,630007,33,53,300,386,26
Pottawatomie,Governor,Chris Powell,LIB,630009,5,14,32,51,
Pottawatomie,Governor,Kevin Stitt,REP,630009,53,142,485,680,
Pottawatomie,Governor,Drew Edmondson,DEM,630009,39,85,312,436,
Pottawatomie,Lieutenant Governor,Matt Pinnell,REP,630009,61,159,556,776,
Pottawatomie,Lieutenant Governor,Anastasia Pittman,DEM,630009,30,72,232,334,
Pottawatomie,Lieutenant Governor,Ivan Holmes,IND,630009,6,6,35,47,
Pottawatomie,State Auditor,John Yeutter,LIB,630009,19,45,159,223,
Pottawatomie,State Auditor,Cindy Byrd,REP,630009,69,178,631,878,
Pottawatomie,Attorney General,Mike Hunter,REP,630009,63,169,597,829,
Pottawatomie,Attorney General,Mark Myles,DEM,630009,32,72,224,328,
Pottawatomie,State Treasurer,Randy Mcdaniel,REP,630009,65,169,606,840,
Pottawatomie,State Treasurer,Charles De Coune,IND,630009,21,53,174,248,
Pottawatomie,Superintendent of Public Instruction,Joy Hofmeister,REP,630009,55,136,543,734,
Pottawatomie,Superintendent of Public Instruction,John Cox,DEM,630009,31,87,193,311,
Pottawatomie,Superintendent of Public Instruction,Larry Huff,IND,630009,7,16,83,106,
Pottawatomie,Commissioner of Labor,Leslie Osborn,REP,630009,62,160,565,787,
Pottawatomie,Commissioner of Labor,Fred Dorrell,DEM,630009,27,65,192,284,
Pottawatomie,Commissioner of Labor,Brandt Dismukes,IND,630009,5,13,56,74,
Pottawatomie,Insurance Commissioner,Glen Mulready,REP,630009,59,159,564,782,
Pottawatomie,Insurance Commissioner,Kimberly Fobbs,DEM,630009,33,76,247,356,
Pottawatomie,Corporation Commissioner,Bob Anthony,REP,630009,56,158,533,747,
Pottawatomie,Corporation Commissioner,Ashley Nicole Mccray,DEM,630009,32,70,222,324,
Pottawatomie,Corporation Commissioner,Jackie Short,IND,630009,6,12,60,78,
Pottawatomie,U.S. House,Steve Russell,REP,630009,63,153,541,757,5
Pottawatomie,U.S. House,Kendra Horn,DEM,630009,34,87,285,406,5
Pottawatomie,State House,Dell Kerbs,REP,630009,52,148,510,710,26
Pottawatomie,State House,Terry Hopkins,DEM,630009,44,94,309,447,26
Pottawatomie,Governor,Chris Powell,LIB,630011,1,1,50,52,
Pottawatomie,Governor,Kevin Stitt,REP,630011,50,83,688,821,
Pottawatomie,Governor,Drew Edmondson,DEM,630011,51,83,471,605,
Pottawatomie,Lieutenant Governor,Matt Pinnell,REP,630011,57,98,806,961,
Pottawatomie,Lieutenant Governor,Anastasia Pittman,DEM,630011,44,63,349,456,
Pottawatomie,Lieutenant Governor,Ivan Holmes,IND,630011,1,6,43,50,
Pottawatomie,State Auditor,John Yeutter,LIB,630011,22,33,231,286,
Pottawatomie,State Auditor,Cindy Byrd,REP,630011,69,121,892,1082,
Pottawatomie,Attorney General,Mike Hunter,REP,630011,55,105,853,1013,
Pottawatomie,Attorney General,Mark Myles,DEM,630011,47,61,341,449,
Pottawatomie,State Treasurer,Randy Mcdaniel,REP,630011,59,110,875,1044,
Pottawatomie,State Treasurer,Charles De Coune,IND,630011,34,47,257,338,
Pottawatomie,Superintendent of Public Instruction,Joy Hofmeister,REP,630011,53,108,766,927,
Pottawatomie,Superintendent of Public Instruction,John Cox,DEM,630011,43,49,329,421,
Pottawatomie,Superintendent of Public Instruction,Larry Huff,IND,630011,4,10,102,116,
Pottawatomie,Commissioner of Labor,Leslie Osborn,REP,630011,56,108,810,974,
Pottawatomie,Commissioner of Labor,Fred Dorrell,DEM,630011,43,51,316,410,
Pottawatomie,Commissioner of Labor,Brandt Dismukes,IND,630011,1,6,55,62,
Pottawatomie,Insurance Commissioner,Glen Mulready,REP,630011,51,101,799,951,
Pottawatomie,Insurance Commissioner,Kimberly Fobbs,DEM,630011,49,61,381,491,
Pottawatomie,Corporation Commissioner,Bob Anthony,REP,630011,57,97,758,912,
Pottawatomie,Corporation Commissioner,Ashley Nicole Mccray,DEM,630011,39,59,351,449,
Pottawatomie,Corporation Commissioner,Jackie Short,IND,630011,5,8,80,93,
Pottawatomie,U.S. House,Steve Russell,REP,630011,54,97,759,910,5
Pottawatomie,U.S. House,Kendra Horn,DEM,630011,48,70,444,562,5
Pottawatomie,State House,Dell Kerbs,REP,630011,44,90,745,879,26
Pottawatomie,State House,Terry Hopkins,DEM,630011,58,77,452,587,26
Pottawatomie,Governor,Chris Powell,LIB,630012,3,5,36,44,
Pottawatomie,Governor,Kevin Stitt,REP,630012,29,60,341,430,
Pottawatomie,Governor,Drew Edmondson,DEM,630012,32,50,335,417,
Pottawatomie,Lieutenant Governor,Matt Pinnell,REP,630012,37,70,413,520,
Pottawatomie,Lieutenant Governor,Anastasia Pittman,DEM,630012,26,39,257,322,
Pottawatomie,Lieutenant Governor,Ivan Holmes,IND,630012,1,4,33,38,
Pottawatomie,State Auditor,John Yeutter,LIB,630012,13,27,163,203,
Pottawatomie,State Auditor,Cindy Byrd,REP,630012,42,80,496,618,
Pottawatomie,Attorney General,Mike Hunter,REP,630012,35,75,454,564,
Pottawatomie,Attorney General,Mark Myles,DEM,630012,28,40,249,317,
Pottawatomie,State Treasurer,Randy Mcdaniel,REP,630012,38,73,474,585,
Pottawatomie,State Treasurer,Charles De Coune,IND,630012,17,33,186,236,
Pottawatomie,Superintendent of Public Instruction,Joy Hofmeister,REP,630012,38,75,432,545,
Pottawatomie,Superintendent of Public Instruction,John Cox,DEM,630012,21,31,221,273,
Pottawatomie,Superintendent of Public Instruction,Larry Huff,IND,630012,3,9,51,63,
Pottawatomie,Commissioner of Labor,Leslie Osborn,REP,630012,31,72,433,536,
Pottawatomie,Commissioner of Labor,Fred Dorrell,DEM,630012,25,39,230,294,
Pottawatomie,Commissioner of Labor,Brandt Dismukes,IND,630012,5,2,35,42,
Pottawatomie,Insurance Commissioner,Glen Mulready,REP,630012,34,67,413,514,
Pottawatomie,Insurance Commissioner,Kimberly Fobbs,DEM,630012,29,47,281,357,
Pottawatomie,Corporation Commissioner,Bob Anthony,REP,630012,34,73,407,514,
Pottawatomie,Corporation Commissioner,Ashley Nicole Mccray,DEM,630012,25,38,247,310,
Pottawatomie,Corporation Commissioner,Jackie Short,IND,630012,4,4,43,51,
Pottawatomie,U.S. House,Steve Russell,REP,630012,33,65,389,487,5
Pottawatomie,U.S. House,Kendra Horn,DEM,630012,30,48,316,394,5
Pottawatomie,State House,Dell Kerbs,REP,630012,29,64,381,474,26
Pottawatomie,State House,Terry Hopkins,DEM,630012,34,50,322,406,26
Pottawatomie,Governor,Chris Powell,LIB,630013,6,5,26,37,
Pottawatomie,Governor,Kevin Stitt,REP,630013,48,108,541,697,
Pottawatomie,Governor,Drew Edmondson,DEM,630013,67,86,346,499,
Pottawatomie,Lieutenant Governor,Matt Pinnell,REP,630013,55,125,618,798,
Pottawatomie,Lieutenant Governor,Anastasia Pittman,DEM,630013,61,67,269,397,
Pottawatomie,Lieutenant Governor,Ivan Holmes,IND,630013,4,6,24,34,
Pottawatomie,State Auditor,John Yeutter,LIB,630013,26,31,144,201,
Pottawatomie,State Auditor,Cindy Byrd,REP,630013,81,153,697,931,
Pottawatomie,Attorney General,Mike Hunter,REP,630013,63,135,646,844,
Pottawatomie,Attorney General,Mark Myles,DEM,630013,56,61,260,377,
Pottawatomie,State Treasurer,Randy Mcdaniel,REP,630013,67,141,669,877,
Pottawatomie,State Treasurer,Charles De Coune,IND,630013,42,44,169,255,
Pottawatomie,Superintendent of Public Instruction,Joy Hofmeister,REP,630013,63,143,602,808,
Pottawatomie,Superintendent of Public Instruction,John Cox,DEM,630013,48,50,232,330,
Pottawatomie,Superintendent of Public Instruction,Larry Huff,IND,630013,7,4,69,80,
Pottawatomie,Commissioner of Labor,Leslie Osborn,REP,630013,60,125,622,807,
Pottawatomie,Commissioner of Labor,Fred Dorrell,DEM,630013,56,62,233,351,
Pottawatomie,Commissioner of Labor,Brandt Dismukes,IND,630013,2,5,29,36,
Pottawatomie,Insurance Commissioner,Glen Mulready,REP,630013,57,128,606,791,
Pottawatomie,Insurance Commissioner,Kimberly Fobbs,DEM,630013,60,68,278,406,
Pottawatomie,Corporation Commissioner,Bob Anthony,REP,630013,59,122,594,775,
Pottawatomie,Corporation Commissioner,Ashley Nicole Mccray,DEM,630013,55,67,257,379,
Pottawatomie,Corporation Commissioner,Jackie Short,IND,630013,4,6,41,51,
Pottawatomie,U.S. House,Steve Russell,REP,630013,55,115,582,752,5
Pottawatomie,U.S. House,Kendra Horn,DEM,630013,63,82,329,474,5
Pottawatomie,State House,Dell Kerbs,REP,630013,45,101,541,687,26
Pottawatomie,State House,Terry Hopkins,DEM,630013,74,95,367,536,26
Pottawatomie,Governor,Chris Powell,LIB,630015,4,2,44,50,
Pottawatomie,Governor,Kevin Stitt,REP,630015,20,61,381,462,
Pottawatomie,Governor,Drew Edmondson,DEM,630015,35,54,398,487,
Pottawatomie,Lieutenant Governor,Matt Pinnell,REP,630015,22,69,464,555,
Pottawatomie,Lieutenant Governor,Anastasia Pittman,DEM,630015,34,46,319,399,
Pottawatomie,Lieutenant Governor,Ivan Holmes,IND,630015,3,1,37,41,
Pottawatomie,State Auditor,John Yeutter,LIB,630015,15,18,212,245,
Pottawatomie,State Auditor,Cindy Byrd,REP,630015,37,96,552,685,
Pottawatomie,Attorney General,Mike Hunter,REP,630015,33,81,498,612,
Pottawatomie,Attorney General,Mark Myles,DEM,630015,24,34,319,377,
Pottawatomie,State Treasurer,Randy Mcdaniel,REP,630015,36,89,536,661,
Pottawatomie,State Treasurer,Charles De Coune,IND,630015,15,24,235,274,
Pottawatomie,Superintendent of Public Instruction,Joy Hofmeister,REP,630015,27,83,451,561,
Pottawatomie,Superintendent of Public Instruction,John Cox,DEM,630015,30,31,296,357,
Pottawatomie,Superintendent of Public Instruction,Larry Huff,IND,630015,2,4,68,74,
Pottawatomie,Commissioner of Labor,Leslie Osborn,REP,630015,28,81,459,568,
Pottawatomie,Commissioner of Labor,Fred Dorrell,DEM,630015,25,35,298,358,
Pottawatomie,Commissioner of Labor,Brandt Dismukes,IND,630015,5,0,52,57,
Pottawatomie,Insurance Commissioner,Glen Mulready,REP,630015,27,75,451,553,
Pottawatomie,Insurance Commissioner,Kimberly Fobbs,DEM,630015,32,40,361,433,
Pottawatomie,Corporation Commissioner,Bob Anthony,REP,630015,29,76,424,529,
Pottawatomie,Corporation Commissioner,Ashley Nicole Mccray,DEM,630015,26,38,336,400,
Pottawatomie,Corporation Commissioner,Jackie Short,IND,630015,3,3,58,64,
Pottawatomie,U.S. House,Steve Russell,REP,630015,25,64,429,518,5
Pottawatomie,U.S. House,Kendra Horn,DEM,630015,33,54,386,473,5
Pottawatomie,State House,Dell Kerbs,REP,630015,22,62,436,520,26
Pottawatomie,State House,Terry Hopkins,DEM,630015,37,56,386,479,26
Pottawatomie,Governor,Chris Powell,LIB,630018,4,2,31,37,
Pottawatomie,Governor,Kevin Stitt,REP,630018,39,38,362,439,
Pottawatomie,Governor,Drew Edmondson,DEM,630018,25,41,351,417,
Pottawatomie,Lieutenant Governor,Matt Pinnell,REP,630018,41,47,420,508,
Pottawatomie,Lieutenant Governor,Anastasia Pittman,DEM,630018,21,32,290,343,
Pottawatomie,Lieutenant Governor,Ivan Holmes,IND,630018,5,2,32,39,
Pottawatomie,State Auditor,John Yeutter,LIB,630018,12,13,183,208,
Pottawatomie,State Auditor,Cindy Byrd,REP,630018,49,60,512,621,
Pottawatomie,Attorney General,Mike Hunter,REP,630018,47,50,475,572,
Pottawatomie,Attorney General,Mark Myles,DEM,630018,20,31,265,316,
Pottawatomie,State Treasurer,Randy Mcdaniel,REP,630018,46,51,476,573,
Pottawatomie,State Treasurer,Charles De Coune,IND,630018,14,24,224,262,
Pottawatomie,Superintendent of Public Instruction,Joy Hofmeister,REP,630018,48,49,420,517,
Pottawatomie,Superintendent of Public Instruction,John Cox,DEM,630018,15,30,249,294,
Pottawatomie,Superintendent of Public Instruction,Larry Huff,IND,630018,4,2,72,78,
Pottawatomie,Commissioner of Labor,Leslie Osborn,REP,630018,45,52,427,524,
Pottawatomie,Commissioner of Labor,Fred Dorrell,DEM,630018,17,28,257,302,
Pottawatomie,Commissioner of Labor,Brandt Dismukes,IND,630018,4,1,49,54,
Pottawatomie,Insurance Commissioner,Glen Mulready,REP,630018,44,48,411,503,
Pottawatomie,Insurance Commissioner,Kimberly Fobbs,DEM,630018,23,33,321,377,
Pottawatomie,Corporation Commissioner,Bob Anthony,REP,630018,42,49,430,521,
Pottawatomie,Corporation Commissioner,Ashley Nicole Mccray,DEM,630018,21,31,262,314,
Pottawatomie,Corporation Commissioner,Jackie Short,IND,630018,4,1,47,52,
Pottawatomie,U.S. House,Steve Russell,REP,630018,43,44,386,473,5
Pottawatomie,U.S. House,Kendra Horn,DEM,630018,25,37,357,419,5
Pottawatomie,State House,Dell Kerbs,REP,630018,46,40,395,481,26
Pottawatomie,State House,Terry Hopkins,DEM,630018,22,41,346,409,26
Pottawatomie,Governor,Chris Powell,LIB,630021,2,1,16,19,
Pottawatomie,Governor,Kevin Stitt,REP,630021,14,24,310,348,
Pottawatomie,Governor,Drew Edmondson,DEM,630021,16,7,149,172,
Pottawatomie,Lieutenant Governor,Matt Pinnell,REP,630021,16,24,338,378,
Pottawatomie,Lieutenant Governor,Anastasia Pittman,DEM,630021,13,6,122,141,
Pottawatomie,Lieutenant Governor,Ivan Holmes,IND,630021,3,2,12,17,
Pottawatomie,State Auditor,John Yeutter,LIB,630021,11,7,84,102,
Pottawatomie,State Auditor,Cindy Byrd,REP,630021,19,25,364,408,
Pottawatomie,Attorney General,Mike Hunter,REP,630021,16,24,343,383,
Pottawatomie,Attorney General,Mark Myles,DEM,630021,16,8,127,151,
Pottawatomie,State Treasurer,Randy Mcdaniel,REP,630021,19,25,348,392,
Pottawatomie,State Treasurer,Charles De Coune,IND,630021,11,7,96,114,
Pottawatomie,Superintendent of Public Instruction,Joy Hofmeister,REP,630021,16,25,313,354,
Pottawatomie,Superintendent of Public Instruction,John Cox,DEM,630021,15,5,125,145,
Pottawatomie,Superintendent of Public Instruction,Larry Huff,IND,630021,1,2,37,40,
Pottawatomie,Commissioner of Labor,Leslie Osborn,REP,630021,18,24,329,371,
Pottawatomie,Commissioner of Labor,Fred Dorrell,DEM,630021,14,5,123,142,
Pottawatomie,Commissioner of Labor,Brandt Dismukes,IND,630021,0,3,18,21,
Pottawatomie,Insurance Commissioner,Glen Mulready,REP,630021,16,24,335,375,
Pottawatomie,Insurance Commissioner,Kimberly Fobbs,DEM,630021,16,8,131,155,
Pottawatomie,Corporation Commissioner,Bob Anthony,REP,630021,19,21,318,358,
Pottawatomie,Corporation Commissioner,Ashley Nicole Mccray,DEM,630021,12,7,129,148,
Pottawatomie,Corporation Commissioner,Jackie Short,IND,630021,1,3,24,28,
Pottawatomie,U.S. House,Steve Russell,REP,630021,20,23,325,368,5
Pottawatomie,U.S. House,Kendra Horn,DEM,630021,12,8,147,167,5
Pottawatomie,State Senate,Jason Smalley,REP,630021,19,24,328,371,28
Pottawatomie,State Senate,Stephanie Sanders,IND,630021,11,8,126,145,28
Pottawatomie,State House,Dell Kerbs,REP,630021,17,25,310,352,26
Pottawatomie,State House,Terry Hopkins,DEM,630021,15,7,160,182,26
Pottawatomie,Governor,Chris Powell,LIB,630022,0,5,55,60,
Pottawatomie,Governor,Kevin Stitt,REP,630022,28,89,630,747,
Pottawatomie,Governor,Drew Edmondson,DEM,630022,45,59,264,368,
Pottawatomie,Lieutenant Governor,Matt Pinnell,REP,630022,33,102,710,845,
Pottawatomie,Lieutenant Governor,Anastasia Pittman,DEM,630022,40,47,194,281,
Pottawatomie,Lieutenant Governor,Ivan Holmes,IND,630022,0,4,41,45,
Pottawatomie,State Auditor,John Yeutter,LIB,630022,26,28,179,233,
Pottawatomie,State Auditor,Cindy Byrd,REP,630022,39,110,726,875,
Pottawatomie,Attorney General,Mike Hunter,REP,630022,29,108,726,863,
Pottawatomie,Attorney General,Mark Myles,DEM,630022,44,45,215,304,
Pottawatomie,State Treasurer,Randy Mcdaniel,REP,630022,36,112,733,881,
Pottawatomie,State Treasurer,Charles De Coune,IND,630022,28,25,175,228,
Pottawatomie,Superintendent of Public Instruction,Joy Hofmeister,REP,630022,36,104,645,785,
Pottawatomie,Superintendent of Public Instruction,John Cox,DEM,630022,31,37,175,243,
Pottawatomie,Superintendent of Public Instruction,Larry Huff,IND,630022,6,12,120,138,
Pottawatomie,Commissioner of Labor,Leslie Osborn,REP,630022,38,108,695,841,
Pottawatomie,Commissioner of Labor,Fred Dorrell,DEM,630022,33,39,188,260,
Pottawatomie,Commissioner of Labor,Brandt Dismukes,IND,630022,2,6,51,59,
Pottawatomie,Insurance Commissioner,Glen Mulready,REP,630022,32,102,706,840,
Pottawatomie,Insurance Commissioner,Kimberly Fobbs,DEM,630022,41,49,228,318,
Pottawatomie,Corporation Commissioner,Bob Anthony,REP,630022,34,103,633,770,
Pottawatomie,Corporation Commissioner,Ashley Nicole Mccray,DEM,630022,34,38,219,291,
Pottawatomie,Corporation Commissioner,Jackie Short,IND,630022,5,11,84,100,
Pottawatomie,U.S. House,Steve Russell,REP,630022,27,105,679,811,5
Pottawatomie,U.S. House,Kendra Horn,DEM,630022,46,46,261,353,5
Pottawatomie,State Senate,Jason Smalley,REP,630022,29,102,685,816,28
Pottawatomie,State Senate,Stephanie Sanders,IND,630022,37,38,230,305,28
Pottawatomie,Governor,Chris Powell,LIB,630024,4,1,39,44,
Pottawatomie,Governor,Kevin Stitt,REP,630024,35,60,648,743,
Pottawatomie,Governor,Drew Edmondson,DEM,630024,40,40,271,351,
Pottawatomie,Lieutenant Governor,Matt Pinnell,REP,630024,40,62,727,829,
Pottawatomie,Lieutenant Governor,Anastasia Pittman,DEM,630024,35,37,196,268,
Pottawatomie,Lieutenant Governor,Ivan Holmes,IND,630024,4,2,26,32,
Pottawatomie,State Auditor,John Yeutter,LIB,630024,16,21,142,179,
Pottawatomie,State Auditor,Cindy Byrd,REP,630024,59,71,774,904,
Pottawatomie,Attorney General,Mike Hunter,REP,630024,46,65,752,863,
Pottawatomie,Attorney General,Mark Myles,DEM,630024,33,36,194,263,
Pottawatomie,State Treasurer,Randy Mcdaniel,REP,630024,54,71,768,893,
Pottawatomie,State Treasurer,Charles De Coune,IND,630024,22,23,150,195,
Pottawatomie,Superintendent of Public Instruction,Joy Hofmeister,REP,630024,39,63,686,788,
Pottawatomie,Superintendent of Public Instruction,John Cox,DEM,630024,35,32,178,245,
Pottawatomie,Superintendent of Public Instruction,Larry Huff,IND,630024,4,6,85,95,
Pottawatomie,Commissioner of Labor,Leslie Osborn,REP,630024,42,60,720,822,
Pottawatomie,Commissioner of Labor,Fred Dorrell,DEM,630024,33,38,188,259,
Pottawatomie,Commissioner of Labor,Brandt Dismukes,IND,630024,3,3,36,42,
Pottawatomie,Insurance Commissioner,Glen Mulready,REP,630024,39,64,711,814,
Pottawatomie,Insurance Commissioner,Kimberly Fobbs,DEM,630024,39,36,229,304,
Pottawatomie,Corporation Commissioner,Bob Anthony,REP,630024,40,63,682,785,
Pottawatomie,Corporation Commissioner,Ashley Nicole Mccray,DEM,630024,32,33,206,271,
Pottawatomie,Corporation Commissioner,Jackie Short,IND,630024,6,5,58,69,
Pottawatomie,U.S. House,Steve Russell,REP,630024,45,61,696,802,5
Pottawatomie,U.S. House,Kendra Horn,DEM,630024,34,40,254,328,5
Pottawatomie,State Senate,Jason Smalley,REP,630024,51,66,714,831,28
Pottawatomie,State Senate,Stephanie Sanders,IND,630024,27,28,200,255,28
Pottawatomie,State House,Zack Taylor,REP,630024,40,59,690,789,28
Pottawatomie,State House,Steve Barnes,DEM,630024,36,42,203,281,28
Pottawatomie,State House,Kyle Webb,IND,630024,3,0,52,55,28
Pottawatomie,Governor,Chris Powell,LIB,630025,0,0,36,36,
Pottawatomie,Governor,Kevin Stitt,REP,630025,24,22,400,446,
Pottawatomie,Governor,Drew Edmondson,DEM,630025,27,14,202,243,
Pottawatomie,Lieutenant Governor,Matt Pinnell,REP,630025,27,27,447,501,
Pottawatomie,Lieutenant Governor,Anastasia Pittman,DEM,630025,23,9,159,191,
Pottawatomie,Lieutenant Governor,Ivan Holmes,IND,630025,1,0,28,29,
Pottawatomie,State Auditor,John Yeutter,LIB,630025,21,2,117,140,
Pottawatomie,State Auditor,Cindy Byrd,REP,630025,26,33,490,549,
Pottawatomie,Attorney General,Mike Hunter,REP,630025,26,24,460,510,
Pottawatomie,Attorney General,Mark Myles,DEM,630025,24,12,171,207,
Pottawatomie,State Treasurer,Randy Mcdaniel,REP,630025,25,28,463,516,
Pottawatomie,State Treasurer,Charles De Coune,IND,630025,24,7,142,173,
Pottawatomie,Superintendent of Public Instruction,Joy Hofmeister,REP,630025,24,25,419,468,
Pottawatomie,Superintendent of Public Instruction,John Cox,DEM,630025,19,8,156,183,
Pottawatomie,Superintendent of Public Instruction,Larry Huff,IND,630025,7,3,58,68,
Pottawatomie,Commissioner of Labor,Leslie Osborn,REP,630025,28,24,441,493,
Pottawatomie,Commissioner of Labor,Fred Dorrell,DEM,630025,21,10,150,181,
Pottawatomie,Commissioner of Labor,Brandt Dismukes,IND,630025,3,1,38,42,
Pottawatomie,Insurance Commissioner,Glen Mulready,REP,630025,24,24,447,495,
Pottawatomie,Insurance Commissioner,Kimberly Fobbs,DEM,630025,25,12,181,218,
Pottawatomie,Corporation Commissioner,Bob Anthony,REP,630025,29,21,429,479,
Pottawatomie,Corporation Commissioner,Ashley Nicole Mccray,DEM,630025,18,12,154,184,
Pottawatomie,Corporation Commissioner,Jackie Short,IND,630025,4,3,44,51,
Pottawatomie,U.S. House,Steve Russell,REP,630025,28,26,433,487,5
Pottawatomie,U.S. House,Kendra Horn,DEM,630025,24,10,202,236,5
Pottawatomie,State Senate,Jason Smalley,REP,630025,28,27,441,496,28
Pottawatomie,State Senate,Stephanie Sanders,IND,630025,22,8,168,198,28
Pottawatomie,State House,Zack Taylor,REP,630025,27,27,426,480,28
Pottawatomie,State House,Steve Barnes,DEM,630025,24,8,174,206,28
Pottawatomie,State House,Kyle Webb,IND,630025,1,1,31,33,28
Pottawatomie,Governor,Chris Powell,LIB,630026,0,3,21,24,
Pottawatomie,Governor,Kevin Stitt,REP,630026,30,69,390,489,
Pottawatomie,Governor,Drew Edmondson,DEM,630026,16,18,188,222,
Pottawatomie,Lieutenant Governor,Matt Pinnell,REP,630026,30,76,431,537,
Pottawatomie,Lieutenant Governor,Anastasia Pittman,DEM,630026,15,13,138,166,
Pottawatomie,Lieutenant Governor,Ivan Holmes,IND,630026,1,1,21,23,
Pottawatomie,State Auditor,John Yeutter,LIB,630026,6,8,96,110,
Pottawatomie,State Auditor,Cindy Byrd,REP,630026,35,78,462,575,
Pottawatomie,Attorney General,Mike Hunter,REP,630026,31,77,443,551,
Pottawatomie,Attorney General,Mark Myles,DEM,630026,15,13,148,176,
Pottawatomie,State Treasurer,Randy Mcdaniel,REP,630026,31,78,452,561,
Pottawatomie,State Treasurer,Charles De Coune,IND,630026,12,8,103,123,
Pottawatomie,Superintendent of Public Instruction,Joy Hofmeister,REP,630026,32,64,391,487,
Pottawatomie,Superintendent of Public Instruction,John Cox,DEM,630026,12,19,128,159,
Pottawatomie,Superintendent of Public Instruction,Larry Huff,IND,630026,1,7,69,77,
Pottawatomie,Commissioner of Labor,Leslie Osborn,REP,630026,29,75,435,539,
Pottawatomie,Commissioner of Labor,Fred Dorrell,DEM,630026,14,14,124,152,
Pottawatomie,Commissioner of Labor,Brandt Dismukes,IND,630026,3,1,28,32,
Pottawatomie,Insurance Commissioner,Glen Mulready,REP,630026,31,74,440,545,
Pottawatomie,Insurance Commissioner,Kimberly Fobbs,DEM,630026,15,16,147,178,
Pottawatomie,Corporation Commissioner,Bob Anthony,REP,630026,30,70,408,508,
Pottawatomie,Corporation Commissioner,Ashley Nicole Mccray,DEM,630026,14,16,148,178,
Pottawatomie,Corporation Commissioner,Jackie Short,IND,630026,2,4,35,41,
Pottawatomie,U.S. House,Steve Russell,REP,630026,30,72,414,516,5
Pottawatomie,U.S. House,Kendra Horn,DEM,630026,16,18,177,211,5
Pottawatomie,State Senate,Jason Smalley,REP,630026,29,75,425,529,28
Pottawatomie,State Senate,Stephanie Sanders,IND,630026,15,12,135,162,28
Pottawatomie,State House,Dell Kerbs,REP,630026,30,67,418,515,26
Pottawatomie,State House,Terry Hopkins,DEM,630026,16,23,174,213,26
Pottawatomie,Governor,Chris Powell,LIB,630027,2,1,34,37,
Pottawatomie,Governor,Kevin Stitt,REP,630027,13,20,368,401,
Pottawatomie,Governor,Drew Edmondson,DEM,630027,9,8,165,182,
Pottawatomie,Lieutenant Governor,Matt Pinnell,REP,630027,15,21,397,433,
Pottawatomie,Lieutenant Governor,Anastasia Pittman,DEM,630027,7,7,139,153,
Pottawatomie,Lieutenant Governor,Ivan Holmes,IND,630027,2,1,29,32,
Pottawatomie,State Auditor,John Yeutter,LIB,630027,3,3,94,100,
Pottawatomie,State Auditor,Cindy Byrd,REP,630027,18,22,433,473,
Pottawatomie,Attorney General,Mike Hunter,REP,630027,16,23,420,459,
Pottawatomie,Attorney General,Mark Myles,DEM,630027,8,6,144,158,
Pottawatomie,State Treasurer,Randy Mcdaniel,REP,630027,17,24,421,462,
Pottawatomie,State Treasurer,Charles De Coune,IND,630027,4,2,113,119,
Pottawatomie,Superintendent of Public Instruction,Joy Hofmeister,REP,630027,13,19,385,417,
Pottawatomie,Superintendent of Public Instruction,John Cox,DEM,630027,10,9,115,134,
Pottawatomie,Superintendent of Public Instruction,Larry Huff,IND,630027,1,1,62,64,
Pottawatomie,Commissioner of Labor,Leslie Osborn,REP,630027,17,23,400,440,
Pottawatomie,Commissioner of Labor,Fred Dorrell,DEM,630027,5,6,123,134,
Pottawatomie,Commissioner of Labor,Brandt Dismukes,IND,630027,2,0,37,39,
Pottawatomie,Insurance Commissioner,Glen Mulready,REP,630027,16,20,401,437,
Pottawatomie,Insurance Commissioner,Kimberly Fobbs,DEM,630027,7,9,156,172,
Pottawatomie,Corporation Commissioner,Bob Anthony,REP,630027,16,18,371,405,
Pottawatomie,Corporation Commissioner,Ashley Nicole Mccray,DEM,630027,6,11,138,155,
Pottawatomie,Corporation Commissioner,Jackie Short,IND,630027,2,0,52,54,
Pottawatomie,U.S. House,Steve Russell,REP,630027,19,20,384,423,5
Pottawatomie,U.S. House,Kendra Horn,DEM,630027,6,9,180,195,5
Pottawatomie,State Senate,Jason Smalley,REP,630027,17,22,374,413,28
Pottawatomie,State Senate,Stephanie Sanders,IND,630027,6,3,161,170,28
Pottawatomie,Governor,Chris Powell,LIB,630029,2,5,47,54,
Pottawatomie,Governor,Kevin Stitt,REP,630029,30,54,474,558,
Pottawatomie,Governor,Drew Edmondson,DEM,630029,32,52,300,384,
Pottawatomie,Lieutenant Governor,Matt Pinnell,REP,630029,38,64,556,658,
Pottawatomie,Lieutenant Governor,Anastasia Pittman,DEM,630029,24,44,229,297,
Pottawatomie,Lieutenant Governor,Ivan Holmes,IND,630029,3,3,35,41,
Pottawatomie,State Auditor,John Yeutter,LIB,630029,10,11,170,191,
Pottawatomie,State Auditor,Cindy Byrd,REP,630029,48,82,601,731,
Pottawatomie,Attorney General,Mike Hunter,REP,630029,42,74,583,699,
Pottawatomie,Attorney General,Mark Myles,DEM,630029,22,37,224,283,
Pottawatomie,State Treasurer,Randy Mcdaniel,REP,630029,42,74,599,715,
Pottawatomie,State Treasurer,Charles De Coune,IND,630029,17,21,165,203,
Pottawatomie,Superintendent of Public Instruction,Joy Hofmeister,REP,630029,42,73,506,621,
Pottawatomie,Superintendent of Public Instruction,John Cox,DEM,630029,19,34,218,271,
Pottawatomie,Superintendent of Public Instruction,Larry Huff,IND,630029,4,3,86,93,
Pottawatomie,Commissioner of Labor,Leslie Osborn,REP,630029,46,71,536,653,
Pottawatomie,Commissioner of Labor,Fred Dorrell,DEM,630029,16,35,223,274,
Pottawatomie,Commissioner of Labor,Brandt Dismukes,IND,630029,2,4,37,43,
Pottawatomie,Insurance Commissioner,Glen Mulready,REP,630029,41,65,539,645,
Pottawatomie,Insurance Commissioner,Kimberly Fobbs,DEM,630029,22,42,258,322,
Pottawatomie,Corporation Commissioner,Bob Anthony,REP,630029,39,69,508,616,
Pottawatomie,Corporation Commissioner,Ashley Nicole Mccray,DEM,630029,24,38,237,299,
Pottawatomie,Corporation Commissioner,Jackie Short,IND,630029,2,3,56,61,
Pottawatomie,U.S. House,Steve Russell,REP,630029,37,66,529,632,5
Pottawatomie,U.S. House,Kendra Horn,DEM,630029,26,44,284,354,5
Pottawatomie,State Senate,Jason Smalley,REP,630029,41,66,531,638,28
Pottawatomie,State Senate,Stephanie Sanders,IND,630029,17,31,236,284,28
Pottawatomie,Governor,Chris Powell,LIB,630030,2,1,59,62,
Pottawatomie,Governor,Kevin Stitt,REP,630030,34,64,664,762,
Pottawatomie,Governor,Drew Edmondson,DEM,630030,38,51,474,563,
Pottawatomie,Lieutenant Governor,Matt Pinnell,REP,630030,41,72,775,888,
Pottawatomie,Lieutenant Governor,Anastasia Pittman,DEM,630030,30,42,363,435,
Pottawatomie,Lieutenant Governor,Ivan Holmes,IND,630030,4,1,51,56,
Pottawatomie,State Auditor,John Yeutter,LIB,630030,19,25,238,282,
Pottawatomie,State Auditor,Cindy Byrd,REP,630030,49,79,895,1023,
Pottawatomie,Attorney General,Mike Hunter,REP,630030,40,71,826,937,
Pottawatomie,Attorney General,Mark Myles,DEM,630030,34,45,358,437,
Pottawatomie,State Treasurer,Randy Mcdaniel,REP,630030,47,76,866,989,
Pottawatomie,State Treasurer,Charles De Coune,IND,630030,22,29,258,309,
Pottawatomie,Superintendent of Public Instruction,Joy Hofmeister,REP,630030,42,71,757,870,
Pottawatomie,Superintendent of Public Instruction,John Cox,DEM,630030,29,35,304,368,
Pottawatomie,Superintendent of Public Instruction,Larry Huff,IND,630030,4,10,126,140,
Pottawatomie,Commissioner of Labor,Leslie Osborn,REP,630030,42,69,779,890,
Pottawatomie,Commissioner of Labor,Fred Dorrell,DEM,630030,30,40,325,395,
Pottawatomie,Commissioner of Labor,Brandt Dismukes,IND,630030,3,5,74,82,
Pottawatomie,Insurance Commissioner,Glen Mulready,REP,630030,41,65,775,881,
Pottawatomie,Insurance Commissioner,Kimberly Fobbs,DEM,630030,33,50,402,485,
Pottawatomie,Corporation Commissioner,Bob Anthony,REP,630030,46,67,744,857,
Pottawatomie,Corporation Commissioner,Ashley Nicole Mccray,DEM,630030,28,42,368,438,
Pottawatomie,Corporation Commissioner,Jackie Short,IND,630030,1,5,76,82,
Pottawatomie,U.S. House,Steve Russell,REP,630030,42,64,741,847,5
Pottawatomie,U.S. House,Kendra Horn,DEM,630030,33,51,452,536,5
Pottawatomie,State Senate,Jason Smalley,REP,630030,39,66,780,885,28
Pottawatomie,State Senate,Stephanie Sanders,IND,630030,29,39,354,422,28
Pottawatomie,Governor,Chris Powell,LIB,630031,7,9,71,87,
Pottawatomie,Governor,Kevin Stitt,REP,630031,64,123,873,1060,
Pottawatomie,Governor,Drew Edmondson,DEM,630031,54,81,497,632,
Pottawatomie,Lieutenant Governor,Matt Pinnell,REP,630031,89,140,990,1219,
Pottawatomie,Lieutenant Governor,Anastasia Pittman,DEM,630031,30,66,362,458,
Pottawatomie,Lieutenant Governor,Ivan Holmes,IND,630031,6,6,77,89,
Pottawatomie,State Auditor,John Yeutter,LIB,630031,21,37,294,352,
Pottawatomie,State Auditor,Cindy Byrd,REP,630031,98,158,1077,1333,
Pottawatomie,Attorney General,Mike Hunter,REP,630031,85,143,1046,1274,
Pottawatomie,Attorney General,Mark Myles,DEM,630031,38,69,371,478,
Pottawatomie,State Treasurer,Randy Mcdaniel,REP,630031,90,148,1051,1289,
Pottawatomie,State Treasurer,Charles De Coune,IND,630031,26,47,318,391,
Pottawatomie,Superintendent of Public Instruction,Joy Hofmeister,REP,630031,79,144,875,1098,
Pottawatomie,Superintendent of Public Instruction,John Cox,DEM,630031,36,58,354,448,
Pottawatomie,Superintendent of Public Instruction,Larry Huff,IND,630031,10,11,195,216,
Pottawatomie,Commissioner of Labor,Leslie Osborn,REP,630031,89,146,963,1198,
Pottawatomie,Commissioner of Labor,Fred Dorrell,DEM,630031,31,58,350,439,
Pottawatomie,Commissioner of Labor,Brandt Dismukes,IND,630031,5,7,93,105,
Pottawatomie,Insurance Commissioner,Glen Mulready,REP,630031,85,146,993,1224,
Pottawatomie,Insurance Commissioner,Kimberly Fobbs,DEM,630031,38,66,412,516,
Pottawatomie,Corporation Commissioner,Bob Anthony,REP,630031,82,133,931,1146,
Pottawatomie,Corporation Commissioner,Ashley Nicole Mccray,DEM,630031,34,67,375,476,
Pottawatomie,Corporation Commissioner,Jackie Short,IND,630031,8,13,111,132,
Pottawatomie,U.S. House,Steve Russell,REP,630031,81,143,951,1175,5
Pottawatomie,U.S. House,Kendra Horn,DEM,630031,43,70,476,589,5
Pottawatomie,State House,Zack Taylor,REP,630031,74,140,911,1125,28
Pottawatomie,State House,Steve Barnes,DEM,630031,37,55,375,467,28
Pottawatomie,State House,Kyle Webb,IND,630031,12,16,143,171,28
Pottawatomie,Governor,Chris Powell,LIB,630033,1,1,19,21,
Pottawatomie,Governor,Kevin Stitt,REP,630033,5,14,244,263,
Pottawatomie,Governor,Drew Edmondson,DEM,630033,5,12,135,152,
Pottawatomie,Lieutenant Governor,Matt Pinnell,REP,630033,6,19,272,297,
Pottawatomie,Lieutenant Governor,Anastasia Pittman,DEM,630033,4,8,109,121,
Pottawatomie,Lieutenant Governor,Ivan Holmes,IND,630033,1,0,15,16,
Pottawatomie,State Auditor,John Yeutter,LIB,630033,2,4,67,73,
Pottawatomie,State Auditor,Cindy Byrd,REP,630033,8,23,307,338,
Pottawatomie,Attorney General,Mike Hunter,REP,630033,7,19,293,319,
Pottawatomie,Attorney General,Mark Myles,DEM,630033,4,8,104,116,
Pottawatomie,State Treasurer,Randy Mcdaniel,REP,630033,7,22,303,332,
Pottawatomie,State Treasurer,Charles De Coune,IND,630033,3,4,72,79,
Pottawatomie,Superintendent of Public Instruction,Joy Hofmeister,REP,630033,8,17,281,306,
Pottawatomie,Superintendent of Public Instruction,John Cox,DEM,630033,3,9,87,99,
Pottawatomie,Superintendent of Public Instruction,Larry Huff,IND,630033,0,1,30,31,
Pottawatomie,Commissioner of Labor,Leslie Osborn,REP,630033,7,19,271,297,
Pottawatomie,Commissioner of Labor,Fred Dorrell,DEM,630033,3,8,108,119,
Pottawatomie,Commissioner of Labor,Brandt Dismukes,IND,630033,1,0,14,15,
Pottawatomie,Insurance Commissioner,Glen Mulready,REP,630033,8,19,274,301,
Pottawatomie,Insurance Commissioner,Kimberly Fobbs,DEM,630033,3,8,118,129,
Pottawatomie,Corporation Commissioner,Bob Anthony,REP,630033,7,17,266,290,
Pottawatomie,Corporation Commissioner,Ashley Nicole Mccray,DEM,630033,4,10,106,120,
Pottawatomie,Corporation Commissioner,Jackie Short,IND,630033,0,0,22,22,
Pottawatomie,U.S. House,Steve Russell,REP,630033,7,17,254,278,5
Pottawatomie,U.S. House,Kendra Horn,DEM,630033,4,10,144,158,5
Pottawatomie,State Senate,Jason Smalley,REP,630033,8,21,271,300,28
Pottawatomie,State Senate,Stephanie Sanders,IND,630033,2,6,104,112,28
Pottawatomie,Governor,Chris Powell,LIB,630037,2,0,14,16,
Pottawatomie,Governor,Kevin Stitt,REP,630037,11,11,277,299,
Pottawatomie,Governor,Drew Edmondson,DEM,630037,12,0,104,116,
Pottawatomie,Lieutenant Governor,Matt Pinnell,REP,630037,12,12,300,324,
Pottawatomie,Lieutenant Governor,Anastasia Pittman,DEM,630037,11,0,83,94,
Pottawatomie,Lieutenant Governor,Ivan Holmes,IND,630037,2,0,12,14,
Pottawatomie,State Auditor,John Yeutter,LIB,630037,6,0,63,69,
Pottawatomie,State Auditor,Cindy Byrd,REP,630037,16,12,314,342,
Pottawatomie,Attorney General,Mike Hunter,REP,630037,12,12,314,338,
Pottawatomie,Attorney General,Mark Myles,DEM,630037,13,0,79,92,
Pottawatomie,State Treasurer,Randy Mcdaniel,REP,630037,13,12,311,336,
Pottawatomie,State Treasurer,Charles De Coune,IND,630037,9,0,63,72,
Pottawatomie,Superintendent of Public Instruction,Joy Hofmeister,REP,630037,11,12,265,288,
Pottawatomie,Superintendent of Public Instruction,John Cox,DEM,630037,11,0,78,89,
Pottawatomie,Superintendent of Public Instruction,Larry Huff,IND,630037,3,0,48,51,
Pottawatomie,Commissioner of Labor,Leslie Osborn,REP,630037,14,12,281,307,
Pottawatomie,Commissioner of Labor,Fred Dorrell,DEM,630037,10,0,74,84,
Pottawatomie,Commissioner of Labor,Brandt Dismukes,IND,630037,1,0,34,35,
Pottawatomie,Insurance Commissioner,Glen Mulready,REP,630037,12,12,296,320,
Pottawatomie,Insurance Commissioner,Kimberly Fobbs,DEM,630037,13,0,96,109,
Pottawatomie,Corporation Commissioner,Bob Anthony,REP,630037,12,12,273,297,
Pottawatomie,Corporation Commissioner,Ashley Nicole Mccray,DEM,630037,13,0,89,102,
Pottawatomie,Corporation Commissioner,Jackie Short,IND,630037,0,0,32,32,
Pottawatomie,U.S. House,Steve Russell,REP,630037,12,12,296,320,5
Pottawatomie,U.S. House,Kendra Horn,DEM,630037,13,0,98,111,5
Pottawatomie,Governor,Chris Powell,LIB,630038,1,2,13,16,
Pottawatomie,Governor,Kevin Stitt,REP,630038,3,20,187,210,
Pottawatomie,Governor,Drew Edmondson,DEM,630038,7,8,94,109,
Pottawatomie,Lieutenant Governor,Matt Pinnell,REP,630038,6,21,199,226,
Pottawatomie,Lieutenant Governor,Anastasia Pittman,DEM,630038,5,9,81,95,
Pottawatomie,Lieutenant Governor,Ivan Holmes,IND,630038,0,0,14,14,
Pottawatomie,State Auditor,John Yeutter,LIB,630038,5,6,58,69,
Pottawatomie,State Auditor,Cindy Byrd,REP,630038,6,23,224,253,
Pottawatomie,Attorney General,Mike Hunter,REP,630038,5,21,219,245,
Pottawatomie,Attorney General,Mark Myles,DEM,630038,6,9,74,89,
Pottawatomie,State Treasurer,Randy Mcdaniel,REP,630038,4,22,218,244,
Pottawatomie,State Treasurer,Charles De Coune,IND,630038,7,8,67,82,
Pottawatomie,Superintendent of Public Instruction,Joy Hofmeister,REP,630038,4,19,194,217,
Pottawatomie,Superintendent of Public Instruction,John Cox,DEM,630038,7,8,67,82,
Pottawatomie,Superintendent of Public Instruction,Larry Huff,IND,630038,0,3,31,34,
Pottawatomie,Commissioner of Labor,Leslie Osborn,REP,630038,4,21,203,228,
Pottawatomie,Commissioner of Labor,Fred Dorrell,DEM,630038,7,6,75,88,
Pottawatomie,Commissioner of Labor,Brandt Dismukes,IND,630038,0,3,14,17,
Pottawatomie,Insurance Commissioner,Glen Mulready,REP,630038,5,20,197,222,
Pottawatomie,Insurance Commissioner,Kimberly Fobbs,DEM,630038,6,10,94,110,
Pottawatomie,Corporation Commissioner,Bob Anthony,REP,630038,3,21,185,209,
Pottawatomie,Corporation Commissioner,Ashley Nicole Mccray,DEM,630038,6,6,79,91,
Pottawatomie,Corporation Commissioner,Jackie Short,IND,630038,2,3,30,35,
Pottawatomie,U.S. House,Steve Russell,REP,630038,6,21,182,209,5
Pottawatomie,U.S. House,Kendra Horn,DEM,630038,5,9,111,125,5
Pottawatomie,Governor,Chris Powell,LIB,630040,1,0,19,20,
Pottawatomie,Governor,Kevin Stitt,REP,630040,10,5,174,189,
Pottawatomie,Governor,Drew Edmondson,DEM,630040,9,5,88,102,
Pottawatomie,Lieutenant Governor,Matt Pinnell,REP,630040,10,6,208,224,
Pottawatomie,Lieutenant Governor,Anastasia Pittman,DEM,630040,10,3,62,75,
Pottawatomie,Lieutenant Governor,Ivan Holmes,IND,630040,0,1,9,10,
Pottawatomie,State Auditor,John Yeutter,LIB,630040,4,1,44,49,
Pottawatomie,State Auditor,Cindy Byrd,REP,630040,14,9,224,247,
Pottawatomie,Attorney General,Mike Hunter,REP,630040,12,7,200,219,
Pottawatomie,Attorney General,Mark Myles,DEM,630040,8,3,78,89,
Pottawatomie,State Treasurer,Randy Mcdaniel,REP,630040,13,8,219,240,
Pottawatomie,State Treasurer,Charles De Coune,IND,630040,5,2,50,57,
Pottawatomie,Superintendent of Public Instruction,Joy Hofmeister,REP,630040,10,6,186,202,
Pottawatomie,Superintendent of Public Instruction,John Cox,DEM,630040,9,3,69,81,
Pottawatomie,Superintendent of Public Instruction,Larry Huff,IND,630040,1,1,25,27,
Pottawatomie,Commissioner of Labor,Leslie Osborn,REP,630040,10,8,195,213,
Pottawatomie,Commissioner of Labor,Fred Dorrell,DEM,630040,9,2,62,73,
Pottawatomie,Commissioner of Labor,Brandt Dismukes,IND,630040,1,0,20,21,
Pottawatomie,Insurance Commissioner,Glen Mulready,REP,630040,11,7,197,215,
Pottawatomie,Insurance Commissioner,Kimberly Fobbs,DEM,630040,9,3,84,96,
Pottawatomie,Corporation Commissioner,Bob Anthony,REP,630040,13,6,197,216,
Pottawatomie,Corporation Commissioner,Ashley Nicole Mccray,DEM,630040,7,2,65,74,
Pottawatomie,Corporation Commissioner,Jackie Short,IND,630040,0,2,17,19,
Pottawatomie,U.S. House,Steve Russell,REP,630040,11,7,187,205,5
Pottawatomie,U.S. House,Kendra Horn,DEM,630040,9,3,93,105,5
Pottawatomie,Governor,Chris Powell,LIB,630041,0,0,13,13,
Pottawatomie,Governor,Kevin Stitt,REP,630041,13,10,236,259,
Pottawatomie,Governor,Drew Edmondson,DEM,630041,6,2,122,130,
Pottawatomie,Lieutenant Governor,Matt Pinnell,REP,630041,14,11,267,292,
Pottawatomie,Lieutenant Governor,Anastasia Pittman,DEM,630041,4,1,88,93,
Pottawatomie,Lieutenant Governor,Ivan Holmes,IND,630041,1,0,9,10,
Pottawatomie,State Auditor,John Yeutter,LIB,630041,2,1,56,59,
Pottawatomie,State Auditor,Cindy Byrd,REP,630041,16,11,268,295,
Pottawatomie,Attorney General,Mike Hunter,REP,630041,15,11,271,297,
Pottawatomie,Attorney General,Mark Myles,DEM,630041,4,1,93,98,
Pottawatomie,State Treasurer,Randy Mcdaniel,REP,630041,15,11,268,294,
Pottawatomie,State Treasurer,Charles De Coune,IND,630041,3,1,58,62,
Pottawatomie,Superintendent of Public Instruction,Joy Hofmeister,REP,630041,15,10,221,246,
Pottawatomie,Superintendent of Public Instruction,John Cox,DEM,630041,4,2,94,100,
Pottawatomie,Superintendent of Public Instruction,Larry Huff,IND,630041,0,0,47,47,
Pottawatomie,Commissioner of Labor,Leslie Osborn,REP,630041,15,10,240,265,
Pottawatomie,Commissioner of Labor,Fred Dorrell,DEM,630041,3,2,100,105,
Pottawatomie,Commissioner of Labor,Brandt Dismukes,IND,630041,1,0,18,19,
Pottawatomie,Insurance Commissioner,Glen Mulready,REP,630041,14,10,247,271,
Pottawatomie,Insurance Commissioner,Kimberly Fobbs,DEM,630041,5,2,112,119,
Pottawatomie,Corporation Commissioner,Bob Anthony,REP,630041,15,11,236,262,
Pottawatomie,Corporation Commissioner,Ashley Nicole Mccray,DEM,630041,3,1,106,110,
Pottawatomie,Corporation Commissioner,Jackie Short,IND,630041,1,0,20,21,
Pottawatomie,U.S. House,Steve Russell,REP,630041,13,11,235,259,5
Pottawatomie,U.S. House,Kendra Horn,DEM,630041,6,1,130,137,5
Pottawatomie,Governor,Chris Powell,LIB,630042,1,0,7,8,
Pottawatomie,Governor,Kevin Stitt,REP,630042,8,4,146,158,
Pottawatomie,Governor,Drew Edmondson,DEM,630042,0,0,56,56,
Pottawatomie,Lieutenant Governor,Matt Pinnell,REP,630042,8,4,150,162,
Pottawatomie,Lieutenant Governor,Anastasia Pittman,DEM,630042,0,0,50,50,
Pottawatomie,Lieutenant Governor,Ivan Holmes,IND,630042,1,0,5,6,
Pottawatomie,State Auditor,John Yeutter,LIB,630042,1,0,21,22,
Pottawatomie,State Auditor,Cindy Byrd,REP,630042,8,4,168,180,
Pottawatomie,Attorney General,Mike Hunter,REP,630042,9,4,164,177,
Pottawatomie,Attorney General,Mark Myles,DEM,630042,0,0,43,43,
Pottawatomie,State Treasurer,Randy Mcdaniel,REP,630042,8,4,163,175,
Pottawatomie,State Treasurer,Charles De Coune,IND,630042,1,0,24,25,
Pottawatomie,Superintendent of Public Instruction,Joy Hofmeister,REP,630042,8,4,147,159,
Pottawatomie,Superintendent of Public Instruction,John Cox,DEM,630042,0,0,45,45,
Pottawatomie,Superintendent of Public Instruction,Larry Huff,IND,630042,1,0,15,16,
Pottawatomie,Commissioner of Labor,Leslie Osborn,REP,630042,6,4,156,166,
Pottawatomie,Commissioner of Labor,Fred Dorrell,DEM,630042,2,0,42,44,
Pottawatomie,Commissioner of Labor,Brandt Dismukes,IND,630042,1,0,7,8,
Pottawatomie,Insurance Commissioner,Glen Mulready,REP,630042,9,4,154,167,
Pottawatomie,Insurance Commissioner,Kimberly Fobbs,DEM,630042,0,0,53,53,
Pottawatomie,Corporation Commissioner,Bob Anthony,REP,630042,8,4,152,164,
Pottawatomie,Corporation Commissioner,Ashley Nicole Mccray,DEM,630042,0,0,45,45,
Pottawatomie,Corporation Commissioner,Jackie Short,IND,630042,1,0,10,11,
Pottawatomie,U.S. House,Steve Russell,REP,630042,8,4,142,154,5
Pottawatomie,U.S. House,Kendra Horn,DEM,630042,1,0,64,65,5
Pottawatomie,State House,Sherrie Conley,REP,630042,8,4,148,160,20
Pottawatomie,State House,Steve Jarman,DEM,630042,1,0,56,57,20
Pushmataha,Governor,Chris Powell,LIB,640001,0,0,11,11,
Pushmataha,Governor,Kevin Stitt,REP,640001,3,8,138,149,
Pushmataha,Governor,Drew Edmondson,DEM,640001,1,13,77,91,
Pushmataha,Lieutenant Governor,Matt Pinnell,REP,640001,3,14,153,170,
Pushmataha,Lieutenant Governor,Anastasia Pittman,DEM,640001,1,7,60,68,
Pushmataha,Lieutenant Governor,Ivan Holmes,IND,640001,0,0,8,8,
Pushmataha,State Auditor,John Yeutter,LIB,640001,1,2,38,41,
Pushmataha,State Auditor,Cindy Byrd,REP,640001,3,16,174,193,
Pushmataha,Attorney General,Mike Hunter,REP,640001,3,13,152,168,
Pushmataha,Attorney General,Mark Myles,DEM,640001,1,7,66,74,
Pushmataha,State Treasurer,Randy Mcdaniel,REP,640001,3,14,162,179,
Pushmataha,State Treasurer,Charles De Coune,IND,640001,1,5,46,52,
Pushmataha,Superintendent of Public Instruction,Joy Hofmeister,REP,640001,2,14,135,151,
Pushmataha,Superintendent of Public Instruction,John Cox,DEM,640001,1,5,63,69,
Pushmataha,Superintendent of Public Instruction,Larry Huff,IND,640001,1,1,24,26,
Pushmataha,Commissioner of Labor,Leslie Osborn,REP,640001,3,11,144,158,
Pushmataha,Commissioner of Labor,Fred Dorrell,DEM,640001,1,7,53,61,
Pushmataha,Commissioner of Labor,Brandt Dismukes,IND,640001,0,1,20,21,
Pushmataha,Insurance Commissioner,Glen Mulready,REP,640001,3,13,145,161,
Pushmataha,Insurance Commissioner,Kimberly Fobbs,DEM,640001,1,5,72,78,
Pushmataha,Corporation Commissioner,Bob Anthony,REP,640001,2,13,138,153,
Pushmataha,Corporation Commissioner,Ashley Nicole Mccray,DEM,640001,1,5,62,68,
Pushmataha,Corporation Commissioner,Jackie Short,IND,640001,1,1,17,19,
Pushmataha,U.S. House,Richard Castaldo,LIB,640001,0,1,3,4,2
Pushmataha,U.S. House,Markwayne Mullin,REP,640001,3,13,150,166,2
Pushmataha,U.S. House,Jason Nichols,DEM,640001,1,7,58,66,2
Pushmataha,U.S. House,John Foreman,IND,640001,0,0,13,13,2
Pushmataha,State House,Justin Humphrey,REP,640001,3,13,153,169,19
Pushmataha,State House,Lewis Collins,DEM,640001,1,8,71,80,19
Pushmataha,Governor,Chris Powell,LIB,640002,0,3,19,22,
Pushmataha,Governor,Kevin Stitt,REP,640002,7,56,274,337,
Pushmataha,Governor,Drew Edmondson,DEM,640002,10,61,147,218,
Pushmataha,Lieutenant Governor,Matt Pinnell,REP,640002,8,71,305,384,
Pushmataha,Lieutenant Governor,Anastasia Pittman,DEM,640002,9,43,111,163,
Pushmataha,Lieutenant Governor,Ivan Holmes,IND,640002,0,5,18,23,
Pushmataha,State Auditor,John Yeutter,LIB,640002,1,29,63,93,
Pushmataha,State Auditor,Cindy Byrd,REP,640002,10,88,351,449,
Pushmataha,Attorney General,Mike Hunter,REP,640002,9,71,313,393,
Pushmataha,Attorney General,Mark Myles,DEM,640002,8,46,118,172,
Pushmataha,State Treasurer,Randy Mcdaniel,REP,640002,11,81,341,433,
Pushmataha,State Treasurer,Charles De Coune,IND,640002,2,34,73,109,
Pushmataha,Superintendent of Public Instruction,Joy Hofmeister,REP,640002,8,56,258,322,
Pushmataha,Superintendent of Public Instruction,John Cox,DEM,640002,8,54,129,191,
Pushmataha,Superintendent of Public Instruction,Larry Huff,IND,640002,1,8,41,50,
Pushmataha,Commissioner of Labor,Leslie Osborn,REP,640002,7,60,283,350,
Pushmataha,Commissioner of Labor,Fred Dorrell,DEM,640002,9,49,113,171,
Pushmataha,Commissioner of Labor,Brandt Dismukes,IND,640002,1,5,22,28,
Pushmataha,Insurance Commissioner,Glen Mulready,REP,640002,10,66,283,359,
Pushmataha,Insurance Commissioner,Kimberly Fobbs,DEM,640002,7,52,141,200,
Pushmataha,Corporation Commissioner,Bob Anthony,REP,640002,9,64,272,345,
Pushmataha,Corporation Commissioner,Ashley Nicole Mccray,DEM,640002,8,50,119,177,
Pushmataha,Corporation Commissioner,Jackie Short,IND,640002,0,3,33,36,
Pushmataha,U.S. House,Richard Castaldo,LIB,640002,0,2,13,15,2
Pushmataha,U.S. House,Markwayne Mullin,REP,640002,9,68,309,386,2
Pushmataha,U.S. House,Jason Nichols,DEM,640002,8,47,101,156,2
Pushmataha,U.S. House,John Foreman,IND,640002,0,1,16,17,2
Pushmataha,State House,Justin Humphrey,REP,640002,7,69,297,373,19
Pushmataha,State House,Lewis Collins,DEM,640002,9,48,140,197,19
Pushmataha,Governor,Chris Powell,LIB,640003,0,0,15,15,
Pushmataha,Governor,Kevin Stitt,REP,640003,1,19,154,174,
Pushmataha,Governor,Drew Edmondson,DEM,640003,0,17,80,97,
Pushmataha,Lieutenant Governor,Matt Pinnell,REP,640003,1,21,169,191,
Pushmataha,Lieutenant Governor,Anastasia Pittman,DEM,640003,0,15,63,78,
Pushmataha,Lieutenant Governor,Ivan Holmes,IND,640003,0,0,14,14,
Pushmataha,State Auditor,John Yeutter,LIB,640003,0,8,42,50,
Pushmataha,State Auditor,Cindy Byrd,REP,640003,1,24,192,217,
Pushmataha,Attorney General,Mike Hunter,REP,640003,0,22,168,190,
Pushmataha,Attorney General,Mark Myles,DEM,640003,0,14,77,91,
Pushmataha,State Treasurer,Randy Mcdaniel,REP,640003,0,25,190,215,
Pushmataha,State Treasurer,Charles De Coune,IND,640003,0,6,42,48,
Pushmataha,Superintendent of Public Instruction,Joy Hofmeister,REP,640003,0,19,153,172,
Pushmataha,Superintendent of Public Instruction,John Cox,DEM,640003,0,13,67,80,
Pushmataha,Superintendent of Public Instruction,Larry Huff,IND,640003,0,4,25,29,
Pushmataha,Commissioner of Labor,Leslie Osborn,REP,640003,0,18,157,175,
Pushmataha,Commissioner of Labor,Fred Dorrell,DEM,640003,0,15,71,86,
Pushmataha,Commissioner of Labor,Brandt Dismukes,IND,640003,0,2,13,15,
Pushmataha,Insurance Commissioner,Glen Mulready,REP,640003,1,21,166,188,
Pushmataha,Insurance Commissioner,Kimberly Fobbs,DEM,640003,0,15,74,89,
Pushmataha,Corporation Commissioner,Bob Anthony,REP,640003,1,18,156,175,
Pushmataha,Corporation Commissioner,Ashley Nicole Mccray,DEM,640003,0,15,74,89,
Pushmataha,Corporation Commissioner,Jackie Short,IND,640003,0,3,12,15,
Pushmataha,U.S. House,Richard Castaldo,LIB,640003,0,0,4,4,2
Pushmataha,U.S. House,Markwayne Mullin,REP,640003,1,20,174,195,2
Pushmataha,U.S. House,Jason Nichols,DEM,640003,0,14,57,71,2
Pushmataha,U.S. House,John Foreman,IND,640003,0,2,12,14,2
Pushmataha,State House,Justin Humphrey,REP,640003,1,17,173,191,19
Pushmataha,State House,Lewis Collins,DEM,640003,0,19,72,91,19
Pushmataha,Governor,Chris Powell,LIB,640004,0,0,14,14,
Pushmataha,Governor,Kevin Stitt,REP,640004,12,46,188,246,
Pushmataha,Governor,Drew Edmondson,DEM,640004,4,19,91,114,
Pushmataha,Lieutenant Governor,Matt Pinnell,REP,640004,12,50,203,265,
Pushmataha,Lieutenant Governor,Anastasia Pittman,DEM,640004,3,14,73,90,
Pushmataha,Lieutenant Governor,Ivan Holmes,IND,640004,0,0,12,12,
Pushmataha,State Auditor,John Yeutter,LIB,640004,0,1,36,37,
Pushmataha,State Auditor,Cindy Byrd,REP,640004,16,55,240,311,
Pushmataha,Attorney General,Mike Hunter,REP,640004,13,48,218,279,
Pushmataha,Attorney General,Mark Myles,DEM,640004,3,15,70,88,
Pushmataha,State Treasurer,Randy Mcdaniel,REP,640004,14,55,229,298,
Pushmataha,State Treasurer,Charles De Coune,IND,640004,1,3,37,41,
Pushmataha,Superintendent of Public Instruction,Joy Hofmeister,REP,640004,10,48,192,250,
Pushmataha,Superintendent of Public Instruction,John Cox,DEM,640004,3,13,75,91,
Pushmataha,Superintendent of Public Instruction,Larry Huff,IND,640004,2,3,21,26,
Pushmataha,Commissioner of Labor,Leslie Osborn,REP,640004,11,47,200,258,
Pushmataha,Commissioner of Labor,Fred Dorrell,DEM,640004,4,14,72,90,
Pushmataha,Commissioner of Labor,Brandt Dismukes,IND,640004,0,2,12,14,
Pushmataha,Insurance Commissioner,Glen Mulready,REP,640004,11,48,209,268,
Pushmataha,Insurance Commissioner,Kimberly Fobbs,DEM,640004,4,16,75,95,
Pushmataha,Corporation Commissioner,Bob Anthony,REP,640004,13,45,195,253,
Pushmataha,Corporation Commissioner,Ashley Nicole Mccray,DEM,640004,3,16,72,91,
Pushmataha,Corporation Commissioner,Jackie Short,IND,640004,0,3,16,19,
Pushmataha,U.S. House,Richard Castaldo,LIB,640004,1,1,4,6,2
Pushmataha,U.S. House,Markwayne Mullin,REP,640004,12,41,214,267,2
Pushmataha,U.S. House,Jason Nichols,DEM,640004,3,19,66,88,2
Pushmataha,U.S. House,John Foreman,IND,640004,0,4,7,11,2
Pushmataha,State House,Justin Humphrey,REP,640004,9,48,207,264,19
Pushmataha,State House,Lewis Collins,DEM,640004,7,17,85,109,19
Pushmataha,Governor,Chris Powell,LIB,640005,0,0,1,1,
Pushmataha,Governor,Kevin Stitt,REP,640005,1,3,40,44,
Pushmataha,Governor,Drew Edmondson,DEM,640005,2,3,17,22,
Pushmataha,Lieutenant Governor,Matt Pinnell,REP,640005,3,4,37,44,
Pushmataha,Lieutenant Governor,Anastasia Pittman,DEM,640005,0,2,15,17,
Pushmataha,Lieutenant Governor,Ivan Holmes,IND,640005,0,0,5,5,
Pushmataha,State Auditor,John Yeutter,LIB,640005,0,0,5,5,
Pushmataha,State Auditor,Cindy Byrd,REP,640005,3,6,46,55,
Pushmataha,Attorney General,Mike Hunter,REP,640005,3,5,42,50,
Pushmataha,Attorney General,Mark Myles,DEM,640005,0,1,15,16,
Pushmataha,State Treasurer,Randy Mcdaniel,REP,640005,3,5,44,52,
Pushmataha,State Treasurer,Charles De Coune,IND,640005,0,0,7,7,
Pushmataha,Superintendent of Public Instruction,Joy Hofmeister,REP,640005,3,4,32,39,
Pushmataha,Superintendent of Public Instruction,John Cox,DEM,640005,0,2,18,20,
Pushmataha,Superintendent of Public Instruction,Larry Huff,IND,640005,0,0,7,7,
Pushmataha,Commissioner of Labor,Leslie Osborn,REP,640005,3,3,41,47,
Pushmataha,Commissioner of Labor,Fred Dorrell,DEM,640005,0,1,16,17,
Pushmataha,Commissioner of Labor,Brandt Dismukes,IND,640005,0,1,0,1,
Pushmataha,Insurance Commissioner,Glen Mulready,REP,640005,3,5,37,45,
Pushmataha,Insurance Commissioner,Kimberly Fobbs,DEM,640005,0,0,17,17,
Pushmataha,Corporation Commissioner,Bob Anthony,REP,640005,3,4,33,40,
Pushmataha,Corporation Commissioner,Ashley Nicole Mccray,DEM,640005,0,1,15,16,
Pushmataha,Corporation Commissioner,Jackie Short,IND,640005,0,1,7,8,
Pushmataha,U.S. House,Richard Castaldo,LIB,640005,0,0,1,1,2
Pushmataha,U.S. House,Markwayne Mullin,REP,640005,3,5,38,46,2
Pushmataha,U.S. House,Jason Nichols,DEM,640005,0,1,15,16,2
Pushmataha,U.S. House,John Foreman,IND,640005,0,0,3,3,2
Pushmataha,State House,Justin Humphrey,REP,640005,3,4,40,47,19
Pushmataha,State House,Lewis Collins,DEM,640005,0,2,18,20,19
Pushmataha,Governor,Chris Powell,LIB,640007,0,0,2,2,
Pushmataha,Governor,Kevin Stitt,REP,640007,4,6,66,76,
Pushmataha,Governor,Drew Edmondson,DEM,640007,0,3,45,48,
Pushmataha,Lieutenant Governor,Matt Pinnell,REP,640007,4,7,73,84,
Pushmataha,Lieutenant Governor,Anastasia Pittman,DEM,640007,0,2,35,37,
Pushmataha,Lieutenant Governor,Ivan Holmes,IND,640007,0,0,2,2,
Pushmataha,State Auditor,John Yeutter,LIB,640007,0,2,19,21,
Pushmataha,State Auditor,Cindy Byrd,REP,640007,4,7,81,92,
Pushmataha,Attorney General,Mike Hunter,REP,640007,4,7,72,83,
Pushmataha,Attorney General,Mark Myles,DEM,640007,0,2,37,39,
Pushmataha,State Treasurer,Randy Mcdaniel,REP,640007,4,7,75,86,
Pushmataha,State Treasurer,Charles De Coune,IND,640007,0,2,24,26,
Pushmataha,Superintendent of Public Instruction,Joy Hofmeister,REP,640007,4,6,64,74,
Pushmataha,Superintendent of Public Instruction,John Cox,DEM,640007,0,3,35,38,
Pushmataha,Superintendent of Public Instruction,Larry Huff,IND,640007,0,0,9,9,
Pushmataha,Commissioner of Labor,Leslie Osborn,REP,640007,4,7,67,78,
Pushmataha,Commissioner of Labor,Fred Dorrell,DEM,640007,0,2,37,39,
Pushmataha,Commissioner of Labor,Brandt Dismukes,IND,640007,0,0,5,5,
Pushmataha,Insurance Commissioner,Glen Mulready,REP,640007,4,7,69,80,
Pushmataha,Insurance Commissioner,Kimberly Fobbs,DEM,640007,0,2,39,41,
Pushmataha,Corporation Commissioner,Bob Anthony,REP,640007,4,7,67,78,
Pushmataha,Corporation Commissioner,Ashley Nicole Mccray,DEM,640007,0,2,37,39,
Pushmataha,Corporation Commissioner,Jackie Short,IND,640007,0,0,4,4,
Pushmataha,U.S. House,Richard Castaldo,LIB,640007,0,0,1,1,2
Pushmataha,U.S. House,Markwayne Mullin,REP,640007,4,7,73,84,2
Pushmataha,U.S. House,Jason Nichols,DEM,640007,0,2,34,36,2
Pushmataha,U.S. House,John Foreman,IND,640007,0,0,3,3,2
Pushmataha,State House,Justin Humphrey,REP,640007,4,6,72,82,19
Pushmataha,State House,Lewis Collins,DEM,640007,0,3,38,41,19
Pushmataha,Governor,Chris Powell,LIB,640008,0,0,10,10,
Pushmataha,Governor,Kevin Stitt,REP,640008,1,5,67,73,
Pushmataha,Governor,Drew Edmondson,DEM,640008,1,3,40,44,
Pushmataha,Lieutenant Governor,Matt Pinnell,REP,640008,1,6,75,82,
Pushmataha,Lieutenant Governor,Anastasia Pittman,DEM,640008,1,2,33,36,
Pushmataha,Lieutenant Governor,Ivan Holmes,IND,640008,0,0,6,6,
Pushmataha,State Auditor,John Yeutter,LIB,640008,0,1,18,19,
Pushmataha,State Auditor,Cindy Byrd,REP,640008,2,7,86,95,
Pushmataha,Attorney General,Mike Hunter,REP,640008,1,7,76,84,
Pushmataha,Attorney General,Mark Myles,DEM,640008,1,1,35,37,
Pushmataha,State Treasurer,Randy Mcdaniel,REP,640008,1,7,85,93,
Pushmataha,State Treasurer,Charles De Coune,IND,640008,1,1,16,18,
Pushmataha,Superintendent of Public Instruction,Joy Hofmeister,REP,640008,1,6,73,80,
Pushmataha,Superintendent of Public Instruction,John Cox,DEM,640008,1,2,32,35,
Pushmataha,Superintendent of Public Instruction,Larry Huff,IND,640008,0,0,7,7,
Pushmataha,Commissioner of Labor,Leslie Osborn,REP,640008,1,5,75,81,
Pushmataha,Commissioner of Labor,Fred Dorrell,DEM,640008,1,2,35,38,
Pushmataha,Commissioner of Labor,Brandt Dismukes,IND,640008,0,0,0,0,
Pushmataha,Insurance Commissioner,Glen Mulready,REP,640008,1,7,75,83,
Pushmataha,Insurance Commissioner,Kimberly Fobbs,DEM,640008,1,1,35,37,
Pushmataha,Corporation Commissioner,Bob Anthony,REP,640008,1,7,76,84,
Pushmataha,Corporation Commissioner,Ashley Nicole Mccray,DEM,640008,1,1,32,34,
Pushmataha,Corporation Commissioner,Jackie Short,IND,640008,0,0,4,4,
Pushmataha,U.S. House,Richard Castaldo,LIB,640008,0,0,1,1,2
Pushmataha,U.S. House,Markwayne Mullin,REP,640008,1,7,85,93,2
Pushmataha,U.S. House,Jason Nichols,DEM,640008,1,1,27,29,2
Pushmataha,U.S. House,John Foreman,IND,640008,0,0,4,4,2
Pushmataha,State House,Justin Humphrey,REP,640008,1,7,79,87,19
Pushmataha,State House,Lewis Collins,DEM,640008,1,1,38,40,19
Pushmataha,Governor,Chris Powell,LIB,640009,0,0,5,5,
Pushmataha,Governor,Kevin Stitt,REP,640009,3,4,78,85,
Pushmataha,Governor,Drew Edmondson,DEM,640009,2,0,53,55,
Pushmataha,Lieutenant Governor,Matt Pinnell,REP,640009,3,4,88,95,
Pushmataha,Lieutenant Governor,Anastasia Pittman,DEM,640009,2,0,38,40,
Pushmataha,Lieutenant Governor,Ivan Holmes,IND,640009,0,0,4,4,
Pushmataha,State Auditor,John Yeutter,LIB,640009,0,0,25,25,
Pushmataha,State Auditor,Cindy Byrd,REP,640009,5,4,93,102,
Pushmataha,Attorney General,Mike Hunter,REP,640009,3,4,87,94,
Pushmataha,Attorney General,Mark Myles,DEM,640009,2,0,40,42,
Pushmataha,State Treasurer,Randy Mcdaniel,REP,640009,3,4,97,104,
Pushmataha,State Treasurer,Charles De Coune,IND,640009,2,0,21,23,
Pushmataha,Superintendent of Public Instruction,Joy Hofmeister,REP,640009,3,4,74,81,
Pushmataha,Superintendent of Public Instruction,John Cox,DEM,640009,2,0,46,48,
Pushmataha,Superintendent of Public Instruction,Larry Huff,IND,640009,0,0,11,11,
Pushmataha,Commissioner of Labor,Leslie Osborn,REP,640009,3,4,80,87,
Pushmataha,Commissioner of Labor,Fred Dorrell,DEM,640009,2,0,39,41,
Pushmataha,Commissioner of Labor,Brandt Dismukes,IND,640009,0,0,7,7,
Pushmataha,Insurance Commissioner,Glen Mulready,REP,640009,3,4,81,88,
Pushmataha,Insurance Commissioner,Kimberly Fobbs,DEM,640009,2,0,44,46,
Pushmataha,Corporation Commissioner,Bob Anthony,REP,640009,3,4,79,86,
Pushmataha,Corporation Commissioner,Ashley Nicole Mccray,DEM,640009,2,0,44,46,
Pushmataha,Corporation Commissioner,Jackie Short,IND,640009,0,0,3,3,
Pushmataha,U.S. House,Richard Castaldo,LIB,640009,0,0,3,3,2
Pushmataha,U.S. House,Markwayne Mullin,REP,640009,3,4,89,96,2
Pushmataha,U.S. House,Jason Nichols,DEM,640009,2,0,36,38,2
Pushmataha,U.S. House,John Foreman,IND,640009,0,0,2,2,2
Pushmataha,State House,Justin Humphrey,REP,640009,2,4,88,94,19
Pushmataha,State House,Lewis Collins,DEM,640009,3,0,47,50,19
Pushmataha,Governor,Chris Powell,LIB,640010,0,0,2,2,
Pushmataha,Governor,Kevin Stitt,REP,640010,5,0,58,63,
Pushmataha,Governor,Drew Edmondson,DEM,640010,1,6,15,22,
Pushmataha,Lieutenant Governor,Matt Pinnell,REP,640010,6,1,58,65,
Pushmataha,Lieutenant Governor,Anastasia Pittman,DEM,640010,0,4,11,15,
Pushmataha,Lieutenant Governor,Ivan Holmes,IND,640010,0,0,4,4,
Pushmataha,State Auditor,John Yeutter,LIB,640010,0,3,6,9,
Pushmataha,State Auditor,Cindy Byrd,REP,640010,6,1,66,73,
Pushmataha,Attorney General,Mike Hunter,REP,640010,5,1,55,61,
Pushmataha,Attorney General,Mark Myles,DEM,640010,1,4,18,23,
Pushmataha,State Treasurer,Randy Mcdaniel,REP,640010,6,1,60,67,
Pushmataha,State Treasurer,Charles De Coune,IND,640010,0,3,9,12,
Pushmataha,Superintendent of Public Instruction,Joy Hofmeister,REP,640010,4,0,53,57,
Pushmataha,Superintendent of Public Instruction,John Cox,DEM,640010,1,5,16,22,
Pushmataha,Superintendent of Public Instruction,Larry Huff,IND,640010,0,0,5,5,
Pushmataha,Commissioner of Labor,Leslie Osborn,REP,640010,5,1,52,58,
Pushmataha,Commissioner of Labor,Fred Dorrell,DEM,640010,1,4,16,21,
Pushmataha,Commissioner of Labor,Brandt Dismukes,IND,640010,0,0,3,3,
Pushmataha,Insurance Commissioner,Glen Mulready,REP,640010,5,0,53,58,
Pushmataha,Insurance Commissioner,Kimberly Fobbs,DEM,640010,1,4,19,24,
Pushmataha,Corporation Commissioner,Bob Anthony,REP,640010,5,0,58,63,
Pushmataha,Corporation Commissioner,Ashley Nicole Mccray,DEM,640010,1,4,12,17,
Pushmataha,Corporation Commissioner,Jackie Short,IND,640010,0,0,4,4,
Pushmataha,U.S. House,Richard Castaldo,LIB,640010,0,0,0,0,2
Pushmataha,U.S. House,Markwayne Mullin,REP,640010,5,2,64,71,2
Pushmataha,U.S. House,Jason Nichols,DEM,640010,1,3,10,14,2
Pushmataha,U.S. House,John Foreman,IND,640010,0,0,1,1,2
Pushmataha,State House,Justin Humphrey,REP,640010,5,1,59,65,19
Pushmataha,State House,Lewis Collins,DEM,640010,1,4,16,21,19
Pushmataha,Governor,Chris Powell,LIB,640011,0,0,17,17,
Pushmataha,Governor,Kevin Stitt,REP,640011,4,10,266,280,
Pushmataha,Governor,Drew Edmondson,DEM,640011,3,10,105,118,
Pushmataha,Lieutenant Governor,Matt Pinnell,REP,640011,5,10,288,303,
Pushmataha,Lieutenant Governor,Anastasia Pittman,DEM,640011,2,11,79,92,
Pushmataha,Lieutenant Governor,Ivan Holmes,IND,640011,0,0,17,17,
Pushmataha,State Auditor,John Yeutter,LIB,640011,0,5,43,48,
Pushmataha,State Auditor,Cindy Byrd,REP,640011,6,14,321,341,
Pushmataha,Attorney General,Mike Hunter,REP,640011,5,12,300,317,
Pushmataha,Attorney General,Mark Myles,DEM,640011,2,9,82,93,
Pushmataha,State Treasurer,Randy Mcdaniel,REP,640011,4,12,316,332,
Pushmataha,State Treasurer,Charles De Coune,IND,640011,2,6,43,51,
Pushmataha,Superintendent of Public Instruction,Joy Hofmeister,REP,640011,4,8,264,276,
Pushmataha,Superintendent of Public Instruction,John Cox,DEM,640011,2,11,96,109,
Pushmataha,Superintendent of Public Instruction,Larry Huff,IND,640011,1,1,24,26,
Pushmataha,Commissioner of Labor,Leslie Osborn,REP,640011,6,12,291,309,
Pushmataha,Commissioner of Labor,Fred Dorrell,DEM,640011,0,7,77,84,
Pushmataha,Commissioner of Labor,Brandt Dismukes,IND,640011,0,1,10,11,
Pushmataha,Insurance Commissioner,Glen Mulready,REP,640011,4,13,301,318,
Pushmataha,Insurance Commissioner,Kimberly Fobbs,DEM,640011,2,7,80,89,
Pushmataha,Corporation Commissioner,Bob Anthony,REP,640011,4,11,282,297,
Pushmataha,Corporation Commissioner,Ashley Nicole Mccray,DEM,640011,1,9,77,87,
Pushmataha,Corporation Commissioner,Jackie Short,IND,640011,2,0,23,25,
Pushmataha,U.S. House,Richard Castaldo,LIB,640011,0,0,6,6,2
Pushmataha,U.S. House,Markwayne Mullin,REP,640011,4,13,311,328,2
Pushmataha,U.S. House,Jason Nichols,DEM,640011,3,9,68,80,2
Pushmataha,U.S. House,John Foreman,IND,640011,0,0,3,3,2
Pushmataha,State House,Justin Humphrey,REP,640011,4,12,293,309,19
Pushmataha,State House,Lewis Collins,DEM,640011,2,10,93,105,19
Pushmataha,Governor,Chris Powell,LIB,640012,0,0,9,9,
Pushmataha,Governor,Kevin Stitt,REP,640012,4,1,41,46,
Pushmataha,Governor,Drew Edmondson,DEM,640012,0,0,27,27,
Pushmataha,Lieutenant Governor,Matt Pinnell,REP,640012,4,1,49,54,
Pushmataha,Lieutenant Governor,Anastasia Pittman,DEM,640012,0,0,25,25,
Pushmataha,Lieutenant Governor,Ivan Holmes,IND,640012,0,0,2,2,
Pushmataha,State Auditor,John Yeutter,LIB,640012,0,0,11,11,
Pushmataha,State Auditor,Cindy Byrd,REP,640012,4,1,59,64,
Pushmataha,Attorney General,Mike Hunter,REP,640012,4,1,50,55,
Pushmataha,Attorney General,Mark Myles,DEM,640012,0,0,26,26,
Pushmataha,State Treasurer,Randy Mcdaniel,REP,640012,4,1,54,59,
Pushmataha,State Treasurer,Charles De Coune,IND,640012,0,0,16,16,
Pushmataha,Superintendent of Public Instruction,Joy Hofmeister,REP,640012,4,1,42,47,
Pushmataha,Superintendent of Public Instruction,John Cox,DEM,640012,0,0,25,25,
Pushmataha,Superintendent of Public Instruction,Larry Huff,IND,640012,0,0,8,8,
Pushmataha,Commissioner of Labor,Leslie Osborn,REP,640012,4,1,50,55,
Pushmataha,Commissioner of Labor,Fred Dorrell,DEM,640012,0,0,20,20,
Pushmataha,Commissioner of Labor,Brandt Dismukes,IND,640012,0,0,6,6,
Pushmataha,Insurance Commissioner,Glen Mulready,REP,640012,4,1,51,56,
Pushmataha,Insurance Commissioner,Kimberly Fobbs,DEM,640012,0,0,24,24,
Pushmataha,Corporation Commissioner,Bob Anthony,REP,640012,4,1,49,54,
Pushmataha,Corporation Commissioner,Ashley Nicole Mccray,DEM,640012,0,0,20,20,
Pushmataha,Corporation Commissioner,Jackie Short,IND,640012,0,0,6,6,
Pushmataha,U.S. House,Richard Castaldo,LIB,640012,0,0,0,0,2
Pushmataha,U.S. House,Markwayne Mullin,REP,640012,4,1,58,63,2
Pushmataha,U.S. House,Jason Nichols,DEM,640012,0,0,17,17,2
Pushmataha,U.S. House,John Foreman,IND,640012,0,0,1,1,2
Pushmataha,State House,Justin Humphrey,REP,640012,4,1,49,54,19
Pushmataha,State House,Lewis Collins,DEM,640012,0,0,27,27,19
Pushmataha,Governor,Chris Powell,LIB,640013,0,0,1,1,
Pushmataha,Governor,Kevin Stitt,REP,640013,0,0,30,30,
Pushmataha,Governor,Drew Edmondson,DEM,640013,0,0,9,9,
Pushmataha,Lieutenant Governor,Matt Pinnell,REP,640013,0,0,30,30,
Pushmataha,Lieutenant Governor,Anastasia Pittman,DEM,640013,0,0,7,7,
Pushmataha,Lieutenant Governor,Ivan Holmes,IND,640013,0,0,2,2,
Pushmataha,State Auditor,John Yeutter,LIB,640013,0,0,6,6,
Pushmataha,State Auditor,Cindy Byrd,REP,640013,0,0,31,31,
Pushmataha,Attorney General,Mike Hunter,REP,640013,0,0,32,32,
Pushmataha,Attorney General,Mark Myles,DEM,640013,0,0,7,7,
Pushmataha,State Treasurer,Randy Mcdaniel,REP,640013,0,0,31,31,
Pushmataha,State Treasurer,Charles De Coune,IND,640013,0,0,5,5,
Pushmataha,Superintendent of Public Instruction,Joy Hofmeister,REP,640013,0,0,28,28,
Pushmataha,Superintendent of Public Instruction,John Cox,DEM,640013,0,0,10,10,
Pushmataha,Superintendent of Public Instruction,Larry Huff,IND,640013,0,0,2,2,
Pushmataha,Commissioner of Labor,Leslie Osborn,REP,640013,0,0,29,29,
Pushmataha,Commissioner of Labor,Fred Dorrell,DEM,640013,0,0,8,8,
Pushmataha,Commissioner of Labor,Brandt Dismukes,IND,640013,0,0,3,3,
Pushmataha,Insurance Commissioner,Glen Mulready,REP,640013,0,0,31,31,
Pushmataha,Insurance Commissioner,Kimberly Fobbs,DEM,640013,0,0,9,9,
Pushmataha,Corporation Commissioner,Bob Anthony,REP,640013,0,0,31,31,
Pushmataha,Corporation Commissioner,Ashley Nicole Mccray,DEM,640013,0,0,7,7,
Pushmataha,Corporation Commissioner,Jackie Short,IND,640013,0,0,1,1,
Pushmataha,U.S. House,Richard Castaldo,LIB,640013,0,0,0,0,2
Pushmataha,U.S. House,Markwayne Mullin,REP,640013,0,0,31,31,2
Pushmataha,U.S. House,Jason Nichols,DEM,640013,0,0,7,7,2
Pushmataha,U.S. House,John Foreman,IND,640013,0,0,2,2,2
Pushmataha,State House,Justin Humphrey,REP,640013,0,0,32,32,19
Pushmataha,State House,Lewis Collins,DEM,640013,0,0,8,8,19
Pushmataha,Governor,Chris Powell,LIB,640014,0,0,1,1,
Pushmataha,Governor,Kevin Stitt,REP,640014,0,3,69,72,
Pushmataha,Governor,Drew Edmondson,DEM,640014,0,0,7,7,
Pushmataha,Lieutenant Governor,Matt Pinnell,REP,640014,0,2,66,68,
Pushmataha,Lieutenant Governor,Anastasia Pittman,DEM,640014,0,1,7,8,
Pushmataha,Lieutenant Governor,Ivan Holmes,IND,640014,0,0,3,3,
Pushmataha,State Auditor,John Yeutter,LIB,640014,0,0,6,6,
Pushmataha,State Auditor,Cindy Byrd,REP,640014,0,3,70,73,
Pushmataha,Attorney General,Mike Hunter,REP,640014,0,2,68,70,
Pushmataha,Attorney General,Mark Myles,DEM,640014,0,1,9,10,
Pushmataha,State Treasurer,Randy Mcdaniel,REP,640014,0,3,68,71,
Pushmataha,State Treasurer,Charles De Coune,IND,640014,0,0,7,7,
Pushmataha,Superintendent of Public Instruction,Joy Hofmeister,REP,640014,0,2,56,58,
Pushmataha,Superintendent of Public Instruction,John Cox,DEM,640014,0,1,13,14,
Pushmataha,Superintendent of Public Instruction,Larry Huff,IND,640014,0,0,6,6,
Pushmataha,Commissioner of Labor,Leslie Osborn,REP,640014,0,3,64,67,
Pushmataha,Commissioner of Labor,Fred Dorrell,DEM,640014,0,0,8,8,
Pushmataha,Commissioner of Labor,Brandt Dismukes,IND,640014,0,0,3,3,
Pushmataha,Insurance Commissioner,Glen Mulready,REP,640014,0,2,63,65,
Pushmataha,Insurance Commissioner,Kimberly Fobbs,DEM,640014,0,1,11,12,
Pushmataha,Corporation Commissioner,Bob Anthony,REP,640014,0,2,64,66,
Pushmataha,Corporation Commissioner,Ashley Nicole Mccray,DEM,640014,0,1,7,8,
Pushmataha,Corporation Commissioner,Jackie Short,IND,640014,0,0,6,6,
Pushmataha,U.S. House,Richard Castaldo,LIB,640014,0,0,0,0,2
Pushmataha,U.S. House,Markwayne Mullin,REP,640014,0,3,71,74,2
Pushmataha,U.S. House,Jason Nichols,DEM,640014,0,0,5,5,2
Pushmataha,U.S. House,John Foreman,IND,640014,0,0,2,2,2
Pushmataha,State House,Justin Humphrey,REP,640014,0,2,64,66,19
Pushmataha,State House,Lewis Collins,DEM,640014,0,1,12,13,19
Pushmataha,Governor,Chris Powell,LIB,640015,0,1,5,6,
Pushmataha,Governor,Kevin Stitt,REP,640015,11,5,213,229,
Pushmataha,Governor,Drew Edmondson,DEM,640015,4,2,131,137,
Pushmataha,Lieutenant Governor,Matt Pinnell,REP,640015,11,7,234,252,
Pushmataha,Lieutenant Governor,Anastasia Pittman,DEM,640015,3,1,97,101,
Pushmataha,Lieutenant Governor,Ivan Holmes,IND,640015,1,0,11,12,
Pushmataha,State Auditor,John Yeutter,LIB,640015,4,2,48,54,
Pushmataha,State Auditor,Cindy Byrd,REP,640015,11,5,267,283,
Pushmataha,Attorney General,Mike Hunter,REP,640015,12,7,246,265,
Pushmataha,Attorney General,Mark Myles,DEM,640015,3,1,93,97,
Pushmataha,State Treasurer,Randy Mcdaniel,REP,640015,13,6,265,284,
Pushmataha,State Treasurer,Charles De Coune,IND,640015,1,1,45,47,
Pushmataha,Superintendent of Public Instruction,Joy Hofmeister,REP,640015,9,6,198,213,
Pushmataha,Superintendent of Public Instruction,John Cox,DEM,640015,6,1,121,128,
Pushmataha,Superintendent of Public Instruction,Larry Huff,IND,640015,0,1,24,25,
Pushmataha,Commissioner of Labor,Leslie Osborn,REP,640015,10,7,234,251,
Pushmataha,Commissioner of Labor,Fred Dorrell,DEM,640015,5,1,94,100,
Pushmataha,Commissioner of Labor,Brandt Dismukes,IND,640015,0,0,9,9,
Pushmataha,Insurance Commissioner,Glen Mulready,REP,640015,11,7,233,251,
Pushmataha,Insurance Commissioner,Kimberly Fobbs,DEM,640015,4,1,107,112,
Pushmataha,Corporation Commissioner,Bob Anthony,REP,640015,13,6,225,244,
Pushmataha,Corporation Commissioner,Ashley Nicole Mccray,DEM,640015,2,1,96,99,
Pushmataha,Corporation Commissioner,Jackie Short,IND,640015,0,1,18,19,
Pushmataha,U.S. House,Richard Castaldo,LIB,640015,0,1,2,3,2
Pushmataha,U.S. House,Markwayne Mullin,REP,640015,11,6,240,257,2
Pushmataha,U.S. House,Jason Nichols,DEM,640015,3,1,91,95,2
Pushmataha,U.S. House,John Foreman,IND,640015,1,0,12,13,2
Pushmataha,State House,Justin Humphrey,REP,640015,12,5,255,272,19
Pushmataha,State House,Lewis Collins,DEM,640015,3,3,94,100,19
Pushmataha,Governor,Chris Powell,LIB,640016,0,0,3,3,
Pushmataha,Governor,Kevin Stitt,REP,640016,5,0,89,94,
Pushmataha,Governor,Drew Edmondson,DEM,640016,3,0,29,32,
Pushmataha,Lieutenant Governor,Matt Pinnell,REP,640016,5,0,92,97,
Pushmataha,Lieutenant Governor,Anastasia Pittman,DEM,640016,3,0,23,26,
Pushmataha,Lieutenant Governor,Ivan Holmes,IND,640016,0,0,5,5,
Pushmataha,State Auditor,John Yeutter,LIB,640016,2,0,18,20,
Pushmataha,State Auditor,Cindy Byrd,REP,640016,6,0,94,100,
Pushmataha,Attorney General,Mike Hunter,REP,640016,5,0,95,100,
Pushmataha,Attorney General,Mark Myles,DEM,640016,3,0,25,28,
Pushmataha,State Treasurer,Randy Mcdaniel,REP,640016,6,0,95,101,
Pushmataha,State Treasurer,Charles De Coune,IND,640016,2,0,19,21,
Pushmataha,Superintendent of Public Instruction,Joy Hofmeister,REP,640016,5,0,86,91,
Pushmataha,Superintendent of Public Instruction,John Cox,DEM,640016,3,0,26,29,
Pushmataha,Superintendent of Public Instruction,Larry Huff,IND,640016,0,0,8,8,
Pushmataha,Commissioner of Labor,Leslie Osborn,REP,640016,5,0,89,94,
Pushmataha,Commissioner of Labor,Fred Dorrell,DEM,640016,3,0,24,27,
Pushmataha,Commissioner of Labor,Brandt Dismukes,IND,640016,0,0,7,7,
Pushmataha,Insurance Commissioner,Glen Mulready,REP,640016,5,0,96,101,
Pushmataha,Insurance Commissioner,Kimberly Fobbs,DEM,640016,3,0,23,26,
Pushmataha,Corporation Commissioner,Bob Anthony,REP,640016,5,0,88,93,
Pushmataha,Corporation Commissioner,Ashley Nicole Mccray,DEM,640016,3,0,24,27,
Pushmataha,Corporation Commissioner,Jackie Short,IND,640016,0,0,8,8,
Pushmataha,U.S. House,Richard Castaldo,LIB,640016,0,0,1,1,2
Pushmataha,U.S. House,Markwayne Mullin,REP,640016,6,0,94,100,2
Pushmataha,U.S. House,Jason Nichols,DEM,640016,2,0,22,24,2
Pushmataha,U.S. House,John Foreman,IND,640016,0,0,3,3,2
Pushmataha,State House,Justin Humphrey,REP,640016,6,0,98,104,19
Pushmataha,State House,Lewis Collins,DEM,640016,2,0,22,24,19
Pushmataha,Governor,Chris Powell,LIB,640017,0,0,6,6,
Pushmataha,Governor,Kevin Stitt,REP,640017,2,1,101,104,
Pushmataha,Governor,Drew Edmondson,DEM,640017,0,0,65,65,
Pushmataha,Lieutenant Governor,Matt Pinnell,REP,640017,2,0,108,110,
Pushmataha,Lieutenant Governor,Anastasia Pittman,DEM,640017,0,1,58,59,
Pushmataha,Lieutenant Governor,Ivan Holmes,IND,640017,0,0,5,5,
Pushmataha,State Auditor,John Yeutter,LIB,640017,0,0,36,36,
Pushmataha,State Auditor,Cindy Byrd,REP,640017,2,1,127,130,
Pushmataha,Attorney General,Mike Hunter,REP,640017,2,0,110,112,
Pushmataha,Attorney General,Mark Myles,DEM,640017,0,1,60,61,
Pushmataha,State Treasurer,Randy Mcdaniel,REP,640017,2,0,121,123,
Pushmataha,State Treasurer,Charles De Coune,IND,640017,0,1,41,42,
Pushmataha,Superintendent of Public Instruction,Joy Hofmeister,REP,640017,2,0,97,99,
Pushmataha,Superintendent of Public Instruction,John Cox,DEM,640017,0,1,57,58,
Pushmataha,Superintendent of Public Instruction,Larry Huff,IND,640017,0,0,17,17,
Pushmataha,Commissioner of Labor,Leslie Osborn,REP,640017,2,0,105,107,
Pushmataha,Commissioner of Labor,Fred Dorrell,DEM,640017,0,1,60,61,
Pushmataha,Commissioner of Labor,Brandt Dismukes,IND,640017,0,0,7,7,
Pushmataha,Insurance Commissioner,Glen Mulready,REP,640017,2,0,111,113,
Pushmataha,Insurance Commissioner,Kimberly Fobbs,DEM,640017,0,1,61,62,
Pushmataha,Corporation Commissioner,Bob Anthony,REP,640017,2,0,102,104,
Pushmataha,Corporation Commissioner,Ashley Nicole Mccray,DEM,640017,0,1,56,57,
Pushmataha,Corporation Commissioner,Jackie Short,IND,640017,0,0,13,13,
Pushmataha,U.S. House,Richard Castaldo,LIB,640017,0,0,3,3,2
Pushmataha,U.S. House,Markwayne Mullin,REP,640017,2,0,111,113,2
Pushmataha,U.S. House,Jason Nichols,DEM,640017,0,1,51,52,2
Pushmataha,U.S. House,John Foreman,IND,640017,0,0,7,7,2
Pushmataha,State House,Justin Humphrey,REP,640017,2,1,118,121,19
Pushmataha,State House,Lewis Collins,DEM,640017,0,0,54,54,19
Roger Mills,Governor,Chris Powell,LIB,650101,0,0,8,8,
Roger Mills,Governor,Kevin Stitt,REP,650101,3,7,99,109,
Roger Mills,Governor,Drew Edmondson,DEM,650101,1,6,11,18,
Roger Mills,Lieutenant Governor,Matt Pinnell,REP,650101,3,11,103,117,
Roger Mills,Lieutenant Governor,Anastasia Pittman,DEM,650101,0,2,15,17,
Roger Mills,Lieutenant Governor,Ivan Holmes,IND,650101,1,0,1,2,
Roger Mills,State Auditor,John Yeutter,LIB,650101,1,3,8,12,
Roger Mills,State Auditor,Cindy Byrd,REP,650101,3,10,107,120,
Roger Mills,Attorney General,Mike Hunter,REP,650101,3,9,105,117,
Roger Mills,Attorney General,Mark Myles,DEM,650101,1,4,12,17,
Roger Mills,State Treasurer,Randy Mcdaniel,REP,650101,3,11,110,124,
Roger Mills,State Treasurer,Charles De Coune,IND,650101,1,2,7,10,
Roger Mills,Superintendent of Public Instruction,Joy Hofmeister,REP,650101,2,9,95,106,
Roger Mills,Superintendent of Public Instruction,John Cox,DEM,650101,2,3,11,16,
Roger Mills,Superintendent of Public Instruction,Larry Huff,IND,650101,0,1,10,11,
Roger Mills,Commissioner of Labor,Leslie Osborn,REP,650101,3,11,97,111,
Roger Mills,Commissioner of Labor,Fred Dorrell,DEM,650101,1,2,13,16,
Roger Mills,Commissioner of Labor,Brandt Dismukes,IND,650101,0,0,6,6,
Roger Mills,Insurance Commissioner,Glen Mulready,REP,650101,1,11,98,110,
Roger Mills,Insurance Commissioner,Kimberly Fobbs,DEM,650101,3,2,19,24,
Roger Mills,Corporation Commissioner,Bob Anthony,REP,650101,1,8,91,100,
Roger Mills,Corporation Commissioner,Ashley Nicole Mccray,DEM,650101,3,4,20,27,
Roger Mills,Corporation Commissioner,Jackie Short,IND,650101,0,1,5,6,
Roger Mills,U.S. House,Frank Lucas,REP,650101,3,11,105,119,3
Roger Mills,U.S. House,Frankie Robbins,DEM,650101,1,2,13,16,3
Roger Mills,State House,Todd Russ,REP,650101,2,4,64,70,55
Roger Mills,State House,Dennis Dugger,DEM,650101,2,8,53,63,55
Roger Mills,Governor,Chris Powell,LIB,650102,0,0,6,6,
Roger Mills,Governor,Kevin Stitt,REP,650102,4,16,85,105,
Roger Mills,Governor,Drew Edmondson,DEM,650102,1,2,14,17,
Roger Mills,Lieutenant Governor,Matt Pinnell,REP,650102,4,15,86,105,
Roger Mills,Lieutenant Governor,Anastasia Pittman,DEM,650102,1,1,10,12,
Roger Mills,Lieutenant Governor,Ivan Holmes,IND,650102,0,1,8,9,
Roger Mills,State Auditor,John Yeutter,LIB,650102,0,2,17,19,
Roger Mills,State Auditor,Cindy Byrd,REP,650102,5,15,88,108,
Roger Mills,Attorney General,Mike Hunter,REP,650102,4,18,89,111,
Roger Mills,Attorney General,Mark Myles,DEM,650102,1,0,16,17,
Roger Mills,State Treasurer,Randy Mcdaniel,REP,650102,5,18,90,113,
Roger Mills,State Treasurer,Charles De Coune,IND,650102,0,0,13,13,
Roger Mills,Superintendent of Public Instruction,Joy Hofmeister,REP,650102,1,12,72,85,
Roger Mills,Superintendent of Public Instruction,John Cox,DEM,650102,2,2,20,24,
Roger Mills,Superintendent of Public Instruction,Larry Huff,IND,650102,2,4,11,17,
Roger Mills,Commissioner of Labor,Leslie Osborn,REP,650102,3,16,87,106,
Roger Mills,Commissioner of Labor,Fred Dorrell,DEM,650102,1,1,12,14,
Roger Mills,Commissioner of Labor,Brandt Dismukes,IND,650102,0,1,4,5,
Roger Mills,Insurance Commissioner,Glen Mulready,REP,650102,3,14,77,94,
Roger Mills,Insurance Commissioner,Kimberly Fobbs,DEM,650102,1,3,26,30,
Roger Mills,Corporation Commissioner,Bob Anthony,REP,650102,4,17,81,102,
Roger Mills,Corporation Commissioner,Ashley Nicole Mccray,DEM,650102,1,0,14,15,
Roger Mills,Corporation Commissioner,Jackie Short,IND,650102,0,1,9,10,
Roger Mills,U.S. House,Frank Lucas,REP,650102,5,18,83,106,3
Roger Mills,U.S. House,Frankie Robbins,DEM,650102,0,0,20,20,3
Roger Mills,State House,Todd Russ,REP,650102,2,10,53,65,55
Roger Mills,State House,Dennis Dugger,DEM,650102,3,8,50,61,55
Roger Mills,Governor,Chris Powell,LIB,650103,0,0,18,18,
Roger Mills,Governor,Kevin Stitt,REP,650103,1,27,117,145,
Roger Mills,Governor,Drew Edmondson,DEM,650103,3,8,29,40,
Roger Mills,Lieutenant Governor,Matt Pinnell,REP,650103,3,31,127,161,
Roger Mills,Lieutenant Governor,Anastasia Pittman,DEM,650103,1,5,26,32,
Roger Mills,Lieutenant Governor,Ivan Holmes,IND,650103,0,0,10,10,
Roger Mills,State Auditor,John Yeutter,LIB,650103,0,2,22,24,
Roger Mills,State Auditor,Cindy Byrd,REP,650103,4,34,138,176,
Roger Mills,Attorney General,Mike Hunter,REP,650103,1,29,136,166,
Roger Mills,Attorney General,Mark Myles,DEM,650103,2,6,27,35,
Roger Mills,State Treasurer,Randy Mcdaniel,REP,650103,4,34,144,182,
Roger Mills,State Treasurer,Charles De Coune,IND,650103,0,2,17,19,
Roger Mills,Superintendent of Public Instruction,Joy Hofmeister,REP,650103,2,25,107,134,
Roger Mills,Superintendent of Public Instruction,John Cox,DEM,650103,2,9,37,48,
Roger Mills,Superintendent of Public Instruction,Larry Huff,IND,650103,0,2,20,22,
Roger Mills,Commissioner of Labor,Leslie Osborn,REP,650103,4,32,129,165,
Roger Mills,Commissioner of Labor,Fred Dorrell,DEM,650103,0,2,23,25,
Roger Mills,Commissioner of Labor,Brandt Dismukes,IND,650103,0,2,12,14,
Roger Mills,Insurance Commissioner,Glen Mulready,REP,650103,2,29,130,161,
Roger Mills,Insurance Commissioner,Kimberly Fobbs,DEM,650103,2,7,30,39,
Roger Mills,Corporation Commissioner,Bob Anthony,REP,650103,2,33,120,155,
Roger Mills,Corporation Commissioner,Ashley Nicole Mccray,DEM,650103,2,3,29,34,
Roger Mills,Corporation Commissioner,Jackie Short,IND,650103,0,0,14,14,
Roger Mills,U.S. House,Frank Lucas,REP,650103,4,35,153,192,3
Roger Mills,U.S. House,Frankie Robbins,DEM,650103,0,1,11,12,3
Roger Mills,State House,Todd Russ,REP,650103,1,19,73,93,55
Roger Mills,State House,Dennis Dugger,DEM,650103,3,17,91,111,55
Roger Mills,Governor,Chris Powell,LIB,650201,0,1,5,6,
Roger Mills,Governor,Kevin Stitt,REP,650201,6,11,219,236,
Roger Mills,Governor,Drew Edmondson,DEM,650201,3,1,96,100,
Roger Mills,Lieutenant Governor,Matt Pinnell,REP,650201,6,12,248,266,
Roger Mills,Lieutenant Governor,Anastasia Pittman,DEM,650201,2,1,67,70,
Roger Mills,Lieutenant Governor,Ivan Holmes,IND,650201,0,0,5,5,
Roger Mills,State Auditor,John Yeutter,LIB,650201,2,0,45,47,
Roger Mills,State Auditor,Cindy Byrd,REP,650201,6,13,270,289,
Roger Mills,Attorney General,Mike Hunter,REP,650201,6,11,245,262,
Roger Mills,Attorney General,Mark Myles,DEM,650201,2,1,75,78,
Roger Mills,State Treasurer,Randy Mcdaniel,REP,650201,6,10,259,275,
Roger Mills,State Treasurer,Charles De Coune,IND,650201,2,2,51,55,
Roger Mills,Superintendent of Public Instruction,Joy Hofmeister,REP,650201,6,10,217,233,
Roger Mills,Superintendent of Public Instruction,John Cox,DEM,650201,2,2,77,81,
Roger Mills,Superintendent of Public Instruction,Larry Huff,IND,650201,0,1,29,30,
Roger Mills,Commissioner of Labor,Leslie Osborn,REP,650201,6,11,233,250,
Roger Mills,Commissioner of Labor,Fred Dorrell,DEM,650201,2,1,72,75,
Roger Mills,Commissioner of Labor,Brandt Dismukes,IND,650201,0,0,15,15,
Roger Mills,Insurance Commissioner,Glen Mulready,REP,650201,6,9,227,242,
Roger Mills,Insurance Commissioner,Kimberly Fobbs,DEM,650201,2,3,91,96,
Roger Mills,Corporation Commissioner,Bob Anthony,REP,650201,6,11,225,242,
Roger Mills,Corporation Commissioner,Ashley Nicole Mccray,DEM,650201,3,2,78,83,
Roger Mills,Corporation Commissioner,Jackie Short,IND,650201,0,0,15,15,
Roger Mills,U.S. House,Frank Lucas,REP,650201,6,13,271,290,3
Roger Mills,U.S. House,Frankie Robbins,DEM,650201,3,0,56,59,3
Roger Mills,State House,Todd Russ,REP,650201,4,6,112,122,55
Roger Mills,State House,Dennis Dugger,DEM,650201,5,7,211,223,55
Roger Mills,Governor,Chris Powell,LIB,650202,0,0,1,1,
Roger Mills,Governor,Kevin Stitt,REP,650202,2,20,48,70,
Roger Mills,Governor,Drew Edmondson,DEM,650202,1,7,10,18,
Roger Mills,Lieutenant Governor,Matt Pinnell,REP,650202,1,23,52,76,
Roger Mills,Lieutenant Governor,Anastasia Pittman,DEM,650202,1,4,6,11,
Roger Mills,Lieutenant Governor,Ivan Holmes,IND,650202,0,0,1,1,
Roger Mills,State Auditor,John Yeutter,LIB,650202,0,1,4,5,
Roger Mills,State Auditor,Cindy Byrd,REP,650202,1,24,54,79,
Roger Mills,Attorney General,Mike Hunter,REP,650202,0,21,49,70,
Roger Mills,Attorney General,Mark Myles,DEM,650202,1,5,9,15,
Roger Mills,State Treasurer,Randy Mcdaniel,REP,650202,1,24,55,80,
Roger Mills,State Treasurer,Charles De Coune,IND,650202,0,2,2,4,
Roger Mills,Superintendent of Public Instruction,Joy Hofmeister,REP,650202,2,11,36,49,
Roger Mills,Superintendent of Public Instruction,John Cox,DEM,650202,1,13,15,29,
Roger Mills,Superintendent of Public Instruction,Larry Huff,IND,650202,0,3,7,10,
Roger Mills,Commissioner of Labor,Leslie Osborn,REP,650202,0,23,49,72,
Roger Mills,Commissioner of Labor,Fred Dorrell,DEM,650202,1,4,8,13,
Roger Mills,Commissioner of Labor,Brandt Dismukes,IND,650202,0,0,0,0,
Roger Mills,Insurance Commissioner,Glen Mulready,REP,650202,0,23,54,77,
Roger Mills,Insurance Commissioner,Kimberly Fobbs,DEM,650202,1,3,4,8,
Roger Mills,Corporation Commissioner,Bob Anthony,REP,650202,0,21,43,64,
Roger Mills,Corporation Commissioner,Ashley Nicole Mccray,DEM,650202,1,5,11,17,
Roger Mills,Corporation Commissioner,Jackie Short,IND,650202,0,1,4,5,
Roger Mills,U.S. House,Frank Lucas,REP,650202,4,27,54,85,3
Roger Mills,U.S. House,Frankie Robbins,DEM,650202,0,0,6,6,3
Roger Mills,State House,Todd Russ,REP,650202,0,6,26,32,55
Roger Mills,State House,Dennis Dugger,DEM,650202,3,21,34,58,55
Roger Mills,Governor,Chris Powell,LIB,650203,0,0,0,0,
Roger Mills,Governor,Kevin Stitt,REP,650203,5,6,60,71,
Roger Mills,Governor,Drew Edmondson,DEM,650203,0,0,11,11,
Roger Mills,Lieutenant Governor,Matt Pinnell,REP,650203,5,5,65,75,
Roger Mills,Lieutenant Governor,Anastasia Pittman,DEM,650203,0,1,5,6,
Roger Mills,Lieutenant Governor,Ivan Holmes,IND,650203,0,0,1,1,
Roger Mills,State Auditor,John Yeutter,LIB,650203,0,1,6,7,
Roger Mills,State Auditor,Cindy Byrd,REP,650203,5,5,63,73,
Roger Mills,Attorney General,Mike Hunter,REP,650203,5,6,62,73,
Roger Mills,Attorney General,Mark Myles,DEM,650203,0,0,9,9,
Roger Mills,State Treasurer,Randy Mcdaniel,REP,650203,3,5,68,76,
Roger Mills,State Treasurer,Charles De Coune,IND,650203,2,1,1,4,
Roger Mills,Superintendent of Public Instruction,Joy Hofmeister,REP,650203,3,4,52,59,
Roger Mills,Superintendent of Public Instruction,John Cox,DEM,650203,1,2,16,19,
Roger Mills,Superintendent of Public Instruction,Larry Huff,IND,650203,1,0,3,4,
Roger Mills,Commissioner of Labor,Leslie Osborn,REP,650203,4,4,59,67,
Roger Mills,Commissioner of Labor,Fred Dorrell,DEM,650203,0,2,8,10,
Roger Mills,Commissioner of Labor,Brandt Dismukes,IND,650203,1,0,1,2,
Roger Mills,Insurance Commissioner,Glen Mulready,REP,650203,4,5,64,73,
Roger Mills,Insurance Commissioner,Kimberly Fobbs,DEM,650203,1,1,7,9,
Roger Mills,Corporation Commissioner,Bob Anthony,REP,650203,1,4,55,60,
Roger Mills,Corporation Commissioner,Ashley Nicole Mccray,DEM,650203,3,1,13,17,
Roger Mills,Corporation Commissioner,Jackie Short,IND,650203,1,1,3,5,
Roger Mills,U.S. House,Frank Lucas,REP,650203,5,6,59,70,3
Roger Mills,U.S. House,Frankie Robbins,DEM,650203,0,0,13,13,3
Roger Mills,State House,Todd Russ,REP,650203,3,5,35,43,55
Roger Mills,State House,Dennis Dugger,DEM,650203,2,1,37,40,55
Roger Mills,Governor,Chris Powell,LIB,650301,0,0,7,7,
Roger Mills,Governor,Kevin Stitt,REP,650301,3,7,101,111,
Roger Mills,Governor,Drew Edmondson,DEM,650301,0,1,21,22,
Roger Mills,Lieutenant Governor,Matt Pinnell,REP,650301,3,7,97,107,
Roger Mills,Lieutenant Governor,Anastasia Pittman,DEM,650301,0,1,18,19,
Roger Mills,Lieutenant Governor,Ivan Holmes,IND,650301,0,0,9,9,
Roger Mills,State Auditor,John Yeutter,LIB,650301,0,0,20,20,
Roger Mills,State Auditor,Cindy Byrd,REP,650301,3,8,100,111,
Roger Mills,Attorney General,Mike Hunter,REP,650301,3,7,98,108,
Roger Mills,Attorney General,Mark Myles,DEM,650301,0,1,23,24,
Roger Mills,State Treasurer,Randy Mcdaniel,REP,650301,3,7,96,106,
Roger Mills,State Treasurer,Charles De Coune,IND,650301,0,1,22,23,
Roger Mills,Superintendent of Public Instruction,Joy Hofmeister,REP,650301,2,7,80,89,
Roger Mills,Superintendent of Public Instruction,John Cox,DEM,650301,1,1,27,29,
Roger Mills,Superintendent of Public Instruction,Larry Huff,IND,650301,0,0,15,15,
Roger Mills,Commissioner of Labor,Leslie Osborn,REP,650301,3,8,90,101,
Roger Mills,Commissioner of Labor,Fred Dorrell,DEM,650301,0,0,20,20,
Roger Mills,Commissioner of Labor,Brandt Dismukes,IND,650301,0,0,9,9,
Roger Mills,Insurance Commissioner,Glen Mulready,REP,650301,3,8,98,109,
Roger Mills,Insurance Commissioner,Kimberly Fobbs,DEM,650301,0,0,21,21,
Roger Mills,Corporation Commissioner,Bob Anthony,REP,650301,3,7,88,98,
Roger Mills,Corporation Commissioner,Ashley Nicole Mccray,DEM,650301,0,1,21,22,
Roger Mills,Corporation Commissioner,Jackie Short,IND,650301,0,0,11,11,
Roger Mills,U.S. House,Frank Lucas,REP,650301,3,8,121,132,3
Roger Mills,U.S. House,Frankie Robbins,DEM,650301,0,0,9,9,3
Roger Mills,State House,Todd Russ,REP,650301,2,7,69,78,55
Roger Mills,State House,Dennis Dugger,DEM,650301,1,1,63,65,55
Roger Mills,Governor,Chris Powell,LIB,650302,0,2,1,3,
Roger Mills,Governor,Kevin Stitt,REP,650302,10,16,124,150,
Roger Mills,Governor,Drew Edmondson,DEM,650302,1,0,15,16,
Roger Mills,Lieutenant Governor,Matt Pinnell,REP,650302,10,16,114,140,
Roger Mills,Lieutenant Governor,Anastasia Pittman,DEM,650302,0,0,19,19,
Roger Mills,Lieutenant Governor,Ivan Holmes,IND,650302,0,2,4,6,
Roger Mills,State Auditor,John Yeutter,LIB,650302,2,0,10,12,
Roger Mills,State Auditor,Cindy Byrd,REP,650302,9,17,121,147,
Roger Mills,Attorney General,Mike Hunter,REP,650302,9,15,120,144,
Roger Mills,Attorney General,Mark Myles,DEM,650302,1,3,16,20,
Roger Mills,State Treasurer,Randy Mcdaniel,REP,650302,9,16,124,149,
Roger Mills,State Treasurer,Charles De Coune,IND,650302,1,2,7,10,
Roger Mills,Superintendent of Public Instruction,Joy Hofmeister,REP,650302,6,14,93,113,
Roger Mills,Superintendent of Public Instruction,John Cox,DEM,650302,3,1,29,33,
Roger Mills,Superintendent of Public Instruction,Larry Huff,IND,650302,1,3,13,17,
Roger Mills,Commissioner of Labor,Leslie Osborn,REP,650302,7,16,115,138,
Roger Mills,Commissioner of Labor,Fred Dorrell,DEM,650302,1,1,16,18,
Roger Mills,Commissioner of Labor,Brandt Dismukes,IND,650302,2,1,4,7,
Roger Mills,Insurance Commissioner,Glen Mulready,REP,650302,9,16,111,136,
Roger Mills,Insurance Commissioner,Kimberly Fobbs,DEM,650302,1,1,22,24,
Roger Mills,Corporation Commissioner,Bob Anthony,REP,650302,8,15,105,128,
Roger Mills,Corporation Commissioner,Ashley Nicole Mccray,DEM,650302,1,2,22,25,
Roger Mills,Corporation Commissioner,Jackie Short,IND,650302,1,0,9,10,
Roger Mills,U.S. House,Frank Lucas,REP,650302,10,18,125,153,3
Roger Mills,U.S. House,Frankie Robbins,DEM,650302,1,0,17,18,3
Roger Mills,State House,Todd Russ,REP,650302,7,14,82,103,55
Roger Mills,State House,Dennis Dugger,DEM,650302,3,3,57,63,55
Roger Mills,Governor,Chris Powell,LIB,650303,0,2,9,11,
Roger Mills,Governor,Kevin Stitt,REP,650303,7,31,122,160,
Roger Mills,Governor,Drew Edmondson,DEM,650303,3,8,30,41,
Roger Mills,Lieutenant Governor,Matt Pinnell,REP,650303,8,33,127,168,
Roger Mills,Lieutenant Governor,Anastasia Pittman,DEM,650303,2,4,25,31,
Roger Mills,Lieutenant Governor,Ivan Holmes,IND,650303,0,2,6,8,
Roger Mills,State Auditor,John Yeutter,LIB,650303,3,5,25,33,
Roger Mills,State Auditor,Cindy Byrd,REP,650303,7,34,129,170,
Roger Mills,Attorney General,Mike Hunter,REP,650303,6,32,122,160,
Roger Mills,Attorney General,Mark Myles,DEM,650303,4,7,33,44,
Roger Mills,State Treasurer,Randy Mcdaniel,REP,650303,8,35,132,175,
Roger Mills,State Treasurer,Charles De Coune,IND,650303,2,3,18,23,
Roger Mills,Superintendent of Public Instruction,Joy Hofmeister,REP,650303,6,23,100,129,
Roger Mills,Superintendent of Public Instruction,John Cox,DEM,650303,2,9,37,48,
Roger Mills,Superintendent of Public Instruction,Larry Huff,IND,650303,2,8,18,28,
Roger Mills,Commissioner of Labor,Leslie Osborn,REP,650303,8,32,122,162,
Roger Mills,Commissioner of Labor,Fred Dorrell,DEM,650303,2,5,22,29,
Roger Mills,Commissioner of Labor,Brandt Dismukes,IND,650303,0,2,8,10,
Roger Mills,Insurance Commissioner,Glen Mulready,REP,650303,8,33,121,162,
Roger Mills,Insurance Commissioner,Kimberly Fobbs,DEM,650303,2,5,34,41,
Roger Mills,Corporation Commissioner,Bob Anthony,REP,650303,7,23,117,147,
Roger Mills,Corporation Commissioner,Ashley Nicole Mccray,DEM,650303,2,11,30,43,
Roger Mills,Corporation Commissioner,Jackie Short,IND,650303,1,6,7,14,
Roger Mills,U.S. House,Frank Lucas,REP,650303,8,36,140,184,3
Roger Mills,U.S. House,Frankie Robbins,DEM,650303,2,5,17,24,3
Roger Mills,State House,Todd Russ,REP,650303,7,11,70,88,55
Roger Mills,State House,Dennis Dugger,DEM,650303,3,29,88,120,55
Rogers,Governor,Chris Powell,LIB,660001,0,5,37,42,
Rogers,Governor,Kevin Stitt,REP,660001,31,112,505,648,
Rogers,Governor,Drew Edmondson,DEM,660001,41,93,383,517,
Rogers,Lieutenant Governor,Matt Pinnell,REP,660001,42,126,571,739,
Rogers,Lieutenant Governor,Anastasia Pittman,DEM,660001,30,82,310,422,
Rogers,Lieutenant Governor,Ivan Holmes,IND,660001,0,3,30,33,
Rogers,State Auditor,John Yeutter,LIB,660001,16,47,221,284,
Rogers,State Auditor,Cindy Byrd,REP,660001,47,139,640,826,
Rogers,Attorney General,Mike Hunter,REP,660001,36,129,596,761,
Rogers,Attorney General,Mark Myles,DEM,660001,33,80,309,422,
Rogers,State Treasurer,Randy Mcdaniel,REP,660001,38,145,611,794,
Rogers,State Treasurer,Charles De Coune,IND,660001,22,42,244,308,
Rogers,Superintendent of Public Instruction,Joy Hofmeister,REP,660001,47,120,537,704,
Rogers,Superintendent of Public Instruction,John Cox,DEM,660001,25,75,302,402,
Rogers,Superintendent of Public Instruction,Larry Huff,IND,660001,0,13,73,86,
Rogers,Commissioner of Labor,Leslie Osborn,REP,660001,39,116,576,731,
Rogers,Commissioner of Labor,Fred Dorrell,DEM,660001,30,83,286,399,
Rogers,Commissioner of Labor,Brandt Dismukes,IND,660001,2,6,38,46,
Rogers,Insurance Commissioner,Glen Mulready,REP,660001,34,127,582,743,
Rogers,Insurance Commissioner,Kimberly Fobbs,DEM,660001,34,80,319,433,
Rogers,Corporation Commissioner,Bob Anthony,REP,660001,37,121,543,701,
Rogers,Corporation Commissioner,Ashley Nicole Mccray,DEM,660001,33,80,317,430,
Rogers,Corporation Commissioner,Jackie Short,IND,660001,1,6,49,56,
Rogers,U.S. House,Richard Castaldo,LIB,660001,1,3,33,37,2
Rogers,U.S. House,Markwayne Mullin,REP,660001,36,124,542,702,2
Rogers,U.S. House,Jason Nichols,DEM,660001,31,82,315,428,2
Rogers,U.S. House,John Foreman,IND,660001,4,2,28,34,2
Rogers,State Senate,Marty Quinn,REP,660001,29,110,491,630,2
Rogers,State Senate,Jennifer Esau,DEM,660001,42,101,431,574,2
Rogers,State House,Mark Lepak,REP,660001,36,121,551,708,9
Rogers,State House,Clay Layton,DEM,660001,35,88,358,481,9
Rogers,Governor,Chris Powell,LIB,660002,0,7,26,33,
Rogers,Governor,Kevin Stitt,REP,660002,16,75,261,352,
Rogers,Governor,Drew Edmondson,DEM,660002,7,65,208,280,
Rogers,Lieutenant Governor,Matt Pinnell,REP,660002,16,79,289,384,
Rogers,Lieutenant Governor,Anastasia Pittman,DEM,660002,6,62,178,246,
Rogers,Lieutenant Governor,Ivan Holmes,IND,660002,1,5,21,27,
Rogers,State Auditor,John Yeutter,LIB,660002,3,33,146,182,
Rogers,State Auditor,Cindy Byrd,REP,660002,20,96,325,441,
Rogers,Attorney General,Mike Hunter,REP,660002,16,86,308,410,
Rogers,Attorney General,Mark Myles,DEM,660002,7,58,180,245,
Rogers,State Treasurer,Randy Mcdaniel,REP,660002,18,86,315,419,
Rogers,State Treasurer,Charles De Coune,IND,660002,4,43,147,194,
Rogers,Superintendent of Public Instruction,Joy Hofmeister,REP,660002,14,68,274,356,
Rogers,Superintendent of Public Instruction,John Cox,DEM,660002,9,67,167,243,
Rogers,Superintendent of Public Instruction,Larry Huff,IND,660002,0,11,50,61,
Rogers,Commissioner of Labor,Leslie Osborn,REP,660002,15,75,281,371,
Rogers,Commissioner of Labor,Fred Dorrell,DEM,660002,7,62,177,246,
Rogers,Commissioner of Labor,Brandt Dismukes,IND,660002,1,6,26,33,
Rogers,Insurance Commissioner,Glen Mulready,REP,660002,16,80,294,390,
Rogers,Insurance Commissioner,Kimberly Fobbs,DEM,660002,7,63,191,261,
Rogers,Corporation Commissioner,Bob Anthony,REP,660002,14,81,274,369,
Rogers,Corporation Commissioner,Ashley Nicole Mccray,DEM,660002,6,59,183,248,
Rogers,Corporation Commissioner,Jackie Short,IND,660002,3,6,31,40,
Rogers,U.S. House,Richard Castaldo,LIB,660002,0,3,26,29,2
Rogers,U.S. House,Markwayne Mullin,REP,660002,15,81,279,375,2
Rogers,U.S. House,Jason Nichols,DEM,660002,6,58,164,228,2
Rogers,U.S. House,John Foreman,IND,660002,2,4,24,30,2
Rogers,State Senate,Marty Quinn,REP,660002,19,77,247,343,2
Rogers,State Senate,Jennifer Esau,DEM,660002,4,69,244,317,2
Rogers,State House,Mark Lepak,REP,660002,16,81,287,384,9
Rogers,State House,Clay Layton,DEM,660002,7,65,200,272,9
Rogers,Governor,Chris Powell,LIB,660003,1,5,21,27,
Rogers,Governor,Kevin Stitt,REP,660003,11,88,380,479,
Rogers,Governor,Drew Edmondson,DEM,660003,14,52,241,307,
Rogers,Lieutenant Governor,Matt Pinnell,REP,660003,13,100,418,531,
Rogers,Lieutenant Governor,Anastasia Pittman,DEM,660003,12,44,197,253,
Rogers,Lieutenant Governor,Ivan Holmes,IND,660003,1,1,20,22,
Rogers,State Auditor,John Yeutter,LIB,660003,2,24,157,183,
Rogers,State Auditor,Cindy Byrd,REP,660003,22,110,447,579,
Rogers,Attorney General,Mike Hunter,REP,660003,15,95,426,536,
Rogers,Attorney General,Mark Myles,DEM,660003,11,48,203,262,
Rogers,State Treasurer,Randy Mcdaniel,REP,660003,19,100,435,554,
Rogers,State Treasurer,Charles De Coune,IND,660003,6,33,171,210,
Rogers,Superintendent of Public Instruction,Joy Hofmeister,REP,660003,13,87,353,453,
Rogers,Superintendent of Public Instruction,John Cox,DEM,660003,10,44,225,279,
Rogers,Superintendent of Public Instruction,Larry Huff,IND,660003,3,13,62,78,
Rogers,Commissioner of Labor,Leslie Osborn,REP,660003,14,89,394,497,
Rogers,Commissioner of Labor,Fred Dorrell,DEM,660003,9,47,207,263,
Rogers,Commissioner of Labor,Brandt Dismukes,IND,660003,2,6,29,37,
Rogers,Insurance Commissioner,Glen Mulready,REP,660003,15,93,407,515,
Rogers,Insurance Commissioner,Kimberly Fobbs,DEM,660003,11,49,221,281,
Rogers,Corporation Commissioner,Bob Anthony,REP,660003,14,92,389,495,
Rogers,Corporation Commissioner,Ashley Nicole Mccray,DEM,660003,10,47,194,251,
Rogers,Corporation Commissioner,Jackie Short,IND,660003,2,5,50,57,
Rogers,U.S. House,Richard Castaldo,LIB,660003,0,2,17,19,2
Rogers,U.S. House,Markwayne Mullin,REP,660003,12,97,386,495,2
Rogers,U.S. House,Jason Nichols,DEM,660003,11,44,201,256,2
Rogers,U.S. House,John Foreman,IND,660003,3,2,34,39,2
Rogers,State Senate,Marty Quinn,REP,660003,9,81,348,438,2
Rogers,State Senate,Jennifer Esau,DEM,660003,16,63,292,371,2
Rogers,State House,Mark Lepak,REP,660003,14,85,384,483,9
Rogers,State House,Clay Layton,DEM,660003,12,56,252,320,9
Rogers,Governor,Chris Powell,LIB,660004,3,8,36,47,
Rogers,Governor,Kevin Stitt,REP,660004,32,120,561,713,
Rogers,Governor,Drew Edmondson,DEM,660004,29,76,361,466,
Rogers,Lieutenant Governor,Matt Pinnell,REP,660004,35,142,640,817,
Rogers,Lieutenant Governor,Anastasia Pittman,DEM,660004,26,54,281,361,
Rogers,Lieutenant Governor,Ivan Holmes,IND,660004,1,7,29,37,
Rogers,State Auditor,John Yeutter,LIB,660004,12,35,184,231,
Rogers,State Auditor,Cindy Byrd,REP,660004,42,154,713,909,
Rogers,Attorney General,Mike Hunter,REP,660004,32,143,633,808,
Rogers,Attorney General,Mark Myles,DEM,660004,29,60,311,400,
Rogers,State Treasurer,Randy Mcdaniel,REP,660004,35,156,676,867,
Rogers,State Treasurer,Charles De Coune,IND,660004,17,35,222,274,
Rogers,Superintendent of Public Instruction,Joy Hofmeister,REP,660004,34,138,578,750,
Rogers,Superintendent of Public Instruction,John Cox,DEM,660004,25,57,289,371,
Rogers,Superintendent of Public Instruction,Larry Huff,IND,660004,3,10,79,92,
Rogers,Commissioner of Labor,Leslie Osborn,REP,660004,34,139,629,802,
Rogers,Commissioner of Labor,Fred Dorrell,DEM,660004,26,57,269,352,
Rogers,Commissioner of Labor,Brandt Dismukes,IND,660004,1,6,40,47,
Rogers,Insurance Commissioner,Glen Mulready,REP,660004,33,136,615,784,
Rogers,Insurance Commissioner,Kimberly Fobbs,DEM,660004,26,63,318,407,
Rogers,Corporation Commissioner,Bob Anthony,REP,660004,34,149,594,777,
Rogers,Corporation Commissioner,Ashley Nicole Mccray,DEM,660004,26,48,286,360,
Rogers,Corporation Commissioner,Jackie Short,IND,660004,2,4,61,67,
Rogers,U.S. House,Richard Castaldo,LIB,660004,0,3,35,38,2
Rogers,U.S. House,Markwayne Mullin,REP,660004,36,130,581,747,2
Rogers,U.S. House,Jason Nichols,DEM,660004,25,68,294,387,2
Rogers,U.S. House,John Foreman,IND,660004,1,3,42,46,2
Rogers,State Senate,Marty Quinn,REP,660004,29,111,515,655,2
Rogers,State Senate,Jennifer Esau,DEM,660004,33,93,439,565,2
Rogers,State House,Mark Lepak,REP,660004,34,142,622,798,9
Rogers,State House,Clay Layton,DEM,660004,27,62,320,409,9
Rogers,Governor,Chris Powell,LIB,660005,2,2,11,15,
Rogers,Governor,Kevin Stitt,REP,660005,29,117,351,497,
Rogers,Governor,Drew Edmondson,DEM,660005,6,52,154,212,
Rogers,Lieutenant Governor,Matt Pinnell,REP,660005,30,123,389,542,
Rogers,Lieutenant Governor,Anastasia Pittman,DEM,660005,7,44,100,151,
Rogers,Lieutenant Governor,Ivan Holmes,IND,660005,0,3,24,27,
Rogers,State Auditor,John Yeutter,LIB,660005,7,18,86,111,
Rogers,State Auditor,Cindy Byrd,REP,660005,30,137,413,580,
Rogers,Attorney General,Mike Hunter,REP,660005,31,120,395,546,
Rogers,Attorney General,Mark Myles,DEM,660005,6,48,118,172,
Rogers,State Treasurer,Randy Mcdaniel,REP,660005,31,130,408,569,
Rogers,State Treasurer,Charles De Coune,IND,660005,5,25,89,119,
Rogers,Superintendent of Public Instruction,Joy Hofmeister,REP,660005,27,117,345,489,
Rogers,Superintendent of Public Instruction,John Cox,DEM,660005,6,43,121,170,
Rogers,Superintendent of Public Instruction,Larry Huff,IND,660005,4,9,44,57,
Rogers,Commissioner of Labor,Leslie Osborn,REP,660005,30,115,373,518,
Rogers,Commissioner of Labor,Fred Dorrell,DEM,660005,5,48,112,165,
Rogers,Commissioner of Labor,Brandt Dismukes,IND,660005,2,3,24,29,
Rogers,Insurance Commissioner,Glen Mulready,REP,660005,30,127,385,542,
Rogers,Insurance Commissioner,Kimberly Fobbs,DEM,660005,7,42,125,174,
Rogers,Corporation Commissioner,Bob Anthony,REP,660005,28,123,378,529,
Rogers,Corporation Commissioner,Ashley Nicole Mccray,DEM,660005,8,42,105,155,
Rogers,Corporation Commissioner,Jackie Short,IND,660005,1,3,27,31,
Rogers,U.S. House,Richard Castaldo,LIB,660005,2,2,15,19,2
Rogers,U.S. House,Markwayne Mullin,REP,660005,28,119,375,522,2
Rogers,U.S. House,Jason Nichols,DEM,660005,8,43,110,161,2
Rogers,U.S. House,John Foreman,IND,660005,0,5,16,21,2
Rogers,State Senate,Marty Quinn,REP,660005,28,111,347,486,2
Rogers,State Senate,Jennifer Esau,DEM,660005,9,59,166,234,2
Rogers,State House,Mark Lepak,REP,660005,29,120,391,540,9
Rogers,State House,Clay Layton,DEM,660005,8,47,122,177,9
Rogers,Governor,Chris Powell,LIB,660006,0,2,24,26,
Rogers,Governor,Kevin Stitt,REP,660006,32,86,362,480,
Rogers,Governor,Drew Edmondson,DEM,660006,27,31,164,222,
Rogers,Lieutenant Governor,Matt Pinnell,REP,660006,39,88,396,523,
Rogers,Lieutenant Governor,Anastasia Pittman,DEM,660006,17,28,128,173,
Rogers,Lieutenant Governor,Ivan Holmes,IND,660006,2,2,21,25,
Rogers,State Auditor,John Yeutter,LIB,660006,15,22,104,141,
Rogers,State Auditor,Cindy Byrd,REP,660006,40,88,411,539,
Rogers,Attorney General,Mike Hunter,REP,660006,34,89,400,523,
Rogers,Attorney General,Mark Myles,DEM,660006,24,29,141,194,
Rogers,State Treasurer,Randy Mcdaniel,REP,660006,36,89,403,528,
Rogers,State Treasurer,Charles De Coune,IND,660006,19,21,115,155,
Rogers,Superintendent of Public Instruction,Joy Hofmeister,REP,660006,31,83,346,460,
Rogers,Superintendent of Public Instruction,John Cox,DEM,660006,23,30,158,211,
Rogers,Superintendent of Public Instruction,Larry Huff,IND,660006,3,5,39,47,
Rogers,Commissioner of Labor,Leslie Osborn,REP,660006,35,86,375,496,
Rogers,Commissioner of Labor,Fred Dorrell,DEM,660006,21,28,127,176,
Rogers,Commissioner of Labor,Brandt Dismukes,IND,660006,2,4,31,37,
Rogers,Insurance Commissioner,Glen Mulready,REP,660006,33,90,402,525,
Rogers,Insurance Commissioner,Kimberly Fobbs,DEM,660006,24,28,135,187,
Rogers,Corporation Commissioner,Bob Anthony,REP,660006,35,88,378,501,
Rogers,Corporation Commissioner,Ashley Nicole Mccray,DEM,660006,23,27,130,180,
Rogers,Corporation Commissioner,Jackie Short,IND,660006,0,4,29,33,
Rogers,U.S. House,Kevin Hern,REP,660006,33,90,398,521,1
Rogers,U.S. House,Tim Gilpin,DEM,660006,26,29,145,200,1
Rogers,State Senate,Marty Quinn,REP,660006,33,88,379,500,2
Rogers,State Senate,Jennifer Esau,DEM,660006,25,30,166,221,2
Rogers,Governor,Chris Powell,LIB,660007,0,3,38,41,
Rogers,Governor,Kevin Stitt,REP,660007,18,156,510,684,
Rogers,Governor,Drew Edmondson,DEM,660007,21,68,294,383,
Rogers,Lieutenant Governor,Matt Pinnell,REP,660007,21,167,601,789,
Rogers,Lieutenant Governor,Anastasia Pittman,DEM,660007,17,55,210,282,
Rogers,Lieutenant Governor,Ivan Holmes,IND,660007,0,4,30,34,
Rogers,State Auditor,John Yeutter,LIB,660007,6,42,162,210,
Rogers,State Auditor,Cindy Byrd,REP,660007,26,172,648,846,
Rogers,Attorney General,Mike Hunter,REP,660007,20,164,622,806,
Rogers,Attorney General,Mark Myles,DEM,660007,19,62,215,296,
Rogers,State Treasurer,Randy Mcdaniel,REP,660007,26,171,637,834,
Rogers,State Treasurer,Charles De Coune,IND,660007,8,41,172,221,
Rogers,Superintendent of Public Instruction,Joy Hofmeister,REP,660007,18,147,536,701,
Rogers,Superintendent of Public Instruction,John Cox,DEM,660007,20,62,226,308,
Rogers,Superintendent of Public Instruction,Larry Huff,IND,660007,1,17,80,98,
Rogers,Commissioner of Labor,Leslie Osborn,REP,660007,23,159,556,738,
Rogers,Commissioner of Labor,Fred Dorrell,DEM,660007,15,59,225,299,
Rogers,Commissioner of Labor,Brandt Dismukes,IND,660007,0,8,53,61,
Rogers,Insurance Commissioner,Glen Mulready,REP,660007,21,154,590,765,
Rogers,Insurance Commissioner,Kimberly Fobbs,DEM,660007,17,71,244,332,
Rogers,Corporation Commissioner,Bob Anthony,REP,660007,20,160,584,764,
Rogers,Corporation Commissioner,Ashley Nicole Mccray,DEM,660007,16,60,198,274,
Rogers,Corporation Commissioner,Jackie Short,IND,660007,2,7,53,62,
Rogers,U.S. House,Richard Castaldo,LIB,660007,1,6,25,32,2
Rogers,U.S. House,Markwayne Mullin,REP,660007,20,150,548,718,2
Rogers,U.S. House,Jason Nichols,DEM,660007,16,67,234,317,2
Rogers,U.S. House,John Foreman,IND,660007,1,6,35,42,2
Rogers,State Senate,Marty Quinn,REP,660007,20,144,468,632,2
Rogers,State Senate,Jennifer Esau,DEM,660007,19,85,372,476,2
Rogers,State House,Mark Lepak,REP,660007,21,159,561,741,9
Rogers,State House,Clay Layton,DEM,660007,17,69,278,364,9
Rogers,Governor,Chris Powell,LIB,660008,0,3,23,26,
Rogers,Governor,Kevin Stitt,REP,660008,27,88,315,430,
Rogers,Governor,Drew Edmondson,DEM,660008,33,74,231,338,
Rogers,Lieutenant Governor,Matt Pinnell,REP,660008,32,104,369,505,
Rogers,Lieutenant Governor,Anastasia Pittman,DEM,660008,26,59,176,261,
Rogers,Lieutenant Governor,Ivan Holmes,IND,660008,1,2,19,22,
Rogers,State Auditor,John Yeutter,LIB,660008,7,25,119,151,
Rogers,State Auditor,Cindy Byrd,REP,660008,40,126,409,575,
Rogers,Attorney General,Mike Hunter,REP,660008,31,112,369,512,
Rogers,Attorney General,Mark Myles,DEM,660008,28,52,192,272,
Rogers,State Treasurer,Randy Mcdaniel,REP,660008,34,113,390,537,
Rogers,State Treasurer,Charles De Coune,IND,660008,13,40,141,194,
Rogers,Superintendent of Public Instruction,Joy Hofmeister,REP,660008,36,101,329,466,
Rogers,Superintendent of Public Instruction,John Cox,DEM,660008,23,56,204,283,
Rogers,Superintendent of Public Instruction,Larry Huff,IND,660008,1,8,37,46,
Rogers,Commissioner of Labor,Leslie Osborn,REP,660008,30,103,354,487,
Rogers,Commissioner of Labor,Fred Dorrell,DEM,660008,30,57,176,263,
Rogers,Commissioner of Labor,Brandt Dismukes,IND,660008,0,5,27,32,
Rogers,Insurance Commissioner,Glen Mulready,REP,660008,28,106,364,498,
Rogers,Insurance Commissioner,Kimberly Fobbs,DEM,660008,31,58,191,280,
Rogers,Corporation Commissioner,Bob Anthony,REP,660008,34,100,352,486,
Rogers,Corporation Commissioner,Ashley Nicole Mccray,DEM,660008,26,62,175,263,
Rogers,Corporation Commissioner,Jackie Short,IND,660008,0,3,33,36,
Rogers,U.S. House,Richard Castaldo,LIB,660008,0,3,18,21,2
Rogers,U.S. House,Markwayne Mullin,REP,660008,30,94,336,460,2
Rogers,U.S. House,Jason Nichols,DEM,660008,29,65,192,286,2
Rogers,U.S. House,John Foreman,IND,660008,1,3,18,22,2
Rogers,State Senate,Marty Quinn,REP,660008,31,82,285,398,2
Rogers,State Senate,Jennifer Esau,DEM,660008,28,82,283,393,2
Rogers,State House,Mark Lepak,REP,660008,35,97,342,474,9
Rogers,State House,Clay Layton,DEM,660008,25,67,222,314,9
Rogers,Governor,Chris Powell,LIB,660009,2,1,13,16,
Rogers,Governor,Kevin Stitt,REP,660009,19,56,303,378,
Rogers,Governor,Drew Edmondson,DEM,660009,9,35,86,130,
Rogers,Lieutenant Governor,Matt Pinnell,REP,660009,22,64,335,421,
Rogers,Lieutenant Governor,Anastasia Pittman,DEM,660009,7,27,59,93,
Rogers,Lieutenant Governor,Ivan Holmes,IND,660009,1,0,8,9,
Rogers,State Auditor,John Yeutter,LIB,660009,3,18,46,67,
Rogers,State Auditor,Cindy Byrd,REP,660009,22,67,349,438,
Rogers,Attorney General,Mike Hunter,REP,660009,21,66,334,421,
Rogers,Attorney General,Mark Myles,DEM,660009,9,26,68,103,
Rogers,State Treasurer,Randy Mcdaniel,REP,660009,22,68,341,431,
Rogers,State Treasurer,Charles De Coune,IND,660009,3,18,55,76,
Rogers,Superintendent of Public Instruction,Joy Hofmeister,REP,660009,18,58,295,371,
Rogers,Superintendent of Public Instruction,John Cox,DEM,660009,9,28,66,103,
Rogers,Superintendent of Public Instruction,Larry Huff,IND,660009,3,5,38,46,
Rogers,Commissioner of Labor,Leslie Osborn,REP,660009,21,62,317,400,
Rogers,Commissioner of Labor,Fred Dorrell,DEM,660009,8,25,63,96,
Rogers,Commissioner of Labor,Brandt Dismukes,IND,660009,1,5,19,25,
Rogers,Insurance Commissioner,Glen Mulready,REP,660009,21,61,332,414,
Rogers,Insurance Commissioner,Kimberly Fobbs,DEM,660009,9,29,69,107,
Rogers,Corporation Commissioner,Bob Anthony,REP,660009,19,60,318,397,
Rogers,Corporation Commissioner,Ashley Nicole Mccray,DEM,660009,8,27,62,97,
Rogers,Corporation Commissioner,Jackie Short,IND,660009,3,3,20,26,
Rogers,U.S. House,Richard Castaldo,LIB,660009,0,1,6,7,2
Rogers,U.S. House,Markwayne Mullin,REP,660009,21,57,331,409,2
Rogers,U.S. House,Jason Nichols,DEM,660009,9,32,55,96,2
Rogers,U.S. House,John Foreman,IND,660009,0,2,11,13,2
Rogers,State Senate,Marty Quinn,REP,660009,21,57,295,373,2
Rogers,State Senate,Jennifer Esau,DEM,660009,9,34,108,151,2
Rogers,State House,Mark Lepak,REP,660009,21,63,322,406,9
Rogers,State House,Clay Layton,DEM,660009,9,29,77,115,9
Rogers,Governor,Chris Powell,LIB,660010,3,1,43,47,
Rogers,Governor,Kevin Stitt,REP,660010,30,67,871,968,
Rogers,Governor,Drew Edmondson,DEM,660010,29,35,437,501,
Rogers,Lieutenant Governor,Matt Pinnell,REP,660010,35,71,945,1051,
Rogers,Lieutenant Governor,Anastasia Pittman,DEM,660010,25,28,345,398,
Rogers,Lieutenant Governor,Ivan Holmes,IND,660010,2,3,52,57,
Rogers,State Auditor,John Yeutter,LIB,660010,11,16,277,304,
Rogers,State Auditor,Cindy Byrd,REP,660010,41,80,990,1111,
Rogers,Attorney General,Mike Hunter,REP,660010,38,76,970,1084,
Rogers,Attorney General,Mark Myles,DEM,660010,24,27,366,417,
Rogers,State Treasurer,Randy Mcdaniel,REP,660010,42,76,980,1098,
Rogers,State Treasurer,Charles De Coune,IND,660010,11,20,288,319,
Rogers,Superintendent of Public Instruction,Joy Hofmeister,REP,660010,32,67,847,946,
Rogers,Superintendent of Public Instruction,John Cox,DEM,660010,26,26,379,431,
Rogers,Superintendent of Public Instruction,Larry Huff,IND,660010,4,10,115,129,
Rogers,Commissioner of Labor,Leslie Osborn,REP,660010,37,72,905,1014,
Rogers,Commissioner of Labor,Fred Dorrell,DEM,660010,25,27,350,402,
Rogers,Commissioner of Labor,Brandt Dismukes,IND,660010,0,3,71,74,
Rogers,Insurance Commissioner,Glen Mulready,REP,660010,38,72,946,1056,
Rogers,Insurance Commissioner,Kimberly Fobbs,DEM,660010,23,30,382,435,
Rogers,Corporation Commissioner,Bob Anthony,REP,660010,37,68,909,1014,
Rogers,Corporation Commissioner,Ashley Nicole Mccray,DEM,660010,21,27,348,396,
Rogers,Corporation Commissioner,Jackie Short,IND,660010,3,7,78,88,
Rogers,U.S. House,Kevin Hern,REP,660010,34,72,970,1076,1
Rogers,U.S. House,Tim Gilpin,DEM,660010,28,33,374,435,1
Rogers,State Senate,Marty Quinn,REP,660010,38,70,899,1007,2
Rogers,State Senate,Jennifer Esau,DEM,660010,24,33,443,500,2
Rogers,State House,Terry O'Donnell,REP,660010,39,75,952,1066,23
Rogers,State House,Craig John Hoxie,DEM,660010,23,27,386,436,23
Rogers,Governor,Chris Powell,LIB,660011,2,1,37,40,
Rogers,Governor,Kevin Stitt,REP,660011,26,66,691,783,
Rogers,Governor,Drew Edmondson,DEM,660011,10,54,312,376,
Rogers,Lieutenant Governor,Matt Pinnell,REP,660011,29,78,728,835,
Rogers,Lieutenant Governor,Anastasia Pittman,DEM,660011,8,39,272,319,
Rogers,Lieutenant Governor,Ivan Holmes,IND,660011,1,4,37,42,
Rogers,State Auditor,John Yeutter,LIB,660011,7,31,215,253,
Rogers,State Auditor,Cindy Byrd,REP,660011,30,83,772,885,
Rogers,Attorney General,Mike Hunter,REP,660011,29,78,740,847,
Rogers,Attorney General,Mark Myles,DEM,660011,9,43,296,348,
Rogers,State Treasurer,Randy Mcdaniel,REP,660011,26,79,776,881,
Rogers,State Treasurer,Charles De Coune,IND,660011,10,34,210,254,
Rogers,Superintendent of Public Instruction,Joy Hofmeister,REP,660011,21,71,636,728,
Rogers,Superintendent of Public Instruction,John Cox,DEM,660011,7,47,295,349,
Rogers,Superintendent of Public Instruction,Larry Huff,IND,660011,10,3,100,113,
Rogers,Commissioner of Labor,Leslie Osborn,REP,660011,28,73,691,792,
Rogers,Commissioner of Labor,Fred Dorrell,DEM,660011,8,41,296,345,
Rogers,Commissioner of Labor,Brandt Dismukes,IND,660011,2,6,40,48,
Rogers,Insurance Commissioner,Glen Mulready,REP,660011,26,76,719,821,
Rogers,Insurance Commissioner,Kimberly Fobbs,DEM,660011,12,41,307,360,
Rogers,Corporation Commissioner,Bob Anthony,REP,660011,25,72,697,794,
Rogers,Corporation Commissioner,Ashley Nicole Mccray,DEM,660011,10,39,268,317,
Rogers,Corporation Commissioner,Jackie Short,IND,660011,3,9,63,75,
Rogers,U.S. House,Richard Castaldo,LIB,660011,2,4,28,34,2
Rogers,U.S. House,Markwayne Mullin,REP,660011,26,68,710,804,2
Rogers,U.S. House,Jason Nichols,DEM,660011,8,46,265,319,2
Rogers,U.S. House,John Foreman,IND,660011,2,3,31,36,2
Rogers,State House,Rusty Cornwell,REP,660011,26,74,707,807,6
Rogers,State House,John Myers,DEM,660011,12,47,321,380,6
Rogers,Governor,Chris Powell,LIB,660012,1,0,12,13,
Rogers,Governor,Kevin Stitt,REP,660012,2,5,179,186,
Rogers,Governor,Drew Edmondson,DEM,660012,2,3,73,78,
Rogers,Lieutenant Governor,Matt Pinnell,REP,660012,4,6,189,199,
Rogers,Lieutenant Governor,Anastasia Pittman,DEM,660012,1,3,65,69,
Rogers,Lieutenant Governor,Ivan Holmes,IND,660012,0,0,10,10,
Rogers,State Auditor,John Yeutter,LIB,660012,1,3,41,45,
Rogers,State Auditor,Cindy Byrd,REP,660012,3,5,206,214,
Rogers,Attorney General,Mike Hunter,REP,660012,4,6,193,203,
Rogers,Attorney General,Mark Myles,DEM,660012,1,3,70,74,
Rogers,State Treasurer,Randy Mcdaniel,REP,660012,4,6,196,206,
Rogers,State Treasurer,Charles De Coune,IND,660012,0,2,51,53,
Rogers,Superintendent of Public Instruction,Joy Hofmeister,REP,660012,4,6,163,173,
Rogers,Superintendent of Public Instruction,John Cox,DEM,660012,1,3,85,89,
Rogers,Superintendent of Public Instruction,Larry Huff,IND,660012,0,0,16,16,
Rogers,Commissioner of Labor,Leslie Osborn,REP,660012,4,5,178,187,
Rogers,Commissioner of Labor,Fred Dorrell,DEM,660012,1,3,71,75,
Rogers,Commissioner of Labor,Brandt Dismukes,IND,660012,0,1,13,14,
Rogers,Insurance Commissioner,Glen Mulready,REP,660012,4,6,189,199,
Rogers,Insurance Commissioner,Kimberly Fobbs,DEM,660012,1,3,72,76,
Rogers,Corporation Commissioner,Bob Anthony,REP,660012,4,6,174,184,
Rogers,Corporation Commissioner,Ashley Nicole Mccray,DEM,660012,1,3,69,73,
Rogers,Corporation Commissioner,Jackie Short,IND,660012,0,0,19,19,
Rogers,U.S. House,Richard Castaldo,LIB,660012,2,0,4,6,2
Rogers,U.S. House,Markwayne Mullin,REP,660012,2,6,183,191,2
Rogers,U.S. House,Jason Nichols,DEM,660012,1,3,63,67,2
Rogers,U.S. House,John Foreman,IND,660012,0,0,12,12,2
Rogers,State Senate,Marty Quinn,REP,660012,3,6,164,173,2
Rogers,State Senate,Jennifer Esau,DEM,660012,2,3,98,103,2
Rogers,State House,Tom Gann,REP,660012,3,6,176,185,8
Rogers,State House,Darrell Moore,DEM,660012,2,3,86,91,8
Rogers,Governor,Chris Powell,LIB,660013,2,0,19,21,
Rogers,Governor,Kevin Stitt,REP,660013,13,68,442,523,
Rogers,Governor,Drew Edmondson,DEM,660013,13,40,217,270,
Rogers,Lieutenant Governor,Matt Pinnell,REP,660013,15,76,502,593,
Rogers,Lieutenant Governor,Anastasia Pittman,DEM,660013,12,30,148,190,
Rogers,Lieutenant Governor,Ivan Holmes,IND,660013,1,3,27,31,
Rogers,State Auditor,John Yeutter,LIB,660013,9,22,112,143,
Rogers,State Auditor,Cindy Byrd,REP,660013,18,87,536,641,
Rogers,Attorney General,Mike Hunter,REP,660013,15,76,514,605,
Rogers,Attorney General,Mark Myles,DEM,660013,13,34,161,208,
Rogers,State Treasurer,Randy Mcdaniel,REP,660013,16,81,519,616,
Rogers,State Treasurer,Charles De Coune,IND,660013,11,26,133,170,
Rogers,Superintendent of Public Instruction,Joy Hofmeister,REP,660013,15,70,414,499,
Rogers,Superintendent of Public Instruction,John Cox,DEM,660013,12,31,194,237,
Rogers,Superintendent of Public Instruction,Larry Huff,IND,660013,1,8,66,75,
Rogers,Commissioner of Labor,Leslie Osborn,REP,660013,16,73,475,564,
Rogers,Commissioner of Labor,Fred Dorrell,DEM,660013,10,29,161,200,
Rogers,Commissioner of Labor,Brandt Dismukes,IND,660013,2,4,35,41,
Rogers,Insurance Commissioner,Glen Mulready,REP,660013,15,75,505,595,
Rogers,Insurance Commissioner,Kimberly Fobbs,DEM,660013,13,34,172,219,
Rogers,Corporation Commissioner,Bob Anthony,REP,660013,13,76,486,575,
Rogers,Corporation Commissioner,Ashley Nicole Mccray,DEM,660013,12,31,145,188,
Rogers,Corporation Commissioner,Jackie Short,IND,660013,3,2,44,49,
Rogers,U.S. House,Richard Castaldo,LIB,660013,1,3,23,27,2
Rogers,U.S. House,Markwayne Mullin,REP,660013,15,71,462,548,2
Rogers,U.S. House,Jason Nichols,DEM,660013,11,33,159,203,2
Rogers,U.S. House,John Foreman,IND,660013,1,3,33,37,2
Rogers,State Senate,Marty Quinn,REP,660013,14,60,431,505,2
Rogers,State Senate,Jennifer Esau,DEM,660013,14,50,245,309,2
Rogers,State House,Mark Lepak,REP,660013,15,72,485,572,9
Rogers,State House,Clay Layton,DEM,660013,13,37,188,238,9
Rogers,Governor,Chris Powell,LIB,660014,1,2,17,20,
Rogers,Governor,Kevin Stitt,REP,660014,17,94,412,523,
Rogers,Governor,Drew Edmondson,DEM,660014,7,64,219,290,
Rogers,Lieutenant Governor,Matt Pinnell,REP,660014,16,110,482,608,
Rogers,Lieutenant Governor,Anastasia Pittman,DEM,660014,7,48,141,196,
Rogers,Lieutenant Governor,Ivan Holmes,IND,660014,2,1,22,25,
Rogers,State Auditor,John Yeutter,LIB,660014,5,28,82,115,
Rogers,State Auditor,Cindy Byrd,REP,660014,20,121,527,668,
Rogers,Attorney General,Mike Hunter,REP,660014,19,108,492,619,
Rogers,Attorney General,Mark Myles,DEM,660014,6,50,147,203,
Rogers,State Treasurer,Randy Mcdaniel,REP,660014,18,115,501,634,
Rogers,State Treasurer,Charles De Coune,IND,660014,7,30,108,145,
Rogers,Superintendent of Public Instruction,Joy Hofmeister,REP,660014,20,109,441,570,
Rogers,Superintendent of Public Instruction,John Cox,DEM,660014,3,45,166,214,
Rogers,Superintendent of Public Instruction,Larry Huff,IND,660014,2,6,37,45,
Rogers,Commissioner of Labor,Leslie Osborn,REP,660014,18,110,467,595,
Rogers,Commissioner of Labor,Fred Dorrell,DEM,660014,6,46,138,190,
Rogers,Commissioner of Labor,Brandt Dismukes,IND,660014,1,2,29,32,
Rogers,Insurance Commissioner,Glen Mulready,REP,660014,18,111,475,604,
Rogers,Insurance Commissioner,Kimberly Fobbs,DEM,660014,7,48,159,214,
Rogers,Corporation Commissioner,Bob Anthony,REP,660014,19,109,463,591,
Rogers,Corporation Commissioner,Ashley Nicole Mccray,DEM,660014,3,45,144,192,
Rogers,Corporation Commissioner,Jackie Short,IND,660014,3,4,28,35,
Rogers,U.S. House,Richard Castaldo,LIB,660014,1,1,9,11,2
Rogers,U.S. House,Markwayne Mullin,REP,660014,17,101,449,567,2
Rogers,U.S. House,Jason Nichols,DEM,660014,6,54,166,226,2
Rogers,U.S. House,John Foreman,IND,660014,1,4,21,26,2
Rogers,State Senate,Marty Quinn,REP,660014,16,93,393,502,2
Rogers,State Senate,Jennifer Esau,DEM,660014,9,67,254,330,2
Rogers,State House,Mark Lepak,REP,660014,20,114,464,598,9
Rogers,State House,Clay Layton,DEM,660014,5,45,174,224,9
Rogers,Governor,Chris Powell,LIB,660015,0,1,38,39,
Rogers,Governor,Kevin Stitt,REP,660015,27,38,631,696,
Rogers,Governor,Drew Edmondson,DEM,660015,19,27,318,364,
Rogers,Lieutenant Governor,Matt Pinnell,REP,660015,30,42,705,777,
Rogers,Lieutenant Governor,Anastasia Pittman,DEM,660015,17,22,245,284,
Rogers,Lieutenant Governor,Ivan Holmes,IND,660015,0,2,33,35,
Rogers,State Auditor,John Yeutter,LIB,660015,17,14,192,223,
Rogers,State Auditor,Cindy Byrd,REP,660015,28,49,750,827,
Rogers,Attorney General,Mike Hunter,REP,660015,25,43,705,773,
Rogers,Attorney General,Mark Myles,DEM,660015,21,22,270,313,
Rogers,State Treasurer,Randy Mcdaniel,REP,660015,26,47,734,807,
Rogers,State Treasurer,Charles De Coune,IND,660015,16,17,208,241,
Rogers,Superintendent of Public Instruction,Joy Hofmeister,REP,660015,25,39,585,649,
Rogers,Superintendent of Public Instruction,John Cox,DEM,660015,18,21,301,340,
Rogers,Superintendent of Public Instruction,Larry Huff,IND,660015,4,4,95,103,
Rogers,Commissioner of Labor,Leslie Osborn,REP,660015,27,42,658,727,
Rogers,Commissioner of Labor,Fred Dorrell,DEM,660015,18,21,273,312,
Rogers,Commissioner of Labor,Brandt Dismukes,IND,660015,1,3,43,47,
Rogers,Insurance Commissioner,Glen Mulready,REP,660015,26,40,675,741,
Rogers,Insurance Commissioner,Kimberly Fobbs,DEM,660015,20,26,295,341,
Rogers,Corporation Commissioner,Bob Anthony,REP,660015,27,41,646,714,
Rogers,Corporation Commissioner,Ashley Nicole Mccray,DEM,660015,19,20,276,315,
Rogers,Corporation Commissioner,Jackie Short,IND,660015,0,5,55,60,
Rogers,U.S. House,Richard Castaldo,LIB,660015,1,3,36,40,2
Rogers,U.S. House,Markwayne Mullin,REP,660015,25,40,657,722,2
Rogers,U.S. House,Jason Nichols,DEM,660015,18,20,256,294,2
Rogers,U.S. House,John Foreman,IND,660015,1,3,35,39,2
Rogers,State House,Rusty Cornwell,REP,660015,20,38,645,703,6
Rogers,State House,John Myers,DEM,660015,26,28,332,386,6
Rogers,Governor,Chris Powell,LIB,660017,0,0,28,28,
Rogers,Governor,Kevin Stitt,REP,660017,12,49,321,382,
Rogers,Governor,Drew Edmondson,DEM,660017,4,13,160,177,
Rogers,Lieutenant Governor,Matt Pinnell,REP,660017,13,50,363,426,
Rogers,Lieutenant Governor,Anastasia Pittman,DEM,660017,2,12,121,135,
Rogers,Lieutenant Governor,Ivan Holmes,IND,660017,1,0,19,20,
Rogers,State Auditor,John Yeutter,LIB,660017,3,8,80,91,
Rogers,State Auditor,Cindy Byrd,REP,660017,13,50,390,453,
Rogers,Attorney General,Mike Hunter,REP,660017,12,49,376,437,
Rogers,Attorney General,Mark Myles,DEM,660017,4,13,124,141,
Rogers,State Treasurer,Randy Mcdaniel,REP,660017,12,50,376,438,
Rogers,State Treasurer,Charles De Coune,IND,660017,4,9,88,101,
Rogers,Superintendent of Public Instruction,Joy Hofmeister,REP,660017,11,45,331,387,
Rogers,Superintendent of Public Instruction,John Cox,DEM,660017,3,13,125,141,
Rogers,Superintendent of Public Instruction,Larry Huff,IND,660017,1,4,44,49,
Rogers,Commissioner of Labor,Leslie Osborn,REP,660017,12,50,341,403,
Rogers,Commissioner of Labor,Fred Dorrell,DEM,660017,3,12,127,142,
Rogers,Commissioner of Labor,Brandt Dismukes,IND,660017,1,0,27,28,
Rogers,Insurance Commissioner,Glen Mulready,REP,660017,13,53,360,426,
Rogers,Insurance Commissioner,Kimberly Fobbs,DEM,660017,3,8,138,149,
Rogers,Corporation Commissioner,Bob Anthony,REP,660017,13,49,359,421,
Rogers,Corporation Commissioner,Ashley Nicole Mccray,DEM,660017,3,11,113,127,
Rogers,Corporation Commissioner,Jackie Short,IND,660017,0,1,28,29,
Rogers,U.S. House,Richard Castaldo,LIB,660017,0,0,8,8,2
Rogers,U.S. House,Markwayne Mullin,REP,660017,14,49,360,423,2
Rogers,U.S. House,Jason Nichols,DEM,660017,1,13,121,135,2
Rogers,U.S. House,John Foreman,IND,660017,0,0,16,16,2
Rogers,State House,Mark Lepak,REP,660017,13,46,351,410,9
Rogers,State House,Clay Layton,DEM,660017,3,16,146,165,9
Rogers,Governor,Chris Powell,LIB,660018,1,9,43,53,
Rogers,Governor,Kevin Stitt,REP,660018,42,130,623,795,
Rogers,Governor,Drew Edmondson,DEM,660018,20,65,269,354,
Rogers,Lieutenant Governor,Matt Pinnell,REP,660018,44,151,724,919,
Rogers,Lieutenant Governor,Anastasia Pittman,DEM,660018,18,45,179,242,
Rogers,Lieutenant Governor,Ivan Holmes,IND,660018,1,6,29,36,
Rogers,State Auditor,John Yeutter,LIB,660018,13,40,131,184,
Rogers,State Auditor,Cindy Byrd,REP,660018,47,154,773,974,
Rogers,Attorney General,Mike Hunter,REP,660018,45,149,713,907,
Rogers,Attorney General,Mark Myles,DEM,660018,18,54,216,288,
Rogers,State Treasurer,Randy Mcdaniel,REP,660018,49,152,733,934,
Rogers,State Treasurer,Charles De Coune,IND,660018,11,43,164,218,
Rogers,Superintendent of Public Instruction,Joy Hofmeister,REP,660018,45,130,646,821,
Rogers,Superintendent of Public Instruction,John Cox,DEM,660018,15,63,219,297,
Rogers,Superintendent of Public Instruction,Larry Huff,IND,660018,3,10,61,74,
Rogers,Commissioner of Labor,Leslie Osborn,REP,660018,46,143,678,867,
Rogers,Commissioner of Labor,Fred Dorrell,DEM,660018,16,52,190,258,
Rogers,Commissioner of Labor,Brandt Dismukes,IND,660018,0,7,41,48,
Rogers,Insurance Commissioner,Glen Mulready,REP,660018,47,144,690,881,
Rogers,Insurance Commissioner,Kimberly Fobbs,DEM,660018,16,57,224,297,
Rogers,Corporation Commissioner,Bob Anthony,REP,660018,44,144,662,850,
Rogers,Corporation Commissioner,Ashley Nicole Mccray,DEM,660018,16,52,209,277,
Rogers,Corporation Commissioner,Jackie Short,IND,660018,3,5,50,58,
Rogers,U.S. House,Richard Castaldo,LIB,660018,3,5,23,31,2
Rogers,U.S. House,Markwayne Mullin,REP,660018,41,140,688,869,2
Rogers,U.S. House,Jason Nichols,DEM,660018,18,54,193,265,2
Rogers,U.S. House,John Foreman,IND,660018,1,4,28,33,2
Rogers,State Senate,Marty Quinn,REP,660018,46,116,578,740,2
Rogers,State Senate,Jennifer Esau,DEM,660018,17,88,357,462,2
Rogers,State House,Mark Lepak,REP,660018,42,141,696,879,9
Rogers,State House,Clay Layton,DEM,660018,21,62,231,314,9
Rogers,Governor,Chris Powell,LIB,660019,0,0,21,21,
Rogers,Governor,Kevin Stitt,REP,660019,17,37,423,477,
Rogers,Governor,Drew Edmondson,DEM,660019,19,29,131,179,
Rogers,Lieutenant Governor,Matt Pinnell,REP,660019,18,47,459,524,
Rogers,Lieutenant Governor,Anastasia Pittman,DEM,660019,16,19,98,133,
Rogers,Lieutenant Governor,Ivan Holmes,IND,660019,2,0,14,16,
Rogers,State Auditor,John Yeutter,LIB,660019,10,7,83,100,
Rogers,State Auditor,Cindy Byrd,REP,660019,22,52,464,538,
Rogers,Attorney General,Mike Hunter,REP,660019,17,46,450,513,
Rogers,Attorney General,Mark Myles,DEM,660019,19,20,117,156,
Rogers,State Treasurer,Randy Mcdaniel,REP,660019,20,49,462,531,
Rogers,State Treasurer,Charles De Coune,IND,660019,12,10,86,108,
Rogers,Superintendent of Public Instruction,Joy Hofmeister,REP,660019,17,43,398,458,
Rogers,Superintendent of Public Instruction,John Cox,DEM,660019,17,22,124,163,
Rogers,Superintendent of Public Instruction,Larry Huff,IND,660019,2,1,49,52,
Rogers,Commissioner of Labor,Leslie Osborn,REP,660019,17,41,436,494,
Rogers,Commissioner of Labor,Fred Dorrell,DEM,660019,17,24,97,138,
Rogers,Commissioner of Labor,Brandt Dismukes,IND,660019,2,1,30,33,
Rogers,Insurance Commissioner,Glen Mulready,REP,660019,20,42,445,507,
Rogers,Insurance Commissioner,Kimberly Fobbs,DEM,660019,16,24,119,159,
Rogers,Corporation Commissioner,Bob Anthony,REP,660019,21,44,435,500,
Rogers,Corporation Commissioner,Ashley Nicole Mccray,DEM,660019,13,22,102,137,
Rogers,Corporation Commissioner,Jackie Short,IND,660019,2,0,28,30,
Rogers,U.S. House,Richard Castaldo,LIB,660019,1,1,14,16,2
Rogers,U.S. House,Markwayne Mullin,REP,660019,16,43,436,495,2
Rogers,U.S. House,Jason Nichols,DEM,660019,16,21,111,148,2
Rogers,U.S. House,John Foreman,IND,660019,2,1,13,16,2
Rogers,State Senate,Marty Quinn,REP,660019,17,39,412,468,2
Rogers,State Senate,Jennifer Esau,DEM,660019,19,27,159,205,2
Rogers,State House,Tom Gann,REP,660019,17,39,430,486,8
Rogers,State House,Darrell Moore,DEM,660019,19,26,143,188,8
Rogers,Governor,Chris Powell,LIB,660020,2,4,34,40,
Rogers,Governor,Kevin Stitt,REP,660020,29,162,691,882,
Rogers,Governor,Drew Edmondson,DEM,660020,23,69,380,472,
Rogers,Lieutenant Governor,Matt Pinnell,REP,660020,35,181,787,1003,
Rogers,Lieutenant Governor,Anastasia Pittman,DEM,660020,16,56,273,345,
Rogers,Lieutenant Governor,Ivan Holmes,IND,660020,3,0,38,41,
Rogers,State Auditor,John Yeutter,LIB,660020,8,32,211,251,
Rogers,State Auditor,Cindy Byrd,REP,660020,43,196,837,1076,
Rogers,Attorney General,Mike Hunter,REP,660020,38,184,797,1019,
Rogers,Attorney General,Mark Myles,DEM,660020,16,53,297,366,
Rogers,State Treasurer,Randy Mcdaniel,REP,660020,39,196,806,1041,
Rogers,State Treasurer,Charles De Coune,IND,660020,12,31,235,278,
Rogers,Superintendent of Public Instruction,Joy Hofmeister,REP,660020,32,169,738,939,
Rogers,Superintendent of Public Instruction,John Cox,DEM,660020,19,53,280,352,
Rogers,Superintendent of Public Instruction,Larry Huff,IND,660020,3,16,81,100,
Rogers,Commissioner of Labor,Leslie Osborn,REP,660020,40,173,731,944,
Rogers,Commissioner of Labor,Fred Dorrell,DEM,660020,14,56,298,368,
Rogers,Commissioner of Labor,Brandt Dismukes,IND,660020,0,4,49,53,
Rogers,Insurance Commissioner,Glen Mulready,REP,660020,38,175,776,989,
Rogers,Insurance Commissioner,Kimberly Fobbs,DEM,660020,16,59,306,381,
Rogers,Corporation Commissioner,Bob Anthony,REP,660020,40,179,735,954,
Rogers,Corporation Commissioner,Ashley Nicole Mccray,DEM,660020,13,56,289,358,
Rogers,Corporation Commissioner,Jackie Short,IND,660020,0,1,59,60,
Rogers,U.S. House,Richard Castaldo,LIB,660020,1,3,45,49,2
Rogers,U.S. House,Markwayne Mullin,REP,660020,37,173,725,935,2
Rogers,U.S. House,Jason Nichols,DEM,660020,16,57,290,363,2
Rogers,U.S. House,John Foreman,IND,660020,0,5,37,42,2
Rogers,State Senate,Marty Quinn,REP,660020,28,147,649,824,2
Rogers,State Senate,Jennifer Esau,DEM,660020,26,90,453,569,2
Rogers,State House,Mark Lepak,REP,660020,33,172,751,956,9
Rogers,State House,Clay Layton,DEM,660020,20,64,344,428,9
Rogers,Governor,Chris Powell,LIB,660021,0,0,6,6,
Rogers,Governor,Kevin Stitt,REP,660021,14,36,245,295,
Rogers,Governor,Drew Edmondson,DEM,660021,9,12,78,99,
Rogers,Lieutenant Governor,Matt Pinnell,REP,660021,16,39,285,340,
Rogers,Lieutenant Governor,Anastasia Pittman,DEM,660021,7,8,39,54,
Rogers,Lieutenant Governor,Ivan Holmes,IND,660021,0,1,4,5,
Rogers,State Auditor,John Yeutter,LIB,660021,3,4,31,38,
Rogers,State Auditor,Cindy Byrd,REP,660021,19,41,288,348,
Rogers,Attorney General,Mike Hunter,REP,660021,16,40,283,339,
Rogers,Attorney General,Mark Myles,DEM,660021,7,8,44,59,
Rogers,State Treasurer,Randy Mcdaniel,REP,660021,16,40,281,337,
Rogers,State Treasurer,Charles De Coune,IND,660021,5,4,36,45,
Rogers,Superintendent of Public Instruction,Joy Hofmeister,REP,660021,16,35,243,294,
Rogers,Superintendent of Public Instruction,John Cox,DEM,660021,5,8,67,80,
Rogers,Superintendent of Public Instruction,Larry Huff,IND,660021,2,5,19,26,
Rogers,Commissioner of Labor,Leslie Osborn,REP,660021,17,40,271,328,
Rogers,Commissioner of Labor,Fred Dorrell,DEM,660021,5,7,48,60,
Rogers,Commissioner of Labor,Brandt Dismukes,IND,660021,0,1,6,7,
Rogers,Insurance Commissioner,Glen Mulready,REP,660021,14,40,275,329,
Rogers,Insurance Commissioner,Kimberly Fobbs,DEM,660021,8,8,50,66,
Rogers,Corporation Commissioner,Bob Anthony,REP,660021,14,39,267,320,
Rogers,Corporation Commissioner,Ashley Nicole Mccray,DEM,660021,7,8,45,60,
Rogers,Corporation Commissioner,Jackie Short,IND,660021,1,0,11,12,
Rogers,U.S. House,Kevin Hern,REP,660021,16,41,278,335,1
Rogers,U.S. House,Tim Gilpin,DEM,660021,7,7,48,62,1
Rogers,Governor,Chris Powell,LIB,660022,4,5,22,31,
Rogers,Governor,Kevin Stitt,REP,660022,26,113,538,677,
Rogers,Governor,Drew Edmondson,DEM,660022,6,38,258,302,
Rogers,Lieutenant Governor,Matt Pinnell,REP,660022,27,123,607,757,
Rogers,Lieutenant Governor,Anastasia Pittman,DEM,660022,6,29,182,217,
Rogers,Lieutenant Governor,Ivan Holmes,IND,660022,2,3,25,30,
Rogers,State Auditor,John Yeutter,LIB,660022,5,32,137,174,
Rogers,State Auditor,Cindy Byrd,REP,660022,29,114,640,783,
Rogers,Attorney General,Mike Hunter,REP,660022,30,117,607,754,
Rogers,Attorney General,Mark Myles,DEM,660022,6,37,200,243,
Rogers,State Treasurer,Randy Mcdaniel,REP,660022,26,118,627,771,
Rogers,State Treasurer,Charles De Coune,IND,660022,7,28,144,179,
Rogers,Superintendent of Public Instruction,Joy Hofmeister,REP,660022,22,106,538,666,
Rogers,Superintendent of Public Instruction,John Cox,DEM,660022,9,39,205,253,
Rogers,Superintendent of Public Instruction,Larry Huff,IND,660022,3,11,65,79,
Rogers,Commissioner of Labor,Leslie Osborn,REP,660022,29,111,569,709,
Rogers,Commissioner of Labor,Fred Dorrell,DEM,660022,5,37,192,234,
Rogers,Commissioner of Labor,Brandt Dismukes,IND,660022,2,5,42,49,
Rogers,Insurance Commissioner,Glen Mulready,REP,660022,26,123,599,748,
Rogers,Insurance Commissioner,Kimberly Fobbs,DEM,660022,8,30,201,239,
Rogers,Corporation Commissioner,Bob Anthony,REP,660022,27,114,592,733,
Rogers,Corporation Commissioner,Ashley Nicole Mccray,DEM,660022,6,31,182,219,
Rogers,Corporation Commissioner,Jackie Short,IND,660022,3,9,33,45,
Rogers,U.S. House,Richard Castaldo,LIB,660022,4,1,23,28,2
Rogers,U.S. House,Markwayne Mullin,REP,660022,27,123,572,722,2
Rogers,U.S. House,Jason Nichols,DEM,660022,5,28,187,220,2
Rogers,U.S. House,John Foreman,IND,660022,0,3,31,34,2
Rogers,State Senate,Marty Quinn,REP,660022,26,110,488,624,2
Rogers,State Senate,Jennifer Esau,DEM,660022,8,46,325,379,2
Rogers,State House,Rusty Cornwell,REP,660022,29,112,576,717,6
Rogers,State House,John Myers,DEM,660022,7,43,232,282,6
Rogers,Governor,Chris Powell,LIB,660023,1,2,56,59,
Rogers,Governor,Kevin Stitt,REP,660023,27,56,963,1046,
Rogers,Governor,Drew Edmondson,DEM,660023,18,27,380,425,
Rogers,Lieutenant Governor,Matt Pinnell,REP,660023,28,64,1030,1122,
Rogers,Lieutenant Governor,Anastasia Pittman,DEM,660023,16,17,311,344,
Rogers,Lieutenant Governor,Ivan Holmes,IND,660023,2,4,48,54,
Rogers,State Auditor,John Yeutter,LIB,660023,11,16,242,269,
Rogers,State Auditor,Cindy Byrd,REP,660023,33,65,1090,1188,
Rogers,Attorney General,Mike Hunter,REP,660023,29,66,1031,1126,
Rogers,Attorney General,Mark Myles,DEM,660023,16,17,353,386,
Rogers,State Treasurer,Randy Mcdaniel,REP,660023,34,70,1086,1190,
Rogers,State Treasurer,Charles De Coune,IND,660023,10,13,243,266,
Rogers,Superintendent of Public Instruction,Joy Hofmeister,REP,660023,33,60,884,977,
Rogers,Superintendent of Public Instruction,John Cox,DEM,660023,10,16,375,401,
Rogers,Superintendent of Public Instruction,Larry Huff,IND,660023,3,8,126,137,
Rogers,Commissioner of Labor,Leslie Osborn,REP,660023,26,61,957,1044,
Rogers,Commissioner of Labor,Fred Dorrell,DEM,660023,16,19,347,382,
Rogers,Commissioner of Labor,Brandt Dismukes,IND,660023,3,4,70,77,
Rogers,Insurance Commissioner,Glen Mulready,REP,660023,28,61,1004,1093,
Rogers,Insurance Commissioner,Kimberly Fobbs,DEM,660023,16,22,368,406,
Rogers,Corporation Commissioner,Bob Anthony,REP,660023,28,62,997,1087,
Rogers,Corporation Commissioner,Ashley Nicole Mccray,DEM,660023,16,17,311,344,
Rogers,Corporation Commissioner,Jackie Short,IND,660023,1,3,77,81,
Rogers,U.S. House,Richard Castaldo,LIB,660023,3,4,42,49,2
Rogers,U.S. House,Markwayne Mullin,REP,660023,27,62,990,1079,2
Rogers,U.S. House,Jason Nichols,DEM,660023,15,17,311,343,2
Rogers,U.S. House,John Foreman,IND,660023,1,2,46,49,2
Rogers,State House,Rusty Cornwell,REP,660023,30,60,965,1055,6
Rogers,State House,John Myers,DEM,660023,15,25,418,458,6
Rogers,Governor,Chris Powell,LIB,660024,0,0,16,16,
Rogers,Governor,Kevin Stitt,REP,660024,18,14,309,341,
Rogers,Governor,Drew Edmondson,DEM,660024,4,3,136,143,
Rogers,Lieutenant Governor,Matt Pinnell,REP,660024,19,14,350,383,
Rogers,Lieutenant Governor,Anastasia Pittman,DEM,660024,3,2,98,103,
Rogers,Lieutenant Governor,Ivan Holmes,IND,660024,0,0,12,12,
Rogers,State Auditor,John Yeutter,LIB,660024,3,1,67,71,
Rogers,State Auditor,Cindy Byrd,REP,660024,18,15,369,402,
Rogers,Attorney General,Mike Hunter,REP,660024,17,14,348,379,
Rogers,Attorney General,Mark Myles,DEM,660024,4,3,107,114,
Rogers,State Treasurer,Randy Mcdaniel,REP,660024,18,14,363,395,
Rogers,State Treasurer,Charles De Coune,IND,660024,3,1,74,78,
Rogers,Superintendent of Public Instruction,Joy Hofmeister,REP,660024,17,12,293,322,
Rogers,Superintendent of Public Instruction,John Cox,DEM,660024,3,5,130,138,
Rogers,Superintendent of Public Instruction,Larry Huff,IND,660024,2,0,37,39,
Rogers,Commissioner of Labor,Leslie Osborn,REP,660024,16,15,343,374,
Rogers,Commissioner of Labor,Fred Dorrell,DEM,660024,4,2,100,106,
Rogers,Commissioner of Labor,Brandt Dismukes,IND,660024,1,0,14,15,
Rogers,Insurance Commissioner,Glen Mulready,REP,660024,16,14,342,372,
Rogers,Insurance Commissioner,Kimberly Fobbs,DEM,660024,5,2,116,123,
Rogers,Corporation Commissioner,Bob Anthony,REP,660024,20,15,328,363,
Rogers,Corporation Commissioner,Ashley Nicole Mccray,DEM,660024,2,2,109,113,
Rogers,Corporation Commissioner,Jackie Short,IND,660024,0,0,21,21,
Rogers,U.S. House,Richard Castaldo,LIB,660024,1,0,13,14,2
Rogers,U.S. House,Markwayne Mullin,REP,660024,17,12,332,361,2
Rogers,U.S. House,Jason Nichols,DEM,660024,3,3,97,103,2
Rogers,U.S. House,John Foreman,IND,660024,1,2,18,21,2
Rogers,State House,Rusty Cornwell,REP,660024,18,14,316,348,6
Rogers,State House,John Myers,DEM,660024,4,3,141,148,6
Rogers,Governor,Chris Powell,LIB,660025,0,1,5,6,
Rogers,Governor,Kevin Stitt,REP,660025,6,1,128,135,
Rogers,Governor,Drew Edmondson,DEM,660025,2,5,67,74,
Rogers,Lieutenant Governor,Matt Pinnell,REP,660025,6,3,144,153,
Rogers,Lieutenant Governor,Anastasia Pittman,DEM,660025,2,4,51,57,
Rogers,Lieutenant Governor,Ivan Holmes,IND,660025,0,0,3,3,
Rogers,State Auditor,John Yeutter,LIB,660025,2,5,30,37,
Rogers,State Auditor,Cindy Byrd,REP,660025,5,2,160,167,
Rogers,Attorney General,Mike Hunter,REP,660025,6,4,147,157,
Rogers,Attorney General,Mark Myles,DEM,660025,2,3,50,55,
Rogers,State Treasurer,Randy Mcdaniel,REP,660025,6,1,153,160,
Rogers,State Treasurer,Charles De Coune,IND,660025,1,5,38,44,
Rogers,Superintendent of Public Instruction,Joy Hofmeister,REP,660025,4,3,135,142,
Rogers,Superintendent of Public Instruction,John Cox,DEM,660025,3,3,48,54,
Rogers,Superintendent of Public Instruction,Larry Huff,IND,660025,1,1,13,15,
Rogers,Commissioner of Labor,Leslie Osborn,REP,660025,4,1,148,153,
Rogers,Commissioner of Labor,Fred Dorrell,DEM,660025,4,6,40,50,
Rogers,Commissioner of Labor,Brandt Dismukes,IND,660025,0,0,6,6,
Rogers,Insurance Commissioner,Glen Mulready,REP,660025,6,2,148,156,
Rogers,Insurance Commissioner,Kimberly Fobbs,DEM,660025,2,5,46,53,
Rogers,Corporation Commissioner,Bob Anthony,REP,660025,4,3,144,151,
Rogers,Corporation Commissioner,Ashley Nicole Mccray,DEM,660025,3,4,45,52,
Rogers,Corporation Commissioner,Jackie Short,IND,660025,0,0,8,8,
Rogers,U.S. House,Kevin Hern,REP,660025,5,3,147,155,1
Rogers,U.S. House,Tim Gilpin,DEM,660025,3,4,50,57,1
Rogers,State Senate,Marty Quinn,REP,660025,5,1,137,143,2
Rogers,State Senate,Jennifer Esau,DEM,660025,3,6,60,69,2
Rogers,State House,Todd Blackburn,REP,660025,5,3,128,136,77
Rogers,State House,John Waldron,DEM,660025,3,4,71,78,77
Rogers,Governor,Chris Powell,LIB,660026,0,8,36,44,
Rogers,Governor,Kevin Stitt,REP,660026,29,81,905,1015,
Rogers,Governor,Drew Edmondson,DEM,660026,22,19,335,376,
Rogers,Lieutenant Governor,Matt Pinnell,REP,660026,32,87,995,1114,
Rogers,Lieutenant Governor,Anastasia Pittman,DEM,660026,18,20,238,276,
Rogers,Lieutenant Governor,Ivan Holmes,IND,660026,1,0,35,36,
Rogers,State Auditor,John Yeutter,LIB,660026,8,17,195,220,
Rogers,State Auditor,Cindy Byrd,REP,660026,37,87,1009,1133,
Rogers,Attorney General,Mike Hunter,REP,660026,33,86,983,1102,
Rogers,Attorney General,Mark Myles,DEM,660026,17,22,277,316,
Rogers,State Treasurer,Randy Mcdaniel,REP,660026,34,89,998,1121,
Rogers,State Treasurer,Charles De Coune,IND,660026,9,15,202,226,
Rogers,Superintendent of Public Instruction,Joy Hofmeister,REP,660026,27,78,804,909,
Rogers,Superintendent of Public Instruction,John Cox,DEM,660026,20,19,357,396,
Rogers,Superintendent of Public Instruction,Larry Huff,IND,660026,3,11,101,115,
Rogers,Commissioner of Labor,Leslie Osborn,REP,660026,36,84,923,1043,
Rogers,Commissioner of Labor,Fred Dorrell,DEM,660026,14,19,276,309,
Rogers,Commissioner of Labor,Brandt Dismukes,IND,660026,1,5,53,59,
Rogers,Insurance Commissioner,Glen Mulready,REP,660026,29,90,950,1069,
Rogers,Insurance Commissioner,Kimberly Fobbs,DEM,660026,22,18,301,341,
Rogers,Corporation Commissioner,Bob Anthony,REP,660026,30,84,927,1041,
Rogers,Corporation Commissioner,Ashley Nicole Mccray,DEM,660026,21,20,268,309,
Rogers,Corporation Commissioner,Jackie Short,IND,660026,0,4,60,64,
Rogers,U.S. House,Richard Castaldo,LIB,660026,3,2,34,39,2
Rogers,U.S. House,Markwayne Mullin,REP,660026,30,83,943,1056,2
Rogers,U.S. House,Jason Nichols,DEM,660026,17,19,249,285,2
Rogers,U.S. House,John Foreman,IND,660026,1,4,42,47,2
Rogers,State House,Tom Gann,REP,660026,28,77,868,973,8
Rogers,State House,Darrell Moore,DEM,660026,23,31,398,452,8
Rogers,Governor,Chris Powell,LIB,660027,0,0,27,27,
Rogers,Governor,Kevin Stitt,REP,660027,8,18,393,419,
Rogers,Governor,Drew Edmondson,DEM,660027,7,15,162,184,
Rogers,Lieutenant Governor,Matt Pinnell,REP,660027,9,21,436,466,
Rogers,Lieutenant Governor,Anastasia Pittman,DEM,660027,6,10,123,139,
Rogers,Lieutenant Governor,Ivan Holmes,IND,660027,0,2,20,22,
Rogers,State Auditor,John Yeutter,LIB,660027,3,6,97,106,
Rogers,State Auditor,Cindy Byrd,REP,660027,11,22,456,489,
Rogers,Attorney General,Mike Hunter,REP,660027,9,20,431,460,
Rogers,Attorney General,Mark Myles,DEM,660027,6,13,142,161,
Rogers,State Treasurer,Randy Mcdaniel,REP,660027,11,20,453,484,
Rogers,State Treasurer,Charles De Coune,IND,660027,4,9,97,110,
Rogers,Superintendent of Public Instruction,Joy Hofmeister,REP,660027,7,20,355,382,
Rogers,Superintendent of Public Instruction,John Cox,DEM,660027,7,13,164,184,
Rogers,Superintendent of Public Instruction,Larry Huff,IND,660027,1,0,55,56,
Rogers,Commissioner of Labor,Leslie Osborn,REP,660027,9,21,404,434,
Rogers,Commissioner of Labor,Fred Dorrell,DEM,660027,6,12,134,152,
Rogers,Commissioner of Labor,Brandt Dismukes,IND,660027,0,0,32,32,
Rogers,Insurance Commissioner,Glen Mulready,REP,660027,9,21,426,456,
Rogers,Insurance Commissioner,Kimberly Fobbs,DEM,660027,6,12,144,162,
Rogers,Corporation Commissioner,Bob Anthony,REP,660027,7,19,404,430,
Rogers,Corporation Commissioner,Ashley Nicole Mccray,DEM,660027,7,12,143,162,
Rogers,Corporation Commissioner,Jackie Short,IND,660027,1,1,25,27,
Rogers,U.S. House,Richard Castaldo,LIB,660027,0,1,23,24,2
Rogers,U.S. House,Markwayne Mullin,REP,660027,8,21,416,445,2
Rogers,U.S. House,Jason Nichols,DEM,660027,7,11,124,142,2
Rogers,U.S. House,John Foreman,IND,660027,0,0,18,18,2
Rogers,State House,Tom Gann,REP,660027,7,17,393,417,8
Rogers,State House,Darrell Moore,DEM,660027,8,15,187,210,8
Rogers,Governor,Chris Powell,LIB,660029,1,0,18,19,
Rogers,Governor,Kevin Stitt,REP,660029,9,35,361,405,
Rogers,Governor,Drew Edmondson,DEM,660029,10,21,131,162,
Rogers,Lieutenant Governor,Matt Pinnell,REP,660029,12,40,387,439,
Rogers,Lieutenant Governor,Anastasia Pittman,DEM,660029,8,15,99,122,
Rogers,Lieutenant Governor,Ivan Holmes,IND,660029,0,1,21,22,
Rogers,State Auditor,John Yeutter,LIB,660029,7,15,85,107,
Rogers,State Auditor,Cindy Byrd,REP,660029,12,38,394,444,
Rogers,Attorney General,Mike Hunter,REP,660029,12,41,400,453,
Rogers,Attorney General,Mark Myles,DEM,660029,8,15,101,124,
Rogers,State Treasurer,Randy Mcdaniel,REP,660029,13,38,384,435,
Rogers,State Treasurer,Charles De Coune,IND,660029,6,13,97,116,
Rogers,Superintendent of Public Instruction,Joy Hofmeister,REP,660029,12,33,350,395,
Rogers,Superintendent of Public Instruction,John Cox,DEM,660029,8,16,105,129,
Rogers,Superintendent of Public Instruction,Larry Huff,IND,660029,0,6,50,56,
Rogers,Commissioner of Labor,Leslie Osborn,REP,660029,12,36,370,418,
Rogers,Commissioner of Labor,Fred Dorrell,DEM,660029,8,16,101,125,
Rogers,Commissioner of Labor,Brandt Dismukes,IND,660029,0,3,31,34,
Rogers,Insurance Commissioner,Glen Mulready,REP,660029,12,39,391,442,
Rogers,Insurance Commissioner,Kimberly Fobbs,DEM,660029,8,17,108,133,
Rogers,Corporation Commissioner,Bob Anthony,REP,660029,13,37,379,429,
Rogers,Corporation Commissioner,Ashley Nicole Mccray,DEM,660029,7,16,98,121,
Rogers,Corporation Commissioner,Jackie Short,IND,660029,0,3,26,29,
Rogers,U.S. House,Richard Castaldo,LIB,660029,1,0,11,12,2
Rogers,U.S. House,Markwayne Mullin,REP,660029,11,40,375,426,2
Rogers,U.S. House,Jason Nichols,DEM,660029,8,16,101,125,2
Rogers,U.S. House,John Foreman,IND,660029,0,0,20,20,2
Rogers,State Senate,Marty Quinn,REP,660029,12,36,356,404,2
Rogers,State Senate,Jennifer Esau,DEM,660029,8,20,148,176,2
Rogers,State House,Mark Lepak,REP,660029,12,37,383,432,9
Rogers,State House,Clay Layton,DEM,660029,8,18,118,144,9
Rogers,Governor,Chris Powell,LIB,660030,4,6,33,43,
Rogers,Governor,Kevin Stitt,REP,660030,59,208,1009,1276,
Rogers,Governor,Drew Edmondson,DEM,660030,38,91,370,499,
Rogers,Lieutenant Governor,Matt Pinnell,REP,660030,66,225,1096,1387,
Rogers,Lieutenant Governor,Anastasia Pittman,DEM,660030,31,72,263,366,
Rogers,Lieutenant Governor,Ivan Holmes,IND,660030,3,6,45,54,
Rogers,State Auditor,John Yeutter,LIB,660030,20,47,200,267,
Rogers,State Auditor,Cindy Byrd,REP,660030,74,244,1149,1467,
Rogers,Attorney General,Mike Hunter,REP,660030,68,232,1123,1423,
Rogers,Attorney General,Mark Myles,DEM,660030,31,71,276,378,
Rogers,State Treasurer,Randy Mcdaniel,REP,660030,66,236,1133,1435,
Rogers,State Treasurer,Charles De Coune,IND,660030,24,56,208,288,
Rogers,Superintendent of Public Instruction,Joy Hofmeister,REP,660030,72,205,1017,1294,
Rogers,Superintendent of Public Instruction,John Cox,DEM,660030,23,74,279,376,
Rogers,Superintendent of Public Instruction,Larry Huff,IND,660030,5,23,105,133,
Rogers,Commissioner of Labor,Leslie Osborn,REP,660030,68,222,1062,1352,
Rogers,Commissioner of Labor,Fred Dorrell,DEM,660030,29,66,254,349,
Rogers,Commissioner of Labor,Brandt Dismukes,IND,660030,3,10,68,81,
Rogers,Insurance Commissioner,Glen Mulready,REP,660030,65,222,1085,1372,
Rogers,Insurance Commissioner,Kimberly Fobbs,DEM,660030,32,76,298,406,
Rogers,Corporation Commissioner,Bob Anthony,REP,660030,64,222,1063,1349,
Rogers,Corporation Commissioner,Ashley Nicole Mccray,DEM,660030,28,66,265,359,
Rogers,Corporation Commissioner,Jackie Short,IND,660030,4,10,62,76,
Rogers,U.S. House,Richard Castaldo,LIB,660030,1,9,30,40,2
Rogers,U.S. House,Markwayne Mullin,REP,660030,62,204,1073,1339,2
Rogers,U.S. House,Jason Nichols,DEM,660030,32,74,253,359,2
Rogers,U.S. House,John Foreman,IND,660030,3,14,42,59,2
Rogers,State Senate,Marty Quinn,REP,660030,63,215,1072,1350,2
Rogers,State Senate,Jennifer Esau,DEM,660030,36,87,326,449,2
Rogers,Governor,Chris Powell,LIB,660031,2,8,34,44,
Rogers,Governor,Kevin Stitt,REP,660031,47,165,658,870,
Rogers,Governor,Drew Edmondson,DEM,660031,38,104,350,492,
Rogers,Lieutenant Governor,Matt Pinnell,REP,660031,46,188,737,971,
Rogers,Lieutenant Governor,Anastasia Pittman,DEM,660031,38,80,252,370,
Rogers,Lieutenant Governor,Ivan Holmes,IND,660031,2,8,41,51,
Rogers,State Auditor,John Yeutter,LIB,660031,18,45,192,255,
Rogers,State Auditor,Cindy Byrd,REP,660031,61,208,771,1040,
Rogers,Attorney General,Mike Hunter,REP,660031,54,189,731,974,
Rogers,Attorney General,Mark Myles,DEM,660031,33,84,290,407,
Rogers,State Treasurer,Randy Mcdaniel,REP,660031,55,188,735,978,
Rogers,State Treasurer,Charles De Coune,IND,660031,24,64,224,312,
Rogers,Superintendent of Public Instruction,Joy Hofmeister,REP,660031,50,181,660,891,
Rogers,Superintendent of Public Instruction,John Cox,DEM,660031,35,78,295,408,
Rogers,Superintendent of Public Instruction,Larry Huff,IND,660031,2,17,76,95,
Rogers,Commissioner of Labor,Leslie Osborn,REP,660031,53,185,695,933,
Rogers,Commissioner of Labor,Fred Dorrell,DEM,660031,31,82,257,370,
Rogers,Commissioner of Labor,Brandt Dismukes,IND,660031,1,4,58,63,
Rogers,Insurance Commissioner,Glen Mulready,REP,660031,48,185,736,969,
Rogers,Insurance Commissioner,Kimberly Fobbs,DEM,660031,38,86,278,402,
Rogers,Corporation Commissioner,Bob Anthony,REP,660031,49,179,695,923,
Rogers,Corporation Commissioner,Ashley Nicole Mccray,DEM,660031,34,82,262,378,
Rogers,Corporation Commissioner,Jackie Short,IND,660031,3,12,67,82,
Rogers,U.S. House,Kevin Hern,REP,660031,50,187,736,973,1
Rogers,U.S. House,Tim Gilpin,DEM,660031,37,89,292,418,1
Rogers,State Senate,Marty Quinn,REP,660031,47,177,699,923,2
Rogers,State Senate,Jennifer Esau,DEM,660031,39,97,321,457,2
Rogers,Governor,Chris Powell,LIB,660032,0,3,11,14,
Rogers,Governor,Kevin Stitt,REP,660032,37,81,349,467,
Rogers,Governor,Drew Edmondson,DEM,660032,21,35,150,206,
Rogers,Lieutenant Governor,Matt Pinnell,REP,660032,40,94,386,520,
Rogers,Lieutenant Governor,Anastasia Pittman,DEM,660032,16,23,115,154,
Rogers,Lieutenant Governor,Ivan Holmes,IND,660032,2,2,9,13,
Rogers,State Auditor,John Yeutter,LIB,660032,10,22,89,121,
Rogers,State Auditor,Cindy Byrd,REP,660032,46,92,393,531,
Rogers,Attorney General,Mike Hunter,REP,660032,40,90,389,519,
Rogers,Attorney General,Mark Myles,DEM,660032,18,27,119,164,
Rogers,State Treasurer,Randy Mcdaniel,REP,660032,44,87,373,504,
Rogers,State Treasurer,Charles De Coune,IND,660032,11,27,109,147,
Rogers,Superintendent of Public Instruction,Joy Hofmeister,REP,660032,34,74,335,443,
Rogers,Superintendent of Public Instruction,John Cox,DEM,660032,17,28,139,184,
Rogers,Superintendent of Public Instruction,Larry Huff,IND,660032,5,14,35,54,
Rogers,Commissioner of Labor,Leslie Osborn,REP,660032,40,85,368,493,
Rogers,Commissioner of Labor,Fred Dorrell,DEM,660032,16,25,115,156,
Rogers,Commissioner of Labor,Brandt Dismukes,IND,660032,2,5,21,28,
Rogers,Insurance Commissioner,Glen Mulready,REP,660032,40,90,370,500,
Rogers,Insurance Commissioner,Kimberly Fobbs,DEM,660032,18,27,134,179,
Rogers,Corporation Commissioner,Bob Anthony,REP,660032,39,91,351,481,
Rogers,Corporation Commissioner,Ashley Nicole Mccray,DEM,660032,18,20,129,167,
Rogers,Corporation Commissioner,Jackie Short,IND,660032,1,7,27,35,
Rogers,U.S. House,Richard Castaldo,LIB,660032,1,3,17,21,2
Rogers,U.S. House,Markwayne Mullin,REP,660032,38,83,370,491,2
Rogers,U.S. House,Jason Nichols,DEM,660032,14,29,107,150,2
Rogers,U.S. House,John Foreman,IND,660032,4,4,14,22,2
Rogers,State Senate,Marty Quinn,REP,660032,39,90,351,480,2
Rogers,State Senate,Jennifer Esau,DEM,660032,17,27,156,200,2
Rogers,State House,Mark Lepak,REP,660032,38,90,373,501,9
Rogers,State House,Clay Layton,DEM,660032,18,27,130,175,9
Rogers,Governor,Chris Powell,LIB,660033,0,0,9,9,
Rogers,Governor,Kevin Stitt,REP,660033,3,13,209,225,
Rogers,Governor,Drew Edmondson,DEM,660033,7,6,124,137,
Rogers,Lieutenant Governor,Matt Pinnell,REP,660033,4,13,244,261,
Rogers,Lieutenant Governor,Anastasia Pittman,DEM,660033,6,5,90,101,
Rogers,Lieutenant Governor,Ivan Holmes,IND,660033,0,1,8,9,
Rogers,State Auditor,John Yeutter,LIB,660033,2,4,62,68,
Rogers,State Auditor,Cindy Byrd,REP,660033,4,15,262,281,
Rogers,Attorney General,Mike Hunter,REP,660033,4,13,251,268,
Rogers,Attorney General,Mark Myles,DEM,660033,6,6,92,104,
Rogers,State Treasurer,Randy Mcdaniel,REP,660033,5,12,260,277,
Rogers,State Treasurer,Charles De Coune,IND,660033,2,6,66,74,
Rogers,Superintendent of Public Instruction,Joy Hofmeister,REP,660033,4,12,224,240,
Rogers,Superintendent of Public Instruction,John Cox,DEM,660033,6,5,93,104,
Rogers,Superintendent of Public Instruction,Larry Huff,IND,660033,0,2,27,29,
Rogers,Commissioner of Labor,Leslie Osborn,REP,660033,4,12,236,252,
Rogers,Commissioner of Labor,Fred Dorrell,DEM,660033,6,6,89,101,
Rogers,Commissioner of Labor,Brandt Dismukes,IND,660033,0,0,14,14,
Rogers,Insurance Commissioner,Glen Mulready,REP,660033,4,15,244,263,
Rogers,Insurance Commissioner,Kimberly Fobbs,DEM,660033,6,4,96,106,
Rogers,Corporation Commissioner,Bob Anthony,REP,660033,3,15,240,258,
Rogers,Corporation Commissioner,Ashley Nicole Mccray,DEM,660033,7,4,84,95,
Rogers,Corporation Commissioner,Jackie Short,IND,660033,0,0,17,17,
Rogers,U.S. House,Richard Castaldo,LIB,660033,0,0,3,3,2
Rogers,U.S. House,Markwayne Mullin,REP,660033,4,13,236,253,2
Rogers,U.S. House,Jason Nichols,DEM,660033,6,5,81,92,2
Rogers,U.S. House,John Foreman,IND,660033,0,1,21,22,2
Rogers,State Senate,Marty Quinn,REP,660033,4,13,238,255,2
Rogers,State Senate,Jennifer Esau,DEM,660033,6,6,103,115,2
Rogers,State House,Rusty Cornwell,REP,660033,4,13,228,245,6
Rogers,State House,John Myers,DEM,660033,6,6,113,125,6
Rogers,Governor,Chris Powell,LIB,660110,0,0,25,25,
Rogers,Governor,Kevin Stitt,REP,660110,19,71,464,554,
Rogers,Governor,Drew Edmondson,DEM,660110,15,42,237,294,
Rogers,Lieutenant Governor,Matt Pinnell,REP,660110,21,73,526,620,
Rogers,Lieutenant Governor,Anastasia Pittman,DEM,660110,13,37,172,222,
Rogers,Lieutenant Governor,Ivan Holmes,IND,660110,0,2,22,24,
Rogers,State Auditor,John Yeutter,LIB,660110,7,12,125,144,
Rogers,State Auditor,Cindy Byrd,REP,660110,20,92,557,669,
Rogers,Attorney General,Mike Hunter,REP,660110,21,76,536,633,
Rogers,Attorney General,Mark Myles,DEM,660110,12,37,176,225,
Rogers,State Treasurer,Randy Mcdaniel,REP,660110,20,86,541,647,
Rogers,State Treasurer,Charles De Coune,IND,660110,8,18,140,166,
Rogers,Superintendent of Public Instruction,Joy Hofmeister,REP,660110,21,77,465,563,
Rogers,Superintendent of Public Instruction,John Cox,DEM,660110,13,29,199,241,
Rogers,Superintendent of Public Instruction,Larry Huff,IND,660110,0,6,50,56,
Rogers,Commissioner of Labor,Leslie Osborn,REP,660110,19,78,499,596,
Rogers,Commissioner of Labor,Fred Dorrell,DEM,660110,12,33,165,210,
Rogers,Commissioner of Labor,Brandt Dismukes,IND,660110,0,1,39,40,
Rogers,Insurance Commissioner,Glen Mulready,REP,660110,22,77,527,626,
Rogers,Insurance Commissioner,Kimberly Fobbs,DEM,660110,11,35,178,224,
Rogers,Corporation Commissioner,Bob Anthony,REP,660110,21,73,505,599,
Rogers,Corporation Commissioner,Ashley Nicole Mccray,DEM,660110,12,32,161,205,
Rogers,Corporation Commissioner,Jackie Short,IND,660110,0,5,41,46,
Rogers,U.S. House,Richard Castaldo,LIB,660110,0,0,19,19,2
Rogers,U.S. House,Markwayne Mullin,REP,660110,19,75,514,608,2
Rogers,U.S. House,Jason Nichols,DEM,660110,15,35,166,216,2
Rogers,U.S. House,John Foreman,IND,660110,0,3,20,23,2
Rogers,State Senate,Marty Quinn,REP,660110,18,61,450,529,2
Rogers,State Senate,Jennifer Esau,DEM,660110,16,52,269,337,2
Rogers,State House,Terry O'Donnell,REP,660110,21,74,507,602,23
Rogers,State House,Craig John Hoxie,DEM,660110,12,39,206,257,23
Rogers,Governor,Chris Powell,LIB,660116,0,0,24,24,
Rogers,Governor,Kevin Stitt,REP,660116,14,29,417,460,
Rogers,Governor,Drew Edmondson,DEM,660116,5,12,165,182,
Rogers,Lieutenant Governor,Matt Pinnell,REP,660116,13,27,460,500,
Rogers,Lieutenant Governor,Anastasia Pittman,DEM,660116,5,12,127,144,
Rogers,Lieutenant Governor,Ivan Holmes,IND,660116,1,2,16,19,
Rogers,State Auditor,John Yeutter,LIB,660116,5,8,104,117,
Rogers,State Auditor,Cindy Byrd,REP,660116,14,31,469,514,
Rogers,Attorney General,Mike Hunter,REP,660116,16,30,472,518,
Rogers,Attorney General,Mark Myles,DEM,660116,3,11,129,143,
Rogers,State Treasurer,Randy Mcdaniel,REP,660116,15,31,464,510,
Rogers,State Treasurer,Charles De Coune,IND,660116,4,8,104,116,
Rogers,Superintendent of Public Instruction,Joy Hofmeister,REP,660116,13,27,387,427,
Rogers,Superintendent of Public Instruction,John Cox,DEM,660116,5,8,160,173,
Rogers,Superintendent of Public Instruction,Larry Huff,IND,660116,1,6,54,61,
Rogers,Commissioner of Labor,Leslie Osborn,REP,660116,15,29,434,478,
Rogers,Commissioner of Labor,Fred Dorrell,DEM,660116,3,11,129,143,
Rogers,Commissioner of Labor,Brandt Dismukes,IND,660116,1,1,30,32,
Rogers,Insurance Commissioner,Glen Mulready,REP,660116,16,30,449,495,
Rogers,Insurance Commissioner,Kimberly Fobbs,DEM,660116,3,11,146,160,
Rogers,Corporation Commissioner,Bob Anthony,REP,660116,14,28,431,473,
Rogers,Corporation Commissioner,Ashley Nicole Mccray,DEM,660116,3,11,127,141,
Rogers,Corporation Commissioner,Jackie Short,IND,660116,2,2,35,39,
Rogers,U.S. House,Richard Castaldo,LIB,660116,0,0,28,28,2
Rogers,U.S. House,Markwayne Mullin,REP,660116,14,30,422,466,2
Rogers,U.S. House,Jason Nichols,DEM,660116,5,10,126,141,2
Rogers,U.S. House,John Foreman,IND,660116,0,1,28,29,2
Rogers,State House,Rusty Cornwell,REP,660116,12,28,425,465,6
Rogers,State House,John Myers,DEM,660116,7,13,176,196,6
Rogers,Governor,Chris Powell,LIB,660120,0,3,25,28,
Rogers,Governor,Kevin Stitt,REP,660120,28,65,506,599,
Rogers,Governor,Drew Edmondson,DEM,660120,14,40,196,250,
Rogers,Lieutenant Governor,Matt Pinnell,REP,660120,30,84,564,678,
Rogers,Lieutenant Governor,Anastasia Pittman,DEM,660120,9,21,137,167,
Rogers,Lieutenant Governor,Ivan Holmes,IND,660120,2,2,21,25,
Rogers,State Auditor,John Yeutter,LIB,660120,11,13,110,134,
Rogers,State Auditor,Cindy Byrd,REP,660120,31,87,578,696,
Rogers,Attorney General,Mike Hunter,REP,660120,29,81,566,676,
Rogers,Attorney General,Mark Myles,DEM,660120,13,27,153,193,
Rogers,State Treasurer,Randy Mcdaniel,REP,660120,29,89,573,691,
Rogers,State Treasurer,Charles De Coune,IND,660120,13,8,115,136,
Rogers,Superintendent of Public Instruction,Joy Hofmeister,REP,660120,28,75,516,619,
Rogers,Superintendent of Public Instruction,John Cox,DEM,660120,11,24,152,187,
Rogers,Superintendent of Public Instruction,Larry Huff,IND,660120,3,9,51,63,
Rogers,Commissioner of Labor,Leslie Osborn,REP,660120,30,77,540,647,
Rogers,Commissioner of Labor,Fred Dorrell,DEM,660120,12,24,144,180,
Rogers,Commissioner of Labor,Brandt Dismukes,IND,660120,0,5,31,36,
Rogers,Insurance Commissioner,Glen Mulready,REP,660120,29,77,556,662,
Rogers,Insurance Commissioner,Kimberly Fobbs,DEM,660120,13,28,153,194,
Rogers,Corporation Commissioner,Bob Anthony,REP,660120,28,81,541,650,
Rogers,Corporation Commissioner,Ashley Nicole Mccray,DEM,660120,13,19,137,169,
Rogers,Corporation Commissioner,Jackie Short,IND,660120,1,7,38,46,
Rogers,U.S. House,Richard Castaldo,LIB,660120,1,2,19,22,2
Rogers,U.S. House,Markwayne Mullin,REP,660120,27,72,531,630,2
Rogers,U.S. House,Jason Nichols,DEM,660120,12,28,144,184,2
Rogers,U.S. House,John Foreman,IND,660120,2,5,29,36,2
Rogers,State Senate,Marty Quinn,REP,660120,25,64,500,589,2
Rogers,State Senate,Jennifer Esau,DEM,660120,17,43,226,286,2
Rogers,State House,Mark Lepak,REP,660120,30,77,558,665,9
Rogers,State House,Clay Layton,DEM,660120,12,29,163,204,9
Rogers,Governor,Chris Powell,LIB,660128,2,3,15,20,
Rogers,Governor,Kevin Stitt,REP,660128,8,25,391,424,
Rogers,Governor,Drew Edmondson,DEM,660128,9,6,181,196,
Rogers,Lieutenant Governor,Matt Pinnell,REP,660128,10,26,439,475,
Rogers,Lieutenant Governor,Anastasia Pittman,DEM,660128,9,5,131,145,
Rogers,Lieutenant Governor,Ivan Holmes,IND,660128,0,2,13,15,
Rogers,State Auditor,John Yeutter,LIB,660128,5,7,90,102,
Rogers,State Auditor,Cindy Byrd,REP,660128,12,25,461,498,
Rogers,Attorney General,Mike Hunter,REP,660128,10,27,436,473,
Rogers,Attorney General,Mark Myles,DEM,660128,9,7,145,161,
Rogers,State Treasurer,Randy Mcdaniel,REP,660128,11,28,446,485,
Rogers,State Treasurer,Charles De Coune,IND,660128,7,5,106,118,
Rogers,Superintendent of Public Instruction,Joy Hofmeister,REP,660128,9,19,385,413,
Rogers,Superintendent of Public Instruction,John Cox,DEM,660128,10,7,146,163,
Rogers,Superintendent of Public Instruction,Larry Huff,IND,660128,0,7,49,56,
Rogers,Commissioner of Labor,Leslie Osborn,REP,660128,9,24,401,434,
Rogers,Commissioner of Labor,Fred Dorrell,DEM,660128,10,7,149,166,
Rogers,Commissioner of Labor,Brandt Dismukes,IND,660128,0,2,21,23,
Rogers,Insurance Commissioner,Glen Mulready,REP,660128,11,27,427,465,
Rogers,Insurance Commissioner,Kimberly Fobbs,DEM,660128,8,6,149,163,
Rogers,Corporation Commissioner,Bob Anthony,REP,660128,11,27,417,455,
Rogers,Corporation Commissioner,Ashley Nicole Mccray,DEM,660128,7,5,139,151,
Rogers,Corporation Commissioner,Jackie Short,IND,660128,1,1,19,21,
Rogers,U.S. House,Richard Castaldo,LIB,660128,0,0,11,11,2
Rogers,U.S. House,Markwayne Mullin,REP,660128,9,26,424,459,2
Rogers,U.S. House,Jason Nichols,DEM,660128,10,6,131,147,2
Rogers,U.S. House,John Foreman,IND,660128,0,1,16,17,2
Rogers,State Senate,Marty Quinn,REP,660128,11,26,400,437,2
Rogers,State Senate,Jennifer Esau,DEM,660128,8,6,184,198,2
Rogers,State House,Terry O'Donnell,REP,660128,10,27,427,464,23
Rogers,State House,Craig John Hoxie,DEM,660128,9,6,157,172,23
Rogers,Governor,Chris Powell,LIB,660130,0,12,47,59,
Rogers,Governor,Kevin Stitt,REP,660130,69,339,958,1366,
Rogers,Governor,Drew Edmondson,DEM,660130,67,202,399,668,
Rogers,Lieutenant Governor,Matt Pinnell,REP,660130,83,382,1053,1518,
Rogers,Lieutenant Governor,Anastasia Pittman,DEM,660130,51,160,299,510,
Rogers,Lieutenant Governor,Ivan Holmes,IND,660130,2,8,44,54,
Rogers,State Auditor,John Yeutter,LIB,660130,27,93,249,369,
Rogers,State Auditor,Cindy Byrd,REP,660130,101,409,1087,1597,
Rogers,Attorney General,Mike Hunter,REP,660130,86,379,1073,1538,
Rogers,Attorney General,Mark Myles,DEM,660130,48,167,316,531,
Rogers,State Treasurer,Randy Mcdaniel,REP,660130,87,393,1058,1538,
Rogers,State Treasurer,Charles De Coune,IND,660130,38,108,271,417,
Rogers,Superintendent of Public Instruction,Joy Hofmeister,REP,660130,78,355,951,1384,
Rogers,Superintendent of Public Instruction,John Cox,DEM,660130,48,170,335,553,
Rogers,Superintendent of Public Instruction,Larry Huff,IND,660130,9,25,108,142,
Rogers,Commissioner of Labor,Leslie Osborn,REP,660130,86,374,1018,1478,
Rogers,Commissioner of Labor,Fred Dorrell,DEM,660130,44,157,298,499,
Rogers,Commissioner of Labor,Brandt Dismukes,IND,660130,6,14,57,77,
Rogers,Insurance Commissioner,Glen Mulready,REP,660130,74,382,1036,1492,
Rogers,Insurance Commissioner,Kimberly Fobbs,DEM,660130,60,164,342,566,
Rogers,Corporation Commissioner,Bob Anthony,REP,660130,72,369,1003,1444,
Rogers,Corporation Commissioner,Ashley Nicole Mccray,DEM,660130,58,156,290,504,
Rogers,Corporation Commissioner,Jackie Short,IND,660130,6,20,86,112,
Rogers,U.S. House,Kevin Hern,REP,660130,81,369,1066,1516,1
Rogers,U.S. House,Tim Gilpin,DEM,660130,55,183,332,570,1
Rogers,State Senate,Marty Quinn,REP,660130,74,360,1001,1435,2
Rogers,State Senate,Jennifer Esau,DEM,660130,61,188,387,636,2
Seminole,Governor,Chris Powell,LIB,670010,0,2,25,27,
Seminole,Governor,Kevin Stitt,REP,670010,10,20,324,354,
Seminole,Governor,Drew Edmondson,DEM,670010,19,17,335,371,
Seminole,Lieutenant Governor,Matt Pinnell,REP,670010,10,22,385,417,
Seminole,Lieutenant Governor,Anastasia Pittman,DEM,670010,17,12,264,293,
Seminole,Lieutenant Governor,Ivan Holmes,IND,670010,2,4,30,36,
Seminole,State Auditor,John Yeutter,LIB,670010,14,7,189,210,
Seminole,State Auditor,Cindy Byrd,REP,670010,13,29,470,512,
Seminole,Attorney General,Mike Hunter,REP,670010,7,23,411,441,
Seminole,Attorney General,Mark Myles,DEM,670010,21,15,267,303,
Seminole,State Treasurer,Randy Mcdaniel,REP,670010,14,28,435,477,
Seminole,State Treasurer,Charles De Coune,IND,670010,14,8,219,241,
Seminole,Superintendent of Public Instruction,Joy Hofmeister,REP,670010,8,18,362,388,
Seminole,Superintendent of Public Instruction,John Cox,DEM,670010,19,19,264,302,
Seminole,Superintendent of Public Instruction,Larry Huff,IND,670010,2,1,52,55,
Seminole,Commissioner of Labor,Leslie Osborn,REP,670010,15,20,387,422,
Seminole,Commissioner of Labor,Fred Dorrell,DEM,670010,14,16,260,290,
Seminole,Commissioner of Labor,Brandt Dismukes,IND,670010,0,1,29,30,
Seminole,Insurance Commissioner,Glen Mulready,REP,670010,12,18,373,403,
Seminole,Insurance Commissioner,Kimberly Fobbs,DEM,670010,17,18,301,336,
Seminole,Corporation Commissioner,Bob Anthony,REP,670010,12,21,381,414,
Seminole,Corporation Commissioner,Ashley Nicole Mccray,DEM,670010,16,16,263,295,
Seminole,Corporation Commissioner,Jackie Short,IND,670010,1,1,34,36,
Seminole,U.S. House,Steve Russell,REP,670010,11,21,356,388,5
Seminole,U.S. House,Kendra Horn,DEM,670010,18,17,323,358,5
Seminole,State Senate,Jason Smalley,REP,670010,13,24,406,443,28
Seminole,State Senate,Stephanie Sanders,IND,670010,13,13,257,283,28
Seminole,State House,Zack Taylor,REP,670010,11,15,364,390,28
Seminole,State House,Steve Barnes,DEM,670010,16,22,286,324,28
Seminole,State House,Kyle Webb,IND,670010,2,2,29,33,28
Seminole,Governor,Chris Powell,LIB,670012,1,0,4,5,
Seminole,Governor,Kevin Stitt,REP,670012,5,3,57,65,
Seminole,Governor,Drew Edmondson,DEM,670012,2,0,31,33,
Seminole,Lieutenant Governor,Matt Pinnell,REP,670012,6,2,62,70,
Seminole,Lieutenant Governor,Anastasia Pittman,DEM,670012,2,1,25,28,
Seminole,Lieutenant Governor,Ivan Holmes,IND,670012,0,0,2,2,
Seminole,State Auditor,John Yeutter,LIB,670012,2,0,10,12,
Seminole,State Auditor,Cindy Byrd,REP,670012,6,3,77,86,
Seminole,Attorney General,Mike Hunter,REP,670012,5,3,63,71,
Seminole,Attorney General,Mark Myles,DEM,670012,3,0,29,32,
Seminole,State Treasurer,Randy Mcdaniel,REP,670012,4,2,64,70,
Seminole,State Treasurer,Charles De Coune,IND,670012,3,1,19,23,
Seminole,Superintendent of Public Instruction,Joy Hofmeister,REP,670012,6,3,45,54,
Seminole,Superintendent of Public Instruction,John Cox,DEM,670012,2,0,31,33,
Seminole,Superintendent of Public Instruction,Larry Huff,IND,670012,0,0,15,15,
Seminole,Commissioner of Labor,Leslie Osborn,REP,670012,5,2,53,60,
Seminole,Commissioner of Labor,Fred Dorrell,DEM,670012,3,0,24,27,
Seminole,Commissioner of Labor,Brandt Dismukes,IND,670012,0,1,10,11,
Seminole,Insurance Commissioner,Glen Mulready,REP,670012,6,2,55,63,
Seminole,Insurance Commissioner,Kimberly Fobbs,DEM,670012,2,1,34,37,
Seminole,Corporation Commissioner,Bob Anthony,REP,670012,6,2,61,69,
Seminole,Corporation Commissioner,Ashley Nicole Mccray,DEM,670012,2,1,25,28,
Seminole,Corporation Commissioner,Jackie Short,IND,670012,0,0,4,4,
Seminole,U.S. House,Steve Russell,REP,670012,6,2,45,53,5
Seminole,U.S. House,Kendra Horn,DEM,670012,2,1,42,45,5
Seminole,State House,Zack Taylor,REP,670012,6,2,54,62,28
Seminole,State House,Steve Barnes,DEM,670012,2,1,34,37,28
Seminole,State House,Kyle Webb,IND,670012,0,0,3,3,28
Seminole,Governor,Chris Powell,LIB,670014,0,0,26,26,
Seminole,Governor,Kevin Stitt,REP,670014,15,12,410,437,
Seminole,Governor,Drew Edmondson,DEM,670014,19,6,212,237,
Seminole,Lieutenant Governor,Matt Pinnell,REP,670014,17,13,443,473,
Seminole,Lieutenant Governor,Anastasia Pittman,DEM,670014,16,5,183,204,
Seminole,Lieutenant Governor,Ivan Holmes,IND,670014,0,0,20,20,
Seminole,State Auditor,John Yeutter,LIB,670014,8,4,118,130,
Seminole,State Auditor,Cindy Byrd,REP,670014,23,12,494,529,
Seminole,Attorney General,Mike Hunter,REP,670014,18,12,471,501,
Seminole,Attorney General,Mark Myles,DEM,670014,15,6,170,191,
Seminole,State Treasurer,Randy Mcdaniel,REP,670014,24,12,492,528,
Seminole,State Treasurer,Charles De Coune,IND,670014,6,4,119,129,
Seminole,Superintendent of Public Instruction,Joy Hofmeister,REP,670014,16,10,417,443,
Seminole,Superintendent of Public Instruction,John Cox,DEM,670014,15,6,175,196,
Seminole,Superintendent of Public Instruction,Larry Huff,IND,670014,3,2,52,57,
Seminole,Commissioner of Labor,Leslie Osborn,REP,670014,17,11,440,468,
Seminole,Commissioner of Labor,Fred Dorrell,DEM,670014,15,6,171,192,
Seminole,Commissioner of Labor,Brandt Dismukes,IND,670014,1,1,23,25,
Seminole,Insurance Commissioner,Glen Mulready,REP,670014,16,10,433,459,
Seminole,Insurance Commissioner,Kimberly Fobbs,DEM,670014,17,7,205,229,
Seminole,Corporation Commissioner,Bob Anthony,REP,670014,16,12,437,465,
Seminole,Corporation Commissioner,Ashley Nicole Mccray,DEM,670014,18,5,168,191,
Seminole,Corporation Commissioner,Jackie Short,IND,670014,0,1,33,34,
Seminole,U.S. House,Steve Russell,REP,670014,18,13,426,457,5
Seminole,U.S. House,Kendra Horn,DEM,670014,16,5,221,242,5
Seminole,State House,Zack Taylor,REP,670014,17,12,413,442,28
Seminole,State House,Steve Barnes,DEM,670014,16,6,211,233,28
Seminole,State House,Kyle Webb,IND,670014,0,0,21,21,28
Seminole,Governor,Chris Powell,LIB,670015,1,0,14,15,
Seminole,Governor,Kevin Stitt,REP,670015,8,17,199,224,
Seminole,Governor,Drew Edmondson,DEM,670015,7,10,90,107,
Seminole,Lieutenant Governor,Matt Pinnell,REP,670015,12,21,209,242,
Seminole,Lieutenant Governor,Anastasia Pittman,DEM,670015,4,5,79,88,
Seminole,Lieutenant Governor,Ivan Holmes,IND,670015,0,1,14,15,
Seminole,State Auditor,John Yeutter,LIB,670015,0,2,63,65,
Seminole,State Auditor,Cindy Byrd,REP,670015,14,25,232,271,
Seminole,Attorney General,Mike Hunter,REP,670015,13,23,208,244,
Seminole,Attorney General,Mark Myles,DEM,670015,3,4,93,100,
Seminole,State Treasurer,Randy Mcdaniel,REP,670015,14,24,231,269,
Seminole,State Treasurer,Charles De Coune,IND,670015,0,3,60,63,
Seminole,Superintendent of Public Instruction,Joy Hofmeister,REP,670015,11,21,198,230,
Seminole,Superintendent of Public Instruction,John Cox,DEM,670015,5,6,75,86,
Seminole,Superintendent of Public Instruction,Larry Huff,IND,670015,0,0,27,27,
Seminole,Commissioner of Labor,Leslie Osborn,REP,670015,13,22,196,231,
Seminole,Commissioner of Labor,Fred Dorrell,DEM,670015,3,5,84,92,
Seminole,Commissioner of Labor,Brandt Dismukes,IND,670015,0,0,18,18,
Seminole,Insurance Commissioner,Glen Mulready,REP,670015,13,21,204,238,
Seminole,Insurance Commissioner,Kimberly Fobbs,DEM,670015,3,6,94,103,
Seminole,Corporation Commissioner,Bob Anthony,REP,670015,14,21,191,226,
Seminole,Corporation Commissioner,Ashley Nicole Mccray,DEM,670015,2,6,83,91,
Seminole,Corporation Commissioner,Jackie Short,IND,670015,0,0,22,22,
Seminole,U.S. House,Steve Russell,REP,670015,11,21,193,225,5
Seminole,U.S. House,Kendra Horn,DEM,670015,5,6,104,115,5
Seminole,State House,Zack Taylor,REP,670015,11,21,172,204,28
Seminole,State House,Steve Barnes,DEM,670015,5,6,122,133,28
Seminole,State House,Kyle Webb,IND,670015,0,0,9,9,28
Seminole,Governor,Chris Powell,LIB,670020,0,1,24,25,
Seminole,Governor,Kevin Stitt,REP,670020,12,12,356,380,
Seminole,Governor,Drew Edmondson,DEM,670020,4,3,189,196,
Seminole,Lieutenant Governor,Matt Pinnell,REP,670020,12,13,408,433,
Seminole,Lieutenant Governor,Anastasia Pittman,DEM,670020,4,1,139,144,
Seminole,Lieutenant Governor,Ivan Holmes,IND,670020,0,1,20,21,
Seminole,State Auditor,John Yeutter,LIB,670020,3,2,84,89,
Seminole,State Auditor,Cindy Byrd,REP,670020,13,14,463,490,
Seminole,Attorney General,Mike Hunter,REP,670020,13,13,435,461,
Seminole,Attorney General,Mark Myles,DEM,670020,3,1,127,131,
Seminole,State Treasurer,Randy Mcdaniel,REP,670020,13,11,450,474,
Seminole,State Treasurer,Charles De Coune,IND,670020,2,4,92,98,
Seminole,Superintendent of Public Instruction,Joy Hofmeister,REP,670020,9,11,368,388,
Seminole,Superintendent of Public Instruction,John Cox,DEM,670020,3,1,133,137,
Seminole,Superintendent of Public Instruction,Larry Huff,IND,670020,4,3,65,72,
Seminole,Commissioner of Labor,Leslie Osborn,REP,670020,12,14,401,427,
Seminole,Commissioner of Labor,Fred Dorrell,DEM,670020,3,0,132,135,
Seminole,Commissioner of Labor,Brandt Dismukes,IND,670020,1,1,29,31,
Seminole,Insurance Commissioner,Glen Mulready,REP,670020,12,11,396,419,
Seminole,Insurance Commissioner,Kimberly Fobbs,DEM,670020,4,3,166,173,
Seminole,Corporation Commissioner,Bob Anthony,REP,670020,11,13,388,412,
Seminole,Corporation Commissioner,Ashley Nicole Mccray,DEM,670020,3,2,142,147,
Seminole,Corporation Commissioner,Jackie Short,IND,670020,2,0,37,39,
Seminole,U.S. House,Steve Russell,REP,670020,13,13,393,419,5
Seminole,U.S. House,Kendra Horn,DEM,670020,3,3,172,178,5
Seminole,State Senate,Jason Smalley,REP,670020,12,12,415,439,28
Seminole,State Senate,Stephanie Sanders,IND,670020,4,3,132,139,28
Seminole,State House,Zack Taylor,REP,670020,13,12,398,423,28
Seminole,State House,Steve Barnes,DEM,670020,3,3,146,152,28
Seminole,State House,Kyle Webb,IND,670020,0,1,25,26,28
Seminole,Governor,Chris Powell,LIB,670022,4,3,19,26,
Seminole,Governor,Kevin Stitt,REP,670022,17,11,288,316,
Seminole,Governor,Drew Edmondson,DEM,670022,14,17,252,283,
Seminole,Lieutenant Governor,Matt Pinnell,REP,670022,18,14,352,384,
Seminole,Lieutenant Governor,Anastasia Pittman,DEM,670022,11,15,196,222,
Seminole,Lieutenant Governor,Ivan Holmes,IND,670022,6,1,7,14,
Seminole,State Auditor,John Yeutter,LIB,670022,12,9,110,131,
Seminole,State Auditor,Cindy Byrd,REP,670022,20,20,415,455,
Seminole,Attorney General,Mike Hunter,REP,670022,19,17,380,416,
Seminole,Attorney General,Mark Myles,DEM,670022,16,13,174,203,
Seminole,State Treasurer,Randy Mcdaniel,REP,670022,18,19,405,442,
Seminole,State Treasurer,Charles De Coune,IND,670022,14,9,120,143,
Seminole,Superintendent of Public Instruction,Joy Hofmeister,REP,670022,18,17,335,370,
Seminole,Superintendent of Public Instruction,John Cox,DEM,670022,12,10,184,206,
Seminole,Superintendent of Public Instruction,Larry Huff,IND,670022,5,3,35,43,
Seminole,Commissioner of Labor,Leslie Osborn,REP,670022,19,15,383,417,
Seminole,Commissioner of Labor,Fred Dorrell,DEM,670022,11,14,151,176,
Seminole,Commissioner of Labor,Brandt Dismukes,IND,670022,5,1,14,20,
Seminole,Insurance Commissioner,Glen Mulready,REP,670022,20,15,343,378,
Seminole,Insurance Commissioner,Kimberly Fobbs,DEM,670022,14,15,209,238,
Seminole,Corporation Commissioner,Bob Anthony,REP,670022,18,15,350,383,
Seminole,Corporation Commissioner,Ashley Nicole Mccray,DEM,670022,13,13,182,208,
Seminole,Corporation Commissioner,Jackie Short,IND,670022,4,2,21,27,
Seminole,U.S. House,Steve Russell,REP,670022,21,16,337,374,5
Seminole,U.S. House,Kendra Horn,DEM,670022,14,14,222,250,5
Seminole,State Senate,Jason Smalley,REP,670022,20,16,381,417,28
Seminole,State Senate,Stephanie Sanders,IND,670022,12,11,147,170,28
Seminole,State House,Zack Taylor,REP,670022,18,15,339,372,28
Seminole,State House,Steve Barnes,DEM,670022,13,13,201,227,28
Seminole,State House,Kyle Webb,IND,670022,4,2,18,24,28
Seminole,Governor,Chris Powell,LIB,670023,1,3,20,24,
Seminole,Governor,Kevin Stitt,REP,670023,18,34,371,423,
Seminole,Governor,Drew Edmondson,DEM,670023,13,38,283,334,
Seminole,Lieutenant Governor,Matt Pinnell,REP,670023,19,39,431,489,
Seminole,Lieutenant Governor,Anastasia Pittman,DEM,670023,13,34,218,265,
Seminole,Lieutenant Governor,Ivan Holmes,IND,670023,0,0,21,21,
Seminole,State Auditor,John Yeutter,LIB,670023,6,16,142,164,
Seminole,State Auditor,Cindy Byrd,REP,670023,22,50,492,564,
Seminole,Attorney General,Mike Hunter,REP,670023,20,45,452,517,
Seminole,Attorney General,Mark Myles,DEM,670023,12,27,211,250,
Seminole,State Treasurer,Randy Mcdaniel,REP,670023,24,45,487,556,
Seminole,State Treasurer,Charles De Coune,IND,670023,4,21,145,170,
Seminole,Superintendent of Public Instruction,Joy Hofmeister,REP,670023,18,41,404,463,
Seminole,Superintendent of Public Instruction,John Cox,DEM,670023,12,30,209,251,
Seminole,Superintendent of Public Instruction,Larry Huff,IND,670023,3,2,57,62,
Seminole,Commissioner of Labor,Leslie Osborn,REP,670023,22,43,432,497,
Seminole,Commissioner of Labor,Fred Dorrell,DEM,670023,8,26,200,234,
Seminole,Commissioner of Labor,Brandt Dismukes,IND,670023,2,3,30,35,
Seminole,Insurance Commissioner,Glen Mulready,REP,670023,17,39,429,485,
Seminole,Insurance Commissioner,Kimberly Fobbs,DEM,670023,13,34,238,285,
Seminole,Corporation Commissioner,Bob Anthony,REP,670023,18,44,420,482,
Seminole,Corporation Commissioner,Ashley Nicole Mccray,DEM,670023,11,27,208,246,
Seminole,Corporation Commissioner,Jackie Short,IND,670023,3,2,36,41,
Seminole,U.S. House,Steve Russell,REP,670023,18,37,400,455,5
Seminole,U.S. House,Kendra Horn,DEM,670023,14,36,270,320,5
Seminole,State Senate,Jason Smalley,REP,670023,21,43,454,518,28
Seminole,State Senate,Stephanie Sanders,IND,670023,9,25,187,221,28
Seminole,State House,Zack Taylor,REP,670023,19,37,394,450,28
Seminole,State House,Steve Barnes,DEM,670023,13,36,254,303,28
Seminole,State House,Kyle Webb,IND,670023,0,1,23,24,28
Seminole,Governor,Chris Powell,LIB,670024,2,1,32,35,
Seminole,Governor,Kevin Stitt,REP,670024,9,14,260,283,
Seminole,Governor,Drew Edmondson,DEM,670024,5,5,163,173,
Seminole,Lieutenant Governor,Matt Pinnell,REP,670024,10,14,297,321,
Seminole,Lieutenant Governor,Anastasia Pittman,DEM,670024,6,4,132,142,
Seminole,Lieutenant Governor,Ivan Holmes,IND,670024,0,2,24,26,
Seminole,State Auditor,John Yeutter,LIB,670024,4,4,97,105,
Seminole,State Auditor,Cindy Byrd,REP,670024,10,16,333,359,
Seminole,Attorney General,Mike Hunter,REP,670024,10,16,311,337,
Seminole,Attorney General,Mark Myles,DEM,670024,6,4,141,151,
Seminole,State Treasurer,Randy Mcdaniel,REP,670024,10,16,323,349,
Seminole,State Treasurer,Charles De Coune,IND,670024,4,4,104,112,
Seminole,Superintendent of Public Instruction,Joy Hofmeister,REP,670024,7,10,259,276,
Seminole,Superintendent of Public Instruction,John Cox,DEM,670024,6,8,149,163,
Seminole,Superintendent of Public Instruction,Larry Huff,IND,670024,3,2,43,48,
Seminole,Commissioner of Labor,Leslie Osborn,REP,670024,10,13,297,320,
Seminole,Commissioner of Labor,Fred Dorrell,DEM,670024,5,6,127,138,
Seminole,Commissioner of Labor,Brandt Dismukes,IND,670024,0,1,27,28,
Seminole,Insurance Commissioner,Glen Mulready,REP,670024,9,14,290,313,
Seminole,Insurance Commissioner,Kimberly Fobbs,DEM,670024,7,6,159,172,
Seminole,Corporation Commissioner,Bob Anthony,REP,670024,10,14,288,312,
Seminole,Corporation Commissioner,Ashley Nicole Mccray,DEM,670024,6,4,137,147,
Seminole,Corporation Commissioner,Jackie Short,IND,670024,0,2,30,32,
Seminole,U.S. House,Steve Russell,REP,670024,10,13,258,281,5
Seminole,U.S. House,Kendra Horn,DEM,670024,6,7,193,206,5
Seminole,State Senate,Jason Smalley,REP,670024,10,15,308,333,28
Seminole,State Senate,Stephanie Sanders,IND,670024,3,5,124,132,28
Seminole,State House,Zack Taylor,REP,670024,9,13,264,286,28
Seminole,State House,Steve Barnes,DEM,670024,7,5,167,179,28
Seminole,State House,Kyle Webb,IND,670024,0,2,25,27,28
Seminole,Governor,Chris Powell,LIB,670025,0,0,13,13,
Seminole,Governor,Kevin Stitt,REP,670025,7,5,70,82,
Seminole,Governor,Drew Edmondson,DEM,670025,1,1,36,38,
Seminole,Lieutenant Governor,Matt Pinnell,REP,670025,7,5,84,96,
Seminole,Lieutenant Governor,Anastasia Pittman,DEM,670025,1,1,29,31,
Seminole,Lieutenant Governor,Ivan Holmes,IND,670025,0,0,7,7,
Seminole,State Auditor,John Yeutter,LIB,670025,0,0,26,26,
Seminole,State Auditor,Cindy Byrd,REP,670025,8,5,89,102,
Seminole,Attorney General,Mike Hunter,REP,670025,6,5,87,98,
Seminole,Attorney General,Mark Myles,DEM,670025,2,1,32,35,
Seminole,State Treasurer,Randy Mcdaniel,REP,670025,8,5,91,104,
Seminole,State Treasurer,Charles De Coune,IND,670025,0,0,25,25,
Seminole,Superintendent of Public Instruction,Joy Hofmeister,REP,670025,7,4,68,79,
Seminole,Superintendent of Public Instruction,John Cox,DEM,670025,1,2,38,41,
Seminole,Superintendent of Public Instruction,Larry Huff,IND,670025,0,0,14,14,
Seminole,Commissioner of Labor,Leslie Osborn,REP,670025,6,5,74,85,
Seminole,Commissioner of Labor,Fred Dorrell,DEM,670025,2,1,35,38,
Seminole,Commissioner of Labor,Brandt Dismukes,IND,670025,0,0,9,9,
Seminole,Insurance Commissioner,Glen Mulready,REP,670025,5,5,82,92,
Seminole,Insurance Commissioner,Kimberly Fobbs,DEM,670025,3,1,36,40,
Seminole,Corporation Commissioner,Bob Anthony,REP,670025,7,4,75,86,
Seminole,Corporation Commissioner,Ashley Nicole Mccray,DEM,670025,1,1,35,37,
Seminole,Corporation Commissioner,Jackie Short,IND,670025,0,0,9,9,
Seminole,U.S. House,Steve Russell,REP,670025,5,5,80,90,5
Seminole,U.S. House,Kendra Horn,DEM,670025,3,1,39,43,5
Seminole,State House,Zack Taylor,REP,670025,7,4,72,83,28
Seminole,State House,Steve Barnes,DEM,670025,1,2,42,45,28
Seminole,State House,Kyle Webb,IND,670025,0,0,6,6,28
Seminole,Governor,Chris Powell,LIB,670030,0,1,6,7,
Seminole,Governor,Kevin Stitt,REP,670030,2,7,137,146,
Seminole,Governor,Drew Edmondson,DEM,670030,2,1,52,55,
Seminole,Lieutenant Governor,Matt Pinnell,REP,670030,2,8,142,152,
Seminole,Lieutenant Governor,Anastasia Pittman,DEM,670030,2,1,45,48,
Seminole,Lieutenant Governor,Ivan Holmes,IND,670030,0,0,5,5,
Seminole,State Auditor,John Yeutter,LIB,670030,1,1,31,33,
Seminole,State Auditor,Cindy Byrd,REP,670030,2,7,151,160,
Seminole,Attorney General,Mike Hunter,REP,670030,2,7,145,154,
Seminole,Attorney General,Mark Myles,DEM,670030,2,2,48,52,
Seminole,State Treasurer,Randy Mcdaniel,REP,670030,2,7,151,160,
Seminole,State Treasurer,Charles De Coune,IND,670030,1,1,28,30,
Seminole,Superintendent of Public Instruction,Joy Hofmeister,REP,670030,2,7,131,140,
Seminole,Superintendent of Public Instruction,John Cox,DEM,670030,2,2,48,52,
Seminole,Superintendent of Public Instruction,Larry Huff,IND,670030,0,0,11,11,
Seminole,Commissioner of Labor,Leslie Osborn,REP,670030,2,5,139,146,
Seminole,Commissioner of Labor,Fred Dorrell,DEM,670030,2,3,43,48,
Seminole,Commissioner of Labor,Brandt Dismukes,IND,670030,0,1,10,11,
Seminole,Insurance Commissioner,Glen Mulready,REP,670030,2,7,140,149,
Seminole,Insurance Commissioner,Kimberly Fobbs,DEM,670030,2,2,49,53,
Seminole,Corporation Commissioner,Bob Anthony,REP,670030,2,7,135,144,
Seminole,Corporation Commissioner,Ashley Nicole Mccray,DEM,670030,2,2,47,51,
Seminole,Corporation Commissioner,Jackie Short,IND,670030,0,0,9,9,
Seminole,U.S. House,Steve Russell,REP,670030,2,7,136,145,5
Seminole,U.S. House,Kendra Horn,DEM,670030,2,2,57,61,5
Seminole,State Senate,Jason Smalley,REP,670030,2,8,147,157,28
Seminole,State Senate,Stephanie Sanders,IND,670030,1,1,37,39,28
Seminole,State House,Zack Taylor,REP,670030,2,5,135,142,28
Seminole,State House,Steve Barnes,DEM,670030,2,4,58,64,28
Seminole,State House,Kyle Webb,IND,670030,0,0,2,2,28
Seminole,Governor,Chris Powell,LIB,670032,1,0,16,17,
Seminole,Governor,Kevin Stitt,REP,670032,10,45,230,285,
Seminole,Governor,Drew Edmondson,DEM,670032,10,38,160,208,
Seminole,Lieutenant Governor,Matt Pinnell,REP,670032,10,50,266,326,
Seminole,Lieutenant Governor,Anastasia Pittman,DEM,670032,10,30,132,172,
Seminole,Lieutenant Governor,Ivan Holmes,IND,670032,1,3,11,15,
Seminole,State Auditor,John Yeutter,LIB,670032,2,16,96,114,
Seminole,State Auditor,Cindy Byrd,REP,670032,15,55,293,363,
Seminole,Attorney General,Mike Hunter,REP,670032,10,55,268,333,
Seminole,Attorney General,Mark Myles,DEM,670032,11,28,137,176,
Seminole,State Treasurer,Randy Mcdaniel,REP,670032,11,56,275,342,
Seminole,State Treasurer,Charles De Coune,IND,670032,8,15,105,128,
Seminole,Superintendent of Public Instruction,Joy Hofmeister,REP,670032,7,48,235,290,
Seminole,Superintendent of Public Instruction,John Cox,DEM,670032,11,29,129,169,
Seminole,Superintendent of Public Instruction,Larry Huff,IND,670032,1,5,43,49,
Seminole,Commissioner of Labor,Leslie Osborn,REP,670032,11,52,267,330,
Seminole,Commissioner of Labor,Fred Dorrell,DEM,670032,9,30,124,163,
Seminole,Commissioner of Labor,Brandt Dismukes,IND,670032,1,2,12,15,
Seminole,Insurance Commissioner,Glen Mulready,REP,670032,9,51,252,312,
Seminole,Insurance Commissioner,Kimberly Fobbs,DEM,670032,12,31,149,192,
Seminole,Corporation Commissioner,Bob Anthony,REP,670032,9,51,246,306,
Seminole,Corporation Commissioner,Ashley Nicole Mccray,DEM,670032,12,31,138,181,
Seminole,Corporation Commissioner,Jackie Short,IND,670032,0,1,22,23,
Seminole,U.S. House,Steve Russell,REP,670032,11,47,255,313,5
Seminole,U.S. House,Kendra Horn,DEM,670032,10,36,153,199,5
Seminole,State Senate,Jason Smalley,REP,670032,14,52,269,335,28
Seminole,State Senate,Stephanie Sanders,IND,670032,4,21,120,145,28
Seminole,State House,Zack Taylor,REP,670032,10,39,225,274,28
Seminole,State House,Steve Barnes,DEM,670032,11,46,173,230,28
Seminole,State House,Kyle Webb,IND,670032,0,0,8,8,28
Seminole,Governor,Chris Powell,LIB,670033,0,0,2,2,
Seminole,Governor,Kevin Stitt,REP,670033,2,5,42,49,
Seminole,Governor,Drew Edmondson,DEM,670033,3,7,17,27,
Seminole,Lieutenant Governor,Matt Pinnell,REP,670033,2,8,44,54,
Seminole,Lieutenant Governor,Anastasia Pittman,DEM,670033,3,2,15,20,
Seminole,Lieutenant Governor,Ivan Holmes,IND,670033,0,1,2,3,
Seminole,State Auditor,John Yeutter,LIB,670033,1,2,7,10,
Seminole,State Auditor,Cindy Byrd,REP,670033,4,8,51,63,
Seminole,Attorney General,Mike Hunter,REP,670033,2,7,48,57,
Seminole,Attorney General,Mark Myles,DEM,670033,3,4,13,20,
Seminole,State Treasurer,Randy Mcdaniel,REP,670033,2,8,51,61,
Seminole,State Treasurer,Charles De Coune,IND,670033,3,2,7,12,
Seminole,Superintendent of Public Instruction,Joy Hofmeister,REP,670033,3,5,35,43,
Seminole,Superintendent of Public Instruction,John Cox,DEM,670033,2,7,20,29,
Seminole,Superintendent of Public Instruction,Larry Huff,IND,670033,0,0,6,6,
Seminole,Commissioner of Labor,Leslie Osborn,REP,670033,2,7,43,52,
Seminole,Commissioner of Labor,Fred Dorrell,DEM,670033,3,4,17,24,
Seminole,Commissioner of Labor,Brandt Dismukes,IND,670033,0,0,1,1,
Seminole,Insurance Commissioner,Glen Mulready,REP,670033,2,7,45,54,
Seminole,Insurance Commissioner,Kimberly Fobbs,DEM,670033,3,4,16,23,
Seminole,Corporation Commissioner,Bob Anthony,REP,670033,2,5,44,51,
Seminole,Corporation Commissioner,Ashley Nicole Mccray,DEM,670033,3,6,17,26,
Seminole,Corporation Commissioner,Jackie Short,IND,670033,0,0,0,0,
Seminole,U.S. House,Steve Russell,REP,670033,2,6,45,53,5
Seminole,U.S. House,Kendra Horn,DEM,670033,3,5,16,24,5
Seminole,State House,Zack Taylor,REP,670033,2,5,28,35,28
Seminole,State House,Steve Barnes,DEM,670033,3,6,31,40,28
Seminole,State House,Kyle Webb,IND,670033,0,0,2,2,28
Seminole,Governor,Chris Powell,LIB,670034,3,3,37,43,
Seminole,Governor,Kevin Stitt,REP,670034,20,70,310,400,
Seminole,Governor,Drew Edmondson,DEM,670034,21,57,331,409,
Seminole,Lieutenant Governor,Matt Pinnell,REP,670034,18,78,353,449,
Seminole,Lieutenant Governor,Anastasia Pittman,DEM,670034,23,47,296,366,
Seminole,Lieutenant Governor,Ivan Holmes,IND,670034,3,6,25,34,
Seminole,State Auditor,John Yeutter,LIB,670034,11,25,197,233,
Seminole,State Auditor,Cindy Byrd,REP,670034,30,99,442,571,
Seminole,Attorney General,Mike Hunter,REP,670034,20,86,373,479,
Seminole,Attorney General,Mark Myles,DEM,670034,24,45,295,364,
Seminole,State Treasurer,Randy Mcdaniel,REP,670034,29,96,424,549,
Seminole,State Treasurer,Charles De Coune,IND,670034,12,27,210,249,
Seminole,Superintendent of Public Instruction,Joy Hofmeister,REP,670034,19,82,337,438,
Seminole,Superintendent of Public Instruction,John Cox,DEM,670034,19,40,271,330,
Seminole,Superintendent of Public Instruction,Larry Huff,IND,670034,6,8,61,75,
Seminole,Commissioner of Labor,Leslie Osborn,REP,670034,20,84,347,451,
Seminole,Commissioner of Labor,Fred Dorrell,DEM,670034,20,43,287,350,
Seminole,Commissioner of Labor,Brandt Dismukes,IND,670034,4,3,36,43,
Seminole,Insurance Commissioner,Glen Mulready,REP,670034,22,81,361,464,
Seminole,Insurance Commissioner,Kimberly Fobbs,DEM,670034,22,48,308,378,
Seminole,Corporation Commissioner,Bob Anthony,REP,670034,25,84,344,453,
Seminole,Corporation Commissioner,Ashley Nicole Mccray,DEM,670034,17,40,288,345,
Seminole,Corporation Commissioner,Jackie Short,IND,670034,2,6,36,44,
Seminole,U.S. House,Steve Russell,REP,670034,20,82,334,436,5
Seminole,U.S. House,Kendra Horn,DEM,670034,24,48,340,412,5
Seminole,State Senate,Jason Smalley,REP,670034,24,91,378,493,28
Seminole,State Senate,Stephanie Sanders,IND,670034,18,35,258,311,28
Seminole,State House,Zack Taylor,REP,670034,15,56,260,331,28
Seminole,State House,Steve Barnes,DEM,670034,28,72,391,491,28
Seminole,State House,Kyle Webb,IND,670034,1,3,23,27,28
Seminole,Governor,Chris Powell,LIB,670035,1,0,20,21,
Seminole,Governor,Kevin Stitt,REP,670035,13,16,208,237,
Seminole,Governor,Drew Edmondson,DEM,670035,11,11,114,136,
Seminole,Lieutenant Governor,Matt Pinnell,REP,670035,14,17,244,275,
Seminole,Lieutenant Governor,Anastasia Pittman,DEM,670035,6,10,85,101,
Seminole,Lieutenant Governor,Ivan Holmes,IND,670035,4,0,13,17,
Seminole,State Auditor,John Yeutter,LIB,670035,4,7,73,84,
Seminole,State Auditor,Cindy Byrd,REP,670035,18,20,253,291,
Seminole,Attorney General,Mike Hunter,REP,670035,15,19,245,279,
Seminole,Attorney General,Mark Myles,DEM,670035,9,8,93,110,
Seminole,State Treasurer,Randy Mcdaniel,REP,670035,15,20,256,291,
Seminole,State Treasurer,Charles De Coune,IND,670035,8,6,65,79,
Seminole,Superintendent of Public Instruction,Joy Hofmeister,REP,670035,18,18,223,259,
Seminole,Superintendent of Public Instruction,John Cox,DEM,670035,5,7,86,98,
Seminole,Superintendent of Public Instruction,Larry Huff,IND,670035,1,2,30,33,
Seminole,Commissioner of Labor,Leslie Osborn,REP,670035,14,16,235,265,
Seminole,Commissioner of Labor,Fred Dorrell,DEM,670035,8,11,87,106,
Seminole,Commissioner of Labor,Brandt Dismukes,IND,670035,2,0,16,18,
Seminole,Insurance Commissioner,Glen Mulready,REP,670035,13,16,240,269,
Seminole,Insurance Commissioner,Kimberly Fobbs,DEM,670035,11,11,95,117,
Seminole,Corporation Commissioner,Bob Anthony,REP,670035,16,18,228,262,
Seminole,Corporation Commissioner,Ashley Nicole Mccray,DEM,670035,6,8,87,101,
Seminole,Corporation Commissioner,Jackie Short,IND,670035,2,1,25,28,
Seminole,U.S. House,Steve Russell,REP,670035,14,18,235,267,5
Seminole,U.S. House,Kendra Horn,DEM,670035,10,9,106,125,5
Seminole,State Senate,Jason Smalley,REP,670035,15,19,249,283,28
Seminole,State Senate,Stephanie Sanders,IND,670035,8,7,76,91,28
Seminole,State House,Zack Taylor,REP,670035,14,15,245,274,28
Seminole,State House,Steve Barnes,DEM,670035,10,12,85,107,28
Seminole,State House,Kyle Webb,IND,670035,0,0,11,11,28
Sequoyah,Governor,Chris Powell,LIB,680101,0,1,10,11,
Sequoyah,Governor,Kevin Stitt,REP,680101,10,37,452,499,
Sequoyah,Governor,Drew Edmondson,DEM,680101,9,17,278,304,
Sequoyah,Lieutenant Governor,Matt Pinnell,REP,680101,10,40,513,563,
Sequoyah,Lieutenant Governor,Anastasia Pittman,DEM,680101,6,14,200,220,
Sequoyah,Lieutenant Governor,Ivan Holmes,IND,680101,3,1,20,24,
Sequoyah,State Auditor,John Yeutter,LIB,680101,3,2,110,115,
Sequoyah,State Auditor,Cindy Byrd,REP,680101,12,50,567,629,
Sequoyah,Attorney General,Mike Hunter,REP,680101,9,43,529,581,
Sequoyah,Attorney General,Mark Myles,DEM,680101,10,12,205,227,
Sequoyah,State Treasurer,Randy Mcdaniel,REP,680101,11,45,560,616,
Sequoyah,State Treasurer,Charles De Coune,IND,680101,8,8,123,139,
Sequoyah,Superintendent of Public Instruction,Joy Hofmeister,REP,680101,8,39,444,491,
Sequoyah,Superintendent of Public Instruction,John Cox,DEM,680101,9,15,251,275,
Sequoyah,Superintendent of Public Instruction,Larry Huff,IND,680101,2,1,40,43,
Sequoyah,Commissioner of Labor,Leslie Osborn,REP,680101,11,38,517,566,
Sequoyah,Commissioner of Labor,Fred Dorrell,DEM,680101,8,16,193,217,
Sequoyah,Commissioner of Labor,Brandt Dismukes,IND,680101,0,1,18,19,
Sequoyah,Insurance Commissioner,Glen Mulready,REP,680101,9,40,505,554,
Sequoyah,Insurance Commissioner,Kimberly Fobbs,DEM,680101,10,15,223,248,
Sequoyah,Corporation Commissioner,Bob Anthony,REP,680101,10,41,505,556,
Sequoyah,Corporation Commissioner,Ashley Nicole Mccray,DEM,680101,7,13,193,213,
Sequoyah,Corporation Commissioner,Jackie Short,IND,680101,2,1,29,32,
Sequoyah,U.S. House,Richard Castaldo,LIB,680101,0,0,8,8,2
Sequoyah,U.S. House,Markwayne Mullin,REP,680101,10,39,512,561,2
Sequoyah,U.S. House,Jason Nichols,DEM,680101,9,15,205,229,2
Sequoyah,U.S. House,John Foreman,IND,680101,0,1,13,14,2
Sequoyah,State Senate,Mark Dean Allen,REP,680101,10,38,486,534,4
Sequoyah,State Senate,Eddie Martin,DEM,680101,9,17,255,281,4
Sequoyah,State House,Jim Olsen,REP,680101,10,34,398,442,2
Sequoyah,State House,Tom Stites,DEM,680101,9,21,345,375,2
Sequoyah,Governor,Chris Powell,LIB,680102,0,1,7,8,
Sequoyah,Governor,Kevin Stitt,REP,680102,4,11,225,240,
Sequoyah,Governor,Drew Edmondson,DEM,680102,7,8,164,179,
Sequoyah,Lieutenant Governor,Matt Pinnell,REP,680102,4,11,240,255,
Sequoyah,Lieutenant Governor,Anastasia Pittman,DEM,680102,6,8,140,154,
Sequoyah,Lieutenant Governor,Ivan Holmes,IND,680102,0,0,14,14,
Sequoyah,State Auditor,John Yeutter,LIB,680102,4,4,57,65,
Sequoyah,State Auditor,Cindy Byrd,REP,680102,6,13,300,319,
Sequoyah,Attorney General,Mike Hunter,REP,680102,4,12,258,274,
Sequoyah,Attorney General,Mark Myles,DEM,680102,5,8,133,146,
Sequoyah,State Treasurer,Randy Mcdaniel,REP,680102,5,15,299,319,
Sequoyah,State Treasurer,Charles De Coune,IND,680102,4,2,56,62,
Sequoyah,Superintendent of Public Instruction,Joy Hofmeister,REP,680102,4,12,209,225,
Sequoyah,Superintendent of Public Instruction,John Cox,DEM,680102,5,8,171,184,
Sequoyah,Superintendent of Public Instruction,Larry Huff,IND,680102,1,0,15,16,
Sequoyah,Commissioner of Labor,Leslie Osborn,REP,680102,4,12,246,262,
Sequoyah,Commissioner of Labor,Fred Dorrell,DEM,680102,6,8,132,146,
Sequoyah,Commissioner of Labor,Brandt Dismukes,IND,680102,0,0,10,10,
Sequoyah,Insurance Commissioner,Glen Mulready,REP,680102,4,12,251,267,
Sequoyah,Insurance Commissioner,Kimberly Fobbs,DEM,680102,6,8,135,149,
Sequoyah,Corporation Commissioner,Bob Anthony,REP,680102,5,12,245,262,
Sequoyah,Corporation Commissioner,Ashley Nicole Mccray,DEM,680102,5,7,133,145,
Sequoyah,Corporation Commissioner,Jackie Short,IND,680102,0,1,9,10,
Sequoyah,U.S. House,Richard Castaldo,LIB,680102,0,0,3,3,2
Sequoyah,U.S. House,Markwayne Mullin,REP,680102,4,12,259,275,2
Sequoyah,U.S. House,Jason Nichols,DEM,680102,6,8,125,139,2
Sequoyah,U.S. House,John Foreman,IND,680102,0,0,5,5,2
Sequoyah,State Senate,Mark Dean Allen,REP,680102,3,12,235,250,4
Sequoyah,State Senate,Eddie Martin,DEM,680102,8,8,158,174,4
Sequoyah,State House,Jim Olsen,REP,680102,3,12,188,203,2
Sequoyah,State House,Tom Stites,DEM,680102,8,8,207,223,2
Sequoyah,Governor,Chris Powell,LIB,680103,0,0,12,12,
Sequoyah,Governor,Kevin Stitt,REP,680103,14,22,395,431,
Sequoyah,Governor,Drew Edmondson,DEM,680103,8,21,232,261,
Sequoyah,Lieutenant Governor,Matt Pinnell,REP,680103,18,21,444,483,
Sequoyah,Lieutenant Governor,Anastasia Pittman,DEM,680103,4,21,179,204,
Sequoyah,Lieutenant Governor,Ivan Holmes,IND,680103,0,1,11,12,
Sequoyah,State Auditor,John Yeutter,LIB,680103,2,9,90,101,
Sequoyah,State Auditor,Cindy Byrd,REP,680103,21,33,481,535,
Sequoyah,Attorney General,Mike Hunter,REP,680103,18,25,456,499,
Sequoyah,Attorney General,Mark Myles,DEM,680103,5,18,174,197,
Sequoyah,State Treasurer,Randy Mcdaniel,REP,680103,17,32,470,519,
Sequoyah,State Treasurer,Charles De Coune,IND,680103,5,9,102,116,
Sequoyah,Superintendent of Public Instruction,Joy Hofmeister,REP,680103,18,21,382,421,
Sequoyah,Superintendent of Public Instruction,John Cox,DEM,680103,5,21,207,233,
Sequoyah,Superintendent of Public Instruction,Larry Huff,IND,680103,0,1,43,44,
Sequoyah,Commissioner of Labor,Leslie Osborn,REP,680103,18,27,432,477,
Sequoyah,Commissioner of Labor,Fred Dorrell,DEM,680103,5,14,177,196,
Sequoyah,Commissioner of Labor,Brandt Dismukes,IND,680103,0,1,22,23,
Sequoyah,Insurance Commissioner,Glen Mulready,REP,680103,18,22,439,479,
Sequoyah,Insurance Commissioner,Kimberly Fobbs,DEM,680103,4,21,189,214,
Sequoyah,Corporation Commissioner,Bob Anthony,REP,680103,20,25,430,475,
Sequoyah,Corporation Commissioner,Ashley Nicole Mccray,DEM,680103,2,16,167,185,
Sequoyah,Corporation Commissioner,Jackie Short,IND,680103,0,1,30,31,
Sequoyah,U.S. House,Richard Castaldo,LIB,680103,0,1,5,6,2
Sequoyah,U.S. House,Markwayne Mullin,REP,680103,19,26,446,491,2
Sequoyah,U.S. House,Jason Nichols,DEM,680103,4,16,172,192,2
Sequoyah,U.S. House,John Foreman,IND,680103,0,0,16,16,2
Sequoyah,State Senate,Mark Dean Allen,REP,680103,15,20,411,446,4
Sequoyah,State Senate,Eddie Martin,DEM,680103,8,23,229,260,4
Sequoyah,State House,Jim Olsen,REP,680103,15,18,364,397,2
Sequoyah,State House,Tom Stites,DEM,680103,8,24,273,305,2
Sequoyah,Governor,Chris Powell,LIB,680104,1,0,11,12,
Sequoyah,Governor,Kevin Stitt,REP,680104,15,36,387,438,
Sequoyah,Governor,Drew Edmondson,DEM,680104,7,17,182,206,
Sequoyah,Lieutenant Governor,Matt Pinnell,REP,680104,16,36,422,474,
Sequoyah,Lieutenant Governor,Anastasia Pittman,DEM,680104,6,15,144,165,
Sequoyah,Lieutenant Governor,Ivan Holmes,IND,680104,1,1,8,10,
Sequoyah,State Auditor,John Yeutter,LIB,680104,5,9,89,103,
Sequoyah,State Auditor,Cindy Byrd,REP,680104,17,41,463,521,
Sequoyah,Attorney General,Mike Hunter,REP,680104,17,40,443,500,
Sequoyah,Attorney General,Mark Myles,DEM,680104,6,12,133,151,
Sequoyah,State Treasurer,Randy Mcdaniel,REP,680104,18,41,452,511,
Sequoyah,State Treasurer,Charles De Coune,IND,680104,5,10,100,115,
Sequoyah,Superintendent of Public Instruction,Joy Hofmeister,REP,680104,16,35,375,426,
Sequoyah,Superintendent of Public Instruction,John Cox,DEM,680104,5,15,176,196,
Sequoyah,Superintendent of Public Instruction,Larry Huff,IND,680104,2,3,24,29,
Sequoyah,Commissioner of Labor,Leslie Osborn,REP,680104,17,38,420,475,
Sequoyah,Commissioner of Labor,Fred Dorrell,DEM,680104,5,13,139,157,
Sequoyah,Commissioner of Labor,Brandt Dismukes,IND,680104,1,1,13,15,
Sequoyah,Insurance Commissioner,Glen Mulready,REP,680104,16,38,422,476,
Sequoyah,Insurance Commissioner,Kimberly Fobbs,DEM,680104,7,13,151,171,
Sequoyah,Corporation Commissioner,Bob Anthony,REP,680104,15,37,419,471,
Sequoyah,Corporation Commissioner,Ashley Nicole Mccray,DEM,680104,4,13,129,146,
Sequoyah,Corporation Commissioner,Jackie Short,IND,680104,4,1,23,28,
Sequoyah,U.S. House,Richard Castaldo,LIB,680104,1,0,6,7,2
Sequoyah,U.S. House,Markwayne Mullin,REP,680104,17,37,431,485,2
Sequoyah,U.S. House,Jason Nichols,DEM,680104,5,14,132,151,2
Sequoyah,U.S. House,John Foreman,IND,680104,0,1,7,8,2
Sequoyah,State Senate,Mark Dean Allen,REP,680104,14,38,423,475,4
Sequoyah,State Senate,Eddie Martin,DEM,680104,9,13,158,180,4
Sequoyah,State House,Jim Olsen,REP,680104,14,36,347,397,2
Sequoyah,State House,Tom Stites,DEM,680104,9,17,237,263,2
Sequoyah,Governor,Chris Powell,LIB,680105,0,1,12,13,
Sequoyah,Governor,Kevin Stitt,REP,680105,6,20,368,394,
Sequoyah,Governor,Drew Edmondson,DEM,680105,7,14,194,215,
Sequoyah,Lieutenant Governor,Matt Pinnell,REP,680105,7,22,394,423,
Sequoyah,Lieutenant Governor,Anastasia Pittman,DEM,680105,6,12,156,174,
Sequoyah,Lieutenant Governor,Ivan Holmes,IND,680105,0,1,20,21,
Sequoyah,State Auditor,John Yeutter,LIB,680105,4,7,113,124,
Sequoyah,State Auditor,Cindy Byrd,REP,680105,8,23,426,457,
Sequoyah,Attorney General,Mike Hunter,REP,680105,6,23,412,441,
Sequoyah,Attorney General,Mark Myles,DEM,680105,7,12,156,175,
Sequoyah,State Treasurer,Randy Mcdaniel,REP,680105,7,25,408,440,
Sequoyah,State Treasurer,Charles De Coune,IND,680105,5,5,127,137,
Sequoyah,Superintendent of Public Instruction,Joy Hofmeister,REP,680105,6,21,352,379,
Sequoyah,Superintendent of Public Instruction,John Cox,DEM,680105,7,12,184,203,
Sequoyah,Superintendent of Public Instruction,Larry Huff,IND,680105,0,2,33,35,
Sequoyah,Commissioner of Labor,Leslie Osborn,REP,680105,5,21,392,418,
Sequoyah,Commissioner of Labor,Fred Dorrell,DEM,680105,8,11,156,175,
Sequoyah,Commissioner of Labor,Brandt Dismukes,IND,680105,0,3,21,24,
Sequoyah,Insurance Commissioner,Glen Mulready,REP,680105,7,22,395,424,
Sequoyah,Insurance Commissioner,Kimberly Fobbs,DEM,680105,6,13,170,189,
Sequoyah,Corporation Commissioner,Bob Anthony,REP,680105,6,22,384,412,
Sequoyah,Corporation Commissioner,Ashley Nicole Mccray,DEM,680105,7,11,147,165,
Sequoyah,Corporation Commissioner,Jackie Short,IND,680105,0,2,31,33,
Sequoyah,U.S. House,Richard Castaldo,LIB,680105,0,0,11,11,2
Sequoyah,U.S. House,Markwayne Mullin,REP,680105,5,26,403,434,2
Sequoyah,U.S. House,Jason Nichols,DEM,680105,8,9,143,160,2
Sequoyah,U.S. House,John Foreman,IND,680105,0,0,13,13,2
Sequoyah,State Senate,Mark Dean Allen,REP,680105,6,21,401,428,4
Sequoyah,State Senate,Eddie Martin,DEM,680105,7,14,173,194,4
Sequoyah,State House,Jim Olsen,REP,680105,6,18,349,373,2
Sequoyah,State House,Tom Stites,DEM,680105,7,17,228,252,2
Sequoyah,Governor,Chris Powell,LIB,680106,1,1,12,14,
Sequoyah,Governor,Kevin Stitt,REP,680106,3,19,311,333,
Sequoyah,Governor,Drew Edmondson,DEM,680106,3,6,132,141,
Sequoyah,Lieutenant Governor,Matt Pinnell,REP,680106,3,20,341,364,
Sequoyah,Lieutenant Governor,Anastasia Pittman,DEM,680106,3,5,101,109,
Sequoyah,Lieutenant Governor,Ivan Holmes,IND,680106,1,1,11,13,
Sequoyah,State Auditor,John Yeutter,LIB,680106,3,3,67,73,
Sequoyah,State Auditor,Cindy Byrd,REP,680106,3,22,358,383,
Sequoyah,Attorney General,Mike Hunter,REP,680106,3,21,350,374,
Sequoyah,Attorney General,Mark Myles,DEM,680106,4,5,103,112,
Sequoyah,State Treasurer,Randy Mcdaniel,REP,680106,3,22,357,382,
Sequoyah,State Treasurer,Charles De Coune,IND,680106,3,3,68,74,
Sequoyah,Superintendent of Public Instruction,Joy Hofmeister,REP,680106,3,18,295,316,
Sequoyah,Superintendent of Public Instruction,John Cox,DEM,680106,3,6,129,138,
Sequoyah,Superintendent of Public Instruction,Larry Huff,IND,680106,1,1,29,31,
Sequoyah,Commissioner of Labor,Leslie Osborn,REP,680106,3,18,336,357,
Sequoyah,Commissioner of Labor,Fred Dorrell,DEM,680106,4,7,101,112,
Sequoyah,Commissioner of Labor,Brandt Dismukes,IND,680106,0,0,15,15,
Sequoyah,Insurance Commissioner,Glen Mulready,REP,680106,3,20,339,362,
Sequoyah,Insurance Commissioner,Kimberly Fobbs,DEM,680106,4,6,113,123,
Sequoyah,Corporation Commissioner,Bob Anthony,REP,680106,3,20,318,341,
Sequoyah,Corporation Commissioner,Ashley Nicole Mccray,DEM,680106,3,4,103,110,
Sequoyah,Corporation Commissioner,Jackie Short,IND,680106,1,2,29,32,
Sequoyah,U.S. House,Richard Castaldo,LIB,680106,1,0,7,8,2
Sequoyah,U.S. House,Markwayne Mullin,REP,680106,3,20,330,353,2
Sequoyah,U.S. House,Jason Nichols,DEM,680106,3,6,101,110,2
Sequoyah,U.S. House,John Foreman,IND,680106,0,0,17,17,2
Sequoyah,State Senate,Mark Dean Allen,REP,680106,3,19,326,348,4
Sequoyah,State Senate,Eddie Martin,DEM,680106,4,7,126,137,4
Sequoyah,State House,Jim Olsen,REP,680106,3,18,282,303,2
Sequoyah,State House,Tom Stites,DEM,680106,4,8,174,186,2
Sequoyah,Governor,Chris Powell,LIB,680201,0,0,10,10,
Sequoyah,Governor,Kevin Stitt,REP,680201,1,5,130,136,
Sequoyah,Governor,Drew Edmondson,DEM,680201,0,8,74,82,
Sequoyah,Lieutenant Governor,Matt Pinnell,REP,680201,1,5,141,147,
Sequoyah,Lieutenant Governor,Anastasia Pittman,DEM,680201,0,8,61,69,
Sequoyah,Lieutenant Governor,Ivan Holmes,IND,680201,0,0,9,9,
Sequoyah,State Auditor,John Yeutter,LIB,680201,0,3,57,60,
Sequoyah,State Auditor,Cindy Byrd,REP,680201,1,8,149,158,
Sequoyah,Attorney General,Mike Hunter,REP,680201,1,5,149,155,
Sequoyah,Attorney General,Mark Myles,DEM,680201,0,8,63,71,
Sequoyah,State Treasurer,Randy Mcdaniel,REP,680201,1,5,154,160,
Sequoyah,State Treasurer,Charles De Coune,IND,680201,0,6,49,55,
Sequoyah,Superintendent of Public Instruction,Joy Hofmeister,REP,680201,1,5,126,132,
Sequoyah,Superintendent of Public Instruction,John Cox,DEM,680201,0,8,63,71,
Sequoyah,Superintendent of Public Instruction,Larry Huff,IND,680201,0,0,25,25,
Sequoyah,Commissioner of Labor,Leslie Osborn,REP,680201,1,5,138,144,
Sequoyah,Commissioner of Labor,Fred Dorrell,DEM,680201,0,8,57,65,
Sequoyah,Commissioner of Labor,Brandt Dismukes,IND,680201,0,0,17,17,
Sequoyah,Insurance Commissioner,Glen Mulready,REP,680201,1,5,145,151,
Sequoyah,Insurance Commissioner,Kimberly Fobbs,DEM,680201,0,8,67,75,
Sequoyah,Corporation Commissioner,Bob Anthony,REP,680201,1,5,136,142,
Sequoyah,Corporation Commissioner,Ashley Nicole Mccray,DEM,680201,0,8,61,69,
Sequoyah,Corporation Commissioner,Jackie Short,IND,680201,0,0,14,14,
Sequoyah,U.S. House,Richard Castaldo,LIB,680201,0,0,6,6,2
Sequoyah,U.S. House,Markwayne Mullin,REP,680201,1,5,138,144,2
Sequoyah,U.S. House,Jason Nichols,DEM,680201,0,8,60,68,2
Sequoyah,U.S. House,John Foreman,IND,680201,0,0,9,9,2
Sequoyah,State Senate,Mark Dean Allen,REP,680201,1,5,141,147,4
Sequoyah,State Senate,Eddie Martin,DEM,680201,0,8,71,79,4
Sequoyah,State House,Randy Randleman,REP,680201,1,5,140,146,15
Sequoyah,State House,Judy Ross Moore,DEM,680201,0,8,72,80,15
Sequoyah,Governor,Chris Powell,LIB,680202,0,0,10,10,
Sequoyah,Governor,Kevin Stitt,REP,680202,7,12,186,205,
Sequoyah,Governor,Drew Edmondson,DEM,680202,6,10,164,180,
Sequoyah,Lieutenant Governor,Matt Pinnell,REP,680202,8,12,216,236,
Sequoyah,Lieutenant Governor,Anastasia Pittman,DEM,680202,5,10,124,139,
Sequoyah,Lieutenant Governor,Ivan Holmes,IND,680202,0,0,16,16,
Sequoyah,State Auditor,John Yeutter,LIB,680202,3,6,88,97,
Sequoyah,State Auditor,Cindy Byrd,REP,680202,7,14,241,262,
Sequoyah,Attorney General,Mike Hunter,REP,680202,7,12,213,232,
Sequoyah,Attorney General,Mark Myles,DEM,680202,6,10,140,156,
Sequoyah,State Treasurer,Randy Mcdaniel,REP,680202,8,14,234,256,
Sequoyah,State Treasurer,Charles De Coune,IND,680202,3,5,96,104,
Sequoyah,Superintendent of Public Instruction,Joy Hofmeister,REP,680202,7,11,184,202,
Sequoyah,Superintendent of Public Instruction,John Cox,DEM,680202,5,10,135,150,
Sequoyah,Superintendent of Public Instruction,Larry Huff,IND,680202,1,1,40,42,
Sequoyah,Commissioner of Labor,Leslie Osborn,REP,680202,10,14,202,226,
Sequoyah,Commissioner of Labor,Fred Dorrell,DEM,680202,3,5,131,139,
Sequoyah,Commissioner of Labor,Brandt Dismukes,IND,680202,0,2,25,27,
Sequoyah,Insurance Commissioner,Glen Mulready,REP,680202,7,11,219,237,
Sequoyah,Insurance Commissioner,Kimberly Fobbs,DEM,680202,6,10,137,153,
Sequoyah,Corporation Commissioner,Bob Anthony,REP,680202,9,10,211,230,
Sequoyah,Corporation Commissioner,Ashley Nicole Mccray,DEM,680202,4,9,123,136,
Sequoyah,Corporation Commissioner,Jackie Short,IND,680202,0,2,22,24,
Sequoyah,U.S. House,Richard Castaldo,LIB,680202,0,0,5,5,2
Sequoyah,U.S. House,Markwayne Mullin,REP,680202,8,13,216,237,2
Sequoyah,U.S. House,Jason Nichols,DEM,680202,4,7,130,141,2
Sequoyah,U.S. House,John Foreman,IND,680202,1,2,8,11,2
Sequoyah,State Senate,Mark Dean Allen,REP,680202,8,12,205,225,4
Sequoyah,State Senate,Eddie Martin,DEM,680202,5,9,156,170,4
Sequoyah,State House,Jim Olsen,REP,680202,7,12,182,201,2
Sequoyah,State House,Tom Stites,DEM,680202,6,10,179,195,2
Sequoyah,Governor,Chris Powell,LIB,680203,0,0,6,6,
Sequoyah,Governor,Kevin Stitt,REP,680203,5,7,102,114,
Sequoyah,Governor,Drew Edmondson,DEM,680203,0,3,74,77,
Sequoyah,Lieutenant Governor,Matt Pinnell,REP,680203,5,8,118,131,
Sequoyah,Lieutenant Governor,Anastasia Pittman,DEM,680203,0,2,55,57,
Sequoyah,Lieutenant Governor,Ivan Holmes,IND,680203,0,0,7,7,
Sequoyah,State Auditor,John Yeutter,LIB,680203,0,2,46,48,
Sequoyah,State Auditor,Cindy Byrd,REP,680203,5,7,126,138,
Sequoyah,Attorney General,Mike Hunter,REP,680203,5,7,124,136,
Sequoyah,Attorney General,Mark Myles,DEM,680203,0,2,57,59,
Sequoyah,State Treasurer,Randy Mcdaniel,REP,680203,5,9,131,145,
Sequoyah,State Treasurer,Charles De Coune,IND,680203,0,1,41,42,
Sequoyah,Superintendent of Public Instruction,Joy Hofmeister,REP,680203,4,7,101,112,
Sequoyah,Superintendent of Public Instruction,John Cox,DEM,680203,0,1,62,63,
Sequoyah,Superintendent of Public Instruction,Larry Huff,IND,680203,1,1,19,21,
Sequoyah,Commissioner of Labor,Leslie Osborn,REP,680203,4,7,112,123,
Sequoyah,Commissioner of Labor,Fred Dorrell,DEM,680203,0,2,56,58,
Sequoyah,Commissioner of Labor,Brandt Dismukes,IND,680203,1,0,10,11,
Sequoyah,Insurance Commissioner,Glen Mulready,REP,680203,5,7,115,127,
Sequoyah,Insurance Commissioner,Kimberly Fobbs,DEM,680203,0,2,64,66,
Sequoyah,Corporation Commissioner,Bob Anthony,REP,680203,5,6,113,124,
Sequoyah,Corporation Commissioner,Ashley Nicole Mccray,DEM,680203,0,2,51,53,
Sequoyah,Corporation Commissioner,Jackie Short,IND,680203,0,1,15,16,
Sequoyah,U.S. House,Richard Castaldo,LIB,680203,0,0,2,2,2
Sequoyah,U.S. House,Markwayne Mullin,REP,680203,5,7,113,125,2
Sequoyah,U.S. House,Jason Nichols,DEM,680203,0,3,63,66,2
Sequoyah,U.S. House,John Foreman,IND,680203,0,0,4,4,2
Sequoyah,State Senate,Mark Dean Allen,REP,680203,5,8,104,117,4
Sequoyah,State Senate,Eddie Martin,DEM,680203,0,2,78,80,4
Sequoyah,State House,Randy Randleman,REP,680203,5,8,115,128,15
Sequoyah,State House,Judy Ross Moore,DEM,680203,0,2,66,68,15
Sequoyah,Governor,Chris Powell,LIB,680204,0,0,3,3,
Sequoyah,Governor,Kevin Stitt,REP,680204,3,9,121,133,
Sequoyah,Governor,Drew Edmondson,DEM,680204,3,16,51,70,
Sequoyah,Lieutenant Governor,Matt Pinnell,REP,680204,5,12,123,140,
Sequoyah,Lieutenant Governor,Anastasia Pittman,DEM,680204,1,12,45,58,
Sequoyah,Lieutenant Governor,Ivan Holmes,IND,680204,0,1,7,8,
Sequoyah,State Auditor,John Yeutter,LIB,680204,0,3,19,22,
Sequoyah,State Auditor,Cindy Byrd,REP,680204,6,18,135,159,
Sequoyah,Attorney General,Mike Hunter,REP,680204,5,12,126,143,
Sequoyah,Attorney General,Mark Myles,DEM,680204,1,11,46,58,
Sequoyah,State Treasurer,Randy Mcdaniel,REP,680204,6,15,135,156,
Sequoyah,State Treasurer,Charles De Coune,IND,680204,0,7,23,30,
Sequoyah,Superintendent of Public Instruction,Joy Hofmeister,REP,680204,4,11,117,132,
Sequoyah,Superintendent of Public Instruction,John Cox,DEM,680204,1,12,48,61,
Sequoyah,Superintendent of Public Instruction,Larry Huff,IND,680204,1,1,9,11,
Sequoyah,Commissioner of Labor,Leslie Osborn,REP,680204,6,11,121,138,
Sequoyah,Commissioner of Labor,Fred Dorrell,DEM,680204,0,11,47,58,
Sequoyah,Commissioner of Labor,Brandt Dismukes,IND,680204,0,2,2,4,
Sequoyah,Insurance Commissioner,Glen Mulready,REP,680204,4,13,123,140,
Sequoyah,Insurance Commissioner,Kimberly Fobbs,DEM,680204,2,11,47,60,
Sequoyah,Corporation Commissioner,Bob Anthony,REP,680204,5,13,124,142,
Sequoyah,Corporation Commissioner,Ashley Nicole Mccray,DEM,680204,1,10,45,56,
Sequoyah,Corporation Commissioner,Jackie Short,IND,680204,0,1,2,3,
Sequoyah,U.S. House,Richard Castaldo,LIB,680204,0,0,2,2,2
Sequoyah,U.S. House,Markwayne Mullin,REP,680204,5,13,127,145,2
Sequoyah,U.S. House,Jason Nichols,DEM,680204,1,10,46,57,2
Sequoyah,U.S. House,John Foreman,IND,680204,0,1,0,1,2
Sequoyah,State Senate,Mark Dean Allen,REP,680204,5,11,120,136,4
Sequoyah,State Senate,Eddie Martin,DEM,680204,1,14,56,71,4
Sequoyah,State House,Jim Olsen,REP,680204,2,8,113,123,2
Sequoyah,State House,Tom Stites,DEM,680204,4,17,66,87,2
Sequoyah,Governor,Chris Powell,LIB,680205,0,4,30,34,
Sequoyah,Governor,Kevin Stitt,REP,680205,9,78,284,371,
Sequoyah,Governor,Drew Edmondson,DEM,680205,13,45,204,262,
Sequoyah,Lieutenant Governor,Matt Pinnell,REP,680205,12,91,325,428,
Sequoyah,Lieutenant Governor,Anastasia Pittman,DEM,680205,10,29,163,202,
Sequoyah,Lieutenant Governor,Ivan Holmes,IND,680205,0,5,22,27,
Sequoyah,State Auditor,John Yeutter,LIB,680205,2,18,113,133,
Sequoyah,State Auditor,Cindy Byrd,REP,680205,17,101,363,481,
Sequoyah,Attorney General,Mike Hunter,REP,680205,12,88,343,443,
Sequoyah,Attorney General,Mark Myles,DEM,680205,10,37,166,213,
Sequoyah,State Treasurer,Randy Mcdaniel,REP,680205,14,92,359,465,
Sequoyah,State Treasurer,Charles De Coune,IND,680205,5,26,118,149,
Sequoyah,Superintendent of Public Instruction,Joy Hofmeister,REP,680205,13,83,287,383,
Sequoyah,Superintendent of Public Instruction,John Cox,DEM,680205,9,40,171,220,
Sequoyah,Superintendent of Public Instruction,Larry Huff,IND,680205,0,3,54,57,
Sequoyah,Commissioner of Labor,Leslie Osborn,REP,680205,11,84,324,419,
Sequoyah,Commissioner of Labor,Fred Dorrell,DEM,680205,10,39,158,207,
Sequoyah,Commissioner of Labor,Brandt Dismukes,IND,680205,1,1,23,25,
Sequoyah,Insurance Commissioner,Glen Mulready,REP,680205,10,88,324,422,
Sequoyah,Insurance Commissioner,Kimberly Fobbs,DEM,680205,12,37,183,232,
Sequoyah,Corporation Commissioner,Bob Anthony,REP,680205,13,82,308,403,
Sequoyah,Corporation Commissioner,Ashley Nicole Mccray,DEM,680205,8,38,164,210,
Sequoyah,Corporation Commissioner,Jackie Short,IND,680205,0,5,34,39,
Sequoyah,U.S. House,Richard Castaldo,LIB,680205,0,1,12,13,2
Sequoyah,U.S. House,Markwayne Mullin,REP,680205,12,86,320,418,2
Sequoyah,U.S. House,Jason Nichols,DEM,680205,8,37,161,206,2
Sequoyah,U.S. House,John Foreman,IND,680205,2,3,20,25,2
Sequoyah,State Senate,Mark Dean Allen,REP,680205,10,74,292,376,4
Sequoyah,State Senate,Eddie Martin,DEM,680205,12,52,224,288,4
Sequoyah,State House,Jim Olsen,REP,680205,10,61,255,326,2
Sequoyah,State House,Tom Stites,DEM,680205,12,65,264,341,2
Sequoyah,Governor,Chris Powell,LIB,680206,0,2,8,10,
Sequoyah,Governor,Kevin Stitt,REP,680206,5,33,121,159,
Sequoyah,Governor,Drew Edmondson,DEM,680206,9,17,91,117,
Sequoyah,Lieutenant Governor,Matt Pinnell,REP,680206,6,36,144,186,
Sequoyah,Lieutenant Governor,Anastasia Pittman,DEM,680206,8,16,64,88,
Sequoyah,Lieutenant Governor,Ivan Holmes,IND,680206,0,0,6,6,
Sequoyah,State Auditor,John Yeutter,LIB,680206,4,7,42,53,
Sequoyah,State Auditor,Cindy Byrd,REP,680206,8,41,167,216,
Sequoyah,Attorney General,Mike Hunter,REP,680206,5,34,150,189,
Sequoyah,Attorney General,Mark Myles,DEM,680206,8,18,67,93,
Sequoyah,State Treasurer,Randy Mcdaniel,REP,680206,6,35,163,204,
Sequoyah,State Treasurer,Charles De Coune,IND,680206,4,12,44,60,
Sequoyah,Superintendent of Public Instruction,Joy Hofmeister,REP,680206,8,31,123,162,
Sequoyah,Superintendent of Public Instruction,John Cox,DEM,680206,5,17,79,101,
Sequoyah,Superintendent of Public Instruction,Larry Huff,IND,680206,1,4,17,22,
Sequoyah,Commissioner of Labor,Leslie Osborn,REP,680206,5,30,145,180,
Sequoyah,Commissioner of Labor,Fred Dorrell,DEM,680206,8,15,63,86,
Sequoyah,Commissioner of Labor,Brandt Dismukes,IND,680206,1,5,9,15,
Sequoyah,Insurance Commissioner,Glen Mulready,REP,680206,7,33,148,188,
Sequoyah,Insurance Commissioner,Kimberly Fobbs,DEM,680206,7,19,68,94,
Sequoyah,Corporation Commissioner,Bob Anthony,REP,680206,5,34,134,173,
Sequoyah,Corporation Commissioner,Ashley Nicole Mccray,DEM,680206,9,17,64,90,
Sequoyah,Corporation Commissioner,Jackie Short,IND,680206,0,1,18,19,
Sequoyah,U.S. House,Richard Castaldo,LIB,680206,0,1,1,2,2
Sequoyah,U.S. House,Markwayne Mullin,REP,680206,7,35,142,184,2
Sequoyah,U.S. House,Jason Nichols,DEM,680206,7,14,67,88,2
Sequoyah,U.S. House,John Foreman,IND,680206,0,2,6,8,2
Sequoyah,State Senate,Mark Dean Allen,REP,680206,7,28,120,155,4
Sequoyah,State Senate,Eddie Martin,DEM,680206,7,24,97,128,4
Sequoyah,State House,Jim Olsen,REP,680206,4,29,113,146,2
Sequoyah,State House,Tom Stites,DEM,680206,10,23,106,139,2
Sequoyah,Governor,Chris Powell,LIB,680207,0,0,13,13,
Sequoyah,Governor,Kevin Stitt,REP,680207,5,21,179,205,
Sequoyah,Governor,Drew Edmondson,DEM,680207,9,14,118,141,
Sequoyah,Lieutenant Governor,Matt Pinnell,REP,680207,5,18,199,222,
Sequoyah,Lieutenant Governor,Anastasia Pittman,DEM,680207,9,16,92,117,
Sequoyah,Lieutenant Governor,Ivan Holmes,IND,680207,0,1,18,19,
Sequoyah,State Auditor,John Yeutter,LIB,680207,8,10,52,70,
Sequoyah,State Auditor,Cindy Byrd,REP,680207,5,21,239,265,
Sequoyah,Attorney General,Mike Hunter,REP,680207,8,19,214,241,
Sequoyah,Attorney General,Mark Myles,DEM,680207,6,16,92,114,
Sequoyah,State Treasurer,Randy Mcdaniel,REP,680207,5,22,219,246,
Sequoyah,State Treasurer,Charles De Coune,IND,680207,7,9,68,84,
Sequoyah,Superintendent of Public Instruction,Joy Hofmeister,REP,680207,7,18,177,202,
Sequoyah,Superintendent of Public Instruction,John Cox,DEM,680207,7,16,101,124,
Sequoyah,Superintendent of Public Instruction,Larry Huff,IND,680207,0,1,28,29,
Sequoyah,Commissioner of Labor,Leslie Osborn,REP,680207,5,19,199,223,
Sequoyah,Commissioner of Labor,Fred Dorrell,DEM,680207,8,16,89,113,
Sequoyah,Commissioner of Labor,Brandt Dismukes,IND,680207,1,0,16,17,
Sequoyah,Insurance Commissioner,Glen Mulready,REP,680207,5,17,195,217,
Sequoyah,Insurance Commissioner,Kimberly Fobbs,DEM,680207,9,18,110,137,
Sequoyah,Corporation Commissioner,Bob Anthony,REP,680207,7,18,194,219,
Sequoyah,Corporation Commissioner,Ashley Nicole Mccray,DEM,680207,7,16,93,116,
Sequoyah,Corporation Commissioner,Jackie Short,IND,680207,0,1,19,20,
Sequoyah,U.S. House,Richard Castaldo,LIB,680207,0,0,7,7,2
Sequoyah,U.S. House,Markwayne Mullin,REP,680207,6,20,200,226,2
Sequoyah,U.S. House,Jason Nichols,DEM,680207,8,14,93,115,2
Sequoyah,U.S. House,John Foreman,IND,680207,0,1,9,10,2
Sequoyah,State Senate,Mark Dean Allen,REP,680207,5,20,187,212,4
Sequoyah,State Senate,Eddie Martin,DEM,680207,8,15,121,144,4
Sequoyah,State House,Jim Olsen,REP,680207,7,14,173,194,2
Sequoyah,State House,Tom Stites,DEM,680207,6,21,136,163,2
Sequoyah,Governor,Chris Powell,LIB,680208,0,0,8,8,
Sequoyah,Governor,Kevin Stitt,REP,680208,7,21,259,287,
Sequoyah,Governor,Drew Edmondson,DEM,680208,0,14,213,227,
Sequoyah,Lieutenant Governor,Matt Pinnell,REP,680208,7,22,281,310,
Sequoyah,Lieutenant Governor,Anastasia Pittman,DEM,680208,0,13,177,190,
Sequoyah,Lieutenant Governor,Ivan Holmes,IND,680208,0,0,18,18,
Sequoyah,State Auditor,John Yeutter,LIB,680208,0,5,119,124,
Sequoyah,State Auditor,Cindy Byrd,REP,680208,7,24,310,341,
Sequoyah,Attorney General,Mike Hunter,REP,680208,7,24,277,308,
Sequoyah,Attorney General,Mark Myles,DEM,680208,0,11,198,209,
Sequoyah,State Treasurer,Randy Mcdaniel,REP,680208,6,25,297,328,
Sequoyah,State Treasurer,Charles De Coune,IND,680208,1,3,131,135,
Sequoyah,Superintendent of Public Instruction,Joy Hofmeister,REP,680208,6,19,264,289,
Sequoyah,Superintendent of Public Instruction,John Cox,DEM,680208,1,15,177,193,
Sequoyah,Superintendent of Public Instruction,Larry Huff,IND,680208,0,1,36,37,
Sequoyah,Commissioner of Labor,Leslie Osborn,REP,680208,6,22,279,307,
Sequoyah,Commissioner of Labor,Fred Dorrell,DEM,680208,0,13,180,193,
Sequoyah,Commissioner of Labor,Brandt Dismukes,IND,680208,1,0,15,16,
Sequoyah,Insurance Commissioner,Glen Mulready,REP,680208,7,22,282,311,
Sequoyah,Insurance Commissioner,Kimberly Fobbs,DEM,680208,0,12,192,204,
Sequoyah,Corporation Commissioner,Bob Anthony,REP,680208,5,19,270,294,
Sequoyah,Corporation Commissioner,Ashley Nicole Mccray,DEM,680208,1,13,179,193,
Sequoyah,Corporation Commissioner,Jackie Short,IND,680208,1,3,25,29,
Sequoyah,U.S. House,Richard Castaldo,LIB,680208,0,0,13,13,2
Sequoyah,U.S. House,Markwayne Mullin,REP,680208,7,23,275,305,2
Sequoyah,U.S. House,Jason Nichols,DEM,680208,0,12,178,190,2
Sequoyah,U.S. House,John Foreman,IND,680208,0,0,13,13,2
Sequoyah,State Senate,Mark Dean Allen,REP,680208,7,21,272,300,4
Sequoyah,State Senate,Eddie Martin,DEM,680208,0,14,205,219,4
Sequoyah,State House,Randy Randleman,REP,680208,7,22,282,311,15
Sequoyah,State House,Judy Ross Moore,DEM,680208,0,13,192,205,15
Sequoyah,Governor,Chris Powell,LIB,680209,0,0,6,6,
Sequoyah,Governor,Kevin Stitt,REP,680209,2,2,221,225,
Sequoyah,Governor,Drew Edmondson,DEM,680209,2,7,139,148,
Sequoyah,Lieutenant Governor,Matt Pinnell,REP,680209,2,2,235,239,
Sequoyah,Lieutenant Governor,Anastasia Pittman,DEM,680209,2,6,111,119,
Sequoyah,Lieutenant Governor,Ivan Holmes,IND,680209,0,1,20,21,
Sequoyah,State Auditor,John Yeutter,LIB,680209,1,1,67,69,
Sequoyah,State Auditor,Cindy Byrd,REP,680209,2,7,267,276,
Sequoyah,Attorney General,Mike Hunter,REP,680209,2,4,255,261,
Sequoyah,Attorney General,Mark Myles,DEM,680209,2,5,112,119,
Sequoyah,State Treasurer,Randy Mcdaniel,REP,680209,2,6,278,286,
Sequoyah,State Treasurer,Charles De Coune,IND,680209,1,2,58,61,
Sequoyah,Superintendent of Public Instruction,Joy Hofmeister,REP,680209,2,3,221,226,
Sequoyah,Superintendent of Public Instruction,John Cox,DEM,680209,2,3,120,125,
Sequoyah,Superintendent of Public Instruction,Larry Huff,IND,680209,0,3,22,25,
Sequoyah,Commissioner of Labor,Leslie Osborn,REP,680209,2,5,226,233,
Sequoyah,Commissioner of Labor,Fred Dorrell,DEM,680209,2,4,119,125,
Sequoyah,Commissioner of Labor,Brandt Dismukes,IND,680209,0,0,15,15,
Sequoyah,Insurance Commissioner,Glen Mulready,REP,680209,2,4,236,242,
Sequoyah,Insurance Commissioner,Kimberly Fobbs,DEM,680209,2,5,124,131,
Sequoyah,Corporation Commissioner,Bob Anthony,REP,680209,2,3,233,238,
Sequoyah,Corporation Commissioner,Ashley Nicole Mccray,DEM,680209,2,5,112,119,
Sequoyah,Corporation Commissioner,Jackie Short,IND,680209,0,1,18,19,
Sequoyah,U.S. House,Richard Castaldo,LIB,680209,0,0,8,8,2
Sequoyah,U.S. House,Markwayne Mullin,REP,680209,2,3,240,245,2
Sequoyah,U.S. House,Jason Nichols,DEM,680209,2,5,109,116,2
Sequoyah,U.S. House,John Foreman,IND,680209,0,1,7,8,2
Sequoyah,State Senate,Mark Dean Allen,REP,680209,2,5,229,236,4
Sequoyah,State Senate,Eddie Martin,DEM,680209,2,4,133,139,4
Sequoyah,State House,Randy Randleman,REP,680209,2,4,231,237,15
Sequoyah,State House,Judy Ross Moore,DEM,680209,2,5,136,143,15
Sequoyah,Governor,Chris Powell,LIB,680210,0,0,19,19,
Sequoyah,Governor,Kevin Stitt,REP,680210,7,3,193,203,
Sequoyah,Governor,Drew Edmondson,DEM,680210,3,7,142,152,
Sequoyah,Lieutenant Governor,Matt Pinnell,REP,680210,9,2,220,231,
Sequoyah,Lieutenant Governor,Anastasia Pittman,DEM,680210,1,8,119,128,
Sequoyah,Lieutenant Governor,Ivan Holmes,IND,680210,0,0,13,13,
Sequoyah,State Auditor,John Yeutter,LIB,680210,1,6,80,87,
Sequoyah,State Auditor,Cindy Byrd,REP,680210,9,3,238,250,
Sequoyah,Attorney General,Mike Hunter,REP,680210,8,2,233,243,
Sequoyah,Attorney General,Mark Myles,DEM,680210,2,8,119,129,
Sequoyah,State Treasurer,Randy Mcdaniel,REP,680210,9,2,237,248,
Sequoyah,State Treasurer,Charles De Coune,IND,680210,1,8,78,87,
Sequoyah,Superintendent of Public Instruction,Joy Hofmeister,REP,680210,8,2,196,206,
Sequoyah,Superintendent of Public Instruction,John Cox,DEM,680210,1,7,131,139,
Sequoyah,Superintendent of Public Instruction,Larry Huff,IND,680210,1,1,24,26,
Sequoyah,Commissioner of Labor,Leslie Osborn,REP,680210,7,2,204,213,
Sequoyah,Commissioner of Labor,Fred Dorrell,DEM,680210,2,7,128,137,
Sequoyah,Commissioner of Labor,Brandt Dismukes,IND,680210,1,1,16,18,
Sequoyah,Insurance Commissioner,Glen Mulready,REP,680210,8,2,228,238,
Sequoyah,Insurance Commissioner,Kimberly Fobbs,DEM,680210,2,8,123,133,
Sequoyah,Corporation Commissioner,Bob Anthony,REP,680210,9,2,223,234,
Sequoyah,Corporation Commissioner,Ashley Nicole Mccray,DEM,680210,1,7,108,116,
Sequoyah,Corporation Commissioner,Jackie Short,IND,680210,0,1,18,19,
Sequoyah,U.S. House,Richard Castaldo,LIB,680210,0,0,5,5,2
Sequoyah,U.S. House,Markwayne Mullin,REP,680210,8,2,218,228,2
Sequoyah,U.S. House,Jason Nichols,DEM,680210,2,7,119,128,2
Sequoyah,U.S. House,John Foreman,IND,680210,0,1,10,11,2
Sequoyah,State Senate,Mark Dean Allen,REP,680210,8,2,212,222,4
Sequoyah,State Senate,Eddie Martin,DEM,680210,2,8,139,149,4
Sequoyah,State House,Randy Randleman,REP,680210,7,2,213,222,15
Sequoyah,State House,Judy Ross Moore,DEM,680210,3,8,140,151,15
Sequoyah,Governor,Chris Powell,LIB,680301,4,2,15,21,
Sequoyah,Governor,Kevin Stitt,REP,680301,13,58,298,369,
Sequoyah,Governor,Drew Edmondson,DEM,680301,19,73,282,374,
Sequoyah,Lieutenant Governor,Matt Pinnell,REP,680301,22,74,352,448,
Sequoyah,Lieutenant Governor,Anastasia Pittman,DEM,680301,11,49,202,262,
Sequoyah,Lieutenant Governor,Ivan Holmes,IND,680301,1,7,30,38,
Sequoyah,State Auditor,John Yeutter,LIB,680301,7,31,130,168,
Sequoyah,State Auditor,Cindy Byrd,REP,680301,24,89,415,528,
Sequoyah,Attorney General,Mike Hunter,REP,680301,24,72,382,478,
Sequoyah,Attorney General,Mark Myles,DEM,680301,9,58,201,268,
Sequoyah,State Treasurer,Randy Mcdaniel,REP,680301,21,76,403,500,
Sequoyah,State Treasurer,Charles De Coune,IND,680301,7,45,146,198,
Sequoyah,Superintendent of Public Instruction,Joy Hofmeister,REP,680301,22,81,340,443,
Sequoyah,Superintendent of Public Instruction,John Cox,DEM,680301,10,44,197,251,
Sequoyah,Superintendent of Public Instruction,Larry Huff,IND,680301,2,7,53,62,
Sequoyah,Commissioner of Labor,Leslie Osborn,REP,680301,20,71,353,444,
Sequoyah,Commissioner of Labor,Fred Dorrell,DEM,680301,10,51,189,250,
Sequoyah,Commissioner of Labor,Brandt Dismukes,IND,680301,1,7,34,42,
Sequoyah,Insurance Commissioner,Glen Mulready,REP,680301,18,72,356,446,
Sequoyah,Insurance Commissioner,Kimberly Fobbs,DEM,680301,13,58,217,288,
Sequoyah,Corporation Commissioner,Bob Anthony,REP,680301,22,65,350,437,
Sequoyah,Corporation Commissioner,Ashley Nicole Mccray,DEM,680301,10,53,185,248,
Sequoyah,Corporation Commissioner,Jackie Short,IND,680301,1,13,42,56,
Sequoyah,U.S. House,Richard Castaldo,LIB,680301,4,1,11,16,2
Sequoyah,U.S. House,Markwayne Mullin,REP,680301,22,73,366,461,2
Sequoyah,U.S. House,Jason Nichols,DEM,680301,9,58,191,258,2
Sequoyah,U.S. House,John Foreman,IND,680301,0,1,20,21,2
Sequoyah,State Senate,Mark Dean Allen,REP,680301,20,55,295,370,4
Sequoyah,State Senate,Eddie Martin,DEM,680301,15,77,298,390,4
Sequoyah,State House,Jim Olsen,REP,680301,17,47,249,313,2
Sequoyah,State House,Tom Stites,DEM,680301,18,85,345,448,2
Sequoyah,Governor,Chris Powell,LIB,680302,0,1,10,11,
Sequoyah,Governor,Kevin Stitt,REP,680302,5,28,114,147,
Sequoyah,Governor,Drew Edmondson,DEM,680302,3,29,118,150,
Sequoyah,Lieutenant Governor,Matt Pinnell,REP,680302,6,32,138,176,
Sequoyah,Lieutenant Governor,Anastasia Pittman,DEM,680302,2,23,89,114,
Sequoyah,Lieutenant Governor,Ivan Holmes,IND,680302,0,2,11,13,
Sequoyah,State Auditor,John Yeutter,LIB,680302,0,6,58,64,
Sequoyah,State Auditor,Cindy Byrd,REP,680302,7,45,161,213,
Sequoyah,Attorney General,Mike Hunter,REP,680302,6,39,141,186,
Sequoyah,Attorney General,Mark Myles,DEM,680302,2,18,97,117,
Sequoyah,State Treasurer,Randy Mcdaniel,REP,680302,7,37,160,204,
Sequoyah,State Treasurer,Charles De Coune,IND,680302,0,14,59,73,
Sequoyah,Superintendent of Public Instruction,Joy Hofmeister,REP,680302,6,36,129,171,
Sequoyah,Superintendent of Public Instruction,John Cox,DEM,680302,2,18,91,111,
Sequoyah,Superintendent of Public Instruction,Larry Huff,IND,680302,0,3,19,22,
Sequoyah,Commissioner of Labor,Leslie Osborn,REP,680302,7,34,131,172,
Sequoyah,Commissioner of Labor,Fred Dorrell,DEM,680302,1,20,94,115,
Sequoyah,Commissioner of Labor,Brandt Dismukes,IND,680302,0,3,13,16,
Sequoyah,Insurance Commissioner,Glen Mulready,REP,680302,5,34,135,174,
Sequoyah,Insurance Commissioner,Kimberly Fobbs,DEM,680302,3,23,100,126,
Sequoyah,Corporation Commissioner,Bob Anthony,REP,680302,6,29,125,160,
Sequoyah,Corporation Commissioner,Ashley Nicole Mccray,DEM,680302,2,24,91,117,
Sequoyah,Corporation Commissioner,Jackie Short,IND,680302,0,4,21,25,
Sequoyah,U.S. House,Richard Castaldo,LIB,680302,0,1,4,5,2
Sequoyah,U.S. House,Markwayne Mullin,REP,680302,5,36,132,173,2
Sequoyah,U.S. House,Jason Nichols,DEM,680302,3,21,94,118,2
Sequoyah,U.S. House,John Foreman,IND,680302,0,0,9,9,2
Sequoyah,State Senate,Mark Dean Allen,REP,680302,3,28,118,149,4
Sequoyah,State Senate,Eddie Martin,DEM,680302,3,29,126,158,4
Sequoyah,State House,Jim Olsen,REP,680302,3,26,95,124,2
Sequoyah,State House,Tom Stites,DEM,680302,5,32,149,186,2
Sequoyah,Governor,Chris Powell,LIB,680303,0,3,21,24,
Sequoyah,Governor,Kevin Stitt,REP,680303,5,49,285,339,
Sequoyah,Governor,Drew Edmondson,DEM,680303,12,68,255,335,
Sequoyah,Lieutenant Governor,Matt Pinnell,REP,680303,4,63,339,406,
Sequoyah,Lieutenant Governor,Anastasia Pittman,DEM,680303,11,52,192,255,
Sequoyah,Lieutenant Governor,Ivan Holmes,IND,680303,1,3,15,19,
Sequoyah,State Auditor,John Yeutter,LIB,680303,4,32,107,143,
Sequoyah,State Auditor,Cindy Byrd,REP,680303,10,75,408,493,
Sequoyah,Attorney General,Mike Hunter,REP,680303,6,70,348,424,
Sequoyah,Attorney General,Mark Myles,DEM,680303,10,50,195,255,
Sequoyah,State Treasurer,Randy Mcdaniel,REP,680303,6,74,387,467,
Sequoyah,State Treasurer,Charles De Coune,IND,680303,8,32,129,169,
Sequoyah,Superintendent of Public Instruction,Joy Hofmeister,REP,680303,7,59,316,382,
Sequoyah,Superintendent of Public Instruction,John Cox,DEM,680303,7,55,177,239,
Sequoyah,Superintendent of Public Instruction,Larry Huff,IND,680303,3,3,54,60,
Sequoyah,Commissioner of Labor,Leslie Osborn,REP,680303,3,67,334,404,
Sequoyah,Commissioner of Labor,Fred Dorrell,DEM,680303,12,49,169,230,
Sequoyah,Commissioner of Labor,Brandt Dismukes,IND,680303,1,2,31,34,
Sequoyah,Insurance Commissioner,Glen Mulready,REP,680303,4,65,345,414,
Sequoyah,Insurance Commissioner,Kimberly Fobbs,DEM,680303,12,53,191,256,
Sequoyah,Corporation Commissioner,Bob Anthony,REP,680303,6,59,331,396,
Sequoyah,Corporation Commissioner,Ashley Nicole Mccray,DEM,680303,9,49,171,229,
Sequoyah,Corporation Commissioner,Jackie Short,IND,680303,1,10,42,53,
Sequoyah,U.S. House,Richard Castaldo,LIB,680303,0,0,8,8,2
Sequoyah,U.S. House,Markwayne Mullin,REP,680303,5,63,354,422,2
Sequoyah,U.S. House,Jason Nichols,DEM,680303,9,53,177,239,2
Sequoyah,U.S. House,John Foreman,IND,680303,2,3,18,23,2
Sequoyah,State Senate,Mark Dean Allen,REP,680303,3,46,287,336,4
Sequoyah,State Senate,Eddie Martin,DEM,680303,13,74,273,360,4
Sequoyah,State House,Jim Olsen,REP,680303,2,40,255,297,2
Sequoyah,State House,Tom Stites,DEM,680303,15,80,306,401,2
Sequoyah,Governor,Chris Powell,LIB,680304,0,1,7,8,
Sequoyah,Governor,Kevin Stitt,REP,680304,9,26,230,265,
Sequoyah,Governor,Drew Edmondson,DEM,680304,0,10,99,109,
Sequoyah,Lieutenant Governor,Matt Pinnell,REP,680304,9,25,246,280,
Sequoyah,Lieutenant Governor,Anastasia Pittman,DEM,680304,0,9,82,91,
Sequoyah,Lieutenant Governor,Ivan Holmes,IND,680304,0,3,8,11,
Sequoyah,State Auditor,John Yeutter,LIB,680304,0,3,50,53,
Sequoyah,State Auditor,Cindy Byrd,REP,680304,9,29,268,306,
Sequoyah,Attorney General,Mike Hunter,REP,680304,9,25,249,283,
Sequoyah,Attorney General,Mark Myles,DEM,680304,0,11,85,96,
Sequoyah,State Treasurer,Randy Mcdaniel,REP,680304,9,27,257,293,
Sequoyah,State Treasurer,Charles De Coune,IND,680304,0,5,62,67,
Sequoyah,Superintendent of Public Instruction,Joy Hofmeister,REP,680304,9,25,210,244,
Sequoyah,Superintendent of Public Instruction,John Cox,DEM,680304,0,10,95,105,
Sequoyah,Superintendent of Public Instruction,Larry Huff,IND,680304,0,2,29,31,
Sequoyah,Commissioner of Labor,Leslie Osborn,REP,680304,9,29,238,276,
Sequoyah,Commissioner of Labor,Fred Dorrell,DEM,680304,0,7,77,84,
Sequoyah,Commissioner of Labor,Brandt Dismukes,IND,680304,0,1,18,19,
Sequoyah,Insurance Commissioner,Glen Mulready,REP,680304,9,29,237,275,
Sequoyah,Insurance Commissioner,Kimberly Fobbs,DEM,680304,0,8,94,102,
Sequoyah,Corporation Commissioner,Bob Anthony,REP,680304,8,26,231,265,
Sequoyah,Corporation Commissioner,Ashley Nicole Mccray,DEM,680304,0,8,82,90,
Sequoyah,Corporation Commissioner,Jackie Short,IND,680304,1,3,18,22,
Sequoyah,U.S. House,Richard Castaldo,LIB,680304,0,0,2,2,2
Sequoyah,U.S. House,Markwayne Mullin,REP,680304,8,25,243,276,2
Sequoyah,U.S. House,Jason Nichols,DEM,680304,0,11,80,91,2
Sequoyah,U.S. House,John Foreman,IND,680304,1,1,9,11,2
Sequoyah,State Senate,Mark Dean Allen,REP,680304,9,24,220,253,4
Sequoyah,State Senate,Eddie Martin,DEM,680304,0,13,114,127,4
Sequoyah,State House,Jim Olsen,REP,680304,9,21,213,243,2
Sequoyah,State House,Tom Stites,DEM,680304,0,16,123,139,2
Sequoyah,Governor,Chris Powell,LIB,680305,0,0,6,6,
Sequoyah,Governor,Kevin Stitt,REP,680305,5,19,148,172,
Sequoyah,Governor,Drew Edmondson,DEM,680305,5,8,97,110,
Sequoyah,Lieutenant Governor,Matt Pinnell,REP,680305,9,23,167,199,
Sequoyah,Lieutenant Governor,Anastasia Pittman,DEM,680305,1,4,73,78,
Sequoyah,Lieutenant Governor,Ivan Holmes,IND,680305,0,0,9,9,
Sequoyah,State Auditor,John Yeutter,LIB,680305,1,4,42,47,
Sequoyah,State Auditor,Cindy Byrd,REP,680305,9,22,193,224,
Sequoyah,Attorney General,Mike Hunter,REP,680305,9,23,175,207,
Sequoyah,Attorney General,Mark Myles,DEM,680305,1,4,75,80,
Sequoyah,State Treasurer,Randy Mcdaniel,REP,680305,9,23,181,213,
Sequoyah,State Treasurer,Charles De Coune,IND,680305,1,3,53,57,
Sequoyah,Superintendent of Public Instruction,Joy Hofmeister,REP,680305,4,19,146,169,
Sequoyah,Superintendent of Public Instruction,John Cox,DEM,680305,5,6,80,91,
Sequoyah,Superintendent of Public Instruction,Larry Huff,IND,680305,1,2,23,26,
Sequoyah,Commissioner of Labor,Leslie Osborn,REP,680305,8,22,166,196,
Sequoyah,Commissioner of Labor,Fred Dorrell,DEM,680305,0,4,70,74,
Sequoyah,Commissioner of Labor,Brandt Dismukes,IND,680305,1,1,11,13,
Sequoyah,Insurance Commissioner,Glen Mulready,REP,680305,8,23,165,196,
Sequoyah,Insurance Commissioner,Kimberly Fobbs,DEM,680305,2,4,82,88,
Sequoyah,Corporation Commissioner,Bob Anthony,REP,680305,9,19,153,181,
Sequoyah,Corporation Commissioner,Ashley Nicole Mccray,DEM,680305,1,6,78,85,
Sequoyah,Corporation Commissioner,Jackie Short,IND,680305,0,2,19,21,
Sequoyah,U.S. House,Richard Castaldo,LIB,680305,0,0,1,1,2
Sequoyah,U.S. House,Markwayne Mullin,REP,680305,6,22,165,193,2
Sequoyah,U.S. House,Jason Nichols,DEM,680305,4,5,70,79,2
Sequoyah,U.S. House,John Foreman,IND,680305,0,0,15,15,2
Sequoyah,State Senate,Mark Dean Allen,REP,680305,4,18,154,176,4
Sequoyah,State Senate,Eddie Martin,DEM,680305,6,9,99,114,4
Sequoyah,State House,Jim Olsen,REP,680305,2,18,138,158,2
Sequoyah,State House,Tom Stites,DEM,680305,8,9,116,133,2
Sequoyah,Governor,Chris Powell,LIB,680306,0,1,15,16,
Sequoyah,Governor,Kevin Stitt,REP,680306,8,32,313,353,
Sequoyah,Governor,Drew Edmondson,DEM,680306,7,30,166,203,
Sequoyah,Lieutenant Governor,Matt Pinnell,REP,680306,11,38,354,403,
Sequoyah,Lieutenant Governor,Anastasia Pittman,DEM,680306,4,24,123,151,
Sequoyah,Lieutenant Governor,Ivan Holmes,IND,680306,0,1,16,17,
Sequoyah,State Auditor,John Yeutter,LIB,680306,5,15,78,98,
Sequoyah,State Auditor,Cindy Byrd,REP,680306,10,42,389,441,
Sequoyah,Attorney General,Mike Hunter,REP,680306,12,39,368,419,
Sequoyah,Attorney General,Mark Myles,DEM,680306,3,24,118,145,
Sequoyah,State Treasurer,Randy Mcdaniel,REP,680306,11,43,373,427,
Sequoyah,State Treasurer,Charles De Coune,IND,680306,4,13,87,104,
Sequoyah,Superintendent of Public Instruction,Joy Hofmeister,REP,680306,8,41,316,365,
Sequoyah,Superintendent of Public Instruction,John Cox,DEM,680306,5,20,138,163,
Sequoyah,Superintendent of Public Instruction,Larry Huff,IND,680306,1,2,36,39,
Sequoyah,Commissioner of Labor,Leslie Osborn,REP,680306,11,35,350,396,
Sequoyah,Commissioner of Labor,Fred Dorrell,DEM,680306,4,26,122,152,
Sequoyah,Commissioner of Labor,Brandt Dismukes,IND,680306,0,2,13,15,
Sequoyah,Insurance Commissioner,Glen Mulready,REP,680306,10,37,352,399,
Sequoyah,Insurance Commissioner,Kimberly Fobbs,DEM,680306,5,26,135,166,
Sequoyah,Corporation Commissioner,Bob Anthony,REP,680306,11,37,347,395,
Sequoyah,Corporation Commissioner,Ashley Nicole Mccray,DEM,680306,4,24,116,144,
Sequoyah,Corporation Commissioner,Jackie Short,IND,680306,0,2,25,27,
Sequoyah,U.S. House,Richard Castaldo,LIB,680306,0,0,7,7,2
Sequoyah,U.S. House,Markwayne Mullin,REP,680306,9,39,355,403,2
Sequoyah,U.S. House,Jason Nichols,DEM,680306,5,22,120,147,2
Sequoyah,U.S. House,John Foreman,IND,680306,1,2,12,15,2
Sequoyah,State Senate,Mark Dean Allen,REP,680306,9,33,328,370,4
Sequoyah,State Senate,Eddie Martin,DEM,680306,6,29,165,200,4
Sequoyah,State House,Jim Olsen,REP,680306,8,29,284,321,2
Sequoyah,State House,Tom Stites,DEM,680306,7,34,211,252,2
Sequoyah,Governor,Chris Powell,LIB,680307,0,1,9,10,
Sequoyah,Governor,Kevin Stitt,REP,680307,3,25,144,172,
Sequoyah,Governor,Drew Edmondson,DEM,680307,4,16,114,134,
Sequoyah,Lieutenant Governor,Matt Pinnell,REP,680307,3,30,170,203,
Sequoyah,Lieutenant Governor,Anastasia Pittman,DEM,680307,4,11,80,95,
Sequoyah,Lieutenant Governor,Ivan Holmes,IND,680307,0,1,13,14,
Sequoyah,State Auditor,John Yeutter,LIB,680307,3,7,47,57,
Sequoyah,State Auditor,Cindy Byrd,REP,680307,3,34,199,236,
Sequoyah,Attorney General,Mike Hunter,REP,680307,4,31,173,208,
Sequoyah,Attorney General,Mark Myles,DEM,680307,3,11,84,98,
Sequoyah,State Treasurer,Randy Mcdaniel,REP,680307,3,30,190,223,
Sequoyah,State Treasurer,Charles De Coune,IND,680307,3,11,56,70,
Sequoyah,Superintendent of Public Instruction,Joy Hofmeister,REP,680307,4,23,153,180,
Sequoyah,Superintendent of Public Instruction,John Cox,DEM,680307,2,16,89,107,
Sequoyah,Superintendent of Public Instruction,Larry Huff,IND,680307,0,3,22,25,
Sequoyah,Commissioner of Labor,Leslie Osborn,REP,680307,3,29,170,202,
Sequoyah,Commissioner of Labor,Fred Dorrell,DEM,680307,3,13,77,93,
Sequoyah,Commissioner of Labor,Brandt Dismukes,IND,680307,0,0,14,14,
Sequoyah,Insurance Commissioner,Glen Mulready,REP,680307,3,32,180,215,
Sequoyah,Insurance Commissioner,Kimberly Fobbs,DEM,680307,3,10,81,94,
Sequoyah,Corporation Commissioner,Bob Anthony,REP,680307,3,27,162,192,
Sequoyah,Corporation Commissioner,Ashley Nicole Mccray,DEM,680307,3,11,77,91,
Sequoyah,Corporation Commissioner,Jackie Short,IND,680307,0,4,20,24,
Sequoyah,U.S. House,Richard Castaldo,LIB,680307,0,0,5,5,2
Sequoyah,U.S. House,Markwayne Mullin,REP,680307,3,26,170,199,2
Sequoyah,U.S. House,Jason Nichols,DEM,680307,4,14,84,102,2
Sequoyah,U.S. House,John Foreman,IND,680307,0,2,6,8,2
Sequoyah,State Senate,Mark Dean Allen,REP,680307,3,29,154,186,4
Sequoyah,State Senate,Eddie Martin,DEM,680307,4,13,114,131,4
Sequoyah,State House,Jim Olsen,REP,680307,3,19,137,159,2
Sequoyah,State House,Tom Stites,DEM,680307,4,23,134,161,2
Sequoyah,Governor,Chris Powell,LIB,680308,0,0,10,10,
Sequoyah,Governor,Kevin Stitt,REP,680308,1,9,133,143,
Sequoyah,Governor,Drew Edmondson,DEM,680308,0,3,73,76,
Sequoyah,Lieutenant Governor,Matt Pinnell,REP,680308,1,10,145,156,
Sequoyah,Lieutenant Governor,Anastasia Pittman,DEM,680308,0,2,59,61,
Sequoyah,Lieutenant Governor,Ivan Holmes,IND,680308,0,0,7,7,
Sequoyah,State Auditor,John Yeutter,LIB,680308,1,3,45,49,
Sequoyah,State Auditor,Cindy Byrd,REP,680308,0,9,153,162,
Sequoyah,Attorney General,Mike Hunter,REP,680308,0,10,149,159,
Sequoyah,Attorney General,Mark Myles,DEM,680308,1,2,64,67,
Sequoyah,State Treasurer,Randy Mcdaniel,REP,680308,0,9,157,166,
Sequoyah,State Treasurer,Charles De Coune,IND,680308,1,3,42,46,
Sequoyah,Superintendent of Public Instruction,Joy Hofmeister,REP,680308,0,9,131,140,
Sequoyah,Superintendent of Public Instruction,John Cox,DEM,680308,0,2,62,64,
Sequoyah,Superintendent of Public Instruction,Larry Huff,IND,680308,1,1,21,23,
Sequoyah,Commissioner of Labor,Leslie Osborn,REP,680308,0,9,144,153,
Sequoyah,Commissioner of Labor,Fred Dorrell,DEM,680308,0,3,54,57,
Sequoyah,Commissioner of Labor,Brandt Dismukes,IND,680308,1,0,13,14,
Sequoyah,Insurance Commissioner,Glen Mulready,REP,680308,0,9,143,152,
Sequoyah,Insurance Commissioner,Kimberly Fobbs,DEM,680308,1,3,68,72,
Sequoyah,Corporation Commissioner,Bob Anthony,REP,680308,0,10,136,146,
Sequoyah,Corporation Commissioner,Ashley Nicole Mccray,DEM,680308,0,2,61,63,
Sequoyah,Corporation Commissioner,Jackie Short,IND,680308,1,0,15,16,
Sequoyah,U.S. House,Richard Castaldo,LIB,680308,0,0,5,5,2
Sequoyah,U.S. House,Markwayne Mullin,REP,680308,1,10,147,158,2
Sequoyah,U.S. House,Jason Nichols,DEM,680308,0,2,58,60,2
Sequoyah,U.S. House,John Foreman,IND,680308,0,0,6,6,2
Sequoyah,State Senate,Mark Dean Allen,REP,680308,1,8,133,142,4
Sequoyah,State Senate,Eddie Martin,DEM,680308,0,4,84,88,4
Sequoyah,State House,Jim Olsen,REP,680308,1,8,124,133,2
Sequoyah,State House,Tom Stites,DEM,680308,0,4,94,98,2
Sequoyah,Governor,Chris Powell,LIB,680309,0,0,8,8,
Sequoyah,Governor,Kevin Stitt,REP,680309,2,3,147,152,
Sequoyah,Governor,Drew Edmondson,DEM,680309,11,4,110,125,
Sequoyah,Lieutenant Governor,Matt Pinnell,REP,680309,7,4,174,185,
Sequoyah,Lieutenant Governor,Anastasia Pittman,DEM,680309,6,3,76,85,
Sequoyah,Lieutenant Governor,Ivan Holmes,IND,680309,0,0,7,7,
Sequoyah,State Auditor,John Yeutter,LIB,680309,1,1,48,50,
Sequoyah,State Auditor,Cindy Byrd,REP,680309,9,4,191,204,
Sequoyah,Attorney General,Mike Hunter,REP,680309,8,4,184,196,
Sequoyah,Attorney General,Mark Myles,DEM,680309,5,3,70,78,
Sequoyah,State Treasurer,Randy Mcdaniel,REP,680309,10,4,187,201,
Sequoyah,State Treasurer,Charles De Coune,IND,680309,0,1,47,48,
Sequoyah,Superintendent of Public Instruction,Joy Hofmeister,REP,680309,3,3,147,153,
Sequoyah,Superintendent of Public Instruction,John Cox,DEM,680309,8,3,91,102,
Sequoyah,Superintendent of Public Instruction,Larry Huff,IND,680309,1,1,23,25,
Sequoyah,Commissioner of Labor,Leslie Osborn,REP,680309,7,4,174,185,
Sequoyah,Commissioner of Labor,Fred Dorrell,DEM,680309,6,3,73,82,
Sequoyah,Commissioner of Labor,Brandt Dismukes,IND,680309,0,0,7,7,
Sequoyah,Insurance Commissioner,Glen Mulready,REP,680309,8,3,175,186,
Sequoyah,Insurance Commissioner,Kimberly Fobbs,DEM,680309,4,4,80,88,
Sequoyah,Corporation Commissioner,Bob Anthony,REP,680309,6,3,166,175,
Sequoyah,Corporation Commissioner,Ashley Nicole Mccray,DEM,680309,6,3,73,82,
Sequoyah,Corporation Commissioner,Jackie Short,IND,680309,1,1,14,16,
Sequoyah,U.S. House,Richard Castaldo,LIB,680309,0,0,5,5,2
Sequoyah,U.S. House,Markwayne Mullin,REP,680309,7,3,176,186,2
Sequoyah,U.S. House,Jason Nichols,DEM,680309,5,4,77,86,2
Sequoyah,U.S. House,John Foreman,IND,680309,1,0,4,5,2
Sequoyah,State Senate,Mark Dean Allen,REP,680309,3,3,151,157,4
Sequoyah,State Senate,Eddie Martin,DEM,680309,10,4,112,126,4
Sequoyah,State House,Jim Olsen,REP,680309,4,3,134,141,2
Sequoyah,State House,Tom Stites,DEM,680309,9,4,128,141,2
Sequoyah,Governor,Chris Powell,LIB,680310,0,0,4,4,
Sequoyah,Governor,Kevin Stitt,REP,680310,4,15,191,210,
Sequoyah,Governor,Drew Edmondson,DEM,680310,5,3,94,102,
Sequoyah,Lieutenant Governor,Matt Pinnell,REP,680310,4,15,207,226,
Sequoyah,Lieutenant Governor,Anastasia Pittman,DEM,680310,5,3,73,81,
Sequoyah,Lieutenant Governor,Ivan Holmes,IND,680310,0,0,5,5,
Sequoyah,State Auditor,John Yeutter,LIB,680310,2,2,40,44,
Sequoyah,State Auditor,Cindy Byrd,REP,680310,5,14,223,242,
Sequoyah,Attorney General,Mike Hunter,REP,680310,4,15,218,237,
Sequoyah,Attorney General,Mark Myles,DEM,680310,5,3,67,75,
Sequoyah,State Treasurer,Randy Mcdaniel,REP,680310,4,15,221,240,
Sequoyah,State Treasurer,Charles De Coune,IND,680310,2,1,39,42,
Sequoyah,Superintendent of Public Instruction,Joy Hofmeister,REP,680310,4,15,178,197,
Sequoyah,Superintendent of Public Instruction,John Cox,DEM,680310,5,3,89,97,
Sequoyah,Superintendent of Public Instruction,Larry Huff,IND,680310,0,0,20,20,
Sequoyah,Commissioner of Labor,Leslie Osborn,REP,680310,4,15,204,223,
Sequoyah,Commissioner of Labor,Fred Dorrell,DEM,680310,5,3,71,79,
Sequoyah,Commissioner of Labor,Brandt Dismukes,IND,680310,0,0,6,6,
Sequoyah,Insurance Commissioner,Glen Mulready,REP,680310,4,13,198,215,
Sequoyah,Insurance Commissioner,Kimberly Fobbs,DEM,680310,5,4,83,92,
Sequoyah,Corporation Commissioner,Bob Anthony,REP,680310,4,14,188,206,
Sequoyah,Corporation Commissioner,Ashley Nicole Mccray,DEM,680310,5,3,83,91,
Sequoyah,Corporation Commissioner,Jackie Short,IND,680310,0,0,12,12,
Sequoyah,U.S. House,Richard Castaldo,LIB,680310,0,0,2,2,2
Sequoyah,U.S. House,Markwayne Mullin,REP,680310,3,15,203,221,2
Sequoyah,U.S. House,Jason Nichols,DEM,680310,6,3,75,84,2
Sequoyah,U.S. House,John Foreman,IND,680310,0,0,8,8,2
Sequoyah,State Senate,Mark Dean Allen,REP,680310,4,14,198,216,4
Sequoyah,State Senate,Eddie Martin,DEM,680310,5,4,91,100,4
Sequoyah,State House,Jim Olsen,REP,680310,3,14,167,184,2
Sequoyah,State House,Tom Stites,DEM,680310,6,4,122,132,2
Stephens,Governor,Chris Powell,LIB,690001,0,2,13,15,
Stephens,Governor,Kevin Stitt,REP,690001,14,62,468,544,
Stephens,Governor,Drew Edmondson,DEM,690001,8,19,172,199,
Stephens,Lieutenant Governor,Matt Pinnell,REP,690001,15,67,516,598,
Stephens,Lieutenant Governor,Anastasia Pittman,DEM,690001,7,13,112,132,
Stephens,Lieutenant Governor,Ivan Holmes,IND,690001,0,3,17,20,
Stephens,State Auditor,John Yeutter,LIB,690001,9,13,74,96,
Stephens,State Auditor,Cindy Byrd,REP,690001,12,67,542,621,
Stephens,Attorney General,Mike Hunter,REP,690001,15,70,522,607,
Stephens,Attorney General,Mark Myles,DEM,690001,7,13,124,144,
Stephens,State Treasurer,Randy Mcdaniel,REP,690001,14,69,530,613,
Stephens,State Treasurer,Charles De Coune,IND,690001,7,11,85,103,
Stephens,Superintendent of Public Instruction,Joy Hofmeister,REP,690001,14,66,468,548,
Stephens,Superintendent of Public Instruction,John Cox,DEM,690001,8,14,142,164,
Stephens,Superintendent of Public Instruction,Larry Huff,IND,690001,0,2,38,40,
Stephens,Commissioner of Labor,Leslie Osborn,REP,690001,15,64,510,589,
Stephens,Commissioner of Labor,Fred Dorrell,DEM,690001,7,13,97,117,
Stephens,Commissioner of Labor,Brandt Dismukes,IND,690001,0,5,28,33,
Stephens,Insurance Commissioner,Glen Mulready,REP,690001,13,64,495,572,
Stephens,Insurance Commissioner,Kimberly Fobbs,DEM,690001,9,17,140,166,
Stephens,Corporation Commissioner,Bob Anthony,REP,690001,16,67,506,589,
Stephens,Corporation Commissioner,Ashley Nicole Mccray,DEM,690001,6,11,110,127,
Stephens,Corporation Commissioner,Jackie Short,IND,690001,0,4,22,26,
Stephens,U.S. House,Tom Cole,REP,690001,15,69,534,618,4
Stephens,U.S. House,Mary Brannon,DEM,690001,7,12,99,118,4
Stephens,U.S. House,Ruby Peters,IND,690001,0,1,17,18,4
Stephens,Governor,Chris Powell,LIB,690003,1,1,12,14,
Stephens,Governor,Kevin Stitt,REP,690003,12,38,374,424,
Stephens,Governor,Drew Edmondson,DEM,690003,24,19,155,198,
Stephens,Lieutenant Governor,Matt Pinnell,REP,690003,13,38,406,457,
Stephens,Lieutenant Governor,Anastasia Pittman,DEM,690003,21,16,113,150,
Stephens,Lieutenant Governor,Ivan Holmes,IND,690003,2,3,16,21,
Stephens,State Auditor,John Yeutter,LIB,690003,9,5,80,94,
Stephens,State Auditor,Cindy Byrd,REP,690003,16,46,435,497,
Stephens,Attorney General,Mike Hunter,REP,690003,15,43,423,481,
Stephens,Attorney General,Mark Myles,DEM,690003,21,14,110,145,
Stephens,State Treasurer,Randy Mcdaniel,REP,690003,15,44,433,492,
Stephens,State Treasurer,Charles De Coune,IND,690003,9,5,80,94,
Stephens,Superintendent of Public Instruction,Joy Hofmeister,REP,690003,14,39,357,410,
Stephens,Superintendent of Public Instruction,John Cox,DEM,690003,22,17,137,176,
Stephens,Superintendent of Public Instruction,Larry Huff,IND,690003,0,0,42,42,
Stephens,Commissioner of Labor,Leslie Osborn,REP,690003,15,41,404,460,
Stephens,Commissioner of Labor,Fred Dorrell,DEM,690003,21,12,101,134,
Stephens,Commissioner of Labor,Brandt Dismukes,IND,690003,0,3,27,30,
Stephens,Insurance Commissioner,Glen Mulready,REP,690003,16,38,397,451,
Stephens,Insurance Commissioner,Kimberly Fobbs,DEM,690003,20,18,131,169,
Stephens,Corporation Commissioner,Bob Anthony,REP,690003,13,41,388,442,
Stephens,Corporation Commissioner,Ashley Nicole Mccray,DEM,690003,22,15,110,147,
Stephens,Corporation Commissioner,Jackie Short,IND,690003,1,1,34,36,
Stephens,U.S. House,Tom Cole,REP,690003,15,43,429,487,4
Stephens,U.S. House,Mary Brannon,DEM,690003,21,14,93,128,4
Stephens,U.S. House,Ruby Peters,IND,690003,0,0,16,16,4
Stephens,Governor,Chris Powell,LIB,690004,0,2,30,32,
Stephens,Governor,Kevin Stitt,REP,690004,14,33,365,412,
Stephens,Governor,Drew Edmondson,DEM,690004,9,17,207,233,
Stephens,Lieutenant Governor,Matt Pinnell,REP,690004,15,36,398,449,
Stephens,Lieutenant Governor,Anastasia Pittman,DEM,690004,8,15,180,203,
Stephens,Lieutenant Governor,Ivan Holmes,IND,690004,0,2,19,21,
Stephens,State Auditor,John Yeutter,LIB,690004,5,8,128,141,
Stephens,State Auditor,Cindy Byrd,REP,690004,15,39,444,498,
Stephens,Attorney General,Mike Hunter,REP,690004,16,36,425,477,
Stephens,Attorney General,Mark Myles,DEM,690004,7,16,169,192,
Stephens,State Treasurer,Randy Mcdaniel,REP,690004,15,37,437,489,
Stephens,State Treasurer,Charles De Coune,IND,690004,6,9,133,148,
Stephens,Superintendent of Public Instruction,Joy Hofmeister,REP,690004,16,36,358,410,
Stephens,Superintendent of Public Instruction,John Cox,DEM,690004,6,13,188,207,
Stephens,Superintendent of Public Instruction,Larry Huff,IND,690004,1,4,49,54,
Stephens,Commissioner of Labor,Leslie Osborn,REP,690004,13,34,384,431,
Stephens,Commissioner of Labor,Fred Dorrell,DEM,690004,8,15,170,193,
Stephens,Commissioner of Labor,Brandt Dismukes,IND,690004,2,4,36,42,
Stephens,Insurance Commissioner,Glen Mulready,REP,690004,14,38,385,437,
Stephens,Insurance Commissioner,Kimberly Fobbs,DEM,690004,9,15,206,230,
Stephens,Corporation Commissioner,Bob Anthony,REP,690004,13,35,398,446,
Stephens,Corporation Commissioner,Ashley Nicole Mccray,DEM,690004,7,14,169,190,
Stephens,Corporation Commissioner,Jackie Short,IND,690004,3,3,30,36,
Stephens,U.S. House,Tom Cole,REP,690004,15,37,416,468,4
Stephens,U.S. House,Mary Brannon,DEM,690004,8,15,155,178,4
Stephens,U.S. House,Ruby Peters,IND,690004,0,1,26,27,4
Stephens,Governor,Chris Powell,LIB,690008,0,3,23,26,
Stephens,Governor,Kevin Stitt,REP,690008,1,16,229,246,
Stephens,Governor,Drew Edmondson,DEM,690008,6,19,225,250,
Stephens,Lieutenant Governor,Matt Pinnell,REP,690008,3,20,253,276,
Stephens,Lieutenant Governor,Anastasia Pittman,DEM,690008,4,16,205,225,
Stephens,Lieutenant Governor,Ivan Holmes,IND,690008,0,2,16,18,
Stephens,State Auditor,John Yeutter,LIB,690008,3,15,124,142,
Stephens,State Auditor,Cindy Byrd,REP,690008,3,20,288,311,
Stephens,Attorney General,Mike Hunter,REP,690008,3,19,264,286,
Stephens,Attorney General,Mark Myles,DEM,690008,4,19,210,233,
Stephens,State Treasurer,Randy Mcdaniel,REP,690008,3,20,277,300,
Stephens,State Treasurer,Charles De Coune,IND,690008,3,14,137,154,
Stephens,Superintendent of Public Instruction,Joy Hofmeister,REP,690008,3,18,229,250,
Stephens,Superintendent of Public Instruction,John Cox,DEM,690008,4,18,200,222,
Stephens,Superintendent of Public Instruction,Larry Huff,IND,690008,0,2,46,48,
Stephens,Commissioner of Labor,Leslie Osborn,REP,690008,3,18,246,267,
Stephens,Commissioner of Labor,Fred Dorrell,DEM,690008,4,17,199,220,
Stephens,Commissioner of Labor,Brandt Dismukes,IND,690008,0,2,31,33,
Stephens,Insurance Commissioner,Glen Mulready,REP,690008,3,19,248,270,
Stephens,Insurance Commissioner,Kimberly Fobbs,DEM,690008,4,19,226,249,
Stephens,Corporation Commissioner,Bob Anthony,REP,690008,3,18,248,269,
Stephens,Corporation Commissioner,Ashley Nicole Mccray,DEM,690008,4,19,198,221,
Stephens,Corporation Commissioner,Jackie Short,IND,690008,0,1,27,28,
Stephens,U.S. House,Tom Cole,REP,690008,3,20,267,290,4
Stephens,U.S. House,Mary Brannon,DEM,690008,4,17,188,209,4
Stephens,U.S. House,Ruby Peters,IND,690008,0,1,20,21,4
Stephens,Governor,Chris Powell,LIB,690012,0,2,21,23,
Stephens,Governor,Kevin Stitt,REP,690012,12,40,258,310,
Stephens,Governor,Drew Edmondson,DEM,690012,6,25,193,224,
Stephens,Lieutenant Governor,Matt Pinnell,REP,690012,13,44,286,343,
Stephens,Lieutenant Governor,Anastasia Pittman,DEM,690012,5,19,163,187,
Stephens,Lieutenant Governor,Ivan Holmes,IND,690012,0,2,19,21,
Stephens,State Auditor,John Yeutter,LIB,690012,3,13,109,125,
Stephens,State Auditor,Cindy Byrd,REP,690012,13,46,319,378,
Stephens,Attorney General,Mike Hunter,REP,690012,13,44,301,358,
Stephens,Attorney General,Mark Myles,DEM,690012,5,20,163,188,
Stephens,State Treasurer,Randy Mcdaniel,REP,690012,13,46,305,364,
Stephens,State Treasurer,Charles De Coune,IND,690012,3,10,123,136,
Stephens,Superintendent of Public Instruction,Joy Hofmeister,REP,690012,12,39,252,303,
Stephens,Superintendent of Public Instruction,John Cox,DEM,690012,5,20,168,193,
Stephens,Superintendent of Public Instruction,Larry Huff,IND,690012,1,6,45,52,
Stephens,Commissioner of Labor,Leslie Osborn,REP,690012,13,42,279,334,
Stephens,Commissioner of Labor,Fred Dorrell,DEM,690012,5,19,149,173,
Stephens,Commissioner of Labor,Brandt Dismukes,IND,690012,0,5,35,40,
Stephens,Insurance Commissioner,Glen Mulready,REP,690012,14,43,297,354,
Stephens,Insurance Commissioner,Kimberly Fobbs,DEM,690012,4,21,166,191,
Stephens,Corporation Commissioner,Bob Anthony,REP,690012,14,40,279,333,
Stephens,Corporation Commissioner,Ashley Nicole Mccray,DEM,690012,4,21,148,173,
Stephens,Corporation Commissioner,Jackie Short,IND,690012,0,4,37,41,
Stephens,U.S. House,Tom Cole,REP,690012,14,42,294,350,4
Stephens,U.S. House,Mary Brannon,DEM,690012,4,21,148,173,4
Stephens,U.S. House,Ruby Peters,IND,690012,0,2,25,27,4
Stephens,Governor,Chris Powell,LIB,690013,1,0,4,5,
Stephens,Governor,Kevin Stitt,REP,690013,4,7,89,100,
Stephens,Governor,Drew Edmondson,DEM,690013,13,3,66,82,
Stephens,Lieutenant Governor,Matt Pinnell,REP,690013,5,7,89,101,
Stephens,Lieutenant Governor,Anastasia Pittman,DEM,690013,11,3,62,76,
Stephens,Lieutenant Governor,Ivan Holmes,IND,690013,0,0,6,6,
Stephens,State Auditor,John Yeutter,LIB,690013,3,2,36,41,
Stephens,State Auditor,Cindy Byrd,REP,690013,9,7,110,126,
Stephens,Attorney General,Mike Hunter,REP,690013,6,7,99,112,
Stephens,Attorney General,Mark Myles,DEM,690013,10,3,57,70,
Stephens,State Treasurer,Randy Mcdaniel,REP,690013,6,7,101,114,
Stephens,State Treasurer,Charles De Coune,IND,690013,5,2,46,53,
Stephens,Superintendent of Public Instruction,Joy Hofmeister,REP,690013,5,5,78,88,
Stephens,Superintendent of Public Instruction,John Cox,DEM,690013,11,5,63,79,
Stephens,Superintendent of Public Instruction,Larry Huff,IND,690013,0,0,15,15,
Stephens,Commissioner of Labor,Leslie Osborn,REP,690013,5,5,87,97,
Stephens,Commissioner of Labor,Fred Dorrell,DEM,690013,10,5,56,71,
Stephens,Commissioner of Labor,Brandt Dismukes,IND,690013,0,0,13,13,
Stephens,Insurance Commissioner,Glen Mulready,REP,690013,4,7,93,104,
Stephens,Insurance Commissioner,Kimberly Fobbs,DEM,690013,11,3,63,77,
Stephens,Corporation Commissioner,Bob Anthony,REP,690013,4,7,93,104,
Stephens,Corporation Commissioner,Ashley Nicole Mccray,DEM,690013,12,3,56,71,
Stephens,Corporation Commissioner,Jackie Short,IND,690013,0,0,7,7,
Stephens,U.S. House,Tom Cole,REP,690013,9,7,100,116,4
Stephens,U.S. House,Mary Brannon,DEM,690013,7,3,53,63,4
Stephens,U.S. House,Ruby Peters,IND,690013,1,0,4,5,4
Stephens,Governor,Chris Powell,LIB,690014,1,0,27,28,
Stephens,Governor,Kevin Stitt,REP,690014,34,59,575,668,
Stephens,Governor,Drew Edmondson,DEM,690014,10,29,229,268,
Stephens,Lieutenant Governor,Matt Pinnell,REP,690014,39,61,639,739,
Stephens,Lieutenant Governor,Anastasia Pittman,DEM,690014,6,25,169,200,
Stephens,Lieutenant Governor,Ivan Holmes,IND,690014,0,2,23,25,
Stephens,State Auditor,John Yeutter,LIB,690014,4,11,116,131,
Stephens,State Auditor,Cindy Byrd,REP,690014,40,70,681,791,
Stephens,Attorney General,Mike Hunter,REP,690014,39,65,648,752,
Stephens,Attorney General,Mark Myles,DEM,690014,6,23,180,209,
Stephens,State Treasurer,Randy Mcdaniel,REP,690014,40,71,676,787,
Stephens,State Treasurer,Charles De Coune,IND,690014,3,11,120,134,
Stephens,Superintendent of Public Instruction,Joy Hofmeister,REP,690014,35,62,576,673,
Stephens,Superintendent of Public Instruction,John Cox,DEM,690014,7,24,195,226,
Stephens,Superintendent of Public Instruction,Larry Huff,IND,690014,3,3,58,64,
Stephens,Commissioner of Labor,Leslie Osborn,REP,690014,38,63,613,714,
Stephens,Commissioner of Labor,Fred Dorrell,DEM,690014,5,24,167,196,
Stephens,Commissioner of Labor,Brandt Dismukes,IND,690014,2,2,42,46,
Stephens,Insurance Commissioner,Glen Mulready,REP,690014,39,62,626,727,
Stephens,Insurance Commissioner,Kimberly Fobbs,DEM,690014,6,26,194,226,
Stephens,Corporation Commissioner,Bob Anthony,REP,690014,36,63,622,721,
Stephens,Corporation Commissioner,Ashley Nicole Mccray,DEM,690014,7,24,171,202,
Stephens,Corporation Commissioner,Jackie Short,IND,690014,2,1,32,35,
Stephens,U.S. House,Tom Cole,REP,690014,38,69,644,751,4
Stephens,U.S. House,Mary Brannon,DEM,690014,5,19,151,175,4
Stephens,U.S. House,Ruby Peters,IND,690014,2,1,35,38,4
Stephens,Governor,Chris Powell,LIB,690015,0,0,4,4,
Stephens,Governor,Kevin Stitt,REP,690015,5,7,105,117,
Stephens,Governor,Drew Edmondson,DEM,690015,1,2,44,47,
Stephens,Lieutenant Governor,Matt Pinnell,REP,690015,5,7,114,126,
Stephens,Lieutenant Governor,Anastasia Pittman,DEM,690015,1,2,34,37,
Stephens,Lieutenant Governor,Ivan Holmes,IND,690015,0,0,5,5,
Stephens,State Auditor,John Yeutter,LIB,690015,0,2,25,27,
Stephens,State Auditor,Cindy Byrd,REP,690015,5,7,118,130,
Stephens,Attorney General,Mike Hunter,REP,690015,5,7,118,130,
Stephens,Attorney General,Mark Myles,DEM,690015,1,2,35,38,
Stephens,State Treasurer,Randy Mcdaniel,REP,690015,5,6,113,124,
Stephens,State Treasurer,Charles De Coune,IND,690015,1,3,30,34,
Stephens,Superintendent of Public Instruction,Joy Hofmeister,REP,690015,5,7,104,116,
Stephens,Superintendent of Public Instruction,John Cox,DEM,690015,1,2,39,42,
Stephens,Superintendent of Public Instruction,Larry Huff,IND,690015,0,0,9,9,
Stephens,Commissioner of Labor,Leslie Osborn,REP,690015,5,6,111,122,
Stephens,Commissioner of Labor,Fred Dorrell,DEM,690015,1,2,36,39,
Stephens,Commissioner of Labor,Brandt Dismukes,IND,690015,0,0,6,6,
Stephens,Insurance Commissioner,Glen Mulready,REP,690015,5,7,116,128,
Stephens,Insurance Commissioner,Kimberly Fobbs,DEM,690015,1,2,37,40,
Stephens,Corporation Commissioner,Bob Anthony,REP,690015,5,6,113,124,
Stephens,Corporation Commissioner,Ashley Nicole Mccray,DEM,690015,1,2,31,34,
Stephens,Corporation Commissioner,Jackie Short,IND,690015,0,1,9,10,
Stephens,U.S. House,Tom Cole,REP,690015,5,5,117,127,4
Stephens,U.S. House,Mary Brannon,DEM,690015,1,2,28,31,4
Stephens,U.S. House,Ruby Peters,IND,690015,0,1,8,9,4
Stephens,Governor,Chris Powell,LIB,690016,0,2,24,26,
Stephens,Governor,Kevin Stitt,REP,690016,22,73,613,708,
Stephens,Governor,Drew Edmondson,DEM,690016,28,33,263,324,
Stephens,Lieutenant Governor,Matt Pinnell,REP,690016,26,77,673,776,
Stephens,Lieutenant Governor,Anastasia Pittman,DEM,690016,24,28,195,247,
Stephens,Lieutenant Governor,Ivan Holmes,IND,690016,0,3,28,31,
Stephens,State Auditor,John Yeutter,LIB,690016,14,17,127,158,
Stephens,State Auditor,Cindy Byrd,REP,690016,27,87,731,845,
Stephens,Attorney General,Mike Hunter,REP,690016,24,80,696,800,
Stephens,Attorney General,Mark Myles,DEM,690016,25,28,200,253,
Stephens,State Treasurer,Randy Mcdaniel,REP,690016,26,83,717,826,
Stephens,State Treasurer,Charles De Coune,IND,690016,15,20,135,170,
Stephens,Superintendent of Public Instruction,Joy Hofmeister,REP,690016,26,76,591,693,
Stephens,Superintendent of Public Instruction,John Cox,DEM,690016,23,24,240,287,
Stephens,Superintendent of Public Instruction,Larry Huff,IND,690016,0,8,61,69,
Stephens,Commissioner of Labor,Leslie Osborn,REP,690016,22,80,648,750,
Stephens,Commissioner of Labor,Fred Dorrell,DEM,690016,25,24,192,241,
Stephens,Commissioner of Labor,Brandt Dismukes,IND,690016,3,4,46,53,
Stephens,Insurance Commissioner,Glen Mulready,REP,690016,24,76,667,767,
Stephens,Insurance Commissioner,Kimberly Fobbs,DEM,690016,26,31,225,282,
Stephens,Corporation Commissioner,Bob Anthony,REP,690016,23,75,655,753,
Stephens,Corporation Commissioner,Ashley Nicole Mccray,DEM,690016,25,25,210,260,
Stephens,Corporation Commissioner,Jackie Short,IND,690016,2,7,30,39,
Stephens,U.S. House,Tom Cole,REP,690016,22,78,702,802,4
Stephens,U.S. House,Mary Brannon,DEM,690016,25,26,170,221,4
Stephens,U.S. House,Ruby Peters,IND,690016,1,5,27,33,4
Stephens,Governor,Chris Powell,LIB,690019,0,3,20,23,
Stephens,Governor,Kevin Stitt,REP,690019,26,74,593,693,
Stephens,Governor,Drew Edmondson,DEM,690019,10,37,280,327,
Stephens,Lieutenant Governor,Matt Pinnell,REP,690019,29,83,678,790,
Stephens,Lieutenant Governor,Anastasia Pittman,DEM,690019,7,29,199,235,
Stephens,Lieutenant Governor,Ivan Holmes,IND,690019,0,1,15,16,
Stephens,State Auditor,John Yeutter,LIB,690019,4,15,111,130,
Stephens,State Auditor,Cindy Byrd,REP,690019,30,89,727,846,
Stephens,Attorney General,Mike Hunter,REP,690019,30,85,684,799,
Stephens,Attorney General,Mark Myles,DEM,690019,6,29,202,237,
Stephens,State Treasurer,Randy Mcdaniel,REP,690019,29,90,706,825,
Stephens,State Treasurer,Charles De Coune,IND,690019,5,15,139,159,
Stephens,Superintendent of Public Instruction,Joy Hofmeister,REP,690019,27,72,599,698,
Stephens,Superintendent of Public Instruction,John Cox,DEM,690019,8,32,239,279,
Stephens,Superintendent of Public Instruction,Larry Huff,IND,690019,1,8,52,61,
Stephens,Commissioner of Labor,Leslie Osborn,REP,690019,28,78,662,768,
Stephens,Commissioner of Labor,Fred Dorrell,DEM,690019,8,27,196,231,
Stephens,Commissioner of Labor,Brandt Dismukes,IND,690019,0,3,24,27,
Stephens,Insurance Commissioner,Glen Mulready,REP,690019,28,82,644,754,
Stephens,Insurance Commissioner,Kimberly Fobbs,DEM,690019,8,33,233,274,
Stephens,Corporation Commissioner,Bob Anthony,REP,690019,29,86,660,775,
Stephens,Corporation Commissioner,Ashley Nicole Mccray,DEM,690019,7,25,192,224,
Stephens,Corporation Commissioner,Jackie Short,IND,690019,0,3,32,35,
Stephens,U.S. House,Tom Cole,REP,690019,29,88,684,801,4
Stephens,U.S. House,Mary Brannon,DEM,690019,7,26,193,226,4
Stephens,U.S. House,Ruby Peters,IND,690019,0,1,15,16,4
Stephens,Governor,Chris Powell,LIB,690032,1,0,19,20,
Stephens,Governor,Kevin Stitt,REP,690032,13,32,466,511,
Stephens,Governor,Drew Edmondson,DEM,690032,8,10,270,288,
Stephens,Lieutenant Governor,Matt Pinnell,REP,690032,15,30,523,568,
Stephens,Lieutenant Governor,Anastasia Pittman,DEM,690032,7,10,198,215,
Stephens,Lieutenant Governor,Ivan Holmes,IND,690032,0,2,28,30,
Stephens,State Auditor,John Yeutter,LIB,690032,4,4,128,136,
Stephens,State Auditor,Cindy Byrd,REP,690032,17,36,593,646,
Stephens,Attorney General,Mike Hunter,REP,690032,14,32,571,617,
Stephens,Attorney General,Mark Myles,DEM,690032,8,8,179,195,
Stephens,State Treasurer,Randy Mcdaniel,REP,690032,17,35,578,630,
Stephens,State Treasurer,Charles De Coune,IND,690032,4,5,146,155,
Stephens,Superintendent of Public Instruction,Joy Hofmeister,REP,690032,16,22,477,515,
Stephens,Superintendent of Public Instruction,John Cox,DEM,690032,6,11,219,236,
Stephens,Superintendent of Public Instruction,Larry Huff,IND,690032,0,9,58,67,
Stephens,Commissioner of Labor,Leslie Osborn,REP,690032,13,30,518,561,
Stephens,Commissioner of Labor,Fred Dorrell,DEM,690032,7,9,179,195,
Stephens,Commissioner of Labor,Brandt Dismukes,IND,690032,1,3,55,59,
Stephens,Insurance Commissioner,Glen Mulready,REP,690032,15,29,554,598,
Stephens,Insurance Commissioner,Kimberly Fobbs,DEM,690032,7,12,197,216,
Stephens,Corporation Commissioner,Bob Anthony,REP,690032,15,29,529,573,
Stephens,Corporation Commissioner,Ashley Nicole Mccray,DEM,690032,7,11,173,191,
Stephens,Corporation Commissioner,Jackie Short,IND,690032,0,2,47,49,
Stephens,U.S. House,Tom Cole,REP,690032,15,33,568,616,4
Stephens,U.S. House,Mary Brannon,DEM,690032,7,8,159,174,4
Stephens,U.S. House,Ruby Peters,IND,690032,0,0,28,28,4
Stephens,Governor,Chris Powell,LIB,690033,1,1,28,30,
Stephens,Governor,Kevin Stitt,REP,690033,33,60,610,703,
Stephens,Governor,Drew Edmondson,DEM,690033,21,30,281,332,
Stephens,Lieutenant Governor,Matt Pinnell,REP,690033,43,66,701,810,
Stephens,Lieutenant Governor,Anastasia Pittman,DEM,690033,11,22,189,222,
Stephens,Lieutenant Governor,Ivan Holmes,IND,690033,1,2,27,30,
Stephens,State Auditor,John Yeutter,LIB,690033,5,6,127,138,
Stephens,State Auditor,Cindy Byrd,REP,690033,44,77,752,873,
Stephens,Attorney General,Mike Hunter,REP,690033,43,73,717,833,
Stephens,Attorney General,Mark Myles,DEM,690033,11,17,197,225,
Stephens,State Treasurer,Randy Mcdaniel,REP,690033,46,76,768,890,
Stephens,State Treasurer,Charles De Coune,IND,690033,3,7,120,130,
Stephens,Superintendent of Public Instruction,Joy Hofmeister,REP,690033,34,70,609,713,
Stephens,Superintendent of Public Instruction,John Cox,DEM,690033,14,19,245,278,
Stephens,Superintendent of Public Instruction,Larry Huff,IND,690033,4,2,61,67,
Stephens,Commissioner of Labor,Leslie Osborn,REP,690033,41,68,663,772,
Stephens,Commissioner of Labor,Fred Dorrell,DEM,690033,9,20,204,233,
Stephens,Commissioner of Labor,Brandt Dismukes,IND,690033,2,2,43,47,
Stephens,Insurance Commissioner,Glen Mulready,REP,690033,39,63,670,772,
Stephens,Insurance Commissioner,Kimberly Fobbs,DEM,690033,15,25,236,276,
Stephens,Corporation Commissioner,Bob Anthony,REP,690033,37,70,681,788,
Stephens,Corporation Commissioner,Ashley Nicole Mccray,DEM,690033,14,19,197,230,
Stephens,Corporation Commissioner,Jackie Short,IND,690033,3,2,34,39,
Stephens,U.S. House,Tom Cole,REP,690033,43,71,725,839,4
Stephens,U.S. House,Mary Brannon,DEM,690033,13,18,162,193,4
Stephens,U.S. House,Ruby Peters,IND,690033,0,2,32,34,4
Stephens,Governor,Chris Powell,LIB,690041,2,0,17,19,
Stephens,Governor,Kevin Stitt,REP,690041,11,25,393,429,
Stephens,Governor,Drew Edmondson,DEM,690041,3,3,165,171,
Stephens,Lieutenant Governor,Matt Pinnell,REP,690041,15,26,423,464,
Stephens,Lieutenant Governor,Anastasia Pittman,DEM,690041,1,1,128,130,
Stephens,Lieutenant Governor,Ivan Holmes,IND,690041,0,1,25,26,
Stephens,State Auditor,John Yeutter,LIB,690041,0,2,83,85,
Stephens,State Auditor,Cindy Byrd,REP,690041,16,26,462,504,
Stephens,Attorney General,Mike Hunter,REP,690041,14,26,434,474,
Stephens,Attorney General,Mark Myles,DEM,690041,1,2,137,140,
Stephens,State Treasurer,Randy Mcdaniel,REP,690041,14,26,446,486,
Stephens,State Treasurer,Charles De Coune,IND,690041,1,2,97,100,
Stephens,Superintendent of Public Instruction,Joy Hofmeister,REP,690041,13,21,384,418,
Stephens,Superintendent of Public Instruction,John Cox,DEM,690041,1,3,156,160,
Stephens,Superintendent of Public Instruction,Larry Huff,IND,690041,1,4,34,39,
Stephens,Commissioner of Labor,Leslie Osborn,REP,690041,13,25,404,442,
Stephens,Commissioner of Labor,Fred Dorrell,DEM,690041,1,2,139,142,
Stephens,Commissioner of Labor,Brandt Dismukes,IND,690041,1,1,26,28,
Stephens,Insurance Commissioner,Glen Mulready,REP,690041,13,27,411,451,
Stephens,Insurance Commissioner,Kimberly Fobbs,DEM,690041,2,1,156,159,
Stephens,Corporation Commissioner,Bob Anthony,REP,690041,11,25,404,440,
Stephens,Corporation Commissioner,Ashley Nicole Mccray,DEM,690041,2,2,138,142,
Stephens,Corporation Commissioner,Jackie Short,IND,690041,3,1,26,30,
Stephens,U.S. House,Tom Cole,REP,690041,13,28,450,491,4
Stephens,U.S. House,Mary Brannon,DEM,690041,2,0,107,109,4
Stephens,U.S. House,Ruby Peters,IND,690041,1,0,15,16,4
Stephens,Governor,Chris Powell,LIB,690049,0,0,7,7,
Stephens,Governor,Kevin Stitt,REP,690049,2,0,80,82,
Stephens,Governor,Drew Edmondson,DEM,690049,1,3,29,33,
Stephens,Lieutenant Governor,Matt Pinnell,REP,690049,2,0,87,89,
Stephens,Lieutenant Governor,Anastasia Pittman,DEM,690049,1,3,26,30,
Stephens,Lieutenant Governor,Ivan Holmes,IND,690049,0,0,2,2,
Stephens,State Auditor,John Yeutter,LIB,690049,0,1,19,20,
Stephens,State Auditor,Cindy Byrd,REP,690049,2,2,93,97,
Stephens,Attorney General,Mike Hunter,REP,690049,0,0,86,86,
Stephens,Attorney General,Mark Myles,DEM,690049,3,3,30,36,
Stephens,State Treasurer,Randy Mcdaniel,REP,690049,2,2,86,90,
Stephens,State Treasurer,Charles De Coune,IND,690049,0,1,26,27,
Stephens,Superintendent of Public Instruction,Joy Hofmeister,REP,690049,0,0,70,70,
Stephens,Superintendent of Public Instruction,John Cox,DEM,690049,1,3,24,28,
Stephens,Superintendent of Public Instruction,Larry Huff,IND,690049,2,0,22,24,
Stephens,Commissioner of Labor,Leslie Osborn,REP,690049,2,0,82,84,
Stephens,Commissioner of Labor,Fred Dorrell,DEM,690049,1,3,28,32,
Stephens,Commissioner of Labor,Brandt Dismukes,IND,690049,0,0,5,5,
Stephens,Insurance Commissioner,Glen Mulready,REP,690049,0,0,86,86,
Stephens,Insurance Commissioner,Kimberly Fobbs,DEM,690049,3,3,29,35,
Stephens,Corporation Commissioner,Bob Anthony,REP,690049,2,0,79,81,
Stephens,Corporation Commissioner,Ashley Nicole Mccray,DEM,690049,1,3,23,27,
Stephens,Corporation Commissioner,Jackie Short,IND,690049,0,0,13,13,
Stephens,U.S. House,Tom Cole,REP,690049,2,0,92,94,4
Stephens,U.S. House,Mary Brannon,DEM,690049,1,2,23,26,4
Stephens,U.S. House,Ruby Peters,IND,690049,0,0,1,1,4
Stephens,Governor,Chris Powell,LIB,690050,0,2,23,25,
Stephens,Governor,Kevin Stitt,REP,690050,21,77,612,710,
Stephens,Governor,Drew Edmondson,DEM,690050,11,41,196,248,
Stephens,Lieutenant Governor,Matt Pinnell,REP,690050,21,90,660,771,
Stephens,Lieutenant Governor,Anastasia Pittman,DEM,690050,11,27,154,192,
Stephens,Lieutenant Governor,Ivan Holmes,IND,690050,0,2,14,16,
Stephens,State Auditor,John Yeutter,LIB,690050,7,10,107,124,
Stephens,State Auditor,Cindy Byrd,REP,690050,25,98,693,816,
Stephens,Attorney General,Mike Hunter,REP,690050,21,95,673,789,
Stephens,Attorney General,Mark Myles,DEM,690050,11,24,151,186,
Stephens,State Treasurer,Randy Mcdaniel,REP,690050,21,90,692,803,
Stephens,State Treasurer,Charles De Coune,IND,690050,11,19,106,136,
Stephens,Superintendent of Public Instruction,Joy Hofmeister,REP,690050,19,86,605,710,
Stephens,Superintendent of Public Instruction,John Cox,DEM,690050,10,31,164,205,
Stephens,Superintendent of Public Instruction,Larry Huff,IND,690050,3,2,56,61,
Stephens,Commissioner of Labor,Leslie Osborn,REP,690050,21,85,625,731,
Stephens,Commissioner of Labor,Fred Dorrell,DEM,690050,9,31,147,187,
Stephens,Commissioner of Labor,Brandt Dismukes,IND,690050,2,3,42,47,
Stephens,Insurance Commissioner,Glen Mulready,REP,690050,21,89,632,742,
Stephens,Insurance Commissioner,Kimberly Fobbs,DEM,690050,11,30,183,224,
Stephens,Corporation Commissioner,Bob Anthony,REP,690050,22,86,639,747,
Stephens,Corporation Commissioner,Ashley Nicole Mccray,DEM,690050,9,26,147,182,
Stephens,Corporation Commissioner,Jackie Short,IND,690050,1,6,34,41,
Stephens,U.S. House,Tom Cole,REP,690050,20,89,673,782,4
Stephens,U.S. House,Mary Brannon,DEM,690050,8,27,133,168,4
Stephens,U.S. House,Ruby Peters,IND,690050,4,4,23,31,4
Stephens,Governor,Chris Powell,LIB,690051,0,1,8,9,
Stephens,Governor,Kevin Stitt,REP,690051,2,18,212,232,
Stephens,Governor,Drew Edmondson,DEM,690051,1,3,65,69,
Stephens,Lieutenant Governor,Matt Pinnell,REP,690051,3,18,228,249,
Stephens,Lieutenant Governor,Anastasia Pittman,DEM,690051,0,3,46,49,
Stephens,Lieutenant Governor,Ivan Holmes,IND,690051,0,1,10,11,
Stephens,State Auditor,John Yeutter,LIB,690051,0,2,42,44,
Stephens,State Auditor,Cindy Byrd,REP,690051,3,20,238,261,
Stephens,Attorney General,Mike Hunter,REP,690051,2,18,236,256,
Stephens,Attorney General,Mark Myles,DEM,690051,1,4,47,52,
Stephens,State Treasurer,Randy Mcdaniel,REP,690051,3,19,247,269,
Stephens,State Treasurer,Charles De Coune,IND,690051,0,3,32,35,
Stephens,Superintendent of Public Instruction,Joy Hofmeister,REP,690051,2,14,200,216,
Stephens,Superintendent of Public Instruction,John Cox,DEM,690051,1,6,56,63,
Stephens,Superintendent of Public Instruction,Larry Huff,IND,690051,0,2,28,30,
Stephens,Commissioner of Labor,Leslie Osborn,REP,690051,3,17,220,240,
Stephens,Commissioner of Labor,Fred Dorrell,DEM,690051,0,2,44,46,
Stephens,Commissioner of Labor,Brandt Dismukes,IND,690051,0,3,20,23,
Stephens,Insurance Commissioner,Glen Mulready,REP,690051,2,20,228,250,
Stephens,Insurance Commissioner,Kimberly Fobbs,DEM,690051,1,2,55,58,
Stephens,Corporation Commissioner,Bob Anthony,REP,690051,2,16,224,242,
Stephens,Corporation Commissioner,Ashley Nicole Mccray,DEM,690051,0,4,42,46,
Stephens,Corporation Commissioner,Jackie Short,IND,690051,1,2,17,20,
Stephens,U.S. House,Tom Cole,REP,690051,3,18,236,257,4
Stephens,U.S. House,Mary Brannon,DEM,690051,0,3,36,39,4
Stephens,U.S. House,Ruby Peters,IND,690051,0,1,13,14,4
Stephens,State House,Toni Hasenbeck,REP,690051,2,16,224,242,65
Stephens,State House,Brandon Thompson,DEM,690051,1,6,57,64,65
Stephens,Governor,Chris Powell,LIB,690052,0,0,5,5,
Stephens,Governor,Kevin Stitt,REP,690052,1,15,91,107,
Stephens,Governor,Drew Edmondson,DEM,690052,6,2,43,51,
Stephens,Lieutenant Governor,Matt Pinnell,REP,690052,3,15,104,122,
Stephens,Lieutenant Governor,Anastasia Pittman,DEM,690052,4,2,29,35,
Stephens,Lieutenant Governor,Ivan Holmes,IND,690052,0,0,5,5,
Stephens,State Auditor,John Yeutter,LIB,690052,4,1,17,22,
Stephens,State Auditor,Cindy Byrd,REP,690052,3,16,117,136,
Stephens,Attorney General,Mike Hunter,REP,690052,4,15,114,133,
Stephens,Attorney General,Mark Myles,DEM,690052,3,2,24,29,
Stephens,State Treasurer,Randy Mcdaniel,REP,690052,3,15,115,133,
Stephens,State Treasurer,Charles De Coune,IND,690052,4,1,21,26,
Stephens,Superintendent of Public Instruction,Joy Hofmeister,REP,690052,4,16,96,116,
Stephens,Superintendent of Public Instruction,John Cox,DEM,690052,3,1,32,36,
Stephens,Superintendent of Public Instruction,Larry Huff,IND,690052,0,0,10,10,
Stephens,Commissioner of Labor,Leslie Osborn,REP,690052,3,15,103,121,
Stephens,Commissioner of Labor,Fred Dorrell,DEM,690052,4,2,26,32,
Stephens,Commissioner of Labor,Brandt Dismukes,IND,690052,0,0,9,9,
Stephens,Insurance Commissioner,Glen Mulready,REP,690052,3,15,105,123,
Stephens,Insurance Commissioner,Kimberly Fobbs,DEM,690052,4,2,31,37,
Stephens,Corporation Commissioner,Bob Anthony,REP,690052,3,15,102,120,
Stephens,Corporation Commissioner,Ashley Nicole Mccray,DEM,690052,4,1,30,35,
Stephens,Corporation Commissioner,Jackie Short,IND,690052,0,1,6,7,
Stephens,U.S. House,Tom Cole,REP,690052,3,15,108,126,4
Stephens,U.S. House,Mary Brannon,DEM,690052,4,2,26,32,4
Stephens,U.S. House,Ruby Peters,IND,690052,0,0,4,4,4
Stephens,Governor,Chris Powell,LIB,690053,0,0,1,1,
Stephens,Governor,Kevin Stitt,REP,690053,1,6,124,131,
Stephens,Governor,Drew Edmondson,DEM,690053,0,7,33,40,
Stephens,Lieutenant Governor,Matt Pinnell,REP,690053,1,9,123,133,
Stephens,Lieutenant Governor,Anastasia Pittman,DEM,690053,0,4,30,34,
Stephens,Lieutenant Governor,Ivan Holmes,IND,690053,0,0,3,3,
Stephens,State Auditor,John Yeutter,LIB,690053,0,4,18,22,
Stephens,State Auditor,Cindy Byrd,REP,690053,1,9,130,140,
Stephens,Attorney General,Mike Hunter,REP,690053,1,7,125,133,
Stephens,Attorney General,Mark Myles,DEM,690053,0,6,31,37,
Stephens,State Treasurer,Randy Mcdaniel,REP,690053,1,7,134,142,
Stephens,State Treasurer,Charles De Coune,IND,690053,0,6,14,20,
Stephens,Superintendent of Public Instruction,Joy Hofmeister,REP,690053,1,8,117,126,
Stephens,Superintendent of Public Instruction,John Cox,DEM,690053,0,5,30,35,
Stephens,Superintendent of Public Instruction,Larry Huff,IND,690053,0,0,9,9,
Stephens,Commissioner of Labor,Leslie Osborn,REP,690053,1,7,116,124,
Stephens,Commissioner of Labor,Fred Dorrell,DEM,690053,0,5,28,33,
Stephens,Commissioner of Labor,Brandt Dismukes,IND,690053,0,1,10,11,
Stephens,Insurance Commissioner,Glen Mulready,REP,690053,1,9,126,136,
Stephens,Insurance Commissioner,Kimberly Fobbs,DEM,690053,0,4,30,34,
Stephens,Corporation Commissioner,Bob Anthony,REP,690053,1,5,125,131,
Stephens,Corporation Commissioner,Ashley Nicole Mccray,DEM,690053,0,6,22,28,
Stephens,Corporation Commissioner,Jackie Short,IND,690053,0,2,9,11,
Stephens,U.S. House,Tom Cole,REP,690053,1,7,127,135,4
Stephens,U.S. House,Mary Brannon,DEM,690053,0,6,26,32,4
Stephens,U.S. House,Ruby Peters,IND,690053,0,0,4,4,4
Stephens,Governor,Chris Powell,LIB,690054,2,0,6,8,
Stephens,Governor,Kevin Stitt,REP,690054,5,10,132,147,
Stephens,Governor,Drew Edmondson,DEM,690054,0,3,66,69,
Stephens,Lieutenant Governor,Matt Pinnell,REP,690054,5,10,139,154,
Stephens,Lieutenant Governor,Anastasia Pittman,DEM,690054,1,3,57,61,
Stephens,Lieutenant Governor,Ivan Holmes,IND,690054,1,0,7,8,
Stephens,State Auditor,John Yeutter,LIB,690054,2,2,31,35,
Stephens,State Auditor,Cindy Byrd,REP,690054,5,10,167,182,
Stephens,Attorney General,Mike Hunter,REP,690054,6,9,153,168,
Stephens,Attorney General,Mark Myles,DEM,690054,1,3,51,55,
Stephens,State Treasurer,Randy Mcdaniel,REP,690054,5,10,162,177,
Stephens,State Treasurer,Charles De Coune,IND,690054,2,1,35,38,
Stephens,Superintendent of Public Instruction,Joy Hofmeister,REP,690054,3,10,120,133,
Stephens,Superintendent of Public Instruction,John Cox,DEM,690054,1,3,65,69,
Stephens,Superintendent of Public Instruction,Larry Huff,IND,690054,3,0,19,22,
Stephens,Commissioner of Labor,Leslie Osborn,REP,690054,4,10,142,156,
Stephens,Commissioner of Labor,Fred Dorrell,DEM,690054,0,3,51,54,
Stephens,Commissioner of Labor,Brandt Dismukes,IND,690054,3,0,11,14,
Stephens,Insurance Commissioner,Glen Mulready,REP,690054,5,10,145,160,
Stephens,Insurance Commissioner,Kimberly Fobbs,DEM,690054,2,3,59,64,
Stephens,Corporation Commissioner,Bob Anthony,REP,690054,4,9,147,160,
Stephens,Corporation Commissioner,Ashley Nicole Mccray,DEM,690054,1,3,47,51,
Stephens,Corporation Commissioner,Jackie Short,IND,690054,2,1,11,14,
Stephens,U.S. House,Tom Cole,REP,690054,5,10,151,166,4
Stephens,U.S. House,Mary Brannon,DEM,690054,1,3,47,51,4
Stephens,U.S. House,Ruby Peters,IND,690054,1,0,7,8,4
Stephens,Governor,Chris Powell,LIB,690055,0,0,4,4,
Stephens,Governor,Kevin Stitt,REP,690055,3,8,114,125,
Stephens,Governor,Drew Edmondson,DEM,690055,2,2,60,64,
Stephens,Lieutenant Governor,Matt Pinnell,REP,690055,3,8,125,136,
Stephens,Lieutenant Governor,Anastasia Pittman,DEM,690055,2,2,50,54,
Stephens,Lieutenant Governor,Ivan Holmes,IND,690055,0,0,3,3,
Stephens,State Auditor,John Yeutter,LIB,690055,1,1,30,32,
Stephens,State Auditor,Cindy Byrd,REP,690055,3,9,138,150,
Stephens,Attorney General,Mike Hunter,REP,690055,3,9,126,138,
Stephens,Attorney General,Mark Myles,DEM,690055,2,1,52,55,
Stephens,State Treasurer,Randy Mcdaniel,REP,690055,3,9,134,146,
Stephens,State Treasurer,Charles De Coune,IND,690055,1,1,33,35,
Stephens,Superintendent of Public Instruction,Joy Hofmeister,REP,690055,2,5,114,121,
Stephens,Superintendent of Public Instruction,John Cox,DEM,690055,3,4,53,60,
Stephens,Superintendent of Public Instruction,Larry Huff,IND,690055,0,1,10,11,
Stephens,Commissioner of Labor,Leslie Osborn,REP,690055,3,8,125,136,
Stephens,Commissioner of Labor,Fred Dorrell,DEM,690055,2,1,47,50,
Stephens,Commissioner of Labor,Brandt Dismukes,IND,690055,0,1,5,6,
Stephens,Insurance Commissioner,Glen Mulready,REP,690055,2,8,125,135,
Stephens,Insurance Commissioner,Kimberly Fobbs,DEM,690055,3,2,52,57,
Stephens,Corporation Commissioner,Bob Anthony,REP,690055,2,9,119,130,
Stephens,Corporation Commissioner,Ashley Nicole Mccray,DEM,690055,3,1,51,55,
Stephens,Corporation Commissioner,Jackie Short,IND,690055,0,0,8,8,
Stephens,U.S. House,Tom Cole,REP,690055,3,6,124,133,4
Stephens,U.S. House,Mary Brannon,DEM,690055,2,4,50,56,4
Stephens,U.S. House,Ruby Peters,IND,690055,0,0,4,4,4
Stephens,Governor,Chris Powell,LIB,690056,1,0,10,11,
Stephens,Governor,Kevin Stitt,REP,690056,4,7,206,217,
Stephens,Governor,Drew Edmondson,DEM,690056,1,5,47,53,
Stephens,Lieutenant Governor,Matt Pinnell,REP,690056,4,8,211,223,
Stephens,Lieutenant Governor,Anastasia Pittman,DEM,690056,1,4,44,49,
Stephens,Lieutenant Governor,Ivan Holmes,IND,690056,1,0,5,6,
Stephens,State Auditor,John Yeutter,LIB,690056,1,4,22,27,
Stephens,State Auditor,Cindy Byrd,REP,690056,4,8,232,244,
Stephens,Attorney General,Mike Hunter,REP,690056,4,7,220,231,
Stephens,Attorney General,Mark Myles,DEM,690056,1,5,40,46,
Stephens,State Treasurer,Randy Mcdaniel,REP,690056,4,8,223,235,
Stephens,State Treasurer,Charles De Coune,IND,690056,1,4,30,35,
Stephens,Superintendent of Public Instruction,Joy Hofmeister,REP,690056,4,7,182,193,
Stephens,Superintendent of Public Instruction,John Cox,DEM,690056,1,5,58,64,
Stephens,Superintendent of Public Instruction,Larry Huff,IND,690056,1,0,21,22,
Stephens,Commissioner of Labor,Leslie Osborn,REP,690056,4,8,205,217,
Stephens,Commissioner of Labor,Fred Dorrell,DEM,690056,1,4,46,51,
Stephens,Commissioner of Labor,Brandt Dismukes,IND,690056,1,0,9,10,
Stephens,Insurance Commissioner,Glen Mulready,REP,690056,4,7,201,212,
Stephens,Insurance Commissioner,Kimberly Fobbs,DEM,690056,1,5,56,62,
Stephens,Corporation Commissioner,Bob Anthony,REP,690056,4,7,206,217,
Stephens,Corporation Commissioner,Ashley Nicole Mccray,DEM,690056,1,5,42,48,
Stephens,Corporation Commissioner,Jackie Short,IND,690056,1,0,15,16,
Stephens,U.S. House,Tom Cole,REP,690056,4,8,222,234,4
Stephens,U.S. House,Mary Brannon,DEM,690056,1,4,35,40,4
Stephens,U.S. House,Ruby Peters,IND,690056,1,0,7,8,4
Stephens,Governor,Chris Powell,LIB,690057,2,1,20,23,
Stephens,Governor,Kevin Stitt,REP,690057,4,49,336,389,
Stephens,Governor,Drew Edmondson,DEM,690057,4,12,93,109,
Stephens,Lieutenant Governor,Matt Pinnell,REP,690057,7,53,364,424,
Stephens,Lieutenant Governor,Anastasia Pittman,DEM,690057,0,8,71,79,
Stephens,Lieutenant Governor,Ivan Holmes,IND,690057,3,1,13,17,
Stephens,State Auditor,John Yeutter,LIB,690057,3,7,58,68,
Stephens,State Auditor,Cindy Byrd,REP,690057,7,54,374,435,
Stephens,Attorney General,Mike Hunter,REP,690057,8,52,369,429,
Stephens,Attorney General,Mark Myles,DEM,690057,2,10,77,89,
Stephens,State Treasurer,Randy Mcdaniel,REP,690057,7,52,374,433,
Stephens,State Treasurer,Charles De Coune,IND,690057,3,9,56,68,
Stephens,Superintendent of Public Instruction,Joy Hofmeister,REP,690057,5,47,321,373,
Stephens,Superintendent of Public Instruction,John Cox,DEM,690057,2,9,82,93,
Stephens,Superintendent of Public Instruction,Larry Huff,IND,690057,3,5,43,51,
Stephens,Commissioner of Labor,Leslie Osborn,REP,690057,7,47,349,403,
Stephens,Commissioner of Labor,Fred Dorrell,DEM,690057,1,12,75,88,
Stephens,Commissioner of Labor,Brandt Dismukes,IND,690057,2,2,21,25,
Stephens,Insurance Commissioner,Glen Mulready,REP,690057,7,50,361,418,
Stephens,Insurance Commissioner,Kimberly Fobbs,DEM,690057,3,11,81,95,
Stephens,Corporation Commissioner,Bob Anthony,REP,690057,6,49,351,406,
Stephens,Corporation Commissioner,Ashley Nicole Mccray,DEM,690057,1,11,71,83,
Stephens,Corporation Commissioner,Jackie Short,IND,690057,3,2,24,29,
Stephens,U.S. House,Tom Cole,REP,690057,8,51,373,432,4
Stephens,U.S. House,Mary Brannon,DEM,690057,0,10,60,70,4
Stephens,U.S. House,Ruby Peters,IND,690057,2,1,15,18,4
Stephens,Governor,Chris Powell,LIB,690058,0,0,6,6,
Stephens,Governor,Kevin Stitt,REP,690058,2,3,216,221,
Stephens,Governor,Drew Edmondson,DEM,690058,0,0,54,54,
Stephens,Lieutenant Governor,Matt Pinnell,REP,690058,2,3,232,237,
Stephens,Lieutenant Governor,Anastasia Pittman,DEM,690058,0,0,35,35,
Stephens,Lieutenant Governor,Ivan Holmes,IND,690058,0,0,6,6,
Stephens,State Auditor,John Yeutter,LIB,690058,0,0,25,25,
Stephens,State Auditor,Cindy Byrd,REP,690058,2,3,246,251,
Stephens,Attorney General,Mike Hunter,REP,690058,2,3,234,239,
Stephens,Attorney General,Mark Myles,DEM,690058,0,0,39,39,
Stephens,State Treasurer,Randy Mcdaniel,REP,690058,2,3,246,251,
Stephens,State Treasurer,Charles De Coune,IND,690058,0,0,26,26,
Stephens,Superintendent of Public Instruction,Joy Hofmeister,REP,690058,2,2,205,209,
Stephens,Superintendent of Public Instruction,John Cox,DEM,690058,0,0,51,51,
Stephens,Superintendent of Public Instruction,Larry Huff,IND,690058,0,1,21,22,
Stephens,Commissioner of Labor,Leslie Osborn,REP,690058,2,2,229,233,
Stephens,Commissioner of Labor,Fred Dorrell,DEM,690058,0,0,31,31,
Stephens,Commissioner of Labor,Brandt Dismukes,IND,690058,0,1,11,12,
Stephens,Insurance Commissioner,Glen Mulready,REP,690058,2,3,232,237,
Stephens,Insurance Commissioner,Kimberly Fobbs,DEM,690058,0,0,40,40,
Stephens,Corporation Commissioner,Bob Anthony,REP,690058,2,3,230,235,
Stephens,Corporation Commissioner,Ashley Nicole Mccray,DEM,690058,0,0,34,34,
Stephens,Corporation Commissioner,Jackie Short,IND,690058,0,0,11,11,
Stephens,U.S. House,Tom Cole,REP,690058,2,2,241,245,4
Stephens,U.S. House,Mary Brannon,DEM,690058,0,0,31,31,4
Stephens,U.S. House,Ruby Peters,IND,690058,0,1,5,6,4
Stephens,Governor,Chris Powell,LIB,690059,0,0,9,9,
Stephens,Governor,Kevin Stitt,REP,690059,4,15,144,163,
Stephens,Governor,Drew Edmondson,DEM,690059,0,1,29,30,
Stephens,Lieutenant Governor,Matt Pinnell,REP,690059,4,15,149,168,
Stephens,Lieutenant Governor,Anastasia Pittman,DEM,690059,0,1,24,25,
Stephens,Lieutenant Governor,Ivan Holmes,IND,690059,0,0,7,7,
Stephens,State Auditor,John Yeutter,LIB,690059,1,1,22,24,
Stephens,State Auditor,Cindy Byrd,REP,690059,3,15,153,171,
Stephens,Attorney General,Mike Hunter,REP,690059,4,14,151,169,
Stephens,Attorney General,Mark Myles,DEM,690059,0,2,27,29,
Stephens,State Treasurer,Randy Mcdaniel,REP,690059,4,14,148,166,
Stephens,State Treasurer,Charles De Coune,IND,690059,0,1,28,29,
Stephens,Superintendent of Public Instruction,Joy Hofmeister,REP,690059,4,11,128,143,
Stephens,Superintendent of Public Instruction,John Cox,DEM,690059,0,1,33,34,
Stephens,Superintendent of Public Instruction,Larry Huff,IND,690059,0,2,19,21,
Stephens,Commissioner of Labor,Leslie Osborn,REP,690059,4,15,138,157,
Stephens,Commissioner of Labor,Fred Dorrell,DEM,690059,0,0,29,29,
Stephens,Commissioner of Labor,Brandt Dismukes,IND,690059,0,0,12,12,
Stephens,Insurance Commissioner,Glen Mulready,REP,690059,4,13,144,161,
Stephens,Insurance Commissioner,Kimberly Fobbs,DEM,690059,0,3,34,37,
Stephens,Corporation Commissioner,Bob Anthony,REP,690059,4,14,141,159,
Stephens,Corporation Commissioner,Ashley Nicole Mccray,DEM,690059,0,2,29,31,
Stephens,Corporation Commissioner,Jackie Short,IND,690059,0,0,11,11,
Stephens,U.S. House,Tom Cole,REP,690059,4,13,155,172,4
Stephens,U.S. House,Mary Brannon,DEM,690059,0,1,23,24,4
Stephens,U.S. House,Ruby Peters,IND,690059,0,0,4,4,4
Stephens,Governor,Chris Powell,LIB,690060,0,0,0,0,
Stephens,Governor,Kevin Stitt,REP,690060,1,3,15,19,
Stephens,Governor,Drew Edmondson,DEM,690060,0,2,5,7,
Stephens,Lieutenant Governor,Matt Pinnell,REP,690060,1,3,14,18,
Stephens,Lieutenant Governor,Anastasia Pittman,DEM,690060,0,2,5,7,
Stephens,Lieutenant Governor,Ivan Holmes,IND,690060,0,0,0,0,
Stephens,State Auditor,John Yeutter,LIB,690060,0,0,3,3,
Stephens,State Auditor,Cindy Byrd,REP,690060,1,3,17,21,
Stephens,Attorney General,Mike Hunter,REP,690060,1,3,14,18,
Stephens,Attorney General,Mark Myles,DEM,690060,0,2,6,8,
Stephens,State Treasurer,Randy Mcdaniel,REP,690060,1,3,16,20,
Stephens,State Treasurer,Charles De Coune,IND,690060,0,0,2,2,
Stephens,Superintendent of Public Instruction,Joy Hofmeister,REP,690060,1,3,15,19,
Stephens,Superintendent of Public Instruction,John Cox,DEM,690060,0,2,4,6,
Stephens,Superintendent of Public Instruction,Larry Huff,IND,690060,0,0,1,1,
Stephens,Commissioner of Labor,Leslie Osborn,REP,690060,1,3,14,18,
Stephens,Commissioner of Labor,Fred Dorrell,DEM,690060,0,2,5,7,
Stephens,Commissioner of Labor,Brandt Dismukes,IND,690060,0,0,1,1,
Stephens,Insurance Commissioner,Glen Mulready,REP,690060,1,3,14,18,
Stephens,Insurance Commissioner,Kimberly Fobbs,DEM,690060,0,2,6,8,
Stephens,Corporation Commissioner,Bob Anthony,REP,690060,1,3,15,19,
Stephens,Corporation Commissioner,Ashley Nicole Mccray,DEM,690060,0,2,5,7,
Stephens,Corporation Commissioner,Jackie Short,IND,690060,0,0,0,0,
Stephens,U.S. House,Tom Cole,REP,690060,1,3,15,19,4
Stephens,U.S. House,Mary Brannon,DEM,690060,0,2,5,7,4
Stephens,U.S. House,Ruby Peters,IND,690060,0,0,0,0,4
Stephens,State House,Toni Hasenbeck,REP,690060,1,3,14,18,65
Stephens,State House,Brandon Thompson,DEM,690060,0,2,6,8,65
Stephens,Governor,Chris Powell,LIB,690061,0,2,13,15,
Stephens,Governor,Kevin Stitt,REP,690061,8,28,348,384,
Stephens,Governor,Drew Edmondson,DEM,690061,2,7,121,130,
Stephens,Lieutenant Governor,Matt Pinnell,REP,690061,8,29,375,412,
Stephens,Lieutenant Governor,Anastasia Pittman,DEM,690061,2,7,85,94,
Stephens,Lieutenant Governor,Ivan Holmes,IND,690061,0,1,22,23,
Stephens,State Auditor,John Yeutter,LIB,690061,0,6,66,72,
Stephens,State Auditor,Cindy Byrd,REP,690061,8,30,401,439,
Stephens,Attorney General,Mike Hunter,REP,690061,8,30,385,423,
Stephens,Attorney General,Mark Myles,DEM,690061,2,7,92,101,
Stephens,State Treasurer,Randy Mcdaniel,REP,690061,8,32,392,432,
Stephens,State Treasurer,Charles De Coune,IND,690061,0,4,76,80,
Stephens,Superintendent of Public Instruction,Joy Hofmeister,REP,690061,8,27,345,380,
Stephens,Superintendent of Public Instruction,John Cox,DEM,690061,2,8,96,106,
Stephens,Superintendent of Public Instruction,Larry Huff,IND,690061,0,2,39,41,
Stephens,Commissioner of Labor,Leslie Osborn,REP,690061,8,28,352,388,
Stephens,Commissioner of Labor,Fred Dorrell,DEM,690061,2,7,94,103,
Stephens,Commissioner of Labor,Brandt Dismukes,IND,690061,0,1,32,33,
Stephens,Insurance Commissioner,Glen Mulready,REP,690061,8,28,370,406,
Stephens,Insurance Commissioner,Kimberly Fobbs,DEM,690061,2,8,104,114,
Stephens,Corporation Commissioner,Bob Anthony,REP,690061,8,27,370,405,
Stephens,Corporation Commissioner,Ashley Nicole Mccray,DEM,690061,2,9,80,91,
Stephens,Corporation Commissioner,Jackie Short,IND,690061,0,1,31,32,
Stephens,U.S. House,Tom Cole,REP,690061,8,30,388,426,4
Stephens,U.S. House,Mary Brannon,DEM,690061,2,6,72,80,4
Stephens,U.S. House,Ruby Peters,IND,690061,0,1,23,24,4
Stephens,Governor,Chris Powell,LIB,690062,2,1,9,12,
Stephens,Governor,Kevin Stitt,REP,690062,8,16,286,310,
Stephens,Governor,Drew Edmondson,DEM,690062,4,3,115,122,
Stephens,Lieutenant Governor,Matt Pinnell,REP,690062,8,16,303,327,
Stephens,Lieutenant Governor,Anastasia Pittman,DEM,690062,4,4,96,104,
Stephens,Lieutenant Governor,Ivan Holmes,IND,690062,2,0,9,11,
Stephens,State Auditor,John Yeutter,LIB,690062,4,2,54,60,
Stephens,State Auditor,Cindy Byrd,REP,690062,9,17,327,353,
Stephens,Attorney General,Mike Hunter,REP,690062,9,15,306,330,
Stephens,Attorney General,Mark Myles,DEM,690062,5,5,102,112,
Stephens,State Treasurer,Randy Mcdaniel,REP,690062,9,15,316,340,
Stephens,State Treasurer,Charles De Coune,IND,690062,4,4,62,70,
Stephens,Superintendent of Public Instruction,Joy Hofmeister,REP,690062,9,13,271,293,
Stephens,Superintendent of Public Instruction,John Cox,DEM,690062,3,6,112,121,
Stephens,Superintendent of Public Instruction,Larry Huff,IND,690062,2,1,23,26,
Stephens,Commissioner of Labor,Leslie Osborn,REP,690062,8,14,294,316,
Stephens,Commissioner of Labor,Fred Dorrell,DEM,690062,4,5,91,100,
Stephens,Commissioner of Labor,Brandt Dismukes,IND,690062,2,0,19,21,
Stephens,Insurance Commissioner,Glen Mulready,REP,690062,11,15,297,323,
Stephens,Insurance Commissioner,Kimberly Fobbs,DEM,690062,3,5,108,116,
Stephens,Corporation Commissioner,Bob Anthony,REP,690062,9,15,301,325,
Stephens,Corporation Commissioner,Ashley Nicole Mccray,DEM,690062,3,5,86,94,
Stephens,Corporation Commissioner,Jackie Short,IND,690062,2,0,21,23,
Stephens,U.S. House,Tom Cole,REP,690062,10,15,309,334,4
Stephens,U.S. House,Mary Brannon,DEM,690062,3,4,87,94,4
Stephens,U.S. House,Ruby Peters,IND,690062,1,1,13,15,4
Stephens,Governor,Chris Powell,LIB,690063,0,0,7,7,
Stephens,Governor,Kevin Stitt,REP,690063,4,13,195,212,
Stephens,Governor,Drew Edmondson,DEM,690063,3,5,51,59,
Stephens,Lieutenant Governor,Matt Pinnell,REP,690063,5,17,203,225,
Stephens,Lieutenant Governor,Anastasia Pittman,DEM,690063,1,1,41,43,
Stephens,Lieutenant Governor,Ivan Holmes,IND,690063,0,0,8,8,
Stephens,State Auditor,John Yeutter,LIB,690063,1,0,30,31,
Stephens,State Auditor,Cindy Byrd,REP,690063,6,18,214,238,
Stephens,Attorney General,Mike Hunter,REP,690063,6,14,206,226,
Stephens,Attorney General,Mark Myles,DEM,690063,1,4,44,49,
Stephens,State Treasurer,Randy Mcdaniel,REP,690063,5,16,205,226,
Stephens,State Treasurer,Charles De Coune,IND,690063,2,2,39,43,
Stephens,Superintendent of Public Instruction,Joy Hofmeister,REP,690063,5,13,190,208,
Stephens,Superintendent of Public Instruction,John Cox,DEM,690063,2,3,47,52,
Stephens,Superintendent of Public Instruction,Larry Huff,IND,690063,0,2,15,17,
Stephens,Commissioner of Labor,Leslie Osborn,REP,690063,3,14,193,210,
Stephens,Commissioner of Labor,Fred Dorrell,DEM,690063,1,2,43,46,
Stephens,Commissioner of Labor,Brandt Dismukes,IND,690063,3,2,14,19,
Stephens,Insurance Commissioner,Glen Mulready,REP,690063,6,16,198,220,
Stephens,Insurance Commissioner,Kimberly Fobbs,DEM,690063,1,2,52,55,
Stephens,Corporation Commissioner,Bob Anthony,REP,690063,6,17,192,215,
Stephens,Corporation Commissioner,Ashley Nicole Mccray,DEM,690063,1,1,42,44,
Stephens,Corporation Commissioner,Jackie Short,IND,690063,0,0,16,16,
Stephens,U.S. House,Tom Cole,REP,690063,6,18,206,230,4
Stephens,U.S. House,Mary Brannon,DEM,690063,1,0,34,35,4
Stephens,U.S. House,Ruby Peters,IND,690063,0,0,8,8,4
Stephens,State House,Toni Hasenbeck,REP,690063,3,17,202,222,65
Stephens,State House,Brandon Thompson,DEM,690063,3,1,48,52,65
Texas,Governor,Chris Powell,LIB,700101,0,0,17,17,
Texas,Governor,Kevin Stitt,REP,700101,29,17,427,473,
Texas,Governor,Drew Edmondson,DEM,700101,2,1,76,79,
Texas,Lieutenant Governor,Matt Pinnell,REP,700101,27,17,445,489,
Texas,Lieutenant Governor,Anastasia Pittman,DEM,700101,1,0,58,59,
Texas,Lieutenant Governor,Ivan Holmes,IND,700101,0,1,16,17,
Texas,State Auditor,John Yeutter,LIB,700101,0,1,56,57,
Texas,State Auditor,Cindy Byrd,REP,700101,25,16,452,493,
Texas,Attorney General,Mike Hunter,REP,700101,27,17,458,502,
Texas,Attorney General,Mark Myles,DEM,700101,1,1,61,63,
Texas,State Treasurer,Randy Mcdaniel,REP,700101,24,16,458,498,
Texas,State Treasurer,Charles De Coune,IND,700101,2,2,50,54,
Texas,Superintendent of Public Instruction,Joy Hofmeister,REP,700101,22,17,411,450,
Texas,Superintendent of Public Instruction,John Cox,DEM,700101,4,0,70,74,
Texas,Superintendent of Public Instruction,Larry Huff,IND,700101,3,1,34,38,
Texas,Commissioner of Labor,Leslie Osborn,REP,700101,24,17,444,485,
Texas,Commissioner of Labor,Fred Dorrell,DEM,700101,1,0,53,54,
Texas,Commissioner of Labor,Brandt Dismukes,IND,700101,1,1,18,20,
Texas,Insurance Commissioner,Glen Mulready,REP,700101,25,18,451,494,
Texas,Insurance Commissioner,Kimberly Fobbs,DEM,700101,1,0,66,67,
Texas,Corporation Commissioner,Bob Anthony,REP,700101,24,17,427,468,
Texas,Corporation Commissioner,Ashley Nicole Mccray,DEM,700101,2,0,67,69,
Texas,Corporation Commissioner,Jackie Short,IND,700101,2,1,23,26,
Texas,U.S. House,Frank Lucas,REP,700101,27,17,467,511,3
Texas,U.S. House,Frankie Robbins,DEM,700101,1,1,52,54,3
Texas,State House,Kenton Patzkowsky,REP,700101,24,16,369,409,61
Texas,State House,Ashley Lehnert,DEM,700101,5,2,147,154,61
Texas,Governor,Chris Powell,LIB,700102,1,2,12,15,
Texas,Governor,Kevin Stitt,REP,700102,4,15,131,150,
Texas,Governor,Drew Edmondson,DEM,700102,2,5,72,79,
Texas,Lieutenant Governor,Matt Pinnell,REP,700102,6,15,146,167,
Texas,Lieutenant Governor,Anastasia Pittman,DEM,700102,1,5,65,71,
Texas,Lieutenant Governor,Ivan Holmes,IND,700102,0,2,4,6,
Texas,State Auditor,John Yeutter,LIB,700102,1,3,47,51,
Texas,State Auditor,Cindy Byrd,REP,700102,6,17,157,180,
Texas,Attorney General,Mike Hunter,REP,700102,5,17,147,169,
Texas,Attorney General,Mark Myles,DEM,700102,2,5,66,73,
Texas,State Treasurer,Randy Mcdaniel,REP,700102,5,16,153,174,
Texas,State Treasurer,Charles De Coune,IND,700102,2,4,48,54,
Texas,Superintendent of Public Instruction,Joy Hofmeister,REP,700102,5,16,135,156,
Texas,Superintendent of Public Instruction,John Cox,DEM,700102,1,4,72,77,
Texas,Superintendent of Public Instruction,Larry Huff,IND,700102,1,2,8,11,
Texas,Commissioner of Labor,Leslie Osborn,REP,700102,5,13,148,166,
Texas,Commissioner of Labor,Fred Dorrell,DEM,700102,1,8,59,68,
Texas,Commissioner of Labor,Brandt Dismukes,IND,700102,1,1,6,8,
Texas,Insurance Commissioner,Glen Mulready,REP,700102,5,16,141,162,
Texas,Insurance Commissioner,Kimberly Fobbs,DEM,700102,2,6,72,80,
Texas,Corporation Commissioner,Bob Anthony,REP,700102,5,14,136,155,
Texas,Corporation Commissioner,Ashley Nicole Mccray,DEM,700102,1,6,61,68,
Texas,Corporation Commissioner,Jackie Short,IND,700102,1,1,14,16,
Texas,U.S. House,Frank Lucas,REP,700102,5,16,143,164,3
Texas,U.S. House,Frankie Robbins,DEM,700102,2,6,71,79,3
Texas,State House,Kenton Patzkowsky,REP,700102,6,14,133,153,61
Texas,State House,Ashley Lehnert,DEM,700102,1,8,83,92,61
Texas,Governor,Chris Powell,LIB,700104,0,0,10,10,
Texas,Governor,Kevin Stitt,REP,700104,17,5,227,249,
Texas,Governor,Drew Edmondson,DEM,700104,1,1,45,47,
Texas,Lieutenant Governor,Matt Pinnell,REP,700104,18,5,235,258,
Texas,Lieutenant Governor,Anastasia Pittman,DEM,700104,0,0,35,35,
Texas,Lieutenant Governor,Ivan Holmes,IND,700104,0,1,13,14,
Texas,State Auditor,John Yeutter,LIB,700104,0,1,30,31,
Texas,State Auditor,Cindy Byrd,REP,700104,17,5,245,267,
Texas,Attorney General,Mike Hunter,REP,700104,17,5,242,264,
Texas,Attorney General,Mark Myles,DEM,700104,1,1,41,43,
Texas,State Treasurer,Randy Mcdaniel,REP,700104,17,5,247,269,
Texas,State Treasurer,Charles De Coune,IND,700104,1,1,33,35,
Texas,Superintendent of Public Instruction,Joy Hofmeister,REP,700104,14,5,212,231,
Texas,Superintendent of Public Instruction,John Cox,DEM,700104,2,1,43,46,
Texas,Superintendent of Public Instruction,Larry Huff,IND,700104,1,0,27,28,
Texas,Commissioner of Labor,Leslie Osborn,REP,700104,17,5,237,259,
Texas,Commissioner of Labor,Fred Dorrell,DEM,700104,0,1,35,36,
Texas,Commissioner of Labor,Brandt Dismukes,IND,700104,1,0,9,10,
Texas,Insurance Commissioner,Glen Mulready,REP,700104,14,5,235,254,
Texas,Insurance Commissioner,Kimberly Fobbs,DEM,700104,4,1,46,51,
Texas,Corporation Commissioner,Bob Anthony,REP,700104,15,5,228,248,
Texas,Corporation Commissioner,Ashley Nicole Mccray,DEM,700104,1,1,37,39,
Texas,Corporation Commissioner,Jackie Short,IND,700104,2,0,17,19,
Texas,U.S. House,Frank Lucas,REP,700104,17,5,249,271,3
Texas,U.S. House,Frankie Robbins,DEM,700104,1,1,34,36,3
Texas,State House,Kenton Patzkowsky,REP,700104,14,5,193,212,61
Texas,State House,Ashley Lehnert,DEM,700104,4,1,91,96,61
Texas,Governor,Chris Powell,LIB,700107,0,0,5,5,
Texas,Governor,Kevin Stitt,REP,700107,5,8,94,107,
Texas,Governor,Drew Edmondson,DEM,700107,1,2,15,18,
Texas,Lieutenant Governor,Matt Pinnell,REP,700107,5,8,94,107,
Texas,Lieutenant Governor,Anastasia Pittman,DEM,700107,1,1,13,15,
Texas,Lieutenant Governor,Ivan Holmes,IND,700107,0,0,7,7,
Texas,State Auditor,John Yeutter,LIB,700107,0,1,13,14,
Texas,State Auditor,Cindy Byrd,REP,700107,6,9,99,114,
Texas,Attorney General,Mike Hunter,REP,700107,4,7,97,108,
Texas,Attorney General,Mark Myles,DEM,700107,2,3,17,22,
Texas,State Treasurer,Randy Mcdaniel,REP,700107,6,9,101,116,
Texas,State Treasurer,Charles De Coune,IND,700107,0,1,13,14,
Texas,Superintendent of Public Instruction,Joy Hofmeister,REP,700107,5,9,95,109,
Texas,Superintendent of Public Instruction,John Cox,DEM,700107,0,1,11,12,
Texas,Superintendent of Public Instruction,Larry Huff,IND,700107,1,0,8,9,
Texas,Commissioner of Labor,Leslie Osborn,REP,700107,6,8,99,113,
Texas,Commissioner of Labor,Fred Dorrell,DEM,700107,0,2,9,11,
Texas,Commissioner of Labor,Brandt Dismukes,IND,700107,0,0,7,7,
Texas,Insurance Commissioner,Glen Mulready,REP,700107,6,8,98,112,
Texas,Insurance Commissioner,Kimberly Fobbs,DEM,700107,0,2,15,17,
Texas,Corporation Commissioner,Bob Anthony,REP,700107,4,5,89,98,
Texas,Corporation Commissioner,Ashley Nicole Mccray,DEM,700107,1,5,20,26,
Texas,Corporation Commissioner,Jackie Short,IND,700107,1,0,6,7,
Texas,U.S. House,Frank Lucas,REP,700107,4,9,101,114,3
Texas,U.S. House,Frankie Robbins,DEM,700107,2,0,13,15,3
Texas,State House,Kenton Patzkowsky,REP,700107,3,7,78,88,61
Texas,State House,Ashley Lehnert,DEM,700107,3,3,36,42,61
Texas,Governor,Chris Powell,LIB,700201,1,1,12,14,
Texas,Governor,Kevin Stitt,REP,700201,19,85,374,478,
Texas,Governor,Drew Edmondson,DEM,700201,4,24,122,150,
Texas,Lieutenant Governor,Matt Pinnell,REP,700201,19,86,409,514,
Texas,Lieutenant Governor,Anastasia Pittman,DEM,700201,4,20,87,111,
Texas,Lieutenant Governor,Ivan Holmes,IND,700201,1,4,10,15,
Texas,State Auditor,John Yeutter,LIB,700201,2,8,53,63,
Texas,State Auditor,Cindy Byrd,REP,700201,18,95,434,547,
Texas,Attorney General,Mike Hunter,REP,700201,19,90,415,524,
Texas,Attorney General,Mark Myles,DEM,700201,4,20,91,115,
Texas,State Treasurer,Randy Mcdaniel,REP,700201,17,94,420,531,
Texas,State Treasurer,Charles De Coune,IND,700201,2,7,68,77,
Texas,Superintendent of Public Instruction,Joy Hofmeister,REP,700201,17,84,375,476,
Texas,Superintendent of Public Instruction,John Cox,DEM,700201,4,22,107,133,
Texas,Superintendent of Public Instruction,Larry Huff,IND,700201,2,5,22,29,
Texas,Commissioner of Labor,Leslie Osborn,REP,700201,19,89,413,521,
Texas,Commissioner of Labor,Fred Dorrell,DEM,700201,3,19,78,100,
Texas,Commissioner of Labor,Brandt Dismukes,IND,700201,1,2,15,18,
Texas,Insurance Commissioner,Glen Mulready,REP,700201,19,88,409,516,
Texas,Insurance Commissioner,Kimberly Fobbs,DEM,700201,4,23,98,125,
Texas,Corporation Commissioner,Bob Anthony,REP,700201,16,87,385,488,
Texas,Corporation Commissioner,Ashley Nicole Mccray,DEM,700201,4,19,109,132,
Texas,Corporation Commissioner,Jackie Short,IND,700201,3,4,12,19,
Texas,U.S. House,Frank Lucas,REP,700201,20,92,417,529,3
Texas,U.S. House,Frankie Robbins,DEM,700201,3,18,87,108,3
Texas,State House,Kenton Patzkowsky,REP,700201,20,77,324,421,61
Texas,State House,Ashley Lehnert,DEM,700201,4,33,182,219,61
Texas,Governor,Chris Powell,LIB,700202,0,1,10,11,
Texas,Governor,Kevin Stitt,REP,700202,14,31,145,190,
Texas,Governor,Drew Edmondson,DEM,700202,4,12,41,57,
Texas,Lieutenant Governor,Matt Pinnell,REP,700202,13,33,150,196,
Texas,Lieutenant Governor,Anastasia Pittman,DEM,700202,4,5,39,48,
Texas,Lieutenant Governor,Ivan Holmes,IND,700202,1,4,5,10,
Texas,State Auditor,John Yeutter,LIB,700202,2,6,27,35,
Texas,State Auditor,Cindy Byrd,REP,700202,15,34,160,209,
Texas,Attorney General,Mike Hunter,REP,700202,15,35,155,205,
Texas,Attorney General,Mark Myles,DEM,700202,3,8,38,49,
Texas,State Treasurer,Randy Mcdaniel,REP,700202,15,33,156,204,
Texas,State Treasurer,Charles De Coune,IND,700202,2,8,30,40,
Texas,Superintendent of Public Instruction,Joy Hofmeister,REP,700202,13,29,141,183,
Texas,Superintendent of Public Instruction,John Cox,DEM,700202,4,10,41,55,
Texas,Superintendent of Public Instruction,Larry Huff,IND,700202,1,2,10,13,
Texas,Commissioner of Labor,Leslie Osborn,REP,700202,15,33,150,198,
Texas,Commissioner of Labor,Fred Dorrell,DEM,700202,3,6,34,43,
Texas,Commissioner of Labor,Brandt Dismukes,IND,700202,0,2,7,9,
Texas,Insurance Commissioner,Glen Mulready,REP,700202,15,32,148,195,
Texas,Insurance Commissioner,Kimberly Fobbs,DEM,700202,3,9,42,54,
Texas,Corporation Commissioner,Bob Anthony,REP,700202,14,31,137,182,
Texas,Corporation Commissioner,Ashley Nicole Mccray,DEM,700202,4,8,39,51,
Texas,Corporation Commissioner,Jackie Short,IND,700202,0,2,15,17,
Texas,U.S. House,Frank Lucas,REP,700202,15,38,153,206,3
Texas,U.S. House,Frankie Robbins,DEM,700202,3,5,41,49,3
Texas,State House,Kenton Patzkowsky,REP,700202,13,25,130,168,61
Texas,State House,Ashley Lehnert,DEM,700202,5,18,64,87,61
Texas,Governor,Chris Powell,LIB,700205,0,1,16,17,
Texas,Governor,Kevin Stitt,REP,700205,18,97,353,468,
Texas,Governor,Drew Edmondson,DEM,700205,5,27,105,137,
Texas,Lieutenant Governor,Matt Pinnell,REP,700205,18,107,392,517,
Texas,Lieutenant Governor,Anastasia Pittman,DEM,700205,5,17,63,85,
Texas,Lieutenant Governor,Ivan Holmes,IND,700205,0,1,16,17,
Texas,State Auditor,John Yeutter,LIB,700205,3,13,49,65,
Texas,State Auditor,Cindy Byrd,REP,700205,20,109,412,541,
Texas,Attorney General,Mike Hunter,REP,700205,16,102,402,520,
Texas,Attorney General,Mark Myles,DEM,700205,7,23,68,98,
Texas,State Treasurer,Randy Mcdaniel,REP,700205,18,104,394,516,
Texas,State Treasurer,Charles De Coune,IND,700205,5,21,66,92,
Texas,Superintendent of Public Instruction,Joy Hofmeister,REP,700205,17,98,371,486,
Texas,Superintendent of Public Instruction,John Cox,DEM,700205,5,23,66,94,
Texas,Superintendent of Public Instruction,Larry Huff,IND,700205,1,3,33,37,
Texas,Commissioner of Labor,Leslie Osborn,REP,700205,16,112,407,535,
Texas,Commissioner of Labor,Fred Dorrell,DEM,700205,7,13,45,65,
Texas,Commissioner of Labor,Brandt Dismukes,IND,700205,0,0,14,14,
Texas,Insurance Commissioner,Glen Mulready,REP,700205,16,102,394,512,
Texas,Insurance Commissioner,Kimberly Fobbs,DEM,700205,7,22,70,99,
Texas,Corporation Commissioner,Bob Anthony,REP,700205,17,105,360,482,
Texas,Corporation Commissioner,Ashley Nicole Mccray,DEM,700205,4,18,81,103,
Texas,Corporation Commissioner,Jackie Short,IND,700205,2,1,28,31,
Texas,U.S. House,Frank Lucas,REP,700205,17,110,404,531,3
Texas,U.S. House,Frankie Robbins,DEM,700205,5,15,67,87,3
Texas,State House,Kenton Patzkowsky,REP,700205,17,85,319,421,61
Texas,State House,Ashley Lehnert,DEM,700205,6,40,155,201,61
Texas,Governor,Chris Powell,LIB,700302,0,0,2,2,
Texas,Governor,Kevin Stitt,REP,700302,8,14,78,100,
Texas,Governor,Drew Edmondson,DEM,700302,0,5,16,21,
Texas,Lieutenant Governor,Matt Pinnell,REP,700302,8,16,83,107,
Texas,Lieutenant Governor,Anastasia Pittman,DEM,700302,0,2,9,11,
Texas,Lieutenant Governor,Ivan Holmes,IND,700302,0,1,4,5,
Texas,State Auditor,John Yeutter,LIB,700302,0,1,13,14,
Texas,State Auditor,Cindy Byrd,REP,700302,8,17,82,107,
Texas,Attorney General,Mike Hunter,REP,700302,8,14,83,105,
Texas,Attorney General,Mark Myles,DEM,700302,0,5,13,18,
Texas,State Treasurer,Randy Mcdaniel,REP,700302,8,17,85,110,
Texas,State Treasurer,Charles De Coune,IND,700302,0,1,10,11,
Texas,Superintendent of Public Instruction,Joy Hofmeister,REP,700302,6,16,77,99,
Texas,Superintendent of Public Instruction,John Cox,DEM,700302,0,3,15,18,
Texas,Superintendent of Public Instruction,Larry Huff,IND,700302,2,0,2,4,
Texas,Commissioner of Labor,Leslie Osborn,REP,700302,8,16,83,107,
Texas,Commissioner of Labor,Fred Dorrell,DEM,700302,0,3,12,15,
Texas,Commissioner of Labor,Brandt Dismukes,IND,700302,0,0,0,0,
Texas,Insurance Commissioner,Glen Mulready,REP,700302,8,16,83,107,
Texas,Insurance Commissioner,Kimberly Fobbs,DEM,700302,0,3,11,14,
Texas,Corporation Commissioner,Bob Anthony,REP,700302,6,16,81,103,
Texas,Corporation Commissioner,Ashley Nicole Mccray,DEM,700302,0,3,11,14,
Texas,Corporation Commissioner,Jackie Short,IND,700302,2,0,4,6,
Texas,U.S. House,Frank Lucas,REP,700302,8,16,87,111,3
Texas,U.S. House,Frankie Robbins,DEM,700302,0,3,9,12,3
Texas,State House,Kenton Patzkowsky,REP,700302,5,13,73,91,61
Texas,State House,Ashley Lehnert,DEM,700302,3,6,23,32,61
Texas,Governor,Chris Powell,LIB,700303,0,0,9,9,
Texas,Governor,Kevin Stitt,REP,700303,9,12,200,221,
Texas,Governor,Drew Edmondson,DEM,700303,3,4,38,45,
Texas,Lieutenant Governor,Matt Pinnell,REP,700303,9,12,206,227,
Texas,Lieutenant Governor,Anastasia Pittman,DEM,700303,3,4,29,36,
Texas,Lieutenant Governor,Ivan Holmes,IND,700303,0,0,9,9,
Texas,State Auditor,John Yeutter,LIB,700303,2,3,18,23,
Texas,State Auditor,Cindy Byrd,REP,700303,9,12,217,238,
Texas,Attorney General,Mike Hunter,REP,700303,9,12,221,242,
Texas,Attorney General,Mark Myles,DEM,700303,3,4,23,30,
Texas,State Treasurer,Randy Mcdaniel,REP,700303,8,14,217,239,
Texas,State Treasurer,Charles De Coune,IND,700303,3,1,15,19,
Texas,Superintendent of Public Instruction,Joy Hofmeister,REP,700303,8,13,207,228,
Texas,Superintendent of Public Instruction,John Cox,DEM,700303,4,3,28,35,
Texas,Superintendent of Public Instruction,Larry Huff,IND,700303,0,0,10,10,
Texas,Commissioner of Labor,Leslie Osborn,REP,700303,9,12,210,231,
Texas,Commissioner of Labor,Fred Dorrell,DEM,700303,3,4,28,35,
Texas,Commissioner of Labor,Brandt Dismukes,IND,700303,0,0,5,5,
Texas,Insurance Commissioner,Glen Mulready,REP,700303,8,12,209,229,
Texas,Insurance Commissioner,Kimberly Fobbs,DEM,700303,4,4,33,41,
Texas,Corporation Commissioner,Bob Anthony,REP,700303,8,12,205,225,
Texas,Corporation Commissioner,Ashley Nicole Mccray,DEM,700303,4,4,28,36,
Texas,Corporation Commissioner,Jackie Short,IND,700303,0,0,11,11,
Texas,U.S. House,Frank Lucas,REP,700303,8,12,222,242,3
Texas,U.S. House,Frankie Robbins,DEM,700303,4,4,23,31,3
Texas,State House,Kenton Patzkowsky,REP,700303,7,11,187,205,61
Texas,State House,Ashley Lehnert,DEM,700303,5,5,59,69,61
Texas,Governor,Chris Powell,LIB,700304,0,0,9,9,
Texas,Governor,Kevin Stitt,REP,700304,6,11,170,187,
Texas,Governor,Drew Edmondson,DEM,700304,2,5,90,97,
Texas,Lieutenant Governor,Matt Pinnell,REP,700304,6,12,192,210,
Texas,Lieutenant Governor,Anastasia Pittman,DEM,700304,2,3,62,67,
Texas,Lieutenant Governor,Ivan Holmes,IND,700304,0,1,13,14,
Texas,State Auditor,John Yeutter,LIB,700304,1,0,59,60,
Texas,State Auditor,Cindy Byrd,REP,700304,7,16,199,222,
Texas,Attorney General,Mike Hunter,REP,700304,6,13,203,222,
Texas,Attorney General,Mark Myles,DEM,700304,2,3,62,67,
Texas,State Treasurer,Randy Mcdaniel,REP,700304,6,14,199,219,
Texas,State Treasurer,Charles De Coune,IND,700304,2,1,59,62,
Texas,Superintendent of Public Instruction,Joy Hofmeister,REP,700304,6,11,187,204,
Texas,Superintendent of Public Instruction,John Cox,DEM,700304,2,5,57,64,
Texas,Superintendent of Public Instruction,Larry Huff,IND,700304,0,0,23,23,
Texas,Commissioner of Labor,Leslie Osborn,REP,700304,6,14,197,217,
Texas,Commissioner of Labor,Fred Dorrell,DEM,700304,2,2,54,58,
Texas,Commissioner of Labor,Brandt Dismukes,IND,700304,0,0,12,12,
Texas,Insurance Commissioner,Glen Mulready,REP,700304,6,11,188,205,
Texas,Insurance Commissioner,Kimberly Fobbs,DEM,700304,2,5,74,81,
Texas,Corporation Commissioner,Bob Anthony,REP,700304,6,11,173,190,
Texas,Corporation Commissioner,Ashley Nicole Mccray,DEM,700304,2,5,62,69,
Texas,Corporation Commissioner,Jackie Short,IND,700304,0,0,28,28,
Texas,U.S. House,Frank Lucas,REP,700304,8,13,202,223,3
Texas,U.S. House,Frankie Robbins,DEM,700304,0,3,64,67,3
Texas,State House,Kenton Patzkowsky,REP,700304,6,9,161,176,61
Texas,State House,Ashley Lehnert,DEM,700304,2,7,107,116,61
Texas,Governor,Chris Powell,LIB,700305,2,2,34,38,
Texas,Governor,Kevin Stitt,REP,700305,14,63,397,474,
Texas,Governor,Drew Edmondson,DEM,700305,3,20,141,164,
Texas,Lieutenant Governor,Matt Pinnell,REP,700305,13,69,443,525,
Texas,Lieutenant Governor,Anastasia Pittman,DEM,700305,5,14,105,124,
Texas,Lieutenant Governor,Ivan Holmes,IND,700305,0,2,23,25,
Texas,State Auditor,John Yeutter,LIB,700305,3,11,71,85,
Texas,State Auditor,Cindy Byrd,REP,700305,15,73,475,563,
Texas,Attorney General,Mike Hunter,REP,700305,14,71,452,537,
Texas,Attorney General,Mark Myles,DEM,700305,4,14,116,134,
Texas,State Treasurer,Randy Mcdaniel,REP,700305,13,70,440,523,
Texas,State Treasurer,Charles De Coune,IND,700305,5,13,103,121,
Texas,Superintendent of Public Instruction,Joy Hofmeister,REP,700305,14,71,396,481,
Texas,Superintendent of Public Instruction,John Cox,DEM,700305,3,13,135,151,
Texas,Superintendent of Public Instruction,Larry Huff,IND,700305,1,1,43,45,
Texas,Commissioner of Labor,Leslie Osborn,REP,700305,15,69,439,523,
Texas,Commissioner of Labor,Fred Dorrell,DEM,700305,2,13,106,121,
Texas,Commissioner of Labor,Brandt Dismukes,IND,700305,1,2,26,29,
Texas,Insurance Commissioner,Glen Mulready,REP,700305,13,70,441,524,
Texas,Insurance Commissioner,Kimberly Fobbs,DEM,700305,5,14,130,149,
Texas,Corporation Commissioner,Bob Anthony,REP,700305,13,61,404,478,
Texas,Corporation Commissioner,Ashley Nicole Mccray,DEM,700305,3,16,128,147,
Texas,Corporation Commissioner,Jackie Short,IND,700305,2,7,37,46,
Texas,U.S. House,Frank Lucas,REP,700305,13,70,454,537,3
Texas,U.S. House,Frankie Robbins,DEM,700305,5,15,119,139,3
Texas,State House,Kenton Patzkowsky,REP,700305,11,60,359,430,61
Texas,State House,Ashley Lehnert,DEM,700305,7,25,217,249,61
Tillman,Governor,Chris Powell,LIB,710001,0,2,5,7,
Tillman,Governor,Kevin Stitt,REP,710001,8,64,243,315,
Tillman,Governor,Drew Edmondson,DEM,710001,12,35,113,160,
Tillman,Lieutenant Governor,Matt Pinnell,REP,710001,9,73,262,344,
Tillman,Lieutenant Governor,Anastasia Pittman,DEM,710001,8,23,85,116,
Tillman,Lieutenant Governor,Ivan Holmes,IND,710001,1,1,7,9,
Tillman,State Auditor,John Yeutter,LIB,710001,4,8,57,69,
Tillman,State Auditor,Cindy Byrd,REP,710001,9,83,279,371,
Tillman,Attorney General,Mike Hunter,REP,710001,10,78,267,355,
Tillman,Attorney General,Mark Myles,DEM,710001,7,16,85,108,
Tillman,State Treasurer,Randy Mcdaniel,REP,710001,11,82,283,376,
Tillman,State Treasurer,Charles De Coune,IND,710001,3,9,49,61,
Tillman,Superintendent of Public Instruction,Joy Hofmeister,REP,710001,8,71,242,321,
Tillman,Superintendent of Public Instruction,John Cox,DEM,710001,9,22,92,123,
Tillman,Superintendent of Public Instruction,Larry Huff,IND,710001,1,5,24,30,
Tillman,Commissioner of Labor,Leslie Osborn,REP,710001,10,77,257,344,
Tillman,Commissioner of Labor,Fred Dorrell,DEM,710001,7,19,78,104,
Tillman,Commissioner of Labor,Brandt Dismukes,IND,710001,1,0,15,16,
Tillman,Insurance Commissioner,Glen Mulready,REP,710001,8,73,252,333,
Tillman,Insurance Commissioner,Kimberly Fobbs,DEM,710001,9,24,96,129,
Tillman,Corporation Commissioner,Bob Anthony,REP,710001,9,77,268,354,
Tillman,Corporation Commissioner,Ashley Nicole Mccray,DEM,710001,9,18,76,103,
Tillman,Corporation Commissioner,Jackie Short,IND,710001,0,1,11,12,
Tillman,U.S. House,Tom Cole,REP,710001,11,86,285,382,4
Tillman,U.S. House,Mary Brannon,DEM,710001,8,15,69,92,4
Tillman,U.S. House,Ruby Peters,IND,710001,0,0,6,6,4
Tillman,State House,Trey Caldwell,REP,710001,13,84,301,398,63
Tillman,State House,Joan Gabelmann,DEM,710001,7,17,59,83,63
Tillman,Governor,Chris Powell,LIB,710002,0,1,12,13,
Tillman,Governor,Kevin Stitt,REP,710002,5,20,122,147,
Tillman,Governor,Drew Edmondson,DEM,710002,1,16,72,89,
Tillman,Lieutenant Governor,Matt Pinnell,REP,710002,5,25,133,163,
Tillman,Lieutenant Governor,Anastasia Pittman,DEM,710002,1,11,63,75,
Tillman,Lieutenant Governor,Ivan Holmes,IND,710002,0,1,6,7,
Tillman,State Auditor,John Yeutter,LIB,710002,0,8,46,54,
Tillman,State Auditor,Cindy Byrd,REP,710002,6,26,143,175,
Tillman,Attorney General,Mike Hunter,REP,710002,5,23,140,168,
Tillman,Attorney General,Mark Myles,DEM,710002,1,13,62,76,
Tillman,State Treasurer,Randy Mcdaniel,REP,710002,5,24,143,172,
Tillman,State Treasurer,Charles De Coune,IND,710002,1,11,46,58,
Tillman,Superintendent of Public Instruction,Joy Hofmeister,REP,710002,4,22,121,147,
Tillman,Superintendent of Public Instruction,John Cox,DEM,710002,0,15,65,80,
Tillman,Superintendent of Public Instruction,Larry Huff,IND,710002,2,0,18,20,
Tillman,Commissioner of Labor,Leslie Osborn,REP,710002,4,23,129,156,
Tillman,Commissioner of Labor,Fred Dorrell,DEM,710002,1,14,60,75,
Tillman,Commissioner of Labor,Brandt Dismukes,IND,710002,1,0,12,13,
Tillman,Insurance Commissioner,Glen Mulready,REP,710002,4,20,133,157,
Tillman,Insurance Commissioner,Kimberly Fobbs,DEM,710002,2,16,69,87,
Tillman,Corporation Commissioner,Bob Anthony,REP,710002,4,23,128,155,
Tillman,Corporation Commissioner,Ashley Nicole Mccray,DEM,710002,2,13,65,80,
Tillman,Corporation Commissioner,Jackie Short,IND,710002,0,0,11,11,
Tillman,U.S. House,Tom Cole,REP,710002,6,22,144,172,4
Tillman,U.S. House,Mary Brannon,DEM,710002,0,14,54,68,4
Tillman,U.S. House,Ruby Peters,IND,710002,0,0,8,8,4
Tillman,State House,Trey Caldwell,REP,710002,5,29,150,184,63
Tillman,State House,Joan Gabelmann,DEM,710002,1,8,55,64,63
Tillman,Governor,Chris Powell,LIB,710003,0,0,1,1,
Tillman,Governor,Kevin Stitt,REP,710003,0,17,54,71,
Tillman,Governor,Drew Edmondson,DEM,710003,2,4,43,49,
Tillman,Lieutenant Governor,Matt Pinnell,REP,710003,1,17,57,75,
Tillman,Lieutenant Governor,Anastasia Pittman,DEM,710003,0,4,36,40,
Tillman,Lieutenant Governor,Ivan Holmes,IND,710003,0,0,3,3,
Tillman,State Auditor,John Yeutter,LIB,710003,0,3,22,25,
Tillman,State Auditor,Cindy Byrd,REP,710003,1,17,63,81,
Tillman,Attorney General,Mike Hunter,REP,710003,1,15,60,76,
Tillman,Attorney General,Mark Myles,DEM,710003,0,5,36,41,
Tillman,State Treasurer,Randy Mcdaniel,REP,710003,1,17,65,83,
Tillman,State Treasurer,Charles De Coune,IND,710003,0,3,21,24,
Tillman,Superintendent of Public Instruction,Joy Hofmeister,REP,710003,0,15,50,65,
Tillman,Superintendent of Public Instruction,John Cox,DEM,710003,1,6,45,52,
Tillman,Superintendent of Public Instruction,Larry Huff,IND,710003,0,0,3,3,
Tillman,Commissioner of Labor,Leslie Osborn,REP,710003,1,17,57,75,
Tillman,Commissioner of Labor,Fred Dorrell,DEM,710003,0,4,37,41,
Tillman,Commissioner of Labor,Brandt Dismukes,IND,710003,0,0,0,0,
Tillman,Insurance Commissioner,Glen Mulready,REP,710003,1,17,56,74,
Tillman,Insurance Commissioner,Kimberly Fobbs,DEM,710003,0,4,37,41,
Tillman,Corporation Commissioner,Bob Anthony,REP,710003,2,15,58,75,
Tillman,Corporation Commissioner,Ashley Nicole Mccray,DEM,710003,0,5,31,36,
Tillman,Corporation Commissioner,Jackie Short,IND,710003,0,1,5,6,
Tillman,U.S. House,Tom Cole,REP,710003,1,17,65,83,4
Tillman,U.S. House,Mary Brannon,DEM,710003,1,4,31,36,4
Tillman,U.S. House,Ruby Peters,IND,710003,0,0,1,1,4
Tillman,State House,Trey Caldwell,REP,710003,2,17,60,79,63
Tillman,State House,Joan Gabelmann,DEM,710003,0,4,36,40,63
Tillman,Governor,Chris Powell,LIB,710004,0,2,6,8,
Tillman,Governor,Kevin Stitt,REP,710004,0,22,72,94,
Tillman,Governor,Drew Edmondson,DEM,710004,2,12,63,77,
Tillman,Lieutenant Governor,Matt Pinnell,REP,710004,0,23,82,105,
Tillman,Lieutenant Governor,Anastasia Pittman,DEM,710004,2,9,52,63,
Tillman,Lieutenant Governor,Ivan Holmes,IND,710004,0,2,7,9,
Tillman,State Auditor,John Yeutter,LIB,710004,0,7,37,44,
Tillman,State Auditor,Cindy Byrd,REP,710004,1,27,94,122,
Tillman,Attorney General,Mike Hunter,REP,710004,0,27,87,114,
Tillman,Attorney General,Mark Myles,DEM,710004,2,8,54,64,
Tillman,State Treasurer,Randy Mcdaniel,REP,710004,1,26,98,125,
Tillman,State Treasurer,Charles De Coune,IND,710004,0,8,32,40,
Tillman,Superintendent of Public Instruction,Joy Hofmeister,REP,710004,1,25,84,110,
Tillman,Superintendent of Public Instruction,John Cox,DEM,710004,1,8,48,57,
Tillman,Superintendent of Public Instruction,Larry Huff,IND,710004,0,2,9,11,
Tillman,Commissioner of Labor,Leslie Osborn,REP,710004,0,24,83,107,
Tillman,Commissioner of Labor,Fred Dorrell,DEM,710004,2,10,50,62,
Tillman,Commissioner of Labor,Brandt Dismukes,IND,710004,0,1,8,9,
Tillman,Insurance Commissioner,Glen Mulready,REP,710004,0,24,83,107,
Tillman,Insurance Commissioner,Kimberly Fobbs,DEM,710004,2,11,59,72,
Tillman,Corporation Commissioner,Bob Anthony,REP,710004,1,25,81,107,
Tillman,Corporation Commissioner,Ashley Nicole Mccray,DEM,710004,1,9,52,62,
Tillman,Corporation Commissioner,Jackie Short,IND,710004,0,2,9,11,
Tillman,U.S. House,Tom Cole,REP,710004,0,27,93,120,4
Tillman,U.S. House,Mary Brannon,DEM,710004,2,8,44,54,4
Tillman,U.S. House,Ruby Peters,IND,710004,0,1,5,6,4
Tillman,State House,Trey Caldwell,REP,710004,1,28,97,126,63
Tillman,State House,Joan Gabelmann,DEM,710004,1,8,45,54,63
Tillman,Governor,Chris Powell,LIB,710006,1,0,1,2,
Tillman,Governor,Kevin Stitt,REP,710006,7,9,73,89,
Tillman,Governor,Drew Edmondson,DEM,710006,0,3,26,29,
Tillman,Lieutenant Governor,Matt Pinnell,REP,710006,7,9,79,95,
Tillman,Lieutenant Governor,Anastasia Pittman,DEM,710006,1,3,20,24,
Tillman,Lieutenant Governor,Ivan Holmes,IND,710006,0,0,1,1,
Tillman,State Auditor,John Yeutter,LIB,710006,0,1,10,11,
Tillman,State Auditor,Cindy Byrd,REP,710006,8,11,87,106,
Tillman,Attorney General,Mike Hunter,REP,710006,7,10,78,95,
Tillman,Attorney General,Mark Myles,DEM,710006,1,2,22,25,
Tillman,State Treasurer,Randy Mcdaniel,REP,710006,8,11,84,103,
Tillman,State Treasurer,Charles De Coune,IND,710006,0,1,14,15,
Tillman,Superintendent of Public Instruction,Joy Hofmeister,REP,710006,8,8,68,84,
Tillman,Superintendent of Public Instruction,John Cox,DEM,710006,0,4,27,31,
Tillman,Superintendent of Public Instruction,Larry Huff,IND,710006,0,0,4,4,
Tillman,Commissioner of Labor,Leslie Osborn,REP,710006,7,9,71,87,
Tillman,Commissioner of Labor,Fred Dorrell,DEM,710006,1,3,27,31,
Tillman,Commissioner of Labor,Brandt Dismukes,IND,710006,0,0,1,1,
Tillman,Insurance Commissioner,Glen Mulready,REP,710006,7,8,76,91,
Tillman,Insurance Commissioner,Kimberly Fobbs,DEM,710006,1,4,24,29,
Tillman,Corporation Commissioner,Bob Anthony,REP,710006,8,10,76,94,
Tillman,Corporation Commissioner,Ashley Nicole Mccray,DEM,710006,0,2,23,25,
Tillman,Corporation Commissioner,Jackie Short,IND,710006,0,0,0,0,
Tillman,U.S. House,Tom Cole,REP,710006,7,11,87,105,4
Tillman,U.S. House,Mary Brannon,DEM,710006,1,1,12,14,4
Tillman,U.S. House,Ruby Peters,IND,710006,0,0,1,1,4
Tillman,State House,Trey Caldwell,REP,710006,7,11,82,100,63
Tillman,State House,Joan Gabelmann,DEM,710006,1,1,15,17,63
Tillman,Governor,Chris Powell,LIB,710007,0,1,10,11,
Tillman,Governor,Kevin Stitt,REP,710007,1,6,195,202,
Tillman,Governor,Drew Edmondson,DEM,710007,0,1,83,84,
Tillman,Lieutenant Governor,Matt Pinnell,REP,710007,1,7,200,208,
Tillman,Lieutenant Governor,Anastasia Pittman,DEM,710007,0,1,73,74,
Tillman,Lieutenant Governor,Ivan Holmes,IND,710007,0,0,12,12,
Tillman,State Auditor,John Yeutter,LIB,710007,0,0,47,47,
Tillman,State Auditor,Cindy Byrd,REP,710007,1,8,220,229,
Tillman,Attorney General,Mike Hunter,REP,710007,1,7,205,213,
Tillman,Attorney General,Mark Myles,DEM,710007,0,1,77,78,
Tillman,State Treasurer,Randy Mcdaniel,REP,710007,1,8,221,230,
Tillman,State Treasurer,Charles De Coune,IND,710007,0,0,49,49,
Tillman,Superintendent of Public Instruction,Joy Hofmeister,REP,710007,0,7,184,191,
Tillman,Superintendent of Public Instruction,John Cox,DEM,710007,0,0,80,80,
Tillman,Superintendent of Public Instruction,Larry Huff,IND,710007,0,1,22,23,
Tillman,Commissioner of Labor,Leslie Osborn,REP,710007,1,6,190,197,
Tillman,Commissioner of Labor,Fred Dorrell,DEM,710007,0,1,82,83,
Tillman,Commissioner of Labor,Brandt Dismukes,IND,710007,0,1,13,14,
Tillman,Insurance Commissioner,Glen Mulready,REP,710007,1,7,194,202,
Tillman,Insurance Commissioner,Kimberly Fobbs,DEM,710007,0,1,87,88,
Tillman,Corporation Commissioner,Bob Anthony,REP,710007,1,7,195,203,
Tillman,Corporation Commissioner,Ashley Nicole Mccray,DEM,710007,0,1,81,82,
Tillman,Corporation Commissioner,Jackie Short,IND,710007,0,0,10,10,
Tillman,U.S. House,Tom Cole,REP,710007,1,6,212,219,4
Tillman,U.S. House,Mary Brannon,DEM,710007,0,1,70,71,4
Tillman,U.S. House,Ruby Peters,IND,710007,0,1,6,7,4
Tillman,State House,Trey Caldwell,REP,710007,1,6,203,210,63
Tillman,State House,Joan Gabelmann,DEM,710007,0,2,83,85,63
Tillman,Governor,Chris Powell,LIB,710009,0,0,3,3,
Tillman,Governor,Kevin Stitt,REP,710009,5,12,88,105,
Tillman,Governor,Drew Edmondson,DEM,710009,0,3,40,43,
Tillman,Lieutenant Governor,Matt Pinnell,REP,710009,5,12,89,106,
Tillman,Lieutenant Governor,Anastasia Pittman,DEM,710009,0,3,36,39,
Tillman,Lieutenant Governor,Ivan Holmes,IND,710009,0,0,5,5,
Tillman,State Auditor,John Yeutter,LIB,710009,0,0,21,21,
Tillman,State Auditor,Cindy Byrd,REP,710009,5,13,98,116,
Tillman,Attorney General,Mike Hunter,REP,710009,3,12,89,104,
Tillman,Attorney General,Mark Myles,DEM,710009,0,3,40,43,
Tillman,State Treasurer,Randy Mcdaniel,REP,710009,3,13,97,113,
Tillman,State Treasurer,Charles De Coune,IND,710009,0,0,21,21,
Tillman,Superintendent of Public Instruction,Joy Hofmeister,REP,710009,5,9,75,89,
Tillman,Superintendent of Public Instruction,John Cox,DEM,710009,0,4,48,52,
Tillman,Superintendent of Public Instruction,Larry Huff,IND,710009,0,1,4,5,
Tillman,Commissioner of Labor,Leslie Osborn,REP,710009,3,12,87,102,
Tillman,Commissioner of Labor,Fred Dorrell,DEM,710009,0,3,38,41,
Tillman,Commissioner of Labor,Brandt Dismukes,IND,710009,0,0,2,2,
Tillman,Insurance Commissioner,Glen Mulready,REP,710009,3,11,89,103,
Tillman,Insurance Commissioner,Kimberly Fobbs,DEM,710009,0,3,39,42,
Tillman,Corporation Commissioner,Bob Anthony,REP,710009,3,12,87,102,
Tillman,Corporation Commissioner,Ashley Nicole Mccray,DEM,710009,0,3,37,40,
Tillman,Corporation Commissioner,Jackie Short,IND,710009,0,0,3,3,
Tillman,U.S. House,Tom Cole,REP,710009,5,12,95,112,4
Tillman,U.S. House,Mary Brannon,DEM,710009,0,3,33,36,4
Tillman,U.S. House,Ruby Peters,IND,710009,0,0,3,3,4
Tillman,State House,Trey Caldwell,REP,710009,5,12,93,110,63
Tillman,State House,Joan Gabelmann,DEM,710009,0,3,37,40,63
Tillman,Governor,Chris Powell,LIB,710010,0,0,11,11,
Tillman,Governor,Kevin Stitt,REP,710010,7,13,196,216,
Tillman,Governor,Drew Edmondson,DEM,710010,4,5,154,163,
Tillman,Lieutenant Governor,Matt Pinnell,REP,710010,5,13,239,257,
Tillman,Lieutenant Governor,Anastasia Pittman,DEM,710010,3,4,102,109,
Tillman,Lieutenant Governor,Ivan Holmes,IND,710010,3,1,15,19,
Tillman,State Auditor,John Yeutter,LIB,710010,1,2,76,79,
Tillman,State Auditor,Cindy Byrd,REP,710010,9,15,264,288,
Tillman,Attorney General,Mike Hunter,REP,710010,8,12,244,264,
Tillman,Attorney General,Mark Myles,DEM,710010,1,5,111,117,
Tillman,State Treasurer,Randy Mcdaniel,REP,710010,9,14,270,293,
Tillman,State Treasurer,Charles De Coune,IND,710010,1,4,69,74,
Tillman,Superintendent of Public Instruction,Joy Hofmeister,REP,710010,6,11,211,228,
Tillman,Superintendent of Public Instruction,John Cox,DEM,710010,5,4,120,129,
Tillman,Superintendent of Public Instruction,Larry Huff,IND,710010,0,3,25,28,
Tillman,Commissioner of Labor,Leslie Osborn,REP,710010,9,14,242,265,
Tillman,Commissioner of Labor,Fred Dorrell,DEM,710010,1,4,103,108,
Tillman,Commissioner of Labor,Brandt Dismukes,IND,710010,0,0,7,7,
Tillman,Insurance Commissioner,Glen Mulready,REP,710010,6,13,233,252,
Tillman,Insurance Commissioner,Kimberly Fobbs,DEM,710010,4,5,121,130,
Tillman,Corporation Commissioner,Bob Anthony,REP,710010,9,13,246,268,
Tillman,Corporation Commissioner,Ashley Nicole Mccray,DEM,710010,1,5,91,97,
Tillman,Corporation Commissioner,Jackie Short,IND,710010,0,0,18,18,
Tillman,U.S. House,Tom Cole,REP,710010,9,13,263,285,4
Tillman,U.S. House,Mary Brannon,DEM,710010,1,4,83,88,4
Tillman,U.S. House,Ruby Peters,IND,710010,0,1,14,15,4
Tillman,State House,Trey Caldwell,REP,710010,9,13,284,306,63
Tillman,State House,Joan Gabelmann,DEM,710010,1,3,79,83,63
Tillman,Governor,Chris Powell,LIB,710012,1,3,0,4,
Tillman,Governor,Kevin Stitt,REP,710012,0,15,61,76,
Tillman,Governor,Drew Edmondson,DEM,710012,0,3,19,22,
Tillman,Lieutenant Governor,Matt Pinnell,REP,710012,0,18,64,82,
Tillman,Lieutenant Governor,Anastasia Pittman,DEM,710012,1,2,14,17,
Tillman,Lieutenant Governor,Ivan Holmes,IND,710012,0,1,1,2,
Tillman,State Auditor,John Yeutter,LIB,710012,0,3,7,10,
Tillman,State Auditor,Cindy Byrd,REP,710012,1,18,68,87,
Tillman,Attorney General,Mike Hunter,REP,710012,0,18,67,85,
Tillman,Attorney General,Mark Myles,DEM,710012,1,3,13,17,
Tillman,State Treasurer,Randy Mcdaniel,REP,710012,0,18,66,84,
Tillman,State Treasurer,Charles De Coune,IND,710012,1,3,10,14,
Tillman,Superintendent of Public Instruction,Joy Hofmeister,REP,710012,1,14,67,82,
Tillman,Superintendent of Public Instruction,John Cox,DEM,710012,0,4,8,12,
Tillman,Superintendent of Public Instruction,Larry Huff,IND,710012,0,3,3,6,
Tillman,Commissioner of Labor,Leslie Osborn,REP,710012,0,15,58,73,
Tillman,Commissioner of Labor,Fred Dorrell,DEM,710012,0,5,13,18,
Tillman,Commissioner of Labor,Brandt Dismukes,IND,710012,1,1,6,8,
Tillman,Insurance Commissioner,Glen Mulready,REP,710012,1,18,58,77,
Tillman,Insurance Commissioner,Kimberly Fobbs,DEM,710012,0,3,18,21,
Tillman,Corporation Commissioner,Bob Anthony,REP,710012,0,14,64,78,
Tillman,Corporation Commissioner,Ashley Nicole Mccray,DEM,710012,0,4,12,16,
Tillman,Corporation Commissioner,Jackie Short,IND,710012,1,3,0,4,
Tillman,U.S. House,Tom Cole,REP,710012,0,19,66,85,4
Tillman,U.S. House,Mary Brannon,DEM,710012,0,2,13,15,4
Tillman,U.S. House,Ruby Peters,IND,710012,1,0,0,1,4
Tillman,State House,Trey Caldwell,REP,710012,1,19,72,92,63
Tillman,State House,Joan Gabelmann,DEM,710012,0,2,9,11,63
Tulsa,Governor,Chris Powell,LIB,720001,0,0,32,32,
Tulsa,Governor,Kevin Stitt,REP,720001,0,0,28,28,
Tulsa,Governor,Drew Edmondson,DEM,720001,0,0,594,594,
Tulsa,Lieutenant Governor,Matt Pinnell,REP,720001,0,0,23,23,
Tulsa,Lieutenant Governor,Anastasia Pittman,DEM,720001,0,0,602,602,
Tulsa,Lieutenant Governor,Ivan Holmes,IND,720001,0,0,27,27,
Tulsa,State Auditor,John Yeutter,LIB,720001,0,0,449,449,
Tulsa,State Auditor,Cindy Byrd,REP,720001,0,0,106,106,
Tulsa,Attorney General,Mike Hunter,REP,720001,0,0,34,34,
Tulsa,Attorney General,Mark Myles,DEM,720001,0,0,621,621,
Tulsa,State Treasurer,Randy Mcdaniel,REP,720001,0,0,56,56,
Tulsa,State Treasurer,Charles De Coune,IND,720001,0,0,492,492,
Tulsa,Superintendent of Public Instruction,Joy Hofmeister,REP,720001,0,0,42,42,
Tulsa,Superintendent of Public Instruction,John Cox,DEM,720001,0,0,578,578,
Tulsa,Superintendent of Public Instruction,Larry Huff,IND,720001,0,0,35,35,
Tulsa,Commissioner of Labor,Leslie Osborn,REP,720001,0,0,25,25,
Tulsa,Commissioner of Labor,Fred Dorrell,DEM,720001,0,0,602,602,
Tulsa,Commissioner of Labor,Brandt Dismukes,IND,720001,0,0,28,28,
Tulsa,Insurance Commissioner,Glen Mulready,REP,720001,0,0,30,30,
Tulsa,Insurance Commissioner,Kimberly Fobbs,DEM,720001,0,0,623,623,
Tulsa,Corporation Commissioner,Bob Anthony,REP,720001,0,0,30,30,
Tulsa,Corporation Commissioner,Ashley Nicole Mccray,DEM,720001,0,0,594,594,
Tulsa,Corporation Commissioner,Jackie Short,IND,720001,0,0,30,30,
Tulsa,U.S. House,Kevin Hern,REP,720001,0,0,26,26,1
Tulsa,U.S. House,Tim Gilpin,DEM,720001,0,0,627,627,1
Tulsa,Governor,Chris Powell,LIB,720002,0,0,22,22,
Tulsa,Governor,Kevin Stitt,REP,720002,0,0,56,56,
Tulsa,Governor,Drew Edmondson,DEM,720002,0,0,527,527,
Tulsa,Lieutenant Governor,Matt Pinnell,REP,720002,0,0,58,58,
Tulsa,Lieutenant Governor,Anastasia Pittman,DEM,720002,0,0,524,524,
Tulsa,Lieutenant Governor,Ivan Holmes,IND,720002,0,0,21,21,
Tulsa,State Auditor,John Yeutter,LIB,720002,0,0,390,390,
Tulsa,State Auditor,Cindy Byrd,REP,720002,0,0,121,121,
Tulsa,Attorney General,Mike Hunter,REP,720002,0,0,69,69,
Tulsa,Attorney General,Mark Myles,DEM,720002,0,0,534,534,
Tulsa,State Treasurer,Randy Mcdaniel,REP,720002,0,0,96,96,
Tulsa,State Treasurer,Charles De Coune,IND,720002,0,0,412,412,
Tulsa,Superintendent of Public Instruction,Joy Hofmeister,REP,720002,0,0,72,72,
Tulsa,Superintendent of Public Instruction,John Cox,DEM,720002,0,0,492,492,
Tulsa,Superintendent of Public Instruction,Larry Huff,IND,720002,0,0,37,37,
Tulsa,Commissioner of Labor,Leslie Osborn,REP,720002,0,0,63,63,
Tulsa,Commissioner of Labor,Fred Dorrell,DEM,720002,0,0,510,510,
Tulsa,Commissioner of Labor,Brandt Dismukes,IND,720002,0,0,30,30,
Tulsa,Insurance Commissioner,Glen Mulready,REP,720002,0,0,72,72,
Tulsa,Insurance Commissioner,Kimberly Fobbs,DEM,720002,0,0,530,530,
Tulsa,Corporation Commissioner,Bob Anthony,REP,720002,0,0,61,61,
Tulsa,Corporation Commissioner,Ashley Nicole Mccray,DEM,720002,0,0,506,506,
Tulsa,Corporation Commissioner,Jackie Short,IND,720002,0,0,37,37,
Tulsa,U.S. House,Kevin Hern,REP,720002,0,0,75,75,1
Tulsa,U.S. House,Tim Gilpin,DEM,720002,0,0,527,527,1
Tulsa,Governor,Chris Powell,LIB,720003,0,0,11,11,
Tulsa,Governor,Kevin Stitt,REP,720003,0,0,113,113,
Tulsa,Governor,Drew Edmondson,DEM,720003,0,0,143,143,
Tulsa,Lieutenant Governor,Matt Pinnell,REP,720003,0,0,119,119,
Tulsa,Lieutenant Governor,Anastasia Pittman,DEM,720003,0,0,132,132,
Tulsa,Lieutenant Governor,Ivan Holmes,IND,720003,0,0,12,12,
Tulsa,State Auditor,John Yeutter,LIB,720003,0,0,92,92,
Tulsa,State Auditor,Cindy Byrd,REP,720003,0,0,134,134,
Tulsa,Attorney General,Mike Hunter,REP,720003,0,0,130,130,
Tulsa,Attorney General,Mark Myles,DEM,720003,0,0,135,135,
Tulsa,State Treasurer,Randy Mcdaniel,REP,720003,0,0,127,127,
Tulsa,State Treasurer,Charles De Coune,IND,720003,0,0,98,98,
Tulsa,Superintendent of Public Instruction,Joy Hofmeister,REP,720003,0,0,119,119,
Tulsa,Superintendent of Public Instruction,John Cox,DEM,720003,0,0,124,124,
Tulsa,Superintendent of Public Instruction,Larry Huff,IND,720003,0,0,23,23,
Tulsa,Commissioner of Labor,Leslie Osborn,REP,720003,0,0,113,113,
Tulsa,Commissioner of Labor,Fred Dorrell,DEM,720003,0,0,137,137,
Tulsa,Commissioner of Labor,Brandt Dismukes,IND,720003,0,0,14,14,
Tulsa,Insurance Commissioner,Glen Mulready,REP,720003,0,0,118,118,
Tulsa,Insurance Commissioner,Kimberly Fobbs,DEM,720003,0,0,143,143,
Tulsa,Corporation Commissioner,Bob Anthony,REP,720003,0,0,112,112,
Tulsa,Corporation Commissioner,Ashley Nicole Mccray,DEM,720003,0,0,134,134,
Tulsa,Corporation Commissioner,Jackie Short,IND,720003,0,0,17,17,
Tulsa,U.S. House,Kevin Hern,REP,720003,0,0,120,120,1
Tulsa,U.S. House,Tim Gilpin,DEM,720003,0,0,145,145,1
Tulsa,Governor,Chris Powell,LIB,720004,0,0,25,25,
Tulsa,Governor,Kevin Stitt,REP,720004,0,0,44,44,
Tulsa,Governor,Drew Edmondson,DEM,720004,0,0,683,683,
Tulsa,Lieutenant Governor,Matt Pinnell,REP,720004,0,0,42,42,
Tulsa,Lieutenant Governor,Anastasia Pittman,DEM,720004,0,0,689,689,
Tulsa,Lieutenant Governor,Ivan Holmes,IND,720004,0,0,20,20,
Tulsa,State Auditor,John Yeutter,LIB,720004,0,0,435,435,
Tulsa,State Auditor,Cindy Byrd,REP,720004,0,0,143,143,
Tulsa,Attorney General,Mike Hunter,REP,720004,0,0,53,53,
Tulsa,Attorney General,Mark Myles,DEM,720004,0,0,695,695,
Tulsa,State Treasurer,Randy Mcdaniel,REP,720004,0,0,86,86,
Tulsa,State Treasurer,Charles De Coune,IND,720004,0,0,492,492,
Tulsa,Superintendent of Public Instruction,Joy Hofmeister,REP,720004,0,0,83,83,
Tulsa,Superintendent of Public Instruction,John Cox,DEM,720004,0,0,628,628,
Tulsa,Superintendent of Public Instruction,Larry Huff,IND,720004,0,0,40,40,
Tulsa,Commissioner of Labor,Leslie Osborn,REP,720004,0,0,46,46,
Tulsa,Commissioner of Labor,Fred Dorrell,DEM,720004,0,0,669,669,
Tulsa,Commissioner of Labor,Brandt Dismukes,IND,720004,0,0,30,30,
Tulsa,Insurance Commissioner,Glen Mulready,REP,720004,0,0,44,44,
Tulsa,Insurance Commissioner,Kimberly Fobbs,DEM,720004,0,0,702,702,
Tulsa,Corporation Commissioner,Bob Anthony,REP,720004,0,0,47,47,
Tulsa,Corporation Commissioner,Ashley Nicole Mccray,DEM,720004,0,0,675,675,
Tulsa,Corporation Commissioner,Jackie Short,IND,720004,0,0,24,24,
Tulsa,U.S. House,Kevin Hern,REP,720004,0,0,50,50,1
Tulsa,U.S. House,Tim Gilpin,DEM,720004,0,0,699,699,1
Tulsa,Governor,Chris Powell,LIB,720005,0,0,12,12,
Tulsa,Governor,Kevin Stitt,REP,720005,0,0,37,37,
Tulsa,Governor,Drew Edmondson,DEM,720005,0,0,307,307,
Tulsa,Lieutenant Governor,Matt Pinnell,REP,720005,0,0,40,40,
Tulsa,Lieutenant Governor,Anastasia Pittman,DEM,720005,0,0,303,303,
Tulsa,Lieutenant Governor,Ivan Holmes,IND,720005,0,0,12,12,
Tulsa,State Auditor,John Yeutter,LIB,720005,0,0,193,193,
Tulsa,State Auditor,Cindy Byrd,REP,720005,0,0,97,97,
Tulsa,Attorney General,Mike Hunter,REP,720005,0,0,47,47,
Tulsa,Attorney General,Mark Myles,DEM,720005,0,0,309,309,
Tulsa,State Treasurer,Randy Mcdaniel,REP,720005,0,0,71,71,
Tulsa,State Treasurer,Charles De Coune,IND,720005,0,0,219,219,
Tulsa,Superintendent of Public Instruction,Joy Hofmeister,REP,720005,0,0,52,52,
Tulsa,Superintendent of Public Instruction,John Cox,DEM,720005,0,0,288,288,
Tulsa,Superintendent of Public Instruction,Larry Huff,IND,720005,0,0,16,16,
Tulsa,Commissioner of Labor,Leslie Osborn,REP,720005,0,0,45,45,
Tulsa,Commissioner of Labor,Fred Dorrell,DEM,720005,0,0,301,301,
Tulsa,Commissioner of Labor,Brandt Dismukes,IND,720005,0,0,9,9,
Tulsa,Insurance Commissioner,Glen Mulready,REP,720005,0,0,39,39,
Tulsa,Insurance Commissioner,Kimberly Fobbs,DEM,720005,0,0,316,316,
Tulsa,Corporation Commissioner,Bob Anthony,REP,720005,0,0,39,39,
Tulsa,Corporation Commissioner,Ashley Nicole Mccray,DEM,720005,0,0,302,302,
Tulsa,Corporation Commissioner,Jackie Short,IND,720005,0,0,15,15,
Tulsa,U.S. House,Kevin Hern,REP,720005,0,0,49,49,1
Tulsa,U.S. House,Tim Gilpin,DEM,720005,0,0,307,307,1
Tulsa,Governor,Chris Powell,LIB,720006,0,0,21,21,
Tulsa,Governor,Kevin Stitt,REP,720006,0,0,32,32,
Tulsa,Governor,Drew Edmondson,DEM,720006,0,0,756,756,
Tulsa,Lieutenant Governor,Matt Pinnell,REP,720006,0,0,28,28,
Tulsa,Lieutenant Governor,Anastasia Pittman,DEM,720006,0,0,752,752,
Tulsa,Lieutenant Governor,Ivan Holmes,IND,720006,0,0,27,27,
Tulsa,State Auditor,John Yeutter,LIB,720006,0,0,524,524,
Tulsa,State Auditor,Cindy Byrd,REP,720006,0,0,138,138,
Tulsa,Attorney General,Mike Hunter,REP,720006,0,0,39,39,
Tulsa,Attorney General,Mark Myles,DEM,720006,0,0,767,767,
Tulsa,State Treasurer,Randy Mcdaniel,REP,720006,0,0,75,75,
Tulsa,State Treasurer,Charles De Coune,IND,720006,0,0,579,579,
Tulsa,Superintendent of Public Instruction,Joy Hofmeister,REP,720006,0,0,61,61,
Tulsa,Superintendent of Public Instruction,John Cox,DEM,720006,0,0,710,710,
Tulsa,Superintendent of Public Instruction,Larry Huff,IND,720006,0,0,34,34,
Tulsa,Commissioner of Labor,Leslie Osborn,REP,720006,0,0,36,36,
Tulsa,Commissioner of Labor,Fred Dorrell,DEM,720006,0,0,745,745,
Tulsa,Commissioner of Labor,Brandt Dismukes,IND,720006,0,0,24,24,
Tulsa,Insurance Commissioner,Glen Mulready,REP,720006,0,0,35,35,
Tulsa,Insurance Commissioner,Kimberly Fobbs,DEM,720006,0,0,768,768,
Tulsa,Corporation Commissioner,Bob Anthony,REP,720006,0,0,29,29,
Tulsa,Corporation Commissioner,Ashley Nicole Mccray,DEM,720006,0,0,746,746,
Tulsa,Corporation Commissioner,Jackie Short,IND,720006,0,0,28,28,
Tulsa,U.S. House,Kevin Hern,REP,720006,0,0,37,37,1
Tulsa,U.S. House,Tim Gilpin,DEM,720006,0,0,770,770,1
Tulsa,Governor,Chris Powell,LIB,720007,0,0,6,6,
Tulsa,Governor,Kevin Stitt,REP,720007,0,0,29,29,
Tulsa,Governor,Drew Edmondson,DEM,720007,0,0,308,308,
Tulsa,Lieutenant Governor,Matt Pinnell,REP,720007,0,0,29,29,
Tulsa,Lieutenant Governor,Anastasia Pittman,DEM,720007,0,0,294,294,
Tulsa,Lieutenant Governor,Ivan Holmes,IND,720007,0,0,18,18,
Tulsa,State Auditor,John Yeutter,LIB,720007,0,0,199,199,
Tulsa,State Auditor,Cindy Byrd,REP,720007,0,0,67,67,
Tulsa,Attorney General,Mike Hunter,REP,720007,0,0,36,36,
Tulsa,Attorney General,Mark Myles,DEM,720007,0,0,305,305,
Tulsa,State Treasurer,Randy Mcdaniel,REP,720007,0,0,41,41,
Tulsa,State Treasurer,Charles De Coune,IND,720007,0,0,229,229,
Tulsa,Superintendent of Public Instruction,Joy Hofmeister,REP,720007,0,0,48,48,
Tulsa,Superintendent of Public Instruction,John Cox,DEM,720007,0,0,278,278,
Tulsa,Superintendent of Public Instruction,Larry Huff,IND,720007,0,0,16,16,
Tulsa,Commissioner of Labor,Leslie Osborn,REP,720007,0,0,34,34,
Tulsa,Commissioner of Labor,Fred Dorrell,DEM,720007,0,0,283,283,
Tulsa,Commissioner of Labor,Brandt Dismukes,IND,720007,0,0,24,24,
Tulsa,Insurance Commissioner,Glen Mulready,REP,720007,0,0,31,31,
Tulsa,Insurance Commissioner,Kimberly Fobbs,DEM,720007,0,0,307,307,
Tulsa,Corporation Commissioner,Bob Anthony,REP,720007,0,0,26,26,
Tulsa,Corporation Commissioner,Ashley Nicole Mccray,DEM,720007,0,0,295,295,
Tulsa,Corporation Commissioner,Jackie Short,IND,720007,0,0,15,15,
Tulsa,U.S. House,Kevin Hern,REP,720007,0,0,34,34,1
Tulsa,U.S. House,Tim Gilpin,DEM,720007,0,0,308,308,1
Tulsa,Governor,Chris Powell,LIB,720008,0,0,17,17,
Tulsa,Governor,Kevin Stitt,REP,720008,0,0,47,47,
Tulsa,Governor,Drew Edmondson,DEM,720008,0,0,370,370,
Tulsa,Lieutenant Governor,Matt Pinnell,REP,720008,0,0,54,54,
Tulsa,Lieutenant Governor,Anastasia Pittman,DEM,720008,0,0,361,361,
Tulsa,Lieutenant Governor,Ivan Holmes,IND,720008,0,0,17,17,
Tulsa,State Auditor,John Yeutter,LIB,720008,0,0,259,259,
Tulsa,State Auditor,Cindy Byrd,REP,720008,0,0,107,107,
Tulsa,Attorney General,Mike Hunter,REP,720008,0,0,56,56,
Tulsa,Attorney General,Mark Myles,DEM,720008,0,0,376,376,
Tulsa,State Treasurer,Randy Mcdaniel,REP,720008,0,0,77,77,
Tulsa,State Treasurer,Charles De Coune,IND,720008,0,0,299,299,
Tulsa,Superintendent of Public Instruction,Joy Hofmeister,REP,720008,0,0,66,66,
Tulsa,Superintendent of Public Instruction,John Cox,DEM,720008,0,0,346,346,
Tulsa,Superintendent of Public Instruction,Larry Huff,IND,720008,0,0,20,20,
Tulsa,Commissioner of Labor,Leslie Osborn,REP,720008,0,0,51,51,
Tulsa,Commissioner of Labor,Fred Dorrell,DEM,720008,0,0,355,355,
Tulsa,Commissioner of Labor,Brandt Dismukes,IND,720008,0,0,25,25,
Tulsa,Insurance Commissioner,Glen Mulready,REP,720008,0,0,59,59,
Tulsa,Insurance Commissioner,Kimberly Fobbs,DEM,720008,0,0,375,375,
Tulsa,Corporation Commissioner,Bob Anthony,REP,720008,0,0,58,58,
Tulsa,Corporation Commissioner,Ashley Nicole Mccray,DEM,720008,0,0,358,358,
Tulsa,Corporation Commissioner,Jackie Short,IND,720008,0,0,16,16,
Tulsa,U.S. House,Kevin Hern,REP,720008,0,0,60,60,1
Tulsa,U.S. House,Tim Gilpin,DEM,720008,0,0,375,375,1
Tulsa,Governor,Chris Powell,LIB,720009,0,0,5,5,
Tulsa,Governor,Kevin Stitt,REP,720009,0,0,21,21,
Tulsa,Governor,Drew Edmondson,DEM,720009,0,0,118,118,
Tulsa,Lieutenant Governor,Matt Pinnell,REP,720009,0,0,19,19,
Tulsa,Lieutenant Governor,Anastasia Pittman,DEM,720009,0,0,118,118,
Tulsa,Lieutenant Governor,Ivan Holmes,IND,720009,0,0,7,7,
Tulsa,State Auditor,John Yeutter,LIB,720009,0,0,80,80,
Tulsa,State Auditor,Cindy Byrd,REP,720009,0,0,38,38,
Tulsa,Attorney General,Mike Hunter,REP,720009,0,0,20,20,
Tulsa,Attorney General,Mark Myles,DEM,720009,0,0,123,123,
Tulsa,State Treasurer,Randy Mcdaniel,REP,720009,0,0,34,34,
Tulsa,State Treasurer,Charles De Coune,IND,720009,0,0,82,82,
Tulsa,Superintendent of Public Instruction,Joy Hofmeister,REP,720009,0,0,22,22,
Tulsa,Superintendent of Public Instruction,John Cox,DEM,720009,0,0,111,111,
Tulsa,Superintendent of Public Instruction,Larry Huff,IND,720009,0,0,10,10,
Tulsa,Commissioner of Labor,Leslie Osborn,REP,720009,0,0,18,18,
Tulsa,Commissioner of Labor,Fred Dorrell,DEM,720009,0,0,118,118,
Tulsa,Commissioner of Labor,Brandt Dismukes,IND,720009,0,0,7,7,
Tulsa,Insurance Commissioner,Glen Mulready,REP,720009,0,0,21,21,
Tulsa,Insurance Commissioner,Kimberly Fobbs,DEM,720009,0,0,122,122,
Tulsa,Corporation Commissioner,Bob Anthony,REP,720009,0,0,22,22,
Tulsa,Corporation Commissioner,Ashley Nicole Mccray,DEM,720009,0,0,117,117,
Tulsa,Corporation Commissioner,Jackie Short,IND,720009,0,0,3,3,
Tulsa,U.S. House,Kevin Hern,REP,720009,0,0,22,22,1
Tulsa,U.S. House,Tim Gilpin,DEM,720009,0,0,121,121,1
Tulsa,Governor,Chris Powell,LIB,720010,0,0,14,14,
Tulsa,Governor,Kevin Stitt,REP,720010,0,0,24,24,
Tulsa,Governor,Drew Edmondson,DEM,720010,0,0,393,393,
Tulsa,Lieutenant Governor,Matt Pinnell,REP,720010,0,0,25,25,
Tulsa,Lieutenant Governor,Anastasia Pittman,DEM,720010,0,0,384,384,
Tulsa,Lieutenant Governor,Ivan Holmes,IND,720010,0,0,22,22,
Tulsa,State Auditor,John Yeutter,LIB,720010,0,0,278,278,
Tulsa,State Auditor,Cindy Byrd,REP,720010,0,0,90,90,
Tulsa,Attorney General,Mike Hunter,REP,720010,0,0,41,41,
Tulsa,Attorney General,Mark Myles,DEM,720010,0,0,389,389,
Tulsa,State Treasurer,Randy Mcdaniel,REP,720010,0,0,61,61,
Tulsa,State Treasurer,Charles De Coune,IND,720010,0,0,314,314,
Tulsa,Superintendent of Public Instruction,Joy Hofmeister,REP,720010,0,0,50,50,
Tulsa,Superintendent of Public Instruction,John Cox,DEM,720010,0,0,356,356,
Tulsa,Superintendent of Public Instruction,Larry Huff,IND,720010,0,0,22,22,
Tulsa,Commissioner of Labor,Leslie Osborn,REP,720010,0,0,31,31,
Tulsa,Commissioner of Labor,Fred Dorrell,DEM,720010,0,0,383,383,
Tulsa,Commissioner of Labor,Brandt Dismukes,IND,720010,0,0,14,14,
Tulsa,Insurance Commissioner,Glen Mulready,REP,720010,0,0,30,30,
Tulsa,Insurance Commissioner,Kimberly Fobbs,DEM,720010,0,0,399,399,
Tulsa,Corporation Commissioner,Bob Anthony,REP,720010,0,0,28,28,
Tulsa,Corporation Commissioner,Ashley Nicole Mccray,DEM,720010,0,0,386,386,
Tulsa,Corporation Commissioner,Jackie Short,IND,720010,0,0,16,16,
Tulsa,U.S. House,Kevin Hern,REP,720010,0,0,32,32,1
Tulsa,U.S. House,Tim Gilpin,DEM,720010,0,0,398,398,1
Tulsa,Governor,Chris Powell,LIB,720011,0,0,25,25,
Tulsa,Governor,Kevin Stitt,REP,720011,0,0,102,102,
Tulsa,Governor,Drew Edmondson,DEM,720011,0,0,255,255,
Tulsa,Lieutenant Governor,Matt Pinnell,REP,720011,0,0,111,111,
Tulsa,Lieutenant Governor,Anastasia Pittman,DEM,720011,0,0,239,239,
Tulsa,Lieutenant Governor,Ivan Holmes,IND,720011,0,0,27,27,
Tulsa,State Auditor,John Yeutter,LIB,720011,0,0,155,155,
Tulsa,State Auditor,Cindy Byrd,REP,720011,0,0,144,144,
Tulsa,Attorney General,Mike Hunter,REP,720011,0,0,120,120,
Tulsa,Attorney General,Mark Myles,DEM,720011,0,0,257,257,
Tulsa,State Treasurer,Randy Mcdaniel,REP,720011,0,0,120,120,
Tulsa,State Treasurer,Charles De Coune,IND,720011,0,0,177,177,
Tulsa,Superintendent of Public Instruction,Joy Hofmeister,REP,720011,0,0,105,105,
Tulsa,Superintendent of Public Instruction,John Cox,DEM,720011,0,0,236,236,
Tulsa,Superintendent of Public Instruction,Larry Huff,IND,720011,0,0,38,38,
Tulsa,Commissioner of Labor,Leslie Osborn,REP,720011,0,0,109,109,
Tulsa,Commissioner of Labor,Fred Dorrell,DEM,720011,0,0,246,246,
Tulsa,Commissioner of Labor,Brandt Dismukes,IND,720011,0,0,23,23,
Tulsa,Insurance Commissioner,Glen Mulready,REP,720011,0,0,113,113,
Tulsa,Insurance Commissioner,Kimberly Fobbs,DEM,720011,0,0,264,264,
Tulsa,Corporation Commissioner,Bob Anthony,REP,720011,0,0,115,115,
Tulsa,Corporation Commissioner,Ashley Nicole Mccray,DEM,720011,0,0,240,240,
Tulsa,Corporation Commissioner,Jackie Short,IND,720011,0,0,23,23,
Tulsa,U.S. House,Kevin Hern,REP,720011,0,0,118,118,1
Tulsa,U.S. House,Tim Gilpin,DEM,720011,0,0,261,261,1
Tulsa,Governor,Chris Powell,LIB,720012,0,0,14,14,
Tulsa,Governor,Kevin Stitt,REP,720012,0,0,92,92,
Tulsa,Governor,Drew Edmondson,DEM,720012,0,0,213,213,
Tulsa,Lieutenant Governor,Matt Pinnell,REP,720012,0,0,94,94,
Tulsa,Lieutenant Governor,Anastasia Pittman,DEM,720012,0,0,201,201,
Tulsa,Lieutenant Governor,Ivan Holmes,IND,720012,0,0,22,22,
Tulsa,State Auditor,John Yeutter,LIB,720012,0,0,157,157,
Tulsa,State Auditor,Cindy Byrd,REP,720012,0,0,122,122,
Tulsa,Attorney General,Mike Hunter,REP,720012,0,0,97,97,
Tulsa,Attorney General,Mark Myles,DEM,720012,0,0,217,217,
Tulsa,State Treasurer,Randy Mcdaniel,REP,720012,0,0,111,111,
Tulsa,State Treasurer,Charles De Coune,IND,720012,0,0,167,167,
Tulsa,Superintendent of Public Instruction,Joy Hofmeister,REP,720012,0,0,90,90,
Tulsa,Superintendent of Public Instruction,John Cox,DEM,720012,0,0,203,203,
Tulsa,Superintendent of Public Instruction,Larry Huff,IND,720012,0,0,23,23,
Tulsa,Commissioner of Labor,Leslie Osborn,REP,720012,0,0,84,84,
Tulsa,Commissioner of Labor,Fred Dorrell,DEM,720012,0,0,206,206,
Tulsa,Commissioner of Labor,Brandt Dismukes,IND,720012,0,0,25,25,
Tulsa,Insurance Commissioner,Glen Mulready,REP,720012,0,0,92,92,
Tulsa,Insurance Commissioner,Kimberly Fobbs,DEM,720012,0,0,225,225,
Tulsa,Corporation Commissioner,Bob Anthony,REP,720012,0,0,83,83,
Tulsa,Corporation Commissioner,Ashley Nicole Mccray,DEM,720012,0,0,214,214,
Tulsa,Corporation Commissioner,Jackie Short,IND,720012,0,0,20,20,
Tulsa,U.S. House,Kevin Hern,REP,720012,0,0,97,97,1
Tulsa,U.S. House,Tim Gilpin,DEM,720012,0,0,220,220,1
Tulsa,Governor,Chris Powell,LIB,720013,0,0,16,16,
Tulsa,Governor,Kevin Stitt,REP,720013,0,0,34,34,
Tulsa,Governor,Drew Edmondson,DEM,720013,0,0,743,743,
Tulsa,Lieutenant Governor,Matt Pinnell,REP,720013,0,0,37,37,
Tulsa,Lieutenant Governor,Anastasia Pittman,DEM,720013,0,0,733,733,
Tulsa,Lieutenant Governor,Ivan Holmes,IND,720013,0,0,23,23,
Tulsa,State Auditor,John Yeutter,LIB,720013,0,0,498,498,
Tulsa,State Auditor,Cindy Byrd,REP,720013,0,0,133,133,
Tulsa,Attorney General,Mike Hunter,REP,720013,0,0,44,44,
Tulsa,Attorney General,Mark Myles,DEM,720013,0,0,749,749,
Tulsa,State Treasurer,Randy Mcdaniel,REP,720013,0,0,65,65,
Tulsa,State Treasurer,Charles De Coune,IND,720013,0,0,566,566,
Tulsa,Superintendent of Public Instruction,Joy Hofmeister,REP,720013,0,0,55,55,
Tulsa,Superintendent of Public Instruction,John Cox,DEM,720013,0,0,694,694,
Tulsa,Superintendent of Public Instruction,Larry Huff,IND,720013,0,0,43,43,
Tulsa,Commissioner of Labor,Leslie Osborn,REP,720013,0,0,37,37,
Tulsa,Commissioner of Labor,Fred Dorrell,DEM,720013,0,0,725,725,
Tulsa,Commissioner of Labor,Brandt Dismukes,IND,720013,0,0,27,27,
Tulsa,Insurance Commissioner,Glen Mulready,REP,720013,0,0,31,31,
Tulsa,Insurance Commissioner,Kimberly Fobbs,DEM,720013,0,0,760,760,
Tulsa,Corporation Commissioner,Bob Anthony,REP,720013,0,0,41,41,
Tulsa,Corporation Commissioner,Ashley Nicole Mccray,DEM,720013,0,0,722,722,
Tulsa,Corporation Commissioner,Jackie Short,IND,720013,0,0,28,28,
Tulsa,U.S. House,Kevin Hern,REP,720013,0,0,33,33,1
Tulsa,U.S. House,Tim Gilpin,DEM,720013,0,0,761,761,1
Tulsa,Governor,Chris Powell,LIB,720014,0,0,16,16,
Tulsa,Governor,Kevin Stitt,REP,720014,0,0,61,61,
Tulsa,Governor,Drew Edmondson,DEM,720014,0,0,549,549,
Tulsa,Lieutenant Governor,Matt Pinnell,REP,720014,0,0,77,77,
Tulsa,Lieutenant Governor,Anastasia Pittman,DEM,720014,0,0,536,536,
Tulsa,Lieutenant Governor,Ivan Holmes,IND,720014,0,0,16,16,
Tulsa,State Auditor,John Yeutter,LIB,720014,0,0,358,358,
Tulsa,State Auditor,Cindy Byrd,REP,720014,0,0,184,184,
Tulsa,Attorney General,Mike Hunter,REP,720014,0,0,79,79,
Tulsa,Attorney General,Mark Myles,DEM,720014,0,0,548,548,
Tulsa,State Treasurer,Randy Mcdaniel,REP,720014,0,0,111,111,
Tulsa,State Treasurer,Charles De Coune,IND,720014,0,0,426,426,
Tulsa,Superintendent of Public Instruction,Joy Hofmeister,REP,720014,0,0,95,95,
Tulsa,Superintendent of Public Instruction,John Cox,DEM,720014,0,0,500,500,
Tulsa,Superintendent of Public Instruction,Larry Huff,IND,720014,0,0,32,32,
Tulsa,Commissioner of Labor,Leslie Osborn,REP,720014,0,0,76,76,
Tulsa,Commissioner of Labor,Fred Dorrell,DEM,720014,0,0,516,516,
Tulsa,Commissioner of Labor,Brandt Dismukes,IND,720014,0,0,31,31,
Tulsa,Insurance Commissioner,Glen Mulready,REP,720014,0,0,84,84,
Tulsa,Insurance Commissioner,Kimberly Fobbs,DEM,720014,0,0,541,541,
Tulsa,Corporation Commissioner,Bob Anthony,REP,720014,0,0,71,71,
Tulsa,Corporation Commissioner,Ashley Nicole Mccray,DEM,720014,0,0,533,533,
Tulsa,Corporation Commissioner,Jackie Short,IND,720014,0,0,21,21,
Tulsa,U.S. House,Kevin Hern,REP,720014,0,0,66,66,1
Tulsa,U.S. House,Tim Gilpin,DEM,720014,0,0,562,562,1
Tulsa,Governor,Chris Powell,LIB,720015,0,0,12,12,
Tulsa,Governor,Kevin Stitt,REP,720015,0,0,54,54,
Tulsa,Governor,Drew Edmondson,DEM,720015,0,0,278,278,
Tulsa,Lieutenant Governor,Matt Pinnell,REP,720015,0,0,54,54,
Tulsa,Lieutenant Governor,Anastasia Pittman,DEM,720015,0,0,281,281,
Tulsa,Lieutenant Governor,Ivan Holmes,IND,720015,0,0,5,5,
Tulsa,State Auditor,John Yeutter,LIB,720015,0,0,196,196,
Tulsa,State Auditor,Cindy Byrd,REP,720015,0,0,90,90,
Tulsa,Attorney General,Mike Hunter,REP,720015,0,0,58,58,
Tulsa,Attorney General,Mark Myles,DEM,720015,0,0,281,281,
Tulsa,State Treasurer,Randy Mcdaniel,REP,720015,0,0,74,74,
Tulsa,State Treasurer,Charles De Coune,IND,720015,0,0,210,210,
Tulsa,Superintendent of Public Instruction,Joy Hofmeister,REP,720015,0,0,62,62,
Tulsa,Superintendent of Public Instruction,John Cox,DEM,720015,0,0,261,261,
Tulsa,Superintendent of Public Instruction,Larry Huff,IND,720015,0,0,17,17,
Tulsa,Commissioner of Labor,Leslie Osborn,REP,720015,0,0,54,54,
Tulsa,Commissioner of Labor,Fred Dorrell,DEM,720015,0,0,266,266,
Tulsa,Commissioner of Labor,Brandt Dismukes,IND,720015,0,0,18,18,
Tulsa,Insurance Commissioner,Glen Mulready,REP,720015,0,0,50,50,
Tulsa,Insurance Commissioner,Kimberly Fobbs,DEM,720015,0,0,288,288,
Tulsa,Corporation Commissioner,Bob Anthony,REP,720015,0,0,49,49,
Tulsa,Corporation Commissioner,Ashley Nicole Mccray,DEM,720015,0,0,274,274,
Tulsa,Corporation Commissioner,Jackie Short,IND,720015,0,0,16,16,
Tulsa,U.S. House,Kevin Hern,REP,720015,0,0,56,56,1
Tulsa,U.S. House,Tim Gilpin,DEM,720015,0,0,287,287,1
Tulsa,Governor,Chris Powell,LIB,720016,0,0,4,4,
Tulsa,Governor,Kevin Stitt,REP,720016,0,0,55,55,
Tulsa,Governor,Drew Edmondson,DEM,720016,0,0,83,83,
Tulsa,Lieutenant Governor,Matt Pinnell,REP,720016,0,0,55,55,
Tulsa,Lieutenant Governor,Anastasia Pittman,DEM,720016,0,0,80,80,
Tulsa,Lieutenant Governor,Ivan Holmes,IND,720016,0,0,7,7,
Tulsa,State Auditor,John Yeutter,LIB,720016,0,0,54,54,
Tulsa,State Auditor,Cindy Byrd,REP,720016,0,0,70,70,
Tulsa,Attorney General,Mike Hunter,REP,720016,0,0,60,60,
Tulsa,Attorney General,Mark Myles,DEM,720016,0,0,81,81,
Tulsa,State Treasurer,Randy Mcdaniel,REP,720016,0,0,59,59,
Tulsa,State Treasurer,Charles De Coune,IND,720016,0,0,66,66,
Tulsa,Superintendent of Public Instruction,Joy Hofmeister,REP,720016,0,0,63,63,
Tulsa,Superintendent of Public Instruction,John Cox,DEM,720016,0,0,69,69,
Tulsa,Superintendent of Public Instruction,Larry Huff,IND,720016,0,0,8,8,
Tulsa,Commissioner of Labor,Leslie Osborn,REP,720016,0,0,53,53,
Tulsa,Commissioner of Labor,Fred Dorrell,DEM,720016,0,0,77,77,
Tulsa,Commissioner of Labor,Brandt Dismukes,IND,720016,0,0,8,8,
Tulsa,Insurance Commissioner,Glen Mulready,REP,720016,0,0,59,59,
Tulsa,Insurance Commissioner,Kimberly Fobbs,DEM,720016,0,0,81,81,
Tulsa,Corporation Commissioner,Bob Anthony,REP,720016,0,0,56,56,
Tulsa,Corporation Commissioner,Ashley Nicole Mccray,DEM,720016,0,0,78,78,
Tulsa,Corporation Commissioner,Jackie Short,IND,720016,0,0,6,6,
Tulsa,U.S. House,Kevin Hern,REP,720016,0,0,60,60,1
Tulsa,U.S. House,Tim Gilpin,DEM,720016,0,0,82,82,1
Tulsa,Governor,Chris Powell,LIB,720017,0,0,15,15,
Tulsa,Governor,Kevin Stitt,REP,720017,0,0,81,81,
Tulsa,Governor,Drew Edmondson,DEM,720017,0,0,158,158,
Tulsa,Lieutenant Governor,Matt Pinnell,REP,720017,0,0,96,96,
Tulsa,Lieutenant Governor,Anastasia Pittman,DEM,720017,0,0,144,144,
Tulsa,Lieutenant Governor,Ivan Holmes,IND,720017,0,0,13,13,
Tulsa,State Auditor,John Yeutter,LIB,720017,0,0,111,111,
Tulsa,State Auditor,Cindy Byrd,REP,720017,0,0,114,114,
Tulsa,Attorney General,Mike Hunter,REP,720017,0,0,103,103,
Tulsa,Attorney General,Mark Myles,DEM,720017,0,0,150,150,
Tulsa,State Treasurer,Randy Mcdaniel,REP,720017,0,0,105,105,
Tulsa,State Treasurer,Charles De Coune,IND,720017,0,0,120,120,
Tulsa,Superintendent of Public Instruction,Joy Hofmeister,REP,720017,0,0,93,93,
Tulsa,Superintendent of Public Instruction,John Cox,DEM,720017,0,0,136,136,
Tulsa,Superintendent of Public Instruction,Larry Huff,IND,720017,0,0,23,23,
Tulsa,Commissioner of Labor,Leslie Osborn,REP,720017,0,0,90,90,
Tulsa,Commissioner of Labor,Fred Dorrell,DEM,720017,0,0,150,150,
Tulsa,Commissioner of Labor,Brandt Dismukes,IND,720017,0,0,10,10,
Tulsa,Insurance Commissioner,Glen Mulready,REP,720017,0,0,93,93,
Tulsa,Insurance Commissioner,Kimberly Fobbs,DEM,720017,0,0,158,158,
Tulsa,Corporation Commissioner,Bob Anthony,REP,720017,0,0,87,87,
Tulsa,Corporation Commissioner,Ashley Nicole Mccray,DEM,720017,0,0,148,148,
Tulsa,Corporation Commissioner,Jackie Short,IND,720017,0,0,16,16,
Tulsa,U.S. House,Kevin Hern,REP,720017,0,0,96,96,1
Tulsa,U.S. House,Tim Gilpin,DEM,720017,0,0,156,156,1
Tulsa,Governor,Chris Powell,LIB,720018,0,0,14,14,
Tulsa,Governor,Kevin Stitt,REP,720018,0,0,124,124,
Tulsa,Governor,Drew Edmondson,DEM,720018,0,0,176,176,
Tulsa,Lieutenant Governor,Matt Pinnell,REP,720018,0,0,131,131,
Tulsa,Lieutenant Governor,Anastasia Pittman,DEM,720018,0,0,155,155,
Tulsa,Lieutenant Governor,Ivan Holmes,IND,720018,0,0,21,21,
Tulsa,State Auditor,John Yeutter,LIB,720018,0,0,126,126,
Tulsa,State Auditor,Cindy Byrd,REP,720018,0,0,145,145,
Tulsa,Attorney General,Mike Hunter,REP,720018,0,0,144,144,
Tulsa,Attorney General,Mark Myles,DEM,720018,0,0,161,161,
Tulsa,State Treasurer,Randy Mcdaniel,REP,720018,0,0,135,135,
Tulsa,State Treasurer,Charles De Coune,IND,720018,0,0,133,133,
Tulsa,Superintendent of Public Instruction,Joy Hofmeister,REP,720018,0,0,130,130,
Tulsa,Superintendent of Public Instruction,John Cox,DEM,720018,0,0,143,143,
Tulsa,Superintendent of Public Instruction,Larry Huff,IND,720018,0,0,32,32,
Tulsa,Commissioner of Labor,Leslie Osborn,REP,720018,0,0,128,128,
Tulsa,Commissioner of Labor,Fred Dorrell,DEM,720018,0,0,152,152,
Tulsa,Commissioner of Labor,Brandt Dismukes,IND,720018,0,0,23,23,
Tulsa,Insurance Commissioner,Glen Mulready,REP,720018,0,0,133,133,
Tulsa,Insurance Commissioner,Kimberly Fobbs,DEM,720018,0,0,168,168,
Tulsa,Corporation Commissioner,Bob Anthony,REP,720018,0,0,129,129,
Tulsa,Corporation Commissioner,Ashley Nicole Mccray,DEM,720018,0,0,149,149,
Tulsa,Corporation Commissioner,Jackie Short,IND,720018,0,0,28,28,
Tulsa,U.S. House,Kevin Hern,REP,720018,0,0,140,140,1
Tulsa,U.S. House,Tim Gilpin,DEM,720018,0,0,171,171,1
Tulsa,Governor,Chris Powell,LIB,720019,0,0,25,25,
Tulsa,Governor,Kevin Stitt,REP,720019,0,0,146,146,
Tulsa,Governor,Drew Edmondson,DEM,720019,0,0,174,174,
Tulsa,Lieutenant Governor,Matt Pinnell,REP,720019,0,0,170,170,
Tulsa,Lieutenant Governor,Anastasia Pittman,DEM,720019,0,0,157,157,
Tulsa,Lieutenant Governor,Ivan Holmes,IND,720019,0,0,17,17,
Tulsa,State Auditor,John Yeutter,LIB,720019,0,0,132,132,
Tulsa,State Auditor,Cindy Byrd,REP,720019,0,0,178,178,
Tulsa,Attorney General,Mike Hunter,REP,720019,0,0,178,178,
Tulsa,Attorney General,Mark Myles,DEM,720019,0,0,161,161,
Tulsa,State Treasurer,Randy Mcdaniel,REP,720019,0,0,179,179,
Tulsa,State Treasurer,Charles De Coune,IND,720019,0,0,132,132,
Tulsa,Superintendent of Public Instruction,Joy Hofmeister,REP,720019,0,0,161,161,
Tulsa,Superintendent of Public Instruction,John Cox,DEM,720019,0,0,144,144,
Tulsa,Superintendent of Public Instruction,Larry Huff,IND,720019,0,0,33,33,
Tulsa,Commissioner of Labor,Leslie Osborn,REP,720019,0,0,162,162,
Tulsa,Commissioner of Labor,Fred Dorrell,DEM,720019,0,0,151,151,
Tulsa,Commissioner of Labor,Brandt Dismukes,IND,720019,0,0,23,23,
Tulsa,Insurance Commissioner,Glen Mulready,REP,720019,0,0,166,166,
Tulsa,Insurance Commissioner,Kimberly Fobbs,DEM,720019,0,0,170,170,
Tulsa,Corporation Commissioner,Bob Anthony,REP,720019,0,0,162,162,
Tulsa,Corporation Commissioner,Ashley Nicole Mccray,DEM,720019,0,0,150,150,
Tulsa,Corporation Commissioner,Jackie Short,IND,720019,0,0,27,27,
Tulsa,U.S. House,Kevin Hern,REP,720019,0,0,175,175,1
Tulsa,U.S. House,Tim Gilpin,DEM,720019,0,0,167,167,1
Tulsa,State House,Todd Blackburn,REP,720019,0,0,133,133,77
Tulsa,State House,John Waldron,DEM,720019,0,0,208,208,77
Tulsa,Governor,Chris Powell,LIB,720020,0,0,20,20,
Tulsa,Governor,Kevin Stitt,REP,720020,0,0,116,116,
Tulsa,Governor,Drew Edmondson,DEM,720020,0,0,192,192,
Tulsa,Lieutenant Governor,Matt Pinnell,REP,720020,0,0,132,132,
Tulsa,Lieutenant Governor,Anastasia Pittman,DEM,720020,0,0,173,173,
Tulsa,Lieutenant Governor,Ivan Holmes,IND,720020,0,0,21,21,
Tulsa,State Auditor,John Yeutter,LIB,720020,0,0,129,129,
Tulsa,State Auditor,Cindy Byrd,REP,720020,0,0,173,173,
Tulsa,Attorney General,Mike Hunter,REP,720020,0,0,146,146,
Tulsa,Attorney General,Mark Myles,DEM,720020,0,0,181,181,
Tulsa,State Treasurer,Randy Mcdaniel,REP,720020,0,0,148,148,
Tulsa,State Treasurer,Charles De Coune,IND,720020,0,0,153,153,
Tulsa,Superintendent of Public Instruction,Joy Hofmeister,REP,720020,0,0,133,133,
Tulsa,Superintendent of Public Instruction,John Cox,DEM,720020,0,0,156,156,
Tulsa,Superintendent of Public Instruction,Larry Huff,IND,720020,0,0,37,37,
Tulsa,Commissioner of Labor,Leslie Osborn,REP,720020,0,0,138,138,
Tulsa,Commissioner of Labor,Fred Dorrell,DEM,720020,0,0,162,162,
Tulsa,Commissioner of Labor,Brandt Dismukes,IND,720020,0,0,24,24,
Tulsa,Insurance Commissioner,Glen Mulready,REP,720020,0,0,133,133,
Tulsa,Insurance Commissioner,Kimberly Fobbs,DEM,720020,0,0,190,190,
Tulsa,Corporation Commissioner,Bob Anthony,REP,720020,0,0,129,129,
Tulsa,Corporation Commissioner,Ashley Nicole Mccray,DEM,720020,0,0,175,175,
Tulsa,Corporation Commissioner,Jackie Short,IND,720020,0,0,20,20,
Tulsa,U.S. House,Kevin Hern,REP,720020,0,0,130,130,1
Tulsa,U.S. House,Tim Gilpin,DEM,720020,0,0,196,196,1
Tulsa,Governor,Chris Powell,LIB,720021,0,0,1,1,
Tulsa,Governor,Kevin Stitt,REP,720021,0,0,31,31,
Tulsa,Governor,Drew Edmondson,DEM,720021,0,0,8,8,
Tulsa,Lieutenant Governor,Matt Pinnell,REP,720021,0,0,31,31,
Tulsa,Lieutenant Governor,Anastasia Pittman,DEM,720021,0,0,5,5,
Tulsa,Lieutenant Governor,Ivan Holmes,IND,720021,0,0,1,1,
Tulsa,State Auditor,John Yeutter,LIB,720021,0,0,5,5,
Tulsa,State Auditor,Cindy Byrd,REP,720021,0,0,29,29,
Tulsa,Attorney General,Mike Hunter,REP,720021,0,0,32,32,
Tulsa,Attorney General,Mark Myles,DEM,720021,0,0,6,6,
Tulsa,State Treasurer,Randy Mcdaniel,REP,720021,0,0,30,30,
Tulsa,State Treasurer,Charles De Coune,IND,720021,0,0,3,3,
Tulsa,Superintendent of Public Instruction,Joy Hofmeister,REP,720021,0,0,29,29,
Tulsa,Superintendent of Public Instruction,John Cox,DEM,720021,0,0,8,8,
Tulsa,Superintendent of Public Instruction,Larry Huff,IND,720021,0,0,2,2,
Tulsa,Commissioner of Labor,Leslie Osborn,REP,720021,0,0,32,32,
Tulsa,Commissioner of Labor,Fred Dorrell,DEM,720021,0,0,6,6,
Tulsa,Commissioner of Labor,Brandt Dismukes,IND,720021,0,0,0,0,
Tulsa,Insurance Commissioner,Glen Mulready,REP,720021,0,0,31,31,
Tulsa,Insurance Commissioner,Kimberly Fobbs,DEM,720021,0,0,6,6,
Tulsa,Corporation Commissioner,Bob Anthony,REP,720021,0,0,30,30,
Tulsa,Corporation Commissioner,Ashley Nicole Mccray,DEM,720021,0,0,6,6,
Tulsa,Corporation Commissioner,Jackie Short,IND,720021,0,0,1,1,
Tulsa,U.S. House,Kevin Hern,REP,720021,0,0,32,32,1
Tulsa,U.S. House,Tim Gilpin,DEM,720021,0,0,6,6,1
Tulsa,Governor,Chris Powell,LIB,720022,0,0,18,18,
Tulsa,Governor,Kevin Stitt,REP,720022,0,0,215,215,
Tulsa,Governor,Drew Edmondson,DEM,720022,0,0,193,193,
Tulsa,Lieutenant Governor,Matt Pinnell,REP,720022,0,0,228,228,
Tulsa,Lieutenant Governor,Anastasia Pittman,DEM,720022,0,0,175,175,
Tulsa,Lieutenant Governor,Ivan Holmes,IND,720022,0,0,17,17,
Tulsa,State Auditor,John Yeutter,LIB,720022,0,0,121,121,
Tulsa,State Auditor,Cindy Byrd,REP,720022,0,0,257,257,
Tulsa,Attorney General,Mike Hunter,REP,720022,0,0,237,237,
Tulsa,Attorney General,Mark Myles,DEM,720022,0,0,181,181,
Tulsa,State Treasurer,Randy Mcdaniel,REP,720022,0,0,248,248,
Tulsa,State Treasurer,Charles De Coune,IND,720022,0,0,121,121,
Tulsa,Superintendent of Public Instruction,Joy Hofmeister,REP,720022,0,0,203,203,
Tulsa,Superintendent of Public Instruction,John Cox,DEM,720022,0,0,183,183,
Tulsa,Superintendent of Public Instruction,Larry Huff,IND,720022,0,0,31,31,
Tulsa,Commissioner of Labor,Leslie Osborn,REP,720022,0,0,211,211,
Tulsa,Commissioner of Labor,Fred Dorrell,DEM,720022,0,0,176,176,
Tulsa,Commissioner of Labor,Brandt Dismukes,IND,720022,0,0,23,23,
Tulsa,Insurance Commissioner,Glen Mulready,REP,720022,0,0,235,235,
Tulsa,Insurance Commissioner,Kimberly Fobbs,DEM,720022,0,0,180,180,
Tulsa,Corporation Commissioner,Bob Anthony,REP,720022,0,0,219,219,
Tulsa,Corporation Commissioner,Ashley Nicole Mccray,DEM,720022,0,0,175,175,
Tulsa,Corporation Commissioner,Jackie Short,IND,720022,0,0,26,26,
Tulsa,U.S. House,Kevin Hern,REP,720022,0,0,231,231,1
Tulsa,U.S. House,Tim Gilpin,DEM,720022,0,0,192,192,1
Tulsa,State House,Todd Blackburn,REP,720022,0,0,202,202,77
Tulsa,State House,John Waldron,DEM,720022,0,0,213,213,77
Tulsa,Governor,Chris Powell,LIB,720023,0,0,8,8,
Tulsa,Governor,Kevin Stitt,REP,720023,0,0,122,122,
Tulsa,Governor,Drew Edmondson,DEM,720023,0,0,81,81,
Tulsa,Lieutenant Governor,Matt Pinnell,REP,720023,0,0,136,136,
Tulsa,Lieutenant Governor,Anastasia Pittman,DEM,720023,0,0,66,66,
Tulsa,Lieutenant Governor,Ivan Holmes,IND,720023,0,0,8,8,
Tulsa,State Auditor,John Yeutter,LIB,720023,0,0,45,45,
Tulsa,State Auditor,Cindy Byrd,REP,720023,0,0,154,154,
Tulsa,Attorney General,Mike Hunter,REP,720023,0,0,139,139,
Tulsa,Attorney General,Mark Myles,DEM,720023,0,0,71,71,
Tulsa,State Treasurer,Randy Mcdaniel,REP,720023,0,0,148,148,
Tulsa,State Treasurer,Charles De Coune,IND,720023,0,0,51,51,
Tulsa,Superintendent of Public Instruction,Joy Hofmeister,REP,720023,0,0,123,123,
Tulsa,Superintendent of Public Instruction,John Cox,DEM,720023,0,0,72,72,
Tulsa,Superintendent of Public Instruction,Larry Huff,IND,720023,0,0,15,15,
Tulsa,Commissioner of Labor,Leslie Osborn,REP,720023,0,0,131,131,
Tulsa,Commissioner of Labor,Fred Dorrell,DEM,720023,0,0,68,68,
Tulsa,Commissioner of Labor,Brandt Dismukes,IND,720023,0,0,9,9,
Tulsa,Insurance Commissioner,Glen Mulready,REP,720023,0,0,137,137,
Tulsa,Insurance Commissioner,Kimberly Fobbs,DEM,720023,0,0,71,71,
Tulsa,Corporation Commissioner,Bob Anthony,REP,720023,0,0,137,137,
Tulsa,Corporation Commissioner,Ashley Nicole Mccray,DEM,720023,0,0,63,63,
Tulsa,Corporation Commissioner,Jackie Short,IND,720023,0,0,8,8,
Tulsa,U.S. House,Kevin Hern,REP,720023,0,0,137,137,1
Tulsa,U.S. House,Tim Gilpin,DEM,720023,0,0,70,70,1
Tulsa,State House,Todd Blackburn,REP,720023,0,0,134,134,77
Tulsa,State House,John Waldron,DEM,720023,0,0,71,71,77
Tulsa,Governor,Chris Powell,LIB,720024,0,0,16,16,
Tulsa,Governor,Kevin Stitt,REP,720024,0,0,177,177,
Tulsa,Governor,Drew Edmondson,DEM,720024,0,0,160,160,
Tulsa,Lieutenant Governor,Matt Pinnell,REP,720024,0,0,197,197,
Tulsa,Lieutenant Governor,Anastasia Pittman,DEM,720024,0,0,137,137,
Tulsa,Lieutenant Governor,Ivan Holmes,IND,720024,0,0,20,20,
Tulsa,State Auditor,John Yeutter,LIB,720024,0,0,106,106,
Tulsa,State Auditor,Cindy Byrd,REP,720024,0,0,210,210,
Tulsa,Attorney General,Mike Hunter,REP,720024,0,0,206,206,
Tulsa,Attorney General,Mark Myles,DEM,720024,0,0,146,146,
Tulsa,State Treasurer,Randy Mcdaniel,REP,720024,0,0,202,202,
Tulsa,State Treasurer,Charles De Coune,IND,720024,0,0,117,117,
Tulsa,Superintendent of Public Instruction,Joy Hofmeister,REP,720024,0,0,181,181,
Tulsa,Superintendent of Public Instruction,John Cox,DEM,720024,0,0,135,135,
Tulsa,Superintendent of Public Instruction,Larry Huff,IND,720024,0,0,37,37,
Tulsa,Commissioner of Labor,Leslie Osborn,REP,720024,0,0,187,187,
Tulsa,Commissioner of Labor,Fred Dorrell,DEM,720024,0,0,141,141,
Tulsa,Commissioner of Labor,Brandt Dismukes,IND,720024,0,0,21,21,
Tulsa,Insurance Commissioner,Glen Mulready,REP,720024,0,0,193,193,
Tulsa,Insurance Commissioner,Kimberly Fobbs,DEM,720024,0,0,154,154,
Tulsa,Corporation Commissioner,Bob Anthony,REP,720024,0,0,188,188,
Tulsa,Corporation Commissioner,Ashley Nicole Mccray,DEM,720024,0,0,134,134,
Tulsa,Corporation Commissioner,Jackie Short,IND,720024,0,0,29,29,
Tulsa,U.S. House,Kevin Hern,REP,720024,0,0,197,197,1
Tulsa,U.S. House,Tim Gilpin,DEM,720024,0,0,156,156,1
Tulsa,State House,Todd Blackburn,REP,720024,0,0,171,171,77
Tulsa,State House,John Waldron,DEM,720024,0,0,183,183,77
Tulsa,Governor,Chris Powell,LIB,720025,0,0,19,19,
Tulsa,Governor,Kevin Stitt,REP,720025,0,0,116,116,
Tulsa,Governor,Drew Edmondson,DEM,720025,0,0,133,133,
Tulsa,Lieutenant Governor,Matt Pinnell,REP,720025,0,0,132,132,
Tulsa,Lieutenant Governor,Anastasia Pittman,DEM,720025,0,0,119,119,
Tulsa,Lieutenant Governor,Ivan Holmes,IND,720025,0,0,15,15,
Tulsa,State Auditor,John Yeutter,LIB,720025,0,0,79,79,
Tulsa,State Auditor,Cindy Byrd,REP,720025,0,0,155,155,
Tulsa,Attorney General,Mike Hunter,REP,720025,0,0,133,133,
Tulsa,Attorney General,Mark Myles,DEM,720025,0,0,131,131,
Tulsa,State Treasurer,Randy Mcdaniel,REP,720025,0,0,135,135,
Tulsa,State Treasurer,Charles De Coune,IND,720025,0,0,100,100,
Tulsa,Superintendent of Public Instruction,Joy Hofmeister,REP,720025,0,0,116,116,
Tulsa,Superintendent of Public Instruction,John Cox,DEM,720025,0,0,126,126,
Tulsa,Superintendent of Public Instruction,Larry Huff,IND,720025,0,0,24,24,
Tulsa,Commissioner of Labor,Leslie Osborn,REP,720025,0,0,123,123,
Tulsa,Commissioner of Labor,Fred Dorrell,DEM,720025,0,0,117,117,
Tulsa,Commissioner of Labor,Brandt Dismukes,IND,720025,0,0,20,20,
Tulsa,Insurance Commissioner,Glen Mulready,REP,720025,0,0,133,133,
Tulsa,Insurance Commissioner,Kimberly Fobbs,DEM,720025,0,0,129,129,
Tulsa,Corporation Commissioner,Bob Anthony,REP,720025,0,0,128,128,
Tulsa,Corporation Commissioner,Ashley Nicole Mccray,DEM,720025,0,0,115,115,
Tulsa,Corporation Commissioner,Jackie Short,IND,720025,0,0,20,20,
Tulsa,U.S. House,Kevin Hern,REP,720025,0,0,133,133,1
Tulsa,U.S. House,Tim Gilpin,DEM,720025,0,0,131,131,1
Tulsa,State House,Todd Blackburn,REP,720025,0,0,119,119,77
Tulsa,State House,John Waldron,DEM,720025,0,0,145,145,77
Tulsa,Governor,Chris Powell,LIB,720026,0,0,24,24,
Tulsa,Governor,Kevin Stitt,REP,720026,0,0,115,115,
Tulsa,Governor,Drew Edmondson,DEM,720026,0,0,195,195,
Tulsa,Lieutenant Governor,Matt Pinnell,REP,720026,0,0,129,129,
Tulsa,Lieutenant Governor,Anastasia Pittman,DEM,720026,0,0,188,188,
Tulsa,Lieutenant Governor,Ivan Holmes,IND,720026,0,0,15,15,
Tulsa,State Auditor,John Yeutter,LIB,720026,0,0,130,130,
Tulsa,State Auditor,Cindy Byrd,REP,720026,0,0,170,170,
Tulsa,Attorney General,Mike Hunter,REP,720026,0,0,144,144,
Tulsa,Attorney General,Mark Myles,DEM,720026,0,0,188,188,
Tulsa,State Treasurer,Randy Mcdaniel,REP,720026,0,0,152,152,
Tulsa,State Treasurer,Charles De Coune,IND,720026,0,0,143,143,
Tulsa,Superintendent of Public Instruction,Joy Hofmeister,REP,720026,0,0,127,127,
Tulsa,Superintendent of Public Instruction,John Cox,DEM,720026,0,0,176,176,
Tulsa,Superintendent of Public Instruction,Larry Huff,IND,720026,0,0,30,30,
Tulsa,Commissioner of Labor,Leslie Osborn,REP,720026,0,0,121,121,
Tulsa,Commissioner of Labor,Fred Dorrell,DEM,720026,0,0,190,190,
Tulsa,Commissioner of Labor,Brandt Dismukes,IND,720026,0,0,18,18,
Tulsa,Insurance Commissioner,Glen Mulready,REP,720026,0,0,137,137,
Tulsa,Insurance Commissioner,Kimberly Fobbs,DEM,720026,0,0,193,193,
Tulsa,Corporation Commissioner,Bob Anthony,REP,720026,0,0,134,134,
Tulsa,Corporation Commissioner,Ashley Nicole Mccray,DEM,720026,0,0,172,172,
Tulsa,Corporation Commissioner,Jackie Short,IND,720026,0,0,24,24,
Tulsa,U.S. House,Kevin Hern,REP,720026,0,0,130,130,1
Tulsa,U.S. House,Tim Gilpin,DEM,720026,0,0,202,202,1
Tulsa,State House,Todd Blackburn,REP,720026,0,0,109,109,77
Tulsa,State House,John Waldron,DEM,720026,0,0,224,224,77
Tulsa,Governor,Chris Powell,LIB,720027,0,0,17,17,
Tulsa,Governor,Kevin Stitt,REP,720027,0,0,118,118,
Tulsa,Governor,Drew Edmondson,DEM,720027,0,0,145,145,
Tulsa,Lieutenant Governor,Matt Pinnell,REP,720027,0,0,144,144,
Tulsa,Lieutenant Governor,Anastasia Pittman,DEM,720027,0,0,120,120,
Tulsa,Lieutenant Governor,Ivan Holmes,IND,720027,0,0,14,14,
Tulsa,State Auditor,John Yeutter,LIB,720027,0,0,109,109,
Tulsa,State Auditor,Cindy Byrd,REP,720027,0,0,142,142,
Tulsa,Attorney General,Mike Hunter,REP,720027,0,0,145,145,
Tulsa,Attorney General,Mark Myles,DEM,720027,0,0,133,133,
Tulsa,State Treasurer,Randy Mcdaniel,REP,720027,0,0,149,149,
Tulsa,State Treasurer,Charles De Coune,IND,720027,0,0,103,103,
Tulsa,Superintendent of Public Instruction,Joy Hofmeister,REP,720027,0,0,133,133,
Tulsa,Superintendent of Public Instruction,John Cox,DEM,720027,0,0,117,117,
Tulsa,Superintendent of Public Instruction,Larry Huff,IND,720027,0,0,28,28,
Tulsa,Commissioner of Labor,Leslie Osborn,REP,720027,0,0,129,129,
Tulsa,Commissioner of Labor,Fred Dorrell,DEM,720027,0,0,132,132,
Tulsa,Commissioner of Labor,Brandt Dismukes,IND,720027,0,0,17,17,
Tulsa,Insurance Commissioner,Glen Mulready,REP,720027,0,0,133,133,
Tulsa,Insurance Commissioner,Kimberly Fobbs,DEM,720027,0,0,142,142,
Tulsa,Corporation Commissioner,Bob Anthony,REP,720027,0,0,130,130,
Tulsa,Corporation Commissioner,Ashley Nicole Mccray,DEM,720027,0,0,123,123,
Tulsa,Corporation Commissioner,Jackie Short,IND,720027,0,0,23,23,
Tulsa,U.S. House,Kevin Hern,REP,720027,0,0,127,127,1
Tulsa,U.S. House,Tim Gilpin,DEM,720027,0,0,151,151,1
Tulsa,State House,Todd Blackburn,REP,720027,0,0,118,118,77
Tulsa,State House,John Waldron,DEM,720027,0,0,161,161,77
Tulsa,Governor,Chris Powell,LIB,720028,0,0,19,19,
Tulsa,Governor,Kevin Stitt,REP,720028,0,0,178,178,
Tulsa,Governor,Drew Edmondson,DEM,720028,0,0,230,230,
Tulsa,Lieutenant Governor,Matt Pinnell,REP,720028,0,0,209,209,
Tulsa,Lieutenant Governor,Anastasia Pittman,DEM,720028,0,0,189,189,
Tulsa,Lieutenant Governor,Ivan Holmes,IND,720028,0,0,25,25,
Tulsa,State Auditor,John Yeutter,LIB,720028,0,0,163,163,
Tulsa,State Auditor,Cindy Byrd,REP,720028,0,0,228,228,
Tulsa,Attorney General,Mike Hunter,REP,720028,0,0,217,217,
Tulsa,Attorney General,Mark Myles,DEM,720028,0,0,203,203,
Tulsa,State Treasurer,Randy Mcdaniel,REP,720028,0,0,222,222,
Tulsa,State Treasurer,Charles De Coune,IND,720028,0,0,167,167,
Tulsa,Superintendent of Public Instruction,Joy Hofmeister,REP,720028,0,0,183,183,
Tulsa,Superintendent of Public Instruction,John Cox,DEM,720028,0,0,186,186,
Tulsa,Superintendent of Public Instruction,Larry Huff,IND,720028,0,0,50,50,
Tulsa,Commissioner of Labor,Leslie Osborn,REP,720028,0,0,196,196,
Tulsa,Commissioner of Labor,Fred Dorrell,DEM,720028,0,0,195,195,
Tulsa,Commissioner of Labor,Brandt Dismukes,IND,720028,0,0,25,25,
Tulsa,Insurance Commissioner,Glen Mulready,REP,720028,0,0,221,221,
Tulsa,Insurance Commissioner,Kimberly Fobbs,DEM,720028,0,0,200,200,
Tulsa,Corporation Commissioner,Bob Anthony,REP,720028,0,0,200,200,
Tulsa,Corporation Commissioner,Ashley Nicole Mccray,DEM,720028,0,0,192,192,
Tulsa,Corporation Commissioner,Jackie Short,IND,720028,0,0,28,28,
Tulsa,U.S. House,Kevin Hern,REP,720028,0,0,212,212,1
Tulsa,U.S. House,Tim Gilpin,DEM,720028,0,0,209,209,1
Tulsa,State House,Todd Blackburn,REP,720028,0,0,172,172,77
Tulsa,State House,John Waldron,DEM,720028,0,0,248,248,77
Tulsa,Governor,Chris Powell,LIB,720029,0,0,9,9,
Tulsa,Governor,Kevin Stitt,REP,720029,0,0,156,156,
Tulsa,Governor,Drew Edmondson,DEM,720029,0,0,162,162,
Tulsa,Lieutenant Governor,Matt Pinnell,REP,720029,0,0,169,169,
Tulsa,Lieutenant Governor,Anastasia Pittman,DEM,720029,0,0,145,145,
Tulsa,Lieutenant Governor,Ivan Holmes,IND,720029,0,0,11,11,
Tulsa,State Auditor,John Yeutter,LIB,720029,0,0,102,102,
Tulsa,State Auditor,Cindy Byrd,REP,720029,0,0,188,188,
Tulsa,Attorney General,Mike Hunter,REP,720029,0,0,172,172,
Tulsa,Attorney General,Mark Myles,DEM,720029,0,0,148,148,
Tulsa,State Treasurer,Randy Mcdaniel,REP,720029,0,0,174,174,
Tulsa,State Treasurer,Charles De Coune,IND,720029,0,0,114,114,
Tulsa,Superintendent of Public Instruction,Joy Hofmeister,REP,720029,0,0,163,163,
Tulsa,Superintendent of Public Instruction,John Cox,DEM,720029,0,0,134,134,
Tulsa,Superintendent of Public Instruction,Larry Huff,IND,720029,0,0,26,26,
Tulsa,Commissioner of Labor,Leslie Osborn,REP,720029,0,0,161,161,
Tulsa,Commissioner of Labor,Fred Dorrell,DEM,720029,0,0,146,146,
Tulsa,Commissioner of Labor,Brandt Dismukes,IND,720029,0,0,15,15,
Tulsa,Insurance Commissioner,Glen Mulready,REP,720029,0,0,164,164,
Tulsa,Insurance Commissioner,Kimberly Fobbs,DEM,720029,0,0,156,156,
Tulsa,Corporation Commissioner,Bob Anthony,REP,720029,0,0,163,163,
Tulsa,Corporation Commissioner,Ashley Nicole Mccray,DEM,720029,0,0,144,144,
Tulsa,Corporation Commissioner,Jackie Short,IND,720029,0,0,17,17,
Tulsa,U.S. House,Kevin Hern,REP,720029,0,0,170,170,1
Tulsa,U.S. House,Tim Gilpin,DEM,720029,0,0,153,153,1
Tulsa,State House,Todd Blackburn,REP,720029,0,0,146,146,77
Tulsa,State House,John Waldron,DEM,720029,0,0,179,179,77
Tulsa,Governor,Chris Powell,LIB,720030,0,0,16,16,
Tulsa,Governor,Kevin Stitt,REP,720030,0,0,176,176,
Tulsa,Governor,Drew Edmondson,DEM,720030,0,0,482,482,
Tulsa,Lieutenant Governor,Matt Pinnell,REP,720030,0,0,204,204,
Tulsa,Lieutenant Governor,Anastasia Pittman,DEM,720030,0,0,427,427,
Tulsa,Lieutenant Governor,Ivan Holmes,IND,720030,0,0,30,30,
Tulsa,State Auditor,John Yeutter,LIB,720030,0,0,294,294,
Tulsa,State Auditor,Cindy Byrd,REP,720030,0,0,298,298,
Tulsa,Attorney General,Mike Hunter,REP,720030,0,0,214,214,
Tulsa,Attorney General,Mark Myles,DEM,720030,0,0,444,444,
Tulsa,State Treasurer,Randy Mcdaniel,REP,720030,0,0,239,239,
Tulsa,State Treasurer,Charles De Coune,IND,720030,0,0,348,348,
Tulsa,Superintendent of Public Instruction,Joy Hofmeister,REP,720030,0,0,246,246,
Tulsa,Superintendent of Public Instruction,John Cox,DEM,720030,0,0,377,377,
Tulsa,Superintendent of Public Instruction,Larry Huff,IND,720030,0,0,37,37,
Tulsa,Commissioner of Labor,Leslie Osborn,REP,720030,0,0,214,214,
Tulsa,Commissioner of Labor,Fred Dorrell,DEM,720030,0,0,410,410,
Tulsa,Commissioner of Labor,Brandt Dismukes,IND,720030,0,0,28,28,
Tulsa,Insurance Commissioner,Glen Mulready,REP,720030,0,0,191,191,
Tulsa,Insurance Commissioner,Kimberly Fobbs,DEM,720030,0,0,462,462,
Tulsa,Corporation Commissioner,Bob Anthony,REP,720030,0,0,206,206,
Tulsa,Corporation Commissioner,Ashley Nicole Mccray,DEM,720030,0,0,409,409,
Tulsa,Corporation Commissioner,Jackie Short,IND,720030,0,0,40,40,
Tulsa,U.S. House,Kevin Hern,REP,720030,0,0,188,188,1
Tulsa,U.S. House,Tim Gilpin,DEM,720030,0,0,471,471,1
Tulsa,Governor,Chris Powell,LIB,720031,0,0,6,6,
Tulsa,Governor,Kevin Stitt,REP,720031,0,0,67,67,
Tulsa,Governor,Drew Edmondson,DEM,720031,0,0,164,164,
Tulsa,Lieutenant Governor,Matt Pinnell,REP,720031,0,0,81,81,
Tulsa,Lieutenant Governor,Anastasia Pittman,DEM,720031,0,0,145,145,
Tulsa,Lieutenant Governor,Ivan Holmes,IND,720031,0,0,11,11,
Tulsa,State Auditor,John Yeutter,LIB,720031,0,0,94,94,
Tulsa,State Auditor,Cindy Byrd,REP,720031,0,0,105,105,
Tulsa,Attorney General,Mike Hunter,REP,720031,0,0,79,79,
Tulsa,Attorney General,Mark Myles,DEM,720031,0,0,156,156,
Tulsa,State Treasurer,Randy Mcdaniel,REP,720031,0,0,91,91,
Tulsa,State Treasurer,Charles De Coune,IND,720031,0,0,109,109,
Tulsa,Superintendent of Public Instruction,Joy Hofmeister,REP,720031,0,0,77,77,
Tulsa,Superintendent of Public Instruction,John Cox,DEM,720031,0,0,138,138,
Tulsa,Superintendent of Public Instruction,Larry Huff,IND,720031,0,0,18,18,
Tulsa,Commissioner of Labor,Leslie Osborn,REP,720031,0,0,73,73,
Tulsa,Commissioner of Labor,Fred Dorrell,DEM,720031,0,0,147,147,
Tulsa,Commissioner of Labor,Brandt Dismukes,IND,720031,0,0,13,13,
Tulsa,Insurance Commissioner,Glen Mulready,REP,720031,0,0,74,74,
Tulsa,Insurance Commissioner,Kimberly Fobbs,DEM,720031,0,0,158,158,
Tulsa,Corporation Commissioner,Bob Anthony,REP,720031,0,0,75,75,
Tulsa,Corporation Commissioner,Ashley Nicole Mccray,DEM,720031,0,0,149,149,
Tulsa,Corporation Commissioner,Jackie Short,IND,720031,0,0,9,9,
Tulsa,U.S. House,Kevin Hern,REP,720031,0,0,74,74,1
Tulsa,U.S. House,Tim Gilpin,DEM,720031,0,0,163,163,1
Tulsa,Governor,Chris Powell,LIB,720032,0,0,9,9,
Tulsa,Governor,Kevin Stitt,REP,720032,0,0,84,84,
Tulsa,Governor,Drew Edmondson,DEM,720032,0,0,294,294,
Tulsa,Lieutenant Governor,Matt Pinnell,REP,720032,0,0,101,101,
Tulsa,Lieutenant Governor,Anastasia Pittman,DEM,720032,0,0,258,258,
Tulsa,Lieutenant Governor,Ivan Holmes,IND,720032,0,0,26,26,
Tulsa,State Auditor,John Yeutter,LIB,720032,0,0,188,188,
Tulsa,State Auditor,Cindy Byrd,REP,720032,0,0,143,143,
Tulsa,Attorney General,Mike Hunter,REP,720032,0,0,108,108,
Tulsa,Attorney General,Mark Myles,DEM,720032,0,0,274,274,
Tulsa,State Treasurer,Randy Mcdaniel,REP,720032,0,0,118,118,
Tulsa,State Treasurer,Charles De Coune,IND,720032,0,0,218,218,
Tulsa,Superintendent of Public Instruction,Joy Hofmeister,REP,720032,0,0,126,126,
Tulsa,Superintendent of Public Instruction,John Cox,DEM,720032,0,0,230,230,
Tulsa,Superintendent of Public Instruction,Larry Huff,IND,720032,0,0,27,27,
Tulsa,Commissioner of Labor,Leslie Osborn,REP,720032,0,0,107,107,
Tulsa,Commissioner of Labor,Fred Dorrell,DEM,720032,0,0,247,247,
Tulsa,Commissioner of Labor,Brandt Dismukes,IND,720032,0,0,20,20,
Tulsa,Insurance Commissioner,Glen Mulready,REP,720032,0,0,97,97,
Tulsa,Insurance Commissioner,Kimberly Fobbs,DEM,720032,0,0,280,280,
Tulsa,Corporation Commissioner,Bob Anthony,REP,720032,0,0,104,104,
Tulsa,Corporation Commissioner,Ashley Nicole Mccray,DEM,720032,0,0,260,260,
Tulsa,Corporation Commissioner,Jackie Short,IND,720032,0,0,15,15,
Tulsa,U.S. House,Kevin Hern,REP,720032,0,0,93,93,1
Tulsa,U.S. House,Tim Gilpin,DEM,720032,0,0,290,290,1
Tulsa,Governor,Chris Powell,LIB,720033,0,0,16,16,
Tulsa,Governor,Kevin Stitt,REP,720033,0,0,91,91,
Tulsa,Governor,Drew Edmondson,DEM,720033,0,0,239,239,
Tulsa,Lieutenant Governor,Matt Pinnell,REP,720033,0,0,114,114,
Tulsa,Lieutenant Governor,Anastasia Pittman,DEM,720033,0,0,219,219,
Tulsa,Lieutenant Governor,Ivan Holmes,IND,720033,0,0,10,10,
Tulsa,State Auditor,John Yeutter,LIB,720033,0,0,148,148,
Tulsa,State Auditor,Cindy Byrd,REP,720033,0,0,148,148,
Tulsa,Attorney General,Mike Hunter,REP,720033,0,0,114,114,
Tulsa,Attorney General,Mark Myles,DEM,720033,0,0,226,226,
Tulsa,State Treasurer,Randy Mcdaniel,REP,720033,0,0,121,121,
Tulsa,State Treasurer,Charles De Coune,IND,720033,0,0,179,179,
Tulsa,Superintendent of Public Instruction,Joy Hofmeister,REP,720033,0,0,116,116,
Tulsa,Superintendent of Public Instruction,John Cox,DEM,720033,0,0,191,191,
Tulsa,Superintendent of Public Instruction,Larry Huff,IND,720033,0,0,30,30,
Tulsa,Commissioner of Labor,Leslie Osborn,REP,720033,0,0,109,109,
Tulsa,Commissioner of Labor,Fred Dorrell,DEM,720033,0,0,192,192,
Tulsa,Commissioner of Labor,Brandt Dismukes,IND,720033,0,0,30,30,
Tulsa,Insurance Commissioner,Glen Mulready,REP,720033,0,0,106,106,
Tulsa,Insurance Commissioner,Kimberly Fobbs,DEM,720033,0,0,222,222,
Tulsa,Corporation Commissioner,Bob Anthony,REP,720033,0,0,110,110,
Tulsa,Corporation Commissioner,Ashley Nicole Mccray,DEM,720033,0,0,202,202,
Tulsa,Corporation Commissioner,Jackie Short,IND,720033,0,0,20,20,
Tulsa,U.S. House,Kevin Hern,REP,720033,0,0,106,106,1
Tulsa,U.S. House,Tim Gilpin,DEM,720033,0,0,234,234,1
Tulsa,Governor,Chris Powell,LIB,720034,0,0,9,9,
Tulsa,Governor,Kevin Stitt,REP,720034,0,0,89,89,
Tulsa,Governor,Drew Edmondson,DEM,720034,0,0,175,175,
Tulsa,Lieutenant Governor,Matt Pinnell,REP,720034,0,0,99,99,
Tulsa,Lieutenant Governor,Anastasia Pittman,DEM,720034,0,0,155,155,
Tulsa,Lieutenant Governor,Ivan Holmes,IND,720034,0,0,14,14,
Tulsa,State Auditor,John Yeutter,LIB,720034,0,0,108,108,
Tulsa,State Auditor,Cindy Byrd,REP,720034,0,0,124,124,
Tulsa,Attorney General,Mike Hunter,REP,720034,0,0,104,104,
Tulsa,Attorney General,Mark Myles,DEM,720034,0,0,163,163,
Tulsa,State Treasurer,Randy Mcdaniel,REP,720034,0,0,111,111,
Tulsa,State Treasurer,Charles De Coune,IND,720034,0,0,121,121,
Tulsa,Superintendent of Public Instruction,Joy Hofmeister,REP,720034,0,0,97,97,
Tulsa,Superintendent of Public Instruction,John Cox,DEM,720034,0,0,148,148,
Tulsa,Superintendent of Public Instruction,Larry Huff,IND,720034,0,0,21,21,
Tulsa,Commissioner of Labor,Leslie Osborn,REP,720034,0,0,97,97,
Tulsa,Commissioner of Labor,Fred Dorrell,DEM,720034,0,0,151,151,
Tulsa,Commissioner of Labor,Brandt Dismukes,IND,720034,0,0,14,14,
Tulsa,Insurance Commissioner,Glen Mulready,REP,720034,0,0,103,103,
Tulsa,Insurance Commissioner,Kimberly Fobbs,DEM,720034,0,0,161,161,
Tulsa,Corporation Commissioner,Bob Anthony,REP,720034,0,0,98,98,
Tulsa,Corporation Commissioner,Ashley Nicole Mccray,DEM,720034,0,0,152,152,
Tulsa,Corporation Commissioner,Jackie Short,IND,720034,0,0,15,15,
Tulsa,U.S. House,Kevin Hern,REP,720034,0,0,100,100,1
Tulsa,U.S. House,Tim Gilpin,DEM,720034,0,0,170,170,1
Tulsa,State House,Todd Blackburn,REP,720034,0,0,81,81,77
Tulsa,State House,John Waldron,DEM,720034,0,0,186,186,77
Tulsa,Governor,Chris Powell,LIB,720035,0,0,41,41,
Tulsa,Governor,Kevin Stitt,REP,720035,0,0,299,299,
Tulsa,Governor,Drew Edmondson,DEM,720035,0,0,585,585,
Tulsa,Lieutenant Governor,Matt Pinnell,REP,720035,0,0,356,356,
Tulsa,Lieutenant Governor,Anastasia Pittman,DEM,720035,0,0,502,502,
Tulsa,Lieutenant Governor,Ivan Holmes,IND,720035,0,0,56,56,
Tulsa,State Auditor,John Yeutter,LIB,720035,0,0,381,381,
Tulsa,State Auditor,Cindy Byrd,REP,720035,0,0,435,435,
Tulsa,Attorney General,Mike Hunter,REP,720035,0,0,343,343,
Tulsa,Attorney General,Mark Myles,DEM,720035,0,0,562,562,
Tulsa,State Treasurer,Randy Mcdaniel,REP,720035,0,0,375,375,
Tulsa,State Treasurer,Charles De Coune,IND,720035,0,0,437,437,
Tulsa,Superintendent of Public Instruction,Joy Hofmeister,REP,720035,0,0,364,364,
Tulsa,Superintendent of Public Instruction,John Cox,DEM,720035,0,0,482,482,
Tulsa,Superintendent of Public Instruction,Larry Huff,IND,720035,0,0,63,63,
Tulsa,Commissioner of Labor,Leslie Osborn,REP,720035,0,0,326,326,
Tulsa,Commissioner of Labor,Fred Dorrell,DEM,720035,0,0,514,514,
Tulsa,Commissioner of Labor,Brandt Dismukes,IND,720035,0,0,54,54,
Tulsa,Insurance Commissioner,Glen Mulready,REP,720035,0,0,351,351,
Tulsa,Insurance Commissioner,Kimberly Fobbs,DEM,720035,0,0,540,540,
Tulsa,Corporation Commissioner,Bob Anthony,REP,720035,0,0,329,329,
Tulsa,Corporation Commissioner,Ashley Nicole Mccray,DEM,720035,0,0,509,509,
Tulsa,Corporation Commissioner,Jackie Short,IND,720035,0,0,57,57,
Tulsa,U.S. House,Kevin Hern,REP,720035,0,0,339,339,1
Tulsa,U.S. House,Tim Gilpin,DEM,720035,0,0,579,579,1
Tulsa,State House,Todd Blackburn,REP,720035,0,0,297,297,77
Tulsa,State House,John Waldron,DEM,720035,0,0,616,616,77
Tulsa,Governor,Chris Powell,LIB,720036,0,0,35,35,
Tulsa,Governor,Kevin Stitt,REP,720036,0,0,286,286,
Tulsa,Governor,Drew Edmondson,DEM,720036,0,0,501,501,
Tulsa,Lieutenant Governor,Matt Pinnell,REP,720036,0,0,345,345,
Tulsa,Lieutenant Governor,Anastasia Pittman,DEM,720036,0,0,427,427,
Tulsa,Lieutenant Governor,Ivan Holmes,IND,720036,0,0,37,37,
Tulsa,State Auditor,John Yeutter,LIB,720036,0,0,302,302,
Tulsa,State Auditor,Cindy Byrd,REP,720036,0,0,415,415,
Tulsa,Attorney General,Mike Hunter,REP,720036,0,0,342,342,
Tulsa,Attorney General,Mark Myles,DEM,720036,0,0,466,466,
Tulsa,State Treasurer,Randy Mcdaniel,REP,720036,0,0,356,356,
Tulsa,State Treasurer,Charles De Coune,IND,720036,0,0,362,362,
Tulsa,Superintendent of Public Instruction,Joy Hofmeister,REP,720036,0,0,330,330,
Tulsa,Superintendent of Public Instruction,John Cox,DEM,720036,0,0,412,412,
Tulsa,Superintendent of Public Instruction,Larry Huff,IND,720036,0,0,67,67,
Tulsa,Commissioner of Labor,Leslie Osborn,REP,720036,0,0,317,317,
Tulsa,Commissioner of Labor,Fred Dorrell,DEM,720036,0,0,438,438,
Tulsa,Commissioner of Labor,Brandt Dismukes,IND,720036,0,0,41,41,
Tulsa,Insurance Commissioner,Glen Mulready,REP,720036,0,0,345,345,
Tulsa,Insurance Commissioner,Kimberly Fobbs,DEM,720036,0,0,454,454,
Tulsa,Corporation Commissioner,Bob Anthony,REP,720036,0,0,340,340,
Tulsa,Corporation Commissioner,Ashley Nicole Mccray,DEM,720036,0,0,414,414,
Tulsa,Corporation Commissioner,Jackie Short,IND,720036,0,0,53,53,
Tulsa,U.S. House,Kevin Hern,REP,720036,0,0,323,323,1
Tulsa,U.S. House,Tim Gilpin,DEM,720036,0,0,490,490,1
Tulsa,State House,Todd Blackburn,REP,720036,0,0,282,282,77
Tulsa,State House,John Waldron,DEM,720036,0,0,534,534,77
Tulsa,Governor,Chris Powell,LIB,720037,0,0,4,4,
Tulsa,Governor,Kevin Stitt,REP,720037,0,0,29,29,
Tulsa,Governor,Drew Edmondson,DEM,720037,0,0,179,179,
Tulsa,Lieutenant Governor,Matt Pinnell,REP,720037,0,0,48,48,
Tulsa,Lieutenant Governor,Anastasia Pittman,DEM,720037,0,0,153,153,
Tulsa,Lieutenant Governor,Ivan Holmes,IND,720037,0,0,10,10,
Tulsa,State Auditor,John Yeutter,LIB,720037,0,0,111,111,
Tulsa,State Auditor,Cindy Byrd,REP,720037,0,0,67,67,
Tulsa,Attorney General,Mike Hunter,REP,720037,0,0,43,43,
Tulsa,Attorney General,Mark Myles,DEM,720037,0,0,169,169,
Tulsa,State Treasurer,Randy Mcdaniel,REP,720037,0,0,43,43,
Tulsa,State Treasurer,Charles De Coune,IND,720037,0,0,133,133,
Tulsa,Superintendent of Public Instruction,Joy Hofmeister,REP,720037,0,0,45,45,
Tulsa,Superintendent of Public Instruction,John Cox,DEM,720037,0,0,156,156,
Tulsa,Superintendent of Public Instruction,Larry Huff,IND,720037,0,0,9,9,
Tulsa,Commissioner of Labor,Leslie Osborn,REP,720037,0,0,34,34,
Tulsa,Commissioner of Labor,Fred Dorrell,DEM,720037,0,0,164,164,
Tulsa,Commissioner of Labor,Brandt Dismukes,IND,720037,0,0,10,10,
Tulsa,Insurance Commissioner,Glen Mulready,REP,720037,0,0,39,39,
Tulsa,Insurance Commissioner,Kimberly Fobbs,DEM,720037,0,0,172,172,
Tulsa,Corporation Commissioner,Bob Anthony,REP,720037,0,0,38,38,
Tulsa,Corporation Commissioner,Ashley Nicole Mccray,DEM,720037,0,0,165,165,
Tulsa,Corporation Commissioner,Jackie Short,IND,720037,0,0,8,8,
Tulsa,U.S. House,Kevin Hern,REP,720037,0,0,40,40,1
Tulsa,U.S. House,Tim Gilpin,DEM,720037,0,0,173,173,1
Tulsa,Governor,Chris Powell,LIB,720038,0,0,20,20,
Tulsa,Governor,Kevin Stitt,REP,720038,0,0,170,170,
Tulsa,Governor,Drew Edmondson,DEM,720038,0,0,165,165,
Tulsa,Lieutenant Governor,Matt Pinnell,REP,720038,0,0,184,184,
Tulsa,Lieutenant Governor,Anastasia Pittman,DEM,720038,0,0,154,154,
Tulsa,Lieutenant Governor,Ivan Holmes,IND,720038,0,0,17,17,
Tulsa,State Auditor,John Yeutter,LIB,720038,0,0,102,102,
Tulsa,State Auditor,Cindy Byrd,REP,720038,0,0,221,221,
Tulsa,Attorney General,Mike Hunter,REP,720038,0,0,203,203,
Tulsa,Attorney General,Mark Myles,DEM,720038,0,0,152,152,
Tulsa,State Treasurer,Randy Mcdaniel,REP,720038,0,0,203,203,
Tulsa,State Treasurer,Charles De Coune,IND,720038,0,0,121,121,
Tulsa,Superintendent of Public Instruction,Joy Hofmeister,REP,720038,0,0,178,178,
Tulsa,Superintendent of Public Instruction,John Cox,DEM,720038,0,0,141,141,
Tulsa,Superintendent of Public Instruction,Larry Huff,IND,720038,0,0,34,34,
Tulsa,Commissioner of Labor,Leslie Osborn,REP,720038,0,0,185,185,
Tulsa,Commissioner of Labor,Fred Dorrell,DEM,720038,0,0,144,144,
Tulsa,Commissioner of Labor,Brandt Dismukes,IND,720038,0,0,25,25,
Tulsa,Insurance Commissioner,Glen Mulready,REP,720038,0,0,187,187,
Tulsa,Insurance Commissioner,Kimberly Fobbs,DEM,720038,0,0,164,164,
Tulsa,Corporation Commissioner,Bob Anthony,REP,720038,0,0,183,183,
Tulsa,Corporation Commissioner,Ashley Nicole Mccray,DEM,720038,0,0,146,146,
Tulsa,Corporation Commissioner,Jackie Short,IND,720038,0,0,26,26,
Tulsa,U.S. House,Kevin Hern,REP,720038,0,0,194,194,1
Tulsa,U.S. House,Tim Gilpin,DEM,720038,0,0,158,158,1
Tulsa,State House,Todd Blackburn,REP,720038,0,0,162,162,77
Tulsa,State House,John Waldron,DEM,720038,0,0,191,191,77
Tulsa,Governor,Chris Powell,LIB,720039,0,0,26,26,
Tulsa,Governor,Kevin Stitt,REP,720039,0,0,271,271,
Tulsa,Governor,Drew Edmondson,DEM,720039,0,0,255,255,
Tulsa,Lieutenant Governor,Matt Pinnell,REP,720039,0,0,287,287,
Tulsa,Lieutenant Governor,Anastasia Pittman,DEM,720039,0,0,232,232,
Tulsa,Lieutenant Governor,Ivan Holmes,IND,720039,0,0,30,30,
Tulsa,State Auditor,John Yeutter,LIB,720039,0,0,165,165,
Tulsa,State Auditor,Cindy Byrd,REP,720039,0,0,321,321,
Tulsa,Attorney General,Mike Hunter,REP,720039,0,0,307,307,
Tulsa,Attorney General,Mark Myles,DEM,720039,0,0,242,242,
Tulsa,State Treasurer,Randy Mcdaniel,REP,720039,0,0,311,311,
Tulsa,State Treasurer,Charles De Coune,IND,720039,0,0,180,180,
Tulsa,Superintendent of Public Instruction,Joy Hofmeister,REP,720039,0,0,271,271,
Tulsa,Superintendent of Public Instruction,John Cox,DEM,720039,0,0,225,225,
Tulsa,Superintendent of Public Instruction,Larry Huff,IND,720039,0,0,51,51,
Tulsa,Commissioner of Labor,Leslie Osborn,REP,720039,0,0,284,284,
Tulsa,Commissioner of Labor,Fred Dorrell,DEM,720039,0,0,223,223,
Tulsa,Commissioner of Labor,Brandt Dismukes,IND,720039,0,0,37,37,
Tulsa,Insurance Commissioner,Glen Mulready,REP,720039,0,0,303,303,
Tulsa,Insurance Commissioner,Kimberly Fobbs,DEM,720039,0,0,239,239,
Tulsa,Corporation Commissioner,Bob Anthony,REP,720039,0,0,289,289,
Tulsa,Corporation Commissioner,Ashley Nicole Mccray,DEM,720039,0,0,223,223,
Tulsa,Corporation Commissioner,Jackie Short,IND,720039,0,0,32,32,
Tulsa,U.S. House,Kevin Hern,REP,720039,0,0,312,312,1
Tulsa,U.S. House,Tim Gilpin,DEM,720039,0,0,235,235,1
Tulsa,State House,Todd Blackburn,REP,720039,0,0,249,249,77
Tulsa,State House,John Waldron,DEM,720039,0,0,297,297,77
Tulsa,Governor,Chris Powell,LIB,720040,0,0,13,13,
Tulsa,Governor,Kevin Stitt,REP,720040,0,0,75,75,
Tulsa,Governor,Drew Edmondson,DEM,720040,0,0,105,105,
Tulsa,Lieutenant Governor,Matt Pinnell,REP,720040,0,0,83,83,
Tulsa,Lieutenant Governor,Anastasia Pittman,DEM,720040,0,0,91,91,
Tulsa,Lieutenant Governor,Ivan Holmes,IND,720040,0,0,17,17,
Tulsa,State Auditor,John Yeutter,LIB,720040,0,0,77,77,
Tulsa,State Auditor,Cindy Byrd,REP,720040,0,0,95,95,
Tulsa,Attorney General,Mike Hunter,REP,720040,0,0,83,83,
Tulsa,Attorney General,Mark Myles,DEM,720040,0,0,108,108,
Tulsa,State Treasurer,Randy Mcdaniel,REP,720040,0,0,95,95,
Tulsa,State Treasurer,Charles De Coune,IND,720040,0,0,79,79,
Tulsa,Superintendent of Public Instruction,Joy Hofmeister,REP,720040,0,0,74,74,
Tulsa,Superintendent of Public Instruction,John Cox,DEM,720040,0,0,93,93,
Tulsa,Superintendent of Public Instruction,Larry Huff,IND,720040,0,0,25,25,
Tulsa,Commissioner of Labor,Leslie Osborn,REP,720040,0,0,84,84,
Tulsa,Commissioner of Labor,Fred Dorrell,DEM,720040,0,0,93,93,
Tulsa,Commissioner of Labor,Brandt Dismukes,IND,720040,0,0,16,16,
Tulsa,Insurance Commissioner,Glen Mulready,REP,720040,0,0,78,78,
Tulsa,Insurance Commissioner,Kimberly Fobbs,DEM,720040,0,0,115,115,
Tulsa,Corporation Commissioner,Bob Anthony,REP,720040,0,0,76,76,
Tulsa,Corporation Commissioner,Ashley Nicole Mccray,DEM,720040,0,0,100,100,
Tulsa,Corporation Commissioner,Jackie Short,IND,720040,0,0,15,15,
Tulsa,U.S. House,Kevin Hern,REP,720040,0,0,83,83,1
Tulsa,U.S. House,Tim Gilpin,DEM,720040,0,0,110,110,1
Tulsa,State House,Todd Blackburn,REP,720040,0,0,71,71,77
Tulsa,State House,John Waldron,DEM,720040,0,0,121,121,77
Tulsa,Governor,Chris Powell,LIB,720041,0,0,19,19,
Tulsa,Governor,Kevin Stitt,REP,720041,0,0,131,131,
Tulsa,Governor,Drew Edmondson,DEM,720041,0,0,142,142,
Tulsa,Lieutenant Governor,Matt Pinnell,REP,720041,0,0,148,148,
Tulsa,Lieutenant Governor,Anastasia Pittman,DEM,720041,0,0,129,129,
Tulsa,Lieutenant Governor,Ivan Holmes,IND,720041,0,0,12,12,
Tulsa,State Auditor,John Yeutter,LIB,720041,0,0,97,97,
Tulsa,State Auditor,Cindy Byrd,REP,720041,0,0,163,163,
Tulsa,Attorney General,Mike Hunter,REP,720041,0,0,149,149,
Tulsa,Attorney General,Mark Myles,DEM,720041,0,0,135,135,
Tulsa,State Treasurer,Randy Mcdaniel,REP,720041,0,0,156,156,
Tulsa,State Treasurer,Charles De Coune,IND,720041,0,0,102,102,
Tulsa,Superintendent of Public Instruction,Joy Hofmeister,REP,720041,0,0,137,137,
Tulsa,Superintendent of Public Instruction,John Cox,DEM,720041,0,0,123,123,
Tulsa,Superintendent of Public Instruction,Larry Huff,IND,720041,0,0,24,24,
Tulsa,Commissioner of Labor,Leslie Osborn,REP,720041,0,0,140,140,
Tulsa,Commissioner of Labor,Fred Dorrell,DEM,720041,0,0,121,121,
Tulsa,Commissioner of Labor,Brandt Dismukes,IND,720041,0,0,21,21,
Tulsa,Insurance Commissioner,Glen Mulready,REP,720041,0,0,141,141,
Tulsa,Insurance Commissioner,Kimberly Fobbs,DEM,720041,0,0,144,144,
Tulsa,Corporation Commissioner,Bob Anthony,REP,720041,0,0,139,139,
Tulsa,Corporation Commissioner,Ashley Nicole Mccray,DEM,720041,0,0,131,131,
Tulsa,Corporation Commissioner,Jackie Short,IND,720041,0,0,17,17,
Tulsa,U.S. House,Kevin Hern,REP,720041,0,0,139,139,1
Tulsa,U.S. House,Tim Gilpin,DEM,720041,0,0,147,147,1
Tulsa,State House,Todd Blackburn,REP,720041,0,0,132,132,77
Tulsa,State House,John Waldron,DEM,720041,0,0,153,153,77
Tulsa,Governor,Chris Powell,LIB,720042,0,0,15,15,
Tulsa,Governor,Kevin Stitt,REP,720042,0,0,203,203,
Tulsa,Governor,Drew Edmondson,DEM,720042,0,0,114,114,
Tulsa,Lieutenant Governor,Matt Pinnell,REP,720042,0,0,220,220,
Tulsa,Lieutenant Governor,Anastasia Pittman,DEM,720042,0,0,93,93,
Tulsa,Lieutenant Governor,Ivan Holmes,IND,720042,0,0,19,19,
Tulsa,State Auditor,John Yeutter,LIB,720042,0,0,75,75,
Tulsa,State Auditor,Cindy Byrd,REP,720042,0,0,233,233,
Tulsa,Attorney General,Mike Hunter,REP,720042,0,0,230,230,
Tulsa,Attorney General,Mark Myles,DEM,720042,0,0,100,100,
Tulsa,State Treasurer,Randy Mcdaniel,REP,720042,0,0,232,232,
Tulsa,State Treasurer,Charles De Coune,IND,720042,0,0,76,76,
Tulsa,Superintendent of Public Instruction,Joy Hofmeister,REP,720042,0,0,210,210,
Tulsa,Superintendent of Public Instruction,John Cox,DEM,720042,0,0,88,88,
Tulsa,Superintendent of Public Instruction,Larry Huff,IND,720042,0,0,33,33,
Tulsa,Commissioner of Labor,Leslie Osborn,REP,720042,0,0,207,207,
Tulsa,Commissioner of Labor,Fred Dorrell,DEM,720042,0,0,102,102,
Tulsa,Commissioner of Labor,Brandt Dismukes,IND,720042,0,0,21,21,
Tulsa,Insurance Commissioner,Glen Mulready,REP,720042,0,0,226,226,
Tulsa,Insurance Commissioner,Kimberly Fobbs,DEM,720042,0,0,104,104,
Tulsa,Corporation Commissioner,Bob Anthony,REP,720042,0,0,215,215,
Tulsa,Corporation Commissioner,Ashley Nicole Mccray,DEM,720042,0,0,87,87,
Tulsa,Corporation Commissioner,Jackie Short,IND,720042,0,0,25,25,
Tulsa,U.S. House,Kevin Hern,REP,720042,0,0,222,222,1
Tulsa,U.S. House,Tim Gilpin,DEM,720042,0,0,109,109,1
Tulsa,State House,Terry O'Donnell,REP,720042,0,0,220,220,23
Tulsa,State House,Craig John Hoxie,DEM,720042,0,0,111,111,23
Tulsa,Governor,Chris Powell,LIB,720043,0,0,23,23,
Tulsa,Governor,Kevin Stitt,REP,720043,0,0,203,203,
Tulsa,Governor,Drew Edmondson,DEM,720043,0,0,156,156,
Tulsa,Lieutenant Governor,Matt Pinnell,REP,720043,0,0,236,236,
Tulsa,Lieutenant Governor,Anastasia Pittman,DEM,720043,0,0,120,120,
Tulsa,Lieutenant Governor,Ivan Holmes,IND,720043,0,0,22,22,
Tulsa,State Auditor,John Yeutter,LIB,720043,0,0,101,101,
Tulsa,State Auditor,Cindy Byrd,REP,720043,0,0,254,254,
Tulsa,Attorney General,Mike Hunter,REP,720043,0,0,238,238,
Tulsa,Attorney General,Mark Myles,DEM,720043,0,0,142,142,
Tulsa,State Treasurer,Randy Mcdaniel,REP,720043,0,0,240,240,
Tulsa,State Treasurer,Charles De Coune,IND,720043,0,0,111,111,
Tulsa,Superintendent of Public Instruction,Joy Hofmeister,REP,720043,0,0,199,199,
Tulsa,Superintendent of Public Instruction,John Cox,DEM,720043,0,0,139,139,
Tulsa,Superintendent of Public Instruction,Larry Huff,IND,720043,0,0,38,38,
Tulsa,Commissioner of Labor,Leslie Osborn,REP,720043,0,0,222,222,
Tulsa,Commissioner of Labor,Fred Dorrell,DEM,720043,0,0,122,122,
Tulsa,Commissioner of Labor,Brandt Dismukes,IND,720043,0,0,27,27,
Tulsa,Insurance Commissioner,Glen Mulready,REP,720043,0,0,236,236,
Tulsa,Insurance Commissioner,Kimberly Fobbs,DEM,720043,0,0,141,141,
Tulsa,Corporation Commissioner,Bob Anthony,REP,720043,0,0,222,222,
Tulsa,Corporation Commissioner,Ashley Nicole Mccray,DEM,720043,0,0,131,131,
Tulsa,Corporation Commissioner,Jackie Short,IND,720043,0,0,24,24,
Tulsa,U.S. House,Kevin Hern,REP,720043,0,0,234,234,1
Tulsa,U.S. House,Tim Gilpin,DEM,720043,0,0,144,144,1
Tulsa,State House,Todd Blackburn,REP,720043,0,0,204,204,77
Tulsa,State House,John Waldron,DEM,720043,0,0,169,169,77
Tulsa,Governor,Chris Powell,LIB,720044,0,0,13,13,
Tulsa,Governor,Kevin Stitt,REP,720044,0,0,328,328,
Tulsa,Governor,Drew Edmondson,DEM,720044,0,0,244,244,
Tulsa,Lieutenant Governor,Matt Pinnell,REP,720044,0,0,342,342,
Tulsa,Lieutenant Governor,Anastasia Pittman,DEM,720044,0,0,220,220,
Tulsa,Lieutenant Governor,Ivan Holmes,IND,720044,0,0,22,22,
Tulsa,State Auditor,John Yeutter,LIB,720044,0,0,157,157,
Tulsa,State Auditor,Cindy Byrd,REP,720044,0,0,388,388,
Tulsa,Attorney General,Mike Hunter,REP,720044,0,0,358,358,
Tulsa,Attorney General,Mark Myles,DEM,720044,0,0,228,228,
Tulsa,State Treasurer,Randy Mcdaniel,REP,720044,0,0,366,366,
Tulsa,State Treasurer,Charles De Coune,IND,720044,0,0,175,175,
Tulsa,Superintendent of Public Instruction,Joy Hofmeister,REP,720044,0,0,317,317,
Tulsa,Superintendent of Public Instruction,John Cox,DEM,720044,0,0,236,236,
Tulsa,Superintendent of Public Instruction,Larry Huff,IND,720044,0,0,33,33,
Tulsa,Commissioner of Labor,Leslie Osborn,REP,720044,0,0,328,328,
Tulsa,Commissioner of Labor,Fred Dorrell,DEM,720044,0,0,230,230,
Tulsa,Commissioner of Labor,Brandt Dismukes,IND,720044,0,0,22,22,
Tulsa,Insurance Commissioner,Glen Mulready,REP,720044,0,0,333,333,
Tulsa,Insurance Commissioner,Kimberly Fobbs,DEM,720044,0,0,248,248,
Tulsa,Corporation Commissioner,Bob Anthony,REP,720044,0,0,336,336,
Tulsa,Corporation Commissioner,Ashley Nicole Mccray,DEM,720044,0,0,223,223,
Tulsa,Corporation Commissioner,Jackie Short,IND,720044,0,0,24,24,
Tulsa,U.S. House,Kevin Hern,REP,720044,0,0,342,342,1
Tulsa,U.S. House,Tim Gilpin,DEM,720044,0,0,241,241,1
Tulsa,State House,Terry O'Donnell,REP,720044,0,0,337,337,23
Tulsa,State House,Craig John Hoxie,DEM,720044,0,0,244,244,23
Tulsa,Governor,Chris Powell,LIB,720045,0,0,0,0,
Tulsa,Governor,Kevin Stitt,REP,720045,0,0,6,6,
Tulsa,Governor,Drew Edmondson,DEM,720045,0,0,1,1,
Tulsa,Lieutenant Governor,Matt Pinnell,REP,720045,0,0,6,6,
Tulsa,Lieutenant Governor,Anastasia Pittman,DEM,720045,0,0,1,1,
Tulsa,Lieutenant Governor,Ivan Holmes,IND,720045,0,0,0,0,
Tulsa,State Auditor,John Yeutter,LIB,720045,0,0,0,0,
Tulsa,State Auditor,Cindy Byrd,REP,720045,0,0,7,7,
Tulsa,Attorney General,Mike Hunter,REP,720045,0,0,6,6,
Tulsa,Attorney General,Mark Myles,DEM,720045,0,0,1,1,
Tulsa,State Treasurer,Randy Mcdaniel,REP,720045,0,0,7,7,
Tulsa,State Treasurer,Charles De Coune,IND,720045,0,0,0,0,
Tulsa,Superintendent of Public Instruction,Joy Hofmeister,REP,720045,0,0,7,7,
Tulsa,Superintendent of Public Instruction,John Cox,DEM,720045,0,0,0,0,
Tulsa,Superintendent of Public Instruction,Larry Huff,IND,720045,0,0,0,0,
Tulsa,Commissioner of Labor,Leslie Osborn,REP,720045,0,0,6,6,
Tulsa,Commissioner of Labor,Fred Dorrell,DEM,720045,0,0,1,1,
Tulsa,Commissioner of Labor,Brandt Dismukes,IND,720045,0,0,0,0,
Tulsa,Insurance Commissioner,Glen Mulready,REP,720045,0,0,6,6,
Tulsa,Insurance Commissioner,Kimberly Fobbs,DEM,720045,0,0,1,1,
Tulsa,Corporation Commissioner,Bob Anthony,REP,720045,0,0,7,7,
Tulsa,Corporation Commissioner,Ashley Nicole Mccray,DEM,720045,0,0,0,0,
Tulsa,Corporation Commissioner,Jackie Short,IND,720045,0,0,0,0,
Tulsa,U.S. House,Kevin Hern,REP,720045,0,0,6,6,1
Tulsa,U.S. House,Tim Gilpin,DEM,720045,0,0,1,1,1
Tulsa,State Senate,John Haste,REP,720045,0,0,6,6,36
Tulsa,State Senate,Bryan O'Brien,DEM,720045,0,0,1,1,36
Tulsa,State House,Terry O'Donnell,REP,720045,0,0,6,6,23
Tulsa,State House,Craig John Hoxie,DEM,720045,0,0,1,1,23
Tulsa,Governor,Chris Powell,LIB,720046,0,0,24,24,
Tulsa,Governor,Kevin Stitt,REP,720046,0,0,279,279,
Tulsa,Governor,Drew Edmondson,DEM,720046,0,0,817,817,
Tulsa,Lieutenant Governor,Matt Pinnell,REP,720046,0,0,354,354,
Tulsa,Lieutenant Governor,Anastasia Pittman,DEM,720046,0,0,698,698,
Tulsa,Lieutenant Governor,Ivan Holmes,IND,720046,0,0,51,51,
Tulsa,State Auditor,John Yeutter,LIB,720046,0,0,454,454,
Tulsa,State Auditor,Cindy Byrd,REP,720046,0,0,519,519,
Tulsa,Attorney General,Mike Hunter,REP,720046,0,0,356,356,
Tulsa,Attorney General,Mark Myles,DEM,720046,0,0,745,745,
Tulsa,State Treasurer,Randy Mcdaniel,REP,720046,0,0,417,417,
Tulsa,State Treasurer,Charles De Coune,IND,720046,0,0,566,566,
Tulsa,Superintendent of Public Instruction,Joy Hofmeister,REP,720046,0,0,435,435,
Tulsa,Superintendent of Public Instruction,John Cox,DEM,720046,0,0,600,600,
Tulsa,Superintendent of Public Instruction,Larry Huff,IND,720046,0,0,68,68,
Tulsa,Commissioner of Labor,Leslie Osborn,REP,720046,0,0,342,342,
Tulsa,Commissioner of Labor,Fred Dorrell,DEM,720046,0,0,674,674,
Tulsa,Commissioner of Labor,Brandt Dismukes,IND,720046,0,0,66,66,
Tulsa,Insurance Commissioner,Glen Mulready,REP,720046,0,0,346,346,
Tulsa,Insurance Commissioner,Kimberly Fobbs,DEM,720046,0,0,736,736,
Tulsa,Corporation Commissioner,Bob Anthony,REP,720046,0,0,358,358,
Tulsa,Corporation Commissioner,Ashley Nicole Mccray,DEM,720046,0,0,670,670,
Tulsa,Corporation Commissioner,Jackie Short,IND,720046,0,0,67,67,
Tulsa,U.S. House,Kevin Hern,REP,720046,0,0,315,315,1
Tulsa,U.S. House,Tim Gilpin,DEM,720046,0,0,793,793,1
Tulsa,State House,Jadine Nollan,REP,720046,0,0,335,335,66
Tulsa,State House,Angela Graham,DEM,720046,0,0,759,759,66
Tulsa,Governor,Chris Powell,LIB,720047,0,0,3,3,
Tulsa,Governor,Kevin Stitt,REP,720047,0,0,28,28,
Tulsa,Governor,Drew Edmondson,DEM,720047,0,0,115,115,
Tulsa,Lieutenant Governor,Matt Pinnell,REP,720047,0,0,38,38,
Tulsa,Lieutenant Governor,Anastasia Pittman,DEM,720047,0,0,99,99,
Tulsa,Lieutenant Governor,Ivan Holmes,IND,720047,0,0,9,9,
Tulsa,State Auditor,John Yeutter,LIB,720047,0,0,70,70,
Tulsa,State Auditor,Cindy Byrd,REP,720047,0,0,50,50,
Tulsa,Attorney General,Mike Hunter,REP,720047,0,0,35,35,
Tulsa,Attorney General,Mark Myles,DEM,720047,0,0,111,111,
Tulsa,State Treasurer,Randy Mcdaniel,REP,720047,0,0,43,43,
Tulsa,State Treasurer,Charles De Coune,IND,720047,0,0,77,77,
Tulsa,Superintendent of Public Instruction,Joy Hofmeister,REP,720047,0,0,38,38,
Tulsa,Superintendent of Public Instruction,John Cox,DEM,720047,0,0,97,97,
Tulsa,Superintendent of Public Instruction,Larry Huff,IND,720047,0,0,8,8,
Tulsa,Commissioner of Labor,Leslie Osborn,REP,720047,0,0,29,29,
Tulsa,Commissioner of Labor,Fred Dorrell,DEM,720047,0,0,102,102,
Tulsa,Commissioner of Labor,Brandt Dismukes,IND,720047,0,0,9,9,
Tulsa,Insurance Commissioner,Glen Mulready,REP,720047,0,0,33,33,
Tulsa,Insurance Commissioner,Kimberly Fobbs,DEM,720047,0,0,109,109,
Tulsa,Corporation Commissioner,Bob Anthony,REP,720047,0,0,31,31,
Tulsa,Corporation Commissioner,Ashley Nicole Mccray,DEM,720047,0,0,105,105,
Tulsa,Corporation Commissioner,Jackie Short,IND,720047,0,0,6,6,
Tulsa,U.S. House,Kevin Hern,REP,720047,0,0,29,29,1
Tulsa,U.S. House,Tim Gilpin,DEM,720047,0,0,116,116,1
Tulsa,State House,Gene Bell,LIB,720047,0,0,8,8,78
Tulsa,State House,Paul Royse,REP,720047,0,0,24,24,78
Tulsa,State House,Meloyde Blancett,DEM,720047,0,0,110,110,78
Tulsa,Governor,Chris Powell,LIB,720048,0,0,20,20,
Tulsa,Governor,Kevin Stitt,REP,720048,0,0,224,224,
Tulsa,Governor,Drew Edmondson,DEM,720048,0,0,615,615,
Tulsa,Lieutenant Governor,Matt Pinnell,REP,720048,0,0,303,303,
Tulsa,Lieutenant Governor,Anastasia Pittman,DEM,720048,0,0,516,516,
Tulsa,Lieutenant Governor,Ivan Holmes,IND,720048,0,0,31,31,
Tulsa,State Auditor,John Yeutter,LIB,720048,0,0,293,293,
Tulsa,State Auditor,Cindy Byrd,REP,720048,0,0,417,417,
Tulsa,Attorney General,Mike Hunter,REP,720048,0,0,308,308,
Tulsa,Attorney General,Mark Myles,DEM,720048,0,0,536,536,
Tulsa,State Treasurer,Randy Mcdaniel,REP,720048,0,0,326,326,
Tulsa,State Treasurer,Charles De Coune,IND,720048,0,0,389,389,
Tulsa,Superintendent of Public Instruction,Joy Hofmeister,REP,720048,0,0,359,359,
Tulsa,Superintendent of Public Instruction,John Cox,DEM,720048,0,0,434,434,
Tulsa,Superintendent of Public Instruction,Larry Huff,IND,720048,0,0,47,47,
Tulsa,Commissioner of Labor,Leslie Osborn,REP,720048,0,0,297,297,
Tulsa,Commissioner of Labor,Fred Dorrell,DEM,720048,0,0,469,469,
Tulsa,Commissioner of Labor,Brandt Dismukes,IND,720048,0,0,47,47,
Tulsa,Insurance Commissioner,Glen Mulready,REP,720048,0,0,284,284,
Tulsa,Insurance Commissioner,Kimberly Fobbs,DEM,720048,0,0,531,531,
Tulsa,Corporation Commissioner,Bob Anthony,REP,720048,0,0,305,305,
Tulsa,Corporation Commissioner,Ashley Nicole Mccray,DEM,720048,0,0,469,469,
Tulsa,Corporation Commissioner,Jackie Short,IND,720048,0,0,55,55,
Tulsa,U.S. House,Kevin Hern,REP,720048,0,0,268,268,1
Tulsa,U.S. House,Tim Gilpin,DEM,720048,0,0,585,585,1
Tulsa,State House,Gene Bell,LIB,720048,0,0,34,34,78
Tulsa,State House,Paul Royse,REP,720048,0,0,213,213,78
Tulsa,State House,Meloyde Blancett,DEM,720048,0,0,601,601,78
Tulsa,Governor,Chris Powell,LIB,720049,0,0,14,14,
Tulsa,Governor,Kevin Stitt,REP,720049,0,0,68,68,
Tulsa,Governor,Drew Edmondson,DEM,720049,0,0,284,284,
Tulsa,Lieutenant Governor,Matt Pinnell,REP,720049,0,0,86,86,
Tulsa,Lieutenant Governor,Anastasia Pittman,DEM,720049,0,0,254,254,
Tulsa,Lieutenant Governor,Ivan Holmes,IND,720049,0,0,23,23,
Tulsa,State Auditor,John Yeutter,LIB,720049,0,0,170,170,
Tulsa,State Auditor,Cindy Byrd,REP,720049,0,0,142,142,
Tulsa,Attorney General,Mike Hunter,REP,720049,0,0,100,100,
Tulsa,Attorney General,Mark Myles,DEM,720049,0,0,263,263,
Tulsa,State Treasurer,Randy Mcdaniel,REP,720049,0,0,110,110,
Tulsa,State Treasurer,Charles De Coune,IND,720049,0,0,200,200,
Tulsa,Superintendent of Public Instruction,Joy Hofmeister,REP,720049,0,0,107,107,
Tulsa,Superintendent of Public Instruction,John Cox,DEM,720049,0,0,229,229,
Tulsa,Superintendent of Public Instruction,Larry Huff,IND,720049,0,0,27,27,
Tulsa,Commissioner of Labor,Leslie Osborn,REP,720049,0,0,98,98,
Tulsa,Commissioner of Labor,Fred Dorrell,DEM,720049,0,0,238,238,
Tulsa,Commissioner of Labor,Brandt Dismukes,IND,720049,0,0,21,21,
Tulsa,Insurance Commissioner,Glen Mulready,REP,720049,0,0,100,100,
Tulsa,Insurance Commissioner,Kimberly Fobbs,DEM,720049,0,0,257,257,
Tulsa,Corporation Commissioner,Bob Anthony,REP,720049,0,0,95,95,
Tulsa,Corporation Commissioner,Ashley Nicole Mccray,DEM,720049,0,0,253,253,
Tulsa,Corporation Commissioner,Jackie Short,IND,720049,0,0,16,16,
Tulsa,U.S. House,Kevin Hern,REP,720049,0,0,82,82,1
Tulsa,U.S. House,Tim Gilpin,DEM,720049,0,0,283,283,1
Tulsa,Governor,Chris Powell,LIB,720050,0,0,15,15,
Tulsa,Governor,Kevin Stitt,REP,720050,0,0,123,123,
Tulsa,Governor,Drew Edmondson,DEM,720050,0,0,340,340,
Tulsa,Lieutenant Governor,Matt Pinnell,REP,720050,0,0,171,171,
Tulsa,Lieutenant Governor,Anastasia Pittman,DEM,720050,0,0,286,286,
Tulsa,Lieutenant Governor,Ivan Holmes,IND,720050,0,0,18,18,
Tulsa,State Auditor,John Yeutter,LIB,720050,0,0,172,172,
Tulsa,State Auditor,Cindy Byrd,REP,720050,0,0,236,236,
Tulsa,Attorney General,Mike Hunter,REP,720050,0,0,169,169,
Tulsa,Attorney General,Mark Myles,DEM,720050,0,0,297,297,
Tulsa,State Treasurer,Randy Mcdaniel,REP,720050,0,0,182,182,
Tulsa,State Treasurer,Charles De Coune,IND,720050,0,0,230,230,
Tulsa,Superintendent of Public Instruction,Joy Hofmeister,REP,720050,0,0,194,194,
Tulsa,Superintendent of Public Instruction,John Cox,DEM,720050,0,0,252,252,
Tulsa,Superintendent of Public Instruction,Larry Huff,IND,720050,0,0,25,25,
Tulsa,Commissioner of Labor,Leslie Osborn,REP,720050,0,0,157,157,
Tulsa,Commissioner of Labor,Fred Dorrell,DEM,720050,0,0,280,280,
Tulsa,Commissioner of Labor,Brandt Dismukes,IND,720050,0,0,19,19,
Tulsa,Insurance Commissioner,Glen Mulready,REP,720050,0,0,165,165,
Tulsa,Insurance Commissioner,Kimberly Fobbs,DEM,720050,0,0,292,292,
Tulsa,Corporation Commissioner,Bob Anthony,REP,720050,0,0,163,163,
Tulsa,Corporation Commissioner,Ashley Nicole Mccray,DEM,720050,0,0,276,276,
Tulsa,Corporation Commissioner,Jackie Short,IND,720050,0,0,22,22,
Tulsa,U.S. House,Kevin Hern,REP,720050,0,0,143,143,1
Tulsa,U.S. House,Tim Gilpin,DEM,720050,0,0,329,329,1
Tulsa,State House,Gene Bell,LIB,720050,0,0,24,24,78
Tulsa,State House,Paul Royse,REP,720050,0,0,113,113,78
Tulsa,State House,Meloyde Blancett,DEM,720050,0,0,329,329,78
Tulsa,Governor,Chris Powell,LIB,720051,0,0,17,17,
Tulsa,Governor,Kevin Stitt,REP,720051,0,0,178,178,
Tulsa,Governor,Drew Edmondson,DEM,720051,0,0,439,439,
Tulsa,Lieutenant Governor,Matt Pinnell,REP,720051,0,0,203,203,
Tulsa,Lieutenant Governor,Anastasia Pittman,DEM,720051,0,0,394,394,
Tulsa,Lieutenant Governor,Ivan Holmes,IND,720051,0,0,31,31,
Tulsa,State Auditor,John Yeutter,LIB,720051,0,0,266,266,
Tulsa,State Auditor,Cindy Byrd,REP,720051,0,0,283,283,
Tulsa,Attorney General,Mike Hunter,REP,720051,0,0,215,215,
Tulsa,Attorney General,Mark Myles,DEM,720051,0,0,409,409,
Tulsa,State Treasurer,Randy Mcdaniel,REP,720051,0,0,239,239,
Tulsa,State Treasurer,Charles De Coune,IND,720051,0,0,313,313,
Tulsa,Superintendent of Public Instruction,Joy Hofmeister,REP,720051,0,0,228,228,
Tulsa,Superintendent of Public Instruction,John Cox,DEM,720051,0,0,355,355,
Tulsa,Superintendent of Public Instruction,Larry Huff,IND,720051,0,0,38,38,
Tulsa,Commissioner of Labor,Leslie Osborn,REP,720051,0,0,206,206,
Tulsa,Commissioner of Labor,Fred Dorrell,DEM,720051,0,0,363,363,
Tulsa,Commissioner of Labor,Brandt Dismukes,IND,720051,0,0,45,45,
Tulsa,Insurance Commissioner,Glen Mulready,REP,720051,0,0,218,218,
Tulsa,Insurance Commissioner,Kimberly Fobbs,DEM,720051,0,0,397,397,
Tulsa,Corporation Commissioner,Bob Anthony,REP,720051,0,0,211,211,
Tulsa,Corporation Commissioner,Ashley Nicole Mccray,DEM,720051,0,0,372,372,
Tulsa,Corporation Commissioner,Jackie Short,IND,720051,0,0,36,36,
Tulsa,U.S. House,Kevin Hern,REP,720051,0,0,195,195,1
Tulsa,U.S. House,Tim Gilpin,DEM,720051,0,0,428,428,1
Tulsa,State House,Gene Bell,LIB,720051,0,0,32,32,78
Tulsa,State House,Paul Royse,REP,720051,0,0,154,154,78
Tulsa,State House,Meloyde Blancett,DEM,720051,0,0,428,428,78
Tulsa,Governor,Chris Powell,LIB,720052,0,0,17,17,
Tulsa,Governor,Kevin Stitt,REP,720052,0,0,403,403,
Tulsa,Governor,Drew Edmondson,DEM,720052,0,0,805,805,
Tulsa,Lieutenant Governor,Matt Pinnell,REP,720052,0,0,507,507,
Tulsa,Lieutenant Governor,Anastasia Pittman,DEM,720052,0,0,672,672,
Tulsa,Lieutenant Governor,Ivan Holmes,IND,720052,0,0,30,30,
Tulsa,State Auditor,John Yeutter,LIB,720052,0,0,409,409,
Tulsa,State Auditor,Cindy Byrd,REP,720052,0,0,629,629,
Tulsa,Attorney General,Mike Hunter,REP,720052,0,0,516,516,
Tulsa,Attorney General,Mark Myles,DEM,720052,0,0,684,684,
Tulsa,State Treasurer,Randy Mcdaniel,REP,720052,0,0,532,532,
Tulsa,State Treasurer,Charles De Coune,IND,720052,0,0,507,507,
Tulsa,Superintendent of Public Instruction,Joy Hofmeister,REP,720052,0,0,563,563,
Tulsa,Superintendent of Public Instruction,John Cox,DEM,720052,0,0,567,567,
Tulsa,Superintendent of Public Instruction,Larry Huff,IND,720052,0,0,64,64,
Tulsa,Commissioner of Labor,Leslie Osborn,REP,720052,0,0,496,496,
Tulsa,Commissioner of Labor,Fred Dorrell,DEM,720052,0,0,622,622,
Tulsa,Commissioner of Labor,Brandt Dismukes,IND,720052,0,0,58,58,
Tulsa,Insurance Commissioner,Glen Mulready,REP,720052,0,0,504,504,
Tulsa,Insurance Commissioner,Kimberly Fobbs,DEM,720052,0,0,672,672,
Tulsa,Corporation Commissioner,Bob Anthony,REP,720052,0,0,493,493,
Tulsa,Corporation Commissioner,Ashley Nicole Mccray,DEM,720052,0,0,637,637,
Tulsa,Corporation Commissioner,Jackie Short,IND,720052,0,0,60,60,
Tulsa,U.S. House,Kevin Hern,REP,720052,0,0,449,449,1
Tulsa,U.S. House,Tim Gilpin,DEM,720052,0,0,765,765,1
Tulsa,State House,Gene Bell,LIB,720052,0,0,44,44,78
Tulsa,State House,Paul Royse,REP,720052,0,0,381,381,78
Tulsa,State House,Meloyde Blancett,DEM,720052,0,0,774,774,78
Tulsa,Governor,Chris Powell,LIB,720053,0,0,27,27,
Tulsa,Governor,Kevin Stitt,REP,720053,0,0,359,359,
Tulsa,Governor,Drew Edmondson,DEM,720053,0,0,389,389,
Tulsa,Lieutenant Governor,Matt Pinnell,REP,720053,0,0,396,396,
Tulsa,Lieutenant Governor,Anastasia Pittman,DEM,720053,0,0,347,347,
Tulsa,Lieutenant Governor,Ivan Holmes,IND,720053,0,0,26,26,
Tulsa,State Auditor,John Yeutter,LIB,720053,0,0,273,273,
Tulsa,State Auditor,Cindy Byrd,REP,720053,0,0,447,447,
Tulsa,Attorney General,Mike Hunter,REP,720053,0,0,415,415,
Tulsa,Attorney General,Mark Myles,DEM,720053,0,0,357,357,
Tulsa,State Treasurer,Randy Mcdaniel,REP,720053,0,0,425,425,
Tulsa,State Treasurer,Charles De Coune,IND,720053,0,0,294,294,
Tulsa,Superintendent of Public Instruction,Joy Hofmeister,REP,720053,0,0,390,390,
Tulsa,Superintendent of Public Instruction,John Cox,DEM,720053,0,0,328,328,
Tulsa,Superintendent of Public Instruction,Larry Huff,IND,720053,0,0,50,50,
Tulsa,Commissioner of Labor,Leslie Osborn,REP,720053,0,0,387,387,
Tulsa,Commissioner of Labor,Fred Dorrell,DEM,720053,0,0,335,335,
Tulsa,Commissioner of Labor,Brandt Dismukes,IND,720053,0,0,43,43,
Tulsa,Insurance Commissioner,Glen Mulready,REP,720053,0,0,397,397,
Tulsa,Insurance Commissioner,Kimberly Fobbs,DEM,720053,0,0,367,367,
Tulsa,Corporation Commissioner,Bob Anthony,REP,720053,0,0,386,386,
Tulsa,Corporation Commissioner,Ashley Nicole Mccray,DEM,720053,0,0,343,343,
Tulsa,Corporation Commissioner,Jackie Short,IND,720053,0,0,36,36,
Tulsa,U.S. House,Kevin Hern,REP,720053,0,0,410,410,1
Tulsa,U.S. House,Tim Gilpin,DEM,720053,0,0,362,362,1
Tulsa,State House,Terry O'Donnell,REP,720053,0,0,402,402,23
Tulsa,State House,Craig John Hoxie,DEM,720053,0,0,367,367,23
Tulsa,Governor,Chris Powell,LIB,720054,0,0,34,34,
Tulsa,Governor,Kevin Stitt,REP,720054,0,0,342,342,
Tulsa,Governor,Drew Edmondson,DEM,720054,0,0,712,712,
Tulsa,Lieutenant Governor,Matt Pinnell,REP,720054,0,0,436,436,
Tulsa,Lieutenant Governor,Anastasia Pittman,DEM,720054,0,0,590,590,
Tulsa,Lieutenant Governor,Ivan Holmes,IND,720054,0,0,51,51,
Tulsa,State Auditor,John Yeutter,LIB,720054,0,0,389,389,
Tulsa,State Auditor,Cindy Byrd,REP,720054,0,0,558,558,
Tulsa,Attorney General,Mike Hunter,REP,720054,0,0,444,444,
Tulsa,Attorney General,Mark Myles,DEM,720054,0,0,628,628,
Tulsa,State Treasurer,Randy Mcdaniel,REP,720054,0,0,473,473,
Tulsa,State Treasurer,Charles De Coune,IND,720054,0,0,475,475,
Tulsa,Superintendent of Public Instruction,Joy Hofmeister,REP,720054,0,0,438,438,
Tulsa,Superintendent of Public Instruction,John Cox,DEM,720054,0,0,554,554,
Tulsa,Superintendent of Public Instruction,Larry Huff,IND,720054,0,0,82,82,
Tulsa,Commissioner of Labor,Leslie Osborn,REP,720054,0,0,405,405,
Tulsa,Commissioner of Labor,Fred Dorrell,DEM,720054,0,0,584,584,
Tulsa,Commissioner of Labor,Brandt Dismukes,IND,720054,0,0,65,65,
Tulsa,Insurance Commissioner,Glen Mulready,REP,720054,0,0,427,427,
Tulsa,Insurance Commissioner,Kimberly Fobbs,DEM,720054,0,0,635,635,
Tulsa,Corporation Commissioner,Bob Anthony,REP,720054,0,0,405,405,
Tulsa,Corporation Commissioner,Ashley Nicole Mccray,DEM,720054,0,0,592,592,
Tulsa,Corporation Commissioner,Jackie Short,IND,720054,0,0,62,62,
Tulsa,U.S. House,Kevin Hern,REP,720054,0,0,406,406,1
Tulsa,U.S. House,Tim Gilpin,DEM,720054,0,0,675,675,1
Tulsa,State House,Gene Bell,LIB,720054,0,0,47,47,78
Tulsa,State House,Paul Royse,REP,720054,0,0,336,336,78
Tulsa,State House,Meloyde Blancett,DEM,720054,0,0,682,682,78
Tulsa,Governor,Chris Powell,LIB,720055,0,0,25,25,
Tulsa,Governor,Kevin Stitt,REP,720055,0,0,235,235,
Tulsa,Governor,Drew Edmondson,DEM,720055,0,0,321,321,
Tulsa,Lieutenant Governor,Matt Pinnell,REP,720055,0,0,274,274,
Tulsa,Lieutenant Governor,Anastasia Pittman,DEM,720055,0,0,273,273,
Tulsa,Lieutenant Governor,Ivan Holmes,IND,720055,0,0,33,33,
Tulsa,State Auditor,John Yeutter,LIB,720055,0,0,214,214,
Tulsa,State Auditor,Cindy Byrd,REP,720055,0,0,320,320,
Tulsa,Attorney General,Mike Hunter,REP,720055,0,0,282,282,
Tulsa,Attorney General,Mark Myles,DEM,720055,0,0,294,294,
Tulsa,State Treasurer,Randy Mcdaniel,REP,720055,0,0,289,289,
Tulsa,State Treasurer,Charles De Coune,IND,720055,0,0,244,244,
Tulsa,Superintendent of Public Instruction,Joy Hofmeister,REP,720055,0,0,282,282,
Tulsa,Superintendent of Public Instruction,John Cox,DEM,720055,0,0,248,248,
Tulsa,Superintendent of Public Instruction,Larry Huff,IND,720055,0,0,47,47,
Tulsa,Commissioner of Labor,Leslie Osborn,REP,720055,0,0,271,271,
Tulsa,Commissioner of Labor,Fred Dorrell,DEM,720055,0,0,257,257,
Tulsa,Commissioner of Labor,Brandt Dismukes,IND,720055,0,0,45,45,
Tulsa,Insurance Commissioner,Glen Mulready,REP,720055,0,0,270,270,
Tulsa,Insurance Commissioner,Kimberly Fobbs,DEM,720055,0,0,300,300,
Tulsa,Corporation Commissioner,Bob Anthony,REP,720055,0,0,271,271,
Tulsa,Corporation Commissioner,Ashley Nicole Mccray,DEM,720055,0,0,273,273,
Tulsa,Corporation Commissioner,Jackie Short,IND,720055,0,0,30,30,
Tulsa,U.S. House,Kevin Hern,REP,720055,0,0,268,268,1
Tulsa,U.S. House,Tim Gilpin,DEM,720055,0,0,311,311,1
Tulsa,State House,Gene Bell,LIB,720055,0,0,32,32,78
Tulsa,State House,Paul Royse,REP,720055,0,0,227,227,78
Tulsa,State House,Meloyde Blancett,DEM,720055,0,0,315,315,78
Tulsa,Governor,Chris Powell,LIB,720056,0,0,19,19,
Tulsa,Governor,Kevin Stitt,REP,720056,0,0,261,261,
Tulsa,Governor,Drew Edmondson,DEM,720056,0,0,363,363,
Tulsa,Lieutenant Governor,Matt Pinnell,REP,720056,0,0,307,307,
Tulsa,Lieutenant Governor,Anastasia Pittman,DEM,720056,0,0,311,311,
Tulsa,Lieutenant Governor,Ivan Holmes,IND,720056,0,0,23,23,
Tulsa,State Auditor,John Yeutter,LIB,720056,0,0,213,213,
Tulsa,State Auditor,Cindy Byrd,REP,720056,0,0,366,366,
Tulsa,Attorney General,Mike Hunter,REP,720056,0,0,299,299,
Tulsa,Attorney General,Mark Myles,DEM,720056,0,0,336,336,
Tulsa,State Treasurer,Randy Mcdaniel,REP,720056,0,0,336,336,
Tulsa,State Treasurer,Charles De Coune,IND,720056,0,0,238,238,
Tulsa,Superintendent of Public Instruction,Joy Hofmeister,REP,720056,0,0,278,278,
Tulsa,Superintendent of Public Instruction,John Cox,DEM,720056,0,0,322,322,
Tulsa,Superintendent of Public Instruction,Larry Huff,IND,720056,0,0,40,40,
Tulsa,Commissioner of Labor,Leslie Osborn,REP,720056,0,0,287,287,
Tulsa,Commissioner of Labor,Fred Dorrell,DEM,720056,0,0,314,314,
Tulsa,Commissioner of Labor,Brandt Dismukes,IND,720056,0,0,33,33,
Tulsa,Insurance Commissioner,Glen Mulready,REP,720056,0,0,301,301,
Tulsa,Insurance Commissioner,Kimberly Fobbs,DEM,720056,0,0,334,334,
Tulsa,Corporation Commissioner,Bob Anthony,REP,720056,0,0,298,298,
Tulsa,Corporation Commissioner,Ashley Nicole Mccray,DEM,720056,0,0,304,304,
Tulsa,Corporation Commissioner,Jackie Short,IND,720056,0,0,35,35,
Tulsa,U.S. House,Kevin Hern,REP,720056,0,0,299,299,1
Tulsa,U.S. House,Tim Gilpin,DEM,720056,0,0,343,343,1
Tulsa,State House,Gene Bell,LIB,720056,0,0,29,29,78
Tulsa,State House,Paul Royse,REP,720056,0,0,255,255,78
Tulsa,State House,Meloyde Blancett,DEM,720056,0,0,348,348,78
Tulsa,Governor,Chris Powell,LIB,720057,0,0,12,12,
Tulsa,Governor,Kevin Stitt,REP,720057,0,0,143,143,
Tulsa,Governor,Drew Edmondson,DEM,720057,0,0,99,99,
Tulsa,Lieutenant Governor,Matt Pinnell,REP,720057,0,0,152,152,
Tulsa,Lieutenant Governor,Anastasia Pittman,DEM,720057,0,0,89,89,
Tulsa,Lieutenant Governor,Ivan Holmes,IND,720057,0,0,12,12,
Tulsa,State Auditor,John Yeutter,LIB,720057,0,0,58,58,
Tulsa,State Auditor,Cindy Byrd,REP,720057,0,0,172,172,
Tulsa,Attorney General,Mike Hunter,REP,720057,0,0,158,158,
Tulsa,Attorney General,Mark Myles,DEM,720057,0,0,95,95,
Tulsa,State Treasurer,Randy Mcdaniel,REP,720057,0,0,158,158,
Tulsa,State Treasurer,Charles De Coune,IND,720057,0,0,76,76,
Tulsa,Superintendent of Public Instruction,Joy Hofmeister,REP,720057,0,0,138,138,
Tulsa,Superintendent of Public Instruction,John Cox,DEM,720057,0,0,88,88,
Tulsa,Superintendent of Public Instruction,Larry Huff,IND,720057,0,0,27,27,
Tulsa,Commissioner of Labor,Leslie Osborn,REP,720057,0,0,141,141,
Tulsa,Commissioner of Labor,Fred Dorrell,DEM,720057,0,0,93,93,
Tulsa,Commissioner of Labor,Brandt Dismukes,IND,720057,0,0,16,16,
Tulsa,Insurance Commissioner,Glen Mulready,REP,720057,0,0,146,146,
Tulsa,Insurance Commissioner,Kimberly Fobbs,DEM,720057,0,0,101,101,
Tulsa,Corporation Commissioner,Bob Anthony,REP,720057,0,0,147,147,
Tulsa,Corporation Commissioner,Ashley Nicole Mccray,DEM,720057,0,0,91,91,
Tulsa,Corporation Commissioner,Jackie Short,IND,720057,0,0,12,12,
Tulsa,U.S. House,Kevin Hern,REP,720057,0,0,154,154,1
Tulsa,U.S. House,Tim Gilpin,DEM,720057,0,0,96,96,1
Tulsa,State House,Gene Bell,LIB,720057,0,0,12,12,78
Tulsa,State House,Paul Royse,REP,720057,0,0,126,126,78
Tulsa,State House,Meloyde Blancett,DEM,720057,0,0,113,113,78
Tulsa,Governor,Chris Powell,LIB,720058,0,0,16,16,
Tulsa,Governor,Kevin Stitt,REP,720058,0,0,198,198,
Tulsa,Governor,Drew Edmondson,DEM,720058,0,0,148,148,
Tulsa,Lieutenant Governor,Matt Pinnell,REP,720058,0,0,229,229,
Tulsa,Lieutenant Governor,Anastasia Pittman,DEM,720058,0,0,122,122,
Tulsa,Lieutenant Governor,Ivan Holmes,IND,720058,0,0,7,7,
Tulsa,State Auditor,John Yeutter,LIB,720058,0,0,86,86,
Tulsa,State Auditor,Cindy Byrd,REP,720058,0,0,250,250,
Tulsa,Attorney General,Mike Hunter,REP,720058,0,0,224,224,
Tulsa,Attorney General,Mark Myles,DEM,720058,0,0,131,131,
Tulsa,State Treasurer,Randy Mcdaniel,REP,720058,0,0,237,237,
Tulsa,State Treasurer,Charles De Coune,IND,720058,0,0,96,96,
Tulsa,Superintendent of Public Instruction,Joy Hofmeister,REP,720058,0,0,216,216,
Tulsa,Superintendent of Public Instruction,John Cox,DEM,720058,0,0,117,117,
Tulsa,Superintendent of Public Instruction,Larry Huff,IND,720058,0,0,26,26,
Tulsa,Commissioner of Labor,Leslie Osborn,REP,720058,0,0,197,197,
Tulsa,Commissioner of Labor,Fred Dorrell,DEM,720058,0,0,141,141,
Tulsa,Commissioner of Labor,Brandt Dismukes,IND,720058,0,0,17,17,
Tulsa,Insurance Commissioner,Glen Mulready,REP,720058,0,0,222,222,
Tulsa,Insurance Commissioner,Kimberly Fobbs,DEM,720058,0,0,134,134,
Tulsa,Corporation Commissioner,Bob Anthony,REP,720058,0,0,210,210,
Tulsa,Corporation Commissioner,Ashley Nicole Mccray,DEM,720058,0,0,127,127,
Tulsa,Corporation Commissioner,Jackie Short,IND,720058,0,0,22,22,
Tulsa,U.S. House,Kevin Hern,REP,720058,0,0,215,215,1
Tulsa,U.S. House,Tim Gilpin,DEM,720058,0,0,143,143,1
Tulsa,State House,Gene Bell,LIB,720058,0,0,20,20,78
Tulsa,State House,Paul Royse,REP,720058,0,0,197,197,78
Tulsa,State House,Meloyde Blancett,DEM,720058,0,0,142,142,78
Tulsa,Governor,Chris Powell,LIB,720059,0,0,14,14,
Tulsa,Governor,Kevin Stitt,REP,720059,0,0,166,166,
Tulsa,Governor,Drew Edmondson,DEM,720059,0,0,204,204,
Tulsa,Lieutenant Governor,Matt Pinnell,REP,720059,0,0,199,199,
Tulsa,Lieutenant Governor,Anastasia Pittman,DEM,720059,0,0,168,168,
Tulsa,Lieutenant Governor,Ivan Holmes,IND,720059,0,0,14,14,
Tulsa,State Auditor,John Yeutter,LIB,720059,0,0,124,124,
Tulsa,State Auditor,Cindy Byrd,REP,720059,0,0,217,217,
Tulsa,Attorney General,Mike Hunter,REP,720059,0,0,193,193,
Tulsa,Attorney General,Mark Myles,DEM,720059,0,0,186,186,
Tulsa,State Treasurer,Randy Mcdaniel,REP,720059,0,0,200,200,
Tulsa,State Treasurer,Charles De Coune,IND,720059,0,0,142,142,
Tulsa,Superintendent of Public Instruction,Joy Hofmeister,REP,720059,0,0,179,179,
Tulsa,Superintendent of Public Instruction,John Cox,DEM,720059,0,0,169,169,
Tulsa,Superintendent of Public Instruction,Larry Huff,IND,720059,0,0,30,30,
Tulsa,Commissioner of Labor,Leslie Osborn,REP,720059,0,0,173,173,
Tulsa,Commissioner of Labor,Fred Dorrell,DEM,720059,0,0,183,183,
Tulsa,Commissioner of Labor,Brandt Dismukes,IND,720059,0,0,21,21,
Tulsa,Insurance Commissioner,Glen Mulready,REP,720059,0,0,189,189,
Tulsa,Insurance Commissioner,Kimberly Fobbs,DEM,720059,0,0,188,188,
Tulsa,Corporation Commissioner,Bob Anthony,REP,720059,0,0,186,186,
Tulsa,Corporation Commissioner,Ashley Nicole Mccray,DEM,720059,0,0,166,166,
Tulsa,Corporation Commissioner,Jackie Short,IND,720059,0,0,26,26,
Tulsa,U.S. House,Kevin Hern,REP,720059,0,0,181,181,1
Tulsa,U.S. House,Tim Gilpin,DEM,720059,0,0,198,198,1
Tulsa,State House,Gene Bell,LIB,720059,0,0,16,16,78
Tulsa,State House,Paul Royse,REP,720059,0,0,159,159,78
Tulsa,State House,Meloyde Blancett,DEM,720059,0,0,204,204,78
Tulsa,Governor,Chris Powell,LIB,720060,0,0,29,29,
Tulsa,Governor,Kevin Stitt,REP,720060,0,0,213,213,
Tulsa,Governor,Drew Edmondson,DEM,720060,0,0,321,321,
Tulsa,Lieutenant Governor,Matt Pinnell,REP,720060,0,0,250,250,
Tulsa,Lieutenant Governor,Anastasia Pittman,DEM,720060,0,0,294,294,
Tulsa,Lieutenant Governor,Ivan Holmes,IND,720060,0,0,20,20,
Tulsa,State Auditor,John Yeutter,LIB,720060,0,0,201,201,
Tulsa,State Auditor,Cindy Byrd,REP,720060,0,0,318,318,
Tulsa,Attorney General,Mike Hunter,REP,720060,0,0,262,262,
Tulsa,Attorney General,Mark Myles,DEM,720060,0,0,300,300,
Tulsa,State Treasurer,Randy Mcdaniel,REP,720060,0,0,283,283,
Tulsa,State Treasurer,Charles De Coune,IND,720060,0,0,240,240,
Tulsa,Superintendent of Public Instruction,Joy Hofmeister,REP,720060,0,0,248,248,
Tulsa,Superintendent of Public Instruction,John Cox,DEM,720060,0,0,273,273,
Tulsa,Superintendent of Public Instruction,Larry Huff,IND,720060,0,0,41,41,
Tulsa,Commissioner of Labor,Leslie Osborn,REP,720060,0,0,236,236,
Tulsa,Commissioner of Labor,Fred Dorrell,DEM,720060,0,0,294,294,
Tulsa,Commissioner of Labor,Brandt Dismukes,IND,720060,0,0,27,27,
Tulsa,Insurance Commissioner,Glen Mulready,REP,720060,0,0,253,253,
Tulsa,Insurance Commissioner,Kimberly Fobbs,DEM,720060,0,0,305,305,
Tulsa,Corporation Commissioner,Bob Anthony,REP,720060,0,0,251,251,
Tulsa,Corporation Commissioner,Ashley Nicole Mccray,DEM,720060,0,0,269,269,
Tulsa,Corporation Commissioner,Jackie Short,IND,720060,0,0,39,39,
Tulsa,U.S. House,Kevin Hern,REP,720060,0,0,247,247,1
Tulsa,U.S. House,Tim Gilpin,DEM,720060,0,0,313,313,1
Tulsa,State Senate,John Haste,REP,720060,0,0,239,239,36
Tulsa,State Senate,Bryan O'Brien,DEM,720060,0,0,316,316,36
Tulsa,State House,Terry O'Donnell,REP,720060,0,0,243,243,23
Tulsa,State House,Craig John Hoxie,DEM,720060,0,0,315,315,23
Tulsa,Governor,Chris Powell,LIB,720061,0,0,18,18,
Tulsa,Governor,Kevin Stitt,REP,720061,0,0,285,285,
Tulsa,Governor,Drew Edmondson,DEM,720061,0,0,389,389,
Tulsa,Lieutenant Governor,Matt Pinnell,REP,720061,0,0,317,317,
Tulsa,Lieutenant Governor,Anastasia Pittman,DEM,720061,0,0,354,354,
Tulsa,Lieutenant Governor,Ivan Holmes,IND,720061,0,0,19,19,
Tulsa,State Auditor,John Yeutter,LIB,720061,0,0,239,239,
Tulsa,State Auditor,Cindy Byrd,REP,720061,0,0,366,366,
Tulsa,Attorney General,Mike Hunter,REP,720061,0,0,318,318,
Tulsa,Attorney General,Mark Myles,DEM,720061,0,0,372,372,
Tulsa,State Treasurer,Randy Mcdaniel,REP,720061,0,0,355,355,
Tulsa,State Treasurer,Charles De Coune,IND,720061,0,0,248,248,
Tulsa,Superintendent of Public Instruction,Joy Hofmeister,REP,720061,0,0,299,299,
Tulsa,Superintendent of Public Instruction,John Cox,DEM,720061,0,0,340,340,
Tulsa,Superintendent of Public Instruction,Larry Huff,IND,720061,0,0,50,50,
Tulsa,Commissioner of Labor,Leslie Osborn,REP,720061,0,0,298,298,
Tulsa,Commissioner of Labor,Fred Dorrell,DEM,720061,0,0,341,341,
Tulsa,Commissioner of Labor,Brandt Dismukes,IND,720061,0,0,42,42,
Tulsa,Insurance Commissioner,Glen Mulready,REP,720061,0,0,314,314,
Tulsa,Insurance Commissioner,Kimberly Fobbs,DEM,720061,0,0,371,371,
Tulsa,Corporation Commissioner,Bob Anthony,REP,720061,0,0,312,312,
Tulsa,Corporation Commissioner,Ashley Nicole Mccray,DEM,720061,0,0,344,344,
Tulsa,Corporation Commissioner,Jackie Short,IND,720061,0,0,33,33,
Tulsa,U.S. House,Kevin Hern,REP,720061,0,0,312,312,1
Tulsa,U.S. House,Tim Gilpin,DEM,720061,0,0,378,378,1
Tulsa,State Senate,John Haste,REP,720061,0,0,307,307,36
Tulsa,State Senate,Bryan O'Brien,DEM,720061,0,0,375,375,36
Tulsa,State House,Terry O'Donnell,REP,720061,0,0,315,315,23
Tulsa,State House,Craig John Hoxie,DEM,720061,0,0,369,369,23
Tulsa,Governor,Chris Powell,LIB,720062,0,0,12,12,
Tulsa,Governor,Kevin Stitt,REP,720062,0,0,497,497,
Tulsa,Governor,Drew Edmondson,DEM,720062,0,0,776,776,
Tulsa,Lieutenant Governor,Matt Pinnell,REP,720062,0,0,640,640,
Tulsa,Lieutenant Governor,Anastasia Pittman,DEM,720062,0,0,600,600,
Tulsa,Lieutenant Governor,Ivan Holmes,IND,720062,0,0,36,36,
Tulsa,State Auditor,John Yeutter,LIB,720062,0,0,345,345,
Tulsa,State Auditor,Cindy Byrd,REP,720062,0,0,769,769,
Tulsa,Attorney General,Mike Hunter,REP,720062,0,0,649,649,
Tulsa,Attorney General,Mark Myles,DEM,720062,0,0,620,620,
Tulsa,State Treasurer,Randy Mcdaniel,REP,720062,0,0,699,699,
Tulsa,State Treasurer,Charles De Coune,IND,720062,0,0,420,420,
Tulsa,Superintendent of Public Instruction,Joy Hofmeister,REP,720062,0,0,728,728,
Tulsa,Superintendent of Public Instruction,John Cox,DEM,720062,0,0,492,492,
Tulsa,Superintendent of Public Instruction,Larry Huff,IND,720062,0,0,55,55,
Tulsa,Commissioner of Labor,Leslie Osborn,REP,720062,0,0,617,617,
Tulsa,Commissioner of Labor,Fred Dorrell,DEM,720062,0,0,582,582,
Tulsa,Commissioner of Labor,Brandt Dismukes,IND,720062,0,0,50,50,
Tulsa,Insurance Commissioner,Glen Mulready,REP,720062,0,0,629,629,
Tulsa,Insurance Commissioner,Kimberly Fobbs,DEM,720062,0,0,623,623,
Tulsa,Corporation Commissioner,Bob Anthony,REP,720062,0,0,644,644,
Tulsa,Corporation Commissioner,Ashley Nicole Mccray,DEM,720062,0,0,573,573,
Tulsa,Corporation Commissioner,Jackie Short,IND,720062,0,0,45,45,
Tulsa,U.S. House,Kevin Hern,REP,720062,0,0,561,561,1
Tulsa,U.S. House,Tim Gilpin,DEM,720062,0,0,720,720,1
Tulsa,State House,Cheryl Baber,REP,720062,0,0,583,583,71
Tulsa,State House,Denise Brewer,DEM,720062,0,0,683,683,71
Tulsa,Governor,Chris Powell,LIB,720063,0,0,8,8,
Tulsa,Governor,Kevin Stitt,REP,720063,0,0,152,152,
Tulsa,Governor,Drew Edmondson,DEM,720063,0,0,302,302,
Tulsa,Lieutenant Governor,Matt Pinnell,REP,720063,0,0,194,194,
Tulsa,Lieutenant Governor,Anastasia Pittman,DEM,720063,0,0,249,249,
Tulsa,Lieutenant Governor,Ivan Holmes,IND,720063,0,0,15,15,
Tulsa,State Auditor,John Yeutter,LIB,720063,0,0,167,167,
Tulsa,State Auditor,Cindy Byrd,REP,720063,0,0,233,233,
Tulsa,Attorney General,Mike Hunter,REP,720063,0,0,203,203,
Tulsa,Attorney General,Mark Myles,DEM,720063,0,0,251,251,
Tulsa,State Treasurer,Randy Mcdaniel,REP,720063,0,0,201,201,
Tulsa,State Treasurer,Charles De Coune,IND,720063,0,0,198,198,
Tulsa,Superintendent of Public Instruction,Joy Hofmeister,REP,720063,0,0,204,204,
Tulsa,Superintendent of Public Instruction,John Cox,DEM,720063,0,0,225,225,
Tulsa,Superintendent of Public Instruction,Larry Huff,IND,720063,0,0,30,30,
Tulsa,Commissioner of Labor,Leslie Osborn,REP,720063,0,0,183,183,
Tulsa,Commissioner of Labor,Fred Dorrell,DEM,720063,0,0,247,247,
Tulsa,Commissioner of Labor,Brandt Dismukes,IND,720063,0,0,19,19,
Tulsa,Insurance Commissioner,Glen Mulready,REP,720063,0,0,185,185,
Tulsa,Insurance Commissioner,Kimberly Fobbs,DEM,720063,0,0,262,262,
Tulsa,Corporation Commissioner,Bob Anthony,REP,720063,0,0,191,191,
Tulsa,Corporation Commissioner,Ashley Nicole Mccray,DEM,720063,0,0,239,239,
Tulsa,Corporation Commissioner,Jackie Short,IND,720063,0,0,23,23,
Tulsa,U.S. House,Kevin Hern,REP,720063,0,0,161,161,1
Tulsa,U.S. House,Tim Gilpin,DEM,720063,0,0,296,296,1
Tulsa,State House,Cheryl Baber,REP,720063,0,0,171,171,71
Tulsa,State House,Denise Brewer,DEM,720063,0,0,284,284,71
Tulsa,Governor,Chris Powell,LIB,720064,0,0,29,29,
Tulsa,Governor,Kevin Stitt,REP,720064,0,0,247,247,
Tulsa,Governor,Drew Edmondson,DEM,720064,0,0,469,469,
Tulsa,Lieutenant Governor,Matt Pinnell,REP,720064,0,0,302,302,
Tulsa,Lieutenant Governor,Anastasia Pittman,DEM,720064,0,0,404,404,
Tulsa,Lieutenant Governor,Ivan Holmes,IND,720064,0,0,30,30,
Tulsa,State Auditor,John Yeutter,LIB,720064,0,0,244,244,
Tulsa,State Auditor,Cindy Byrd,REP,720064,0,0,395,395,
Tulsa,Attorney General,Mike Hunter,REP,720064,0,0,302,302,
Tulsa,Attorney General,Mark Myles,DEM,720064,0,0,424,424,
Tulsa,State Treasurer,Randy Mcdaniel,REP,720064,0,0,327,327,
Tulsa,State Treasurer,Charles De Coune,IND,720064,0,0,321,321,
Tulsa,Superintendent of Public Instruction,Joy Hofmeister,REP,720064,0,0,303,303,
Tulsa,Superintendent of Public Instruction,John Cox,DEM,720064,0,0,379,379,
Tulsa,Superintendent of Public Instruction,Larry Huff,IND,720064,0,0,48,48,
Tulsa,Commissioner of Labor,Leslie Osborn,REP,720064,0,0,294,294,
Tulsa,Commissioner of Labor,Fred Dorrell,DEM,720064,0,0,381,381,
Tulsa,Commissioner of Labor,Brandt Dismukes,IND,720064,0,0,43,43,
Tulsa,Insurance Commissioner,Glen Mulready,REP,720064,0,0,292,292,
Tulsa,Insurance Commissioner,Kimberly Fobbs,DEM,720064,0,0,428,428,
Tulsa,Corporation Commissioner,Bob Anthony,REP,720064,0,0,297,297,
Tulsa,Corporation Commissioner,Ashley Nicole Mccray,DEM,720064,0,0,386,386,
Tulsa,Corporation Commissioner,Jackie Short,IND,720064,0,0,43,43,
Tulsa,U.S. House,Kevin Hern,REP,720064,0,0,282,282,1
Tulsa,U.S. House,Tim Gilpin,DEM,720064,0,0,457,457,1
Tulsa,State House,Cheryl Baber,REP,720064,0,0,287,287,71
Tulsa,State House,Denise Brewer,DEM,720064,0,0,439,439,71
Tulsa,Governor,Chris Powell,LIB,720065,0,0,13,13,
Tulsa,Governor,Kevin Stitt,REP,720065,0,0,395,395,
Tulsa,Governor,Drew Edmondson,DEM,720065,0,0,445,445,
Tulsa,Lieutenant Governor,Matt Pinnell,REP,720065,0,0,522,522,
Tulsa,Lieutenant Governor,Anastasia Pittman,DEM,720065,0,0,313,313,
Tulsa,Lieutenant Governor,Ivan Holmes,IND,720065,0,0,16,16,
Tulsa,State Auditor,John Yeutter,LIB,720065,0,0,176,176,
Tulsa,State Auditor,Cindy Byrd,REP,720065,0,0,572,572,
Tulsa,Attorney General,Mike Hunter,REP,720065,0,0,507,507,
Tulsa,Attorney General,Mark Myles,DEM,720065,0,0,327,327,
Tulsa,State Treasurer,Randy Mcdaniel,REP,720065,0,0,533,533,
Tulsa,State Treasurer,Charles De Coune,IND,720065,0,0,213,213,
Tulsa,Superintendent of Public Instruction,Joy Hofmeister,REP,720065,0,0,534,534,
Tulsa,Superintendent of Public Instruction,John Cox,DEM,720065,0,0,271,271,
Tulsa,Superintendent of Public Instruction,Larry Huff,IND,720065,0,0,36,36,
Tulsa,Commissioner of Labor,Leslie Osborn,REP,720065,0,0,484,484,
Tulsa,Commissioner of Labor,Fred Dorrell,DEM,720065,0,0,301,301,
Tulsa,Commissioner of Labor,Brandt Dismukes,IND,720065,0,0,24,24,
Tulsa,Insurance Commissioner,Glen Mulready,REP,720065,0,0,495,495,
Tulsa,Insurance Commissioner,Kimberly Fobbs,DEM,720065,0,0,319,319,
Tulsa,Corporation Commissioner,Bob Anthony,REP,720065,0,0,507,507,
Tulsa,Corporation Commissioner,Ashley Nicole Mccray,DEM,720065,0,0,291,291,
Tulsa,Corporation Commissioner,Jackie Short,IND,720065,0,0,28,28,
Tulsa,U.S. House,Kevin Hern,REP,720065,0,0,439,439,1
Tulsa,U.S. House,Tim Gilpin,DEM,720065,0,0,408,408,1
Tulsa,State House,Cheryl Baber,REP,720065,0,0,476,476,71
Tulsa,State House,Denise Brewer,DEM,720065,0,0,364,364,71
Tulsa,Governor,Chris Powell,LIB,720066,0,0,4,4,
Tulsa,Governor,Kevin Stitt,REP,720066,0,0,339,339,
Tulsa,Governor,Drew Edmondson,DEM,720066,0,0,464,464,
Tulsa,Lieutenant Governor,Matt Pinnell,REP,720066,0,0,454,454,
Tulsa,Lieutenant Governor,Anastasia Pittman,DEM,720066,0,0,331,331,
Tulsa,Lieutenant Governor,Ivan Holmes,IND,720066,0,0,16,16,
Tulsa,State Auditor,John Yeutter,LIB,720066,0,0,163,163,
Tulsa,State Auditor,Cindy Byrd,REP,720066,0,0,560,560,
Tulsa,Attorney General,Mike Hunter,REP,720066,0,0,450,450,
Tulsa,Attorney General,Mark Myles,DEM,720066,0,0,344,344,
Tulsa,State Treasurer,Randy Mcdaniel,REP,720066,0,0,500,500,
Tulsa,State Treasurer,Charles De Coune,IND,720066,0,0,222,222,
Tulsa,Superintendent of Public Instruction,Joy Hofmeister,REP,720066,0,0,470,470,
Tulsa,Superintendent of Public Instruction,John Cox,DEM,720066,0,0,291,291,
Tulsa,Superintendent of Public Instruction,Larry Huff,IND,720066,0,0,35,35,
Tulsa,Commissioner of Labor,Leslie Osborn,REP,720066,0,0,450,450,
Tulsa,Commissioner of Labor,Fred Dorrell,DEM,720066,0,0,315,315,
Tulsa,Commissioner of Labor,Brandt Dismukes,IND,720066,0,0,21,21,
Tulsa,Insurance Commissioner,Glen Mulready,REP,720066,0,0,448,448,
Tulsa,Insurance Commissioner,Kimberly Fobbs,DEM,720066,0,0,337,337,
Tulsa,Corporation Commissioner,Bob Anthony,REP,720066,0,0,447,447,
Tulsa,Corporation Commissioner,Ashley Nicole Mccray,DEM,720066,0,0,308,308,
Tulsa,Corporation Commissioner,Jackie Short,IND,720066,0,0,33,33,
Tulsa,U.S. House,Kevin Hern,REP,720066,0,0,378,378,1
Tulsa,U.S. House,Tim Gilpin,DEM,720066,0,0,426,426,1
Tulsa,State House,Cheryl Baber,REP,720066,0,0,411,411,71
Tulsa,State House,Denise Brewer,DEM,720066,0,0,385,385,71
Tulsa,Governor,Chris Powell,LIB,720067,0,0,15,15,
Tulsa,Governor,Kevin Stitt,REP,720067,0,0,313,313,
Tulsa,Governor,Drew Edmondson,DEM,720067,0,0,433,433,
Tulsa,Lieutenant Governor,Matt Pinnell,REP,720067,0,0,397,397,
Tulsa,Lieutenant Governor,Anastasia Pittman,DEM,720067,0,0,335,335,
Tulsa,Lieutenant Governor,Ivan Holmes,IND,720067,0,0,17,17,
Tulsa,State Auditor,John Yeutter,LIB,720067,0,0,178,178,
Tulsa,State Auditor,Cindy Byrd,REP,720067,0,0,495,495,
Tulsa,Attorney General,Mike Hunter,REP,720067,0,0,379,379,
Tulsa,Attorney General,Mark Myles,DEM,720067,0,0,363,363,
Tulsa,State Treasurer,Randy Mcdaniel,REP,720067,0,0,428,428,
Tulsa,State Treasurer,Charles De Coune,IND,720067,0,0,238,238,
Tulsa,Superintendent of Public Instruction,Joy Hofmeister,REP,720067,0,0,417,417,
Tulsa,Superintendent of Public Instruction,John Cox,DEM,720067,0,0,294,294,
Tulsa,Superintendent of Public Instruction,Larry Huff,IND,720067,0,0,37,37,
Tulsa,Commissioner of Labor,Leslie Osborn,REP,720067,0,0,371,371,
Tulsa,Commissioner of Labor,Fred Dorrell,DEM,720067,0,0,326,326,
Tulsa,Commissioner of Labor,Brandt Dismukes,IND,720067,0,0,30,30,
Tulsa,Insurance Commissioner,Glen Mulready,REP,720067,0,0,366,366,
Tulsa,Insurance Commissioner,Kimberly Fobbs,DEM,720067,0,0,356,356,
Tulsa,Corporation Commissioner,Bob Anthony,REP,720067,0,0,383,383,
Tulsa,Corporation Commissioner,Ashley Nicole Mccray,DEM,720067,0,0,320,320,
Tulsa,Corporation Commissioner,Jackie Short,IND,720067,0,0,30,30,
Tulsa,U.S. House,Kevin Hern,REP,720067,0,0,345,345,1
Tulsa,U.S. House,Tim Gilpin,DEM,720067,0,0,408,408,1
Tulsa,State House,Cheryl Baber,REP,720067,0,0,364,364,71
Tulsa,State House,Denise Brewer,DEM,720067,0,0,377,377,71
Tulsa,Governor,Chris Powell,LIB,720068,0,0,23,23,
Tulsa,Governor,Kevin Stitt,REP,720068,0,0,191,191,
Tulsa,Governor,Drew Edmondson,DEM,720068,0,0,362,362,
Tulsa,Lieutenant Governor,Matt Pinnell,REP,720068,0,0,227,227,
Tulsa,Lieutenant Governor,Anastasia Pittman,DEM,720068,0,0,323,323,
Tulsa,Lieutenant Governor,Ivan Holmes,IND,720068,0,0,20,20,
Tulsa,State Auditor,John Yeutter,LIB,720068,0,0,222,222,
Tulsa,State Auditor,Cindy Byrd,REP,720068,0,0,294,294,
Tulsa,Attorney General,Mike Hunter,REP,720068,0,0,239,239,
Tulsa,Attorney General,Mark Myles,DEM,720068,0,0,330,330,
Tulsa,State Treasurer,Randy Mcdaniel,REP,720068,0,0,250,250,
Tulsa,State Treasurer,Charles De Coune,IND,720068,0,0,264,264,
Tulsa,Superintendent of Public Instruction,Joy Hofmeister,REP,720068,0,0,220,220,
Tulsa,Superintendent of Public Instruction,John Cox,DEM,720068,0,0,308,308,
Tulsa,Superintendent of Public Instruction,Larry Huff,IND,720068,0,0,43,43,
Tulsa,Commissioner of Labor,Leslie Osborn,REP,720068,0,0,220,220,
Tulsa,Commissioner of Labor,Fred Dorrell,DEM,720068,0,0,313,313,
Tulsa,Commissioner of Labor,Brandt Dismukes,IND,720068,0,0,30,30,
Tulsa,Insurance Commissioner,Glen Mulready,REP,720068,0,0,220,220,
Tulsa,Insurance Commissioner,Kimberly Fobbs,DEM,720068,0,0,343,343,
Tulsa,Corporation Commissioner,Bob Anthony,REP,720068,0,0,230,230,
Tulsa,Corporation Commissioner,Ashley Nicole Mccray,DEM,720068,0,0,303,303,
Tulsa,Corporation Commissioner,Jackie Short,IND,720068,0,0,34,34,
Tulsa,U.S. House,Kevin Hern,REP,720068,0,0,209,209,1
Tulsa,U.S. House,Tim Gilpin,DEM,720068,0,0,364,364,1
Tulsa,State House,Cheryl Baber,REP,720068,0,0,216,216,71
Tulsa,State House,Denise Brewer,DEM,720068,0,0,354,354,71
Tulsa,Governor,Chris Powell,LIB,720069,0,0,40,40,
Tulsa,Governor,Kevin Stitt,REP,720069,0,0,467,467,
Tulsa,Governor,Drew Edmondson,DEM,720069,0,0,651,651,
Tulsa,Lieutenant Governor,Matt Pinnell,REP,720069,0,0,570,570,
Tulsa,Lieutenant Governor,Anastasia Pittman,DEM,720069,0,0,525,525,
Tulsa,Lieutenant Governor,Ivan Holmes,IND,720069,0,0,49,49,
Tulsa,State Auditor,John Yeutter,LIB,720069,0,0,353,353,
Tulsa,State Auditor,Cindy Byrd,REP,720069,0,0,677,677,
Tulsa,Attorney General,Mike Hunter,REP,720069,0,0,582,582,
Tulsa,Attorney General,Mark Myles,DEM,720069,0,0,554,554,
Tulsa,State Treasurer,Randy Mcdaniel,REP,720069,0,0,592,592,
Tulsa,State Treasurer,Charles De Coune,IND,720069,0,0,435,435,
Tulsa,Superintendent of Public Instruction,Joy Hofmeister,REP,720069,0,0,596,596,
Tulsa,Superintendent of Public Instruction,John Cox,DEM,720069,0,0,464,464,
Tulsa,Superintendent of Public Instruction,Larry Huff,IND,720069,0,0,86,86,
Tulsa,Commissioner of Labor,Leslie Osborn,REP,720069,0,0,550,550,
Tulsa,Commissioner of Labor,Fred Dorrell,DEM,720069,0,0,508,508,
Tulsa,Commissioner of Labor,Brandt Dismukes,IND,720069,0,0,63,63,
Tulsa,Insurance Commissioner,Glen Mulready,REP,720069,0,0,548,548,
Tulsa,Insurance Commissioner,Kimberly Fobbs,DEM,720069,0,0,570,570,
Tulsa,Corporation Commissioner,Bob Anthony,REP,720069,0,0,549,549,
Tulsa,Corporation Commissioner,Ashley Nicole Mccray,DEM,720069,0,0,508,508,
Tulsa,Corporation Commissioner,Jackie Short,IND,720069,0,0,68,68,
Tulsa,U.S. House,Kevin Hern,REP,720069,0,0,530,530,1
Tulsa,U.S. House,Tim Gilpin,DEM,720069,0,0,619,619,1
Tulsa,State House,Cheryl Baber,REP,720069,0,0,524,524,71
Tulsa,State House,Denise Brewer,DEM,720069,0,0,609,609,71
Tulsa,Governor,Chris Powell,LIB,720070,0,0,10,10,
Tulsa,Governor,Kevin Stitt,REP,720070,0,0,98,98,
Tulsa,Governor,Drew Edmondson,DEM,720070,0,0,115,115,
Tulsa,Lieutenant Governor,Matt Pinnell,REP,720070,0,0,103,103,
Tulsa,Lieutenant Governor,Anastasia Pittman,DEM,720070,0,0,104,104,
Tulsa,Lieutenant Governor,Ivan Holmes,IND,720070,0,0,12,12,
Tulsa,State Auditor,John Yeutter,LIB,720070,0,0,72,72,
Tulsa,State Auditor,Cindy Byrd,REP,720070,0,0,124,124,
Tulsa,Attorney General,Mike Hunter,REP,720070,0,0,111,111,
Tulsa,Attorney General,Mark Myles,DEM,720070,0,0,107,107,
Tulsa,State Treasurer,Randy Mcdaniel,REP,720070,0,0,118,118,
Tulsa,State Treasurer,Charles De Coune,IND,720070,0,0,77,77,
Tulsa,Superintendent of Public Instruction,Joy Hofmeister,REP,720070,0,0,93,93,
Tulsa,Superintendent of Public Instruction,John Cox,DEM,720070,0,0,99,99,
Tulsa,Superintendent of Public Instruction,Larry Huff,IND,720070,0,0,26,26,
Tulsa,Commissioner of Labor,Leslie Osborn,REP,720070,0,0,101,101,
Tulsa,Commissioner of Labor,Fred Dorrell,DEM,720070,0,0,101,101,
Tulsa,Commissioner of Labor,Brandt Dismukes,IND,720070,0,0,11,11,
Tulsa,Insurance Commissioner,Glen Mulready,REP,720070,0,0,104,104,
Tulsa,Insurance Commissioner,Kimberly Fobbs,DEM,720070,0,0,112,112,
Tulsa,Corporation Commissioner,Bob Anthony,REP,720070,0,0,105,105,
Tulsa,Corporation Commissioner,Ashley Nicole Mccray,DEM,720070,0,0,95,95,
Tulsa,Corporation Commissioner,Jackie Short,IND,720070,0,0,17,17,
Tulsa,U.S. House,Kevin Hern,REP,720070,0,0,103,103,1
Tulsa,U.S. House,Tim Gilpin,DEM,720070,0,0,115,115,1
Tulsa,State House,Gene Bell,LIB,720070,0,0,14,14,78
Tulsa,State House,Paul Royse,REP,720070,0,0,94,94,78
Tulsa,State House,Meloyde Blancett,DEM,720070,0,0,108,108,78
Tulsa,Governor,Chris Powell,LIB,720071,0,0,22,22,
Tulsa,Governor,Kevin Stitt,REP,720071,0,0,697,697,
Tulsa,Governor,Drew Edmondson,DEM,720071,0,0,902,902,
Tulsa,Lieutenant Governor,Matt Pinnell,REP,720071,0,0,901,901,
Tulsa,Lieutenant Governor,Anastasia Pittman,DEM,720071,0,0,660,660,
Tulsa,Lieutenant Governor,Ivan Holmes,IND,720071,0,0,39,39,
Tulsa,State Auditor,John Yeutter,LIB,720071,0,0,348,348,
Tulsa,State Auditor,Cindy Byrd,REP,720071,0,0,1081,1081,
Tulsa,Attorney General,Mike Hunter,REP,720071,0,0,888,888,
Tulsa,Attorney General,Mark Myles,DEM,720071,0,0,703,703,
Tulsa,State Treasurer,Randy Mcdaniel,REP,720071,0,0,976,976,
Tulsa,State Treasurer,Charles De Coune,IND,720071,0,0,451,451,
Tulsa,Superintendent of Public Instruction,Joy Hofmeister,REP,720071,0,0,935,935,
Tulsa,Superintendent of Public Instruction,John Cox,DEM,720071,0,0,593,593,
Tulsa,Superintendent of Public Instruction,Larry Huff,IND,720071,0,0,59,59,
Tulsa,Commissioner of Labor,Leslie Osborn,REP,720071,0,0,841,841,
Tulsa,Commissioner of Labor,Fred Dorrell,DEM,720071,0,0,647,647,
Tulsa,Commissioner of Labor,Brandt Dismukes,IND,720071,0,0,57,57,
Tulsa,Insurance Commissioner,Glen Mulready,REP,720071,0,0,865,865,
Tulsa,Insurance Commissioner,Kimberly Fobbs,DEM,720071,0,0,695,695,
Tulsa,Corporation Commissioner,Bob Anthony,REP,720071,0,0,892,892,
Tulsa,Corporation Commissioner,Ashley Nicole Mccray,DEM,720071,0,0,631,631,
Tulsa,Corporation Commissioner,Jackie Short,IND,720071,0,0,48,48,
Tulsa,U.S. House,Kevin Hern,REP,720071,0,0,769,769,1
Tulsa,U.S. House,Tim Gilpin,DEM,720071,0,0,834,834,1
Tulsa,State House,Carol Bush,REP,720071,0,0,895,895,70
Tulsa,State House,Jj Burnam,DEM,720071,0,0,702,702,70
Tulsa,Governor,Chris Powell,LIB,720072,0,0,12,12,
Tulsa,Governor,Kevin Stitt,REP,720072,0,0,272,272,
Tulsa,Governor,Drew Edmondson,DEM,720072,0,0,349,349,
Tulsa,Lieutenant Governor,Matt Pinnell,REP,720072,0,0,375,375,
Tulsa,Lieutenant Governor,Anastasia Pittman,DEM,720072,0,0,239,239,
Tulsa,Lieutenant Governor,Ivan Holmes,IND,720072,0,0,12,12,
Tulsa,State Auditor,John Yeutter,LIB,720072,0,0,119,119,
Tulsa,State Auditor,Cindy Byrd,REP,720072,0,0,450,450,
Tulsa,Attorney General,Mike Hunter,REP,720072,0,0,378,378,
Tulsa,Attorney General,Mark Myles,DEM,720072,0,0,240,240,
Tulsa,State Treasurer,Randy Mcdaniel,REP,720072,0,0,404,404,
Tulsa,State Treasurer,Charles De Coune,IND,720072,0,0,166,166,
Tulsa,Superintendent of Public Instruction,Joy Hofmeister,REP,720072,0,0,364,364,
Tulsa,Superintendent of Public Instruction,John Cox,DEM,720072,0,0,221,221,
Tulsa,Superintendent of Public Instruction,Larry Huff,IND,720072,0,0,34,34,
Tulsa,Commissioner of Labor,Leslie Osborn,REP,720072,0,0,353,353,
Tulsa,Commissioner of Labor,Fred Dorrell,DEM,720072,0,0,225,225,
Tulsa,Commissioner of Labor,Brandt Dismukes,IND,720072,0,0,27,27,
Tulsa,Insurance Commissioner,Glen Mulready,REP,720072,0,0,360,360,
Tulsa,Insurance Commissioner,Kimberly Fobbs,DEM,720072,0,0,248,248,
Tulsa,Corporation Commissioner,Bob Anthony,REP,720072,0,0,369,369,
Tulsa,Corporation Commissioner,Ashley Nicole Mccray,DEM,720072,0,0,226,226,
Tulsa,Corporation Commissioner,Jackie Short,IND,720072,0,0,24,24,
Tulsa,U.S. House,Kevin Hern,REP,720072,0,0,318,318,1
Tulsa,U.S. House,Tim Gilpin,DEM,720072,0,0,311,311,1
Tulsa,State House,Carol Bush,REP,720072,0,0,348,348,70
Tulsa,State House,Jj Burnam,DEM,720072,0,0,279,279,70
Tulsa,Governor,Chris Powell,LIB,720073,0,0,6,6,
Tulsa,Governor,Kevin Stitt,REP,720073,0,0,291,291,
Tulsa,Governor,Drew Edmondson,DEM,720073,0,0,303,303,
Tulsa,Lieutenant Governor,Matt Pinnell,REP,720073,0,0,373,373,
Tulsa,Lieutenant Governor,Anastasia Pittman,DEM,720073,0,0,205,205,
Tulsa,Lieutenant Governor,Ivan Holmes,IND,720073,0,0,14,14,
Tulsa,State Auditor,John Yeutter,LIB,720073,0,0,97,97,
Tulsa,State Auditor,Cindy Byrd,REP,720073,0,0,446,446,
Tulsa,Attorney General,Mike Hunter,REP,720073,0,0,362,362,
Tulsa,Attorney General,Mark Myles,DEM,720073,0,0,229,229,
Tulsa,State Treasurer,Randy Mcdaniel,REP,720073,0,0,413,413,
Tulsa,State Treasurer,Charles De Coune,IND,720073,0,0,134,134,
Tulsa,Superintendent of Public Instruction,Joy Hofmeister,REP,720073,0,0,380,380,
Tulsa,Superintendent of Public Instruction,John Cox,DEM,720073,0,0,187,187,
Tulsa,Superintendent of Public Instruction,Larry Huff,IND,720073,0,0,25,25,
Tulsa,Commissioner of Labor,Leslie Osborn,REP,720073,0,0,350,350,
Tulsa,Commissioner of Labor,Fred Dorrell,DEM,720073,0,0,207,207,
Tulsa,Commissioner of Labor,Brandt Dismukes,IND,720073,0,0,24,24,
Tulsa,Insurance Commissioner,Glen Mulready,REP,720073,0,0,369,369,
Tulsa,Insurance Commissioner,Kimberly Fobbs,DEM,720073,0,0,217,217,
Tulsa,Corporation Commissioner,Bob Anthony,REP,720073,0,0,365,365,
Tulsa,Corporation Commissioner,Ashley Nicole Mccray,DEM,720073,0,0,202,202,
Tulsa,Corporation Commissioner,Jackie Short,IND,720073,0,0,21,21,
Tulsa,U.S. House,Kevin Hern,REP,720073,0,0,317,317,1
Tulsa,U.S. House,Tim Gilpin,DEM,720073,0,0,277,277,1
Tulsa,State House,Carol Bush,REP,720073,0,0,376,376,70
Tulsa,State House,Jj Burnam,DEM,720073,0,0,220,220,70
Tulsa,Governor,Chris Powell,LIB,720074,0,0,16,16,
Tulsa,Governor,Kevin Stitt,REP,720074,0,0,440,440,
Tulsa,Governor,Drew Edmondson,DEM,720074,0,0,437,437,
Tulsa,Lieutenant Governor,Matt Pinnell,REP,720074,0,0,527,527,
Tulsa,Lieutenant Governor,Anastasia Pittman,DEM,720074,0,0,335,335,
Tulsa,Lieutenant Governor,Ivan Holmes,IND,720074,0,0,22,22,
Tulsa,State Auditor,John Yeutter,LIB,720074,0,0,173,173,
Tulsa,State Auditor,Cindy Byrd,REP,720074,0,0,640,640,
Tulsa,Attorney General,Mike Hunter,REP,720074,0,0,534,534,
Tulsa,Attorney General,Mark Myles,DEM,720074,0,0,345,345,
Tulsa,State Treasurer,Randy Mcdaniel,REP,720074,0,0,572,572,
Tulsa,State Treasurer,Charles De Coune,IND,720074,0,0,239,239,
Tulsa,Superintendent of Public Instruction,Joy Hofmeister,REP,720074,0,0,528,528,
Tulsa,Superintendent of Public Instruction,John Cox,DEM,720074,0,0,304,304,
Tulsa,Superintendent of Public Instruction,Larry Huff,IND,720074,0,0,51,51,
Tulsa,Commissioner of Labor,Leslie Osborn,REP,720074,0,0,512,512,
Tulsa,Commissioner of Labor,Fred Dorrell,DEM,720074,0,0,317,317,
Tulsa,Commissioner of Labor,Brandt Dismukes,IND,720074,0,0,35,35,
Tulsa,Insurance Commissioner,Glen Mulready,REP,720074,0,0,539,539,
Tulsa,Insurance Commissioner,Kimberly Fobbs,DEM,720074,0,0,329,329,
Tulsa,Corporation Commissioner,Bob Anthony,REP,720074,0,0,537,537,
Tulsa,Corporation Commissioner,Ashley Nicole Mccray,DEM,720074,0,0,301,301,
Tulsa,Corporation Commissioner,Jackie Short,IND,720074,0,0,40,40,
Tulsa,U.S. House,Kevin Hern,REP,720074,0,0,475,475,1
Tulsa,U.S. House,Tim Gilpin,DEM,720074,0,0,413,413,1
Tulsa,State House,Carol Bush,REP,720074,0,0,555,555,70
Tulsa,State House,Jj Burnam,DEM,720074,0,0,331,331,70
Tulsa,Governor,Chris Powell,LIB,720075,0,0,18,18,
Tulsa,Governor,Kevin Stitt,REP,720075,0,0,156,156,
Tulsa,Governor,Drew Edmondson,DEM,720075,0,0,356,356,
Tulsa,Lieutenant Governor,Matt Pinnell,REP,720075,0,0,201,201,
Tulsa,Lieutenant Governor,Anastasia Pittman,DEM,720075,0,0,300,300,
Tulsa,Lieutenant Governor,Ivan Holmes,IND,720075,0,0,22,22,
Tulsa,State Auditor,John Yeutter,LIB,720075,0,0,192,192,
Tulsa,State Auditor,Cindy Byrd,REP,720075,0,0,273,273,
Tulsa,Attorney General,Mike Hunter,REP,720075,0,0,202,202,
Tulsa,Attorney General,Mark Myles,DEM,720075,0,0,318,318,
Tulsa,State Treasurer,Randy Mcdaniel,REP,720075,0,0,228,228,
Tulsa,State Treasurer,Charles De Coune,IND,720075,0,0,233,233,
Tulsa,Superintendent of Public Instruction,Joy Hofmeister,REP,720075,0,0,211,211,
Tulsa,Superintendent of Public Instruction,John Cox,DEM,720075,0,0,279,279,
Tulsa,Superintendent of Public Instruction,Larry Huff,IND,720075,0,0,34,34,
Tulsa,Commissioner of Labor,Leslie Osborn,REP,720075,0,0,191,191,
Tulsa,Commissioner of Labor,Fred Dorrell,DEM,720075,0,0,295,295,
Tulsa,Commissioner of Labor,Brandt Dismukes,IND,720075,0,0,30,30,
Tulsa,Insurance Commissioner,Glen Mulready,REP,720075,0,0,183,183,
Tulsa,Insurance Commissioner,Kimberly Fobbs,DEM,720075,0,0,328,328,
Tulsa,Corporation Commissioner,Bob Anthony,REP,720075,0,0,181,181,
Tulsa,Corporation Commissioner,Ashley Nicole Mccray,DEM,720075,0,0,305,305,
Tulsa,Corporation Commissioner,Jackie Short,IND,720075,0,0,30,30,
Tulsa,U.S. House,Kevin Hern,REP,720075,0,0,171,171,1
Tulsa,U.S. House,Tim Gilpin,DEM,720075,0,0,354,354,1
Tulsa,State House,Carol Bush,REP,720075,0,0,188,188,70
Tulsa,State House,Jj Burnam,DEM,720075,0,0,334,334,70
Tulsa,Governor,Chris Powell,LIB,720076,0,0,20,20,
Tulsa,Governor,Kevin Stitt,REP,720076,0,0,267,267,
Tulsa,Governor,Drew Edmondson,DEM,720076,0,0,463,463,
Tulsa,Lieutenant Governor,Matt Pinnell,REP,720076,0,0,334,334,
Tulsa,Lieutenant Governor,Anastasia Pittman,DEM,720076,0,0,377,377,
Tulsa,Lieutenant Governor,Ivan Holmes,IND,720076,0,0,30,30,
Tulsa,State Auditor,John Yeutter,LIB,720076,0,0,250,250,
Tulsa,State Auditor,Cindy Byrd,REP,720076,0,0,415,415,
Tulsa,Attorney General,Mike Hunter,REP,720076,0,0,336,336,
Tulsa,Attorney General,Mark Myles,DEM,720076,0,0,402,402,
Tulsa,State Treasurer,Randy Mcdaniel,REP,720076,0,0,363,363,
Tulsa,State Treasurer,Charles De Coune,IND,720076,0,0,299,299,
Tulsa,Superintendent of Public Instruction,Joy Hofmeister,REP,720076,0,0,338,338,
Tulsa,Superintendent of Public Instruction,John Cox,DEM,720076,0,0,352,352,
Tulsa,Superintendent of Public Instruction,Larry Huff,IND,720076,0,0,47,47,
Tulsa,Commissioner of Labor,Leslie Osborn,REP,720076,0,0,326,326,
Tulsa,Commissioner of Labor,Fred Dorrell,DEM,720076,0,0,364,364,
Tulsa,Commissioner of Labor,Brandt Dismukes,IND,720076,0,0,40,40,
Tulsa,Insurance Commissioner,Glen Mulready,REP,720076,0,0,328,328,
Tulsa,Insurance Commissioner,Kimberly Fobbs,DEM,720076,0,0,400,400,
Tulsa,Corporation Commissioner,Bob Anthony,REP,720076,0,0,316,316,
Tulsa,Corporation Commissioner,Ashley Nicole Mccray,DEM,720076,0,0,380,380,
Tulsa,Corporation Commissioner,Jackie Short,IND,720076,0,0,33,33,
Tulsa,U.S. House,Kevin Hern,REP,720076,0,0,290,290,1
Tulsa,U.S. House,Tim Gilpin,DEM,720076,0,0,454,454,1
Tulsa,State House,Carol Bush,REP,720076,0,0,303,303,70
Tulsa,State House,Jj Burnam,DEM,720076,0,0,432,432,70
Tulsa,Governor,Chris Powell,LIB,720077,0,0,29,29,
Tulsa,Governor,Kevin Stitt,REP,720077,0,0,312,312,
Tulsa,Governor,Drew Edmondson,DEM,720077,0,0,529,529,
Tulsa,Lieutenant Governor,Matt Pinnell,REP,720077,0,0,382,382,
Tulsa,Lieutenant Governor,Anastasia Pittman,DEM,720077,0,0,448,448,
Tulsa,Lieutenant Governor,Ivan Holmes,IND,720077,0,0,33,33,
Tulsa,State Auditor,John Yeutter,LIB,720077,0,0,274,274,
Tulsa,State Auditor,Cindy Byrd,REP,720077,0,0,483,483,
Tulsa,Attorney General,Mike Hunter,REP,720077,0,0,386,386,
Tulsa,Attorney General,Mark Myles,DEM,720077,0,0,468,468,
Tulsa,State Treasurer,Randy Mcdaniel,REP,720077,0,0,427,427,
Tulsa,State Treasurer,Charles De Coune,IND,720077,0,0,329,329,
Tulsa,Superintendent of Public Instruction,Joy Hofmeister,REP,720077,0,0,410,410,
Tulsa,Superintendent of Public Instruction,John Cox,DEM,720077,0,0,398,398,
Tulsa,Superintendent of Public Instruction,Larry Huff,IND,720077,0,0,52,52,
Tulsa,Commissioner of Labor,Leslie Osborn,REP,720077,0,0,373,373,
Tulsa,Commissioner of Labor,Fred Dorrell,DEM,720077,0,0,432,432,
Tulsa,Commissioner of Labor,Brandt Dismukes,IND,720077,0,0,40,40,
Tulsa,Insurance Commissioner,Glen Mulready,REP,720077,0,0,373,373,
Tulsa,Insurance Commissioner,Kimberly Fobbs,DEM,720077,0,0,471,471,
Tulsa,Corporation Commissioner,Bob Anthony,REP,720077,0,0,378,378,
Tulsa,Corporation Commissioner,Ashley Nicole Mccray,DEM,720077,0,0,422,422,
Tulsa,Corporation Commissioner,Jackie Short,IND,720077,0,0,45,45,
Tulsa,U.S. House,Kevin Hern,REP,720077,0,0,349,349,1
Tulsa,U.S. House,Tim Gilpin,DEM,720077,0,0,513,513,1
Tulsa,State House,Gene Bell,LIB,720077,0,0,33,33,78
Tulsa,State House,Paul Royse,REP,720077,0,0,292,292,78
Tulsa,State House,Meloyde Blancett,DEM,720077,0,0,528,528,78
Tulsa,Governor,Chris Powell,LIB,720078,0,0,35,35,
Tulsa,Governor,Kevin Stitt,REP,720078,0,0,352,352,
Tulsa,Governor,Drew Edmondson,DEM,720078,0,0,463,463,
Tulsa,Lieutenant Governor,Matt Pinnell,REP,720078,0,0,436,436,
Tulsa,Lieutenant Governor,Anastasia Pittman,DEM,720078,0,0,385,385,
Tulsa,Lieutenant Governor,Ivan Holmes,IND,720078,0,0,28,28,
Tulsa,State Auditor,John Yeutter,LIB,720078,0,0,267,267,
Tulsa,State Auditor,Cindy Byrd,REP,720078,0,0,497,497,
Tulsa,Attorney General,Mike Hunter,REP,720078,0,0,443,443,
Tulsa,Attorney General,Mark Myles,DEM,720078,0,0,394,394,
Tulsa,State Treasurer,Randy Mcdaniel,REP,720078,0,0,464,464,
Tulsa,State Treasurer,Charles De Coune,IND,720078,0,0,300,300,
Tulsa,Superintendent of Public Instruction,Joy Hofmeister,REP,720078,0,0,404,404,
Tulsa,Superintendent of Public Instruction,John Cox,DEM,720078,0,0,366,366,
Tulsa,Superintendent of Public Instruction,Larry Huff,IND,720078,0,0,71,71,
Tulsa,Commissioner of Labor,Leslie Osborn,REP,720078,0,0,413,413,
Tulsa,Commissioner of Labor,Fred Dorrell,DEM,720078,0,0,374,374,
Tulsa,Commissioner of Labor,Brandt Dismukes,IND,720078,0,0,41,41,
Tulsa,Insurance Commissioner,Glen Mulready,REP,720078,0,0,432,432,
Tulsa,Insurance Commissioner,Kimberly Fobbs,DEM,720078,0,0,398,398,
Tulsa,Corporation Commissioner,Bob Anthony,REP,720078,0,0,416,416,
Tulsa,Corporation Commissioner,Ashley Nicole Mccray,DEM,720078,0,0,376,376,
Tulsa,Corporation Commissioner,Jackie Short,IND,720078,0,0,51,51,
Tulsa,U.S. House,Kevin Hern,REP,720078,0,0,414,414,1
Tulsa,U.S. House,Tim Gilpin,DEM,720078,0,0,437,437,1
Tulsa,State House,Gene Bell,LIB,720078,0,0,34,34,78
Tulsa,State House,Paul Royse,REP,720078,0,0,360,360,78
Tulsa,State House,Meloyde Blancett,DEM,720078,0,0,445,445,78
Tulsa,Governor,Chris Powell,LIB,720079,0,0,29,29,
Tulsa,Governor,Kevin Stitt,REP,720079,0,0,336,336,
Tulsa,Governor,Drew Edmondson,DEM,720079,0,0,504,504,
Tulsa,Lieutenant Governor,Matt Pinnell,REP,720079,0,0,397,397,
Tulsa,Lieutenant Governor,Anastasia Pittman,DEM,720079,0,0,424,424,
Tulsa,Lieutenant Governor,Ivan Holmes,IND,720079,0,0,39,39,
Tulsa,State Auditor,John Yeutter,LIB,720079,0,0,291,291,
Tulsa,State Auditor,Cindy Byrd,REP,720079,0,0,490,490,
Tulsa,Attorney General,Mike Hunter,REP,720079,0,0,403,403,
Tulsa,Attorney General,Mark Myles,DEM,720079,0,0,453,453,
Tulsa,State Treasurer,Randy Mcdaniel,REP,720079,0,0,447,447,
Tulsa,State Treasurer,Charles De Coune,IND,720079,0,0,328,328,
Tulsa,Superintendent of Public Instruction,Joy Hofmeister,REP,720079,0,0,423,423,
Tulsa,Superintendent of Public Instruction,John Cox,DEM,720079,0,0,376,376,
Tulsa,Superintendent of Public Instruction,Larry Huff,IND,720079,0,0,61,61,
Tulsa,Commissioner of Labor,Leslie Osborn,REP,720079,0,0,385,385,
Tulsa,Commissioner of Labor,Fred Dorrell,DEM,720079,0,0,417,417,
Tulsa,Commissioner of Labor,Brandt Dismukes,IND,720079,0,0,44,44,
Tulsa,Insurance Commissioner,Glen Mulready,REP,720079,0,0,390,390,
Tulsa,Insurance Commissioner,Kimberly Fobbs,DEM,720079,0,0,453,453,
Tulsa,Corporation Commissioner,Bob Anthony,REP,720079,0,0,399,399,
Tulsa,Corporation Commissioner,Ashley Nicole Mccray,DEM,720079,0,0,406,406,
Tulsa,Corporation Commissioner,Jackie Short,IND,720079,0,0,41,41,
Tulsa,U.S. House,Kevin Hern,REP,720079,0,0,380,380,1
Tulsa,U.S. House,Tim Gilpin,DEM,720079,0,0,481,481,1
Tulsa,State House,Gene Bell,LIB,720079,0,0,41,41,78
Tulsa,State House,Paul Royse,REP,720079,0,0,332,332,78
Tulsa,State House,Meloyde Blancett,DEM,720079,0,0,482,482,78
Tulsa,Governor,Chris Powell,LIB,720080,0,0,5,5,
Tulsa,Governor,Kevin Stitt,REP,720080,0,0,78,78,
Tulsa,Governor,Drew Edmondson,DEM,720080,0,0,95,95,
Tulsa,Lieutenant Governor,Matt Pinnell,REP,720080,0,0,99,99,
Tulsa,Lieutenant Governor,Anastasia Pittman,DEM,720080,0,0,73,73,
Tulsa,Lieutenant Governor,Ivan Holmes,IND,720080,0,0,6,6,
Tulsa,State Auditor,John Yeutter,LIB,720080,0,0,44,44,
Tulsa,State Auditor,Cindy Byrd,REP,720080,0,0,115,115,
Tulsa,Attorney General,Mike Hunter,REP,720080,0,0,95,95,
Tulsa,Attorney General,Mark Myles,DEM,720080,0,0,80,80,
Tulsa,State Treasurer,Randy Mcdaniel,REP,720080,0,0,100,100,
Tulsa,State Treasurer,Charles De Coune,IND,720080,0,0,58,58,
Tulsa,Superintendent of Public Instruction,Joy Hofmeister,REP,720080,0,0,92,92,
Tulsa,Superintendent of Public Instruction,John Cox,DEM,720080,0,0,68,68,
Tulsa,Superintendent of Public Instruction,Larry Huff,IND,720080,0,0,15,15,
Tulsa,Commissioner of Labor,Leslie Osborn,REP,720080,0,0,93,93,
Tulsa,Commissioner of Labor,Fred Dorrell,DEM,720080,0,0,70,70,
Tulsa,Commissioner of Labor,Brandt Dismukes,IND,720080,0,0,8,8,
Tulsa,Insurance Commissioner,Glen Mulready,REP,720080,0,0,95,95,
Tulsa,Insurance Commissioner,Kimberly Fobbs,DEM,720080,0,0,78,78,
Tulsa,Corporation Commissioner,Bob Anthony,REP,720080,0,0,92,92,
Tulsa,Corporation Commissioner,Ashley Nicole Mccray,DEM,720080,0,0,74,74,
Tulsa,Corporation Commissioner,Jackie Short,IND,720080,0,0,7,7,
Tulsa,U.S. House,Kevin Hern,REP,720080,0,0,90,90,1
Tulsa,U.S. House,Tim Gilpin,DEM,720080,0,0,88,88,1
Tulsa,State House,Carol Bush,REP,720080,0,0,98,98,70
Tulsa,State House,Jj Burnam,DEM,720080,0,0,77,77,70
Tulsa,Governor,Chris Powell,LIB,720081,0,0,24,24,
Tulsa,Governor,Kevin Stitt,REP,720081,0,0,402,402,
Tulsa,Governor,Drew Edmondson,DEM,720081,0,0,589,589,
Tulsa,Lieutenant Governor,Matt Pinnell,REP,720081,0,0,502,502,
Tulsa,Lieutenant Governor,Anastasia Pittman,DEM,720081,0,0,463,463,
Tulsa,Lieutenant Governor,Ivan Holmes,IND,720081,0,0,45,45,
Tulsa,State Auditor,John Yeutter,LIB,720081,0,0,292,292,
Tulsa,State Auditor,Cindy Byrd,REP,720081,0,0,590,590,
Tulsa,Attorney General,Mike Hunter,REP,720081,0,0,528,528,
Tulsa,Attorney General,Mark Myles,DEM,720081,0,0,470,470,
Tulsa,State Treasurer,Randy Mcdaniel,REP,720081,0,0,545,545,
Tulsa,State Treasurer,Charles De Coune,IND,720081,0,0,332,332,
Tulsa,Superintendent of Public Instruction,Joy Hofmeister,REP,720081,0,0,503,503,
Tulsa,Superintendent of Public Instruction,John Cox,DEM,720081,0,0,434,434,
Tulsa,Superintendent of Public Instruction,Larry Huff,IND,720081,0,0,69,69,
Tulsa,Commissioner of Labor,Leslie Osborn,REP,720081,0,0,476,476,
Tulsa,Commissioner of Labor,Fred Dorrell,DEM,720081,0,0,442,442,
Tulsa,Commissioner of Labor,Brandt Dismukes,IND,720081,0,0,62,62,
Tulsa,Insurance Commissioner,Glen Mulready,REP,720081,0,0,492,492,
Tulsa,Insurance Commissioner,Kimberly Fobbs,DEM,720081,0,0,498,498,
Tulsa,Corporation Commissioner,Bob Anthony,REP,720081,0,0,494,494,
Tulsa,Corporation Commissioner,Ashley Nicole Mccray,DEM,720081,0,0,451,451,
Tulsa,Corporation Commissioner,Jackie Short,IND,720081,0,0,47,47,
Tulsa,U.S. House,Kevin Hern,REP,720081,0,0,469,469,1
Tulsa,U.S. House,Tim Gilpin,DEM,720081,0,0,537,537,1
Tulsa,State House,Carol Bush,REP,720081,0,0,498,498,70
Tulsa,State House,Jj Burnam,DEM,720081,0,0,501,501,70
Tulsa,Governor,Chris Powell,LIB,720082,0,0,22,22,
Tulsa,Governor,Kevin Stitt,REP,720082,0,0,242,242,
Tulsa,Governor,Drew Edmondson,DEM,720082,0,0,368,368,
Tulsa,Lieutenant Governor,Matt Pinnell,REP,720082,0,0,288,288,
Tulsa,Lieutenant Governor,Anastasia Pittman,DEM,720082,0,0,310,310,
Tulsa,Lieutenant Governor,Ivan Holmes,IND,720082,0,0,25,25,
Tulsa,State Auditor,John Yeutter,LIB,720082,0,0,177,177,
Tulsa,State Auditor,Cindy Byrd,REP,720082,0,0,377,377,
Tulsa,Attorney General,Mike Hunter,REP,720082,0,0,295,295,
Tulsa,Attorney General,Mark Myles,DEM,720082,0,0,326,326,
Tulsa,State Treasurer,Randy Mcdaniel,REP,720082,0,0,311,311,
Tulsa,State Treasurer,Charles De Coune,IND,720082,0,0,250,250,
Tulsa,Superintendent of Public Instruction,Joy Hofmeister,REP,720082,0,0,299,299,
Tulsa,Superintendent of Public Instruction,John Cox,DEM,720082,0,0,280,280,
Tulsa,Superintendent of Public Instruction,Larry Huff,IND,720082,0,0,45,45,
Tulsa,Commissioner of Labor,Leslie Osborn,REP,720082,0,0,279,279,
Tulsa,Commissioner of Labor,Fred Dorrell,DEM,720082,0,0,298,298,
Tulsa,Commissioner of Labor,Brandt Dismukes,IND,720082,0,0,35,35,
Tulsa,Insurance Commissioner,Glen Mulready,REP,720082,0,0,277,277,
Tulsa,Insurance Commissioner,Kimberly Fobbs,DEM,720082,0,0,332,332,
Tulsa,Corporation Commissioner,Bob Anthony,REP,720082,0,0,293,293,
Tulsa,Corporation Commissioner,Ashley Nicole Mccray,DEM,720082,0,0,287,287,
Tulsa,Corporation Commissioner,Jackie Short,IND,720082,0,0,35,35,
Tulsa,U.S. House,Kevin Hern,REP,720082,0,0,282,282,1
Tulsa,U.S. House,Tim Gilpin,DEM,720082,0,0,345,345,1
Tulsa,State House,Carol Bush,REP,720082,0,0,282,282,70
Tulsa,State House,Jj Burnam,DEM,720082,0,0,335,335,70
Tulsa,Governor,Chris Powell,LIB,720083,0,0,17,17,
Tulsa,Governor,Kevin Stitt,REP,720083,0,0,219,219,
Tulsa,Governor,Drew Edmondson,DEM,720083,0,0,417,417,
Tulsa,Lieutenant Governor,Matt Pinnell,REP,720083,0,0,271,271,
Tulsa,Lieutenant Governor,Anastasia Pittman,DEM,720083,0,0,352,352,
Tulsa,Lieutenant Governor,Ivan Holmes,IND,720083,0,0,23,23,
Tulsa,State Auditor,John Yeutter,LIB,720083,0,0,232,232,
Tulsa,State Auditor,Cindy Byrd,REP,720083,0,0,342,342,
Tulsa,Attorney General,Mike Hunter,REP,720083,0,0,268,268,
Tulsa,Attorney General,Mark Myles,DEM,720083,0,0,371,371,
Tulsa,State Treasurer,Randy Mcdaniel,REP,720083,0,0,284,284,
Tulsa,State Treasurer,Charles De Coune,IND,720083,0,0,288,288,
Tulsa,Superintendent of Public Instruction,Joy Hofmeister,REP,720083,0,0,278,278,
Tulsa,Superintendent of Public Instruction,John Cox,DEM,720083,0,0,317,317,
Tulsa,Superintendent of Public Instruction,Larry Huff,IND,720083,0,0,44,44,
Tulsa,Commissioner of Labor,Leslie Osborn,REP,720083,0,0,253,253,
Tulsa,Commissioner of Labor,Fred Dorrell,DEM,720083,0,0,348,348,
Tulsa,Commissioner of Labor,Brandt Dismukes,IND,720083,0,0,29,29,
Tulsa,Insurance Commissioner,Glen Mulready,REP,720083,0,0,264,264,
Tulsa,Insurance Commissioner,Kimberly Fobbs,DEM,720083,0,0,370,370,
Tulsa,Corporation Commissioner,Bob Anthony,REP,720083,0,0,253,253,
Tulsa,Corporation Commissioner,Ashley Nicole Mccray,DEM,720083,0,0,340,340,
Tulsa,Corporation Commissioner,Jackie Short,IND,720083,0,0,46,46,
Tulsa,U.S. House,Kevin Hern,REP,720083,0,0,258,258,1
Tulsa,U.S. House,Tim Gilpin,DEM,720083,0,0,389,389,1
Tulsa,State House,Carol Bush,REP,720083,0,0,293,293,70
Tulsa,State House,Jj Burnam,DEM,720083,0,0,354,354,70
Tulsa,Governor,Chris Powell,LIB,720084,0,0,9,9,
Tulsa,Governor,Kevin Stitt,REP,720084,0,0,238,238,
Tulsa,Governor,Drew Edmondson,DEM,720084,0,0,350,350,
Tulsa,Lieutenant Governor,Matt Pinnell,REP,720084,0,0,311,311,
Tulsa,Lieutenant Governor,Anastasia Pittman,DEM,720084,0,0,269,269,
Tulsa,Lieutenant Governor,Ivan Holmes,IND,720084,0,0,13,13,
Tulsa,State Auditor,John Yeutter,LIB,720084,0,0,155,155,
Tulsa,State Auditor,Cindy Byrd,REP,720084,0,0,391,391,
Tulsa,Attorney General,Mike Hunter,REP,720084,0,0,310,310,
Tulsa,Attorney General,Mark Myles,DEM,720084,0,0,280,280,
Tulsa,State Treasurer,Randy Mcdaniel,REP,720084,0,0,349,349,
Tulsa,State Treasurer,Charles De Coune,IND,720084,0,0,197,197,
Tulsa,Superintendent of Public Instruction,Joy Hofmeister,REP,720084,0,0,335,335,
Tulsa,Superintendent of Public Instruction,John Cox,DEM,720084,0,0,231,231,
Tulsa,Superintendent of Public Instruction,Larry Huff,IND,720084,0,0,28,28,
Tulsa,Commissioner of Labor,Leslie Osborn,REP,720084,0,0,298,298,
Tulsa,Commissioner of Labor,Fred Dorrell,DEM,720084,0,0,251,251,
Tulsa,Commissioner of Labor,Brandt Dismukes,IND,720084,0,0,29,29,
Tulsa,Insurance Commissioner,Glen Mulready,REP,720084,0,0,304,304,
Tulsa,Insurance Commissioner,Kimberly Fobbs,DEM,720084,0,0,275,275,
Tulsa,Corporation Commissioner,Bob Anthony,REP,720084,0,0,304,304,
Tulsa,Corporation Commissioner,Ashley Nicole Mccray,DEM,720084,0,0,252,252,
Tulsa,Corporation Commissioner,Jackie Short,IND,720084,0,0,26,26,
Tulsa,U.S. House,Kevin Hern,REP,720084,0,0,269,269,1
Tulsa,U.S. House,Tim Gilpin,DEM,720084,0,0,322,322,1
Tulsa,State House,Carol Bush,REP,720084,0,0,329,329,70
Tulsa,State House,Jj Burnam,DEM,720084,0,0,260,260,70
Tulsa,Governor,Chris Powell,LIB,720085,0,0,8,8,
Tulsa,Governor,Kevin Stitt,REP,720085,0,0,87,87,
Tulsa,Governor,Drew Edmondson,DEM,720085,0,0,195,195,
Tulsa,Lieutenant Governor,Matt Pinnell,REP,720085,0,0,119,119,
Tulsa,Lieutenant Governor,Anastasia Pittman,DEM,720085,0,0,158,158,
Tulsa,Lieutenant Governor,Ivan Holmes,IND,720085,0,0,13,13,
Tulsa,State Auditor,John Yeutter,LIB,720085,0,0,105,105,
Tulsa,State Auditor,Cindy Byrd,REP,720085,0,0,151,151,
Tulsa,Attorney General,Mike Hunter,REP,720085,0,0,122,122,
Tulsa,Attorney General,Mark Myles,DEM,720085,0,0,164,164,
Tulsa,State Treasurer,Randy Mcdaniel,REP,720085,0,0,133,133,
Tulsa,State Treasurer,Charles De Coune,IND,720085,0,0,123,123,
Tulsa,Superintendent of Public Instruction,Joy Hofmeister,REP,720085,0,0,103,103,
Tulsa,Superintendent of Public Instruction,John Cox,DEM,720085,0,0,159,159,
Tulsa,Superintendent of Public Instruction,Larry Huff,IND,720085,0,0,25,25,
Tulsa,Commissioner of Labor,Leslie Osborn,REP,720085,0,0,108,108,
Tulsa,Commissioner of Labor,Fred Dorrell,DEM,720085,0,0,155,155,
Tulsa,Commissioner of Labor,Brandt Dismukes,IND,720085,0,0,20,20,
Tulsa,Insurance Commissioner,Glen Mulready,REP,720085,0,0,109,109,
Tulsa,Insurance Commissioner,Kimberly Fobbs,DEM,720085,0,0,178,178,
Tulsa,Corporation Commissioner,Bob Anthony,REP,720085,0,0,105,105,
Tulsa,Corporation Commissioner,Ashley Nicole Mccray,DEM,720085,0,0,163,163,
Tulsa,Corporation Commissioner,Jackie Short,IND,720085,0,0,19,19,
Tulsa,U.S. House,Kevin Hern,REP,720085,0,0,100,100,1
Tulsa,U.S. House,Tim Gilpin,DEM,720085,0,0,188,188,1
Tulsa,State House,Carol Bush,REP,720085,0,0,116,116,70
Tulsa,State House,Jj Burnam,DEM,720085,0,0,170,170,70
Tulsa,Governor,Chris Powell,LIB,720086,0,0,24,24,
Tulsa,Governor,Kevin Stitt,REP,720086,0,0,365,365,
Tulsa,Governor,Drew Edmondson,DEM,720086,0,0,401,401,
Tulsa,Lieutenant Governor,Matt Pinnell,REP,720086,0,0,405,405,
Tulsa,Lieutenant Governor,Anastasia Pittman,DEM,720086,0,0,349,349,
Tulsa,Lieutenant Governor,Ivan Holmes,IND,720086,0,0,35,35,
Tulsa,State Auditor,John Yeutter,LIB,720086,0,0,239,239,
Tulsa,State Auditor,Cindy Byrd,REP,720086,0,0,468,468,
Tulsa,Attorney General,Mike Hunter,REP,720086,0,0,408,408,
Tulsa,Attorney General,Mark Myles,DEM,720086,0,0,370,370,
Tulsa,State Treasurer,Randy Mcdaniel,REP,720086,0,0,422,422,
Tulsa,State Treasurer,Charles De Coune,IND,720086,0,0,282,282,
Tulsa,Superintendent of Public Instruction,Joy Hofmeister,REP,720086,0,0,393,393,
Tulsa,Superintendent of Public Instruction,John Cox,DEM,720086,0,0,331,331,
Tulsa,Superintendent of Public Instruction,Larry Huff,IND,720086,0,0,62,62,
Tulsa,Commissioner of Labor,Leslie Osborn,REP,720086,0,0,389,389,
Tulsa,Commissioner of Labor,Fred Dorrell,DEM,720086,0,0,341,341,
Tulsa,Commissioner of Labor,Brandt Dismukes,IND,720086,0,0,42,42,
Tulsa,Insurance Commissioner,Glen Mulready,REP,720086,0,0,396,396,
Tulsa,Insurance Commissioner,Kimberly Fobbs,DEM,720086,0,0,373,373,
Tulsa,Corporation Commissioner,Bob Anthony,REP,720086,0,0,387,387,
Tulsa,Corporation Commissioner,Ashley Nicole Mccray,DEM,720086,0,0,343,343,
Tulsa,Corporation Commissioner,Jackie Short,IND,720086,0,0,49,49,
Tulsa,U.S. House,Kevin Hern,REP,720086,0,0,395,395,1
Tulsa,U.S. House,Tim Gilpin,DEM,720086,0,0,389,389,1
Tulsa,State House,Kelli Krebs,LIB,720086,0,0,35,35,75
Tulsa,State House,T. Marti,REP,720086,0,0,362,362,75
Tulsa,State House,Karen Gaddis,DEM,720086,0,0,387,387,75
Tulsa,Governor,Chris Powell,LIB,720087,0,0,20,20,
Tulsa,Governor,Kevin Stitt,REP,720087,0,0,302,302,
Tulsa,Governor,Drew Edmondson,DEM,720087,0,0,417,417,
Tulsa,Lieutenant Governor,Matt Pinnell,REP,720087,0,0,362,362,
Tulsa,Lieutenant Governor,Anastasia Pittman,DEM,720087,0,0,343,343,
Tulsa,Lieutenant Governor,Ivan Holmes,IND,720087,0,0,21,21,
Tulsa,State Auditor,John Yeutter,LIB,720087,0,0,226,226,
Tulsa,State Auditor,Cindy Byrd,REP,720087,0,0,437,437,
Tulsa,Attorney General,Mike Hunter,REP,720087,0,0,365,365,
Tulsa,Attorney General,Mark Myles,DEM,720087,0,0,358,358,
Tulsa,State Treasurer,Randy Mcdaniel,REP,720087,0,0,401,401,
Tulsa,State Treasurer,Charles De Coune,IND,720087,0,0,255,255,
Tulsa,Superintendent of Public Instruction,Joy Hofmeister,REP,720087,0,0,354,354,
Tulsa,Superintendent of Public Instruction,John Cox,DEM,720087,0,0,315,315,
Tulsa,Superintendent of Public Instruction,Larry Huff,IND,720087,0,0,51,51,
Tulsa,Commissioner of Labor,Leslie Osborn,REP,720087,0,0,346,346,
Tulsa,Commissioner of Labor,Fred Dorrell,DEM,720087,0,0,336,336,
Tulsa,Commissioner of Labor,Brandt Dismukes,IND,720087,0,0,34,34,
Tulsa,Insurance Commissioner,Glen Mulready,REP,720087,0,0,354,354,
Tulsa,Insurance Commissioner,Kimberly Fobbs,DEM,720087,0,0,360,360,
Tulsa,Corporation Commissioner,Bob Anthony,REP,720087,0,0,344,344,
Tulsa,Corporation Commissioner,Ashley Nicole Mccray,DEM,720087,0,0,328,328,
Tulsa,Corporation Commissioner,Jackie Short,IND,720087,0,0,53,53,
Tulsa,U.S. House,Kevin Hern,REP,720087,0,0,343,343,1
Tulsa,U.S. House,Tim Gilpin,DEM,720087,0,0,385,385,1
Tulsa,State House,Dan Hicks,REP,720087,0,0,306,306,79
Tulsa,State House,Melissa Provenzano,DEM,720087,0,0,414,414,79
Tulsa,Governor,Chris Powell,LIB,720088,0,0,6,6,
Tulsa,Governor,Kevin Stitt,REP,720088,0,0,67,67,
Tulsa,Governor,Drew Edmondson,DEM,720088,0,0,117,117,
Tulsa,Lieutenant Governor,Matt Pinnell,REP,720088,0,0,76,76,
Tulsa,Lieutenant Governor,Anastasia Pittman,DEM,720088,0,0,109,109,
Tulsa,Lieutenant Governor,Ivan Holmes,IND,720088,0,0,3,3,
Tulsa,State Auditor,John Yeutter,LIB,720088,0,0,73,73,
Tulsa,State Auditor,Cindy Byrd,REP,720088,0,0,92,92,
Tulsa,Attorney General,Mike Hunter,REP,720088,0,0,76,76,
Tulsa,Attorney General,Mark Myles,DEM,720088,0,0,110,110,
Tulsa,State Treasurer,Randy Mcdaniel,REP,720088,0,0,84,84,
Tulsa,State Treasurer,Charles De Coune,IND,720088,0,0,81,81,
Tulsa,Superintendent of Public Instruction,Joy Hofmeister,REP,720088,0,0,73,73,
Tulsa,Superintendent of Public Instruction,John Cox,DEM,720088,0,0,108,108,
Tulsa,Superintendent of Public Instruction,Larry Huff,IND,720088,0,0,8,8,
Tulsa,Commissioner of Labor,Leslie Osborn,REP,720088,0,0,75,75,
Tulsa,Commissioner of Labor,Fred Dorrell,DEM,720088,0,0,103,103,
Tulsa,Commissioner of Labor,Brandt Dismukes,IND,720088,0,0,9,9,
Tulsa,Insurance Commissioner,Glen Mulready,REP,720088,0,0,69,69,
Tulsa,Insurance Commissioner,Kimberly Fobbs,DEM,720088,0,0,117,117,
Tulsa,Corporation Commissioner,Bob Anthony,REP,720088,0,0,71,71,
Tulsa,Corporation Commissioner,Ashley Nicole Mccray,DEM,720088,0,0,104,104,
Tulsa,Corporation Commissioner,Jackie Short,IND,720088,0,0,12,12,
Tulsa,U.S. House,Kevin Hern,REP,720088,0,0,73,73,1
Tulsa,U.S. House,Tim Gilpin,DEM,720088,0,0,113,113,1
Tulsa,State House,Kelli Krebs,LIB,720088,0,0,9,9,75
Tulsa,State House,T. Marti,REP,720088,0,0,67,67,75
Tulsa,State House,Karen Gaddis,DEM,720088,0,0,112,112,75
Tulsa,Governor,Chris Powell,LIB,720089,0,0,17,17,
Tulsa,Governor,Kevin Stitt,REP,720089,0,0,142,142,
Tulsa,Governor,Drew Edmondson,DEM,720089,0,0,200,200,
Tulsa,Lieutenant Governor,Matt Pinnell,REP,720089,0,0,172,172,
Tulsa,Lieutenant Governor,Anastasia Pittman,DEM,720089,0,0,169,169,
Tulsa,Lieutenant Governor,Ivan Holmes,IND,720089,0,0,17,17,
Tulsa,State Auditor,John Yeutter,LIB,720089,0,0,126,126,
Tulsa,State Auditor,Cindy Byrd,REP,720089,0,0,203,203,
Tulsa,Attorney General,Mike Hunter,REP,720089,0,0,188,188,
Tulsa,Attorney General,Mark Myles,DEM,720089,0,0,168,168,
Tulsa,State Treasurer,Randy Mcdaniel,REP,720089,0,0,198,198,
Tulsa,State Treasurer,Charles De Coune,IND,720089,0,0,132,132,
Tulsa,Superintendent of Public Instruction,Joy Hofmeister,REP,720089,0,0,164,164,
Tulsa,Superintendent of Public Instruction,John Cox,DEM,720089,0,0,161,161,
Tulsa,Superintendent of Public Instruction,Larry Huff,IND,720089,0,0,33,33,
Tulsa,Commissioner of Labor,Leslie Osborn,REP,720089,0,0,172,172,
Tulsa,Commissioner of Labor,Fred Dorrell,DEM,720089,0,0,166,166,
Tulsa,Commissioner of Labor,Brandt Dismukes,IND,720089,0,0,18,18,
Tulsa,Insurance Commissioner,Glen Mulready,REP,720089,0,0,179,179,
Tulsa,Insurance Commissioner,Kimberly Fobbs,DEM,720089,0,0,178,178,
Tulsa,Corporation Commissioner,Bob Anthony,REP,720089,0,0,163,163,
Tulsa,Corporation Commissioner,Ashley Nicole Mccray,DEM,720089,0,0,167,167,
Tulsa,Corporation Commissioner,Jackie Short,IND,720089,0,0,27,27,
Tulsa,U.S. House,Kevin Hern,REP,720089,0,0,168,168,1
Tulsa,U.S. House,Tim Gilpin,DEM,720089,0,0,190,190,1
Tulsa,State House,Carol Bush,REP,720089,0,0,190,190,70
Tulsa,State House,Jj Burnam,DEM,720089,0,0,167,167,70
Tulsa,Governor,Chris Powell,LIB,720090,0,0,10,10,
Tulsa,Governor,Kevin Stitt,REP,720090,0,0,87,87,
Tulsa,Governor,Drew Edmondson,DEM,720090,0,0,138,138,
Tulsa,Lieutenant Governor,Matt Pinnell,REP,720090,0,0,103,103,
Tulsa,Lieutenant Governor,Anastasia Pittman,DEM,720090,0,0,119,119,
Tulsa,Lieutenant Governor,Ivan Holmes,IND,720090,0,0,12,12,
Tulsa,State Auditor,John Yeutter,LIB,720090,0,0,95,95,
Tulsa,State Auditor,Cindy Byrd,REP,720090,0,0,111,111,
Tulsa,Attorney General,Mike Hunter,REP,720090,0,0,101,101,
Tulsa,Attorney General,Mark Myles,DEM,720090,0,0,129,129,
Tulsa,State Treasurer,Randy Mcdaniel,REP,720090,0,0,105,105,
Tulsa,State Treasurer,Charles De Coune,IND,720090,0,0,98,98,
Tulsa,Superintendent of Public Instruction,Joy Hofmeister,REP,720090,0,0,93,93,
Tulsa,Superintendent of Public Instruction,John Cox,DEM,720090,0,0,122,122,
Tulsa,Superintendent of Public Instruction,Larry Huff,IND,720090,0,0,15,15,
Tulsa,Commissioner of Labor,Leslie Osborn,REP,720090,0,0,101,101,
Tulsa,Commissioner of Labor,Fred Dorrell,DEM,720090,0,0,118,118,
Tulsa,Commissioner of Labor,Brandt Dismukes,IND,720090,0,0,11,11,
Tulsa,Insurance Commissioner,Glen Mulready,REP,720090,0,0,100,100,
Tulsa,Insurance Commissioner,Kimberly Fobbs,DEM,720090,0,0,132,132,
Tulsa,Corporation Commissioner,Bob Anthony,REP,720090,0,0,95,95,
Tulsa,Corporation Commissioner,Ashley Nicole Mccray,DEM,720090,0,0,122,122,
Tulsa,Corporation Commissioner,Jackie Short,IND,720090,0,0,14,14,
Tulsa,U.S. House,Kevin Hern,REP,720090,0,0,97,97,1
Tulsa,U.S. House,Tim Gilpin,DEM,720090,0,0,132,132,1
Tulsa,State Senate,John Haste,REP,720090,0,0,100,100,36
Tulsa,State Senate,Bryan O'Brien,DEM,720090,0,0,130,130,36
Tulsa,State House,Kelli Krebs,LIB,720090,0,0,12,12,75
Tulsa,State House,T. Marti,REP,720090,0,0,89,89,75
Tulsa,State House,Karen Gaddis,DEM,720090,0,0,130,130,75
Tulsa,Governor,Chris Powell,LIB,720091,0,0,22,22,
Tulsa,Governor,Kevin Stitt,REP,720091,0,0,170,170,
Tulsa,Governor,Drew Edmondson,DEM,720091,0,0,271,271,
Tulsa,Lieutenant Governor,Matt Pinnell,REP,720091,0,0,194,194,
Tulsa,Lieutenant Governor,Anastasia Pittman,DEM,720091,0,0,243,243,
Tulsa,Lieutenant Governor,Ivan Holmes,IND,720091,0,0,22,22,
Tulsa,State Auditor,John Yeutter,LIB,720091,0,0,170,170,
Tulsa,State Auditor,Cindy Byrd,REP,720091,0,0,244,244,
Tulsa,Attorney General,Mike Hunter,REP,720091,0,0,196,196,
Tulsa,Attorney General,Mark Myles,DEM,720091,0,0,255,255,
Tulsa,State Treasurer,Randy Mcdaniel,REP,720091,0,0,216,216,
Tulsa,State Treasurer,Charles De Coune,IND,720091,0,0,197,197,
Tulsa,Superintendent of Public Instruction,Joy Hofmeister,REP,720091,0,0,187,187,
Tulsa,Superintendent of Public Instruction,John Cox,DEM,720091,0,0,241,241,
Tulsa,Superintendent of Public Instruction,Larry Huff,IND,720091,0,0,31,31,
Tulsa,Commissioner of Labor,Leslie Osborn,REP,720091,0,0,194,194,
Tulsa,Commissioner of Labor,Fred Dorrell,DEM,720091,0,0,233,233,
Tulsa,Commissioner of Labor,Brandt Dismukes,IND,720091,0,0,25,25,
Tulsa,Insurance Commissioner,Glen Mulready,REP,720091,0,0,196,196,
Tulsa,Insurance Commissioner,Kimberly Fobbs,DEM,720091,0,0,257,257,
Tulsa,Corporation Commissioner,Bob Anthony,REP,720091,0,0,191,191,
Tulsa,Corporation Commissioner,Ashley Nicole Mccray,DEM,720091,0,0,236,236,
Tulsa,Corporation Commissioner,Jackie Short,IND,720091,0,0,28,28,
Tulsa,U.S. House,Kevin Hern,REP,720091,0,0,191,191,1
Tulsa,U.S. House,Tim Gilpin,DEM,720091,0,0,267,267,1
Tulsa,State House,Dan Hicks,REP,720091,0,0,182,182,79
Tulsa,State House,Melissa Provenzano,DEM,720091,0,0,275,275,79
Tulsa,Governor,Chris Powell,LIB,720092,0,0,14,14,
Tulsa,Governor,Kevin Stitt,REP,720092,0,0,165,165,
Tulsa,Governor,Drew Edmondson,DEM,720092,0,0,226,226,
Tulsa,Lieutenant Governor,Matt Pinnell,REP,720092,0,0,192,192,
Tulsa,Lieutenant Governor,Anastasia Pittman,DEM,720092,0,0,197,197,
Tulsa,Lieutenant Governor,Ivan Holmes,IND,720092,0,0,15,15,
Tulsa,State Auditor,John Yeutter,LIB,720092,0,0,140,140,
Tulsa,State Auditor,Cindy Byrd,REP,720092,0,0,223,223,
Tulsa,Attorney General,Mike Hunter,REP,720092,0,0,201,201,
Tulsa,Attorney General,Mark Myles,DEM,720092,0,0,201,201,
Tulsa,State Treasurer,Randy Mcdaniel,REP,720092,0,0,207,207,
Tulsa,State Treasurer,Charles De Coune,IND,720092,0,0,161,161,
Tulsa,Superintendent of Public Instruction,Joy Hofmeister,REP,720092,0,0,190,190,
Tulsa,Superintendent of Public Instruction,John Cox,DEM,720092,0,0,183,183,
Tulsa,Superintendent of Public Instruction,Larry Huff,IND,720092,0,0,27,27,
Tulsa,Commissioner of Labor,Leslie Osborn,REP,720092,0,0,186,186,
Tulsa,Commissioner of Labor,Fred Dorrell,DEM,720092,0,0,191,191,
Tulsa,Commissioner of Labor,Brandt Dismukes,IND,720092,0,0,22,22,
Tulsa,Insurance Commissioner,Glen Mulready,REP,720092,0,0,181,181,
Tulsa,Insurance Commissioner,Kimberly Fobbs,DEM,720092,0,0,218,218,
Tulsa,Corporation Commissioner,Bob Anthony,REP,720092,0,0,188,188,
Tulsa,Corporation Commissioner,Ashley Nicole Mccray,DEM,720092,0,0,191,191,
Tulsa,Corporation Commissioner,Jackie Short,IND,720092,0,0,24,24,
Tulsa,U.S. House,Kevin Hern,REP,720092,0,0,183,183,1
Tulsa,U.S. House,Tim Gilpin,DEM,720092,0,0,221,221,1
Tulsa,State House,Gene Bell,LIB,720092,0,0,17,17,78
Tulsa,State House,Paul Royse,REP,720092,0,0,158,158,78
Tulsa,State House,Meloyde Blancett,DEM,720092,0,0,226,226,78
Tulsa,Governor,Chris Powell,LIB,720093,0,0,15,15,
Tulsa,Governor,Kevin Stitt,REP,720093,0,0,197,197,
Tulsa,Governor,Drew Edmondson,DEM,720093,0,0,179,179,
Tulsa,Lieutenant Governor,Matt Pinnell,REP,720093,0,0,220,220,
Tulsa,Lieutenant Governor,Anastasia Pittman,DEM,720093,0,0,156,156,
Tulsa,Lieutenant Governor,Ivan Holmes,IND,720093,0,0,15,15,
Tulsa,State Auditor,John Yeutter,LIB,720093,0,0,110,110,
Tulsa,State Auditor,Cindy Byrd,REP,720093,0,0,244,244,
Tulsa,Attorney General,Mike Hunter,REP,720093,0,0,215,215,
Tulsa,Attorney General,Mark Myles,DEM,720093,0,0,170,170,
Tulsa,State Treasurer,Randy Mcdaniel,REP,720093,0,0,220,220,
Tulsa,State Treasurer,Charles De Coune,IND,720093,0,0,137,137,
Tulsa,Superintendent of Public Instruction,Joy Hofmeister,REP,720093,0,0,201,201,
Tulsa,Superintendent of Public Instruction,John Cox,DEM,720093,0,0,160,160,
Tulsa,Superintendent of Public Instruction,Larry Huff,IND,720093,0,0,25,25,
Tulsa,Commissioner of Labor,Leslie Osborn,REP,720093,0,0,213,213,
Tulsa,Commissioner of Labor,Fred Dorrell,DEM,720093,0,0,147,147,
Tulsa,Commissioner of Labor,Brandt Dismukes,IND,720093,0,0,23,23,
Tulsa,Insurance Commissioner,Glen Mulready,REP,720093,0,0,214,214,
Tulsa,Insurance Commissioner,Kimberly Fobbs,DEM,720093,0,0,169,169,
Tulsa,Corporation Commissioner,Bob Anthony,REP,720093,0,0,216,216,
Tulsa,Corporation Commissioner,Ashley Nicole Mccray,DEM,720093,0,0,145,145,
Tulsa,Corporation Commissioner,Jackie Short,IND,720093,0,0,24,24,
Tulsa,U.S. House,Kevin Hern,REP,720093,0,0,217,217,1
Tulsa,U.S. House,Tim Gilpin,DEM,720093,0,0,167,167,1
Tulsa,State House,Gene Bell,LIB,720093,0,0,27,27,78
Tulsa,State House,Paul Royse,REP,720093,0,0,177,177,78
Tulsa,State House,Meloyde Blancett,DEM,720093,0,0,179,179,78
Tulsa,Governor,Chris Powell,LIB,720094,0,0,28,28,
Tulsa,Governor,Kevin Stitt,REP,720094,0,0,300,300,
Tulsa,Governor,Drew Edmondson,DEM,720094,0,0,309,309,
Tulsa,Lieutenant Governor,Matt Pinnell,REP,720094,0,0,357,357,
Tulsa,Lieutenant Governor,Anastasia Pittman,DEM,720094,0,0,255,255,
Tulsa,Lieutenant Governor,Ivan Holmes,IND,720094,0,0,19,19,
Tulsa,State Auditor,John Yeutter,LIB,720094,0,0,176,176,
Tulsa,State Auditor,Cindy Byrd,REP,720094,0,0,395,395,
Tulsa,Attorney General,Mike Hunter,REP,720094,0,0,368,368,
Tulsa,Attorney General,Mark Myles,DEM,720094,0,0,257,257,
Tulsa,State Treasurer,Randy Mcdaniel,REP,720094,0,0,378,378,
Tulsa,State Treasurer,Charles De Coune,IND,720094,0,0,190,190,
Tulsa,Superintendent of Public Instruction,Joy Hofmeister,REP,720094,0,0,338,338,
Tulsa,Superintendent of Public Instruction,John Cox,DEM,720094,0,0,243,243,
Tulsa,Superintendent of Public Instruction,Larry Huff,IND,720094,0,0,52,52,
Tulsa,Commissioner of Labor,Leslie Osborn,REP,720094,0,0,349,349,
Tulsa,Commissioner of Labor,Fred Dorrell,DEM,720094,0,0,243,243,
Tulsa,Commissioner of Labor,Brandt Dismukes,IND,720094,0,0,28,28,
Tulsa,Insurance Commissioner,Glen Mulready,REP,720094,0,0,358,358,
Tulsa,Insurance Commissioner,Kimberly Fobbs,DEM,720094,0,0,264,264,
Tulsa,Corporation Commissioner,Bob Anthony,REP,720094,0,0,355,355,
Tulsa,Corporation Commissioner,Ashley Nicole Mccray,DEM,720094,0,0,234,234,
Tulsa,Corporation Commissioner,Jackie Short,IND,720094,0,0,36,36,
Tulsa,U.S. House,Kevin Hern,REP,720094,0,0,353,353,1
Tulsa,U.S. House,Tim Gilpin,DEM,720094,0,0,280,280,1
Tulsa,State House,Gene Bell,LIB,720094,0,0,25,25,78
Tulsa,State House,Paul Royse,REP,720094,0,0,298,298,78
Tulsa,State House,Meloyde Blancett,DEM,720094,0,0,307,307,78
Tulsa,Governor,Chris Powell,LIB,720095,0,0,17,17,
Tulsa,Governor,Kevin Stitt,REP,720095,0,0,290,290,
Tulsa,Governor,Drew Edmondson,DEM,720095,0,0,272,272,
Tulsa,Lieutenant Governor,Matt Pinnell,REP,720095,0,0,319,319,
Tulsa,Lieutenant Governor,Anastasia Pittman,DEM,720095,0,0,233,233,
Tulsa,Lieutenant Governor,Ivan Holmes,IND,720095,0,0,24,24,
Tulsa,State Auditor,John Yeutter,LIB,720095,0,0,168,168,
Tulsa,State Auditor,Cindy Byrd,REP,720095,0,0,358,358,
Tulsa,Attorney General,Mike Hunter,REP,720095,0,0,323,323,
Tulsa,Attorney General,Mark Myles,DEM,720095,0,0,250,250,
Tulsa,State Treasurer,Randy Mcdaniel,REP,720095,0,0,334,334,
Tulsa,State Treasurer,Charles De Coune,IND,720095,0,0,187,187,
Tulsa,Superintendent of Public Instruction,Joy Hofmeister,REP,720095,0,0,300,300,
Tulsa,Superintendent of Public Instruction,John Cox,DEM,720095,0,0,218,218,
Tulsa,Superintendent of Public Instruction,Larry Huff,IND,720095,0,0,53,53,
Tulsa,Commissioner of Labor,Leslie Osborn,REP,720095,0,0,303,303,
Tulsa,Commissioner of Labor,Fred Dorrell,DEM,720095,0,0,225,225,
Tulsa,Commissioner of Labor,Brandt Dismukes,IND,720095,0,0,36,36,
Tulsa,Insurance Commissioner,Glen Mulready,REP,720095,0,0,313,313,
Tulsa,Insurance Commissioner,Kimberly Fobbs,DEM,720095,0,0,249,249,
Tulsa,Corporation Commissioner,Bob Anthony,REP,720095,0,0,322,322,
Tulsa,Corporation Commissioner,Ashley Nicole Mccray,DEM,720095,0,0,222,222,
Tulsa,Corporation Commissioner,Jackie Short,IND,720095,0,0,29,29,
Tulsa,U.S. House,Kevin Hern,REP,720095,0,0,320,320,1
Tulsa,U.S. House,Tim Gilpin,DEM,720095,0,0,258,258,1
Tulsa,State House,Gene Bell,LIB,720095,0,0,31,31,78
Tulsa,State House,Paul Royse,REP,720095,0,0,281,281,78
Tulsa,State House,Meloyde Blancett,DEM,720095,0,0,259,259,78
Tulsa,Governor,Chris Powell,LIB,720096,0,0,17,17,
Tulsa,Governor,Kevin Stitt,REP,720096,0,0,206,206,
Tulsa,Governor,Drew Edmondson,DEM,720096,0,0,231,231,
Tulsa,Lieutenant Governor,Matt Pinnell,REP,720096,0,0,226,226,
Tulsa,Lieutenant Governor,Anastasia Pittman,DEM,720096,0,0,210,210,
Tulsa,Lieutenant Governor,Ivan Holmes,IND,720096,0,0,17,17,
Tulsa,State Auditor,John Yeutter,LIB,720096,0,0,151,151,
Tulsa,State Auditor,Cindy Byrd,REP,720096,0,0,257,257,
Tulsa,Attorney General,Mike Hunter,REP,720096,0,0,237,237,
Tulsa,Attorney General,Mark Myles,DEM,720096,0,0,212,212,
Tulsa,State Treasurer,Randy Mcdaniel,REP,720096,0,0,237,237,
Tulsa,State Treasurer,Charles De Coune,IND,720096,0,0,174,174,
Tulsa,Superintendent of Public Instruction,Joy Hofmeister,REP,720096,0,0,221,221,
Tulsa,Superintendent of Public Instruction,John Cox,DEM,720096,0,0,192,192,
Tulsa,Superintendent of Public Instruction,Larry Huff,IND,720096,0,0,38,38,
Tulsa,Commissioner of Labor,Leslie Osborn,REP,720096,0,0,220,220,
Tulsa,Commissioner of Labor,Fred Dorrell,DEM,720096,0,0,195,195,
Tulsa,Commissioner of Labor,Brandt Dismukes,IND,720096,0,0,31,31,
Tulsa,Insurance Commissioner,Glen Mulready,REP,720096,0,0,233,233,
Tulsa,Insurance Commissioner,Kimberly Fobbs,DEM,720096,0,0,213,213,
Tulsa,Corporation Commissioner,Bob Anthony,REP,720096,0,0,232,232,
Tulsa,Corporation Commissioner,Ashley Nicole Mccray,DEM,720096,0,0,189,189,
Tulsa,Corporation Commissioner,Jackie Short,IND,720096,0,0,28,28,
Tulsa,U.S. House,Kevin Hern,REP,720096,0,0,226,226,1
Tulsa,U.S. House,Tim Gilpin,DEM,720096,0,0,223,223,1
Tulsa,State House,Kelli Krebs,LIB,720096,0,0,17,17,75
Tulsa,State House,T. Marti,REP,720096,0,0,213,213,75
Tulsa,State House,Karen Gaddis,DEM,720096,0,0,220,220,75
Tulsa,Governor,Chris Powell,LIB,720097,0,0,29,29,
Tulsa,Governor,Kevin Stitt,REP,720097,0,0,273,273,
Tulsa,Governor,Drew Edmondson,DEM,720097,0,0,388,388,
Tulsa,Lieutenant Governor,Matt Pinnell,REP,720097,0,0,313,313,
Tulsa,Lieutenant Governor,Anastasia Pittman,DEM,720097,0,0,343,343,
Tulsa,Lieutenant Governor,Ivan Holmes,IND,720097,0,0,29,29,
Tulsa,State Auditor,John Yeutter,LIB,720097,0,0,225,225,
Tulsa,State Auditor,Cindy Byrd,REP,720097,0,0,381,381,
Tulsa,Attorney General,Mike Hunter,REP,720097,0,0,336,336,
Tulsa,Attorney General,Mark Myles,DEM,720097,0,0,350,350,
Tulsa,State Treasurer,Randy Mcdaniel,REP,720097,0,0,334,334,
Tulsa,State Treasurer,Charles De Coune,IND,720097,0,0,281,281,
Tulsa,Superintendent of Public Instruction,Joy Hofmeister,REP,720097,0,0,286,286,
Tulsa,Superintendent of Public Instruction,John Cox,DEM,720097,0,0,329,329,
Tulsa,Superintendent of Public Instruction,Larry Huff,IND,720097,0,0,68,68,
Tulsa,Commissioner of Labor,Leslie Osborn,REP,720097,0,0,311,311,
Tulsa,Commissioner of Labor,Fred Dorrell,DEM,720097,0,0,327,327,
Tulsa,Commissioner of Labor,Brandt Dismukes,IND,720097,0,0,44,44,
Tulsa,Insurance Commissioner,Glen Mulready,REP,720097,0,0,320,320,
Tulsa,Insurance Commissioner,Kimberly Fobbs,DEM,720097,0,0,358,358,
Tulsa,Corporation Commissioner,Bob Anthony,REP,720097,0,0,311,311,
Tulsa,Corporation Commissioner,Ashley Nicole Mccray,DEM,720097,0,0,335,335,
Tulsa,Corporation Commissioner,Jackie Short,IND,720097,0,0,36,36,
Tulsa,U.S. House,Kevin Hern,REP,720097,0,0,311,311,1
Tulsa,U.S. House,Tim Gilpin,DEM,720097,0,0,377,377,1
Tulsa,State House,Terry O'Donnell,REP,720097,0,0,313,313,23
Tulsa,State House,Craig John Hoxie,DEM,720097,0,0,369,369,23
Tulsa,Governor,Chris Powell,LIB,720098,0,0,18,18,
Tulsa,Governor,Kevin Stitt,REP,720098,0,0,198,198,
Tulsa,Governor,Drew Edmondson,DEM,720098,0,0,251,251,
Tulsa,Lieutenant Governor,Matt Pinnell,REP,720098,0,0,225,225,
Tulsa,Lieutenant Governor,Anastasia Pittman,DEM,720098,0,0,220,220,
Tulsa,Lieutenant Governor,Ivan Holmes,IND,720098,0,0,19,19,
Tulsa,State Auditor,John Yeutter,LIB,720098,0,0,179,179,
Tulsa,State Auditor,Cindy Byrd,REP,720098,0,0,248,248,
Tulsa,Attorney General,Mike Hunter,REP,720098,0,0,232,232,
Tulsa,Attorney General,Mark Myles,DEM,720098,0,0,230,230,
Tulsa,State Treasurer,Randy Mcdaniel,REP,720098,0,0,230,230,
Tulsa,State Treasurer,Charles De Coune,IND,720098,0,0,190,190,
Tulsa,Superintendent of Public Instruction,Joy Hofmeister,REP,720098,0,0,213,213,
Tulsa,Superintendent of Public Instruction,John Cox,DEM,720098,0,0,212,212,
Tulsa,Superintendent of Public Instruction,Larry Huff,IND,720098,0,0,36,36,
Tulsa,Commissioner of Labor,Leslie Osborn,REP,720098,0,0,212,212,
Tulsa,Commissioner of Labor,Fred Dorrell,DEM,720098,0,0,230,230,
Tulsa,Commissioner of Labor,Brandt Dismukes,IND,720098,0,0,17,17,
Tulsa,Insurance Commissioner,Glen Mulready,REP,720098,0,0,221,221,
Tulsa,Insurance Commissioner,Kimberly Fobbs,DEM,720098,0,0,232,232,
Tulsa,Corporation Commissioner,Bob Anthony,REP,720098,0,0,220,220,
Tulsa,Corporation Commissioner,Ashley Nicole Mccray,DEM,720098,0,0,215,215,
Tulsa,Corporation Commissioner,Jackie Short,IND,720098,0,0,25,25,
Tulsa,U.S. House,Kevin Hern,REP,720098,0,0,225,225,1
Tulsa,U.S. House,Tim Gilpin,DEM,720098,0,0,239,239,1
Tulsa,State Senate,John Haste,REP,720098,0,0,217,217,36
Tulsa,State Senate,Bryan O'Brien,DEM,720098,0,0,242,242,36
Tulsa,State House,Terry O'Donnell,REP,720098,0,0,219,219,23
Tulsa,State House,Craig John Hoxie,DEM,720098,0,0,237,237,23
Tulsa,Governor,Chris Powell,LIB,720099,0,0,11,11,
Tulsa,Governor,Kevin Stitt,REP,720099,0,0,146,146,
Tulsa,Governor,Drew Edmondson,DEM,720099,0,0,201,201,
Tulsa,Lieutenant Governor,Matt Pinnell,REP,720099,0,0,161,161,
Tulsa,Lieutenant Governor,Anastasia Pittman,DEM,720099,0,0,184,184,
Tulsa,Lieutenant Governor,Ivan Holmes,IND,720099,0,0,13,13,
Tulsa,State Auditor,John Yeutter,LIB,720099,0,0,131,131,
Tulsa,State Auditor,Cindy Byrd,REP,720099,0,0,185,185,
Tulsa,Attorney General,Mike Hunter,REP,720099,0,0,155,155,
Tulsa,Attorney General,Mark Myles,DEM,720099,0,0,198,198,
Tulsa,State Treasurer,Randy Mcdaniel,REP,720099,0,0,167,167,
Tulsa,State Treasurer,Charles De Coune,IND,720099,0,0,150,150,
Tulsa,Superintendent of Public Instruction,Joy Hofmeister,REP,720099,0,0,153,153,
Tulsa,Superintendent of Public Instruction,John Cox,DEM,720099,0,0,175,175,
Tulsa,Superintendent of Public Instruction,Larry Huff,IND,720099,0,0,28,28,
Tulsa,Commissioner of Labor,Leslie Osborn,REP,720099,0,0,156,156,
Tulsa,Commissioner of Labor,Fred Dorrell,DEM,720099,0,0,187,187,
Tulsa,Commissioner of Labor,Brandt Dismukes,IND,720099,0,0,11,11,
Tulsa,Insurance Commissioner,Glen Mulready,REP,720099,0,0,158,158,
Tulsa,Insurance Commissioner,Kimberly Fobbs,DEM,720099,0,0,198,198,
Tulsa,Corporation Commissioner,Bob Anthony,REP,720099,0,0,153,153,
Tulsa,Corporation Commissioner,Ashley Nicole Mccray,DEM,720099,0,0,185,185,
Tulsa,Corporation Commissioner,Jackie Short,IND,720099,0,0,14,14,
Tulsa,U.S. House,Kevin Hern,REP,720099,0,0,156,156,1
Tulsa,U.S. House,Tim Gilpin,DEM,720099,0,0,200,200,1
Tulsa,State Senate,John Haste,REP,720099,0,0,155,155,36
Tulsa,State Senate,Bryan O'Brien,DEM,720099,0,0,198,198,36
Tulsa,State House,Terry O'Donnell,REP,720099,0,0,154,154,23
Tulsa,State House,Craig John Hoxie,DEM,720099,0,0,200,200,23
Tulsa,Governor,Chris Powell,LIB,720100,0,0,11,11,
Tulsa,Governor,Kevin Stitt,REP,720100,0,0,92,92,
Tulsa,Governor,Drew Edmondson,DEM,720100,0,0,113,113,
Tulsa,Lieutenant Governor,Matt Pinnell,REP,720100,0,0,113,113,
Tulsa,Lieutenant Governor,Anastasia Pittman,DEM,720100,0,0,89,89,
Tulsa,Lieutenant Governor,Ivan Holmes,IND,720100,0,0,13,13,
Tulsa,State Auditor,John Yeutter,LIB,720100,0,0,61,61,
Tulsa,State Auditor,Cindy Byrd,REP,720100,0,0,134,134,
Tulsa,Attorney General,Mike Hunter,REP,720100,0,0,120,120,
Tulsa,Attorney General,Mark Myles,DEM,720100,0,0,94,94,
Tulsa,State Treasurer,Randy Mcdaniel,REP,720100,0,0,124,124,
Tulsa,State Treasurer,Charles De Coune,IND,720100,0,0,70,70,
Tulsa,Superintendent of Public Instruction,Joy Hofmeister,REP,720100,0,0,105,105,
Tulsa,Superintendent of Public Instruction,John Cox,DEM,720100,0,0,93,93,
Tulsa,Superintendent of Public Instruction,Larry Huff,IND,720100,0,0,18,18,
Tulsa,Commissioner of Labor,Leslie Osborn,REP,720100,0,0,116,116,
Tulsa,Commissioner of Labor,Fred Dorrell,DEM,720100,0,0,90,90,
Tulsa,Commissioner of Labor,Brandt Dismukes,IND,720100,0,0,6,6,
Tulsa,Insurance Commissioner,Glen Mulready,REP,720100,0,0,117,117,
Tulsa,Insurance Commissioner,Kimberly Fobbs,DEM,720100,0,0,96,96,
Tulsa,Corporation Commissioner,Bob Anthony,REP,720100,0,0,110,110,
Tulsa,Corporation Commissioner,Ashley Nicole Mccray,DEM,720100,0,0,90,90,
Tulsa,Corporation Commissioner,Jackie Short,IND,720100,0,0,13,13,
Tulsa,U.S. House,Kevin Hern,REP,720100,0,0,113,113,1
Tulsa,U.S. House,Tim Gilpin,DEM,720100,0,0,102,102,1
Tulsa,State House,Kelli Krebs,LIB,720100,0,0,8,8,75
Tulsa,State House,T. Marti,REP,720100,0,0,101,101,75
Tulsa,State House,Karen Gaddis,DEM,720100,0,0,108,108,75
Tulsa,Governor,Chris Powell,LIB,720101,0,0,26,26,
Tulsa,Governor,Kevin Stitt,REP,720101,0,0,316,316,
Tulsa,Governor,Drew Edmondson,DEM,720101,0,0,401,401,
Tulsa,Lieutenant Governor,Matt Pinnell,REP,720101,0,0,366,366,
Tulsa,Lieutenant Governor,Anastasia Pittman,DEM,720101,0,0,346,346,
Tulsa,Lieutenant Governor,Ivan Holmes,IND,720101,0,0,31,31,
Tulsa,State Auditor,John Yeutter,LIB,720101,0,0,276,276,
Tulsa,State Auditor,Cindy Byrd,REP,720101,0,0,404,404,
Tulsa,Attorney General,Mike Hunter,REP,720101,0,0,369,369,
Tulsa,Attorney General,Mark Myles,DEM,720101,0,0,370,370,
Tulsa,State Treasurer,Randy Mcdaniel,REP,720101,0,0,368,368,
Tulsa,State Treasurer,Charles De Coune,IND,720101,0,0,307,307,
Tulsa,Superintendent of Public Instruction,Joy Hofmeister,REP,720101,0,0,341,341,
Tulsa,Superintendent of Public Instruction,John Cox,DEM,720101,0,0,339,339,
Tulsa,Superintendent of Public Instruction,Larry Huff,IND,720101,0,0,58,58,
Tulsa,Commissioner of Labor,Leslie Osborn,REP,720101,0,0,337,337,
Tulsa,Commissioner of Labor,Fred Dorrell,DEM,720101,0,0,359,359,
Tulsa,Commissioner of Labor,Brandt Dismukes,IND,720101,0,0,37,37,
Tulsa,Insurance Commissioner,Glen Mulready,REP,720101,0,0,364,364,
Tulsa,Insurance Commissioner,Kimberly Fobbs,DEM,720101,0,0,372,372,
Tulsa,Corporation Commissioner,Bob Anthony,REP,720101,0,0,341,341,
Tulsa,Corporation Commissioner,Ashley Nicole Mccray,DEM,720101,0,0,355,355,
Tulsa,Corporation Commissioner,Jackie Short,IND,720101,0,0,43,43,
Tulsa,U.S. House,Kevin Hern,REP,720101,0,0,352,352,1
Tulsa,U.S. House,Tim Gilpin,DEM,720101,0,0,388,388,1
Tulsa,State Senate,John Haste,REP,720101,0,0,347,347,36
Tulsa,State Senate,Bryan O'Brien,DEM,720101,0,0,391,391,36
Tulsa,State House,Kelli Krebs,LIB,720101,0,0,37,37,75
Tulsa,State House,T. Marti,REP,720101,0,0,332,332,75
Tulsa,State House,Karen Gaddis,DEM,720101,0,0,370,370,75
Tulsa,Governor,Chris Powell,LIB,720102,0,0,29,29,
Tulsa,Governor,Kevin Stitt,REP,720102,0,0,249,249,
Tulsa,Governor,Drew Edmondson,DEM,720102,0,0,303,303,
Tulsa,Lieutenant Governor,Matt Pinnell,REP,720102,0,0,285,285,
Tulsa,Lieutenant Governor,Anastasia Pittman,DEM,720102,0,0,270,270,
Tulsa,Lieutenant Governor,Ivan Holmes,IND,720102,0,0,24,24,
Tulsa,State Auditor,John Yeutter,LIB,720102,0,0,206,206,
Tulsa,State Auditor,Cindy Byrd,REP,720102,0,0,327,327,
Tulsa,Attorney General,Mike Hunter,REP,720102,0,0,288,288,
Tulsa,Attorney General,Mark Myles,DEM,720102,0,0,291,291,
Tulsa,State Treasurer,Randy Mcdaniel,REP,720102,0,0,291,291,
Tulsa,State Treasurer,Charles De Coune,IND,720102,0,0,243,243,
Tulsa,Superintendent of Public Instruction,Joy Hofmeister,REP,720102,0,0,273,273,
Tulsa,Superintendent of Public Instruction,John Cox,DEM,720102,0,0,262,262,
Tulsa,Superintendent of Public Instruction,Larry Huff,IND,720102,0,0,41,41,
Tulsa,Commissioner of Labor,Leslie Osborn,REP,720102,0,0,262,262,
Tulsa,Commissioner of Labor,Fred Dorrell,DEM,720102,0,0,278,278,
Tulsa,Commissioner of Labor,Brandt Dismukes,IND,720102,0,0,34,34,
Tulsa,Insurance Commissioner,Glen Mulready,REP,720102,0,0,282,282,
Tulsa,Insurance Commissioner,Kimberly Fobbs,DEM,720102,0,0,296,296,
Tulsa,Corporation Commissioner,Bob Anthony,REP,720102,0,0,268,268,
Tulsa,Corporation Commissioner,Ashley Nicole Mccray,DEM,720102,0,0,281,281,
Tulsa,Corporation Commissioner,Jackie Short,IND,720102,0,0,26,26,
Tulsa,U.S. House,Kevin Hern,REP,720102,0,0,283,283,1
Tulsa,U.S. House,Tim Gilpin,DEM,720102,0,0,298,298,1
Tulsa,State Senate,John Haste,REP,720102,0,0,276,276,36
Tulsa,State Senate,Bryan O'Brien,DEM,720102,0,0,299,299,36
Tulsa,State House,Kelli Krebs,LIB,720102,0,0,38,38,75
Tulsa,State House,T. Marti,REP,720102,0,0,246,246,75
Tulsa,State House,Karen Gaddis,DEM,720102,0,0,295,295,75
Tulsa,Governor,Chris Powell,LIB,720103,0,0,11,11,
Tulsa,Governor,Kevin Stitt,REP,720103,0,0,176,176,
Tulsa,Governor,Drew Edmondson,DEM,720103,0,0,169,169,
Tulsa,Lieutenant Governor,Matt Pinnell,REP,720103,0,0,191,191,
Tulsa,Lieutenant Governor,Anastasia Pittman,DEM,720103,0,0,146,146,
Tulsa,Lieutenant Governor,Ivan Holmes,IND,720103,0,0,18,18,
Tulsa,State Auditor,John Yeutter,LIB,720103,0,0,112,112,
Tulsa,State Auditor,Cindy Byrd,REP,720103,0,0,212,212,
Tulsa,Attorney General,Mike Hunter,REP,720103,0,0,205,205,
Tulsa,Attorney General,Mark Myles,DEM,720103,0,0,150,150,
Tulsa,State Treasurer,Randy Mcdaniel,REP,720103,0,0,194,194,
Tulsa,State Treasurer,Charles De Coune,IND,720103,0,0,131,131,
Tulsa,Superintendent of Public Instruction,Joy Hofmeister,REP,720103,0,0,177,177,
Tulsa,Superintendent of Public Instruction,John Cox,DEM,720103,0,0,144,144,
Tulsa,Superintendent of Public Instruction,Larry Huff,IND,720103,0,0,33,33,
Tulsa,Commissioner of Labor,Leslie Osborn,REP,720103,0,0,188,188,
Tulsa,Commissioner of Labor,Fred Dorrell,DEM,720103,0,0,138,138,
Tulsa,Commissioner of Labor,Brandt Dismukes,IND,720103,0,0,29,29,
Tulsa,Insurance Commissioner,Glen Mulready,REP,720103,0,0,187,187,
Tulsa,Insurance Commissioner,Kimberly Fobbs,DEM,720103,0,0,167,167,
Tulsa,Corporation Commissioner,Bob Anthony,REP,720103,0,0,177,177,
Tulsa,Corporation Commissioner,Ashley Nicole Mccray,DEM,720103,0,0,155,155,
Tulsa,Corporation Commissioner,Jackie Short,IND,720103,0,0,21,21,
Tulsa,U.S. House,Kevin Hern,REP,720103,0,0,192,192,1
Tulsa,U.S. House,Tim Gilpin,DEM,720103,0,0,163,163,1
Tulsa,State Senate,John Haste,REP,720103,0,0,184,184,36
Tulsa,State Senate,Bryan O'Brien,DEM,720103,0,0,170,170,36
Tulsa,State House,Kelli Krebs,LIB,720103,0,0,18,18,75
Tulsa,State House,T. Marti,REP,720103,0,0,181,181,75
Tulsa,State House,Karen Gaddis,DEM,720103,0,0,156,156,75
Tulsa,Governor,Chris Powell,LIB,720104,0,0,9,9,
Tulsa,Governor,Kevin Stitt,REP,720104,0,0,197,197,
Tulsa,Governor,Drew Edmondson,DEM,720104,0,0,252,252,
Tulsa,Lieutenant Governor,Matt Pinnell,REP,720104,0,0,217,217,
Tulsa,Lieutenant Governor,Anastasia Pittman,DEM,720104,0,0,230,230,
Tulsa,Lieutenant Governor,Ivan Holmes,IND,720104,0,0,12,12,
Tulsa,State Auditor,John Yeutter,LIB,720104,0,0,142,142,
Tulsa,State Auditor,Cindy Byrd,REP,720104,0,0,262,262,
Tulsa,Attorney General,Mike Hunter,REP,720104,0,0,226,226,
Tulsa,Attorney General,Mark Myles,DEM,720104,0,0,231,231,
Tulsa,State Treasurer,Randy Mcdaniel,REP,720104,0,0,238,238,
Tulsa,State Treasurer,Charles De Coune,IND,720104,0,0,166,166,
Tulsa,Superintendent of Public Instruction,Joy Hofmeister,REP,720104,0,0,218,218,
Tulsa,Superintendent of Public Instruction,John Cox,DEM,720104,0,0,206,206,
Tulsa,Superintendent of Public Instruction,Larry Huff,IND,720104,0,0,32,32,
Tulsa,Commissioner of Labor,Leslie Osborn,REP,720104,0,0,212,212,
Tulsa,Commissioner of Labor,Fred Dorrell,DEM,720104,0,0,229,229,
Tulsa,Commissioner of Labor,Brandt Dismukes,IND,720104,0,0,13,13,
Tulsa,Insurance Commissioner,Glen Mulready,REP,720104,0,0,217,217,
Tulsa,Insurance Commissioner,Kimberly Fobbs,DEM,720104,0,0,237,237,
Tulsa,Corporation Commissioner,Bob Anthony,REP,720104,0,0,210,210,
Tulsa,Corporation Commissioner,Ashley Nicole Mccray,DEM,720104,0,0,229,229,
Tulsa,Corporation Commissioner,Jackie Short,IND,720104,0,0,18,18,
Tulsa,U.S. House,Kevin Hern,REP,720104,0,0,215,215,1
Tulsa,U.S. House,Tim Gilpin,DEM,720104,0,0,244,244,1
Tulsa,State Senate,John Haste,REP,720104,0,0,212,212,36
Tulsa,State Senate,Bryan O'Brien,DEM,720104,0,0,246,246,36
Tulsa,State House,Kelli Krebs,LIB,720104,0,0,16,16,75
Tulsa,State House,T. Marti,REP,720104,0,0,195,195,75
Tulsa,State House,Karen Gaddis,DEM,720104,0,0,247,247,75
Tulsa,Governor,Chris Powell,LIB,720105,0,0,20,20,
Tulsa,Governor,Kevin Stitt,REP,720105,0,0,240,240,
Tulsa,Governor,Drew Edmondson,DEM,720105,0,0,348,348,
Tulsa,Lieutenant Governor,Matt Pinnell,REP,720105,0,0,269,269,
Tulsa,Lieutenant Governor,Anastasia Pittman,DEM,720105,0,0,311,311,
Tulsa,Lieutenant Governor,Ivan Holmes,IND,720105,0,0,26,26,
Tulsa,State Auditor,John Yeutter,LIB,720105,0,0,214,214,
Tulsa,State Auditor,Cindy Byrd,REP,720105,0,0,329,329,
Tulsa,Attorney General,Mike Hunter,REP,720105,0,0,290,290,
Tulsa,Attorney General,Mark Myles,DEM,720105,0,0,312,312,
Tulsa,State Treasurer,Randy Mcdaniel,REP,720105,0,0,300,300,
Tulsa,State Treasurer,Charles De Coune,IND,720105,0,0,241,241,
Tulsa,Superintendent of Public Instruction,Joy Hofmeister,REP,720105,0,0,270,270,
Tulsa,Superintendent of Public Instruction,John Cox,DEM,720105,0,0,290,290,
Tulsa,Superintendent of Public Instruction,Larry Huff,IND,720105,0,0,42,42,
Tulsa,Commissioner of Labor,Leslie Osborn,REP,720105,0,0,269,269,
Tulsa,Commissioner of Labor,Fred Dorrell,DEM,720105,0,0,297,297,
Tulsa,Commissioner of Labor,Brandt Dismukes,IND,720105,0,0,36,36,
Tulsa,Insurance Commissioner,Glen Mulready,REP,720105,0,0,270,270,
Tulsa,Insurance Commissioner,Kimberly Fobbs,DEM,720105,0,0,329,329,
Tulsa,Corporation Commissioner,Bob Anthony,REP,720105,0,0,271,271,
Tulsa,Corporation Commissioner,Ashley Nicole Mccray,DEM,720105,0,0,292,292,
Tulsa,Corporation Commissioner,Jackie Short,IND,720105,0,0,39,39,
Tulsa,U.S. House,Kevin Hern,REP,720105,0,0,277,277,1
Tulsa,U.S. House,Tim Gilpin,DEM,720105,0,0,330,330,1
Tulsa,State Senate,John Haste,REP,720105,0,0,274,274,36
Tulsa,State Senate,Bryan O'Brien,DEM,720105,0,0,332,332,36
Tulsa,State House,Kelli Krebs,LIB,720105,0,0,25,25,75
Tulsa,State House,T. Marti,REP,720105,0,0,262,262,75
Tulsa,State House,Karen Gaddis,DEM,720105,0,0,322,322,75
Tulsa,Governor,Chris Powell,LIB,720106,0,0,19,19,
Tulsa,Governor,Kevin Stitt,REP,720106,0,0,201,201,
Tulsa,Governor,Drew Edmondson,DEM,720106,0,0,251,251,
Tulsa,Lieutenant Governor,Matt Pinnell,REP,720106,0,0,211,211,
Tulsa,Lieutenant Governor,Anastasia Pittman,DEM,720106,0,0,230,230,
Tulsa,Lieutenant Governor,Ivan Holmes,IND,720106,0,0,24,24,
Tulsa,State Auditor,John Yeutter,LIB,720106,0,0,164,164,
Tulsa,State Auditor,Cindy Byrd,REP,720106,0,0,257,257,
Tulsa,Attorney General,Mike Hunter,REP,720106,0,0,222,222,
Tulsa,Attorney General,Mark Myles,DEM,720106,0,0,242,242,
Tulsa,State Treasurer,Randy Mcdaniel,REP,720106,0,0,236,236,
Tulsa,State Treasurer,Charles De Coune,IND,720106,0,0,188,188,
Tulsa,Superintendent of Public Instruction,Joy Hofmeister,REP,720106,0,0,216,216,
Tulsa,Superintendent of Public Instruction,John Cox,DEM,720106,0,0,214,214,
Tulsa,Superintendent of Public Instruction,Larry Huff,IND,720106,0,0,33,33,
Tulsa,Commissioner of Labor,Leslie Osborn,REP,720106,0,0,207,207,
Tulsa,Commissioner of Labor,Fred Dorrell,DEM,720106,0,0,223,223,
Tulsa,Commissioner of Labor,Brandt Dismukes,IND,720106,0,0,29,29,
Tulsa,Insurance Commissioner,Glen Mulready,REP,720106,0,0,224,224,
Tulsa,Insurance Commissioner,Kimberly Fobbs,DEM,720106,0,0,236,236,
Tulsa,Corporation Commissioner,Bob Anthony,REP,720106,0,0,205,205,
Tulsa,Corporation Commissioner,Ashley Nicole Mccray,DEM,720106,0,0,227,227,
Tulsa,Corporation Commissioner,Jackie Short,IND,720106,0,0,32,32,
Tulsa,U.S. House,Kevin Hern,REP,720106,0,0,220,220,1
Tulsa,U.S. House,Tim Gilpin,DEM,720106,0,0,248,248,1
Tulsa,State Senate,John Haste,REP,720106,0,0,222,222,36
Tulsa,State Senate,Bryan O'Brien,DEM,720106,0,0,240,240,36
Tulsa,State House,Kelli Krebs,LIB,720106,0,0,28,28,75
Tulsa,State House,T. Marti,REP,720106,0,0,189,189,75
Tulsa,State House,Karen Gaddis,DEM,720106,0,0,246,246,75
Tulsa,Governor,Chris Powell,LIB,720107,0,0,23,23,
Tulsa,Governor,Kevin Stitt,REP,720107,0,0,299,299,
Tulsa,Governor,Drew Edmondson,DEM,720107,0,0,493,493,
Tulsa,Lieutenant Governor,Matt Pinnell,REP,720107,0,0,368,368,
Tulsa,Lieutenant Governor,Anastasia Pittman,DEM,720107,0,0,412,412,
Tulsa,Lieutenant Governor,Ivan Holmes,IND,720107,0,0,29,29,
Tulsa,State Auditor,John Yeutter,LIB,720107,0,0,275,275,
Tulsa,State Auditor,Cindy Byrd,REP,720107,0,0,436,436,
Tulsa,Attorney General,Mike Hunter,REP,720107,0,0,372,372,
Tulsa,Attorney General,Mark Myles,DEM,720107,0,0,433,433,
Tulsa,State Treasurer,Randy Mcdaniel,REP,720107,0,0,402,402,
Tulsa,State Treasurer,Charles De Coune,IND,720107,0,0,300,300,
Tulsa,Superintendent of Public Instruction,Joy Hofmeister,REP,720107,0,0,380,380,
Tulsa,Superintendent of Public Instruction,John Cox,DEM,720107,0,0,383,383,
Tulsa,Superintendent of Public Instruction,Larry Huff,IND,720107,0,0,48,48,
Tulsa,Commissioner of Labor,Leslie Osborn,REP,720107,0,0,350,350,
Tulsa,Commissioner of Labor,Fred Dorrell,DEM,720107,0,0,412,412,
Tulsa,Commissioner of Labor,Brandt Dismukes,IND,720107,0,0,38,38,
Tulsa,Insurance Commissioner,Glen Mulready,REP,720107,0,0,371,371,
Tulsa,Insurance Commissioner,Kimberly Fobbs,DEM,720107,0,0,436,436,
Tulsa,Corporation Commissioner,Bob Anthony,REP,720107,0,0,373,373,
Tulsa,Corporation Commissioner,Ashley Nicole Mccray,DEM,720107,0,0,388,388,
Tulsa,Corporation Commissioner,Jackie Short,IND,720107,0,0,40,40,
Tulsa,U.S. House,Kevin Hern,REP,720107,0,0,347,347,1
Tulsa,U.S. House,Tim Gilpin,DEM,720107,0,0,467,467,1
Tulsa,State House,Cheryl Baber,REP,720107,0,0,348,348,71
Tulsa,State House,Denise Brewer,DEM,720107,0,0,457,457,71
Tulsa,Governor,Chris Powell,LIB,720108,0,0,23,23,
Tulsa,Governor,Kevin Stitt,REP,720108,0,0,196,196,
Tulsa,Governor,Drew Edmondson,DEM,720108,0,0,274,274,
Tulsa,Lieutenant Governor,Matt Pinnell,REP,720108,0,0,231,231,
Tulsa,Lieutenant Governor,Anastasia Pittman,DEM,720108,0,0,237,237,
Tulsa,Lieutenant Governor,Ivan Holmes,IND,720108,0,0,24,24,
Tulsa,State Auditor,John Yeutter,LIB,720108,0,0,159,159,
Tulsa,State Auditor,Cindy Byrd,REP,720108,0,0,278,278,
Tulsa,Attorney General,Mike Hunter,REP,720108,0,0,240,240,
Tulsa,Attorney General,Mark Myles,DEM,720108,0,0,243,243,
Tulsa,State Treasurer,Randy Mcdaniel,REP,720108,0,0,245,245,
Tulsa,State Treasurer,Charles De Coune,IND,720108,0,0,187,187,
Tulsa,Superintendent of Public Instruction,Joy Hofmeister,REP,720108,0,0,239,239,
Tulsa,Superintendent of Public Instruction,John Cox,DEM,720108,0,0,215,215,
Tulsa,Superintendent of Public Instruction,Larry Huff,IND,720108,0,0,35,35,
Tulsa,Commissioner of Labor,Leslie Osborn,REP,720108,0,0,230,230,
Tulsa,Commissioner of Labor,Fred Dorrell,DEM,720108,0,0,225,225,
Tulsa,Commissioner of Labor,Brandt Dismukes,IND,720108,0,0,25,25,
Tulsa,Insurance Commissioner,Glen Mulready,REP,720108,0,0,236,236,
Tulsa,Insurance Commissioner,Kimberly Fobbs,DEM,720108,0,0,241,241,
Tulsa,Corporation Commissioner,Bob Anthony,REP,720108,0,0,226,226,
Tulsa,Corporation Commissioner,Ashley Nicole Mccray,DEM,720108,0,0,228,228,
Tulsa,Corporation Commissioner,Jackie Short,IND,720108,0,0,25,25,
Tulsa,U.S. House,Kevin Hern,REP,720108,0,0,225,225,1
Tulsa,U.S. House,Tim Gilpin,DEM,720108,0,0,263,263,1
Tulsa,State House,Cheryl Baber,REP,720108,0,0,227,227,71
Tulsa,State House,Denise Brewer,DEM,720108,0,0,258,258,71
Tulsa,Governor,Chris Powell,LIB,720109,0,0,16,16,
Tulsa,Governor,Kevin Stitt,REP,720109,0,0,145,145,
Tulsa,Governor,Drew Edmondson,DEM,720109,0,0,244,244,
Tulsa,Lieutenant Governor,Matt Pinnell,REP,720109,0,0,167,167,
Tulsa,Lieutenant Governor,Anastasia Pittman,DEM,720109,0,0,224,224,
Tulsa,Lieutenant Governor,Ivan Holmes,IND,720109,0,0,11,11,
Tulsa,State Auditor,John Yeutter,LIB,720109,0,0,148,148,
Tulsa,State Auditor,Cindy Byrd,REP,720109,0,0,201,201,
Tulsa,Attorney General,Mike Hunter,REP,720109,0,0,173,173,
Tulsa,Attorney General,Mark Myles,DEM,720109,0,0,227,227,
Tulsa,State Treasurer,Randy Mcdaniel,REP,720109,0,0,188,188,
Tulsa,State Treasurer,Charles De Coune,IND,720109,0,0,169,169,
Tulsa,Superintendent of Public Instruction,Joy Hofmeister,REP,720109,0,0,171,171,
Tulsa,Superintendent of Public Instruction,John Cox,DEM,720109,0,0,206,206,
Tulsa,Superintendent of Public Instruction,Larry Huff,IND,720109,0,0,23,23,
Tulsa,Commissioner of Labor,Leslie Osborn,REP,720109,0,0,155,155,
Tulsa,Commissioner of Labor,Fred Dorrell,DEM,720109,0,0,217,217,
Tulsa,Commissioner of Labor,Brandt Dismukes,IND,720109,0,0,23,23,
Tulsa,Insurance Commissioner,Glen Mulready,REP,720109,0,0,167,167,
Tulsa,Insurance Commissioner,Kimberly Fobbs,DEM,720109,0,0,229,229,
Tulsa,Corporation Commissioner,Bob Anthony,REP,720109,0,0,165,165,
Tulsa,Corporation Commissioner,Ashley Nicole Mccray,DEM,720109,0,0,210,210,
Tulsa,Corporation Commissioner,Jackie Short,IND,720109,0,0,25,25,
Tulsa,U.S. House,Kevin Hern,REP,720109,0,0,161,161,1
Tulsa,U.S. House,Tim Gilpin,DEM,720109,0,0,239,239,1
Tulsa,State House,Cheryl Baber,REP,720109,0,0,161,161,71
Tulsa,State House,Denise Brewer,DEM,720109,0,0,238,238,71
Tulsa,Governor,Chris Powell,LIB,720110,0,0,22,22,
Tulsa,Governor,Kevin Stitt,REP,720110,0,0,222,222,
Tulsa,Governor,Drew Edmondson,DEM,720110,0,0,314,314,
Tulsa,Lieutenant Governor,Matt Pinnell,REP,720110,0,0,235,235,
Tulsa,Lieutenant Governor,Anastasia Pittman,DEM,720110,0,0,296,296,
Tulsa,Lieutenant Governor,Ivan Holmes,IND,720110,0,0,23,23,
Tulsa,State Auditor,John Yeutter,LIB,720110,0,0,197,197,
Tulsa,State Auditor,Cindy Byrd,REP,720110,0,0,289,289,
Tulsa,Attorney General,Mike Hunter,REP,720110,0,0,241,241,
Tulsa,Attorney General,Mark Myles,DEM,720110,0,0,309,309,
Tulsa,State Treasurer,Randy Mcdaniel,REP,720110,0,0,262,262,
Tulsa,State Treasurer,Charles De Coune,IND,720110,0,0,222,222,
Tulsa,Superintendent of Public Instruction,Joy Hofmeister,REP,720110,0,0,232,232,
Tulsa,Superintendent of Public Instruction,John Cox,DEM,720110,0,0,271,271,
Tulsa,Superintendent of Public Instruction,Larry Huff,IND,720110,0,0,51,51,
Tulsa,Commissioner of Labor,Leslie Osborn,REP,720110,0,0,223,223,
Tulsa,Commissioner of Labor,Fred Dorrell,DEM,720110,0,0,293,293,
Tulsa,Commissioner of Labor,Brandt Dismukes,IND,720110,0,0,32,32,
Tulsa,Insurance Commissioner,Glen Mulready,REP,720110,0,0,227,227,
Tulsa,Insurance Commissioner,Kimberly Fobbs,DEM,720110,0,0,322,322,
Tulsa,Corporation Commissioner,Bob Anthony,REP,720110,0,0,229,229,
Tulsa,Corporation Commissioner,Ashley Nicole Mccray,DEM,720110,0,0,289,289,
Tulsa,Corporation Commissioner,Jackie Short,IND,720110,0,0,35,35,
Tulsa,U.S. House,Kevin Hern,REP,720110,0,0,242,242,1
Tulsa,U.S. House,Tim Gilpin,DEM,720110,0,0,314,314,1
Tulsa,State House,Cheryl Baber,REP,720110,0,0,238,238,71
Tulsa,State House,Denise Brewer,DEM,720110,0,0,314,314,71
Tulsa,Governor,Chris Powell,LIB,720111,0,0,12,12,
Tulsa,Governor,Kevin Stitt,REP,720111,0,0,157,157,
Tulsa,Governor,Drew Edmondson,DEM,720111,0,0,275,275,
Tulsa,Lieutenant Governor,Matt Pinnell,REP,720111,0,0,175,175,
Tulsa,Lieutenant Governor,Anastasia Pittman,DEM,720111,0,0,250,250,
Tulsa,Lieutenant Governor,Ivan Holmes,IND,720111,0,0,18,18,
Tulsa,State Auditor,John Yeutter,LIB,720111,0,0,179,179,
Tulsa,State Auditor,Cindy Byrd,REP,720111,0,0,219,219,
Tulsa,Attorney General,Mike Hunter,REP,720111,0,0,198,198,
Tulsa,Attorney General,Mark Myles,DEM,720111,0,0,242,242,
Tulsa,State Treasurer,Randy Mcdaniel,REP,720111,0,0,206,206,
Tulsa,State Treasurer,Charles De Coune,IND,720111,0,0,194,194,
Tulsa,Superintendent of Public Instruction,Joy Hofmeister,REP,720111,0,0,194,194,
Tulsa,Superintendent of Public Instruction,John Cox,DEM,720111,0,0,218,218,
Tulsa,Superintendent of Public Instruction,Larry Huff,IND,720111,0,0,28,28,
Tulsa,Commissioner of Labor,Leslie Osborn,REP,720111,0,0,177,177,
Tulsa,Commissioner of Labor,Fred Dorrell,DEM,720111,0,0,234,234,
Tulsa,Commissioner of Labor,Brandt Dismukes,IND,720111,0,0,23,23,
Tulsa,Insurance Commissioner,Glen Mulready,REP,720111,0,0,182,182,
Tulsa,Insurance Commissioner,Kimberly Fobbs,DEM,720111,0,0,254,254,
Tulsa,Corporation Commissioner,Bob Anthony,REP,720111,0,0,191,191,
Tulsa,Corporation Commissioner,Ashley Nicole Mccray,DEM,720111,0,0,222,222,
Tulsa,Corporation Commissioner,Jackie Short,IND,720111,0,0,26,26,
Tulsa,U.S. House,Kevin Hern,REP,720111,0,0,176,176,1
Tulsa,U.S. House,Tim Gilpin,DEM,720111,0,0,268,268,1
Tulsa,State House,Cheryl Baber,REP,720111,0,0,186,186,71
Tulsa,State House,Denise Brewer,DEM,720111,0,0,255,255,71
Tulsa,Governor,Chris Powell,LIB,720112,0,0,20,20,
Tulsa,Governor,Kevin Stitt,REP,720112,0,0,195,195,
Tulsa,Governor,Drew Edmondson,DEM,720112,0,0,291,291,
Tulsa,Lieutenant Governor,Matt Pinnell,REP,720112,0,0,211,211,
Tulsa,Lieutenant Governor,Anastasia Pittman,DEM,720112,0,0,268,268,
Tulsa,Lieutenant Governor,Ivan Holmes,IND,720112,0,0,23,23,
Tulsa,State Auditor,John Yeutter,LIB,720112,0,0,212,212,
Tulsa,State Auditor,Cindy Byrd,REP,720112,0,0,246,246,
Tulsa,Attorney General,Mike Hunter,REP,720112,0,0,223,223,
Tulsa,Attorney General,Mark Myles,DEM,720112,0,0,281,281,
Tulsa,State Treasurer,Randy Mcdaniel,REP,720112,0,0,229,229,
Tulsa,State Treasurer,Charles De Coune,IND,720112,0,0,229,229,
Tulsa,Superintendent of Public Instruction,Joy Hofmeister,REP,720112,0,0,193,193,
Tulsa,Superintendent of Public Instruction,John Cox,DEM,720112,0,0,258,258,
Tulsa,Superintendent of Public Instruction,Larry Huff,IND,720112,0,0,50,50,
Tulsa,Commissioner of Labor,Leslie Osborn,REP,720112,0,0,195,195,
Tulsa,Commissioner of Labor,Fred Dorrell,DEM,720112,0,0,262,262,
Tulsa,Commissioner of Labor,Brandt Dismukes,IND,720112,0,0,40,40,
Tulsa,Insurance Commissioner,Glen Mulready,REP,720112,0,0,214,214,
Tulsa,Insurance Commissioner,Kimberly Fobbs,DEM,720112,0,0,284,284,
Tulsa,Corporation Commissioner,Bob Anthony,REP,720112,0,0,201,201,
Tulsa,Corporation Commissioner,Ashley Nicole Mccray,DEM,720112,0,0,263,263,
Tulsa,Corporation Commissioner,Jackie Short,IND,720112,0,0,33,33,
Tulsa,U.S. House,Kevin Hern,REP,720112,0,0,211,211,1
Tulsa,U.S. House,Tim Gilpin,DEM,720112,0,0,292,292,1
Tulsa,State House,Cheryl Baber,REP,720112,0,0,207,207,71
Tulsa,State House,Denise Brewer,DEM,720112,0,0,292,292,71
Tulsa,Governor,Chris Powell,LIB,720113,0,0,23,23,
Tulsa,Governor,Kevin Stitt,REP,720113,0,0,263,263,
Tulsa,Governor,Drew Edmondson,DEM,720113,0,0,317,317,
Tulsa,Lieutenant Governor,Matt Pinnell,REP,720113,0,0,303,303,
Tulsa,Lieutenant Governor,Anastasia Pittman,DEM,720113,0,0,270,270,
Tulsa,Lieutenant Governor,Ivan Holmes,IND,720113,0,0,27,27,
Tulsa,State Auditor,John Yeutter,LIB,720113,0,0,187,187,
Tulsa,State Auditor,Cindy Byrd,REP,720113,0,0,359,359,
Tulsa,Attorney General,Mike Hunter,REP,720113,0,0,319,319,
Tulsa,Attorney General,Mark Myles,DEM,720113,0,0,275,275,
Tulsa,State Treasurer,Randy Mcdaniel,REP,720113,0,0,306,306,
Tulsa,State Treasurer,Charles De Coune,IND,720113,0,0,234,234,
Tulsa,Superintendent of Public Instruction,Joy Hofmeister,REP,720113,0,0,297,297,
Tulsa,Superintendent of Public Instruction,John Cox,DEM,720113,0,0,257,257,
Tulsa,Superintendent of Public Instruction,Larry Huff,IND,720113,0,0,45,45,
Tulsa,Commissioner of Labor,Leslie Osborn,REP,720113,0,0,297,297,
Tulsa,Commissioner of Labor,Fred Dorrell,DEM,720113,0,0,258,258,
Tulsa,Commissioner of Labor,Brandt Dismukes,IND,720113,0,0,32,32,
Tulsa,Insurance Commissioner,Glen Mulready,REP,720113,0,0,312,312,
Tulsa,Insurance Commissioner,Kimberly Fobbs,DEM,720113,0,0,277,277,
Tulsa,Corporation Commissioner,Bob Anthony,REP,720113,0,0,297,297,
Tulsa,Corporation Commissioner,Ashley Nicole Mccray,DEM,720113,0,0,260,260,
Tulsa,Corporation Commissioner,Jackie Short,IND,720113,0,0,33,33,
Tulsa,U.S. House,Kevin Hern,REP,720113,0,0,304,304,1
Tulsa,U.S. House,Tim Gilpin,DEM,720113,0,0,295,295,1
Tulsa,State House,Sheila Dills,REP,720113,0,0,310,310,69
Tulsa,State House,Andy Richardson,DEM,720113,0,0,280,280,69
Tulsa,Governor,Chris Powell,LIB,720114,0,0,13,13,
Tulsa,Governor,Kevin Stitt,REP,720114,0,0,170,170,
Tulsa,Governor,Drew Edmondson,DEM,720114,0,0,236,236,
Tulsa,Lieutenant Governor,Matt Pinnell,REP,720114,0,0,199,199,
Tulsa,Lieutenant Governor,Anastasia Pittman,DEM,720114,0,0,206,206,
Tulsa,Lieutenant Governor,Ivan Holmes,IND,720114,0,0,10,10,
Tulsa,State Auditor,John Yeutter,LIB,720114,0,0,125,125,
Tulsa,State Auditor,Cindy Byrd,REP,720114,0,0,236,236,
Tulsa,Attorney General,Mike Hunter,REP,720114,0,0,200,200,
Tulsa,Attorney General,Mark Myles,DEM,720114,0,0,212,212,
Tulsa,State Treasurer,Randy Mcdaniel,REP,720114,0,0,205,205,
Tulsa,State Treasurer,Charles De Coune,IND,720114,0,0,148,148,
Tulsa,Superintendent of Public Instruction,Joy Hofmeister,REP,720114,0,0,188,188,
Tulsa,Superintendent of Public Instruction,John Cox,DEM,720114,0,0,192,192,
Tulsa,Superintendent of Public Instruction,Larry Huff,IND,720114,0,0,29,29,
Tulsa,Commissioner of Labor,Leslie Osborn,REP,720114,0,0,194,194,
Tulsa,Commissioner of Labor,Fred Dorrell,DEM,720114,0,0,185,185,
Tulsa,Commissioner of Labor,Brandt Dismukes,IND,720114,0,0,23,23,
Tulsa,Insurance Commissioner,Glen Mulready,REP,720114,0,0,197,197,
Tulsa,Insurance Commissioner,Kimberly Fobbs,DEM,720114,0,0,207,207,
Tulsa,Corporation Commissioner,Bob Anthony,REP,720114,0,0,192,192,
Tulsa,Corporation Commissioner,Ashley Nicole Mccray,DEM,720114,0,0,201,201,
Tulsa,Corporation Commissioner,Jackie Short,IND,720114,0,0,20,20,
Tulsa,U.S. House,Kevin Hern,REP,720114,0,0,192,192,1
Tulsa,U.S. House,Tim Gilpin,DEM,720114,0,0,224,224,1
Tulsa,State House,Carol Bush,REP,720114,0,0,204,204,70
Tulsa,State House,Jj Burnam,DEM,720114,0,0,210,210,70
Tulsa,Governor,Chris Powell,LIB,720115,0,0,4,4,
Tulsa,Governor,Kevin Stitt,REP,720115,0,0,286,286,
Tulsa,Governor,Drew Edmondson,DEM,720115,0,0,172,172,
Tulsa,Lieutenant Governor,Matt Pinnell,REP,720115,0,0,346,346,
Tulsa,Lieutenant Governor,Anastasia Pittman,DEM,720115,0,0,108,108,
Tulsa,Lieutenant Governor,Ivan Holmes,IND,720115,0,0,6,6,
Tulsa,State Auditor,John Yeutter,LIB,720115,0,0,72,72,
Tulsa,State Auditor,Cindy Byrd,REP,720115,0,0,355,355,
Tulsa,Attorney General,Mike Hunter,REP,720115,0,0,319,319,
Tulsa,Attorney General,Mark Myles,DEM,720115,0,0,138,138,
Tulsa,State Treasurer,Randy Mcdaniel,REP,720115,0,0,338,338,
Tulsa,State Treasurer,Charles De Coune,IND,720115,0,0,85,85,
Tulsa,Superintendent of Public Instruction,Joy Hofmeister,REP,720115,0,0,312,312,
Tulsa,Superintendent of Public Instruction,John Cox,DEM,720115,0,0,121,121,
Tulsa,Superintendent of Public Instruction,Larry Huff,IND,720115,0,0,22,22,
Tulsa,Commissioner of Labor,Leslie Osborn,REP,720115,0,0,317,317,
Tulsa,Commissioner of Labor,Fred Dorrell,DEM,720115,0,0,121,121,
Tulsa,Commissioner of Labor,Brandt Dismukes,IND,720115,0,0,13,13,
Tulsa,Insurance Commissioner,Glen Mulready,REP,720115,0,0,315,315,
Tulsa,Insurance Commissioner,Kimberly Fobbs,DEM,720115,0,0,136,136,
Tulsa,Corporation Commissioner,Bob Anthony,REP,720115,0,0,330,330,
Tulsa,Corporation Commissioner,Ashley Nicole Mccray,DEM,720115,0,0,117,117,
Tulsa,Corporation Commissioner,Jackie Short,IND,720115,0,0,7,7,
Tulsa,U.S. House,Kevin Hern,REP,720115,0,0,307,307,1
Tulsa,U.S. House,Tim Gilpin,DEM,720115,0,0,147,147,1
Tulsa,State House,Carol Bush,REP,720115,0,0,343,343,70
Tulsa,State House,Jj Burnam,DEM,720115,0,0,114,114,70
Tulsa,Governor,Chris Powell,LIB,720116,0,0,13,13,
Tulsa,Governor,Kevin Stitt,REP,720116,0,0,400,400,
Tulsa,Governor,Drew Edmondson,DEM,720116,0,0,266,266,
Tulsa,Lieutenant Governor,Matt Pinnell,REP,720116,0,0,489,489,
Tulsa,Lieutenant Governor,Anastasia Pittman,DEM,720116,0,0,183,183,
Tulsa,Lieutenant Governor,Ivan Holmes,IND,720116,0,0,13,13,
Tulsa,State Auditor,John Yeutter,LIB,720116,0,0,99,99,
Tulsa,State Auditor,Cindy Byrd,REP,720116,0,0,533,533,
Tulsa,Attorney General,Mike Hunter,REP,720116,0,0,492,492,
Tulsa,Attorney General,Mark Myles,DEM,720116,0,0,186,186,
Tulsa,State Treasurer,Randy Mcdaniel,REP,720116,0,0,507,507,
Tulsa,State Treasurer,Charles De Coune,IND,720116,0,0,125,125,
Tulsa,Superintendent of Public Instruction,Joy Hofmeister,REP,720116,0,0,481,481,
Tulsa,Superintendent of Public Instruction,John Cox,DEM,720116,0,0,163,163,
Tulsa,Superintendent of Public Instruction,Larry Huff,IND,720116,0,0,33,33,
Tulsa,Commissioner of Labor,Leslie Osborn,REP,720116,0,0,465,465,
Tulsa,Commissioner of Labor,Fred Dorrell,DEM,720116,0,0,180,180,
Tulsa,Commissioner of Labor,Brandt Dismukes,IND,720116,0,0,21,21,
Tulsa,Insurance Commissioner,Glen Mulready,REP,720116,0,0,479,479,
Tulsa,Insurance Commissioner,Kimberly Fobbs,DEM,720116,0,0,190,190,
Tulsa,Corporation Commissioner,Bob Anthony,REP,720116,0,0,477,477,
Tulsa,Corporation Commissioner,Ashley Nicole Mccray,DEM,720116,0,0,166,166,
Tulsa,Corporation Commissioner,Jackie Short,IND,720116,0,0,29,29,
Tulsa,U.S. House,Kevin Hern,REP,720116,0,0,454,454,1
Tulsa,U.S. House,Tim Gilpin,DEM,720116,0,0,226,226,1
Tulsa,State House,Sheila Dills,REP,720116,0,0,482,482,69
Tulsa,State House,Andy Richardson,DEM,720116,0,0,197,197,69
Tulsa,Governor,Chris Powell,LIB,720117,0,0,28,28,
Tulsa,Governor,Kevin Stitt,REP,720117,0,0,816,816,
Tulsa,Governor,Drew Edmondson,DEM,720117,0,0,581,581,
Tulsa,Lieutenant Governor,Matt Pinnell,REP,720117,0,0,946,946,
Tulsa,Lieutenant Governor,Anastasia Pittman,DEM,720117,0,0,437,437,
Tulsa,Lieutenant Governor,Ivan Holmes,IND,720117,0,0,36,36,
Tulsa,State Auditor,John Yeutter,LIB,720117,0,0,249,249,
Tulsa,State Auditor,Cindy Byrd,REP,720117,0,0,1055,1055,
Tulsa,Attorney General,Mike Hunter,REP,720117,0,0,950,950,
Tulsa,Attorney General,Mark Myles,DEM,720117,0,0,451,451,
Tulsa,State Treasurer,Randy Mcdaniel,REP,720117,0,0,988,988,
Tulsa,State Treasurer,Charles De Coune,IND,720117,0,0,308,308,
Tulsa,Superintendent of Public Instruction,Joy Hofmeister,REP,720117,0,0,936,936,
Tulsa,Superintendent of Public Instruction,John Cox,DEM,720117,0,0,395,395,
Tulsa,Superintendent of Public Instruction,Larry Huff,IND,720117,0,0,78,78,
Tulsa,Commissioner of Labor,Leslie Osborn,REP,720117,0,0,895,895,
Tulsa,Commissioner of Labor,Fred Dorrell,DEM,720117,0,0,414,414,
Tulsa,Commissioner of Labor,Brandt Dismukes,IND,720117,0,0,64,64,
Tulsa,Insurance Commissioner,Glen Mulready,REP,720117,0,0,916,916,
Tulsa,Insurance Commissioner,Kimberly Fobbs,DEM,720117,0,0,469,469,
Tulsa,Corporation Commissioner,Bob Anthony,REP,720117,0,0,922,922,
Tulsa,Corporation Commissioner,Ashley Nicole Mccray,DEM,720117,0,0,410,410,
Tulsa,Corporation Commissioner,Jackie Short,IND,720117,0,0,66,66,
Tulsa,U.S. House,Kevin Hern,REP,720117,0,0,897,897,1
Tulsa,U.S. House,Tim Gilpin,DEM,720117,0,0,518,518,1
Tulsa,State House,Jeff Boatman,REP,720117,0,0,869,869,67
Tulsa,State House,Carly Hotvedt,DEM,720117,0,0,516,516,67
Tulsa,Governor,Chris Powell,LIB,720118,0,0,9,9,
Tulsa,Governor,Kevin Stitt,REP,720118,0,0,690,690,
Tulsa,Governor,Drew Edmondson,DEM,720118,0,0,404,404,
Tulsa,Lieutenant Governor,Matt Pinnell,REP,720118,0,0,767,767,
Tulsa,Lieutenant Governor,Anastasia Pittman,DEM,720118,0,0,312,312,
Tulsa,Lieutenant Governor,Ivan Holmes,IND,720118,0,0,20,20,
Tulsa,State Auditor,John Yeutter,LIB,720118,0,0,191,191,
Tulsa,State Auditor,Cindy Byrd,REP,720118,0,0,833,833,
Tulsa,Attorney General,Mike Hunter,REP,720118,0,0,771,771,
Tulsa,Attorney General,Mark Myles,DEM,720118,0,0,318,318,
Tulsa,State Treasurer,Randy Mcdaniel,REP,720118,0,0,785,785,
Tulsa,State Treasurer,Charles De Coune,IND,720118,0,0,232,232,
Tulsa,Superintendent of Public Instruction,Joy Hofmeister,REP,720118,0,0,755,755,
Tulsa,Superintendent of Public Instruction,John Cox,DEM,720118,0,0,271,271,
Tulsa,Superintendent of Public Instruction,Larry Huff,IND,720118,0,0,60,60,
Tulsa,Commissioner of Labor,Leslie Osborn,REP,720118,0,0,710,710,
Tulsa,Commissioner of Labor,Fred Dorrell,DEM,720118,0,0,308,308,
Tulsa,Commissioner of Labor,Brandt Dismukes,IND,720118,0,0,45,45,
Tulsa,Insurance Commissioner,Glen Mulready,REP,720118,0,0,752,752,
Tulsa,Insurance Commissioner,Kimberly Fobbs,DEM,720118,0,0,320,320,
Tulsa,Corporation Commissioner,Bob Anthony,REP,720118,0,0,752,752,
Tulsa,Corporation Commissioner,Ashley Nicole Mccray,DEM,720118,0,0,282,282,
Tulsa,Corporation Commissioner,Jackie Short,IND,720118,0,0,40,40,
Tulsa,U.S. House,Kevin Hern,REP,720118,0,0,754,754,1
Tulsa,U.S. House,Tim Gilpin,DEM,720118,0,0,342,342,1
Tulsa,State House,Jeff Boatman,REP,720118,0,0,721,721,67
Tulsa,State House,Carly Hotvedt,DEM,720118,0,0,356,356,67
Tulsa,Governor,Chris Powell,LIB,720119,0,0,7,7,
Tulsa,Governor,Kevin Stitt,REP,720119,0,0,449,449,
Tulsa,Governor,Drew Edmondson,DEM,720119,0,0,260,260,
Tulsa,Lieutenant Governor,Matt Pinnell,REP,720119,0,0,530,530,
Tulsa,Lieutenant Governor,Anastasia Pittman,DEM,720119,0,0,172,172,
Tulsa,Lieutenant Governor,Ivan Holmes,IND,720119,0,0,9,9,
Tulsa,State Auditor,John Yeutter,LIB,720119,0,0,103,103,
Tulsa,State Auditor,Cindy Byrd,REP,720119,0,0,549,549,
Tulsa,Attorney General,Mike Hunter,REP,720119,0,0,508,508,
Tulsa,Attorney General,Mark Myles,DEM,720119,0,0,199,199,
Tulsa,State Treasurer,Randy Mcdaniel,REP,720119,0,0,536,536,
Tulsa,State Treasurer,Charles De Coune,IND,720119,0,0,120,120,
Tulsa,Superintendent of Public Instruction,Joy Hofmeister,REP,720119,0,0,510,510,
Tulsa,Superintendent of Public Instruction,John Cox,DEM,720119,0,0,168,168,
Tulsa,Superintendent of Public Instruction,Larry Huff,IND,720119,0,0,28,28,
Tulsa,Commissioner of Labor,Leslie Osborn,REP,720119,0,0,489,489,
Tulsa,Commissioner of Labor,Fred Dorrell,DEM,720119,0,0,179,179,
Tulsa,Commissioner of Labor,Brandt Dismukes,IND,720119,0,0,17,17,
Tulsa,Insurance Commissioner,Glen Mulready,REP,720119,0,0,504,504,
Tulsa,Insurance Commissioner,Kimberly Fobbs,DEM,720119,0,0,195,195,
Tulsa,Corporation Commissioner,Bob Anthony,REP,720119,0,0,510,510,
Tulsa,Corporation Commissioner,Ashley Nicole Mccray,DEM,720119,0,0,167,167,
Tulsa,Corporation Commissioner,Jackie Short,IND,720119,0,0,23,23,
Tulsa,U.S. House,Kevin Hern,REP,720119,0,0,500,500,1
Tulsa,U.S. House,Tim Gilpin,DEM,720119,0,0,213,213,1
Tulsa,State House,Sheila Dills,REP,720119,0,0,503,503,69
Tulsa,State House,Andy Richardson,DEM,720119,0,0,202,202,69
Tulsa,Governor,Chris Powell,LIB,720120,0,0,22,22,
Tulsa,Governor,Kevin Stitt,REP,720120,0,0,240,240,
Tulsa,Governor,Drew Edmondson,DEM,720120,0,0,245,245,
Tulsa,Lieutenant Governor,Matt Pinnell,REP,720120,0,0,281,281,
Tulsa,Lieutenant Governor,Anastasia Pittman,DEM,720120,0,0,199,199,
Tulsa,Lieutenant Governor,Ivan Holmes,IND,720120,0,0,23,23,
Tulsa,State Auditor,John Yeutter,LIB,720120,0,0,141,141,
Tulsa,State Auditor,Cindy Byrd,REP,720120,0,0,310,310,
Tulsa,Attorney General,Mike Hunter,REP,720120,0,0,284,284,
Tulsa,Attorney General,Mark Myles,DEM,720120,0,0,215,215,
Tulsa,State Treasurer,Randy Mcdaniel,REP,720120,0,0,289,289,
Tulsa,State Treasurer,Charles De Coune,IND,720120,0,0,166,166,
Tulsa,Superintendent of Public Instruction,Joy Hofmeister,REP,720120,0,0,273,273,
Tulsa,Superintendent of Public Instruction,John Cox,DEM,720120,0,0,196,196,
Tulsa,Superintendent of Public Instruction,Larry Huff,IND,720120,0,0,30,30,
Tulsa,Commissioner of Labor,Leslie Osborn,REP,720120,0,0,265,265,
Tulsa,Commissioner of Labor,Fred Dorrell,DEM,720120,0,0,195,195,
Tulsa,Commissioner of Labor,Brandt Dismukes,IND,720120,0,0,29,29,
Tulsa,Insurance Commissioner,Glen Mulready,REP,720120,0,0,283,283,
Tulsa,Insurance Commissioner,Kimberly Fobbs,DEM,720120,0,0,211,211,
Tulsa,Corporation Commissioner,Bob Anthony,REP,720120,0,0,262,262,
Tulsa,Corporation Commissioner,Ashley Nicole Mccray,DEM,720120,0,0,209,209,
Tulsa,Corporation Commissioner,Jackie Short,IND,720120,0,0,24,24,
Tulsa,U.S. House,Kevin Hern,REP,720120,0,0,276,276,1
Tulsa,U.S. House,Tim Gilpin,DEM,720120,0,0,226,226,1
Tulsa,State House,Dan Hicks,REP,720120,0,0,261,261,79
Tulsa,State House,Melissa Provenzano,DEM,720120,0,0,237,237,79
Tulsa,Governor,Chris Powell,LIB,720121,0,0,27,27,
Tulsa,Governor,Kevin Stitt,REP,720121,0,0,344,344,
Tulsa,Governor,Drew Edmondson,DEM,720121,0,0,469,469,
Tulsa,Lieutenant Governor,Matt Pinnell,REP,720121,0,0,431,431,
Tulsa,Lieutenant Governor,Anastasia Pittman,DEM,720121,0,0,374,374,
Tulsa,Lieutenant Governor,Ivan Holmes,IND,720121,0,0,27,27,
Tulsa,State Auditor,John Yeutter,LIB,720121,0,0,208,208,
Tulsa,State Auditor,Cindy Byrd,REP,720121,0,0,545,545,
Tulsa,Attorney General,Mike Hunter,REP,720121,0,0,445,445,
Tulsa,Attorney General,Mark Myles,DEM,720121,0,0,377,377,
Tulsa,State Treasurer,Randy Mcdaniel,REP,720121,0,0,476,476,
Tulsa,State Treasurer,Charles De Coune,IND,720121,0,0,271,271,
Tulsa,Superintendent of Public Instruction,Joy Hofmeister,REP,720121,0,0,459,459,
Tulsa,Superintendent of Public Instruction,John Cox,DEM,720121,0,0,330,330,
Tulsa,Superintendent of Public Instruction,Larry Huff,IND,720121,0,0,38,38,
Tulsa,Commissioner of Labor,Leslie Osborn,REP,720121,0,0,422,422,
Tulsa,Commissioner of Labor,Fred Dorrell,DEM,720121,0,0,352,352,
Tulsa,Commissioner of Labor,Brandt Dismukes,IND,720121,0,0,31,31,
Tulsa,Insurance Commissioner,Glen Mulready,REP,720121,0,0,443,443,
Tulsa,Insurance Commissioner,Kimberly Fobbs,DEM,720121,0,0,371,371,
Tulsa,Corporation Commissioner,Bob Anthony,REP,720121,0,0,449,449,
Tulsa,Corporation Commissioner,Ashley Nicole Mccray,DEM,720121,0,0,335,335,
Tulsa,Corporation Commissioner,Jackie Short,IND,720121,0,0,32,32,
Tulsa,U.S. House,Kevin Hern,REP,720121,0,0,385,385,1
Tulsa,U.S. House,Tim Gilpin,DEM,720121,0,0,443,443,1
Tulsa,State House,Carol Bush,REP,720121,0,0,462,462,70
Tulsa,State House,Jj Burnam,DEM,720121,0,0,358,358,70
Tulsa,Governor,Chris Powell,LIB,720122,0,0,11,11,
Tulsa,Governor,Kevin Stitt,REP,720122,0,0,207,207,
Tulsa,Governor,Drew Edmondson,DEM,720122,0,0,167,167,
Tulsa,Lieutenant Governor,Matt Pinnell,REP,720122,0,0,248,248,
Tulsa,Lieutenant Governor,Anastasia Pittman,DEM,720122,0,0,125,125,
Tulsa,Lieutenant Governor,Ivan Holmes,IND,720122,0,0,9,9,
Tulsa,State Auditor,John Yeutter,LIB,720122,0,0,81,81,
Tulsa,State Auditor,Cindy Byrd,REP,720122,0,0,274,274,
Tulsa,Attorney General,Mike Hunter,REP,720122,0,0,241,241,
Tulsa,Attorney General,Mark Myles,DEM,720122,0,0,137,137,
Tulsa,State Treasurer,Randy Mcdaniel,REP,720122,0,0,258,258,
Tulsa,State Treasurer,Charles De Coune,IND,720122,0,0,98,98,
Tulsa,Superintendent of Public Instruction,Joy Hofmeister,REP,720122,0,0,233,233,
Tulsa,Superintendent of Public Instruction,John Cox,DEM,720122,0,0,122,122,
Tulsa,Superintendent of Public Instruction,Larry Huff,IND,720122,0,0,25,25,
Tulsa,Commissioner of Labor,Leslie Osborn,REP,720122,0,0,236,236,
Tulsa,Commissioner of Labor,Fred Dorrell,DEM,720122,0,0,123,123,
Tulsa,Commissioner of Labor,Brandt Dismukes,IND,720122,0,0,20,20,
Tulsa,Insurance Commissioner,Glen Mulready,REP,720122,0,0,247,247,
Tulsa,Insurance Commissioner,Kimberly Fobbs,DEM,720122,0,0,133,133,
Tulsa,Corporation Commissioner,Bob Anthony,REP,720122,0,0,239,239,
Tulsa,Corporation Commissioner,Ashley Nicole Mccray,DEM,720122,0,0,118,118,
Tulsa,Corporation Commissioner,Jackie Short,IND,720122,0,0,22,22,
Tulsa,U.S. House,Kevin Hern,REP,720122,0,0,226,226,1
Tulsa,U.S. House,Tim Gilpin,DEM,720122,0,0,152,152,1
Tulsa,State House,Jeff Boatman,REP,720122,0,0,224,224,67
Tulsa,State House,Carly Hotvedt,DEM,720122,0,0,152,152,67
Tulsa,Governor,Chris Powell,LIB,720123,0,0,23,23,
Tulsa,Governor,Kevin Stitt,REP,720123,0,0,464,464,
Tulsa,Governor,Drew Edmondson,DEM,720123,0,0,426,426,
Tulsa,Lieutenant Governor,Matt Pinnell,REP,720123,0,0,560,560,
Tulsa,Lieutenant Governor,Anastasia Pittman,DEM,720123,0,0,318,318,
Tulsa,Lieutenant Governor,Ivan Holmes,IND,720123,0,0,31,31,
Tulsa,State Auditor,John Yeutter,LIB,720123,0,0,206,206,
Tulsa,State Auditor,Cindy Byrd,REP,720123,0,0,634,634,
Tulsa,Attorney General,Mike Hunter,REP,720123,0,0,564,564,
Tulsa,Attorney General,Mark Myles,DEM,720123,0,0,334,334,
Tulsa,State Treasurer,Randy Mcdaniel,REP,720123,0,0,586,586,
Tulsa,State Treasurer,Charles De Coune,IND,720123,0,0,253,253,
Tulsa,Superintendent of Public Instruction,Joy Hofmeister,REP,720123,0,0,523,523,
Tulsa,Superintendent of Public Instruction,John Cox,DEM,720123,0,0,311,311,
Tulsa,Superintendent of Public Instruction,Larry Huff,IND,720123,0,0,69,69,
Tulsa,Commissioner of Labor,Leslie Osborn,REP,720123,0,0,536,536,
Tulsa,Commissioner of Labor,Fred Dorrell,DEM,720123,0,0,307,307,
Tulsa,Commissioner of Labor,Brandt Dismukes,IND,720123,0,0,47,47,
Tulsa,Insurance Commissioner,Glen Mulready,REP,720123,0,0,558,558,
Tulsa,Insurance Commissioner,Kimberly Fobbs,DEM,720123,0,0,327,327,
Tulsa,Corporation Commissioner,Bob Anthony,REP,720123,0,0,556,556,
Tulsa,Corporation Commissioner,Ashley Nicole Mccray,DEM,720123,0,0,299,299,
Tulsa,Corporation Commissioner,Jackie Short,IND,720123,0,0,36,36,
Tulsa,U.S. House,Kevin Hern,REP,720123,0,0,520,520,1
Tulsa,U.S. House,Tim Gilpin,DEM,720123,0,0,389,389,1
Tulsa,State House,Carol Bush,REP,720123,0,0,579,579,70
Tulsa,State House,Jj Burnam,DEM,720123,0,0,321,321,70
Tulsa,Governor,Chris Powell,LIB,720124,0,0,20,20,
Tulsa,Governor,Kevin Stitt,REP,720124,0,0,441,441,
Tulsa,Governor,Drew Edmondson,DEM,720124,0,0,379,379,
Tulsa,Lieutenant Governor,Matt Pinnell,REP,720124,0,0,527,527,
Tulsa,Lieutenant Governor,Anastasia Pittman,DEM,720124,0,0,292,292,
Tulsa,Lieutenant Governor,Ivan Holmes,IND,720124,0,0,14,14,
Tulsa,State Auditor,John Yeutter,LIB,720124,0,0,180,180,
Tulsa,State Auditor,Cindy Byrd,REP,720124,0,0,581,581,
Tulsa,Attorney General,Mike Hunter,REP,720124,0,0,530,530,
Tulsa,Attorney General,Mark Myles,DEM,720124,0,0,305,305,
Tulsa,State Treasurer,Randy Mcdaniel,REP,720124,0,0,543,543,
Tulsa,State Treasurer,Charles De Coune,IND,720124,0,0,222,222,
Tulsa,Superintendent of Public Instruction,Joy Hofmeister,REP,720124,0,0,533,533,
Tulsa,Superintendent of Public Instruction,John Cox,DEM,720124,0,0,267,267,
Tulsa,Superintendent of Public Instruction,Larry Huff,IND,720124,0,0,35,35,
Tulsa,Commissioner of Labor,Leslie Osborn,REP,720124,0,0,509,509,
Tulsa,Commissioner of Labor,Fred Dorrell,DEM,720124,0,0,278,278,
Tulsa,Commissioner of Labor,Brandt Dismukes,IND,720124,0,0,33,33,
Tulsa,Insurance Commissioner,Glen Mulready,REP,720124,0,0,514,514,
Tulsa,Insurance Commissioner,Kimberly Fobbs,DEM,720124,0,0,315,315,
Tulsa,Corporation Commissioner,Bob Anthony,REP,720124,0,0,509,509,
Tulsa,Corporation Commissioner,Ashley Nicole Mccray,DEM,720124,0,0,283,283,
Tulsa,Corporation Commissioner,Jackie Short,IND,720124,0,0,40,40,
Tulsa,U.S. House,Kevin Hern,REP,720124,0,0,505,505,1
Tulsa,U.S. House,Tim Gilpin,DEM,720124,0,0,336,336,1
Tulsa,State House,Carol Bush,REP,720124,0,0,526,526,70
Tulsa,State House,Jj Burnam,DEM,720124,0,0,313,313,70
Tulsa,Governor,Chris Powell,LIB,720125,0,0,24,24,
Tulsa,Governor,Kevin Stitt,REP,720125,0,0,364,364,
Tulsa,Governor,Drew Edmondson,DEM,720125,0,0,389,389,
Tulsa,Lieutenant Governor,Matt Pinnell,REP,720125,0,0,469,469,
Tulsa,Lieutenant Governor,Anastasia Pittman,DEM,720125,0,0,281,281,
Tulsa,Lieutenant Governor,Ivan Holmes,IND,720125,0,0,21,21,
Tulsa,State Auditor,John Yeutter,LIB,720125,0,0,184,184,
Tulsa,State Auditor,Cindy Byrd,REP,720125,0,0,518,518,
Tulsa,Attorney General,Mike Hunter,REP,720125,0,0,446,446,
Tulsa,Attorney General,Mark Myles,DEM,720125,0,0,317,317,
Tulsa,State Treasurer,Randy Mcdaniel,REP,720125,0,0,464,464,
Tulsa,State Treasurer,Charles De Coune,IND,720125,0,0,236,236,
Tulsa,Superintendent of Public Instruction,Joy Hofmeister,REP,720125,0,0,437,437,
Tulsa,Superintendent of Public Instruction,John Cox,DEM,720125,0,0,278,278,
Tulsa,Superintendent of Public Instruction,Larry Huff,IND,720125,0,0,50,50,
Tulsa,Commissioner of Labor,Leslie Osborn,REP,720125,0,0,423,423,
Tulsa,Commissioner of Labor,Fred Dorrell,DEM,720125,0,0,294,294,
Tulsa,Commissioner of Labor,Brandt Dismukes,IND,720125,0,0,36,36,
Tulsa,Insurance Commissioner,Glen Mulready,REP,720125,0,0,431,431,
Tulsa,Insurance Commissioner,Kimberly Fobbs,DEM,720125,0,0,324,324,
Tulsa,Corporation Commissioner,Bob Anthony,REP,720125,0,0,440,440,
Tulsa,Corporation Commissioner,Ashley Nicole Mccray,DEM,720125,0,0,286,286,
Tulsa,Corporation Commissioner,Jackie Short,IND,720125,0,0,38,38,
Tulsa,U.S. House,Kevin Hern,REP,720125,0,0,409,409,1
Tulsa,U.S. House,Tim Gilpin,DEM,720125,0,0,361,361,1
Tulsa,State House,Dan Hicks,REP,720125,0,0,349,349,79
Tulsa,State House,Melissa Provenzano,DEM,720125,0,0,426,426,79
Tulsa,Governor,Chris Powell,LIB,720126,0,0,8,8,
Tulsa,Governor,Kevin Stitt,REP,720126,0,0,421,421,
Tulsa,Governor,Drew Edmondson,DEM,720126,0,0,326,326,
Tulsa,Lieutenant Governor,Matt Pinnell,REP,720126,0,0,466,466,
Tulsa,Lieutenant Governor,Anastasia Pittman,DEM,720126,0,0,267,267,
Tulsa,Lieutenant Governor,Ivan Holmes,IND,720126,0,0,17,17,
Tulsa,State Auditor,John Yeutter,LIB,720126,0,0,152,152,
Tulsa,State Auditor,Cindy Byrd,REP,720126,0,0,547,547,
Tulsa,Attorney General,Mike Hunter,REP,720126,0,0,474,474,
Tulsa,Attorney General,Mark Myles,DEM,720126,0,0,275,275,
Tulsa,State Treasurer,Randy Mcdaniel,REP,720126,0,0,509,509,
Tulsa,State Treasurer,Charles De Coune,IND,720126,0,0,188,188,
Tulsa,Superintendent of Public Instruction,Joy Hofmeister,REP,720126,0,0,488,488,
Tulsa,Superintendent of Public Instruction,John Cox,DEM,720126,0,0,243,243,
Tulsa,Superintendent of Public Instruction,Larry Huff,IND,720126,0,0,19,19,
Tulsa,Commissioner of Labor,Leslie Osborn,REP,720126,0,0,460,460,
Tulsa,Commissioner of Labor,Fred Dorrell,DEM,720126,0,0,251,251,
Tulsa,Commissioner of Labor,Brandt Dismukes,IND,720126,0,0,31,31,
Tulsa,Insurance Commissioner,Glen Mulready,REP,720126,0,0,465,465,
Tulsa,Insurance Commissioner,Kimberly Fobbs,DEM,720126,0,0,276,276,
Tulsa,Corporation Commissioner,Bob Anthony,REP,720126,0,0,482,482,
Tulsa,Corporation Commissioner,Ashley Nicole Mccray,DEM,720126,0,0,238,238,
Tulsa,Corporation Commissioner,Jackie Short,IND,720126,0,0,26,26,
Tulsa,U.S. House,Kevin Hern,REP,720126,0,0,456,456,1
Tulsa,U.S. House,Tim Gilpin,DEM,720126,0,0,291,291,1
Tulsa,State House,Dan Hicks,REP,720126,0,0,412,412,79
Tulsa,State House,Melissa Provenzano,DEM,720126,0,0,335,335,79
Tulsa,Governor,Chris Powell,LIB,720127,0,0,11,11,
Tulsa,Governor,Kevin Stitt,REP,720127,0,0,255,255,
Tulsa,Governor,Drew Edmondson,DEM,720127,0,0,217,217,
Tulsa,Lieutenant Governor,Matt Pinnell,REP,720127,0,0,290,290,
Tulsa,Lieutenant Governor,Anastasia Pittman,DEM,720127,0,0,172,172,
Tulsa,Lieutenant Governor,Ivan Holmes,IND,720127,0,0,20,20,
Tulsa,State Auditor,John Yeutter,LIB,720127,0,0,133,133,
Tulsa,State Auditor,Cindy Byrd,REP,720127,0,0,313,313,
Tulsa,Attorney General,Mike Hunter,REP,720127,0,0,305,305,
Tulsa,Attorney General,Mark Myles,DEM,720127,0,0,171,171,
Tulsa,State Treasurer,Randy Mcdaniel,REP,720127,0,0,313,313,
Tulsa,State Treasurer,Charles De Coune,IND,720127,0,0,127,127,
Tulsa,Superintendent of Public Instruction,Joy Hofmeister,REP,720127,0,0,293,293,
Tulsa,Superintendent of Public Instruction,John Cox,DEM,720127,0,0,163,163,
Tulsa,Superintendent of Public Instruction,Larry Huff,IND,720127,0,0,22,22,
Tulsa,Commissioner of Labor,Leslie Osborn,REP,720127,0,0,280,280,
Tulsa,Commissioner of Labor,Fred Dorrell,DEM,720127,0,0,162,162,
Tulsa,Commissioner of Labor,Brandt Dismukes,IND,720127,0,0,23,23,
Tulsa,Insurance Commissioner,Glen Mulready,REP,720127,0,0,293,293,
Tulsa,Insurance Commissioner,Kimberly Fobbs,DEM,720127,0,0,174,174,
Tulsa,Corporation Commissioner,Bob Anthony,REP,720127,0,0,291,291,
Tulsa,Corporation Commissioner,Ashley Nicole Mccray,DEM,720127,0,0,156,156,
Tulsa,Corporation Commissioner,Jackie Short,IND,720127,0,0,21,21,
Tulsa,U.S. House,Kevin Hern,REP,720127,0,0,282,282,1
Tulsa,U.S. House,Tim Gilpin,DEM,720127,0,0,197,197,1
Tulsa,State House,Dan Hicks,REP,720127,0,0,251,251,79
Tulsa,State House,Melissa Provenzano,DEM,720127,0,0,222,222,79
Tulsa,Governor,Chris Powell,LIB,720128,0,0,24,24,
Tulsa,Governor,Kevin Stitt,REP,720128,0,0,359,359,
Tulsa,Governor,Drew Edmondson,DEM,720128,0,0,389,389,
Tulsa,Lieutenant Governor,Matt Pinnell,REP,720128,0,0,414,414,
Tulsa,Lieutenant Governor,Anastasia Pittman,DEM,720128,0,0,316,316,
Tulsa,Lieutenant Governor,Ivan Holmes,IND,720128,0,0,29,29,
Tulsa,State Auditor,John Yeutter,LIB,720128,0,0,202,202,
Tulsa,State Auditor,Cindy Byrd,REP,720128,0,0,494,494,
Tulsa,Attorney General,Mike Hunter,REP,720128,0,0,419,419,
Tulsa,Attorney General,Mark Myles,DEM,720128,0,0,339,339,
Tulsa,State Treasurer,Randy Mcdaniel,REP,720128,0,0,451,451,
Tulsa,State Treasurer,Charles De Coune,IND,720128,0,0,244,244,
Tulsa,Superintendent of Public Instruction,Joy Hofmeister,REP,720128,0,0,422,422,
Tulsa,Superintendent of Public Instruction,John Cox,DEM,720128,0,0,296,296,
Tulsa,Superintendent of Public Instruction,Larry Huff,IND,720128,0,0,40,40,
Tulsa,Commissioner of Labor,Leslie Osborn,REP,720128,0,0,409,409,
Tulsa,Commissioner of Labor,Fred Dorrell,DEM,720128,0,0,303,303,
Tulsa,Commissioner of Labor,Brandt Dismukes,IND,720128,0,0,39,39,
Tulsa,Insurance Commissioner,Glen Mulready,REP,720128,0,0,425,425,
Tulsa,Insurance Commissioner,Kimberly Fobbs,DEM,720128,0,0,332,332,
Tulsa,Corporation Commissioner,Bob Anthony,REP,720128,0,0,413,413,
Tulsa,Corporation Commissioner,Ashley Nicole Mccray,DEM,720128,0,0,300,300,
Tulsa,Corporation Commissioner,Jackie Short,IND,720128,0,0,46,46,
Tulsa,U.S. House,Kevin Hern,REP,720128,0,0,404,404,1
Tulsa,U.S. House,Tim Gilpin,DEM,720128,0,0,358,358,1
Tulsa,State House,Dan Hicks,REP,720128,0,0,375,375,79
Tulsa,State House,Melissa Provenzano,DEM,720128,0,0,388,388,79
Tulsa,Governor,Chris Powell,LIB,720129,0,0,19,19,
Tulsa,Governor,Kevin Stitt,REP,720129,0,0,356,356,
Tulsa,Governor,Drew Edmondson,DEM,720129,0,0,367,367,
Tulsa,Lieutenant Governor,Matt Pinnell,REP,720129,0,0,433,433,
Tulsa,Lieutenant Governor,Anastasia Pittman,DEM,720129,0,0,280,280,
Tulsa,Lieutenant Governor,Ivan Holmes,IND,720129,0,0,21,21,
Tulsa,State Auditor,John Yeutter,LIB,720129,0,0,177,177,
Tulsa,State Auditor,Cindy Byrd,REP,720129,0,0,496,496,
Tulsa,Attorney General,Mike Hunter,REP,720129,0,0,437,437,
Tulsa,Attorney General,Mark Myles,DEM,720129,0,0,293,293,
Tulsa,State Treasurer,Randy Mcdaniel,REP,720129,0,0,457,457,
Tulsa,State Treasurer,Charles De Coune,IND,720129,0,0,205,205,
Tulsa,Superintendent of Public Instruction,Joy Hofmeister,REP,720129,0,0,427,427,
Tulsa,Superintendent of Public Instruction,John Cox,DEM,720129,0,0,251,251,
Tulsa,Superintendent of Public Instruction,Larry Huff,IND,720129,0,0,47,47,
Tulsa,Commissioner of Labor,Leslie Osborn,REP,720129,0,0,396,396,
Tulsa,Commissioner of Labor,Fred Dorrell,DEM,720129,0,0,281,281,
Tulsa,Commissioner of Labor,Brandt Dismukes,IND,720129,0,0,38,38,
Tulsa,Insurance Commissioner,Glen Mulready,REP,720129,0,0,421,421,
Tulsa,Insurance Commissioner,Kimberly Fobbs,DEM,720129,0,0,297,297,
Tulsa,Corporation Commissioner,Bob Anthony,REP,720129,0,0,418,418,
Tulsa,Corporation Commissioner,Ashley Nicole Mccray,DEM,720129,0,0,270,270,
Tulsa,Corporation Commissioner,Jackie Short,IND,720129,0,0,37,37,
Tulsa,U.S. House,Kevin Hern,REP,720129,0,0,405,405,1
Tulsa,U.S. House,Tim Gilpin,DEM,720129,0,0,328,328,1
Tulsa,State House,Dan Hicks,REP,720129,0,0,355,355,79
Tulsa,State House,Melissa Provenzano,DEM,720129,0,0,383,383,79
Tulsa,Governor,Chris Powell,LIB,720130,0,0,17,17,
Tulsa,Governor,Kevin Stitt,REP,720130,0,0,338,338,
Tulsa,Governor,Drew Edmondson,DEM,720130,0,0,400,400,
Tulsa,Lieutenant Governor,Matt Pinnell,REP,720130,0,0,407,407,
Tulsa,Lieutenant Governor,Anastasia Pittman,DEM,720130,0,0,323,323,
Tulsa,Lieutenant Governor,Ivan Holmes,IND,720130,0,0,24,24,
Tulsa,State Auditor,John Yeutter,LIB,720130,0,0,206,206,
Tulsa,State Auditor,Cindy Byrd,REP,720130,0,0,474,474,
Tulsa,Attorney General,Mike Hunter,REP,720130,0,0,412,412,
Tulsa,Attorney General,Mark Myles,DEM,720130,0,0,335,335,
Tulsa,State Treasurer,Randy Mcdaniel,REP,720130,0,0,418,418,
Tulsa,State Treasurer,Charles De Coune,IND,720130,0,0,259,259,
Tulsa,Superintendent of Public Instruction,Joy Hofmeister,REP,720130,0,0,387,387,
Tulsa,Superintendent of Public Instruction,John Cox,DEM,720130,0,0,314,314,
Tulsa,Superintendent of Public Instruction,Larry Huff,IND,720130,0,0,46,46,
Tulsa,Commissioner of Labor,Leslie Osborn,REP,720130,0,0,385,385,
Tulsa,Commissioner of Labor,Fred Dorrell,DEM,720130,0,0,318,318,
Tulsa,Commissioner of Labor,Brandt Dismukes,IND,720130,0,0,31,31,
Tulsa,Insurance Commissioner,Glen Mulready,REP,720130,0,0,399,399,
Tulsa,Insurance Commissioner,Kimberly Fobbs,DEM,720130,0,0,336,336,
Tulsa,Corporation Commissioner,Bob Anthony,REP,720130,0,0,393,393,
Tulsa,Corporation Commissioner,Ashley Nicole Mccray,DEM,720130,0,0,322,322,
Tulsa,Corporation Commissioner,Jackie Short,IND,720130,0,0,25,25,
Tulsa,U.S. House,Kevin Hern,REP,720130,0,0,383,383,1
Tulsa,U.S. House,Tim Gilpin,DEM,720130,0,0,367,367,1
Tulsa,State House,Dan Hicks,REP,720130,0,0,342,342,79
Tulsa,State House,Melissa Provenzano,DEM,720130,0,0,408,408,79
Tulsa,Governor,Chris Powell,LIB,720131,0,0,10,10,
Tulsa,Governor,Kevin Stitt,REP,720131,0,0,52,52,
Tulsa,Governor,Drew Edmondson,DEM,720131,0,0,97,97,
Tulsa,Lieutenant Governor,Matt Pinnell,REP,720131,0,0,65,65,
Tulsa,Lieutenant Governor,Anastasia Pittman,DEM,720131,0,0,89,89,
Tulsa,Lieutenant Governor,Ivan Holmes,IND,720131,0,0,4,4,
Tulsa,State Auditor,John Yeutter,LIB,720131,0,0,65,65,
Tulsa,State Auditor,Cindy Byrd,REP,720131,0,0,77,77,
Tulsa,Attorney General,Mike Hunter,REP,720131,0,0,65,65,
Tulsa,Attorney General,Mark Myles,DEM,720131,0,0,91,91,
Tulsa,State Treasurer,Randy Mcdaniel,REP,720131,0,0,69,69,
Tulsa,State Treasurer,Charles De Coune,IND,720131,0,0,73,73,
Tulsa,Superintendent of Public Instruction,Joy Hofmeister,REP,720131,0,0,60,60,
Tulsa,Superintendent of Public Instruction,John Cox,DEM,720131,0,0,80,80,
Tulsa,Superintendent of Public Instruction,Larry Huff,IND,720131,0,0,14,14,
Tulsa,Commissioner of Labor,Leslie Osborn,REP,720131,0,0,65,65,
Tulsa,Commissioner of Labor,Fred Dorrell,DEM,720131,0,0,80,80,
Tulsa,Commissioner of Labor,Brandt Dismukes,IND,720131,0,0,11,11,
Tulsa,Insurance Commissioner,Glen Mulready,REP,720131,0,0,64,64,
Tulsa,Insurance Commissioner,Kimberly Fobbs,DEM,720131,0,0,90,90,
Tulsa,Corporation Commissioner,Bob Anthony,REP,720131,0,0,62,62,
Tulsa,Corporation Commissioner,Ashley Nicole Mccray,DEM,720131,0,0,85,85,
Tulsa,Corporation Commissioner,Jackie Short,IND,720131,0,0,11,11,
Tulsa,U.S. House,Kevin Hern,REP,720131,0,0,66,66,1
Tulsa,U.S. House,Tim Gilpin,DEM,720131,0,0,91,91,1
Tulsa,State Senate,John Haste,REP,720131,0,0,63,63,36
Tulsa,State Senate,Bryan O'Brien,DEM,720131,0,0,93,93,36
Tulsa,State House,Dan Hicks,REP,720131,0,0,66,66,79
Tulsa,State House,Melissa Provenzano,DEM,720131,0,0,91,91,79
Tulsa,Governor,Chris Powell,LIB,720132,0,0,20,20,
Tulsa,Governor,Kevin Stitt,REP,720132,0,0,371,371,
Tulsa,Governor,Drew Edmondson,DEM,720132,0,0,292,292,
Tulsa,Lieutenant Governor,Matt Pinnell,REP,720132,0,0,426,426,
Tulsa,Lieutenant Governor,Anastasia Pittman,DEM,720132,0,0,230,230,
Tulsa,Lieutenant Governor,Ivan Holmes,IND,720132,0,0,24,24,
Tulsa,State Auditor,John Yeutter,LIB,720132,0,0,135,135,
Tulsa,State Auditor,Cindy Byrd,REP,720132,0,0,495,495,
Tulsa,Attorney General,Mike Hunter,REP,720132,0,0,438,438,
Tulsa,Attorney General,Mark Myles,DEM,720132,0,0,240,240,
Tulsa,State Treasurer,Randy Mcdaniel,REP,720132,0,0,441,441,
Tulsa,State Treasurer,Charles De Coune,IND,720132,0,0,190,190,
Tulsa,Superintendent of Public Instruction,Joy Hofmeister,REP,720132,0,0,415,415,
Tulsa,Superintendent of Public Instruction,John Cox,DEM,720132,0,0,220,220,
Tulsa,Superintendent of Public Instruction,Larry Huff,IND,720132,0,0,43,43,
Tulsa,Commissioner of Labor,Leslie Osborn,REP,720132,0,0,419,419,
Tulsa,Commissioner of Labor,Fred Dorrell,DEM,720132,0,0,227,227,
Tulsa,Commissioner of Labor,Brandt Dismukes,IND,720132,0,0,27,27,
Tulsa,Insurance Commissioner,Glen Mulready,REP,720132,0,0,428,428,
Tulsa,Insurance Commissioner,Kimberly Fobbs,DEM,720132,0,0,240,240,
Tulsa,Corporation Commissioner,Bob Anthony,REP,720132,0,0,423,423,
Tulsa,Corporation Commissioner,Ashley Nicole Mccray,DEM,720132,0,0,227,227,
Tulsa,Corporation Commissioner,Jackie Short,IND,720132,0,0,24,24,
Tulsa,U.S. House,Kevin Hern,REP,720132,0,0,399,399,1
Tulsa,U.S. House,Tim Gilpin,DEM,720132,0,0,283,283,1
Tulsa,State House,Dan Hicks,REP,720132,0,0,350,350,79
Tulsa,State House,Melissa Provenzano,DEM,720132,0,0,329,329,79
Tulsa,Governor,Chris Powell,LIB,720133,0,0,14,14,
Tulsa,Governor,Kevin Stitt,REP,720133,0,0,347,347,
Tulsa,Governor,Drew Edmondson,DEM,720133,0,0,366,366,
Tulsa,Lieutenant Governor,Matt Pinnell,REP,720133,0,0,402,402,
Tulsa,Lieutenant Governor,Anastasia Pittman,DEM,720133,0,0,285,285,
Tulsa,Lieutenant Governor,Ivan Holmes,IND,720133,0,0,25,25,
Tulsa,State Auditor,John Yeutter,LIB,720133,0,0,164,164,
Tulsa,State Auditor,Cindy Byrd,REP,720133,0,0,481,481,
Tulsa,Attorney General,Mike Hunter,REP,720133,0,0,420,420,
Tulsa,Attorney General,Mark Myles,DEM,720133,0,0,292,292,
Tulsa,State Treasurer,Randy Mcdaniel,REP,720133,0,0,438,438,
Tulsa,State Treasurer,Charles De Coune,IND,720133,0,0,210,210,
Tulsa,Superintendent of Public Instruction,Joy Hofmeister,REP,720133,0,0,424,424,
Tulsa,Superintendent of Public Instruction,John Cox,DEM,720133,0,0,252,252,
Tulsa,Superintendent of Public Instruction,Larry Huff,IND,720133,0,0,41,41,
Tulsa,Commissioner of Labor,Leslie Osborn,REP,720133,0,0,400,400,
Tulsa,Commissioner of Labor,Fred Dorrell,DEM,720133,0,0,266,266,
Tulsa,Commissioner of Labor,Brandt Dismukes,IND,720133,0,0,37,37,
Tulsa,Insurance Commissioner,Glen Mulready,REP,720133,0,0,402,402,
Tulsa,Insurance Commissioner,Kimberly Fobbs,DEM,720133,0,0,305,305,
Tulsa,Corporation Commissioner,Bob Anthony,REP,720133,0,0,417,417,
Tulsa,Corporation Commissioner,Ashley Nicole Mccray,DEM,720133,0,0,280,280,
Tulsa,Corporation Commissioner,Jackie Short,IND,720133,0,0,15,15,
Tulsa,U.S. House,Kevin Hern,REP,720133,0,0,399,399,1
Tulsa,U.S. House,Tim Gilpin,DEM,720133,0,0,323,323,1
Tulsa,State House,Dan Hicks,REP,720133,0,0,346,346,79
Tulsa,State House,Melissa Provenzano,DEM,720133,0,0,376,376,79
Tulsa,Governor,Chris Powell,LIB,720134,0,0,15,15,
Tulsa,Governor,Kevin Stitt,REP,720134,0,0,452,452,
Tulsa,Governor,Drew Edmondson,DEM,720134,0,0,338,338,
Tulsa,Lieutenant Governor,Matt Pinnell,REP,720134,0,0,515,515,
Tulsa,Lieutenant Governor,Anastasia Pittman,DEM,720134,0,0,265,265,
Tulsa,Lieutenant Governor,Ivan Holmes,IND,720134,0,0,20,20,
Tulsa,State Auditor,John Yeutter,LIB,720134,0,0,170,170,
Tulsa,State Auditor,Cindy Byrd,REP,720134,0,0,563,563,
Tulsa,Attorney General,Mike Hunter,REP,720134,0,0,526,526,
Tulsa,Attorney General,Mark Myles,DEM,720134,0,0,269,269,
Tulsa,State Treasurer,Randy Mcdaniel,REP,720134,0,0,531,531,
Tulsa,State Treasurer,Charles De Coune,IND,720134,0,0,203,203,
Tulsa,Superintendent of Public Instruction,Joy Hofmeister,REP,720134,0,0,493,493,
Tulsa,Superintendent of Public Instruction,John Cox,DEM,720134,0,0,250,250,
Tulsa,Superintendent of Public Instruction,Larry Huff,IND,720134,0,0,50,50,
Tulsa,Commissioner of Labor,Leslie Osborn,REP,720134,0,0,481,481,
Tulsa,Commissioner of Labor,Fred Dorrell,DEM,720134,0,0,276,276,
Tulsa,Commissioner of Labor,Brandt Dismukes,IND,720134,0,0,31,31,
Tulsa,Insurance Commissioner,Glen Mulready,REP,720134,0,0,506,506,
Tulsa,Insurance Commissioner,Kimberly Fobbs,DEM,720134,0,0,277,277,
Tulsa,Corporation Commissioner,Bob Anthony,REP,720134,0,0,506,506,
Tulsa,Corporation Commissioner,Ashley Nicole Mccray,DEM,720134,0,0,247,247,
Tulsa,Corporation Commissioner,Jackie Short,IND,720134,0,0,32,32,
Tulsa,U.S. House,Kevin Hern,REP,720134,0,0,489,489,1
Tulsa,U.S. House,Tim Gilpin,DEM,720134,0,0,304,304,1
Tulsa,State House,Jeff Boatman,REP,720134,0,0,485,485,67
Tulsa,State House,Carly Hotvedt,DEM,720134,0,0,299,299,67
Tulsa,Governor,Chris Powell,LIB,720135,0,0,23,23,
Tulsa,Governor,Kevin Stitt,REP,720135,0,0,558,558,
Tulsa,Governor,Drew Edmondson,DEM,720135,0,0,477,477,
Tulsa,Lieutenant Governor,Matt Pinnell,REP,720135,0,0,632,632,
Tulsa,Lieutenant Governor,Anastasia Pittman,DEM,720135,0,0,385,385,
Tulsa,Lieutenant Governor,Ivan Holmes,IND,720135,0,0,31,31,
Tulsa,State Auditor,John Yeutter,LIB,720135,0,0,275,275,
Tulsa,State Auditor,Cindy Byrd,REP,720135,0,0,701,701,
Tulsa,Attorney General,Mike Hunter,REP,720135,0,0,629,629,
Tulsa,Attorney General,Mark Myles,DEM,720135,0,0,414,414,
Tulsa,State Treasurer,Randy Mcdaniel,REP,720135,0,0,650,650,
Tulsa,State Treasurer,Charles De Coune,IND,720135,0,0,324,324,
Tulsa,Superintendent of Public Instruction,Joy Hofmeister,REP,720135,0,0,617,617,
Tulsa,Superintendent of Public Instruction,John Cox,DEM,720135,0,0,356,356,
Tulsa,Superintendent of Public Instruction,Larry Huff,IND,720135,0,0,71,71,
Tulsa,Commissioner of Labor,Leslie Osborn,REP,720135,0,0,597,597,
Tulsa,Commissioner of Labor,Fred Dorrell,DEM,720135,0,0,373,373,
Tulsa,Commissioner of Labor,Brandt Dismukes,IND,720135,0,0,45,45,
Tulsa,Insurance Commissioner,Glen Mulready,REP,720135,0,0,611,611,
Tulsa,Insurance Commissioner,Kimberly Fobbs,DEM,720135,0,0,408,408,
Tulsa,Corporation Commissioner,Bob Anthony,REP,720135,0,0,592,592,
Tulsa,Corporation Commissioner,Ashley Nicole Mccray,DEM,720135,0,0,380,380,
Tulsa,Corporation Commissioner,Jackie Short,IND,720135,0,0,53,53,
Tulsa,U.S. House,Kevin Hern,REP,720135,0,0,613,613,1
Tulsa,U.S. House,Tim Gilpin,DEM,720135,0,0,434,434,1
Tulsa,State House,Jeff Boatman,REP,720135,0,0,599,599,67
Tulsa,State House,Carly Hotvedt,DEM,720135,0,0,426,426,67
Tulsa,Governor,Chris Powell,LIB,720136,0,0,23,23,
Tulsa,Governor,Kevin Stitt,REP,720136,0,0,447,447,
Tulsa,Governor,Drew Edmondson,DEM,720136,0,0,292,292,
Tulsa,Lieutenant Governor,Matt Pinnell,REP,720136,0,0,520,520,
Tulsa,Lieutenant Governor,Anastasia Pittman,DEM,720136,0,0,211,211,
Tulsa,Lieutenant Governor,Ivan Holmes,IND,720136,0,0,24,24,
Tulsa,State Auditor,John Yeutter,LIB,720136,0,0,148,148,
Tulsa,State Auditor,Cindy Byrd,REP,720136,0,0,561,561,
Tulsa,Attorney General,Mike Hunter,REP,720136,0,0,533,533,
Tulsa,Attorney General,Mark Myles,DEM,720136,0,0,209,209,
Tulsa,State Treasurer,Randy Mcdaniel,REP,720136,0,0,535,535,
Tulsa,State Treasurer,Charles De Coune,IND,720136,0,0,170,170,
Tulsa,Superintendent of Public Instruction,Joy Hofmeister,REP,720136,0,0,505,505,
Tulsa,Superintendent of Public Instruction,John Cox,DEM,720136,0,0,191,191,
Tulsa,Superintendent of Public Instruction,Larry Huff,IND,720136,0,0,51,51,
Tulsa,Commissioner of Labor,Leslie Osborn,REP,720136,0,0,495,495,
Tulsa,Commissioner of Labor,Fred Dorrell,DEM,720136,0,0,202,202,
Tulsa,Commissioner of Labor,Brandt Dismukes,IND,720136,0,0,36,36,
Tulsa,Insurance Commissioner,Glen Mulready,REP,720136,0,0,506,506,
Tulsa,Insurance Commissioner,Kimberly Fobbs,DEM,720136,0,0,227,227,
Tulsa,Corporation Commissioner,Bob Anthony,REP,720136,0,0,517,517,
Tulsa,Corporation Commissioner,Ashley Nicole Mccray,DEM,720136,0,0,189,189,
Tulsa,Corporation Commissioner,Jackie Short,IND,720136,0,0,34,34,
Tulsa,U.S. House,Kevin Hern,REP,720136,0,0,509,509,1
Tulsa,U.S. House,Tim Gilpin,DEM,720136,0,0,240,240,1
Tulsa,State House,Jeff Boatman,REP,720136,0,0,485,485,67
Tulsa,State House,Carly Hotvedt,DEM,720136,0,0,248,248,67
Tulsa,Governor,Chris Powell,LIB,720137,0,0,13,13,
Tulsa,Governor,Kevin Stitt,REP,720137,0,0,197,197,
Tulsa,Governor,Drew Edmondson,DEM,720137,0,0,244,244,
Tulsa,Lieutenant Governor,Matt Pinnell,REP,720137,0,0,221,221,
Tulsa,Lieutenant Governor,Anastasia Pittman,DEM,720137,0,0,212,212,
Tulsa,Lieutenant Governor,Ivan Holmes,IND,720137,0,0,19,19,
Tulsa,State Auditor,John Yeutter,LIB,720137,0,0,154,154,
Tulsa,State Auditor,Cindy Byrd,REP,720137,0,0,251,251,
Tulsa,Attorney General,Mike Hunter,REP,720137,0,0,219,219,
Tulsa,Attorney General,Mark Myles,DEM,720137,0,0,232,232,
Tulsa,State Treasurer,Randy Mcdaniel,REP,720137,0,0,232,232,
Tulsa,State Treasurer,Charles De Coune,IND,720137,0,0,174,174,
Tulsa,Superintendent of Public Instruction,Joy Hofmeister,REP,720137,0,0,209,209,
Tulsa,Superintendent of Public Instruction,John Cox,DEM,720137,0,0,205,205,
Tulsa,Superintendent of Public Instruction,Larry Huff,IND,720137,0,0,36,36,
Tulsa,Commissioner of Labor,Leslie Osborn,REP,720137,0,0,207,207,
Tulsa,Commissioner of Labor,Fred Dorrell,DEM,720137,0,0,203,203,
Tulsa,Commissioner of Labor,Brandt Dismukes,IND,720137,0,0,35,35,
Tulsa,Insurance Commissioner,Glen Mulready,REP,720137,0,0,220,220,
Tulsa,Insurance Commissioner,Kimberly Fobbs,DEM,720137,0,0,227,227,
Tulsa,Corporation Commissioner,Bob Anthony,REP,720137,0,0,210,210,
Tulsa,Corporation Commissioner,Ashley Nicole Mccray,DEM,720137,0,0,210,210,
Tulsa,Corporation Commissioner,Jackie Short,IND,720137,0,0,28,28,
Tulsa,U.S. House,Kevin Hern,REP,720137,0,0,215,215,1
Tulsa,U.S. House,Tim Gilpin,DEM,720137,0,0,236,236,1
Tulsa,State House,Dan Hicks,REP,720137,0,0,213,213,79
Tulsa,State House,Melissa Provenzano,DEM,720137,0,0,238,238,79
Tulsa,Governor,Chris Powell,LIB,720138,0,0,2,2,
Tulsa,Governor,Kevin Stitt,REP,720138,0,0,48,48,
Tulsa,Governor,Drew Edmondson,DEM,720138,0,0,60,60,
Tulsa,Lieutenant Governor,Matt Pinnell,REP,720138,0,0,60,60,
Tulsa,Lieutenant Governor,Anastasia Pittman,DEM,720138,0,0,46,46,
Tulsa,Lieutenant Governor,Ivan Holmes,IND,720138,0,0,4,4,
Tulsa,State Auditor,John Yeutter,LIB,720138,0,0,38,38,
Tulsa,State Auditor,Cindy Byrd,REP,720138,0,0,63,63,
Tulsa,Attorney General,Mike Hunter,REP,720138,0,0,61,61,
Tulsa,Attorney General,Mark Myles,DEM,720138,0,0,49,49,
Tulsa,State Treasurer,Randy Mcdaniel,REP,720138,0,0,58,58,
Tulsa,State Treasurer,Charles De Coune,IND,720138,0,0,41,41,
Tulsa,Superintendent of Public Instruction,Joy Hofmeister,REP,720138,0,0,60,60,
Tulsa,Superintendent of Public Instruction,John Cox,DEM,720138,0,0,45,45,
Tulsa,Superintendent of Public Instruction,Larry Huff,IND,720138,0,0,5,5,
Tulsa,Commissioner of Labor,Leslie Osborn,REP,720138,0,0,53,53,
Tulsa,Commissioner of Labor,Fred Dorrell,DEM,720138,0,0,51,51,
Tulsa,Commissioner of Labor,Brandt Dismukes,IND,720138,0,0,5,5,
Tulsa,Insurance Commissioner,Glen Mulready,REP,720138,0,0,59,59,
Tulsa,Insurance Commissioner,Kimberly Fobbs,DEM,720138,0,0,51,51,
Tulsa,Corporation Commissioner,Bob Anthony,REP,720138,0,0,53,53,
Tulsa,Corporation Commissioner,Ashley Nicole Mccray,DEM,720138,0,0,50,50,
Tulsa,Corporation Commissioner,Jackie Short,IND,720138,0,0,6,6,
Tulsa,U.S. House,Kevin Hern,REP,720138,0,0,56,56,1
Tulsa,U.S. House,Tim Gilpin,DEM,720138,0,0,54,54,1
Tulsa,State House,Dan Hicks,REP,720138,0,0,55,55,79
Tulsa,State House,Melissa Provenzano,DEM,720138,0,0,54,54,79
Tulsa,Governor,Chris Powell,LIB,720139,0,0,16,16,
Tulsa,Governor,Kevin Stitt,REP,720139,0,0,106,106,
Tulsa,Governor,Drew Edmondson,DEM,720139,0,0,266,266,
Tulsa,Lieutenant Governor,Matt Pinnell,REP,720139,0,0,115,115,
Tulsa,Lieutenant Governor,Anastasia Pittman,DEM,720139,0,0,249,249,
Tulsa,Lieutenant Governor,Ivan Holmes,IND,720139,0,0,23,23,
Tulsa,State Auditor,John Yeutter,LIB,720139,0,0,189,189,
Tulsa,State Auditor,Cindy Byrd,REP,720139,0,0,145,145,
Tulsa,Attorney General,Mike Hunter,REP,720139,0,0,120,120,
Tulsa,Attorney General,Mark Myles,DEM,720139,0,0,262,262,
Tulsa,State Treasurer,Randy Mcdaniel,REP,720139,0,0,123,123,
Tulsa,State Treasurer,Charles De Coune,IND,720139,0,0,217,217,
Tulsa,Superintendent of Public Instruction,Joy Hofmeister,REP,720139,0,0,118,118,
Tulsa,Superintendent of Public Instruction,John Cox,DEM,720139,0,0,242,242,
Tulsa,Superintendent of Public Instruction,Larry Huff,IND,720139,0,0,28,28,
Tulsa,Commissioner of Labor,Leslie Osborn,REP,720139,0,0,112,112,
Tulsa,Commissioner of Labor,Fred Dorrell,DEM,720139,0,0,239,239,
Tulsa,Commissioner of Labor,Brandt Dismukes,IND,720139,0,0,31,31,
Tulsa,Insurance Commissioner,Glen Mulready,REP,720139,0,0,110,110,
Tulsa,Insurance Commissioner,Kimberly Fobbs,DEM,720139,0,0,273,273,
Tulsa,Corporation Commissioner,Bob Anthony,REP,720139,0,0,104,104,
Tulsa,Corporation Commissioner,Ashley Nicole Mccray,DEM,720139,0,0,249,249,
Tulsa,Corporation Commissioner,Jackie Short,IND,720139,0,0,33,33,
Tulsa,U.S. House,Kevin Hern,REP,720139,0,0,114,114,1
Tulsa,U.S. House,Tim Gilpin,DEM,720139,0,0,274,274,1
Tulsa,State House,J. Lee Miller Jr.,LIB,720139,0,0,17,17,68
Tulsa,State House,Lonnie Sims,REP,720139,0,0,92,92,68
Tulsa,State House,Michael Ross,DEM,720139,0,0,238,238,68
Tulsa,State House,Heather Chenoweth,IND,720139,0,0,38,38,68
Tulsa,Governor,Chris Powell,LIB,720140,0,0,14,14,
Tulsa,Governor,Kevin Stitt,REP,720140,0,0,75,75,
Tulsa,Governor,Drew Edmondson,DEM,720140,0,0,255,255,
Tulsa,Lieutenant Governor,Matt Pinnell,REP,720140,0,0,89,89,
Tulsa,Lieutenant Governor,Anastasia Pittman,DEM,720140,0,0,239,239,
Tulsa,Lieutenant Governor,Ivan Holmes,IND,720140,0,0,9,9,
Tulsa,State Auditor,John Yeutter,LIB,720140,0,0,171,171,
Tulsa,State Auditor,Cindy Byrd,REP,720140,0,0,125,125,
Tulsa,Attorney General,Mike Hunter,REP,720140,0,0,96,96,
Tulsa,Attorney General,Mark Myles,DEM,720140,0,0,241,241,
Tulsa,State Treasurer,Randy Mcdaniel,REP,720140,0,0,99,99,
Tulsa,State Treasurer,Charles De Coune,IND,720140,0,0,200,200,
Tulsa,Superintendent of Public Instruction,Joy Hofmeister,REP,720140,0,0,108,108,
Tulsa,Superintendent of Public Instruction,John Cox,DEM,720140,0,0,202,202,
Tulsa,Superintendent of Public Instruction,Larry Huff,IND,720140,0,0,24,24,
Tulsa,Commissioner of Labor,Leslie Osborn,REP,720140,0,0,85,85,
Tulsa,Commissioner of Labor,Fred Dorrell,DEM,720140,0,0,227,227,
Tulsa,Commissioner of Labor,Brandt Dismukes,IND,720140,0,0,19,19,
Tulsa,Insurance Commissioner,Glen Mulready,REP,720140,0,0,89,89,
Tulsa,Insurance Commissioner,Kimberly Fobbs,DEM,720140,0,0,247,247,
Tulsa,Corporation Commissioner,Bob Anthony,REP,720140,0,0,85,85,
Tulsa,Corporation Commissioner,Ashley Nicole Mccray,DEM,720140,0,0,230,230,
Tulsa,Corporation Commissioner,Jackie Short,IND,720140,0,0,22,22,
Tulsa,U.S. House,Kevin Hern,REP,720140,0,0,80,80,1
Tulsa,U.S. House,Tim Gilpin,DEM,720140,0,0,258,258,1
Tulsa,State House,Jadine Nollan,REP,720140,0,0,86,86,66
Tulsa,State House,Angela Graham,DEM,720140,0,0,251,251,66
Tulsa,Governor,Chris Powell,LIB,720141,0,0,35,35,
Tulsa,Governor,Kevin Stitt,REP,720141,0,0,424,424,
Tulsa,Governor,Drew Edmondson,DEM,720141,0,0,371,371,
Tulsa,Lieutenant Governor,Matt Pinnell,REP,720141,0,0,474,474,
Tulsa,Lieutenant Governor,Anastasia Pittman,DEM,720141,0,0,312,312,
Tulsa,Lieutenant Governor,Ivan Holmes,IND,720141,0,0,41,41,
Tulsa,State Auditor,John Yeutter,LIB,720141,0,0,220,220,
Tulsa,State Auditor,Cindy Byrd,REP,720141,0,0,526,526,
Tulsa,Attorney General,Mike Hunter,REP,720141,0,0,497,497,
Tulsa,Attorney General,Mark Myles,DEM,720141,0,0,325,325,
Tulsa,State Treasurer,Randy Mcdaniel,REP,720141,0,0,501,501,
Tulsa,State Treasurer,Charles De Coune,IND,720141,0,0,239,239,
Tulsa,Superintendent of Public Instruction,Joy Hofmeister,REP,720141,0,0,445,445,
Tulsa,Superintendent of Public Instruction,John Cox,DEM,720141,0,0,303,303,
Tulsa,Superintendent of Public Instruction,Larry Huff,IND,720141,0,0,78,78,
Tulsa,Commissioner of Labor,Leslie Osborn,REP,720141,0,0,454,454,
Tulsa,Commissioner of Labor,Fred Dorrell,DEM,720141,0,0,310,310,
Tulsa,Commissioner of Labor,Brandt Dismukes,IND,720141,0,0,56,56,
Tulsa,Insurance Commissioner,Glen Mulready,REP,720141,0,0,491,491,
Tulsa,Insurance Commissioner,Kimberly Fobbs,DEM,720141,0,0,331,331,
Tulsa,Corporation Commissioner,Bob Anthony,REP,720141,0,0,460,460,
Tulsa,Corporation Commissioner,Ashley Nicole Mccray,DEM,720141,0,0,316,316,
Tulsa,Corporation Commissioner,Jackie Short,IND,720141,0,0,48,48,
Tulsa,U.S. House,Kevin Hern,REP,720141,0,0,484,484,1
Tulsa,U.S. House,Tim Gilpin,DEM,720141,0,0,343,343,1
Tulsa,State House,J. Lee Miller Jr.,LIB,720141,0,0,28,28,68
Tulsa,State House,Lonnie Sims,REP,720141,0,0,430,430,68
Tulsa,State House,Michael Ross,DEM,720141,0,0,272,272,68
Tulsa,State House,Heather Chenoweth,IND,720141,0,0,93,93,68
Tulsa,Governor,Chris Powell,LIB,720142,0,0,20,20,
Tulsa,Governor,Kevin Stitt,REP,720142,0,0,355,355,
Tulsa,Governor,Drew Edmondson,DEM,720142,0,0,176,176,
Tulsa,Lieutenant Governor,Matt Pinnell,REP,720142,0,0,392,392,
Tulsa,Lieutenant Governor,Anastasia Pittman,DEM,720142,0,0,132,132,
Tulsa,Lieutenant Governor,Ivan Holmes,IND,720142,0,0,18,18,
Tulsa,State Auditor,John Yeutter,LIB,720142,0,0,80,80,
Tulsa,State Auditor,Cindy Byrd,REP,720142,0,0,428,428,
Tulsa,Attorney General,Mike Hunter,REP,720142,0,0,400,400,
Tulsa,Attorney General,Mark Myles,DEM,720142,0,0,141,141,
Tulsa,State Treasurer,Randy Mcdaniel,REP,720142,0,0,406,406,
Tulsa,State Treasurer,Charles De Coune,IND,720142,0,0,98,98,
Tulsa,Superintendent of Public Instruction,Joy Hofmeister,REP,720142,0,0,371,371,
Tulsa,Superintendent of Public Instruction,John Cox,DEM,720142,0,0,136,136,
Tulsa,Superintendent of Public Instruction,Larry Huff,IND,720142,0,0,38,38,
Tulsa,Commissioner of Labor,Leslie Osborn,REP,720142,0,0,375,375,
Tulsa,Commissioner of Labor,Fred Dorrell,DEM,720142,0,0,134,134,
Tulsa,Commissioner of Labor,Brandt Dismukes,IND,720142,0,0,27,27,
Tulsa,Insurance Commissioner,Glen Mulready,REP,720142,0,0,395,395,
Tulsa,Insurance Commissioner,Kimberly Fobbs,DEM,720142,0,0,147,147,
Tulsa,Corporation Commissioner,Bob Anthony,REP,720142,0,0,378,378,
Tulsa,Corporation Commissioner,Ashley Nicole Mccray,DEM,720142,0,0,137,137,
Tulsa,Corporation Commissioner,Jackie Short,IND,720142,0,0,24,24,
Tulsa,U.S. House,Kevin Hern,REP,720142,0,0,400,400,1
Tulsa,U.S. House,Tim Gilpin,DEM,720142,0,0,146,146,1
Tulsa,State House,J. Lee Miller Jr.,LIB,720142,0,0,6,6,68
Tulsa,State House,Lonnie Sims,REP,720142,0,0,349,349,68
Tulsa,State House,Michael Ross,DEM,720142,0,0,125,125,68
Tulsa,State House,Heather Chenoweth,IND,720142,0,0,60,60,68
Tulsa,Governor,Chris Powell,LIB,720143,0,0,33,33,
Tulsa,Governor,Kevin Stitt,REP,720143,0,0,242,242,
Tulsa,Governor,Drew Edmondson,DEM,720143,0,0,211,211,
Tulsa,Lieutenant Governor,Matt Pinnell,REP,720143,0,0,267,267,
Tulsa,Lieutenant Governor,Anastasia Pittman,DEM,720143,0,0,183,183,
Tulsa,Lieutenant Governor,Ivan Holmes,IND,720143,0,0,31,31,
Tulsa,State Auditor,John Yeutter,LIB,720143,0,0,136,136,
Tulsa,State Auditor,Cindy Byrd,REP,720143,0,0,304,304,
Tulsa,Attorney General,Mike Hunter,REP,720143,0,0,287,287,
Tulsa,Attorney General,Mark Myles,DEM,720143,0,0,191,191,
Tulsa,State Treasurer,Randy Mcdaniel,REP,720143,0,0,284,284,
Tulsa,State Treasurer,Charles De Coune,IND,720143,0,0,155,155,
Tulsa,Superintendent of Public Instruction,Joy Hofmeister,REP,720143,0,0,241,241,
Tulsa,Superintendent of Public Instruction,John Cox,DEM,720143,0,0,167,167,
Tulsa,Superintendent of Public Instruction,Larry Huff,IND,720143,0,0,72,72,
Tulsa,Commissioner of Labor,Leslie Osborn,REP,720143,0,0,258,258,
Tulsa,Commissioner of Labor,Fred Dorrell,DEM,720143,0,0,174,174,
Tulsa,Commissioner of Labor,Brandt Dismukes,IND,720143,0,0,44,44,
Tulsa,Insurance Commissioner,Glen Mulready,REP,720143,0,0,281,281,
Tulsa,Insurance Commissioner,Kimberly Fobbs,DEM,720143,0,0,192,192,
Tulsa,Corporation Commissioner,Bob Anthony,REP,720143,0,0,261,261,
Tulsa,Corporation Commissioner,Ashley Nicole Mccray,DEM,720143,0,0,171,171,
Tulsa,Corporation Commissioner,Jackie Short,IND,720143,0,0,44,44,
Tulsa,U.S. House,Kevin Hern,REP,720143,0,0,284,284,1
Tulsa,U.S. House,Tim Gilpin,DEM,720143,0,0,193,193,1
Tulsa,State House,J. Lee Miller Jr.,LIB,720143,0,0,23,23,68
Tulsa,State House,Lonnie Sims,REP,720143,0,0,220,220,68
Tulsa,State House,Michael Ross,DEM,720143,0,0,166,166,68
Tulsa,State House,Heather Chenoweth,IND,720143,0,0,69,69,68
Tulsa,Governor,Chris Powell,LIB,720144,0,0,36,36,
Tulsa,Governor,Kevin Stitt,REP,720144,0,0,503,503,
Tulsa,Governor,Drew Edmondson,DEM,720144,0,0,483,483,
Tulsa,Lieutenant Governor,Matt Pinnell,REP,720144,0,0,563,563,
Tulsa,Lieutenant Governor,Anastasia Pittman,DEM,720144,0,0,413,413,
Tulsa,Lieutenant Governor,Ivan Holmes,IND,720144,0,0,43,43,
Tulsa,State Auditor,John Yeutter,LIB,720144,0,0,312,312,
Tulsa,State Auditor,Cindy Byrd,REP,720144,0,0,609,609,
Tulsa,Attorney General,Mike Hunter,REP,720144,0,0,582,582,
Tulsa,Attorney General,Mark Myles,DEM,720144,0,0,433,433,
Tulsa,State Treasurer,Randy Mcdaniel,REP,720144,0,0,590,590,
Tulsa,State Treasurer,Charles De Coune,IND,720144,0,0,336,336,
Tulsa,Superintendent of Public Instruction,Joy Hofmeister,REP,720144,0,0,519,519,
Tulsa,Superintendent of Public Instruction,John Cox,DEM,720144,0,0,396,396,
Tulsa,Superintendent of Public Instruction,Larry Huff,IND,720144,0,0,100,100,
Tulsa,Commissioner of Labor,Leslie Osborn,REP,720144,0,0,526,526,
Tulsa,Commissioner of Labor,Fred Dorrell,DEM,720144,0,0,418,418,
Tulsa,Commissioner of Labor,Brandt Dismukes,IND,720144,0,0,61,61,
Tulsa,Insurance Commissioner,Glen Mulready,REP,720144,0,0,563,563,
Tulsa,Insurance Commissioner,Kimberly Fobbs,DEM,720144,0,0,442,442,
Tulsa,Corporation Commissioner,Bob Anthony,REP,720144,0,0,536,536,
Tulsa,Corporation Commissioner,Ashley Nicole Mccray,DEM,720144,0,0,411,411,
Tulsa,Corporation Commissioner,Jackie Short,IND,720144,0,0,62,62,
Tulsa,U.S. House,Kevin Hern,REP,720144,0,0,548,548,1
Tulsa,U.S. House,Tim Gilpin,DEM,720144,0,0,466,466,1
Tulsa,State House,J. Lee Miller Jr.,LIB,720144,0,0,31,31,68
Tulsa,State House,Lonnie Sims,REP,720144,0,0,478,478,68
Tulsa,State House,Michael Ross,DEM,720144,0,0,392,392,68
Tulsa,State House,Heather Chenoweth,IND,720144,0,0,112,112,68
Tulsa,Governor,Chris Powell,LIB,720145,0,0,29,29,
Tulsa,Governor,Kevin Stitt,REP,720145,0,0,729,729,
Tulsa,Governor,Drew Edmondson,DEM,720145,0,0,346,346,
Tulsa,Lieutenant Governor,Matt Pinnell,REP,720145,0,0,787,787,
Tulsa,Lieutenant Governor,Anastasia Pittman,DEM,720145,0,0,277,277,
Tulsa,Lieutenant Governor,Ivan Holmes,IND,720145,0,0,30,30,
Tulsa,State Auditor,John Yeutter,LIB,720145,0,0,188,188,
Tulsa,State Auditor,Cindy Byrd,REP,720145,0,0,835,835,
Tulsa,Attorney General,Mike Hunter,REP,720145,0,0,774,774,
Tulsa,Attorney General,Mark Myles,DEM,720145,0,0,307,307,
Tulsa,State Treasurer,Randy Mcdaniel,REP,720145,0,0,796,796,
Tulsa,State Treasurer,Charles De Coune,IND,720145,0,0,222,222,
Tulsa,Superintendent of Public Instruction,Joy Hofmeister,REP,720145,0,0,748,748,
Tulsa,Superintendent of Public Instruction,John Cox,DEM,720145,0,0,279,279,
Tulsa,Superintendent of Public Instruction,Larry Huff,IND,720145,0,0,62,62,
Tulsa,Commissioner of Labor,Leslie Osborn,REP,720145,0,0,745,745,
Tulsa,Commissioner of Labor,Fred Dorrell,DEM,720145,0,0,265,265,
Tulsa,Commissioner of Labor,Brandt Dismukes,IND,720145,0,0,55,55,
Tulsa,Insurance Commissioner,Glen Mulready,REP,720145,0,0,801,801,
Tulsa,Insurance Commissioner,Kimberly Fobbs,DEM,720145,0,0,277,277,
Tulsa,Corporation Commissioner,Bob Anthony,REP,720145,0,0,745,745,
Tulsa,Corporation Commissioner,Ashley Nicole Mccray,DEM,720145,0,0,272,272,
Tulsa,Corporation Commissioner,Jackie Short,IND,720145,0,0,55,55,
Tulsa,U.S. House,Kevin Hern,REP,720145,0,0,781,781,1
Tulsa,U.S. House,Tim Gilpin,DEM,720145,0,0,312,312,1
Tulsa,State House,J. Lee Miller Jr.,LIB,720145,0,0,25,25,68
Tulsa,State House,Lonnie Sims,REP,720145,0,0,707,707,68
Tulsa,State House,Michael Ross,DEM,720145,0,0,263,263,68
Tulsa,State House,Heather Chenoweth,IND,720145,0,0,80,80,68
Tulsa,Governor,Chris Powell,LIB,720146,0,0,26,26,
Tulsa,Governor,Kevin Stitt,REP,720146,0,0,444,444,
Tulsa,Governor,Drew Edmondson,DEM,720146,0,0,354,354,
Tulsa,Lieutenant Governor,Matt Pinnell,REP,720146,0,0,503,503,
Tulsa,Lieutenant Governor,Anastasia Pittman,DEM,720146,0,0,286,286,
Tulsa,Lieutenant Governor,Ivan Holmes,IND,720146,0,0,31,31,
Tulsa,State Auditor,John Yeutter,LIB,720146,0,0,241,241,
Tulsa,State Auditor,Cindy Byrd,REP,720146,0,0,529,529,
Tulsa,Attorney General,Mike Hunter,REP,720146,0,0,510,510,
Tulsa,Attorney General,Mark Myles,DEM,720146,0,0,304,304,
Tulsa,State Treasurer,Randy Mcdaniel,REP,720146,0,0,523,523,
Tulsa,State Treasurer,Charles De Coune,IND,720146,0,0,238,238,
Tulsa,Superintendent of Public Instruction,Joy Hofmeister,REP,720146,0,0,466,466,
Tulsa,Superintendent of Public Instruction,John Cox,DEM,720146,0,0,284,284,
Tulsa,Superintendent of Public Instruction,Larry Huff,IND,720146,0,0,67,67,
Tulsa,Commissioner of Labor,Leslie Osborn,REP,720146,0,0,458,458,
Tulsa,Commissioner of Labor,Fred Dorrell,DEM,720146,0,0,304,304,
Tulsa,Commissioner of Labor,Brandt Dismukes,IND,720146,0,0,35,35,
Tulsa,Insurance Commissioner,Glen Mulready,REP,720146,0,0,509,509,
Tulsa,Insurance Commissioner,Kimberly Fobbs,DEM,720146,0,0,303,303,
Tulsa,Corporation Commissioner,Bob Anthony,REP,720146,0,0,480,480,
Tulsa,Corporation Commissioner,Ashley Nicole Mccray,DEM,720146,0,0,291,291,
Tulsa,Corporation Commissioner,Jackie Short,IND,720146,0,0,41,41,
Tulsa,U.S. House,Kevin Hern,REP,720146,0,0,502,502,1
Tulsa,U.S. House,Tim Gilpin,DEM,720146,0,0,318,318,1
Tulsa,State House,J. Lee Miller Jr.,LIB,720146,0,0,32,32,68
Tulsa,State House,Lonnie Sims,REP,720146,0,0,449,449,68
Tulsa,State House,Michael Ross,DEM,720146,0,0,278,278,68
Tulsa,State House,Heather Chenoweth,IND,720146,0,0,54,54,68
Tulsa,Governor,Chris Powell,LIB,720147,0,0,11,11,
Tulsa,Governor,Kevin Stitt,REP,720147,0,0,55,55,
Tulsa,Governor,Drew Edmondson,DEM,720147,0,0,183,183,
Tulsa,Lieutenant Governor,Matt Pinnell,REP,720147,0,0,65,65,
Tulsa,Lieutenant Governor,Anastasia Pittman,DEM,720147,0,0,169,169,
Tulsa,Lieutenant Governor,Ivan Holmes,IND,720147,0,0,15,15,
Tulsa,State Auditor,John Yeutter,LIB,720147,0,0,129,129,
Tulsa,State Auditor,Cindy Byrd,REP,720147,0,0,93,93,
Tulsa,Attorney General,Mike Hunter,REP,720147,0,0,65,65,
Tulsa,Attorney General,Mark Myles,DEM,720147,0,0,183,183,
Tulsa,State Treasurer,Randy Mcdaniel,REP,720147,0,0,80,80,
Tulsa,State Treasurer,Charles De Coune,IND,720147,0,0,141,141,
Tulsa,Superintendent of Public Instruction,Joy Hofmeister,REP,720147,0,0,71,71,
Tulsa,Superintendent of Public Instruction,John Cox,DEM,720147,0,0,155,155,
Tulsa,Superintendent of Public Instruction,Larry Huff,IND,720147,0,0,23,23,
Tulsa,Commissioner of Labor,Leslie Osborn,REP,720147,0,0,64,64,
Tulsa,Commissioner of Labor,Fred Dorrell,DEM,720147,0,0,165,165,
Tulsa,Commissioner of Labor,Brandt Dismukes,IND,720147,0,0,19,19,
Tulsa,Insurance Commissioner,Glen Mulready,REP,720147,0,0,65,65,
Tulsa,Insurance Commissioner,Kimberly Fobbs,DEM,720147,0,0,184,184,
Tulsa,Corporation Commissioner,Bob Anthony,REP,720147,0,0,63,63,
Tulsa,Corporation Commissioner,Ashley Nicole Mccray,DEM,720147,0,0,168,168,
Tulsa,Corporation Commissioner,Jackie Short,IND,720147,0,0,18,18,
Tulsa,U.S. House,Kevin Hern,REP,720147,0,0,65,65,1
Tulsa,U.S. House,Tim Gilpin,DEM,720147,0,0,182,182,1
Tulsa,State House,Jadine Nollan,REP,720147,0,0,63,63,66
Tulsa,State House,Angela Graham,DEM,720147,0,0,184,184,66
Tulsa,Governor,Chris Powell,LIB,720148,0,0,22,22,
Tulsa,Governor,Kevin Stitt,REP,720148,0,0,217,217,
Tulsa,Governor,Drew Edmondson,DEM,720148,0,0,235,235,
Tulsa,Lieutenant Governor,Matt Pinnell,REP,720148,0,0,247,247,
Tulsa,Lieutenant Governor,Anastasia Pittman,DEM,720148,0,0,199,199,
Tulsa,Lieutenant Governor,Ivan Holmes,IND,720148,0,0,23,23,
Tulsa,State Auditor,John Yeutter,LIB,720148,0,0,150,150,
Tulsa,State Auditor,Cindy Byrd,REP,720148,0,0,279,279,
Tulsa,Attorney General,Mike Hunter,REP,720148,0,0,255,255,
Tulsa,Attorney General,Mark Myles,DEM,720148,0,0,212,212,
Tulsa,State Treasurer,Randy Mcdaniel,REP,720148,0,0,259,259,
Tulsa,State Treasurer,Charles De Coune,IND,720148,0,0,164,164,
Tulsa,Superintendent of Public Instruction,Joy Hofmeister,REP,720148,0,0,226,226,
Tulsa,Superintendent of Public Instruction,John Cox,DEM,720148,0,0,181,181,
Tulsa,Superintendent of Public Instruction,Larry Huff,IND,720148,0,0,58,58,
Tulsa,Commissioner of Labor,Leslie Osborn,REP,720148,0,0,231,231,
Tulsa,Commissioner of Labor,Fred Dorrell,DEM,720148,0,0,199,199,
Tulsa,Commissioner of Labor,Brandt Dismukes,IND,720148,0,0,29,29,
Tulsa,Insurance Commissioner,Glen Mulready,REP,720148,0,0,248,248,
Tulsa,Insurance Commissioner,Kimberly Fobbs,DEM,720148,0,0,213,213,
Tulsa,Corporation Commissioner,Bob Anthony,REP,720148,0,0,233,233,
Tulsa,Corporation Commissioner,Ashley Nicole Mccray,DEM,720148,0,0,205,205,
Tulsa,Corporation Commissioner,Jackie Short,IND,720148,0,0,27,27,
Tulsa,U.S. House,Kevin Hern,REP,720148,0,0,250,250,1
Tulsa,U.S. House,Tim Gilpin,DEM,720148,0,0,220,220,1
Tulsa,State House,Jadine Nollan,REP,720148,0,0,260,260,66
Tulsa,State House,Angela Graham,DEM,720148,0,0,205,205,66
Tulsa,Governor,Chris Powell,LIB,720149,0,0,23,23,
Tulsa,Governor,Kevin Stitt,REP,720149,0,0,210,210,
Tulsa,Governor,Drew Edmondson,DEM,720149,0,0,164,164,
Tulsa,Lieutenant Governor,Matt Pinnell,REP,720149,0,0,209,209,
Tulsa,Lieutenant Governor,Anastasia Pittman,DEM,720149,0,0,162,162,
Tulsa,Lieutenant Governor,Ivan Holmes,IND,720149,0,0,19,19,
Tulsa,State Auditor,John Yeutter,LIB,720149,0,0,122,122,
Tulsa,State Auditor,Cindy Byrd,REP,720149,0,0,240,240,
Tulsa,Attorney General,Mike Hunter,REP,720149,0,0,217,217,
Tulsa,Attorney General,Mark Myles,DEM,720149,0,0,172,172,
Tulsa,State Treasurer,Randy Mcdaniel,REP,720149,0,0,228,228,
Tulsa,State Treasurer,Charles De Coune,IND,720149,0,0,127,127,
Tulsa,Superintendent of Public Instruction,Joy Hofmeister,REP,720149,0,0,207,207,
Tulsa,Superintendent of Public Instruction,John Cox,DEM,720149,0,0,140,140,
Tulsa,Superintendent of Public Instruction,Larry Huff,IND,720149,0,0,45,45,
Tulsa,Commissioner of Labor,Leslie Osborn,REP,720149,0,0,191,191,
Tulsa,Commissioner of Labor,Fred Dorrell,DEM,720149,0,0,172,172,
Tulsa,Commissioner of Labor,Brandt Dismukes,IND,720149,0,0,23,23,
Tulsa,Insurance Commissioner,Glen Mulready,REP,720149,0,0,195,195,
Tulsa,Insurance Commissioner,Kimberly Fobbs,DEM,720149,0,0,191,191,
Tulsa,Corporation Commissioner,Bob Anthony,REP,720149,0,0,191,191,
Tulsa,Corporation Commissioner,Ashley Nicole Mccray,DEM,720149,0,0,164,164,
Tulsa,Corporation Commissioner,Jackie Short,IND,720149,0,0,32,32,
Tulsa,U.S. House,Kevin Hern,REP,720149,0,0,216,216,1
Tulsa,U.S. House,Tim Gilpin,DEM,720149,0,0,177,177,1
Tulsa,State House,Jadine Nollan,REP,720149,0,0,210,210,66
Tulsa,State House,Angela Graham,DEM,720149,0,0,178,178,66
Tulsa,Governor,Chris Powell,LIB,720150,0,0,28,28,
Tulsa,Governor,Kevin Stitt,REP,720150,0,0,1149,1149,
Tulsa,Governor,Drew Edmondson,DEM,720150,0,0,573,573,
Tulsa,Lieutenant Governor,Matt Pinnell,REP,720150,0,0,1293,1293,
Tulsa,Lieutenant Governor,Anastasia Pittman,DEM,720150,0,0,406,406,
Tulsa,Lieutenant Governor,Ivan Holmes,IND,720150,0,0,39,39,
Tulsa,State Auditor,John Yeutter,LIB,720150,0,0,289,289,
Tulsa,State Auditor,Cindy Byrd,REP,720150,0,0,1361,1361,
Tulsa,Attorney General,Mike Hunter,REP,720150,0,0,1273,1273,
Tulsa,Attorney General,Mark Myles,DEM,720150,0,0,441,441,
Tulsa,State Treasurer,Randy Mcdaniel,REP,720150,0,0,1297,1297,
Tulsa,State Treasurer,Charles De Coune,IND,720150,0,0,336,336,
Tulsa,Superintendent of Public Instruction,Joy Hofmeister,REP,720150,0,0,1173,1173,
Tulsa,Superintendent of Public Instruction,John Cox,DEM,720150,0,0,466,466,
Tulsa,Superintendent of Public Instruction,Larry Huff,IND,720150,0,0,95,95,
Tulsa,Commissioner of Labor,Leslie Osborn,REP,720150,0,0,1232,1232,
Tulsa,Commissioner of Labor,Fred Dorrell,DEM,720150,0,0,409,409,
Tulsa,Commissioner of Labor,Brandt Dismukes,IND,720150,0,0,56,56,
Tulsa,Insurance Commissioner,Glen Mulready,REP,720150,0,0,1249,1249,
Tulsa,Insurance Commissioner,Kimberly Fobbs,DEM,720150,0,0,451,451,
Tulsa,Corporation Commissioner,Bob Anthony,REP,720150,0,0,1215,1215,
Tulsa,Corporation Commissioner,Ashley Nicole Mccray,DEM,720150,0,0,420,420,
Tulsa,Corporation Commissioner,Jackie Short,IND,720150,0,0,72,72,
Tulsa,U.S. House,Kevin Hern,REP,720150,0,0,1249,1249,1
Tulsa,U.S. House,Tim Gilpin,DEM,720150,0,0,482,482,1
Tulsa,State Senate,John Haste,REP,720150,0,0,1243,1243,36
Tulsa,State Senate,Bryan O'Brien,DEM,720150,0,0,475,475,36
Tulsa,State House,Kelli Krebs,LIB,720150,0,0,35,35,75
Tulsa,State House,T. Marti,REP,720150,0,0,1205,1205,75
Tulsa,State House,Karen Gaddis,DEM,720150,0,0,499,499,75
Tulsa,Governor,Chris Powell,LIB,720151,0,0,11,11,
Tulsa,Governor,Kevin Stitt,REP,720151,0,0,173,173,
Tulsa,Governor,Drew Edmondson,DEM,720151,0,0,166,166,
Tulsa,Lieutenant Governor,Matt Pinnell,REP,720151,0,0,207,207,
Tulsa,Lieutenant Governor,Anastasia Pittman,DEM,720151,0,0,132,132,
Tulsa,Lieutenant Governor,Ivan Holmes,IND,720151,0,0,10,10,
Tulsa,State Auditor,John Yeutter,LIB,720151,0,0,88,88,
Tulsa,State Auditor,Cindy Byrd,REP,720151,0,0,222,222,
Tulsa,Attorney General,Mike Hunter,REP,720151,0,0,204,204,
Tulsa,Attorney General,Mark Myles,DEM,720151,0,0,138,138,
Tulsa,State Treasurer,Randy Mcdaniel,REP,720151,0,0,197,197,
Tulsa,State Treasurer,Charles De Coune,IND,720151,0,0,117,117,
Tulsa,Superintendent of Public Instruction,Joy Hofmeister,REP,720151,0,0,199,199,
Tulsa,Superintendent of Public Instruction,John Cox,DEM,720151,0,0,127,127,
Tulsa,Superintendent of Public Instruction,Larry Huff,IND,720151,0,0,19,19,
Tulsa,Commissioner of Labor,Leslie Osborn,REP,720151,0,0,195,195,
Tulsa,Commissioner of Labor,Fred Dorrell,DEM,720151,0,0,128,128,
Tulsa,Commissioner of Labor,Brandt Dismukes,IND,720151,0,0,17,17,
Tulsa,Insurance Commissioner,Glen Mulready,REP,720151,0,0,194,194,
Tulsa,Insurance Commissioner,Kimberly Fobbs,DEM,720151,0,0,147,147,
Tulsa,Corporation Commissioner,Bob Anthony,REP,720151,0,0,194,194,
Tulsa,Corporation Commissioner,Ashley Nicole Mccray,DEM,720151,0,0,129,129,
Tulsa,Corporation Commissioner,Jackie Short,IND,720151,0,0,18,18,
Tulsa,U.S. House,Kevin Hern,REP,720151,0,0,189,189,1
Tulsa,U.S. House,Tim Gilpin,DEM,720151,0,0,157,157,1
Tulsa,State House,Dan Hicks,REP,720151,0,0,171,171,79
Tulsa,State House,Melissa Provenzano,DEM,720151,0,0,171,171,79
Tulsa,Governor,Chris Powell,LIB,720152,0,0,22,22,
Tulsa,Governor,Kevin Stitt,REP,720152,0,0,606,606,
Tulsa,Governor,Drew Edmondson,DEM,720152,0,0,435,435,
Tulsa,Lieutenant Governor,Matt Pinnell,REP,720152,0,0,702,702,
Tulsa,Lieutenant Governor,Anastasia Pittman,DEM,720152,0,0,336,336,
Tulsa,Lieutenant Governor,Ivan Holmes,IND,720152,0,0,19,19,
Tulsa,State Auditor,John Yeutter,LIB,720152,0,0,201,201,
Tulsa,State Auditor,Cindy Byrd,REP,720152,0,0,785,785,
Tulsa,Attorney General,Mike Hunter,REP,720152,0,0,708,708,
Tulsa,Attorney General,Mark Myles,DEM,720152,0,0,340,340,
Tulsa,State Treasurer,Randy Mcdaniel,REP,720152,0,0,739,739,
Tulsa,State Treasurer,Charles De Coune,IND,720152,0,0,246,246,
Tulsa,Superintendent of Public Instruction,Joy Hofmeister,REP,720152,0,0,657,657,
Tulsa,Superintendent of Public Instruction,John Cox,DEM,720152,0,0,335,335,
Tulsa,Superintendent of Public Instruction,Larry Huff,IND,720152,0,0,59,59,
Tulsa,Commissioner of Labor,Leslie Osborn,REP,720152,0,0,668,668,
Tulsa,Commissioner of Labor,Fred Dorrell,DEM,720152,0,0,331,331,
Tulsa,Commissioner of Labor,Brandt Dismukes,IND,720152,0,0,35,35,
Tulsa,Insurance Commissioner,Glen Mulready,REP,720152,0,0,686,686,
Tulsa,Insurance Commissioner,Kimberly Fobbs,DEM,720152,0,0,353,353,
Tulsa,Corporation Commissioner,Bob Anthony,REP,720152,0,0,664,664,
Tulsa,Corporation Commissioner,Ashley Nicole Mccray,DEM,720152,0,0,338,338,
Tulsa,Corporation Commissioner,Jackie Short,IND,720152,0,0,34,34,
Tulsa,U.S. House,Kevin Hern,REP,720152,0,0,674,674,1
Tulsa,U.S. House,Tim Gilpin,DEM,720152,0,0,379,379,1
Tulsa,State Senate,John Haste,REP,720152,0,0,685,685,36
Tulsa,State Senate,Bryan O'Brien,DEM,720152,0,0,362,362,36
Tulsa,State House,Kelli Krebs,LIB,720152,0,0,25,25,75
Tulsa,State House,T. Marti,REP,720152,0,0,665,665,75
Tulsa,State House,Karen Gaddis,DEM,720152,0,0,366,366,75
Tulsa,Governor,Chris Powell,LIB,720153,0,0,13,13,
Tulsa,Governor,Kevin Stitt,REP,720153,0,0,487,487,
Tulsa,Governor,Drew Edmondson,DEM,720153,0,0,388,388,
Tulsa,Lieutenant Governor,Matt Pinnell,REP,720153,0,0,569,569,
Tulsa,Lieutenant Governor,Anastasia Pittman,DEM,720153,0,0,295,295,
Tulsa,Lieutenant Governor,Ivan Holmes,IND,720153,0,0,20,20,
Tulsa,State Auditor,John Yeutter,LIB,720153,0,0,189,189,
Tulsa,State Auditor,Cindy Byrd,REP,720153,0,0,631,631,
Tulsa,Attorney General,Mike Hunter,REP,720153,0,0,587,587,
Tulsa,Attorney General,Mark Myles,DEM,720153,0,0,292,292,
Tulsa,State Treasurer,Randy Mcdaniel,REP,720153,0,0,582,582,
Tulsa,State Treasurer,Charles De Coune,IND,720153,0,0,235,235,
Tulsa,Superintendent of Public Instruction,Joy Hofmeister,REP,720153,0,0,549,549,
Tulsa,Superintendent of Public Instruction,John Cox,DEM,720153,0,0,293,293,
Tulsa,Superintendent of Public Instruction,Larry Huff,IND,720153,0,0,43,43,
Tulsa,Commissioner of Labor,Leslie Osborn,REP,720153,0,0,551,551,
Tulsa,Commissioner of Labor,Fred Dorrell,DEM,720153,0,0,280,280,
Tulsa,Commissioner of Labor,Brandt Dismukes,IND,720153,0,0,38,38,
Tulsa,Insurance Commissioner,Glen Mulready,REP,720153,0,0,567,567,
Tulsa,Insurance Commissioner,Kimberly Fobbs,DEM,720153,0,0,304,304,
Tulsa,Corporation Commissioner,Bob Anthony,REP,720153,0,0,556,556,
Tulsa,Corporation Commissioner,Ashley Nicole Mccray,DEM,720153,0,0,275,275,
Tulsa,Corporation Commissioner,Jackie Short,IND,720153,0,0,39,39,
Tulsa,U.S. House,Kevin Hern,REP,720153,0,0,554,554,1
Tulsa,U.S. House,Tim Gilpin,DEM,720153,0,0,333,333,1
Tulsa,State House,Jeff Boatman,REP,720153,0,0,555,555,67
Tulsa,State House,Carly Hotvedt,DEM,720153,0,0,325,325,67
Tulsa,Governor,Chris Powell,LIB,720154,0,0,34,34,
Tulsa,Governor,Kevin Stitt,REP,720154,0,0,598,598,
Tulsa,Governor,Drew Edmondson,DEM,720154,0,0,431,431,
Tulsa,Lieutenant Governor,Matt Pinnell,REP,720154,0,0,696,696,
Tulsa,Lieutenant Governor,Anastasia Pittman,DEM,720154,0,0,329,329,
Tulsa,Lieutenant Governor,Ivan Holmes,IND,720154,0,0,28,28,
Tulsa,State Auditor,John Yeutter,LIB,720154,0,0,219,219,
Tulsa,State Auditor,Cindy Byrd,REP,720154,0,0,746,746,
Tulsa,Attorney General,Mike Hunter,REP,720154,0,0,701,701,
Tulsa,Attorney General,Mark Myles,DEM,720154,0,0,339,339,
Tulsa,State Treasurer,Randy Mcdaniel,REP,720154,0,0,718,718,
Tulsa,State Treasurer,Charles De Coune,IND,720154,0,0,234,234,
Tulsa,Superintendent of Public Instruction,Joy Hofmeister,REP,720154,0,0,685,685,
Tulsa,Superintendent of Public Instruction,John Cox,DEM,720154,0,0,298,298,
Tulsa,Superintendent of Public Instruction,Larry Huff,IND,720154,0,0,71,71,
Tulsa,Commissioner of Labor,Leslie Osborn,REP,720154,0,0,666,666,
Tulsa,Commissioner of Labor,Fred Dorrell,DEM,720154,0,0,305,305,
Tulsa,Commissioner of Labor,Brandt Dismukes,IND,720154,0,0,58,58,
Tulsa,Insurance Commissioner,Glen Mulready,REP,720154,0,0,681,681,
Tulsa,Insurance Commissioner,Kimberly Fobbs,DEM,720154,0,0,350,350,
Tulsa,Corporation Commissioner,Bob Anthony,REP,720154,0,0,677,677,
Tulsa,Corporation Commissioner,Ashley Nicole Mccray,DEM,720154,0,0,314,314,
Tulsa,Corporation Commissioner,Jackie Short,IND,720154,0,0,49,49,
Tulsa,U.S. House,Kevin Hern,REP,720154,0,0,667,667,1
Tulsa,U.S. House,Tim Gilpin,DEM,720154,0,0,389,389,1
Tulsa,State House,Jeff Boatman,REP,720154,0,0,652,652,67
Tulsa,State House,Carly Hotvedt,DEM,720154,0,0,384,384,67
Tulsa,Governor,Chris Powell,LIB,720155,0,0,14,14,
Tulsa,Governor,Kevin Stitt,REP,720155,0,0,1036,1036,
Tulsa,Governor,Drew Edmondson,DEM,720155,0,0,491,491,
Tulsa,Lieutenant Governor,Matt Pinnell,REP,720155,0,0,1206,1206,
Tulsa,Lieutenant Governor,Anastasia Pittman,DEM,720155,0,0,304,304,
Tulsa,Lieutenant Governor,Ivan Holmes,IND,720155,0,0,21,21,
Tulsa,State Auditor,John Yeutter,LIB,720155,0,0,167,167,
Tulsa,State Auditor,Cindy Byrd,REP,720155,0,0,1282,1282,
Tulsa,Attorney General,Mike Hunter,REP,720155,0,0,1192,1192,
Tulsa,Attorney General,Mark Myles,DEM,720155,0,0,326,326,
Tulsa,State Treasurer,Randy Mcdaniel,REP,720155,0,0,1236,1236,
Tulsa,State Treasurer,Charles De Coune,IND,720155,0,0,215,215,
Tulsa,Superintendent of Public Instruction,Joy Hofmeister,REP,720155,0,0,1178,1178,
Tulsa,Superintendent of Public Instruction,John Cox,DEM,720155,0,0,296,296,
Tulsa,Superintendent of Public Instruction,Larry Huff,IND,720155,0,0,51,51,
Tulsa,Commissioner of Labor,Leslie Osborn,REP,720155,0,0,1165,1165,
Tulsa,Commissioner of Labor,Fred Dorrell,DEM,720155,0,0,284,284,
Tulsa,Commissioner of Labor,Brandt Dismukes,IND,720155,0,0,43,43,
Tulsa,Insurance Commissioner,Glen Mulready,REP,720155,0,0,1182,1182,
Tulsa,Insurance Commissioner,Kimberly Fobbs,DEM,720155,0,0,327,327,
Tulsa,Corporation Commissioner,Bob Anthony,REP,720155,0,0,1180,1180,
Tulsa,Corporation Commissioner,Ashley Nicole Mccray,DEM,720155,0,0,282,282,
Tulsa,Corporation Commissioner,Jackie Short,IND,720155,0,0,47,47,
Tulsa,U.S. House,Kevin Hern,REP,720155,0,0,1132,1132,1
Tulsa,U.S. House,Tim Gilpin,DEM,720155,0,0,402,402,1
Tulsa,State House,Jeff Boatman,REP,720155,0,0,1126,1126,67
Tulsa,State House,Carly Hotvedt,DEM,720155,0,0,376,376,67
Tulsa,Governor,Chris Powell,LIB,720156,0,0,16,16,
Tulsa,Governor,Kevin Stitt,REP,720156,0,0,125,125,
Tulsa,Governor,Drew Edmondson,DEM,720156,0,0,200,200,
Tulsa,Lieutenant Governor,Matt Pinnell,REP,720156,0,0,141,141,
Tulsa,Lieutenant Governor,Anastasia Pittman,DEM,720156,0,0,187,187,
Tulsa,Lieutenant Governor,Ivan Holmes,IND,720156,0,0,11,11,
Tulsa,State Auditor,John Yeutter,LIB,720156,0,0,132,132,
Tulsa,State Auditor,Cindy Byrd,REP,720156,0,0,173,173,
Tulsa,Attorney General,Mike Hunter,REP,720156,0,0,148,148,
Tulsa,Attorney General,Mark Myles,DEM,720156,0,0,188,188,
Tulsa,State Treasurer,Randy Mcdaniel,REP,720156,0,0,151,151,
Tulsa,State Treasurer,Charles De Coune,IND,720156,0,0,154,154,
Tulsa,Superintendent of Public Instruction,Joy Hofmeister,REP,720156,0,0,133,133,
Tulsa,Superintendent of Public Instruction,John Cox,DEM,720156,0,0,173,173,
Tulsa,Superintendent of Public Instruction,Larry Huff,IND,720156,0,0,33,33,
Tulsa,Commissioner of Labor,Leslie Osborn,REP,720156,0,0,132,132,
Tulsa,Commissioner of Labor,Fred Dorrell,DEM,720156,0,0,171,171,
Tulsa,Commissioner of Labor,Brandt Dismukes,IND,720156,0,0,26,26,
Tulsa,Insurance Commissioner,Glen Mulready,REP,720156,0,0,142,142,
Tulsa,Insurance Commissioner,Kimberly Fobbs,DEM,720156,0,0,193,193,
Tulsa,Corporation Commissioner,Bob Anthony,REP,720156,0,0,135,135,
Tulsa,Corporation Commissioner,Ashley Nicole Mccray,DEM,720156,0,0,178,178,
Tulsa,Corporation Commissioner,Jackie Short,IND,720156,0,0,25,25,
Tulsa,U.S. House,Kevin Hern,REP,720156,0,0,140,140,1
Tulsa,U.S. House,Tim Gilpin,DEM,720156,0,0,198,198,1
Tulsa,State House,Dan Hicks,REP,720156,0,0,129,129,79
Tulsa,State House,Melissa Provenzano,DEM,720156,0,0,208,208,79
Tulsa,Governor,Chris Powell,LIB,720157,0,0,23,23,
Tulsa,Governor,Kevin Stitt,REP,720157,0,0,966,966,
Tulsa,Governor,Drew Edmondson,DEM,720157,0,0,502,502,
Tulsa,Lieutenant Governor,Matt Pinnell,REP,720157,0,0,1124,1124,
Tulsa,Lieutenant Governor,Anastasia Pittman,DEM,720157,0,0,329,329,
Tulsa,Lieutenant Governor,Ivan Holmes,IND,720157,0,0,28,28,
Tulsa,State Auditor,John Yeutter,LIB,720157,0,0,199,199,
Tulsa,State Auditor,Cindy Byrd,REP,720157,0,0,1194,1194,
Tulsa,Attorney General,Mike Hunter,REP,720157,0,0,1100,1100,
Tulsa,Attorney General,Mark Myles,DEM,720157,0,0,363,363,
Tulsa,State Treasurer,Randy Mcdaniel,REP,720157,0,0,1151,1151,
Tulsa,State Treasurer,Charles De Coune,IND,720157,0,0,248,248,
Tulsa,Superintendent of Public Instruction,Joy Hofmeister,REP,720157,0,0,1089,1089,
Tulsa,Superintendent of Public Instruction,John Cox,DEM,720157,0,0,325,325,
Tulsa,Superintendent of Public Instruction,Larry Huff,IND,720157,0,0,55,55,
Tulsa,Commissioner of Labor,Leslie Osborn,REP,720157,0,0,1070,1070,
Tulsa,Commissioner of Labor,Fred Dorrell,DEM,720157,0,0,326,326,
Tulsa,Commissioner of Labor,Brandt Dismukes,IND,720157,0,0,43,43,
Tulsa,Insurance Commissioner,Glen Mulready,REP,720157,0,0,1086,1086,
Tulsa,Insurance Commissioner,Kimberly Fobbs,DEM,720157,0,0,357,357,
Tulsa,Corporation Commissioner,Bob Anthony,REP,720157,0,0,1092,1092,
Tulsa,Corporation Commissioner,Ashley Nicole Mccray,DEM,720157,0,0,312,312,
Tulsa,Corporation Commissioner,Jackie Short,IND,720157,0,0,49,49,
Tulsa,U.S. House,Kevin Hern,REP,720157,0,0,1068,1068,1
Tulsa,U.S. House,Tim Gilpin,DEM,720157,0,0,408,408,1
Tulsa,State House,Sheila Dills,REP,720157,0,0,1071,1071,69
Tulsa,State House,Andy Richardson,DEM,720157,0,0,403,403,69
Tulsa,Governor,Chris Powell,LIB,720158,0,0,25,25,
Tulsa,Governor,Kevin Stitt,REP,720158,0,0,462,462,
Tulsa,Governor,Drew Edmondson,DEM,720158,0,0,296,296,
Tulsa,Lieutenant Governor,Matt Pinnell,REP,720158,0,0,533,533,
Tulsa,Lieutenant Governor,Anastasia Pittman,DEM,720158,0,0,218,218,
Tulsa,Lieutenant Governor,Ivan Holmes,IND,720158,0,0,27,27,
Tulsa,State Auditor,John Yeutter,LIB,720158,0,0,142,142,
Tulsa,State Auditor,Cindy Byrd,REP,720158,0,0,588,588,
Tulsa,Attorney General,Mike Hunter,REP,720158,0,0,532,532,
Tulsa,Attorney General,Mark Myles,DEM,720158,0,0,240,240,
Tulsa,State Treasurer,Randy Mcdaniel,REP,720158,0,0,550,550,
Tulsa,State Treasurer,Charles De Coune,IND,720158,0,0,176,176,
Tulsa,Superintendent of Public Instruction,Joy Hofmeister,REP,720158,0,0,526,526,
Tulsa,Superintendent of Public Instruction,John Cox,DEM,720158,0,0,202,202,
Tulsa,Superintendent of Public Instruction,Larry Huff,IND,720158,0,0,47,47,
Tulsa,Commissioner of Labor,Leslie Osborn,REP,720158,0,0,511,511,
Tulsa,Commissioner of Labor,Fred Dorrell,DEM,720158,0,0,214,214,
Tulsa,Commissioner of Labor,Brandt Dismukes,IND,720158,0,0,37,37,
Tulsa,Insurance Commissioner,Glen Mulready,REP,720158,0,0,516,516,
Tulsa,Insurance Commissioner,Kimberly Fobbs,DEM,720158,0,0,247,247,
Tulsa,Corporation Commissioner,Bob Anthony,REP,720158,0,0,505,505,
Tulsa,Corporation Commissioner,Ashley Nicole Mccray,DEM,720158,0,0,212,212,
Tulsa,Corporation Commissioner,Jackie Short,IND,720158,0,0,46,46,
Tulsa,U.S. House,Kevin Hern,REP,720158,0,0,512,512,1
Tulsa,U.S. House,Tim Gilpin,DEM,720158,0,0,258,258,1
Tulsa,State House,Jeff Boatman,REP,720158,0,0,496,496,67
Tulsa,State House,Carly Hotvedt,DEM,720158,0,0,270,270,67
Tulsa,Governor,Chris Powell,LIB,720159,0,0,24,24,
Tulsa,Governor,Kevin Stitt,REP,720159,0,0,486,486,
Tulsa,Governor,Drew Edmondson,DEM,720159,0,0,365,365,
Tulsa,Lieutenant Governor,Matt Pinnell,REP,720159,0,0,572,572,
Tulsa,Lieutenant Governor,Anastasia Pittman,DEM,720159,0,0,279,279,
Tulsa,Lieutenant Governor,Ivan Holmes,IND,720159,0,0,23,23,
Tulsa,State Auditor,John Yeutter,LIB,720159,0,0,190,190,
Tulsa,State Auditor,Cindy Byrd,REP,720159,0,0,623,623,
Tulsa,Attorney General,Mike Hunter,REP,720159,0,0,565,565,
Tulsa,Attorney General,Mark Myles,DEM,720159,0,0,293,293,
Tulsa,State Treasurer,Randy Mcdaniel,REP,720159,0,0,576,576,
Tulsa,State Treasurer,Charles De Coune,IND,720159,0,0,228,228,
Tulsa,Superintendent of Public Instruction,Joy Hofmeister,REP,720159,0,0,530,530,
Tulsa,Superintendent of Public Instruction,John Cox,DEM,720159,0,0,276,276,
Tulsa,Superintendent of Public Instruction,Larry Huff,IND,720159,0,0,54,54,
Tulsa,Commissioner of Labor,Leslie Osborn,REP,720159,0,0,554,554,
Tulsa,Commissioner of Labor,Fred Dorrell,DEM,720159,0,0,262,262,
Tulsa,Commissioner of Labor,Brandt Dismukes,IND,720159,0,0,34,34,
Tulsa,Insurance Commissioner,Glen Mulready,REP,720159,0,0,552,552,
Tulsa,Insurance Commissioner,Kimberly Fobbs,DEM,720159,0,0,303,303,
Tulsa,Corporation Commissioner,Bob Anthony,REP,720159,0,0,552,552,
Tulsa,Corporation Commissioner,Ashley Nicole Mccray,DEM,720159,0,0,260,260,
Tulsa,Corporation Commissioner,Jackie Short,IND,720159,0,0,44,44,
Tulsa,U.S. House,Kevin Hern,REP,720159,0,0,545,545,1
Tulsa,U.S. House,Tim Gilpin,DEM,720159,0,0,322,322,1
Tulsa,State House,Jeff Boatman,REP,720159,0,0,520,520,67
Tulsa,State House,Carly Hotvedt,DEM,720159,0,0,339,339,67
Tulsa,Governor,Chris Powell,LIB,720160,0,0,33,33,
Tulsa,Governor,Kevin Stitt,REP,720160,0,0,450,450,
Tulsa,Governor,Drew Edmondson,DEM,720160,0,0,655,655,
Tulsa,Lieutenant Governor,Matt Pinnell,REP,720160,0,0,568,568,
Tulsa,Lieutenant Governor,Anastasia Pittman,DEM,720160,0,0,530,530,
Tulsa,Lieutenant Governor,Ivan Holmes,IND,720160,0,0,35,35,
Tulsa,State Auditor,John Yeutter,LIB,720160,0,0,358,358,
Tulsa,State Auditor,Cindy Byrd,REP,720160,0,0,666,666,
Tulsa,Attorney General,Mike Hunter,REP,720160,0,0,550,550,
Tulsa,Attorney General,Mark Myles,DEM,720160,0,0,574,574,
Tulsa,State Treasurer,Randy Mcdaniel,REP,720160,0,0,601,601,
Tulsa,State Treasurer,Charles De Coune,IND,720160,0,0,422,422,
Tulsa,Superintendent of Public Instruction,Joy Hofmeister,REP,720160,0,0,578,578,
Tulsa,Superintendent of Public Instruction,John Cox,DEM,720160,0,0,491,491,
Tulsa,Superintendent of Public Instruction,Larry Huff,IND,720160,0,0,60,60,
Tulsa,Commissioner of Labor,Leslie Osborn,REP,720160,0,0,557,557,
Tulsa,Commissioner of Labor,Fred Dorrell,DEM,720160,0,0,508,508,
Tulsa,Commissioner of Labor,Brandt Dismukes,IND,720160,0,0,44,44,
Tulsa,Insurance Commissioner,Glen Mulready,REP,720160,0,0,552,552,
Tulsa,Insurance Commissioner,Kimberly Fobbs,DEM,720160,0,0,554,554,
Tulsa,Corporation Commissioner,Bob Anthony,REP,720160,0,0,540,540,
Tulsa,Corporation Commissioner,Ashley Nicole Mccray,DEM,720160,0,0,521,521,
Tulsa,Corporation Commissioner,Jackie Short,IND,720160,0,0,53,53,
Tulsa,U.S. House,Kevin Hern,REP,720160,0,0,498,498,1
Tulsa,U.S. House,Tim Gilpin,DEM,720160,0,0,631,631,1
Tulsa,State House,Carol Bush,REP,720160,0,0,564,564,70
Tulsa,State House,Jj Burnam,DEM,720160,0,0,556,556,70
Tulsa,Governor,Chris Powell,LIB,720161,0,0,22,22,
Tulsa,Governor,Kevin Stitt,REP,720161,0,0,104,104,
Tulsa,Governor,Drew Edmondson,DEM,720161,0,0,275,275,
Tulsa,Lieutenant Governor,Matt Pinnell,REP,720161,0,0,119,119,
Tulsa,Lieutenant Governor,Anastasia Pittman,DEM,720161,0,0,252,252,
Tulsa,Lieutenant Governor,Ivan Holmes,IND,720161,0,0,27,27,
Tulsa,State Auditor,John Yeutter,LIB,720161,0,0,189,189,
Tulsa,State Auditor,Cindy Byrd,REP,720161,0,0,169,169,
Tulsa,Attorney General,Mike Hunter,REP,720161,0,0,126,126,
Tulsa,Attorney General,Mark Myles,DEM,720161,0,0,269,269,
Tulsa,State Treasurer,Randy Mcdaniel,REP,720161,0,0,132,132,
Tulsa,State Treasurer,Charles De Coune,IND,720161,0,0,223,223,
Tulsa,Superintendent of Public Instruction,Joy Hofmeister,REP,720161,0,0,135,135,
Tulsa,Superintendent of Public Instruction,John Cox,DEM,720161,0,0,226,226,
Tulsa,Superintendent of Public Instruction,Larry Huff,IND,720161,0,0,36,36,
Tulsa,Commissioner of Labor,Leslie Osborn,REP,720161,0,0,123,123,
Tulsa,Commissioner of Labor,Fred Dorrell,DEM,720161,0,0,238,238,
Tulsa,Commissioner of Labor,Brandt Dismukes,IND,720161,0,0,31,31,
Tulsa,Insurance Commissioner,Glen Mulready,REP,720161,0,0,119,119,
Tulsa,Insurance Commissioner,Kimberly Fobbs,DEM,720161,0,0,273,273,
Tulsa,Corporation Commissioner,Bob Anthony,REP,720161,0,0,111,111,
Tulsa,Corporation Commissioner,Ashley Nicole Mccray,DEM,720161,0,0,242,242,
Tulsa,Corporation Commissioner,Jackie Short,IND,720161,0,0,41,41,
Tulsa,U.S. House,Kevin Hern,REP,720161,0,0,121,121,1
Tulsa,U.S. House,Tim Gilpin,DEM,720161,0,0,277,277,1
Tulsa,State House,Cheryl Baber,REP,720161,0,0,125,125,71
Tulsa,State House,Denise Brewer,DEM,720161,0,0,270,270,71
Tulsa,Governor,Chris Powell,LIB,720162,0,0,4,4,
Tulsa,Governor,Kevin Stitt,REP,720162,0,0,58,58,
Tulsa,Governor,Drew Edmondson,DEM,720162,0,0,21,21,
Tulsa,Lieutenant Governor,Matt Pinnell,REP,720162,0,0,57,57,
Tulsa,Lieutenant Governor,Anastasia Pittman,DEM,720162,0,0,25,25,
Tulsa,Lieutenant Governor,Ivan Holmes,IND,720162,0,0,1,1,
Tulsa,State Auditor,John Yeutter,LIB,720162,0,0,6,6,
Tulsa,State Auditor,Cindy Byrd,REP,720162,0,0,72,72,
Tulsa,Attorney General,Mike Hunter,REP,720162,0,0,56,56,
Tulsa,Attorney General,Mark Myles,DEM,720162,0,0,26,26,
Tulsa,State Treasurer,Randy Mcdaniel,REP,720162,0,0,62,62,
Tulsa,State Treasurer,Charles De Coune,IND,720162,0,0,16,16,
Tulsa,Superintendent of Public Instruction,Joy Hofmeister,REP,720162,0,0,58,58,
Tulsa,Superintendent of Public Instruction,John Cox,DEM,720162,0,0,19,19,
Tulsa,Superintendent of Public Instruction,Larry Huff,IND,720162,0,0,6,6,
Tulsa,Commissioner of Labor,Leslie Osborn,REP,720162,0,0,58,58,
Tulsa,Commissioner of Labor,Fred Dorrell,DEM,720162,0,0,21,21,
Tulsa,Commissioner of Labor,Brandt Dismukes,IND,720162,0,0,4,4,
Tulsa,Insurance Commissioner,Glen Mulready,REP,720162,0,0,56,56,
Tulsa,Insurance Commissioner,Kimberly Fobbs,DEM,720162,0,0,25,25,
Tulsa,Corporation Commissioner,Bob Anthony,REP,720162,0,0,56,56,
Tulsa,Corporation Commissioner,Ashley Nicole Mccray,DEM,720162,0,0,23,23,
Tulsa,Corporation Commissioner,Jackie Short,IND,720162,0,0,3,3,
Tulsa,U.S. House,Kevin Hern,REP,720162,0,0,60,60,1
Tulsa,U.S. House,Tim Gilpin,DEM,720162,0,0,22,22,1
Tulsa,State House,Sheila Dills,REP,720162,0,0,60,60,69
Tulsa,State House,Andy Richardson,DEM,720162,0,0,23,23,69
Tulsa,Governor,Chris Powell,LIB,720163,0,0,18,18,
Tulsa,Governor,Kevin Stitt,REP,720163,0,0,393,393,
Tulsa,Governor,Drew Edmondson,DEM,720163,0,0,418,418,
Tulsa,Lieutenant Governor,Matt Pinnell,REP,720163,0,0,477,477,
Tulsa,Lieutenant Governor,Anastasia Pittman,DEM,720163,0,0,331,331,
Tulsa,Lieutenant Governor,Ivan Holmes,IND,720163,0,0,16,16,
Tulsa,State Auditor,John Yeutter,LIB,720163,0,0,184,184,
Tulsa,State Auditor,Cindy Byrd,REP,720163,0,0,556,556,
Tulsa,Attorney General,Mike Hunter,REP,720163,0,0,476,476,
Tulsa,Attorney General,Mark Myles,DEM,720163,0,0,341,341,
Tulsa,State Treasurer,Randy Mcdaniel,REP,720163,0,0,507,507,
Tulsa,State Treasurer,Charles De Coune,IND,720163,0,0,232,232,
Tulsa,Superintendent of Public Instruction,Joy Hofmeister,REP,720163,0,0,485,485,
Tulsa,Superintendent of Public Instruction,John Cox,DEM,720163,0,0,305,305,
Tulsa,Superintendent of Public Instruction,Larry Huff,IND,720163,0,0,30,30,
Tulsa,Commissioner of Labor,Leslie Osborn,REP,720163,0,0,452,452,
Tulsa,Commissioner of Labor,Fred Dorrell,DEM,720163,0,0,327,327,
Tulsa,Commissioner of Labor,Brandt Dismukes,IND,720163,0,0,25,25,
Tulsa,Insurance Commissioner,Glen Mulready,REP,720163,0,0,461,461,
Tulsa,Insurance Commissioner,Kimberly Fobbs,DEM,720163,0,0,340,340,
Tulsa,Corporation Commissioner,Bob Anthony,REP,720163,0,0,478,478,
Tulsa,Corporation Commissioner,Ashley Nicole Mccray,DEM,720163,0,0,302,302,
Tulsa,Corporation Commissioner,Jackie Short,IND,720163,0,0,32,32,
Tulsa,U.S. House,Kevin Hern,REP,720163,0,0,438,438,1
Tulsa,U.S. House,Tim Gilpin,DEM,720163,0,0,387,387,1
Tulsa,State House,Carol Bush,REP,720163,0,0,523,523,70
Tulsa,State House,Jj Burnam,DEM,720163,0,0,301,301,70
Tulsa,Governor,Chris Powell,LIB,720164,0,0,8,8,
Tulsa,Governor,Kevin Stitt,REP,720164,0,0,164,164,
Tulsa,Governor,Drew Edmondson,DEM,720164,0,0,184,184,
Tulsa,Lieutenant Governor,Matt Pinnell,REP,720164,0,0,209,209,
Tulsa,Lieutenant Governor,Anastasia Pittman,DEM,720164,0,0,135,135,
Tulsa,Lieutenant Governor,Ivan Holmes,IND,720164,0,0,7,7,
Tulsa,State Auditor,John Yeutter,LIB,720164,0,0,80,80,
Tulsa,State Auditor,Cindy Byrd,REP,720164,0,0,238,238,
Tulsa,Attorney General,Mike Hunter,REP,720164,0,0,207,207,
Tulsa,Attorney General,Mark Myles,DEM,720164,0,0,140,140,
Tulsa,State Treasurer,Randy Mcdaniel,REP,720164,0,0,217,217,
Tulsa,State Treasurer,Charles De Coune,IND,720164,0,0,100,100,
Tulsa,Superintendent of Public Instruction,Joy Hofmeister,REP,720164,0,0,208,208,
Tulsa,Superintendent of Public Instruction,John Cox,DEM,720164,0,0,118,118,
Tulsa,Superintendent of Public Instruction,Larry Huff,IND,720164,0,0,25,25,
Tulsa,Commissioner of Labor,Leslie Osborn,REP,720164,0,0,206,206,
Tulsa,Commissioner of Labor,Fred Dorrell,DEM,720164,0,0,119,119,
Tulsa,Commissioner of Labor,Brandt Dismukes,IND,720164,0,0,15,15,
Tulsa,Insurance Commissioner,Glen Mulready,REP,720164,0,0,203,203,
Tulsa,Insurance Commissioner,Kimberly Fobbs,DEM,720164,0,0,140,140,
Tulsa,Corporation Commissioner,Bob Anthony,REP,720164,0,0,211,211,
Tulsa,Corporation Commissioner,Ashley Nicole Mccray,DEM,720164,0,0,120,120,
Tulsa,Corporation Commissioner,Jackie Short,IND,720164,0,0,13,13,
Tulsa,U.S. House,Kevin Hern,REP,720164,0,0,187,187,1
Tulsa,U.S. House,Tim Gilpin,DEM,720164,0,0,167,167,1
Tulsa,State House,Carol Bush,REP,720164,0,0,214,214,70
Tulsa,State House,Jj Burnam,DEM,720164,0,0,133,133,70
Tulsa,Governor,Chris Powell,LIB,720165,0,0,10,10,
Tulsa,Governor,Kevin Stitt,REP,720165,0,0,268,268,
Tulsa,Governor,Drew Edmondson,DEM,720165,0,0,159,159,
Tulsa,Lieutenant Governor,Matt Pinnell,REP,720165,0,0,292,292,
Tulsa,Lieutenant Governor,Anastasia Pittman,DEM,720165,0,0,136,136,
Tulsa,Lieutenant Governor,Ivan Holmes,IND,720165,0,0,8,8,
Tulsa,State Auditor,John Yeutter,LIB,720165,0,0,95,95,
Tulsa,State Auditor,Cindy Byrd,REP,720165,0,0,313,313,
Tulsa,Attorney General,Mike Hunter,REP,720165,0,0,289,289,
Tulsa,Attorney General,Mark Myles,DEM,720165,0,0,144,144,
Tulsa,State Treasurer,Randy Mcdaniel,REP,720165,0,0,293,293,
Tulsa,State Treasurer,Charles De Coune,IND,720165,0,0,111,111,
Tulsa,Superintendent of Public Instruction,Joy Hofmeister,REP,720165,0,0,281,281,
Tulsa,Superintendent of Public Instruction,John Cox,DEM,720165,0,0,125,125,
Tulsa,Superintendent of Public Instruction,Larry Huff,IND,720165,0,0,25,25,
Tulsa,Commissioner of Labor,Leslie Osborn,REP,720165,0,0,277,277,
Tulsa,Commissioner of Labor,Fred Dorrell,DEM,720165,0,0,131,131,
Tulsa,Commissioner of Labor,Brandt Dismukes,IND,720165,0,0,19,19,
Tulsa,Insurance Commissioner,Glen Mulready,REP,720165,0,0,288,288,
Tulsa,Insurance Commissioner,Kimberly Fobbs,DEM,720165,0,0,138,138,
Tulsa,Corporation Commissioner,Bob Anthony,REP,720165,0,0,284,284,
Tulsa,Corporation Commissioner,Ashley Nicole Mccray,DEM,720165,0,0,127,127,
Tulsa,Corporation Commissioner,Jackie Short,IND,720165,0,0,16,16,
Tulsa,U.S. House,Kevin Hern,REP,720165,0,0,278,278,1
Tulsa,U.S. House,Tim Gilpin,DEM,720165,0,0,154,154,1
Tulsa,State House,Carol Bush,REP,720165,0,0,294,294,70
Tulsa,State House,Jj Burnam,DEM,720165,0,0,136,136,70
Tulsa,Governor,Chris Powell,LIB,720166,0,0,37,37,
Tulsa,Governor,Kevin Stitt,REP,720166,0,0,624,624,
Tulsa,Governor,Drew Edmondson,DEM,720166,0,0,429,429,
Tulsa,Lieutenant Governor,Matt Pinnell,REP,720166,0,0,739,739,
Tulsa,Lieutenant Governor,Anastasia Pittman,DEM,720166,0,0,308,308,
Tulsa,Lieutenant Governor,Ivan Holmes,IND,720166,0,0,39,39,
Tulsa,State Auditor,John Yeutter,LIB,720166,0,0,212,212,
Tulsa,State Auditor,Cindy Byrd,REP,720166,0,0,789,789,
Tulsa,Attorney General,Mike Hunter,REP,720166,0,0,743,743,
Tulsa,Attorney General,Mark Myles,DEM,720166,0,0,337,337,
Tulsa,State Treasurer,Randy Mcdaniel,REP,720166,0,0,746,746,
Tulsa,State Treasurer,Charles De Coune,IND,720166,0,0,260,260,
Tulsa,Superintendent of Public Instruction,Joy Hofmeister,REP,720166,0,0,709,709,
Tulsa,Superintendent of Public Instruction,John Cox,DEM,720166,0,0,297,297,
Tulsa,Superintendent of Public Instruction,Larry Huff,IND,720166,0,0,69,69,
Tulsa,Commissioner of Labor,Leslie Osborn,REP,720166,0,0,688,688,
Tulsa,Commissioner of Labor,Fred Dorrell,DEM,720166,0,0,304,304,
Tulsa,Commissioner of Labor,Brandt Dismukes,IND,720166,0,0,64,64,
Tulsa,Insurance Commissioner,Glen Mulready,REP,720166,0,0,710,710,
Tulsa,Insurance Commissioner,Kimberly Fobbs,DEM,720166,0,0,353,353,
Tulsa,Corporation Commissioner,Bob Anthony,REP,720166,0,0,713,713,
Tulsa,Corporation Commissioner,Ashley Nicole Mccray,DEM,720166,0,0,300,300,
Tulsa,Corporation Commissioner,Jackie Short,IND,720166,0,0,54,54,
Tulsa,U.S. House,Kevin Hern,REP,720166,0,0,698,698,1
Tulsa,U.S. House,Tim Gilpin,DEM,720166,0,0,381,381,1
Tulsa,State House,Jeff Boatman,REP,720166,0,0,686,686,67
Tulsa,State House,Carly Hotvedt,DEM,720166,0,0,379,379,67
Tulsa,Governor,Chris Powell,LIB,720167,0,0,8,8,
Tulsa,Governor,Kevin Stitt,REP,720167,0,0,678,678,
Tulsa,Governor,Drew Edmondson,DEM,720167,0,0,268,268,
Tulsa,Lieutenant Governor,Matt Pinnell,REP,720167,0,0,759,759,
Tulsa,Lieutenant Governor,Anastasia Pittman,DEM,720167,0,0,179,179,
Tulsa,Lieutenant Governor,Ivan Holmes,IND,720167,0,0,11,11,
Tulsa,State Auditor,John Yeutter,LIB,720167,0,0,114,114,
Tulsa,State Auditor,Cindy Byrd,REP,720167,0,0,796,796,
Tulsa,Attorney General,Mike Hunter,REP,720167,0,0,754,754,
Tulsa,Attorney General,Mark Myles,DEM,720167,0,0,189,189,
Tulsa,State Treasurer,Randy Mcdaniel,REP,720167,0,0,762,762,
Tulsa,State Treasurer,Charles De Coune,IND,720167,0,0,143,143,
Tulsa,Superintendent of Public Instruction,Joy Hofmeister,REP,720167,0,0,735,735,
Tulsa,Superintendent of Public Instruction,John Cox,DEM,720167,0,0,174,174,
Tulsa,Superintendent of Public Instruction,Larry Huff,IND,720167,0,0,40,40,
Tulsa,Commissioner of Labor,Leslie Osborn,REP,720167,0,0,718,718,
Tulsa,Commissioner of Labor,Fred Dorrell,DEM,720167,0,0,178,178,
Tulsa,Commissioner of Labor,Brandt Dismukes,IND,720167,0,0,33,33,
Tulsa,Insurance Commissioner,Glen Mulready,REP,720167,0,0,751,751,
Tulsa,Insurance Commissioner,Kimberly Fobbs,DEM,720167,0,0,186,186,
Tulsa,Corporation Commissioner,Bob Anthony,REP,720167,0,0,746,746,
Tulsa,Corporation Commissioner,Ashley Nicole Mccray,DEM,720167,0,0,176,176,
Tulsa,Corporation Commissioner,Jackie Short,IND,720167,0,0,18,18,
Tulsa,U.S. House,Kevin Hern,REP,720167,0,0,722,722,1
Tulsa,U.S. House,Tim Gilpin,DEM,720167,0,0,230,230,1
Tulsa,State House,Sheila Dills,REP,720167,0,0,733,733,69
Tulsa,State House,Andy Richardson,DEM,720167,0,0,209,209,69
Tulsa,Governor,Chris Powell,LIB,720168,0,0,21,21,
Tulsa,Governor,Kevin Stitt,REP,720168,0,0,423,423,
Tulsa,Governor,Drew Edmondson,DEM,720168,0,0,372,372,
Tulsa,Lieutenant Governor,Matt Pinnell,REP,720168,0,0,516,516,
Tulsa,Lieutenant Governor,Anastasia Pittman,DEM,720168,0,0,270,270,
Tulsa,Lieutenant Governor,Ivan Holmes,IND,720168,0,0,22,22,
Tulsa,State Auditor,John Yeutter,LIB,720168,0,0,180,180,
Tulsa,State Auditor,Cindy Byrd,REP,720168,0,0,568,568,
Tulsa,Attorney General,Mike Hunter,REP,720168,0,0,522,522,
Tulsa,Attorney General,Mark Myles,DEM,720168,0,0,286,286,
Tulsa,State Treasurer,Randy Mcdaniel,REP,720168,0,0,533,533,
Tulsa,State Treasurer,Charles De Coune,IND,720168,0,0,216,216,
Tulsa,Superintendent of Public Instruction,Joy Hofmeister,REP,720168,0,0,484,484,
Tulsa,Superintendent of Public Instruction,John Cox,DEM,720168,0,0,267,267,
Tulsa,Superintendent of Public Instruction,Larry Huff,IND,720168,0,0,58,58,
Tulsa,Commissioner of Labor,Leslie Osborn,REP,720168,0,0,491,491,
Tulsa,Commissioner of Labor,Fred Dorrell,DEM,720168,0,0,270,270,
Tulsa,Commissioner of Labor,Brandt Dismukes,IND,720168,0,0,33,33,
Tulsa,Insurance Commissioner,Glen Mulready,REP,720168,0,0,502,502,
Tulsa,Insurance Commissioner,Kimberly Fobbs,DEM,720168,0,0,301,301,
Tulsa,Corporation Commissioner,Bob Anthony,REP,720168,0,0,492,492,
Tulsa,Corporation Commissioner,Ashley Nicole Mccray,DEM,720168,0,0,269,269,
Tulsa,Corporation Commissioner,Jackie Short,IND,720168,0,0,45,45,
Tulsa,U.S. House,Kevin Hern,REP,720168,0,0,480,480,1
Tulsa,U.S. House,Tim Gilpin,DEM,720168,0,0,333,333,1
Tulsa,State House,Dan Hicks,REP,720168,0,0,430,430,79
Tulsa,State House,Melissa Provenzano,DEM,720168,0,0,379,379,79
Tulsa,Governor,Chris Powell,LIB,720169,0,0,22,22,
Tulsa,Governor,Kevin Stitt,REP,720169,0,0,292,292,
Tulsa,Governor,Drew Edmondson,DEM,720169,0,0,327,327,
Tulsa,Lieutenant Governor,Matt Pinnell,REP,720169,0,0,349,349,
Tulsa,Lieutenant Governor,Anastasia Pittman,DEM,720169,0,0,259,259,
Tulsa,Lieutenant Governor,Ivan Holmes,IND,720169,0,0,25,25,
Tulsa,State Auditor,John Yeutter,LIB,720169,0,0,162,162,
Tulsa,State Auditor,Cindy Byrd,REP,720169,0,0,390,390,
Tulsa,Attorney General,Mike Hunter,REP,720169,0,0,342,342,
Tulsa,Attorney General,Mark Myles,DEM,720169,0,0,283,283,
Tulsa,State Treasurer,Randy Mcdaniel,REP,720169,0,0,354,354,
Tulsa,State Treasurer,Charles De Coune,IND,720169,0,0,192,192,
Tulsa,Superintendent of Public Instruction,Joy Hofmeister,REP,720169,0,0,323,323,
Tulsa,Superintendent of Public Instruction,John Cox,DEM,720169,0,0,256,256,
Tulsa,Superintendent of Public Instruction,Larry Huff,IND,720169,0,0,50,50,
Tulsa,Commissioner of Labor,Leslie Osborn,REP,720169,0,0,338,338,
Tulsa,Commissioner of Labor,Fred Dorrell,DEM,720169,0,0,256,256,
Tulsa,Commissioner of Labor,Brandt Dismukes,IND,720169,0,0,32,32,
Tulsa,Insurance Commissioner,Glen Mulready,REP,720169,0,0,328,328,
Tulsa,Insurance Commissioner,Kimberly Fobbs,DEM,720169,0,0,289,289,
Tulsa,Corporation Commissioner,Bob Anthony,REP,720169,0,0,324,324,
Tulsa,Corporation Commissioner,Ashley Nicole Mccray,DEM,720169,0,0,255,255,
Tulsa,Corporation Commissioner,Jackie Short,IND,720169,0,0,40,40,
Tulsa,U.S. House,Kevin Hern,REP,720169,0,0,332,332,1
Tulsa,U.S. House,Tim Gilpin,DEM,720169,0,0,295,295,1
Tulsa,State House,Dan Hicks,REP,720169,0,0,293,293,79
Tulsa,State House,Melissa Provenzano,DEM,720169,0,0,330,330,79
Tulsa,Governor,Chris Powell,LIB,720170,0,0,8,8,
Tulsa,Governor,Kevin Stitt,REP,720170,0,0,406,406,
Tulsa,Governor,Drew Edmondson,DEM,720170,0,0,146,146,
Tulsa,Lieutenant Governor,Matt Pinnell,REP,720170,0,0,461,461,
Tulsa,Lieutenant Governor,Anastasia Pittman,DEM,720170,0,0,87,87,
Tulsa,Lieutenant Governor,Ivan Holmes,IND,720170,0,0,12,12,
Tulsa,State Auditor,John Yeutter,LIB,720170,0,0,74,74,
Tulsa,State Auditor,Cindy Byrd,REP,720170,0,0,462,462,
Tulsa,Attorney General,Mike Hunter,REP,720170,0,0,450,450,
Tulsa,Attorney General,Mark Myles,DEM,720170,0,0,104,104,
Tulsa,State Treasurer,Randy Mcdaniel,REP,720170,0,0,459,459,
Tulsa,State Treasurer,Charles De Coune,IND,720170,0,0,73,73,
Tulsa,Superintendent of Public Instruction,Joy Hofmeister,REP,720170,0,0,427,427,
Tulsa,Superintendent of Public Instruction,John Cox,DEM,720170,0,0,97,97,
Tulsa,Superintendent of Public Instruction,Larry Huff,IND,720170,0,0,34,34,
Tulsa,Commissioner of Labor,Leslie Osborn,REP,720170,0,0,446,446,
Tulsa,Commissioner of Labor,Fred Dorrell,DEM,720170,0,0,91,91,
Tulsa,Commissioner of Labor,Brandt Dismukes,IND,720170,0,0,18,18,
Tulsa,Insurance Commissioner,Glen Mulready,REP,720170,0,0,458,458,
Tulsa,Insurance Commissioner,Kimberly Fobbs,DEM,720170,0,0,97,97,
Tulsa,Corporation Commissioner,Bob Anthony,REP,720170,0,0,453,453,
Tulsa,Corporation Commissioner,Ashley Nicole Mccray,DEM,720170,0,0,77,77,
Tulsa,Corporation Commissioner,Jackie Short,IND,720170,0,0,24,24,
Tulsa,U.S. House,Kevin Hern,REP,720170,0,0,442,442,1
Tulsa,U.S. House,Tim Gilpin,DEM,720170,0,0,118,118,1
Tulsa,State House,Jeff Boatman,REP,720170,0,0,441,441,67
Tulsa,State House,Carly Hotvedt,DEM,720170,0,0,109,109,67
Tulsa,Governor,Chris Powell,LIB,720171,0,0,13,13,
Tulsa,Governor,Kevin Stitt,REP,720171,0,0,299,299,
Tulsa,Governor,Drew Edmondson,DEM,720171,0,0,260,260,
Tulsa,Lieutenant Governor,Matt Pinnell,REP,720171,0,0,358,358,
Tulsa,Lieutenant Governor,Anastasia Pittman,DEM,720171,0,0,196,196,
Tulsa,Lieutenant Governor,Ivan Holmes,IND,720171,0,0,13,13,
Tulsa,State Auditor,John Yeutter,LIB,720171,0,0,123,123,
Tulsa,State Auditor,Cindy Byrd,REP,720171,0,0,391,391,
Tulsa,Attorney General,Mike Hunter,REP,720171,0,0,359,359,
Tulsa,Attorney General,Mark Myles,DEM,720171,0,0,205,205,
Tulsa,State Treasurer,Randy Mcdaniel,REP,720171,0,0,377,377,
Tulsa,State Treasurer,Charles De Coune,IND,720171,0,0,134,134,
Tulsa,Superintendent of Public Instruction,Joy Hofmeister,REP,720171,0,0,377,377,
Tulsa,Superintendent of Public Instruction,John Cox,DEM,720171,0,0,159,159,
Tulsa,Superintendent of Public Instruction,Larry Huff,IND,720171,0,0,26,26,
Tulsa,Commissioner of Labor,Leslie Osborn,REP,720171,0,0,346,346,
Tulsa,Commissioner of Labor,Fred Dorrell,DEM,720171,0,0,180,180,
Tulsa,Commissioner of Labor,Brandt Dismukes,IND,720171,0,0,26,26,
Tulsa,Insurance Commissioner,Glen Mulready,REP,720171,0,0,345,345,
Tulsa,Insurance Commissioner,Kimberly Fobbs,DEM,720171,0,0,208,208,
Tulsa,Corporation Commissioner,Bob Anthony,REP,720171,0,0,350,350,
Tulsa,Corporation Commissioner,Ashley Nicole Mccray,DEM,720171,0,0,178,178,
Tulsa,Corporation Commissioner,Jackie Short,IND,720171,0,0,31,31,
Tulsa,U.S. House,Kevin Hern,REP,720171,0,0,333,333,1
Tulsa,U.S. House,Tim Gilpin,DEM,720171,0,0,233,233,1
Tulsa,State House,Sheila Dills,REP,720171,0,0,349,349,69
Tulsa,State House,Andy Richardson,DEM,720171,0,0,212,212,69
Tulsa,Governor,Chris Powell,LIB,720172,0,0,16,16,
Tulsa,Governor,Kevin Stitt,REP,720172,0,0,392,392,
Tulsa,Governor,Drew Edmondson,DEM,720172,0,0,372,372,
Tulsa,Lieutenant Governor,Matt Pinnell,REP,720172,0,0,461,461,
Tulsa,Lieutenant Governor,Anastasia Pittman,DEM,720172,0,0,291,291,
Tulsa,Lieutenant Governor,Ivan Holmes,IND,720172,0,0,20,20,
Tulsa,State Auditor,John Yeutter,LIB,720172,0,0,166,166,
Tulsa,State Auditor,Cindy Byrd,REP,720172,0,0,531,531,
Tulsa,Attorney General,Mike Hunter,REP,720172,0,0,468,468,
Tulsa,Attorney General,Mark Myles,DEM,720172,0,0,299,299,
Tulsa,State Treasurer,Randy Mcdaniel,REP,720172,0,0,497,497,
Tulsa,State Treasurer,Charles De Coune,IND,720172,0,0,201,201,
Tulsa,Superintendent of Public Instruction,Joy Hofmeister,REP,720172,0,0,443,443,
Tulsa,Superintendent of Public Instruction,John Cox,DEM,720172,0,0,276,276,
Tulsa,Superintendent of Public Instruction,Larry Huff,IND,720172,0,0,49,49,
Tulsa,Commissioner of Labor,Leslie Osborn,REP,720172,0,0,452,452,
Tulsa,Commissioner of Labor,Fred Dorrell,DEM,720172,0,0,278,278,
Tulsa,Commissioner of Labor,Brandt Dismukes,IND,720172,0,0,28,28,
Tulsa,Insurance Commissioner,Glen Mulready,REP,720172,0,0,459,459,
Tulsa,Insurance Commissioner,Kimberly Fobbs,DEM,720172,0,0,305,305,
Tulsa,Corporation Commissioner,Bob Anthony,REP,720172,0,0,464,464,
Tulsa,Corporation Commissioner,Ashley Nicole Mccray,DEM,720172,0,0,271,271,
Tulsa,Corporation Commissioner,Jackie Short,IND,720172,0,0,35,35,
Tulsa,U.S. House,Kevin Hern,REP,720172,0,0,445,445,1
Tulsa,U.S. House,Tim Gilpin,DEM,720172,0,0,328,328,1
Tulsa,State House,Dan Hicks,REP,720172,0,0,403,403,79
Tulsa,State House,Melissa Provenzano,DEM,720172,0,0,366,366,79
Tulsa,Governor,Chris Powell,LIB,720173,0,0,24,24,
Tulsa,Governor,Kevin Stitt,REP,720173,0,0,494,494,
Tulsa,Governor,Drew Edmondson,DEM,720173,0,0,385,385,
Tulsa,Lieutenant Governor,Matt Pinnell,REP,720173,0,0,597,597,
Tulsa,Lieutenant Governor,Anastasia Pittman,DEM,720173,0,0,286,286,
Tulsa,Lieutenant Governor,Ivan Holmes,IND,720173,0,0,17,17,
Tulsa,State Auditor,John Yeutter,LIB,720173,0,0,192,192,
Tulsa,State Auditor,Cindy Byrd,REP,720173,0,0,628,628,
Tulsa,Attorney General,Mike Hunter,REP,720173,0,0,597,597,
Tulsa,Attorney General,Mark Myles,DEM,720173,0,0,293,293,
Tulsa,State Treasurer,Randy Mcdaniel,REP,720173,0,0,610,610,
Tulsa,State Treasurer,Charles De Coune,IND,720173,0,0,203,203,
Tulsa,Superintendent of Public Instruction,Joy Hofmeister,REP,720173,0,0,594,594,
Tulsa,Superintendent of Public Instruction,John Cox,DEM,720173,0,0,249,249,
Tulsa,Superintendent of Public Instruction,Larry Huff,IND,720173,0,0,51,51,
Tulsa,Commissioner of Labor,Leslie Osborn,REP,720173,0,0,561,561,
Tulsa,Commissioner of Labor,Fred Dorrell,DEM,720173,0,0,280,280,
Tulsa,Commissioner of Labor,Brandt Dismukes,IND,720173,0,0,26,26,
Tulsa,Insurance Commissioner,Glen Mulready,REP,720173,0,0,564,564,
Tulsa,Insurance Commissioner,Kimberly Fobbs,DEM,720173,0,0,303,303,
Tulsa,Corporation Commissioner,Bob Anthony,REP,720173,0,0,581,581,
Tulsa,Corporation Commissioner,Ashley Nicole Mccray,DEM,720173,0,0,264,264,
Tulsa,Corporation Commissioner,Jackie Short,IND,720173,0,0,32,32,
Tulsa,U.S. House,Kevin Hern,REP,720173,0,0,552,552,1
Tulsa,U.S. House,Tim Gilpin,DEM,720173,0,0,343,343,1
Tulsa,State House,Sheila Dills,REP,720173,0,0,578,578,69
Tulsa,State House,Andy Richardson,DEM,720173,0,0,308,308,69
Tulsa,Governor,Chris Powell,LIB,720174,0,0,0,0,
Tulsa,Governor,Kevin Stitt,REP,720174,0,0,0,0,
Tulsa,Governor,Drew Edmondson,DEM,720174,0,0,0,0,
Tulsa,Lieutenant Governor,Matt Pinnell,REP,720174,0,0,0,0,
Tulsa,Lieutenant Governor,Anastasia Pittman,DEM,720174,0,0,0,0,
Tulsa,Lieutenant Governor,Ivan Holmes,IND,720174,0,0,0,0,
Tulsa,State Auditor,John Yeutter,LIB,720174,0,0,0,0,
Tulsa,State Auditor,Cindy Byrd,REP,720174,0,0,0,0,
Tulsa,Attorney General,Mike Hunter,REP,720174,0,0,0,0,
Tulsa,Attorney General,Mark Myles,DEM,720174,0,0,0,0,
Tulsa,State Treasurer,Randy Mcdaniel,REP,720174,0,0,0,0,
Tulsa,State Treasurer,Charles De Coune,IND,720174,0,0,0,0,
Tulsa,Superintendent of Public Instruction,Joy Hofmeister,REP,720174,0,0,0,0,
Tulsa,Superintendent of Public Instruction,John Cox,DEM,720174,0,0,0,0,
Tulsa,Superintendent of Public Instruction,Larry Huff,IND,720174,0,0,0,0,
Tulsa,Commissioner of Labor,Leslie Osborn,REP,720174,0,0,0,0,
Tulsa,Commissioner of Labor,Fred Dorrell,DEM,720174,0,0,0,0,
Tulsa,Commissioner of Labor,Brandt Dismukes,IND,720174,0,0,0,0,
Tulsa,Insurance Commissioner,Glen Mulready,REP,720174,0,0,0,0,
Tulsa,Insurance Commissioner,Kimberly Fobbs,DEM,720174,0,0,0,0,
Tulsa,Corporation Commissioner,Bob Anthony,REP,720174,0,0,0,0,
Tulsa,Corporation Commissioner,Ashley Nicole Mccray,DEM,720174,0,0,0,0,
Tulsa,Corporation Commissioner,Jackie Short,IND,720174,0,0,0,0,
Tulsa,U.S. House,Kevin Hern,REP,720174,0,0,0,0,1
Tulsa,U.S. House,Tim Gilpin,DEM,720174,0,0,0,0,1
Tulsa,State House,Todd Blackburn,REP,720174,0,0,0,0,77
Tulsa,State House,John Waldron,DEM,720174,0,0,0,0,77
Tulsa,Governor,Chris Powell,LIB,720175,0,0,0,0,
Tulsa,Governor,Kevin Stitt,REP,720175,0,0,0,0,
Tulsa,Governor,Drew Edmondson,DEM,720175,0,0,0,0,
Tulsa,Lieutenant Governor,Matt Pinnell,REP,720175,0,0,0,0,
Tulsa,Lieutenant Governor,Anastasia Pittman,DEM,720175,0,0,0,0,
Tulsa,Lieutenant Governor,Ivan Holmes,IND,720175,0,0,0,0,
Tulsa,State Auditor,John Yeutter,LIB,720175,0,0,0,0,
Tulsa,State Auditor,Cindy Byrd,REP,720175,0,0,0,0,
Tulsa,Attorney General,Mike Hunter,REP,720175,0,0,0,0,
Tulsa,Attorney General,Mark Myles,DEM,720175,0,0,0,0,
Tulsa,State Treasurer,Randy Mcdaniel,REP,720175,0,0,0,0,
Tulsa,State Treasurer,Charles De Coune,IND,720175,0,0,0,0,
Tulsa,Superintendent of Public Instruction,Joy Hofmeister,REP,720175,0,0,0,0,
Tulsa,Superintendent of Public Instruction,John Cox,DEM,720175,0,0,0,0,
Tulsa,Superintendent of Public Instruction,Larry Huff,IND,720175,0,0,0,0,
Tulsa,Commissioner of Labor,Leslie Osborn,REP,720175,0,0,0,0,
Tulsa,Commissioner of Labor,Fred Dorrell,DEM,720175,0,0,0,0,
Tulsa,Commissioner of Labor,Brandt Dismukes,IND,720175,0,0,0,0,
Tulsa,Insurance Commissioner,Glen Mulready,REP,720175,0,0,0,0,
Tulsa,Insurance Commissioner,Kimberly Fobbs,DEM,720175,0,0,0,0,
Tulsa,Corporation Commissioner,Bob Anthony,REP,720175,0,0,0,0,
Tulsa,Corporation Commissioner,Ashley Nicole Mccray,DEM,720175,0,0,0,0,
Tulsa,Corporation Commissioner,Jackie Short,IND,720175,0,0,0,0,
Tulsa,U.S. House,Kevin Hern,REP,720175,0,0,0,0,1
Tulsa,U.S. House,Tim Gilpin,DEM,720175,0,0,0,0,1
Tulsa,State House,Todd Blackburn,REP,720175,0,0,0,0,77
Tulsa,State House,John Waldron,DEM,720175,0,0,0,0,77
Tulsa,Governor,Chris Powell,LIB,720176,0,0,0,0,
Tulsa,Governor,Kevin Stitt,REP,720176,0,0,0,0,
Tulsa,Governor,Drew Edmondson,DEM,720176,0,0,0,0,
Tulsa,Lieutenant Governor,Matt Pinnell,REP,720176,0,0,0,0,
Tulsa,Lieutenant Governor,Anastasia Pittman,DEM,720176,0,0,0,0,
Tulsa,Lieutenant Governor,Ivan Holmes,IND,720176,0,0,0,0,
Tulsa,State Auditor,John Yeutter,LIB,720176,0,0,0,0,
Tulsa,State Auditor,Cindy Byrd,REP,720176,0,0,0,0,
Tulsa,Attorney General,Mike Hunter,REP,720176,0,0,0,0,
Tulsa,Attorney General,Mark Myles,DEM,720176,0,0,0,0,
Tulsa,State Treasurer,Randy Mcdaniel,REP,720176,0,0,0,0,
Tulsa,State Treasurer,Charles De Coune,IND,720176,0,0,0,0,
Tulsa,Superintendent of Public Instruction,Joy Hofmeister,REP,720176,0,0,0,0,
Tulsa,Superintendent of Public Instruction,John Cox,DEM,720176,0,0,0,0,
Tulsa,Superintendent of Public Instruction,Larry Huff,IND,720176,0,0,0,0,
Tulsa,Commissioner of Labor,Leslie Osborn,REP,720176,0,0,0,0,
Tulsa,Commissioner of Labor,Fred Dorrell,DEM,720176,0,0,0,0,
Tulsa,Commissioner of Labor,Brandt Dismukes,IND,720176,0,0,0,0,
Tulsa,Insurance Commissioner,Glen Mulready,REP,720176,0,0,0,0,
Tulsa,Insurance Commissioner,Kimberly Fobbs,DEM,720176,0,0,0,0,
Tulsa,Corporation Commissioner,Bob Anthony,REP,720176,0,0,0,0,
Tulsa,Corporation Commissioner,Ashley Nicole Mccray,DEM,720176,0,0,0,0,
Tulsa,Corporation Commissioner,Jackie Short,IND,720176,0,0,0,0,
Tulsa,U.S. House,Kevin Hern,REP,720176,0,0,0,0,1
Tulsa,U.S. House,Tim Gilpin,DEM,720176,0,0,0,0,1
Tulsa,State House,Gene Bell,LIB,720176,0,0,0,0,78
Tulsa,State House,Paul Royse,REP,720176,0,0,0,0,78
Tulsa,State House,Meloyde Blancett,DEM,720176,0,0,0,0,78
Tulsa,Governor,Chris Powell,LIB,720351,0,0,56,56,
Tulsa,Governor,Kevin Stitt,REP,720351,0,0,1048,1048,
Tulsa,Governor,Drew Edmondson,DEM,720351,0,0,535,535,
Tulsa,Lieutenant Governor,Matt Pinnell,REP,720351,0,0,1184,1184,
Tulsa,Lieutenant Governor,Anastasia Pittman,DEM,720351,0,0,395,395,
Tulsa,Lieutenant Governor,Ivan Holmes,IND,720351,0,0,48,48,
Tulsa,State Auditor,John Yeutter,LIB,720351,0,0,294,294,
Tulsa,State Auditor,Cindy Byrd,REP,720351,0,0,1251,1251,
Tulsa,Attorney General,Mike Hunter,REP,720351,0,0,1196,1196,
Tulsa,Attorney General,Mark Myles,DEM,720351,0,0,420,420,
Tulsa,State Treasurer,Randy Mcdaniel,REP,720351,0,0,1201,1201,
Tulsa,State Treasurer,Charles De Coune,IND,720351,0,0,344,344,
Tulsa,Superintendent of Public Instruction,Joy Hofmeister,REP,720351,0,0,1088,1088,
Tulsa,Superintendent of Public Instruction,John Cox,DEM,720351,0,0,405,405,
Tulsa,Superintendent of Public Instruction,Larry Huff,IND,720351,0,0,125,125,
Tulsa,Commissioner of Labor,Leslie Osborn,REP,720351,0,0,1140,1140,
Tulsa,Commissioner of Labor,Fred Dorrell,DEM,720351,0,0,386,386,
Tulsa,Commissioner of Labor,Brandt Dismukes,IND,720351,0,0,79,79,
Tulsa,Insurance Commissioner,Glen Mulready,REP,720351,0,0,1154,1154,
Tulsa,Insurance Commissioner,Kimberly Fobbs,DEM,720351,0,0,450,450,
Tulsa,Corporation Commissioner,Bob Anthony,REP,720351,0,0,1109,1109,
Tulsa,Corporation Commissioner,Ashley Nicole Mccray,DEM,720351,0,0,398,398,
Tulsa,Corporation Commissioner,Jackie Short,IND,720351,0,0,95,95,
Tulsa,U.S. House,Kevin Hern,REP,720351,0,0,1164,1164,1
Tulsa,U.S. House,Tim Gilpin,DEM,720351,0,0,457,457,1
Tulsa,State House,Sheila Dills,REP,720351,0,0,1187,1187,69
Tulsa,State House,Andy Richardson,DEM,720351,0,0,428,428,69
Tulsa,Governor,Chris Powell,LIB,720352,0,0,22,22,
Tulsa,Governor,Kevin Stitt,REP,720352,0,0,549,549,
Tulsa,Governor,Drew Edmondson,DEM,720352,0,0,172,172,
Tulsa,Lieutenant Governor,Matt Pinnell,REP,720352,0,0,589,589,
Tulsa,Lieutenant Governor,Anastasia Pittman,DEM,720352,0,0,131,131,
Tulsa,Lieutenant Governor,Ivan Holmes,IND,720352,0,0,15,15,
Tulsa,State Auditor,John Yeutter,LIB,720352,0,0,112,112,
Tulsa,State Auditor,Cindy Byrd,REP,720352,0,0,583,583,
Tulsa,Attorney General,Mike Hunter,REP,720352,0,0,587,587,
Tulsa,Attorney General,Mark Myles,DEM,720352,0,0,145,145,
Tulsa,State Treasurer,Randy Mcdaniel,REP,720352,0,0,580,580,
Tulsa,State Treasurer,Charles De Coune,IND,720352,0,0,118,118,
Tulsa,Superintendent of Public Instruction,Joy Hofmeister,REP,720352,0,0,517,517,
Tulsa,Superintendent of Public Instruction,John Cox,DEM,720352,0,0,156,156,
Tulsa,Superintendent of Public Instruction,Larry Huff,IND,720352,0,0,64,64,
Tulsa,Commissioner of Labor,Leslie Osborn,REP,720352,0,0,548,548,
Tulsa,Commissioner of Labor,Fred Dorrell,DEM,720352,0,0,138,138,
Tulsa,Commissioner of Labor,Brandt Dismukes,IND,720352,0,0,40,40,
Tulsa,Insurance Commissioner,Glen Mulready,REP,720352,0,0,578,578,
Tulsa,Insurance Commissioner,Kimberly Fobbs,DEM,720352,0,0,154,154,
Tulsa,Corporation Commissioner,Bob Anthony,REP,720352,0,0,556,556,
Tulsa,Corporation Commissioner,Ashley Nicole Mccray,DEM,720352,0,0,134,134,
Tulsa,Corporation Commissioner,Jackie Short,IND,720352,0,0,43,43,
Tulsa,U.S. House,Kevin Hern,REP,720352,0,0,597,597,1
Tulsa,U.S. House,Tim Gilpin,DEM,720352,0,0,138,138,1
Tulsa,Governor,Chris Powell,LIB,720353,0,0,3,3,
Tulsa,Governor,Kevin Stitt,REP,720353,0,0,120,120,
Tulsa,Governor,Drew Edmondson,DEM,720353,0,0,33,33,
Tulsa,Lieutenant Governor,Matt Pinnell,REP,720353,0,0,128,128,
Tulsa,Lieutenant Governor,Anastasia Pittman,DEM,720353,0,0,22,22,
Tulsa,Lieutenant Governor,Ivan Holmes,IND,720353,0,0,3,3,
Tulsa,State Auditor,John Yeutter,LIB,720353,0,0,18,18,
Tulsa,State Auditor,Cindy Byrd,REP,720353,0,0,128,128,
Tulsa,Attorney General,Mike Hunter,REP,720353,0,0,132,132,
Tulsa,Attorney General,Mark Myles,DEM,720353,0,0,23,23,
Tulsa,State Treasurer,Randy Mcdaniel,REP,720353,0,0,132,132,
Tulsa,State Treasurer,Charles De Coune,IND,720353,0,0,14,14,
Tulsa,Superintendent of Public Instruction,Joy Hofmeister,REP,720353,0,0,129,129,
Tulsa,Superintendent of Public Instruction,John Cox,DEM,720353,0,0,22,22,
Tulsa,Superintendent of Public Instruction,Larry Huff,IND,720353,0,0,2,2,
Tulsa,Commissioner of Labor,Leslie Osborn,REP,720353,0,0,118,118,
Tulsa,Commissioner of Labor,Fred Dorrell,DEM,720353,0,0,32,32,
Tulsa,Commissioner of Labor,Brandt Dismukes,IND,720353,0,0,3,3,
Tulsa,Insurance Commissioner,Glen Mulready,REP,720353,0,0,126,126,
Tulsa,Insurance Commissioner,Kimberly Fobbs,DEM,720353,0,0,28,28,
Tulsa,Corporation Commissioner,Bob Anthony,REP,720353,0,0,126,126,
Tulsa,Corporation Commissioner,Ashley Nicole Mccray,DEM,720353,0,0,25,25,
Tulsa,Corporation Commissioner,Jackie Short,IND,720353,0,0,4,4,
Tulsa,U.S. House,Kevin Hern,REP,720353,0,0,130,130,1
Tulsa,U.S. House,Tim Gilpin,DEM,720353,0,0,25,25,1
Tulsa,State House,Scott Fetgatter,REP,720353,0,0,127,127,16
Tulsa,State House,Chandler Torbett,DEM,720353,0,0,24,24,16
Tulsa,State House,James Delso,IND,720353,0,0,0,0,16
Tulsa,Governor,Chris Powell,LIB,720354,0,0,5,5,
Tulsa,Governor,Kevin Stitt,REP,720354,0,0,96,96,
Tulsa,Governor,Drew Edmondson,DEM,720354,0,0,35,35,
Tulsa,Lieutenant Governor,Matt Pinnell,REP,720354,0,0,103,103,
Tulsa,Lieutenant Governor,Anastasia Pittman,DEM,720354,0,0,25,25,
Tulsa,Lieutenant Governor,Ivan Holmes,IND,720354,0,0,7,7,
Tulsa,State Auditor,John Yeutter,LIB,720354,0,0,21,21,
Tulsa,State Auditor,Cindy Byrd,REP,720354,0,0,105,105,
Tulsa,Attorney General,Mike Hunter,REP,720354,0,0,109,109,
Tulsa,Attorney General,Mark Myles,DEM,720354,0,0,26,26,
Tulsa,State Treasurer,Randy Mcdaniel,REP,720354,0,0,102,102,
Tulsa,State Treasurer,Charles De Coune,IND,720354,0,0,24,24,
Tulsa,Superintendent of Public Instruction,Joy Hofmeister,REP,720354,0,0,94,94,
Tulsa,Superintendent of Public Instruction,John Cox,DEM,720354,0,0,29,29,
Tulsa,Superintendent of Public Instruction,Larry Huff,IND,720354,0,0,12,12,
Tulsa,Commissioner of Labor,Leslie Osborn,REP,720354,0,0,100,100,
Tulsa,Commissioner of Labor,Fred Dorrell,DEM,720354,0,0,26,26,
Tulsa,Commissioner of Labor,Brandt Dismukes,IND,720354,0,0,8,8,
Tulsa,Insurance Commissioner,Glen Mulready,REP,720354,0,0,101,101,
Tulsa,Insurance Commissioner,Kimberly Fobbs,DEM,720354,0,0,31,31,
Tulsa,Corporation Commissioner,Bob Anthony,REP,720354,0,0,102,102,
Tulsa,Corporation Commissioner,Ashley Nicole Mccray,DEM,720354,0,0,24,24,
Tulsa,Corporation Commissioner,Jackie Short,IND,720354,0,0,7,7,
Tulsa,U.S. House,Kevin Hern,REP,720354,0,0,103,103,1
Tulsa,U.S. House,Tim Gilpin,DEM,720354,0,0,30,30,1
Tulsa,State House,Stan May,REP,720354,0,0,102,102,80
Tulsa,State House,Janice Graham,DEM,720354,0,0,28,28,80
Tulsa,Governor,Chris Powell,LIB,720355,0,0,6,6,
Tulsa,Governor,Kevin Stitt,REP,720355,0,0,117,117,
Tulsa,Governor,Drew Edmondson,DEM,720355,0,0,58,58,
Tulsa,Lieutenant Governor,Matt Pinnell,REP,720355,0,0,126,126,
Tulsa,Lieutenant Governor,Anastasia Pittman,DEM,720355,0,0,51,51,
Tulsa,Lieutenant Governor,Ivan Holmes,IND,720355,0,0,3,3,
Tulsa,State Auditor,John Yeutter,LIB,720355,0,0,34,34,
Tulsa,State Auditor,Cindy Byrd,REP,720355,0,0,134,134,
Tulsa,Attorney General,Mike Hunter,REP,720355,0,0,127,127,
Tulsa,Attorney General,Mark Myles,DEM,720355,0,0,54,54,
Tulsa,State Treasurer,Randy Mcdaniel,REP,720355,0,0,130,130,
Tulsa,State Treasurer,Charles De Coune,IND,720355,0,0,40,40,
Tulsa,Superintendent of Public Instruction,Joy Hofmeister,REP,720355,0,0,107,107,
Tulsa,Superintendent of Public Instruction,John Cox,DEM,720355,0,0,57,57,
Tulsa,Superintendent of Public Instruction,Larry Huff,IND,720355,0,0,17,17,
Tulsa,Commissioner of Labor,Leslie Osborn,REP,720355,0,0,125,125,
Tulsa,Commissioner of Labor,Fred Dorrell,DEM,720355,0,0,50,50,
Tulsa,Commissioner of Labor,Brandt Dismukes,IND,720355,0,0,6,6,
Tulsa,Insurance Commissioner,Glen Mulready,REP,720355,0,0,125,125,
Tulsa,Insurance Commissioner,Kimberly Fobbs,DEM,720355,0,0,56,56,
Tulsa,Corporation Commissioner,Bob Anthony,REP,720355,0,0,127,127,
Tulsa,Corporation Commissioner,Ashley Nicole Mccray,DEM,720355,0,0,48,48,
Tulsa,Corporation Commissioner,Jackie Short,IND,720355,0,0,6,6,
Tulsa,U.S. House,Kevin Hern,REP,720355,0,0,130,130,1
Tulsa,U.S. House,Tim Gilpin,DEM,720355,0,0,51,51,1
Tulsa,State House,Stan May,REP,720355,0,0,125,125,80
Tulsa,State House,Janice Graham,DEM,720355,0,0,55,55,80
Tulsa,Governor,Chris Powell,LIB,720356,0,0,4,4,
Tulsa,Governor,Kevin Stitt,REP,720356,0,0,158,158,
Tulsa,Governor,Drew Edmondson,DEM,720356,0,0,72,72,
Tulsa,Lieutenant Governor,Matt Pinnell,REP,720356,0,0,181,181,
Tulsa,Lieutenant Governor,Anastasia Pittman,DEM,720356,0,0,49,49,
Tulsa,Lieutenant Governor,Ivan Holmes,IND,720356,0,0,3,3,
Tulsa,State Auditor,John Yeutter,LIB,720356,0,0,26,26,
Tulsa,State Auditor,Cindy Byrd,REP,720356,0,0,197,197,
Tulsa,Attorney General,Mike Hunter,REP,720356,0,0,192,192,
Tulsa,Attorney General,Mark Myles,DEM,720356,0,0,42,42,
Tulsa,State Treasurer,Randy Mcdaniel,REP,720356,0,0,190,190,
Tulsa,State Treasurer,Charles De Coune,IND,720356,0,0,33,33,
Tulsa,Superintendent of Public Instruction,Joy Hofmeister,REP,720356,0,0,172,172,
Tulsa,Superintendent of Public Instruction,John Cox,DEM,720356,0,0,53,53,
Tulsa,Superintendent of Public Instruction,Larry Huff,IND,720356,0,0,9,9,
Tulsa,Commissioner of Labor,Leslie Osborn,REP,720356,0,0,179,179,
Tulsa,Commissioner of Labor,Fred Dorrell,DEM,720356,0,0,41,41,
Tulsa,Commissioner of Labor,Brandt Dismukes,IND,720356,0,0,12,12,
Tulsa,Insurance Commissioner,Glen Mulready,REP,720356,0,0,178,178,
Tulsa,Insurance Commissioner,Kimberly Fobbs,DEM,720356,0,0,54,54,
Tulsa,Corporation Commissioner,Bob Anthony,REP,720356,0,0,177,177,
Tulsa,Corporation Commissioner,Ashley Nicole Mccray,DEM,720356,0,0,48,48,
Tulsa,Corporation Commissioner,Jackie Short,IND,720356,0,0,6,6,
Tulsa,U.S. House,Kevin Hern,REP,720356,0,0,180,180,1
Tulsa,U.S. House,Tim Gilpin,DEM,720356,0,0,53,53,1
Tulsa,Governor,Chris Powell,LIB,720400,0,0,31,31,
Tulsa,Governor,Kevin Stitt,REP,720400,0,0,945,945,
Tulsa,Governor,Drew Edmondson,DEM,720400,0,0,401,401,
Tulsa,Lieutenant Governor,Matt Pinnell,REP,720400,0,0,1065,1065,
Tulsa,Lieutenant Governor,Anastasia Pittman,DEM,720400,0,0,281,281,
Tulsa,Lieutenant Governor,Ivan Holmes,IND,720400,0,0,28,28,
Tulsa,State Auditor,John Yeutter,LIB,720400,0,0,195,195,
Tulsa,State Auditor,Cindy Byrd,REP,720400,0,0,1111,1111,
Tulsa,Attorney General,Mike Hunter,REP,720400,0,0,1059,1059,
Tulsa,Attorney General,Mark Myles,DEM,720400,0,0,306,306,
Tulsa,State Treasurer,Randy Mcdaniel,REP,720400,0,0,1079,1079,
Tulsa,State Treasurer,Charles De Coune,IND,720400,0,0,227,227,
Tulsa,Superintendent of Public Instruction,Joy Hofmeister,REP,720400,0,0,1024,1024,
Tulsa,Superintendent of Public Instruction,John Cox,DEM,720400,0,0,274,274,
Tulsa,Superintendent of Public Instruction,Larry Huff,IND,720400,0,0,70,70,
Tulsa,Commissioner of Labor,Leslie Osborn,REP,720400,0,0,1026,1026,
Tulsa,Commissioner of Labor,Fred Dorrell,DEM,720400,0,0,262,262,
Tulsa,Commissioner of Labor,Brandt Dismukes,IND,720400,0,0,49,49,
Tulsa,Insurance Commissioner,Glen Mulready,REP,720400,0,0,1037,1037,
Tulsa,Insurance Commissioner,Kimberly Fobbs,DEM,720400,0,0,308,308,
Tulsa,Corporation Commissioner,Bob Anthony,REP,720400,0,0,1016,1016,
Tulsa,Corporation Commissioner,Ashley Nicole Mccray,DEM,720400,0,0,284,284,
Tulsa,Corporation Commissioner,Jackie Short,IND,720400,0,0,52,52,
Tulsa,U.S. House,Kevin Hern,REP,720400,0,0,1026,1026,1
Tulsa,U.S. House,Tim Gilpin,DEM,720400,0,0,347,347,1
Tulsa,State House,Sheila Dills,REP,720400,0,0,1061,1061,69
Tulsa,State House,Andy Richardson,DEM,720400,0,0,301,301,69
Tulsa,Governor,Chris Powell,LIB,720401,0,0,22,22,
Tulsa,Governor,Kevin Stitt,REP,720401,0,0,893,893,
Tulsa,Governor,Drew Edmondson,DEM,720401,0,0,398,398,
Tulsa,Lieutenant Governor,Matt Pinnell,REP,720401,0,0,1024,1024,
Tulsa,Lieutenant Governor,Anastasia Pittman,DEM,720401,0,0,254,254,
Tulsa,Lieutenant Governor,Ivan Holmes,IND,720401,0,0,22,22,
Tulsa,State Auditor,John Yeutter,LIB,720401,0,0,159,159,
Tulsa,State Auditor,Cindy Byrd,REP,720401,0,0,1076,1076,
Tulsa,Attorney General,Mike Hunter,REP,720401,0,0,1003,1003,
Tulsa,Attorney General,Mark Myles,DEM,720401,0,0,283,283,
Tulsa,State Treasurer,Randy Mcdaniel,REP,720401,0,0,1023,1023,
Tulsa,State Treasurer,Charles De Coune,IND,720401,0,0,203,203,
Tulsa,Superintendent of Public Instruction,Joy Hofmeister,REP,720401,0,0,978,978,
Tulsa,Superintendent of Public Instruction,John Cox,DEM,720401,0,0,264,264,
Tulsa,Superintendent of Public Instruction,Larry Huff,IND,720401,0,0,51,51,
Tulsa,Commissioner of Labor,Leslie Osborn,REP,720401,0,0,963,963,
Tulsa,Commissioner of Labor,Fred Dorrell,DEM,720401,0,0,270,270,
Tulsa,Commissioner of Labor,Brandt Dismukes,IND,720401,0,0,30,30,
Tulsa,Insurance Commissioner,Glen Mulready,REP,720401,0,0,981,981,
Tulsa,Insurance Commissioner,Kimberly Fobbs,DEM,720401,0,0,291,291,
Tulsa,Corporation Commissioner,Bob Anthony,REP,720401,0,0,978,978,
Tulsa,Corporation Commissioner,Ashley Nicole Mccray,DEM,720401,0,0,262,262,
Tulsa,Corporation Commissioner,Jackie Short,IND,720401,0,0,36,36,
Tulsa,U.S. House,Kevin Hern,REP,720401,0,0,970,970,1
Tulsa,U.S. House,Tim Gilpin,DEM,720401,0,0,319,319,1
Tulsa,State House,Jeff Boatman,REP,720401,0,0,954,954,67
Tulsa,State House,Carly Hotvedt,DEM,720401,0,0,316,316,67
Tulsa,Governor,Chris Powell,LIB,720402,0,0,26,26,
Tulsa,Governor,Kevin Stitt,REP,720402,0,0,512,512,
Tulsa,Governor,Drew Edmondson,DEM,720402,0,0,264,264,
Tulsa,Lieutenant Governor,Matt Pinnell,REP,720402,0,0,565,565,
Tulsa,Lieutenant Governor,Anastasia Pittman,DEM,720402,0,0,202,202,
Tulsa,Lieutenant Governor,Ivan Holmes,IND,720402,0,0,29,29,
Tulsa,State Auditor,John Yeutter,LIB,720402,0,0,141,141,
Tulsa,State Auditor,Cindy Byrd,REP,720402,0,0,614,614,
Tulsa,Attorney General,Mike Hunter,REP,720402,0,0,569,569,
Tulsa,Attorney General,Mark Myles,DEM,720402,0,0,215,215,
Tulsa,State Treasurer,Randy Mcdaniel,REP,720402,0,0,572,572,
Tulsa,State Treasurer,Charles De Coune,IND,720402,0,0,174,174,
Tulsa,Superintendent of Public Instruction,Joy Hofmeister,REP,720402,0,0,524,524,
Tulsa,Superintendent of Public Instruction,John Cox,DEM,720402,0,0,198,198,
Tulsa,Superintendent of Public Instruction,Larry Huff,IND,720402,0,0,59,59,
Tulsa,Commissioner of Labor,Leslie Osborn,REP,720402,0,0,551,551,
Tulsa,Commissioner of Labor,Fred Dorrell,DEM,720402,0,0,189,189,
Tulsa,Commissioner of Labor,Brandt Dismukes,IND,720402,0,0,29,29,
Tulsa,Insurance Commissioner,Glen Mulready,REP,720402,0,0,554,554,
Tulsa,Insurance Commissioner,Kimberly Fobbs,DEM,720402,0,0,225,225,
Tulsa,Corporation Commissioner,Bob Anthony,REP,720402,0,0,535,535,
Tulsa,Corporation Commissioner,Ashley Nicole Mccray,DEM,720402,0,0,199,199,
Tulsa,Corporation Commissioner,Jackie Short,IND,720402,0,0,45,45,
Tulsa,U.S. House,Kevin Hern,REP,720402,0,0,564,564,1
Tulsa,U.S. House,Tim Gilpin,DEM,720402,0,0,225,225,1
Tulsa,State House,Sheila Dills,REP,720402,0,0,573,573,69
Tulsa,State House,Andy Richardson,DEM,720402,0,0,215,215,69
Tulsa,Governor,Chris Powell,LIB,720403,0,0,45,45,
Tulsa,Governor,Kevin Stitt,REP,720403,0,0,1015,1015,
Tulsa,Governor,Drew Edmondson,DEM,720403,0,0,534,534,
Tulsa,Lieutenant Governor,Matt Pinnell,REP,720403,0,0,1112,1112,
Tulsa,Lieutenant Governor,Anastasia Pittman,DEM,720403,0,0,421,421,
Tulsa,Lieutenant Governor,Ivan Holmes,IND,720403,0,0,52,52,
Tulsa,State Auditor,John Yeutter,LIB,720403,0,0,298,298,
Tulsa,State Auditor,Cindy Byrd,REP,720403,0,0,1195,1195,
Tulsa,Attorney General,Mike Hunter,REP,720403,0,0,1160,1160,
Tulsa,Attorney General,Mark Myles,DEM,720403,0,0,416,416,
Tulsa,State Treasurer,Randy Mcdaniel,REP,720403,0,0,1153,1153,
Tulsa,State Treasurer,Charles De Coune,IND,720403,0,0,332,332,
Tulsa,Superintendent of Public Instruction,Joy Hofmeister,REP,720403,0,0,1086,1086,
Tulsa,Superintendent of Public Instruction,John Cox,DEM,720403,0,0,373,373,
Tulsa,Superintendent of Public Instruction,Larry Huff,IND,720403,0,0,118,118,
Tulsa,Commissioner of Labor,Leslie Osborn,REP,720403,0,0,1070,1070,
Tulsa,Commissioner of Labor,Fred Dorrell,DEM,720403,0,0,406,406,
Tulsa,Commissioner of Labor,Brandt Dismukes,IND,720403,0,0,84,84,
Tulsa,Insurance Commissioner,Glen Mulready,REP,720403,0,0,1118,1118,
Tulsa,Insurance Commissioner,Kimberly Fobbs,DEM,720403,0,0,446,446,
Tulsa,Corporation Commissioner,Bob Anthony,REP,720403,0,0,1077,1077,
Tulsa,Corporation Commissioner,Ashley Nicole Mccray,DEM,720403,0,0,405,405,
Tulsa,Corporation Commissioner,Jackie Short,IND,720403,0,0,88,88,
Tulsa,U.S. House,Kevin Hern,REP,720403,0,0,1114,1114,1
Tulsa,U.S. House,Tim Gilpin,DEM,720403,0,0,466,466,1
Tulsa,State House,Stan May,REP,720403,0,0,1086,1086,80
Tulsa,State House,Janice Graham,DEM,720403,0,0,481,481,80
Tulsa,Governor,Chris Powell,LIB,720404,0,0,14,14,
Tulsa,Governor,Kevin Stitt,REP,720404,0,0,649,649,
Tulsa,Governor,Drew Edmondson,DEM,720404,0,0,259,259,
Tulsa,Lieutenant Governor,Matt Pinnell,REP,720404,0,0,711,711,
Tulsa,Lieutenant Governor,Anastasia Pittman,DEM,720404,0,0,200,200,
Tulsa,Lieutenant Governor,Ivan Holmes,IND,720404,0,0,8,8,
Tulsa,State Auditor,John Yeutter,LIB,720404,0,0,145,145,
Tulsa,State Auditor,Cindy Byrd,REP,720404,0,0,713,713,
Tulsa,Attorney General,Mike Hunter,REP,720404,0,0,702,702,
Tulsa,Attorney General,Mark Myles,DEM,720404,0,0,213,213,
Tulsa,State Treasurer,Randy Mcdaniel,REP,720404,0,0,713,713,
Tulsa,State Treasurer,Charles De Coune,IND,720404,0,0,148,148,
Tulsa,Superintendent of Public Instruction,Joy Hofmeister,REP,720404,0,0,656,656,
Tulsa,Superintendent of Public Instruction,John Cox,DEM,720404,0,0,209,209,
Tulsa,Superintendent of Public Instruction,Larry Huff,IND,720404,0,0,50,50,
Tulsa,Commissioner of Labor,Leslie Osborn,REP,720404,0,0,679,679,
Tulsa,Commissioner of Labor,Fred Dorrell,DEM,720404,0,0,199,199,
Tulsa,Commissioner of Labor,Brandt Dismukes,IND,720404,0,0,28,28,
Tulsa,Insurance Commissioner,Glen Mulready,REP,720404,0,0,687,687,
Tulsa,Insurance Commissioner,Kimberly Fobbs,DEM,720404,0,0,219,219,
Tulsa,Corporation Commissioner,Bob Anthony,REP,720404,0,0,672,672,
Tulsa,Corporation Commissioner,Ashley Nicole Mccray,DEM,720404,0,0,203,203,
Tulsa,Corporation Commissioner,Jackie Short,IND,720404,0,0,35,35,
Tulsa,U.S. House,Kevin Hern,REP,720404,0,0,687,687,1
Tulsa,U.S. House,Tim Gilpin,DEM,720404,0,0,231,231,1
Tulsa,State House,Stan May,REP,720404,0,0,670,670,80
Tulsa,State House,Janice Graham,DEM,720404,0,0,236,236,80
Tulsa,Governor,Chris Powell,LIB,720405,0,0,4,4,
Tulsa,Governor,Kevin Stitt,REP,720405,0,0,108,108,
Tulsa,Governor,Drew Edmondson,DEM,720405,0,0,54,54,
Tulsa,Lieutenant Governor,Matt Pinnell,REP,720405,0,0,121,121,
Tulsa,Lieutenant Governor,Anastasia Pittman,DEM,720405,0,0,42,42,
Tulsa,Lieutenant Governor,Ivan Holmes,IND,720405,0,0,3,3,
Tulsa,State Auditor,John Yeutter,LIB,720405,0,0,31,31,
Tulsa,State Auditor,Cindy Byrd,REP,720405,0,0,130,130,
Tulsa,Attorney General,Mike Hunter,REP,720405,0,0,122,122,
Tulsa,Attorney General,Mark Myles,DEM,720405,0,0,42,42,
Tulsa,State Treasurer,Randy Mcdaniel,REP,720405,0,0,126,126,
Tulsa,State Treasurer,Charles De Coune,IND,720405,0,0,33,33,
Tulsa,Superintendent of Public Instruction,Joy Hofmeister,REP,720405,0,0,119,119,
Tulsa,Superintendent of Public Instruction,John Cox,DEM,720405,0,0,36,36,
Tulsa,Superintendent of Public Instruction,Larry Huff,IND,720405,0,0,9,9,
Tulsa,Commissioner of Labor,Leslie Osborn,REP,720405,0,0,118,118,
Tulsa,Commissioner of Labor,Fred Dorrell,DEM,720405,0,0,40,40,
Tulsa,Commissioner of Labor,Brandt Dismukes,IND,720405,0,0,6,6,
Tulsa,Insurance Commissioner,Glen Mulready,REP,720405,0,0,120,120,
Tulsa,Insurance Commissioner,Kimberly Fobbs,DEM,720405,0,0,42,42,
Tulsa,Corporation Commissioner,Bob Anthony,REP,720405,0,0,119,119,
Tulsa,Corporation Commissioner,Ashley Nicole Mccray,DEM,720405,0,0,40,40,
Tulsa,Corporation Commissioner,Jackie Short,IND,720405,0,0,5,5,
Tulsa,U.S. House,Kevin Hern,REP,720405,0,0,119,119,1
Tulsa,U.S. House,Tim Gilpin,DEM,720405,0,0,46,46,1
Tulsa,State Senate,Kim David,REP,720405,0,0,120,120,18
Tulsa,State Senate,Charles Arnall,DEM,720405,0,0,45,45,18
Tulsa,State House,Stan May,REP,720405,0,0,113,113,80
Tulsa,State House,Janice Graham,DEM,720405,0,0,52,52,80
Tulsa,Governor,Chris Powell,LIB,720406,0,0,19,19,
Tulsa,Governor,Kevin Stitt,REP,720406,0,0,686,686,
Tulsa,Governor,Drew Edmondson,DEM,720406,0,0,327,327,
Tulsa,Lieutenant Governor,Matt Pinnell,REP,720406,0,0,789,789,
Tulsa,Lieutenant Governor,Anastasia Pittman,DEM,720406,0,0,210,210,
Tulsa,Lieutenant Governor,Ivan Holmes,IND,720406,0,0,23,23,
Tulsa,State Auditor,John Yeutter,LIB,720406,0,0,160,160,
Tulsa,State Auditor,Cindy Byrd,REP,720406,0,0,811,811,
Tulsa,Attorney General,Mike Hunter,REP,720406,0,0,781,781,
Tulsa,Attorney General,Mark Myles,DEM,720406,0,0,229,229,
Tulsa,State Treasurer,Randy Mcdaniel,REP,720406,0,0,787,787,
Tulsa,State Treasurer,Charles De Coune,IND,720406,0,0,177,177,
Tulsa,Superintendent of Public Instruction,Joy Hofmeister,REP,720406,0,0,758,758,
Tulsa,Superintendent of Public Instruction,John Cox,DEM,720406,0,0,200,200,
Tulsa,Superintendent of Public Instruction,Larry Huff,IND,720406,0,0,62,62,
Tulsa,Commissioner of Labor,Leslie Osborn,REP,720406,0,0,729,729,
Tulsa,Commissioner of Labor,Fred Dorrell,DEM,720406,0,0,224,224,
Tulsa,Commissioner of Labor,Brandt Dismukes,IND,720406,0,0,43,43,
Tulsa,Insurance Commissioner,Glen Mulready,REP,720406,0,0,767,767,
Tulsa,Insurance Commissioner,Kimberly Fobbs,DEM,720406,0,0,235,235,
Tulsa,Corporation Commissioner,Bob Anthony,REP,720406,0,0,742,742,
Tulsa,Corporation Commissioner,Ashley Nicole Mccray,DEM,720406,0,0,211,211,
Tulsa,Corporation Commissioner,Jackie Short,IND,720406,0,0,45,45,
Tulsa,U.S. House,Kevin Hern,REP,720406,0,0,755,755,1
Tulsa,U.S. House,Tim Gilpin,DEM,720406,0,0,265,265,1
Tulsa,State House,Stan May,REP,720406,0,0,724,724,80
Tulsa,State House,Janice Graham,DEM,720406,0,0,281,281,80
Tulsa,Governor,Chris Powell,LIB,720407,0,0,34,34,
Tulsa,Governor,Kevin Stitt,REP,720407,0,0,786,786,
Tulsa,Governor,Drew Edmondson,DEM,720407,0,0,361,361,
Tulsa,Lieutenant Governor,Matt Pinnell,REP,720407,0,0,899,899,
Tulsa,Lieutenant Governor,Anastasia Pittman,DEM,720407,0,0,240,240,
Tulsa,Lieutenant Governor,Ivan Holmes,IND,720407,0,0,35,35,
Tulsa,State Auditor,John Yeutter,LIB,720407,0,0,184,184,
Tulsa,State Auditor,Cindy Byrd,REP,720407,0,0,921,921,
Tulsa,Attorney General,Mike Hunter,REP,720407,0,0,893,893,
Tulsa,Attorney General,Mark Myles,DEM,720407,0,0,271,271,
Tulsa,State Treasurer,Randy Mcdaniel,REP,720407,0,0,905,905,
Tulsa,State Treasurer,Charles De Coune,IND,720407,0,0,194,194,
Tulsa,Superintendent of Public Instruction,Joy Hofmeister,REP,720407,0,0,850,850,
Tulsa,Superintendent of Public Instruction,John Cox,DEM,720407,0,0,240,240,
Tulsa,Superintendent of Public Instruction,Larry Huff,IND,720407,0,0,84,84,
Tulsa,Commissioner of Labor,Leslie Osborn,REP,720407,0,0,846,846,
Tulsa,Commissioner of Labor,Fred Dorrell,DEM,720407,0,0,259,259,
Tulsa,Commissioner of Labor,Brandt Dismukes,IND,720407,0,0,49,49,
Tulsa,Insurance Commissioner,Glen Mulready,REP,720407,0,0,883,883,
Tulsa,Insurance Commissioner,Kimberly Fobbs,DEM,720407,0,0,275,275,
Tulsa,Corporation Commissioner,Bob Anthony,REP,720407,0,0,854,854,
Tulsa,Corporation Commissioner,Ashley Nicole Mccray,DEM,720407,0,0,248,248,
Tulsa,Corporation Commissioner,Jackie Short,IND,720407,0,0,54,54,
Tulsa,U.S. House,Kevin Hern,REP,720407,0,0,901,901,1
Tulsa,U.S. House,Tim Gilpin,DEM,720407,0,0,276,276,1
Tulsa,State House,Stan May,REP,720407,0,0,875,875,80
Tulsa,State House,Janice Graham,DEM,720407,0,0,286,286,80
Tulsa,Governor,Chris Powell,LIB,720408,0,0,35,35,
Tulsa,Governor,Kevin Stitt,REP,720408,0,0,734,734,
Tulsa,Governor,Drew Edmondson,DEM,720408,0,0,355,355,
Tulsa,Lieutenant Governor,Matt Pinnell,REP,720408,0,0,814,814,
Tulsa,Lieutenant Governor,Anastasia Pittman,DEM,720408,0,0,265,265,
Tulsa,Lieutenant Governor,Ivan Holmes,IND,720408,0,0,40,40,
Tulsa,State Auditor,John Yeutter,LIB,720408,0,0,202,202,
Tulsa,State Auditor,Cindy Byrd,REP,720408,0,0,872,872,
Tulsa,Attorney General,Mike Hunter,REP,720408,0,0,824,824,
Tulsa,Attorney General,Mark Myles,DEM,720408,0,0,285,285,
Tulsa,State Treasurer,Randy Mcdaniel,REP,720408,0,0,834,834,
Tulsa,State Treasurer,Charles De Coune,IND,720408,0,0,230,230,
Tulsa,Superintendent of Public Instruction,Joy Hofmeister,REP,720408,0,0,772,772,
Tulsa,Superintendent of Public Instruction,John Cox,DEM,720408,0,0,257,257,
Tulsa,Superintendent of Public Instruction,Larry Huff,IND,720408,0,0,83,83,
Tulsa,Commissioner of Labor,Leslie Osborn,REP,720408,0,0,783,783,
Tulsa,Commissioner of Labor,Fred Dorrell,DEM,720408,0,0,261,261,
Tulsa,Commissioner of Labor,Brandt Dismukes,IND,720408,0,0,54,54,
Tulsa,Insurance Commissioner,Glen Mulready,REP,720408,0,0,806,806,
Tulsa,Insurance Commissioner,Kimberly Fobbs,DEM,720408,0,0,293,293,
Tulsa,Corporation Commissioner,Bob Anthony,REP,720408,0,0,795,795,
Tulsa,Corporation Commissioner,Ashley Nicole Mccray,DEM,720408,0,0,246,246,
Tulsa,Corporation Commissioner,Jackie Short,IND,720408,0,0,62,62,
Tulsa,U.S. House,Kevin Hern,REP,720408,0,0,810,810,1
Tulsa,U.S. House,Tim Gilpin,DEM,720408,0,0,303,303,1
Tulsa,State House,Stan May,REP,720408,0,0,784,784,80
Tulsa,State House,Janice Graham,DEM,720408,0,0,328,328,80
Tulsa,Governor,Chris Powell,LIB,720409,0,0,31,31,
Tulsa,Governor,Kevin Stitt,REP,720409,0,0,649,649,
Tulsa,Governor,Drew Edmondson,DEM,720409,0,0,373,373,
Tulsa,Lieutenant Governor,Matt Pinnell,REP,720409,0,0,766,766,
Tulsa,Lieutenant Governor,Anastasia Pittman,DEM,720409,0,0,253,253,
Tulsa,Lieutenant Governor,Ivan Holmes,IND,720409,0,0,32,32,
Tulsa,State Auditor,John Yeutter,LIB,720409,0,0,199,199,
Tulsa,State Auditor,Cindy Byrd,REP,720409,0,0,800,800,
Tulsa,Attorney General,Mike Hunter,REP,720409,0,0,776,776,
Tulsa,Attorney General,Mark Myles,DEM,720409,0,0,260,260,
Tulsa,State Treasurer,Randy Mcdaniel,REP,720409,0,0,768,768,
Tulsa,State Treasurer,Charles De Coune,IND,720409,0,0,226,226,
Tulsa,Superintendent of Public Instruction,Joy Hofmeister,REP,720409,0,0,709,709,
Tulsa,Superintendent of Public Instruction,John Cox,DEM,720409,0,0,261,261,
Tulsa,Superintendent of Public Instruction,Larry Huff,IND,720409,0,0,71,71,
Tulsa,Commissioner of Labor,Leslie Osborn,REP,720409,0,0,743,743,
Tulsa,Commissioner of Labor,Fred Dorrell,DEM,720409,0,0,244,244,
Tulsa,Commissioner of Labor,Brandt Dismukes,IND,720409,0,0,41,41,
Tulsa,Insurance Commissioner,Glen Mulready,REP,720409,0,0,746,746,
Tulsa,Insurance Commissioner,Kimberly Fobbs,DEM,720409,0,0,284,284,
Tulsa,Corporation Commissioner,Bob Anthony,REP,720409,0,0,721,721,
Tulsa,Corporation Commissioner,Ashley Nicole Mccray,DEM,720409,0,0,263,263,
Tulsa,Corporation Commissioner,Jackie Short,IND,720409,0,0,49,49,
Tulsa,U.S. House,Kevin Hern,REP,720409,0,0,747,747,1
Tulsa,U.S. House,Tim Gilpin,DEM,720409,0,0,304,304,1
Tulsa,State House,Stan May,REP,720409,0,0,723,723,80
Tulsa,State House,Janice Graham,DEM,720409,0,0,324,324,80
Tulsa,Governor,Chris Powell,LIB,720410,0,0,8,8,
Tulsa,Governor,Kevin Stitt,REP,720410,0,0,511,511,
Tulsa,Governor,Drew Edmondson,DEM,720410,0,0,165,165,
Tulsa,Lieutenant Governor,Matt Pinnell,REP,720410,0,0,562,562,
Tulsa,Lieutenant Governor,Anastasia Pittman,DEM,720410,0,0,111,111,
Tulsa,Lieutenant Governor,Ivan Holmes,IND,720410,0,0,9,9,
Tulsa,State Auditor,John Yeutter,LIB,720410,0,0,67,67,
Tulsa,State Auditor,Cindy Byrd,REP,720410,0,0,583,583,
Tulsa,Attorney General,Mike Hunter,REP,720410,0,0,567,567,
Tulsa,Attorney General,Mark Myles,DEM,720410,0,0,106,106,
Tulsa,State Treasurer,Randy Mcdaniel,REP,720410,0,0,577,577,
Tulsa,State Treasurer,Charles De Coune,IND,720410,0,0,73,73,
Tulsa,Superintendent of Public Instruction,Joy Hofmeister,REP,720410,0,0,533,533,
Tulsa,Superintendent of Public Instruction,John Cox,DEM,720410,0,0,119,119,
Tulsa,Superintendent of Public Instruction,Larry Huff,IND,720410,0,0,25,25,
Tulsa,Commissioner of Labor,Leslie Osborn,REP,720410,0,0,534,534,
Tulsa,Commissioner of Labor,Fred Dorrell,DEM,720410,0,0,119,119,
Tulsa,Commissioner of Labor,Brandt Dismukes,IND,720410,0,0,15,15,
Tulsa,Insurance Commissioner,Glen Mulready,REP,720410,0,0,554,554,
Tulsa,Insurance Commissioner,Kimberly Fobbs,DEM,720410,0,0,117,117,
Tulsa,Corporation Commissioner,Bob Anthony,REP,720410,0,0,547,547,
Tulsa,Corporation Commissioner,Ashley Nicole Mccray,DEM,720410,0,0,109,109,
Tulsa,Corporation Commissioner,Jackie Short,IND,720410,0,0,18,18,
Tulsa,U.S. House,Kevin Hern,REP,720410,0,0,541,541,1
Tulsa,U.S. House,Tim Gilpin,DEM,720410,0,0,142,142,1
Tulsa,State House,Jeff Boatman,REP,720410,0,0,558,558,67
Tulsa,State House,Carly Hotvedt,DEM,720410,0,0,116,116,67
Tulsa,Governor,Chris Powell,LIB,720411,0,0,27,27,
Tulsa,Governor,Kevin Stitt,REP,720411,0,0,299,299,
Tulsa,Governor,Drew Edmondson,DEM,720411,0,0,197,197,
Tulsa,Lieutenant Governor,Matt Pinnell,REP,720411,0,0,349,349,
Tulsa,Lieutenant Governor,Anastasia Pittman,DEM,720411,0,0,153,153,
Tulsa,Lieutenant Governor,Ivan Holmes,IND,720411,0,0,20,20,
Tulsa,State Auditor,John Yeutter,LIB,720411,0,0,108,108,
Tulsa,State Auditor,Cindy Byrd,REP,720411,0,0,377,377,
Tulsa,Attorney General,Mike Hunter,REP,720411,0,0,357,357,
Tulsa,Attorney General,Mark Myles,DEM,720411,0,0,159,159,
Tulsa,State Treasurer,Randy Mcdaniel,REP,720411,0,0,358,358,
Tulsa,State Treasurer,Charles De Coune,IND,720411,0,0,127,127,
Tulsa,Superintendent of Public Instruction,Joy Hofmeister,REP,720411,0,0,324,324,
Tulsa,Superintendent of Public Instruction,John Cox,DEM,720411,0,0,152,152,
Tulsa,Superintendent of Public Instruction,Larry Huff,IND,720411,0,0,45,45,
Tulsa,Commissioner of Labor,Leslie Osborn,REP,720411,0,0,335,335,
Tulsa,Commissioner of Labor,Fred Dorrell,DEM,720411,0,0,140,140,
Tulsa,Commissioner of Labor,Brandt Dismukes,IND,720411,0,0,35,35,
Tulsa,Insurance Commissioner,Glen Mulready,REP,720411,0,0,343,343,
Tulsa,Insurance Commissioner,Kimberly Fobbs,DEM,720411,0,0,164,164,
Tulsa,Corporation Commissioner,Bob Anthony,REP,720411,0,0,335,335,
Tulsa,Corporation Commissioner,Ashley Nicole Mccray,DEM,720411,0,0,143,143,
Tulsa,Corporation Commissioner,Jackie Short,IND,720411,0,0,34,34,
Tulsa,U.S. House,Kevin Hern,REP,720411,0,0,360,360,1
Tulsa,U.S. House,Tim Gilpin,DEM,720411,0,0,158,158,1
Tulsa,State House,Stan May,REP,720411,0,0,335,335,80
Tulsa,State House,Janice Graham,DEM,720411,0,0,174,174,80
Tulsa,Governor,Chris Powell,LIB,720451,0,0,27,27,
Tulsa,Governor,Kevin Stitt,REP,720451,0,0,451,451,
Tulsa,Governor,Drew Edmondson,DEM,720451,0,0,256,256,
Tulsa,Lieutenant Governor,Matt Pinnell,REP,720451,0,0,485,485,
Tulsa,Lieutenant Governor,Anastasia Pittman,DEM,720451,0,0,217,217,
Tulsa,Lieutenant Governor,Ivan Holmes,IND,720451,0,0,24,24,
Tulsa,State Auditor,John Yeutter,LIB,720451,0,0,155,155,
Tulsa,State Auditor,Cindy Byrd,REP,720451,0,0,530,530,
Tulsa,Attorney General,Mike Hunter,REP,720451,0,0,515,515,
Tulsa,Attorney General,Mark Myles,DEM,720451,0,0,206,206,
Tulsa,State Treasurer,Randy Mcdaniel,REP,720451,0,0,506,506,
Tulsa,State Treasurer,Charles De Coune,IND,720451,0,0,177,177,
Tulsa,Superintendent of Public Instruction,Joy Hofmeister,REP,720451,0,0,454,454,
Tulsa,Superintendent of Public Instruction,John Cox,DEM,720451,0,0,204,204,
Tulsa,Superintendent of Public Instruction,Larry Huff,IND,720451,0,0,64,64,
Tulsa,Commissioner of Labor,Leslie Osborn,REP,720451,0,0,477,477,
Tulsa,Commissioner of Labor,Fred Dorrell,DEM,720451,0,0,197,197,
Tulsa,Commissioner of Labor,Brandt Dismukes,IND,720451,0,0,39,39,
Tulsa,Insurance Commissioner,Glen Mulready,REP,720451,0,0,479,479,
Tulsa,Insurance Commissioner,Kimberly Fobbs,DEM,720451,0,0,232,232,
Tulsa,Corporation Commissioner,Bob Anthony,REP,720451,0,0,467,467,
Tulsa,Corporation Commissioner,Ashley Nicole Mccray,DEM,720451,0,0,210,210,
Tulsa,Corporation Commissioner,Jackie Short,IND,720451,0,0,41,41,
Tulsa,U.S. House,Kevin Hern,REP,720451,0,0,501,501,1
Tulsa,U.S. House,Tim Gilpin,DEM,720451,0,0,221,221,1
Tulsa,State Senate,John Haste,REP,720451,0,0,493,493,36
Tulsa,State Senate,Bryan O'Brien,DEM,720451,0,0,222,222,36
Tulsa,State House,Ross Ford,REP,720451,0,0,512,512,76
Tulsa,State House,Forrest Mayer,DEM,720451,0,0,205,205,76
Tulsa,Governor,Chris Powell,LIB,720452,0,0,47,47,
Tulsa,Governor,Kevin Stitt,REP,720452,0,0,764,764,
Tulsa,Governor,Drew Edmondson,DEM,720452,0,0,500,500,
Tulsa,Lieutenant Governor,Matt Pinnell,REP,720452,0,0,821,821,
Tulsa,Lieutenant Governor,Anastasia Pittman,DEM,720452,0,0,422,422,
Tulsa,Lieutenant Governor,Ivan Holmes,IND,720452,0,0,49,49,
Tulsa,State Auditor,John Yeutter,LIB,720452,0,0,278,278,
Tulsa,State Auditor,Cindy Byrd,REP,720452,0,0,916,916,
Tulsa,Attorney General,Mike Hunter,REP,720452,0,0,851,851,
Tulsa,Attorney General,Mark Myles,DEM,720452,0,0,436,436,
Tulsa,State Treasurer,Randy Mcdaniel,REP,720452,0,0,872,872,
Tulsa,State Treasurer,Charles De Coune,IND,720452,0,0,322,322,
Tulsa,Superintendent of Public Instruction,Joy Hofmeister,REP,720452,0,0,829,829,
Tulsa,Superintendent of Public Instruction,John Cox,DEM,720452,0,0,368,368,
Tulsa,Superintendent of Public Instruction,Larry Huff,IND,720452,0,0,99,99,
Tulsa,Commissioner of Labor,Leslie Osborn,REP,720452,0,0,784,784,
Tulsa,Commissioner of Labor,Fred Dorrell,DEM,720452,0,0,428,428,
Tulsa,Commissioner of Labor,Brandt Dismukes,IND,720452,0,0,65,65,
Tulsa,Insurance Commissioner,Glen Mulready,REP,720452,0,0,804,804,
Tulsa,Insurance Commissioner,Kimberly Fobbs,DEM,720452,0,0,471,471,
Tulsa,Corporation Commissioner,Bob Anthony,REP,720452,0,0,809,809,
Tulsa,Corporation Commissioner,Ashley Nicole Mccray,DEM,720452,0,0,411,411,
Tulsa,Corporation Commissioner,Jackie Short,IND,720452,0,0,62,62,
Tulsa,U.S. House,Kevin Hern,REP,720452,0,0,832,832,1
Tulsa,U.S. House,Tim Gilpin,DEM,720452,0,0,463,463,1
Tulsa,State House,Dean Davis,REP,720452,0,0,768,768,98
Tulsa,State House,Kilmyn Easley-Graf,DEM,720452,0,0,497,497,98
Tulsa,State House,Sean Parrish,IND,720452,0,0,32,32,98
Tulsa,Governor,Chris Powell,LIB,720453,0,0,32,32,
Tulsa,Governor,Kevin Stitt,REP,720453,0,0,479,479,
Tulsa,Governor,Drew Edmondson,DEM,720453,0,0,341,341,
Tulsa,Lieutenant Governor,Matt Pinnell,REP,720453,0,0,571,571,
Tulsa,Lieutenant Governor,Anastasia Pittman,DEM,720453,0,0,253,253,
Tulsa,Lieutenant Governor,Ivan Holmes,IND,720453,0,0,28,28,
Tulsa,State Auditor,John Yeutter,LIB,720453,0,0,168,168,
Tulsa,State Auditor,Cindy Byrd,REP,720453,0,0,626,626,
Tulsa,Attorney General,Mike Hunter,REP,720453,0,0,577,577,
Tulsa,Attorney General,Mark Myles,DEM,720453,0,0,269,269,
Tulsa,State Treasurer,Randy Mcdaniel,REP,720453,0,0,596,596,
Tulsa,State Treasurer,Charles De Coune,IND,720453,0,0,204,204,
Tulsa,Superintendent of Public Instruction,Joy Hofmeister,REP,720453,0,0,528,528,
Tulsa,Superintendent of Public Instruction,John Cox,DEM,720453,0,0,261,261,
Tulsa,Superintendent of Public Instruction,Larry Huff,IND,720453,0,0,56,56,
Tulsa,Commissioner of Labor,Leslie Osborn,REP,720453,0,0,555,555,
Tulsa,Commissioner of Labor,Fred Dorrell,DEM,720453,0,0,253,253,
Tulsa,Commissioner of Labor,Brandt Dismukes,IND,720453,0,0,29,29,
Tulsa,Insurance Commissioner,Glen Mulready,REP,720453,0,0,553,553,
Tulsa,Insurance Commissioner,Kimberly Fobbs,DEM,720453,0,0,282,282,
Tulsa,Corporation Commissioner,Bob Anthony,REP,720453,0,0,542,542,
Tulsa,Corporation Commissioner,Ashley Nicole Mccray,DEM,720453,0,0,258,258,
Tulsa,Corporation Commissioner,Jackie Short,IND,720453,0,0,39,39,
Tulsa,U.S. House,Kevin Hern,REP,720453,0,0,557,557,1
Tulsa,U.S. House,Tim Gilpin,DEM,720453,0,0,295,295,1
Tulsa,State Senate,John Haste,REP,720453,0,0,554,554,36
Tulsa,State Senate,Bryan O'Brien,DEM,720453,0,0,288,288,36
Tulsa,State House,Dean Davis,REP,720453,0,0,530,530,98
Tulsa,State House,Kilmyn Easley-Graf,DEM,720453,0,0,301,301,98
Tulsa,State House,Sean Parrish,IND,720453,0,0,18,18,98
Tulsa,Governor,Chris Powell,LIB,720454,0,0,22,22,
Tulsa,Governor,Kevin Stitt,REP,720454,0,0,689,689,
Tulsa,Governor,Drew Edmondson,DEM,720454,0,0,543,543,
Tulsa,Lieutenant Governor,Matt Pinnell,REP,720454,0,0,796,796,
Tulsa,Lieutenant Governor,Anastasia Pittman,DEM,720454,0,0,415,415,
Tulsa,Lieutenant Governor,Ivan Holmes,IND,720454,0,0,31,31,
Tulsa,State Auditor,John Yeutter,LIB,720454,0,0,280,280,
Tulsa,State Auditor,Cindy Byrd,REP,720454,0,0,860,860,
Tulsa,Attorney General,Mike Hunter,REP,720454,0,0,785,785,
Tulsa,Attorney General,Mark Myles,DEM,720454,0,0,454,454,
Tulsa,State Treasurer,Randy Mcdaniel,REP,720454,0,0,815,815,
Tulsa,State Treasurer,Charles De Coune,IND,720454,0,0,328,328,
Tulsa,Superintendent of Public Instruction,Joy Hofmeister,REP,720454,0,0,778,778,
Tulsa,Superintendent of Public Instruction,John Cox,DEM,720454,0,0,396,396,
Tulsa,Superintendent of Public Instruction,Larry Huff,IND,720454,0,0,67,67,
Tulsa,Commissioner of Labor,Leslie Osborn,REP,720454,0,0,752,752,
Tulsa,Commissioner of Labor,Fred Dorrell,DEM,720454,0,0,414,414,
Tulsa,Commissioner of Labor,Brandt Dismukes,IND,720454,0,0,53,53,
Tulsa,Insurance Commissioner,Glen Mulready,REP,720454,0,0,770,770,
Tulsa,Insurance Commissioner,Kimberly Fobbs,DEM,720454,0,0,455,455,
Tulsa,Corporation Commissioner,Bob Anthony,REP,720454,0,0,775,775,
Tulsa,Corporation Commissioner,Ashley Nicole Mccray,DEM,720454,0,0,396,396,
Tulsa,Corporation Commissioner,Jackie Short,IND,720454,0,0,58,58,
Tulsa,U.S. House,Kevin Hern,REP,720454,0,0,765,765,1
Tulsa,U.S. House,Tim Gilpin,DEM,720454,0,0,479,479,1
Tulsa,State House,Ross Ford,REP,720454,0,0,819,819,76
Tulsa,State House,Forrest Mayer,DEM,720454,0,0,417,417,76
Tulsa,Governor,Chris Powell,LIB,720455,0,0,13,13,
Tulsa,Governor,Kevin Stitt,REP,720455,0,0,279,279,
Tulsa,Governor,Drew Edmondson,DEM,720455,0,0,209,209,
Tulsa,Lieutenant Governor,Matt Pinnell,REP,720455,0,0,311,311,
Tulsa,Lieutenant Governor,Anastasia Pittman,DEM,720455,0,0,167,167,
Tulsa,Lieutenant Governor,Ivan Holmes,IND,720455,0,0,22,22,
Tulsa,State Auditor,John Yeutter,LIB,720455,0,0,114,114,
Tulsa,State Auditor,Cindy Byrd,REP,720455,0,0,343,343,
Tulsa,Attorney General,Mike Hunter,REP,720455,0,0,324,324,
Tulsa,Attorney General,Mark Myles,DEM,720455,0,0,172,172,
Tulsa,State Treasurer,Randy Mcdaniel,REP,720455,0,0,325,325,
Tulsa,State Treasurer,Charles De Coune,IND,720455,0,0,132,132,
Tulsa,Superintendent of Public Instruction,Joy Hofmeister,REP,720455,0,0,302,302,
Tulsa,Superintendent of Public Instruction,John Cox,DEM,720455,0,0,157,157,
Tulsa,Superintendent of Public Instruction,Larry Huff,IND,720455,0,0,38,38,
Tulsa,Commissioner of Labor,Leslie Osborn,REP,720455,0,0,297,297,
Tulsa,Commissioner of Labor,Fred Dorrell,DEM,720455,0,0,172,172,
Tulsa,Commissioner of Labor,Brandt Dismukes,IND,720455,0,0,20,20,
Tulsa,Insurance Commissioner,Glen Mulready,REP,720455,0,0,305,305,
Tulsa,Insurance Commissioner,Kimberly Fobbs,DEM,720455,0,0,183,183,
Tulsa,Corporation Commissioner,Bob Anthony,REP,720455,0,0,297,297,
Tulsa,Corporation Commissioner,Ashley Nicole Mccray,DEM,720455,0,0,169,169,
Tulsa,Corporation Commissioner,Jackie Short,IND,720455,0,0,28,28,
Tulsa,U.S. House,Kevin Hern,REP,720455,0,0,314,314,1
Tulsa,U.S. House,Tim Gilpin,DEM,720455,0,0,183,183,1
Tulsa,State House,Ross Ford,REP,720455,0,0,332,332,76
Tulsa,State House,Forrest Mayer,DEM,720455,0,0,161,161,76
Tulsa,Governor,Chris Powell,LIB,720456,0,0,27,27,
Tulsa,Governor,Kevin Stitt,REP,720456,0,0,449,449,
Tulsa,Governor,Drew Edmondson,DEM,720456,0,0,280,280,
Tulsa,Lieutenant Governor,Matt Pinnell,REP,720456,0,0,501,501,
Tulsa,Lieutenant Governor,Anastasia Pittman,DEM,720456,0,0,228,228,
Tulsa,Lieutenant Governor,Ivan Holmes,IND,720456,0,0,21,21,
Tulsa,State Auditor,John Yeutter,LIB,720456,0,0,158,158,
Tulsa,State Auditor,Cindy Byrd,REP,720456,0,0,553,553,
Tulsa,Attorney General,Mike Hunter,REP,720456,0,0,516,516,
Tulsa,Attorney General,Mark Myles,DEM,720456,0,0,231,231,
Tulsa,State Treasurer,Randy Mcdaniel,REP,720456,0,0,515,515,
Tulsa,State Treasurer,Charles De Coune,IND,720456,0,0,195,195,
Tulsa,Superintendent of Public Instruction,Joy Hofmeister,REP,720456,0,0,488,488,
Tulsa,Superintendent of Public Instruction,John Cox,DEM,720456,0,0,195,195,
Tulsa,Superintendent of Public Instruction,Larry Huff,IND,720456,0,0,64,64,
Tulsa,Commissioner of Labor,Leslie Osborn,REP,720456,0,0,480,480,
Tulsa,Commissioner of Labor,Fred Dorrell,DEM,720456,0,0,218,218,
Tulsa,Commissioner of Labor,Brandt Dismukes,IND,720456,0,0,43,43,
Tulsa,Insurance Commissioner,Glen Mulready,REP,720456,0,0,502,502,
Tulsa,Insurance Commissioner,Kimberly Fobbs,DEM,720456,0,0,242,242,
Tulsa,Corporation Commissioner,Bob Anthony,REP,720456,0,0,501,501,
Tulsa,Corporation Commissioner,Ashley Nicole Mccray,DEM,720456,0,0,207,207,
Tulsa,Corporation Commissioner,Jackie Short,IND,720456,0,0,37,37,
Tulsa,U.S. House,Kevin Hern,REP,720456,0,0,502,502,1
Tulsa,U.S. House,Tim Gilpin,DEM,720456,0,0,247,247,1
Tulsa,State House,Ross Ford,REP,720456,0,0,510,510,76
Tulsa,State House,Forrest Mayer,DEM,720456,0,0,235,235,76
Tulsa,Governor,Chris Powell,LIB,720457,0,0,0,0,
Tulsa,Governor,Kevin Stitt,REP,720457,0,0,6,6,
Tulsa,Governor,Drew Edmondson,DEM,720457,0,0,11,11,
Tulsa,Lieutenant Governor,Matt Pinnell,REP,720457,0,0,9,9,
Tulsa,Lieutenant Governor,Anastasia Pittman,DEM,720457,0,0,5,5,
Tulsa,Lieutenant Governor,Ivan Holmes,IND,720457,0,0,3,3,
Tulsa,State Auditor,John Yeutter,LIB,720457,0,0,5,5,
Tulsa,State Auditor,Cindy Byrd,REP,720457,0,0,10,10,
Tulsa,Attorney General,Mike Hunter,REP,720457,0,0,10,10,
Tulsa,Attorney General,Mark Myles,DEM,720457,0,0,7,7,
Tulsa,State Treasurer,Randy Mcdaniel,REP,720457,0,0,9,9,
Tulsa,State Treasurer,Charles De Coune,IND,720457,0,0,6,6,
Tulsa,Superintendent of Public Instruction,Joy Hofmeister,REP,720457,0,0,8,8,
Tulsa,Superintendent of Public Instruction,John Cox,DEM,720457,0,0,6,6,
Tulsa,Superintendent of Public Instruction,Larry Huff,IND,720457,0,0,3,3,
Tulsa,Commissioner of Labor,Leslie Osborn,REP,720457,0,0,10,10,
Tulsa,Commissioner of Labor,Fred Dorrell,DEM,720457,0,0,7,7,
Tulsa,Commissioner of Labor,Brandt Dismukes,IND,720457,0,0,0,0,
Tulsa,Insurance Commissioner,Glen Mulready,REP,720457,0,0,9,9,
Tulsa,Insurance Commissioner,Kimberly Fobbs,DEM,720457,0,0,8,8,
Tulsa,Corporation Commissioner,Bob Anthony,REP,720457,0,0,8,8,
Tulsa,Corporation Commissioner,Ashley Nicole Mccray,DEM,720457,0,0,6,6,
Tulsa,Corporation Commissioner,Jackie Short,IND,720457,0,0,3,3,
Tulsa,U.S. House,Kevin Hern,REP,720457,0,0,9,9,1
Tulsa,U.S. House,Tim Gilpin,DEM,720457,0,0,8,8,1
Tulsa,State Senate,Kim David,REP,720457,0,0,10,10,18
Tulsa,State Senate,Charles Arnall,DEM,720457,0,0,7,7,18
Tulsa,State House,Dean Davis,REP,720457,0,0,9,9,98
Tulsa,State House,Kilmyn Easley-Graf,DEM,720457,0,0,7,7,98
Tulsa,State House,Sean Parrish,IND,720457,0,0,1,1,98
Tulsa,Governor,Chris Powell,LIB,720458,0,0,47,47,
Tulsa,Governor,Kevin Stitt,REP,720458,0,0,905,905,
Tulsa,Governor,Drew Edmondson,DEM,720458,0,0,556,556,
Tulsa,Lieutenant Governor,Matt Pinnell,REP,720458,0,0,1000,1000,
Tulsa,Lieutenant Governor,Anastasia Pittman,DEM,720458,0,0,439,439,
Tulsa,Lieutenant Governor,Ivan Holmes,IND,720458,0,0,51,51,
Tulsa,State Auditor,John Yeutter,LIB,720458,0,0,316,316,
Tulsa,State Auditor,Cindy Byrd,REP,720458,0,0,1080,1080,
Tulsa,Attorney General,Mike Hunter,REP,720458,0,0,1034,1034,
Tulsa,Attorney General,Mark Myles,DEM,720458,0,0,453,453,
Tulsa,State Treasurer,Randy Mcdaniel,REP,720458,0,0,1026,1026,
Tulsa,State Treasurer,Charles De Coune,IND,720458,0,0,367,367,
Tulsa,Superintendent of Public Instruction,Joy Hofmeister,REP,720458,0,0,944,944,
Tulsa,Superintendent of Public Instruction,John Cox,DEM,720458,0,0,444,444,
Tulsa,Superintendent of Public Instruction,Larry Huff,IND,720458,0,0,102,102,
Tulsa,Commissioner of Labor,Leslie Osborn,REP,720458,0,0,967,967,
Tulsa,Commissioner of Labor,Fred Dorrell,DEM,720458,0,0,425,425,
Tulsa,Commissioner of Labor,Brandt Dismukes,IND,720458,0,0,81,81,
Tulsa,Insurance Commissioner,Glen Mulready,REP,720458,0,0,986,986,
Tulsa,Insurance Commissioner,Kimberly Fobbs,DEM,720458,0,0,488,488,
Tulsa,Corporation Commissioner,Bob Anthony,REP,720458,0,0,976,976,
Tulsa,Corporation Commissioner,Ashley Nicole Mccray,DEM,720458,0,0,436,436,
Tulsa,Corporation Commissioner,Jackie Short,IND,720458,0,0,70,70,
Tulsa,U.S. House,Kevin Hern,REP,720458,0,0,988,988,1
Tulsa,U.S. House,Tim Gilpin,DEM,720458,0,0,503,503,1
Tulsa,State House,Ross Ford,REP,720458,0,0,1034,1034,76
Tulsa,State House,Forrest Mayer,DEM,720458,0,0,450,450,76
Tulsa,Governor,Chris Powell,LIB,720459,0,0,28,28,
Tulsa,Governor,Kevin Stitt,REP,720459,0,0,320,320,
Tulsa,Governor,Drew Edmondson,DEM,720459,0,0,192,192,
Tulsa,Lieutenant Governor,Matt Pinnell,REP,720459,0,0,363,363,
Tulsa,Lieutenant Governor,Anastasia Pittman,DEM,720459,0,0,152,152,
Tulsa,Lieutenant Governor,Ivan Holmes,IND,720459,0,0,23,23,
Tulsa,State Auditor,John Yeutter,LIB,720459,0,0,104,104,
Tulsa,State Auditor,Cindy Byrd,REP,720459,0,0,389,389,
Tulsa,Attorney General,Mike Hunter,REP,720459,0,0,371,371,
Tulsa,Attorney General,Mark Myles,DEM,720459,0,0,165,165,
Tulsa,State Treasurer,Randy Mcdaniel,REP,720459,0,0,381,381,
Tulsa,State Treasurer,Charles De Coune,IND,720459,0,0,113,113,
Tulsa,Superintendent of Public Instruction,Joy Hofmeister,REP,720459,0,0,351,351,
Tulsa,Superintendent of Public Instruction,John Cox,DEM,720459,0,0,147,147,
Tulsa,Superintendent of Public Instruction,Larry Huff,IND,720459,0,0,40,40,
Tulsa,Commissioner of Labor,Leslie Osborn,REP,720459,0,0,345,345,
Tulsa,Commissioner of Labor,Fred Dorrell,DEM,720459,0,0,161,161,
Tulsa,Commissioner of Labor,Brandt Dismukes,IND,720459,0,0,28,28,
Tulsa,Insurance Commissioner,Glen Mulready,REP,720459,0,0,372,372,
Tulsa,Insurance Commissioner,Kimberly Fobbs,DEM,720459,0,0,159,159,
Tulsa,Corporation Commissioner,Bob Anthony,REP,720459,0,0,355,355,
Tulsa,Corporation Commissioner,Ashley Nicole Mccray,DEM,720459,0,0,151,151,
Tulsa,Corporation Commissioner,Jackie Short,IND,720459,0,0,29,29,
Tulsa,U.S. House,Kevin Hern,REP,720459,0,0,365,365,1
Tulsa,U.S. House,Tim Gilpin,DEM,720459,0,0,173,173,1
Tulsa,State House,Stan May,REP,720459,0,0,355,355,80
Tulsa,State House,Janice Graham,DEM,720459,0,0,180,180,80
Tulsa,Governor,Chris Powell,LIB,720460,0,0,17,17,
Tulsa,Governor,Kevin Stitt,REP,720460,0,0,534,534,
Tulsa,Governor,Drew Edmondson,DEM,720460,0,0,231,231,
Tulsa,Lieutenant Governor,Matt Pinnell,REP,720460,0,0,599,599,
Tulsa,Lieutenant Governor,Anastasia Pittman,DEM,720460,0,0,159,159,
Tulsa,Lieutenant Governor,Ivan Holmes,IND,720460,0,0,17,17,
Tulsa,State Auditor,John Yeutter,LIB,720460,0,0,118,118,
Tulsa,State Auditor,Cindy Byrd,REP,720460,0,0,628,628,
Tulsa,Attorney General,Mike Hunter,REP,720460,0,0,602,602,
Tulsa,Attorney General,Mark Myles,DEM,720460,0,0,170,170,
Tulsa,State Treasurer,Randy Mcdaniel,REP,720460,0,0,601,601,
Tulsa,State Treasurer,Charles De Coune,IND,720460,0,0,138,138,
Tulsa,Superintendent of Public Instruction,Joy Hofmeister,REP,720460,0,0,567,567,
Tulsa,Superintendent of Public Instruction,John Cox,DEM,720460,0,0,163,163,
Tulsa,Superintendent of Public Instruction,Larry Huff,IND,720460,0,0,46,46,
Tulsa,Commissioner of Labor,Leslie Osborn,REP,720460,0,0,582,582,
Tulsa,Commissioner of Labor,Fred Dorrell,DEM,720460,0,0,164,164,
Tulsa,Commissioner of Labor,Brandt Dismukes,IND,720460,0,0,25,25,
Tulsa,Insurance Commissioner,Glen Mulready,REP,720460,0,0,593,593,
Tulsa,Insurance Commissioner,Kimberly Fobbs,DEM,720460,0,0,177,177,
Tulsa,Corporation Commissioner,Bob Anthony,REP,720460,0,0,572,572,
Tulsa,Corporation Commissioner,Ashley Nicole Mccray,DEM,720460,0,0,163,163,
Tulsa,Corporation Commissioner,Jackie Short,IND,720460,0,0,34,34,
Tulsa,U.S. House,Kevin Hern,REP,720460,0,0,579,579,1
Tulsa,U.S. House,Tim Gilpin,DEM,720460,0,0,198,198,1
Tulsa,State House,Stan May,REP,720460,0,0,587,587,80
Tulsa,State House,Janice Graham,DEM,720460,0,0,184,184,80
Tulsa,Governor,Chris Powell,LIB,720461,0,0,23,23,
Tulsa,Governor,Kevin Stitt,REP,720461,0,0,386,386,
Tulsa,Governor,Drew Edmondson,DEM,720461,0,0,347,347,
Tulsa,Lieutenant Governor,Matt Pinnell,REP,720461,0,0,449,449,
Tulsa,Lieutenant Governor,Anastasia Pittman,DEM,720461,0,0,266,266,
Tulsa,Lieutenant Governor,Ivan Holmes,IND,720461,0,0,32,32,
Tulsa,State Auditor,John Yeutter,LIB,720461,0,0,163,163,
Tulsa,State Auditor,Cindy Byrd,REP,720461,0,0,504,504,
Tulsa,Attorney General,Mike Hunter,REP,720461,0,0,461,461,
Tulsa,Attorney General,Mark Myles,DEM,720461,0,0,282,282,
Tulsa,State Treasurer,Randy Mcdaniel,REP,720461,0,0,473,473,
Tulsa,State Treasurer,Charles De Coune,IND,720461,0,0,186,186,
Tulsa,Superintendent of Public Instruction,Joy Hofmeister,REP,720461,0,0,433,433,
Tulsa,Superintendent of Public Instruction,John Cox,DEM,720461,0,0,260,260,
Tulsa,Superintendent of Public Instruction,Larry Huff,IND,720461,0,0,50,50,
Tulsa,Commissioner of Labor,Leslie Osborn,REP,720461,0,0,436,436,
Tulsa,Commissioner of Labor,Fred Dorrell,DEM,720461,0,0,269,269,
Tulsa,Commissioner of Labor,Brandt Dismukes,IND,720461,0,0,30,30,
Tulsa,Insurance Commissioner,Glen Mulready,REP,720461,0,0,438,438,
Tulsa,Insurance Commissioner,Kimberly Fobbs,DEM,720461,0,0,302,302,
Tulsa,Corporation Commissioner,Bob Anthony,REP,720461,0,0,439,439,
Tulsa,Corporation Commissioner,Ashley Nicole Mccray,DEM,720461,0,0,264,264,
Tulsa,Corporation Commissioner,Jackie Short,IND,720461,0,0,41,41,
Tulsa,U.S. House,Kevin Hern,REP,720461,0,0,450,450,1
Tulsa,U.S. House,Tim Gilpin,DEM,720461,0,0,297,297,1
Tulsa,State House,Stan May,REP,720461,0,0,443,443,80
Tulsa,State House,Janice Graham,DEM,720461,0,0,306,306,80
Tulsa,Governor,Chris Powell,LIB,720462,0,0,46,46,
Tulsa,Governor,Kevin Stitt,REP,720462,0,0,709,709,
Tulsa,Governor,Drew Edmondson,DEM,720462,0,0,422,422,
Tulsa,Lieutenant Governor,Matt Pinnell,REP,720462,0,0,787,787,
Tulsa,Lieutenant Governor,Anastasia Pittman,DEM,720462,0,0,337,337,
Tulsa,Lieutenant Governor,Ivan Holmes,IND,720462,0,0,38,38,
Tulsa,State Auditor,John Yeutter,LIB,720462,0,0,247,247,
Tulsa,State Auditor,Cindy Byrd,REP,720462,0,0,847,847,
Tulsa,Attorney General,Mike Hunter,REP,720462,0,0,805,805,
Tulsa,Attorney General,Mark Myles,DEM,720462,0,0,343,343,
Tulsa,State Treasurer,Randy Mcdaniel,REP,720462,0,0,795,795,
Tulsa,State Treasurer,Charles De Coune,IND,720462,0,0,293,293,
Tulsa,Superintendent of Public Instruction,Joy Hofmeister,REP,720462,0,0,734,734,
Tulsa,Superintendent of Public Instruction,John Cox,DEM,720462,0,0,337,337,
Tulsa,Superintendent of Public Instruction,Larry Huff,IND,720462,0,0,95,95,
Tulsa,Commissioner of Labor,Leslie Osborn,REP,720462,0,0,755,755,
Tulsa,Commissioner of Labor,Fred Dorrell,DEM,720462,0,0,339,339,
Tulsa,Commissioner of Labor,Brandt Dismukes,IND,720462,0,0,58,58,
Tulsa,Insurance Commissioner,Glen Mulready,REP,720462,0,0,771,771,
Tulsa,Insurance Commissioner,Kimberly Fobbs,DEM,720462,0,0,376,376,
Tulsa,Corporation Commissioner,Bob Anthony,REP,720462,0,0,752,752,
Tulsa,Corporation Commissioner,Ashley Nicole Mccray,DEM,720462,0,0,334,334,
Tulsa,Corporation Commissioner,Jackie Short,IND,720462,0,0,66,66,
Tulsa,U.S. House,Kevin Hern,REP,720462,0,0,784,784,1
Tulsa,U.S. House,Tim Gilpin,DEM,720462,0,0,373,373,1
Tulsa,State House,Ross Ford,REP,720462,0,0,800,800,76
Tulsa,State House,Forrest Mayer,DEM,720462,0,0,359,359,76
Tulsa,Governor,Chris Powell,LIB,720463,0,0,28,28,
Tulsa,Governor,Kevin Stitt,REP,720463,0,0,410,410,
Tulsa,Governor,Drew Edmondson,DEM,720463,0,0,298,298,
Tulsa,Lieutenant Governor,Matt Pinnell,REP,720463,0,0,458,458,
Tulsa,Lieutenant Governor,Anastasia Pittman,DEM,720463,0,0,246,246,
Tulsa,Lieutenant Governor,Ivan Holmes,IND,720463,0,0,24,24,
Tulsa,State Auditor,John Yeutter,LIB,720463,0,0,162,162,
Tulsa,State Auditor,Cindy Byrd,REP,720463,0,0,501,501,
Tulsa,Attorney General,Mike Hunter,REP,720463,0,0,464,464,
Tulsa,Attorney General,Mark Myles,DEM,720463,0,0,261,261,
Tulsa,State Treasurer,Randy Mcdaniel,REP,720463,0,0,470,470,
Tulsa,State Treasurer,Charles De Coune,IND,720463,0,0,190,190,
Tulsa,Superintendent of Public Instruction,Joy Hofmeister,REP,720463,0,0,425,425,
Tulsa,Superintendent of Public Instruction,John Cox,DEM,720463,0,0,227,227,
Tulsa,Superintendent of Public Instruction,Larry Huff,IND,720463,0,0,75,75,
Tulsa,Commissioner of Labor,Leslie Osborn,REP,720463,0,0,430,430,
Tulsa,Commissioner of Labor,Fred Dorrell,DEM,720463,0,0,257,257,
Tulsa,Commissioner of Labor,Brandt Dismukes,IND,720463,0,0,30,30,
Tulsa,Insurance Commissioner,Glen Mulready,REP,720463,0,0,450,450,
Tulsa,Insurance Commissioner,Kimberly Fobbs,DEM,720463,0,0,269,269,
Tulsa,Corporation Commissioner,Bob Anthony,REP,720463,0,0,442,442,
Tulsa,Corporation Commissioner,Ashley Nicole Mccray,DEM,720463,0,0,236,236,
Tulsa,Corporation Commissioner,Jackie Short,IND,720463,0,0,40,40,
Tulsa,U.S. House,Kevin Hern,REP,720463,0,0,451,451,1
Tulsa,U.S. House,Tim Gilpin,DEM,720463,0,0,275,275,1
Tulsa,State House,Ross Ford,REP,720463,0,0,490,490,76
Tulsa,State House,Forrest Mayer,DEM,720463,0,0,236,236,76
Tulsa,Governor,Chris Powell,LIB,720464,0,0,46,46,
Tulsa,Governor,Kevin Stitt,REP,720464,0,0,921,921,
Tulsa,Governor,Drew Edmondson,DEM,720464,0,0,506,506,
Tulsa,Lieutenant Governor,Matt Pinnell,REP,720464,0,0,1033,1033,
Tulsa,Lieutenant Governor,Anastasia Pittman,DEM,720464,0,0,385,385,
Tulsa,Lieutenant Governor,Ivan Holmes,IND,720464,0,0,48,48,
Tulsa,State Auditor,John Yeutter,LIB,720464,0,0,296,296,
Tulsa,State Auditor,Cindy Byrd,REP,720464,0,0,1106,1106,
Tulsa,Attorney General,Mike Hunter,REP,720464,0,0,1060,1060,
Tulsa,Attorney General,Mark Myles,DEM,720464,0,0,392,392,
Tulsa,State Treasurer,Randy Mcdaniel,REP,720464,0,0,1067,1067,
Tulsa,State Treasurer,Charles De Coune,IND,720464,0,0,325,325,
Tulsa,Superintendent of Public Instruction,Joy Hofmeister,REP,720464,0,0,986,986,
Tulsa,Superintendent of Public Instruction,John Cox,DEM,720464,0,0,358,358,
Tulsa,Superintendent of Public Instruction,Larry Huff,IND,720464,0,0,115,115,
Tulsa,Commissioner of Labor,Leslie Osborn,REP,720464,0,0,1015,1015,
Tulsa,Commissioner of Labor,Fred Dorrell,DEM,720464,0,0,362,362,
Tulsa,Commissioner of Labor,Brandt Dismukes,IND,720464,0,0,72,72,
Tulsa,Insurance Commissioner,Glen Mulready,REP,720464,0,0,1025,1025,
Tulsa,Insurance Commissioner,Kimberly Fobbs,DEM,720464,0,0,419,419,
Tulsa,Corporation Commissioner,Bob Anthony,REP,720464,0,0,1007,1007,
Tulsa,Corporation Commissioner,Ashley Nicole Mccray,DEM,720464,0,0,368,368,
Tulsa,Corporation Commissioner,Jackie Short,IND,720464,0,0,81,81,
Tulsa,U.S. House,Kevin Hern,REP,720464,0,0,1033,1033,1
Tulsa,U.S. House,Tim Gilpin,DEM,720464,0,0,427,427,1
Tulsa,State House,Stan May,REP,720464,0,0,1026,1026,80
Tulsa,State House,Janice Graham,DEM,720464,0,0,436,436,80
Tulsa,Governor,Chris Powell,LIB,720465,0,0,36,36,
Tulsa,Governor,Kevin Stitt,REP,720465,0,0,589,589,
Tulsa,Governor,Drew Edmondson,DEM,720465,0,0,614,614,
Tulsa,Lieutenant Governor,Matt Pinnell,REP,720465,0,0,684,684,
Tulsa,Lieutenant Governor,Anastasia Pittman,DEM,720465,0,0,505,505,
Tulsa,Lieutenant Governor,Ivan Holmes,IND,720465,0,0,42,42,
Tulsa,State Auditor,John Yeutter,LIB,720465,0,0,344,344,
Tulsa,State Auditor,Cindy Byrd,REP,720465,0,0,765,765,
Tulsa,Attorney General,Mike Hunter,REP,720465,0,0,670,670,
Tulsa,Attorney General,Mark Myles,DEM,720465,0,0,553,553,
Tulsa,State Treasurer,Randy Mcdaniel,REP,720465,0,0,702,702,
Tulsa,State Treasurer,Charles De Coune,IND,720465,0,0,410,410,
Tulsa,Superintendent of Public Instruction,Joy Hofmeister,REP,720465,0,0,650,650,
Tulsa,Superintendent of Public Instruction,John Cox,DEM,720465,0,0,481,481,
Tulsa,Superintendent of Public Instruction,Larry Huff,IND,720465,0,0,94,94,
Tulsa,Commissioner of Labor,Leslie Osborn,REP,720465,0,0,633,633,
Tulsa,Commissioner of Labor,Fred Dorrell,DEM,720465,0,0,512,512,
Tulsa,Commissioner of Labor,Brandt Dismukes,IND,720465,0,0,65,65,
Tulsa,Insurance Commissioner,Glen Mulready,REP,720465,0,0,660,660,
Tulsa,Insurance Commissioner,Kimberly Fobbs,DEM,720465,0,0,554,554,
Tulsa,Corporation Commissioner,Bob Anthony,REP,720465,0,0,646,646,
Tulsa,Corporation Commissioner,Ashley Nicole Mccray,DEM,720465,0,0,496,496,
Tulsa,Corporation Commissioner,Jackie Short,IND,720465,0,0,73,73,
Tulsa,U.S. House,Kevin Hern,REP,720465,0,0,662,662,1
Tulsa,U.S. House,Tim Gilpin,DEM,720465,0,0,565,565,1
Tulsa,State Senate,John Haste,REP,720465,0,0,663,663,36
Tulsa,State Senate,Bryan O'Brien,DEM,720465,0,0,556,556,36
Tulsa,State House,Ross Ford,REP,720465,0,0,710,710,76
Tulsa,State House,Forrest Mayer,DEM,720465,0,0,513,513,76
Tulsa,Governor,Chris Powell,LIB,720466,0,0,29,29,
Tulsa,Governor,Kevin Stitt,REP,720466,0,0,626,626,
Tulsa,Governor,Drew Edmondson,DEM,720466,0,0,381,381,
Tulsa,Lieutenant Governor,Matt Pinnell,REP,720466,0,0,721,721,
Tulsa,Lieutenant Governor,Anastasia Pittman,DEM,720466,0,0,286,286,
Tulsa,Lieutenant Governor,Ivan Holmes,IND,720466,0,0,22,22,
Tulsa,State Auditor,John Yeutter,LIB,720466,0,0,185,185,
Tulsa,State Auditor,Cindy Byrd,REP,720466,0,0,767,767,
Tulsa,Attorney General,Mike Hunter,REP,720466,0,0,714,714,
Tulsa,Attorney General,Mark Myles,DEM,720466,0,0,310,310,
Tulsa,State Treasurer,Randy Mcdaniel,REP,720466,0,0,725,725,
Tulsa,State Treasurer,Charles De Coune,IND,720466,0,0,220,220,
Tulsa,Superintendent of Public Instruction,Joy Hofmeister,REP,720466,0,0,689,689,
Tulsa,Superintendent of Public Instruction,John Cox,DEM,720466,0,0,267,267,
Tulsa,Superintendent of Public Instruction,Larry Huff,IND,720466,0,0,70,70,
Tulsa,Commissioner of Labor,Leslie Osborn,REP,720466,0,0,681,681,
Tulsa,Commissioner of Labor,Fred Dorrell,DEM,720466,0,0,299,299,
Tulsa,Commissioner of Labor,Brandt Dismukes,IND,720466,0,0,37,37,
Tulsa,Insurance Commissioner,Glen Mulready,REP,720466,0,0,694,694,
Tulsa,Insurance Commissioner,Kimberly Fobbs,DEM,720466,0,0,321,321,
Tulsa,Corporation Commissioner,Bob Anthony,REP,720466,0,0,683,683,
Tulsa,Corporation Commissioner,Ashley Nicole Mccray,DEM,720466,0,0,283,283,
Tulsa,Corporation Commissioner,Jackie Short,IND,720466,0,0,52,52,
Tulsa,U.S. House,Kevin Hern,REP,720466,0,0,709,709,1
Tulsa,U.S. House,Tim Gilpin,DEM,720466,0,0,317,317,1
Tulsa,State Senate,John Haste,REP,720466,0,0,713,713,36
Tulsa,State Senate,Bryan O'Brien,DEM,720466,0,0,311,311,36
Tulsa,State House,Dean Davis,REP,720466,0,0,649,649,98
Tulsa,State House,Kilmyn Easley-Graf,DEM,720466,0,0,362,362,98
Tulsa,State House,Sean Parrish,IND,720466,0,0,18,18,98
Tulsa,Governor,Chris Powell,LIB,720467,0,0,6,6,
Tulsa,Governor,Kevin Stitt,REP,720467,0,0,235,235,
Tulsa,Governor,Drew Edmondson,DEM,720467,0,0,147,147,
Tulsa,Lieutenant Governor,Matt Pinnell,REP,720467,0,0,265,265,
Tulsa,Lieutenant Governor,Anastasia Pittman,DEM,720467,0,0,115,115,
Tulsa,Lieutenant Governor,Ivan Holmes,IND,720467,0,0,6,6,
Tulsa,State Auditor,John Yeutter,LIB,720467,0,0,65,65,
Tulsa,State Auditor,Cindy Byrd,REP,720467,0,0,297,297,
Tulsa,Attorney General,Mike Hunter,REP,720467,0,0,266,266,
Tulsa,Attorney General,Mark Myles,DEM,720467,0,0,116,116,
Tulsa,State Treasurer,Randy Mcdaniel,REP,720467,0,0,277,277,
Tulsa,State Treasurer,Charles De Coune,IND,720467,0,0,85,85,
Tulsa,Superintendent of Public Instruction,Joy Hofmeister,REP,720467,0,0,248,248,
Tulsa,Superintendent of Public Instruction,John Cox,DEM,720467,0,0,109,109,
Tulsa,Superintendent of Public Instruction,Larry Huff,IND,720467,0,0,23,23,
Tulsa,Commissioner of Labor,Leslie Osborn,REP,720467,0,0,257,257,
Tulsa,Commissioner of Labor,Fred Dorrell,DEM,720467,0,0,113,113,
Tulsa,Commissioner of Labor,Brandt Dismukes,IND,720467,0,0,10,10,
Tulsa,Insurance Commissioner,Glen Mulready,REP,720467,0,0,249,249,
Tulsa,Insurance Commissioner,Kimberly Fobbs,DEM,720467,0,0,130,130,
Tulsa,Corporation Commissioner,Bob Anthony,REP,720467,0,0,249,249,
Tulsa,Corporation Commissioner,Ashley Nicole Mccray,DEM,720467,0,0,111,111,
Tulsa,Corporation Commissioner,Jackie Short,IND,720467,0,0,15,15,
Tulsa,U.S. House,Kevin Hern,REP,720467,0,0,254,254,1
Tulsa,U.S. House,Tim Gilpin,DEM,720467,0,0,128,128,1
Tulsa,State House,Stan May,REP,720467,0,0,258,258,80
Tulsa,State House,Janice Graham,DEM,720467,0,0,126,126,80
Tulsa,Governor,Chris Powell,LIB,720468,0,0,39,39,
Tulsa,Governor,Kevin Stitt,REP,720468,0,0,728,728,
Tulsa,Governor,Drew Edmondson,DEM,720468,0,0,517,517,
Tulsa,Lieutenant Governor,Matt Pinnell,REP,720468,0,0,836,836,
Tulsa,Lieutenant Governor,Anastasia Pittman,DEM,720468,0,0,400,400,
Tulsa,Lieutenant Governor,Ivan Holmes,IND,720468,0,0,35,35,
Tulsa,State Auditor,John Yeutter,LIB,720468,0,0,284,284,
Tulsa,State Auditor,Cindy Byrd,REP,720468,0,0,876,876,
Tulsa,Attorney General,Mike Hunter,REP,720468,0,0,830,830,
Tulsa,Attorney General,Mark Myles,DEM,720468,0,0,434,434,
Tulsa,State Treasurer,Randy Mcdaniel,REP,720468,0,0,835,835,
Tulsa,State Treasurer,Charles De Coune,IND,720468,0,0,319,319,
Tulsa,Superintendent of Public Instruction,Joy Hofmeister,REP,720468,0,0,779,779,
Tulsa,Superintendent of Public Instruction,John Cox,DEM,720468,0,0,405,405,
Tulsa,Superintendent of Public Instruction,Larry Huff,IND,720468,0,0,84,84,
Tulsa,Commissioner of Labor,Leslie Osborn,REP,720468,0,0,790,790,
Tulsa,Commissioner of Labor,Fred Dorrell,DEM,720468,0,0,399,399,
Tulsa,Commissioner of Labor,Brandt Dismukes,IND,720468,0,0,57,57,
Tulsa,Insurance Commissioner,Glen Mulready,REP,720468,0,0,814,814,
Tulsa,Insurance Commissioner,Kimberly Fobbs,DEM,720468,0,0,441,441,
Tulsa,Corporation Commissioner,Bob Anthony,REP,720468,0,0,790,790,
Tulsa,Corporation Commissioner,Ashley Nicole Mccray,DEM,720468,0,0,399,399,
Tulsa,Corporation Commissioner,Jackie Short,IND,720468,0,0,62,62,
Tulsa,U.S. House,Kevin Hern,REP,720468,0,0,790,790,1
Tulsa,U.S. House,Tim Gilpin,DEM,720468,0,0,477,477,1
Tulsa,State House,Ross Ford,REP,720468,0,0,870,870,76
Tulsa,State House,Forrest Mayer,DEM,720468,0,0,396,396,76
Tulsa,Governor,Chris Powell,LIB,720469,0,0,16,16,
Tulsa,Governor,Kevin Stitt,REP,720469,0,0,163,163,
Tulsa,Governor,Drew Edmondson,DEM,720469,0,0,115,115,
Tulsa,Lieutenant Governor,Matt Pinnell,REP,720469,0,0,185,185,
Tulsa,Lieutenant Governor,Anastasia Pittman,DEM,720469,0,0,95,95,
Tulsa,Lieutenant Governor,Ivan Holmes,IND,720469,0,0,13,13,
Tulsa,State Auditor,John Yeutter,LIB,720469,0,0,73,73,
Tulsa,State Auditor,Cindy Byrd,REP,720469,0,0,200,200,
Tulsa,Attorney General,Mike Hunter,REP,720469,0,0,199,199,
Tulsa,Attorney General,Mark Myles,DEM,720469,0,0,95,95,
Tulsa,State Treasurer,Randy Mcdaniel,REP,720469,0,0,196,196,
Tulsa,State Treasurer,Charles De Coune,IND,720469,0,0,79,79,
Tulsa,Superintendent of Public Instruction,Joy Hofmeister,REP,720469,0,0,170,170,
Tulsa,Superintendent of Public Instruction,John Cox,DEM,720469,0,0,98,98,
Tulsa,Superintendent of Public Instruction,Larry Huff,IND,720469,0,0,22,22,
Tulsa,Commissioner of Labor,Leslie Osborn,REP,720469,0,0,170,170,
Tulsa,Commissioner of Labor,Fred Dorrell,DEM,720469,0,0,99,99,
Tulsa,Commissioner of Labor,Brandt Dismukes,IND,720469,0,0,19,19,
Tulsa,Insurance Commissioner,Glen Mulready,REP,720469,0,0,189,189,
Tulsa,Insurance Commissioner,Kimberly Fobbs,DEM,720469,0,0,100,100,
Tulsa,Corporation Commissioner,Bob Anthony,REP,720469,0,0,178,178,
Tulsa,Corporation Commissioner,Ashley Nicole Mccray,DEM,720469,0,0,93,93,
Tulsa,Corporation Commissioner,Jackie Short,IND,720469,0,0,21,21,
Tulsa,U.S. House,Kevin Hern,REP,720469,0,0,193,193,1
Tulsa,U.S. House,Tim Gilpin,DEM,720469,0,0,100,100,1
Tulsa,State Senate,John Haste,REP,720469,0,0,193,193,36
Tulsa,State Senate,Bryan O'Brien,DEM,720469,0,0,99,99,36
Tulsa,State House,Dean Davis,REP,720469,0,0,165,165,98
Tulsa,State House,Kilmyn Easley-Graf,DEM,720469,0,0,119,119,98
Tulsa,State House,Sean Parrish,IND,720469,0,0,10,10,98
Tulsa,Governor,Chris Powell,LIB,720470,0,0,28,28,
Tulsa,Governor,Kevin Stitt,REP,720470,0,0,692,692,
Tulsa,Governor,Drew Edmondson,DEM,720470,0,0,560,560,
Tulsa,Lieutenant Governor,Matt Pinnell,REP,720470,0,0,793,793,
Tulsa,Lieutenant Governor,Anastasia Pittman,DEM,720470,0,0,437,437,
Tulsa,Lieutenant Governor,Ivan Holmes,IND,720470,0,0,30,30,
Tulsa,State Auditor,John Yeutter,LIB,720470,0,0,267,267,
Tulsa,State Auditor,Cindy Byrd,REP,720470,0,0,875,875,
Tulsa,Attorney General,Mike Hunter,REP,720470,0,0,799,799,
Tulsa,Attorney General,Mark Myles,DEM,720470,0,0,445,445,
Tulsa,State Treasurer,Randy Mcdaniel,REP,720470,0,0,819,819,
Tulsa,State Treasurer,Charles De Coune,IND,720470,0,0,328,328,
Tulsa,Superintendent of Public Instruction,Joy Hofmeister,REP,720470,0,0,781,781,
Tulsa,Superintendent of Public Instruction,John Cox,DEM,720470,0,0,412,412,
Tulsa,Superintendent of Public Instruction,Larry Huff,IND,720470,0,0,64,64,
Tulsa,Commissioner of Labor,Leslie Osborn,REP,720470,0,0,770,770,
Tulsa,Commissioner of Labor,Fred Dorrell,DEM,720470,0,0,413,413,
Tulsa,Commissioner of Labor,Brandt Dismukes,IND,720470,0,0,45,45,
Tulsa,Insurance Commissioner,Glen Mulready,REP,720470,0,0,786,786,
Tulsa,Insurance Commissioner,Kimberly Fobbs,DEM,720470,0,0,445,445,
Tulsa,Corporation Commissioner,Bob Anthony,REP,720470,0,0,757,757,
Tulsa,Corporation Commissioner,Ashley Nicole Mccray,DEM,720470,0,0,420,420,
Tulsa,Corporation Commissioner,Jackie Short,IND,720470,0,0,53,53,
Tulsa,U.S. House,Kevin Hern,REP,720470,0,0,768,768,1
Tulsa,U.S. House,Tim Gilpin,DEM,720470,0,0,486,486,1
Tulsa,State House,Ross Ford,REP,720470,0,0,855,855,76
Tulsa,State House,Forrest Mayer,DEM,720470,0,0,398,398,76
Tulsa,Governor,Chris Powell,LIB,720471,0,0,11,11,
Tulsa,Governor,Kevin Stitt,REP,720471,0,0,395,395,
Tulsa,Governor,Drew Edmondson,DEM,720471,0,0,169,169,
Tulsa,Lieutenant Governor,Matt Pinnell,REP,720471,0,0,430,430,
Tulsa,Lieutenant Governor,Anastasia Pittman,DEM,720471,0,0,130,130,
Tulsa,Lieutenant Governor,Ivan Holmes,IND,720471,0,0,9,9,
Tulsa,State Auditor,John Yeutter,LIB,720471,0,0,80,80,
Tulsa,State Auditor,Cindy Byrd,REP,720471,0,0,462,462,
Tulsa,Attorney General,Mike Hunter,REP,720471,0,0,427,427,
Tulsa,Attorney General,Mark Myles,DEM,720471,0,0,137,137,
Tulsa,State Treasurer,Randy Mcdaniel,REP,720471,0,0,429,429,
Tulsa,State Treasurer,Charles De Coune,IND,720471,0,0,109,109,
Tulsa,Superintendent of Public Instruction,Joy Hofmeister,REP,720471,0,0,393,393,
Tulsa,Superintendent of Public Instruction,John Cox,DEM,720471,0,0,153,153,
Tulsa,Superintendent of Public Instruction,Larry Huff,IND,720471,0,0,22,22,
Tulsa,Commissioner of Labor,Leslie Osborn,REP,720471,0,0,401,401,
Tulsa,Commissioner of Labor,Fred Dorrell,DEM,720471,0,0,134,134,
Tulsa,Commissioner of Labor,Brandt Dismukes,IND,720471,0,0,23,23,
Tulsa,Insurance Commissioner,Glen Mulready,REP,720471,0,0,427,427,
Tulsa,Insurance Commissioner,Kimberly Fobbs,DEM,720471,0,0,134,134,
Tulsa,Corporation Commissioner,Bob Anthony,REP,720471,0,0,412,412,
Tulsa,Corporation Commissioner,Ashley Nicole Mccray,DEM,720471,0,0,134,134,
Tulsa,Corporation Commissioner,Jackie Short,IND,720471,0,0,16,16,
Tulsa,U.S. House,Kevin Hern,REP,720471,0,0,425,425,1
Tulsa,U.S. House,Tim Gilpin,DEM,720471,0,0,141,141,1
Tulsa,State House,Ross Ford,REP,720471,0,0,438,438,76
Tulsa,State House,Forrest Mayer,DEM,720471,0,0,127,127,76
Tulsa,Governor,Chris Powell,LIB,720472,0,0,13,13,
Tulsa,Governor,Kevin Stitt,REP,720472,0,0,282,282,
Tulsa,Governor,Drew Edmondson,DEM,720472,0,0,171,171,
Tulsa,Lieutenant Governor,Matt Pinnell,REP,720472,0,0,316,316,
Tulsa,Lieutenant Governor,Anastasia Pittman,DEM,720472,0,0,134,134,
Tulsa,Lieutenant Governor,Ivan Holmes,IND,720472,0,0,14,14,
Tulsa,State Auditor,John Yeutter,LIB,720472,0,0,88,88,
Tulsa,State Auditor,Cindy Byrd,REP,720472,0,0,344,344,
Tulsa,Attorney General,Mike Hunter,REP,720472,0,0,320,320,
Tulsa,Attorney General,Mark Myles,DEM,720472,0,0,140,140,
Tulsa,State Treasurer,Randy Mcdaniel,REP,720472,0,0,322,322,
Tulsa,State Treasurer,Charles De Coune,IND,720472,0,0,107,107,
Tulsa,Superintendent of Public Instruction,Joy Hofmeister,REP,720472,0,0,291,291,
Tulsa,Superintendent of Public Instruction,John Cox,DEM,720472,0,0,143,143,
Tulsa,Superintendent of Public Instruction,Larry Huff,IND,720472,0,0,27,27,
Tulsa,Commissioner of Labor,Leslie Osborn,REP,720472,0,0,296,296,
Tulsa,Commissioner of Labor,Fred Dorrell,DEM,720472,0,0,142,142,
Tulsa,Commissioner of Labor,Brandt Dismukes,IND,720472,0,0,15,15,
Tulsa,Insurance Commissioner,Glen Mulready,REP,720472,0,0,306,306,
Tulsa,Insurance Commissioner,Kimberly Fobbs,DEM,720472,0,0,146,146,
Tulsa,Corporation Commissioner,Bob Anthony,REP,720472,0,0,308,308,
Tulsa,Corporation Commissioner,Ashley Nicole Mccray,DEM,720472,0,0,123,123,
Tulsa,Corporation Commissioner,Jackie Short,IND,720472,0,0,19,19,
Tulsa,U.S. House,Kevin Hern,REP,720472,0,0,314,314,1
Tulsa,U.S. House,Tim Gilpin,DEM,720472,0,0,149,149,1
Tulsa,State House,Stan May,REP,720472,0,0,310,310,80
Tulsa,State House,Janice Graham,DEM,720472,0,0,147,147,80
Tulsa,Governor,Chris Powell,LIB,720473,0,0,22,22,
Tulsa,Governor,Kevin Stitt,REP,720473,0,0,415,415,
Tulsa,Governor,Drew Edmondson,DEM,720473,0,0,272,272,
Tulsa,Lieutenant Governor,Matt Pinnell,REP,720473,0,0,459,459,
Tulsa,Lieutenant Governor,Anastasia Pittman,DEM,720473,0,0,214,214,
Tulsa,Lieutenant Governor,Ivan Holmes,IND,720473,0,0,33,33,
Tulsa,State Auditor,John Yeutter,LIB,720473,0,0,136,136,
Tulsa,State Auditor,Cindy Byrd,REP,720473,0,0,525,525,
Tulsa,Attorney General,Mike Hunter,REP,720473,0,0,486,486,
Tulsa,Attorney General,Mark Myles,DEM,720473,0,0,220,220,
Tulsa,State Treasurer,Randy Mcdaniel,REP,720473,0,0,503,503,
Tulsa,State Treasurer,Charles De Coune,IND,720473,0,0,160,160,
Tulsa,Superintendent of Public Instruction,Joy Hofmeister,REP,720473,0,0,441,441,
Tulsa,Superintendent of Public Instruction,John Cox,DEM,720473,0,0,213,213,
Tulsa,Superintendent of Public Instruction,Larry Huff,IND,720473,0,0,49,49,
Tulsa,Commissioner of Labor,Leslie Osborn,REP,720473,0,0,446,446,
Tulsa,Commissioner of Labor,Fred Dorrell,DEM,720473,0,0,215,215,
Tulsa,Commissioner of Labor,Brandt Dismukes,IND,720473,0,0,30,30,
Tulsa,Insurance Commissioner,Glen Mulready,REP,720473,0,0,459,459,
Tulsa,Insurance Commissioner,Kimberly Fobbs,DEM,720473,0,0,235,235,
Tulsa,Corporation Commissioner,Bob Anthony,REP,720473,0,0,466,466,
Tulsa,Corporation Commissioner,Ashley Nicole Mccray,DEM,720473,0,0,197,197,
Tulsa,Corporation Commissioner,Jackie Short,IND,720473,0,0,37,37,
Tulsa,U.S. House,Kevin Hern,REP,720473,0,0,469,469,1
Tulsa,U.S. House,Tim Gilpin,DEM,720473,0,0,234,234,1
Tulsa,State House,Stan May,REP,720473,0,0,449,449,80
Tulsa,State House,Janice Graham,DEM,720473,0,0,250,250,80
Tulsa,Governor,Chris Powell,LIB,720474,0,0,45,45,
Tulsa,Governor,Kevin Stitt,REP,720474,0,0,728,728,
Tulsa,Governor,Drew Edmondson,DEM,720474,0,0,518,518,
Tulsa,Lieutenant Governor,Matt Pinnell,REP,720474,0,0,850,850,
Tulsa,Lieutenant Governor,Anastasia Pittman,DEM,720474,0,0,378,378,
Tulsa,Lieutenant Governor,Ivan Holmes,IND,720474,0,0,45,45,
Tulsa,State Auditor,John Yeutter,LIB,720474,0,0,265,265,
Tulsa,State Auditor,Cindy Byrd,REP,720474,0,0,915,915,
Tulsa,Attorney General,Mike Hunter,REP,720474,0,0,855,855,
Tulsa,Attorney General,Mark Myles,DEM,720474,0,0,409,409,
Tulsa,State Treasurer,Randy Mcdaniel,REP,720474,0,0,849,849,
Tulsa,State Treasurer,Charles De Coune,IND,720474,0,0,327,327,
Tulsa,Superintendent of Public Instruction,Joy Hofmeister,REP,720474,0,0,771,771,
Tulsa,Superintendent of Public Instruction,John Cox,DEM,720474,0,0,390,390,
Tulsa,Superintendent of Public Instruction,Larry Huff,IND,720474,0,0,109,109,
Tulsa,Commissioner of Labor,Leslie Osborn,REP,720474,0,0,785,785,
Tulsa,Commissioner of Labor,Fred Dorrell,DEM,720474,0,0,392,392,
Tulsa,Commissioner of Labor,Brandt Dismukes,IND,720474,0,0,71,71,
Tulsa,Insurance Commissioner,Glen Mulready,REP,720474,0,0,814,814,
Tulsa,Insurance Commissioner,Kimberly Fobbs,DEM,720474,0,0,437,437,
Tulsa,Corporation Commissioner,Bob Anthony,REP,720474,0,0,816,816,
Tulsa,Corporation Commissioner,Ashley Nicole Mccray,DEM,720474,0,0,374,374,
Tulsa,Corporation Commissioner,Jackie Short,IND,720474,0,0,68,68,
Tulsa,U.S. House,Kevin Hern,REP,720474,0,0,837,837,1
Tulsa,U.S. House,Tim Gilpin,DEM,720474,0,0,435,435,1
Tulsa,State House,Ross Ford,REP,720474,0,0,883,883,76
Tulsa,State House,Forrest Mayer,DEM,720474,0,0,381,381,76
Tulsa,Governor,Chris Powell,LIB,720475,0,0,43,43,
Tulsa,Governor,Kevin Stitt,REP,720475,0,0,913,913,
Tulsa,Governor,Drew Edmondson,DEM,720475,0,0,618,618,
Tulsa,Lieutenant Governor,Matt Pinnell,REP,720475,0,0,1015,1015,
Tulsa,Lieutenant Governor,Anastasia Pittman,DEM,720475,0,0,502,502,
Tulsa,Lieutenant Governor,Ivan Holmes,IND,720475,0,0,44,44,
Tulsa,State Auditor,John Yeutter,LIB,720475,0,0,346,346,
Tulsa,State Auditor,Cindy Byrd,REP,720475,0,0,1080,1080,
Tulsa,Attorney General,Mike Hunter,REP,720475,0,0,1030,1030,
Tulsa,Attorney General,Mark Myles,DEM,720475,0,0,514,514,
Tulsa,State Treasurer,Randy Mcdaniel,REP,720475,0,0,1040,1040,
Tulsa,State Treasurer,Charles De Coune,IND,720475,0,0,384,384,
Tulsa,Superintendent of Public Instruction,Joy Hofmeister,REP,720475,0,0,967,967,
Tulsa,Superintendent of Public Instruction,John Cox,DEM,720475,0,0,490,490,
Tulsa,Superintendent of Public Instruction,Larry Huff,IND,720475,0,0,95,95,
Tulsa,Commissioner of Labor,Leslie Osborn,REP,720475,0,0,960,960,
Tulsa,Commissioner of Labor,Fred Dorrell,DEM,720475,0,0,497,497,
Tulsa,Commissioner of Labor,Brandt Dismukes,IND,720475,0,0,63,63,
Tulsa,Insurance Commissioner,Glen Mulready,REP,720475,0,0,973,973,
Tulsa,Insurance Commissioner,Kimberly Fobbs,DEM,720475,0,0,546,546,
Tulsa,Corporation Commissioner,Bob Anthony,REP,720475,0,0,969,969,
Tulsa,Corporation Commissioner,Ashley Nicole Mccray,DEM,720475,0,0,485,485,
Tulsa,Corporation Commissioner,Jackie Short,IND,720475,0,0,73,73,
Tulsa,U.S. House,Kevin Hern,REP,720475,0,0,1001,1001,1
Tulsa,U.S. House,Tim Gilpin,DEM,720475,0,0,560,560,1
Tulsa,State Senate,John Haste,REP,720475,0,0,1013,1013,36
Tulsa,State Senate,Bryan O'Brien,DEM,720475,0,0,538,538,36
Tulsa,State House,Kelli Krebs,LIB,720475,0,0,68,68,75
Tulsa,State House,T. Marti,REP,720475,0,0,969,969,75
Tulsa,State House,Karen Gaddis,DEM,720475,0,0,528,528,75
Tulsa,Governor,Chris Powell,LIB,720476,0,0,13,13,
Tulsa,Governor,Kevin Stitt,REP,720476,0,0,361,361,
Tulsa,Governor,Drew Edmondson,DEM,720476,0,0,200,200,
Tulsa,Lieutenant Governor,Matt Pinnell,REP,720476,0,0,408,408,
Tulsa,Lieutenant Governor,Anastasia Pittman,DEM,720476,0,0,147,147,
Tulsa,Lieutenant Governor,Ivan Holmes,IND,720476,0,0,12,12,
Tulsa,State Auditor,John Yeutter,LIB,720476,0,0,94,94,
Tulsa,State Auditor,Cindy Byrd,REP,720476,0,0,452,452,
Tulsa,Attorney General,Mike Hunter,REP,720476,0,0,420,420,
Tulsa,Attorney General,Mark Myles,DEM,720476,0,0,144,144,
Tulsa,State Treasurer,Randy Mcdaniel,REP,720476,0,0,435,435,
Tulsa,State Treasurer,Charles De Coune,IND,720476,0,0,115,115,
Tulsa,Superintendent of Public Instruction,Joy Hofmeister,REP,720476,0,0,378,378,
Tulsa,Superintendent of Public Instruction,John Cox,DEM,720476,0,0,150,150,
Tulsa,Superintendent of Public Instruction,Larry Huff,IND,720476,0,0,38,38,
Tulsa,Commissioner of Labor,Leslie Osborn,REP,720476,0,0,391,391,
Tulsa,Commissioner of Labor,Fred Dorrell,DEM,720476,0,0,141,141,
Tulsa,Commissioner of Labor,Brandt Dismukes,IND,720476,0,0,26,26,
Tulsa,Insurance Commissioner,Glen Mulready,REP,720476,0,0,404,404,
Tulsa,Insurance Commissioner,Kimberly Fobbs,DEM,720476,0,0,155,155,
Tulsa,Corporation Commissioner,Bob Anthony,REP,720476,0,0,402,402,
Tulsa,Corporation Commissioner,Ashley Nicole Mccray,DEM,720476,0,0,139,139,
Tulsa,Corporation Commissioner,Jackie Short,IND,720476,0,0,25,25,
Tulsa,U.S. House,Kevin Hern,REP,720476,0,0,406,406,1
Tulsa,U.S. House,Tim Gilpin,DEM,720476,0,0,163,163,1
Tulsa,State Senate,Kim David,REP,720476,0,0,417,417,18
Tulsa,State Senate,Charles Arnall,DEM,720476,0,0,145,145,18
Tulsa,State House,Dean Davis,REP,720476,0,0,362,362,98
Tulsa,State House,Kilmyn Easley-Graf,DEM,720476,0,0,200,200,98
Tulsa,State House,Sean Parrish,IND,720476,0,0,4,4,98
Tulsa,Governor,Chris Powell,LIB,720501,0,0,13,13,
Tulsa,Governor,Kevin Stitt,REP,720501,0,0,433,433,
Tulsa,Governor,Drew Edmondson,DEM,720501,0,0,202,202,
Tulsa,Lieutenant Governor,Matt Pinnell,REP,720501,0,0,493,493,
Tulsa,Lieutenant Governor,Anastasia Pittman,DEM,720501,0,0,145,145,
Tulsa,Lieutenant Governor,Ivan Holmes,IND,720501,0,0,7,7,
Tulsa,State Auditor,John Yeutter,LIB,720501,0,0,109,109,
Tulsa,State Auditor,Cindy Byrd,REP,720501,0,0,515,515,
Tulsa,Attorney General,Mike Hunter,REP,720501,0,0,491,491,
Tulsa,Attorney General,Mark Myles,DEM,720501,0,0,152,152,
Tulsa,State Treasurer,Randy Mcdaniel,REP,720501,0,0,490,490,
Tulsa,State Treasurer,Charles De Coune,IND,720501,0,0,127,127,
Tulsa,Superintendent of Public Instruction,Joy Hofmeister,REP,720501,0,0,430,430,
Tulsa,Superintendent of Public Instruction,John Cox,DEM,720501,0,0,170,170,
Tulsa,Superintendent of Public Instruction,Larry Huff,IND,720501,0,0,46,46,
Tulsa,Commissioner of Labor,Leslie Osborn,REP,720501,0,0,469,469,
Tulsa,Commissioner of Labor,Fred Dorrell,DEM,720501,0,0,143,143,
Tulsa,Commissioner of Labor,Brandt Dismukes,IND,720501,0,0,18,18,
Tulsa,Insurance Commissioner,Glen Mulready,REP,720501,0,0,468,468,
Tulsa,Insurance Commissioner,Kimberly Fobbs,DEM,720501,0,0,163,163,
Tulsa,Corporation Commissioner,Bob Anthony,REP,720501,0,0,446,446,
Tulsa,Corporation Commissioner,Ashley Nicole Mccray,DEM,720501,0,0,163,163,
Tulsa,Corporation Commissioner,Jackie Short,IND,720501,0,0,20,20,
Tulsa,U.S. House,Kevin Hern,REP,720501,0,0,478,478,1
Tulsa,U.S. House,Tim Gilpin,DEM,720501,0,0,161,161,1
Tulsa,Governor,Chris Powell,LIB,720502,0,0,45,45,
Tulsa,Governor,Kevin Stitt,REP,720502,0,0,779,779,
Tulsa,Governor,Drew Edmondson,DEM,720502,0,0,428,428,
Tulsa,Lieutenant Governor,Matt Pinnell,REP,720502,0,0,901,901,
Tulsa,Lieutenant Governor,Anastasia Pittman,DEM,720502,0,0,313,313,
Tulsa,Lieutenant Governor,Ivan Holmes,IND,720502,0,0,30,30,
Tulsa,State Auditor,John Yeutter,LIB,720502,0,0,238,238,
Tulsa,State Auditor,Cindy Byrd,REP,720502,0,0,950,950,
Tulsa,Attorney General,Mike Hunter,REP,720502,0,0,911,911,
Tulsa,Attorney General,Mark Myles,DEM,720502,0,0,324,324,
Tulsa,State Treasurer,Randy Mcdaniel,REP,720502,0,0,905,905,
Tulsa,State Treasurer,Charles De Coune,IND,720502,0,0,278,278,
Tulsa,Superintendent of Public Instruction,Joy Hofmeister,REP,720502,0,0,801,801,
Tulsa,Superintendent of Public Instruction,John Cox,DEM,720502,0,0,347,347,
Tulsa,Superintendent of Public Instruction,Larry Huff,IND,720502,0,0,95,95,
Tulsa,Commissioner of Labor,Leslie Osborn,REP,720502,0,0,852,852,
Tulsa,Commissioner of Labor,Fred Dorrell,DEM,720502,0,0,306,306,
Tulsa,Commissioner of Labor,Brandt Dismukes,IND,720502,0,0,65,65,
Tulsa,Insurance Commissioner,Glen Mulready,REP,720502,0,0,874,874,
Tulsa,Insurance Commissioner,Kimberly Fobbs,DEM,720502,0,0,351,351,
Tulsa,Corporation Commissioner,Bob Anthony,REP,720502,0,0,825,825,
Tulsa,Corporation Commissioner,Ashley Nicole Mccray,DEM,720502,0,0,326,326,
Tulsa,Corporation Commissioner,Jackie Short,IND,720502,0,0,73,73,
Tulsa,U.S. House,Kevin Hern,REP,720502,0,0,879,879,1
Tulsa,U.S. House,Tim Gilpin,DEM,720502,0,0,356,356,1
Tulsa,Governor,Chris Powell,LIB,720503,0,0,35,35,
Tulsa,Governor,Kevin Stitt,REP,720503,0,0,487,487,
Tulsa,Governor,Drew Edmondson,DEM,720503,0,0,210,210,
Tulsa,Lieutenant Governor,Matt Pinnell,REP,720503,0,0,545,545,
Tulsa,Lieutenant Governor,Anastasia Pittman,DEM,720503,0,0,140,140,
Tulsa,Lieutenant Governor,Ivan Holmes,IND,720503,0,0,39,39,
Tulsa,State Auditor,John Yeutter,LIB,720503,0,0,131,131,
Tulsa,State Auditor,Cindy Byrd,REP,720503,0,0,558,558,
Tulsa,Attorney General,Mike Hunter,REP,720503,0,0,544,544,
Tulsa,Attorney General,Mark Myles,DEM,720503,0,0,174,174,
Tulsa,State Treasurer,Randy Mcdaniel,REP,720503,0,0,535,535,
Tulsa,State Treasurer,Charles De Coune,IND,720503,0,0,156,156,
Tulsa,Superintendent of Public Instruction,Joy Hofmeister,REP,720503,0,0,456,456,
Tulsa,Superintendent of Public Instruction,John Cox,DEM,720503,0,0,199,199,
Tulsa,Superintendent of Public Instruction,Larry Huff,IND,720503,0,0,74,74,
Tulsa,Commissioner of Labor,Leslie Osborn,REP,720503,0,0,504,504,
Tulsa,Commissioner of Labor,Fred Dorrell,DEM,720503,0,0,167,167,
Tulsa,Commissioner of Labor,Brandt Dismukes,IND,720503,0,0,43,43,
Tulsa,Insurance Commissioner,Glen Mulready,REP,720503,0,0,520,520,
Tulsa,Insurance Commissioner,Kimberly Fobbs,DEM,720503,0,0,195,195,
Tulsa,Corporation Commissioner,Bob Anthony,REP,720503,0,0,511,511,
Tulsa,Corporation Commissioner,Ashley Nicole Mccray,DEM,720503,0,0,159,159,
Tulsa,Corporation Commissioner,Jackie Short,IND,720503,0,0,52,52,
Tulsa,U.S. House,Kevin Hern,REP,720503,0,0,542,542,1
Tulsa,U.S. House,Tim Gilpin,DEM,720503,0,0,182,182,1
Tulsa,Governor,Chris Powell,LIB,720504,0,0,30,30,
Tulsa,Governor,Kevin Stitt,REP,720504,0,0,573,573,
Tulsa,Governor,Drew Edmondson,DEM,720504,0,0,360,360,
Tulsa,Lieutenant Governor,Matt Pinnell,REP,720504,0,0,683,683,
Tulsa,Lieutenant Governor,Anastasia Pittman,DEM,720504,0,0,245,245,
Tulsa,Lieutenant Governor,Ivan Holmes,IND,720504,0,0,30,30,
Tulsa,State Auditor,John Yeutter,LIB,720504,0,0,164,164,
Tulsa,State Auditor,Cindy Byrd,REP,720504,0,0,734,734,
Tulsa,Attorney General,Mike Hunter,REP,720504,0,0,697,697,
Tulsa,Attorney General,Mark Myles,DEM,720504,0,0,258,258,
Tulsa,State Treasurer,Randy Mcdaniel,REP,720504,0,0,674,674,
Tulsa,State Treasurer,Charles De Coune,IND,720504,0,0,221,221,
Tulsa,Superintendent of Public Instruction,Joy Hofmeister,REP,720504,0,0,565,565,
Tulsa,Superintendent of Public Instruction,John Cox,DEM,720504,0,0,309,309,
Tulsa,Superintendent of Public Instruction,Larry Huff,IND,720504,0,0,81,81,
Tulsa,Commissioner of Labor,Leslie Osborn,REP,720504,0,0,644,644,
Tulsa,Commissioner of Labor,Fred Dorrell,DEM,720504,0,0,263,263,
Tulsa,Commissioner of Labor,Brandt Dismukes,IND,720504,0,0,38,38,
Tulsa,Insurance Commissioner,Glen Mulready,REP,720504,0,0,661,661,
Tulsa,Insurance Commissioner,Kimberly Fobbs,DEM,720504,0,0,287,287,
Tulsa,Corporation Commissioner,Bob Anthony,REP,720504,0,0,641,641,
Tulsa,Corporation Commissioner,Ashley Nicole Mccray,DEM,720504,0,0,265,265,
Tulsa,Corporation Commissioner,Jackie Short,IND,720504,0,0,42,42,
Tulsa,U.S. House,Kevin Hern,REP,720504,0,0,669,669,1
Tulsa,U.S. House,Tim Gilpin,DEM,720504,0,0,290,290,1
Tulsa,Governor,Chris Powell,LIB,720551,0,0,6,6,
Tulsa,Governor,Kevin Stitt,REP,720551,0,0,154,154,
Tulsa,Governor,Drew Edmondson,DEM,720551,0,0,79,79,
Tulsa,Lieutenant Governor,Matt Pinnell,REP,720551,0,0,148,148,
Tulsa,Lieutenant Governor,Anastasia Pittman,DEM,720551,0,0,72,72,
Tulsa,Lieutenant Governor,Ivan Holmes,IND,720551,0,0,17,17,
Tulsa,State Auditor,John Yeutter,LIB,720551,0,0,51,51,
Tulsa,State Auditor,Cindy Byrd,REP,720551,0,0,170,170,
Tulsa,Attorney General,Mike Hunter,REP,720551,0,0,166,166,
Tulsa,Attorney General,Mark Myles,DEM,720551,0,0,71,71,
Tulsa,State Treasurer,Randy Mcdaniel,REP,720551,0,0,164,164,
Tulsa,State Treasurer,Charles De Coune,IND,720551,0,0,57,57,
Tulsa,Superintendent of Public Instruction,Joy Hofmeister,REP,720551,0,0,136,136,
Tulsa,Superintendent of Public Instruction,John Cox,DEM,720551,0,0,78,78,
Tulsa,Superintendent of Public Instruction,Larry Huff,IND,720551,0,0,20,20,
Tulsa,Commissioner of Labor,Leslie Osborn,REP,720551,0,0,155,155,
Tulsa,Commissioner of Labor,Fred Dorrell,DEM,720551,0,0,68,68,
Tulsa,Commissioner of Labor,Brandt Dismukes,IND,720551,0,0,11,11,
Tulsa,Insurance Commissioner,Glen Mulready,REP,720551,0,0,156,156,
Tulsa,Insurance Commissioner,Kimberly Fobbs,DEM,720551,0,0,77,77,
Tulsa,Corporation Commissioner,Bob Anthony,REP,720551,0,0,153,153,
Tulsa,Corporation Commissioner,Ashley Nicole Mccray,DEM,720551,0,0,70,70,
Tulsa,Corporation Commissioner,Jackie Short,IND,720551,0,0,12,12,
Tulsa,U.S. House,Kevin Hern,REP,720551,0,0,164,164,1
Tulsa,U.S. House,Tim Gilpin,DEM,720551,0,0,72,72,1
Tulsa,Governor,Chris Powell,LIB,720552,0,0,19,19,
Tulsa,Governor,Kevin Stitt,REP,720552,0,0,286,286,
Tulsa,Governor,Drew Edmondson,DEM,720552,0,0,144,144,
Tulsa,Lieutenant Governor,Matt Pinnell,REP,720552,0,0,316,316,
Tulsa,Lieutenant Governor,Anastasia Pittman,DEM,720552,0,0,116,116,
Tulsa,Lieutenant Governor,Ivan Holmes,IND,720552,0,0,12,12,
Tulsa,State Auditor,John Yeutter,LIB,720552,0,0,78,78,
Tulsa,State Auditor,Cindy Byrd,REP,720552,0,0,342,342,
Tulsa,Attorney General,Mike Hunter,REP,720552,0,0,334,334,
Tulsa,Attorney General,Mark Myles,DEM,720552,0,0,110,110,
Tulsa,State Treasurer,Randy Mcdaniel,REP,720552,0,0,338,338,
Tulsa,State Treasurer,Charles De Coune,IND,720552,0,0,82,82,
Tulsa,Superintendent of Public Instruction,Joy Hofmeister,REP,720552,0,0,290,290,
Tulsa,Superintendent of Public Instruction,John Cox,DEM,720552,0,0,113,113,
Tulsa,Superintendent of Public Instruction,Larry Huff,IND,720552,0,0,40,40,
Tulsa,Commissioner of Labor,Leslie Osborn,REP,720552,0,0,297,297,
Tulsa,Commissioner of Labor,Fred Dorrell,DEM,720552,0,0,118,118,
Tulsa,Commissioner of Labor,Brandt Dismukes,IND,720552,0,0,24,24,
Tulsa,Insurance Commissioner,Glen Mulready,REP,720552,0,0,312,312,
Tulsa,Insurance Commissioner,Kimberly Fobbs,DEM,720552,0,0,126,126,
Tulsa,Corporation Commissioner,Bob Anthony,REP,720552,0,0,303,303,
Tulsa,Corporation Commissioner,Ashley Nicole Mccray,DEM,720552,0,0,111,111,
Tulsa,Corporation Commissioner,Jackie Short,IND,720552,0,0,27,27,
Tulsa,U.S. House,Kevin Hern,REP,720552,0,0,313,313,1
Tulsa,U.S. House,Tim Gilpin,DEM,720552,0,0,134,134,1
Tulsa,Governor,Chris Powell,LIB,720553,0,0,8,8,
Tulsa,Governor,Kevin Stitt,REP,720553,0,0,171,171,
Tulsa,Governor,Drew Edmondson,DEM,720553,0,0,72,72,
Tulsa,Lieutenant Governor,Matt Pinnell,REP,720553,0,0,175,175,
Tulsa,Lieutenant Governor,Anastasia Pittman,DEM,720553,0,0,63,63,
Tulsa,Lieutenant Governor,Ivan Holmes,IND,720553,0,0,11,11,
Tulsa,State Auditor,John Yeutter,LIB,720553,0,0,44,44,
Tulsa,State Auditor,Cindy Byrd,REP,720553,0,0,184,184,
Tulsa,Attorney General,Mike Hunter,REP,720553,0,0,179,179,
Tulsa,Attorney General,Mark Myles,DEM,720553,0,0,69,69,
Tulsa,State Treasurer,Randy Mcdaniel,REP,720553,0,0,191,191,
Tulsa,State Treasurer,Charles De Coune,IND,720553,0,0,39,39,
Tulsa,Superintendent of Public Instruction,Joy Hofmeister,REP,720553,0,0,150,150,
Tulsa,Superintendent of Public Instruction,John Cox,DEM,720553,0,0,67,67,
Tulsa,Superintendent of Public Instruction,Larry Huff,IND,720553,0,0,33,33,
Tulsa,Commissioner of Labor,Leslie Osborn,REP,720553,0,0,167,167,
Tulsa,Commissioner of Labor,Fred Dorrell,DEM,720553,0,0,64,64,
Tulsa,Commissioner of Labor,Brandt Dismukes,IND,720553,0,0,17,17,
Tulsa,Insurance Commissioner,Glen Mulready,REP,720553,0,0,177,177,
Tulsa,Insurance Commissioner,Kimberly Fobbs,DEM,720553,0,0,71,71,
Tulsa,Corporation Commissioner,Bob Anthony,REP,720553,0,0,167,167,
Tulsa,Corporation Commissioner,Ashley Nicole Mccray,DEM,720553,0,0,66,66,
Tulsa,Corporation Commissioner,Jackie Short,IND,720553,0,0,14,14,
Tulsa,U.S. House,Kevin Hern,REP,720553,0,0,184,184,1
Tulsa,U.S. House,Tim Gilpin,DEM,720553,0,0,66,66,1
Tulsa,Governor,Chris Powell,LIB,720700,0,0,29,29,
Tulsa,Governor,Kevin Stitt,REP,720700,0,0,818,818,
Tulsa,Governor,Drew Edmondson,DEM,720700,0,0,443,443,
Tulsa,Lieutenant Governor,Matt Pinnell,REP,720700,0,0,956,956,
Tulsa,Lieutenant Governor,Anastasia Pittman,DEM,720700,0,0,298,298,
Tulsa,Lieutenant Governor,Ivan Holmes,IND,720700,0,0,27,27,
Tulsa,State Auditor,John Yeutter,LIB,720700,0,0,192,192,
Tulsa,State Auditor,Cindy Byrd,REP,720700,0,0,1034,1034,
Tulsa,Attorney General,Mike Hunter,REP,720700,0,0,942,942,
Tulsa,Attorney General,Mark Myles,DEM,720700,0,0,327,327,
Tulsa,State Treasurer,Randy Mcdaniel,REP,720700,0,0,960,960,
Tulsa,State Treasurer,Charles De Coune,IND,720700,0,0,264,264,
Tulsa,Superintendent of Public Instruction,Joy Hofmeister,REP,720700,0,0,940,940,
Tulsa,Superintendent of Public Instruction,John Cox,DEM,720700,0,0,264,264,
Tulsa,Superintendent of Public Instruction,Larry Huff,IND,720700,0,0,69,69,
Tulsa,Commissioner of Labor,Leslie Osborn,REP,720700,0,0,946,946,
Tulsa,Commissioner of Labor,Fred Dorrell,DEM,720700,0,0,260,260,
Tulsa,Commissioner of Labor,Brandt Dismukes,IND,720700,0,0,48,48,
Tulsa,Insurance Commissioner,Glen Mulready,REP,720700,0,0,955,955,
Tulsa,Insurance Commissioner,Kimberly Fobbs,DEM,720700,0,0,308,308,
Tulsa,Corporation Commissioner,Bob Anthony,REP,720700,0,0,919,919,
Tulsa,Corporation Commissioner,Ashley Nicole Mccray,DEM,720700,0,0,279,279,
Tulsa,Corporation Commissioner,Jackie Short,IND,720700,0,0,59,59,
Tulsa,U.S. House,Kevin Hern,REP,720700,0,0,922,922,1
Tulsa,U.S. House,Tim Gilpin,DEM,720700,0,0,355,355,1
Tulsa,State House,Sheila Dills,REP,720700,0,0,974,974,69
Tulsa,State House,Andy Richardson,DEM,720700,0,0,305,305,69
Tulsa,Governor,Chris Powell,LIB,720701,0,0,35,35,
Tulsa,Governor,Kevin Stitt,REP,720701,0,0,783,783,
Tulsa,Governor,Drew Edmondson,DEM,720701,0,0,587,587,
Tulsa,Lieutenant Governor,Matt Pinnell,REP,720701,0,0,949,949,
Tulsa,Lieutenant Governor,Anastasia Pittman,DEM,720701,0,0,410,410,
Tulsa,Lieutenant Governor,Ivan Holmes,IND,720701,0,0,31,31,
Tulsa,State Auditor,John Yeutter,LIB,720701,0,0,286,286,
Tulsa,State Auditor,Cindy Byrd,REP,720701,0,0,1011,1011,
Tulsa,Attorney General,Mike Hunter,REP,720701,0,0,937,937,
Tulsa,Attorney General,Mark Myles,DEM,720701,0,0,446,446,
Tulsa,State Treasurer,Randy Mcdaniel,REP,720701,0,0,952,952,
Tulsa,State Treasurer,Charles De Coune,IND,720701,0,0,343,343,
Tulsa,Superintendent of Public Instruction,Joy Hofmeister,REP,720701,0,0,910,910,
Tulsa,Superintendent of Public Instruction,John Cox,DEM,720701,0,0,399,399,
Tulsa,Superintendent of Public Instruction,Larry Huff,IND,720701,0,0,77,77,
Tulsa,Commissioner of Labor,Leslie Osborn,REP,720701,0,0,899,899,
Tulsa,Commissioner of Labor,Fred Dorrell,DEM,720701,0,0,399,399,
Tulsa,Commissioner of Labor,Brandt Dismukes,IND,720701,0,0,57,57,
Tulsa,Insurance Commissioner,Glen Mulready,REP,720701,0,0,928,928,
Tulsa,Insurance Commissioner,Kimberly Fobbs,DEM,720701,0,0,441,441,
Tulsa,Corporation Commissioner,Bob Anthony,REP,720701,0,0,884,884,
Tulsa,Corporation Commissioner,Ashley Nicole Mccray,DEM,720701,0,0,419,419,
Tulsa,Corporation Commissioner,Jackie Short,IND,720701,0,0,71,71,
Tulsa,U.S. House,Kevin Hern,REP,720701,0,0,887,887,1
Tulsa,U.S. House,Tim Gilpin,DEM,720701,0,0,502,502,1
Tulsa,State House,J. Lee Miller Jr.,LIB,720701,0,0,30,30,68
Tulsa,State House,Lonnie Sims,REP,720701,0,0,829,829,68
Tulsa,State House,Michael Ross,DEM,720701,0,0,401,401,68
Tulsa,State House,Heather Chenoweth,IND,720701,0,0,128,128,68
Tulsa,Governor,Chris Powell,LIB,720702,0,0,26,26,
Tulsa,Governor,Kevin Stitt,REP,720702,0,0,402,402,
Tulsa,Governor,Drew Edmondson,DEM,720702,0,0,311,311,
Tulsa,Lieutenant Governor,Matt Pinnell,REP,720702,0,0,460,460,
Tulsa,Lieutenant Governor,Anastasia Pittman,DEM,720702,0,0,247,247,
Tulsa,Lieutenant Governor,Ivan Holmes,IND,720702,0,0,24,24,
Tulsa,State Auditor,John Yeutter,LIB,720702,0,0,180,180,
Tulsa,State Auditor,Cindy Byrd,REP,720702,0,0,503,503,
Tulsa,Attorney General,Mike Hunter,REP,720702,0,0,463,463,
Tulsa,Attorney General,Mark Myles,DEM,720702,0,0,264,264,
Tulsa,State Treasurer,Randy Mcdaniel,REP,720702,0,0,479,479,
Tulsa,State Treasurer,Charles De Coune,IND,720702,0,0,196,196,
Tulsa,Superintendent of Public Instruction,Joy Hofmeister,REP,720702,0,0,448,448,
Tulsa,Superintendent of Public Instruction,John Cox,DEM,720702,0,0,223,223,
Tulsa,Superintendent of Public Instruction,Larry Huff,IND,720702,0,0,57,57,
Tulsa,Commissioner of Labor,Leslie Osborn,REP,720702,0,0,436,436,
Tulsa,Commissioner of Labor,Fred Dorrell,DEM,720702,0,0,247,247,
Tulsa,Commissioner of Labor,Brandt Dismukes,IND,720702,0,0,37,37,
Tulsa,Insurance Commissioner,Glen Mulready,REP,720702,0,0,449,449,
Tulsa,Insurance Commissioner,Kimberly Fobbs,DEM,720702,0,0,281,281,
Tulsa,Corporation Commissioner,Bob Anthony,REP,720702,0,0,428,428,
Tulsa,Corporation Commissioner,Ashley Nicole Mccray,DEM,720702,0,0,258,258,
Tulsa,Corporation Commissioner,Jackie Short,IND,720702,0,0,44,44,
Tulsa,U.S. House,Kevin Hern,REP,720702,0,0,439,439,1
Tulsa,U.S. House,Tim Gilpin,DEM,720702,0,0,291,291,1
Tulsa,State House,Sheila Dills,REP,720702,0,0,449,449,69
Tulsa,State House,Andy Richardson,DEM,720702,0,0,278,278,69
Tulsa,Governor,Chris Powell,LIB,720703,0,0,26,26,
Tulsa,Governor,Kevin Stitt,REP,720703,0,0,850,850,
Tulsa,Governor,Drew Edmondson,DEM,720703,0,0,630,630,
Tulsa,Lieutenant Governor,Matt Pinnell,REP,720703,0,0,1020,1020,
Tulsa,Lieutenant Governor,Anastasia Pittman,DEM,720703,0,0,437,437,
Tulsa,Lieutenant Governor,Ivan Holmes,IND,720703,0,0,37,37,
Tulsa,State Auditor,John Yeutter,LIB,720703,0,0,290,290,
Tulsa,State Auditor,Cindy Byrd,REP,720703,0,0,1111,1111,
Tulsa,Attorney General,Mike Hunter,REP,720703,0,0,988,988,
Tulsa,Attorney General,Mark Myles,DEM,720703,0,0,490,490,
Tulsa,State Treasurer,Randy Mcdaniel,REP,720703,0,0,1027,1027,
Tulsa,State Treasurer,Charles De Coune,IND,720703,0,0,362,362,
Tulsa,Superintendent of Public Instruction,Joy Hofmeister,REP,720703,0,0,970,970,
Tulsa,Superintendent of Public Instruction,John Cox,DEM,720703,0,0,422,422,
Tulsa,Superintendent of Public Instruction,Larry Huff,IND,720703,0,0,100,100,
Tulsa,Commissioner of Labor,Leslie Osborn,REP,720703,0,0,942,942,
Tulsa,Commissioner of Labor,Fred Dorrell,DEM,720703,0,0,452,452,
Tulsa,Commissioner of Labor,Brandt Dismukes,IND,720703,0,0,64,64,
Tulsa,Insurance Commissioner,Glen Mulready,REP,720703,0,0,972,972,
Tulsa,Insurance Commissioner,Kimberly Fobbs,DEM,720703,0,0,493,493,
Tulsa,Corporation Commissioner,Bob Anthony,REP,720703,0,0,948,948,
Tulsa,Corporation Commissioner,Ashley Nicole Mccray,DEM,720703,0,0,450,450,
Tulsa,Corporation Commissioner,Jackie Short,IND,720703,0,0,64,64,
Tulsa,U.S. House,Kevin Hern,REP,720703,0,0,941,941,1
Tulsa,U.S. House,Tim Gilpin,DEM,720703,0,0,550,550,1
Tulsa,State House,J. Lee Miller Jr.,LIB,720703,0,0,33,33,68
Tulsa,State House,Lonnie Sims,REP,720703,0,0,949,949,68
Tulsa,State House,Michael Ross,DEM,720703,0,0,394,394,68
Tulsa,State House,Heather Chenoweth,IND,720703,0,0,111,111,68
Tulsa,Governor,Chris Powell,LIB,720704,0,0,34,34,
Tulsa,Governor,Kevin Stitt,REP,720704,0,0,1048,1048,
Tulsa,Governor,Drew Edmondson,DEM,720704,0,0,534,534,
Tulsa,Lieutenant Governor,Matt Pinnell,REP,720704,0,0,1227,1227,
Tulsa,Lieutenant Governor,Anastasia Pittman,DEM,720704,0,0,342,342,
Tulsa,Lieutenant Governor,Ivan Holmes,IND,720704,0,0,34,34,
Tulsa,State Auditor,John Yeutter,LIB,720704,0,0,214,214,
Tulsa,State Auditor,Cindy Byrd,REP,720704,0,0,1294,1294,
Tulsa,Attorney General,Mike Hunter,REP,720704,0,0,1186,1186,
Tulsa,Attorney General,Mark Myles,DEM,720704,0,0,398,398,
Tulsa,State Treasurer,Randy Mcdaniel,REP,720704,0,0,1189,1189,
Tulsa,State Treasurer,Charles De Coune,IND,720704,0,0,305,305,
Tulsa,Superintendent of Public Instruction,Joy Hofmeister,REP,720704,0,0,1159,1159,
Tulsa,Superintendent of Public Instruction,John Cox,DEM,720704,0,0,349,349,
Tulsa,Superintendent of Public Instruction,Larry Huff,IND,720704,0,0,86,86,
Tulsa,Commissioner of Labor,Leslie Osborn,REP,720704,0,0,1153,1153,
Tulsa,Commissioner of Labor,Fred Dorrell,DEM,720704,0,0,342,342,
Tulsa,Commissioner of Labor,Brandt Dismukes,IND,720704,0,0,68,68,
Tulsa,Insurance Commissioner,Glen Mulready,REP,720704,0,0,1177,1177,
Tulsa,Insurance Commissioner,Kimberly Fobbs,DEM,720704,0,0,394,394,
Tulsa,Corporation Commissioner,Bob Anthony,REP,720704,0,0,1154,1154,
Tulsa,Corporation Commissioner,Ashley Nicole Mccray,DEM,720704,0,0,359,359,
Tulsa,Corporation Commissioner,Jackie Short,IND,720704,0,0,60,60,
Tulsa,U.S. House,Kevin Hern,REP,720704,0,0,1172,1172,1
Tulsa,U.S. House,Tim Gilpin,DEM,720704,0,0,423,423,1
Tulsa,State House,Sheila Dills,REP,720704,0,0,1214,1214,69
Tulsa,State House,Andy Richardson,DEM,720704,0,0,388,388,69
Tulsa,Governor,Chris Powell,LIB,720705,0,0,21,21,
Tulsa,Governor,Kevin Stitt,REP,720705,0,0,483,483,
Tulsa,Governor,Drew Edmondson,DEM,720705,0,0,323,323,
Tulsa,Lieutenant Governor,Matt Pinnell,REP,720705,0,0,547,547,
Tulsa,Lieutenant Governor,Anastasia Pittman,DEM,720705,0,0,249,249,
Tulsa,Lieutenant Governor,Ivan Holmes,IND,720705,0,0,27,27,
Tulsa,State Auditor,John Yeutter,LIB,720705,0,0,196,196,
Tulsa,State Auditor,Cindy Byrd,REP,720705,0,0,595,595,
Tulsa,Attorney General,Mike Hunter,REP,720705,0,0,569,569,
Tulsa,Attorney General,Mark Myles,DEM,720705,0,0,256,256,
Tulsa,State Treasurer,Randy Mcdaniel,REP,720705,0,0,568,568,
Tulsa,State Treasurer,Charles De Coune,IND,720705,0,0,218,218,
Tulsa,Superintendent of Public Instruction,Joy Hofmeister,REP,720705,0,0,507,507,
Tulsa,Superintendent of Public Instruction,John Cox,DEM,720705,0,0,251,251,
Tulsa,Superintendent of Public Instruction,Larry Huff,IND,720705,0,0,60,60,
Tulsa,Commissioner of Labor,Leslie Osborn,REP,720705,0,0,527,527,
Tulsa,Commissioner of Labor,Fred Dorrell,DEM,720705,0,0,247,247,
Tulsa,Commissioner of Labor,Brandt Dismukes,IND,720705,0,0,41,41,
Tulsa,Insurance Commissioner,Glen Mulready,REP,720705,0,0,534,534,
Tulsa,Insurance Commissioner,Kimberly Fobbs,DEM,720705,0,0,282,282,
Tulsa,Corporation Commissioner,Bob Anthony,REP,720705,0,0,523,523,
Tulsa,Corporation Commissioner,Ashley Nicole Mccray,DEM,720705,0,0,243,243,
Tulsa,Corporation Commissioner,Jackie Short,IND,720705,0,0,50,50,
Tulsa,U.S. House,Kevin Hern,REP,720705,0,0,547,547,1
Tulsa,U.S. House,Tim Gilpin,DEM,720705,0,0,274,274,1
Tulsa,State Senate,James Leewright,REP,720705,0,0,550,550,12
Tulsa,State Senate,Rick Parris,DEM,720705,0,0,270,270,12
Tulsa,Governor,Chris Powell,LIB,720706,0,0,47,47,
Tulsa,Governor,Kevin Stitt,REP,720706,0,0,937,937,
Tulsa,Governor,Drew Edmondson,DEM,720706,0,0,530,530,
Tulsa,Lieutenant Governor,Matt Pinnell,REP,720706,0,0,1043,1043,
Tulsa,Lieutenant Governor,Anastasia Pittman,DEM,720706,0,0,408,408,
Tulsa,Lieutenant Governor,Ivan Holmes,IND,720706,0,0,48,48,
Tulsa,State Auditor,John Yeutter,LIB,720706,0,0,298,298,
Tulsa,State Auditor,Cindy Byrd,REP,720706,0,0,1104,1104,
Tulsa,Attorney General,Mike Hunter,REP,720706,0,0,1061,1061,
Tulsa,Attorney General,Mark Myles,DEM,720706,0,0,428,428,
Tulsa,State Treasurer,Randy Mcdaniel,REP,720706,0,0,1053,1053,
Tulsa,State Treasurer,Charles De Coune,IND,720706,0,0,355,355,
Tulsa,Superintendent of Public Instruction,Joy Hofmeister,REP,720706,0,0,951,951,
Tulsa,Superintendent of Public Instruction,John Cox,DEM,720706,0,0,427,427,
Tulsa,Superintendent of Public Instruction,Larry Huff,IND,720706,0,0,117,117,
Tulsa,Commissioner of Labor,Leslie Osborn,REP,720706,0,0,993,993,
Tulsa,Commissioner of Labor,Fred Dorrell,DEM,720706,0,0,405,405,
Tulsa,Commissioner of Labor,Brandt Dismukes,IND,720706,0,0,77,77,
Tulsa,Insurance Commissioner,Glen Mulready,REP,720706,0,0,1057,1057,
Tulsa,Insurance Commissioner,Kimberly Fobbs,DEM,720706,0,0,425,425,
Tulsa,Corporation Commissioner,Bob Anthony,REP,720706,0,0,970,970,
Tulsa,Corporation Commissioner,Ashley Nicole Mccray,DEM,720706,0,0,419,419,
Tulsa,Corporation Commissioner,Jackie Short,IND,720706,0,0,96,96,
Tulsa,U.S. House,Kevin Hern,REP,720706,0,0,1053,1053,1
Tulsa,U.S. House,Tim Gilpin,DEM,720706,0,0,446,446,1
Tulsa,State House,J. Lee Miller Jr.,LIB,720706,0,0,41,41,68
Tulsa,State House,Lonnie Sims,REP,720706,0,0,949,949,68
Tulsa,State House,Michael Ross,DEM,720706,0,0,348,348,68
Tulsa,State House,Heather Chenoweth,IND,720706,0,0,155,155,68
Tulsa,Governor,Chris Powell,LIB,720707,0,0,17,17,
Tulsa,Governor,Kevin Stitt,REP,720707,0,0,426,426,
Tulsa,Governor,Drew Edmondson,DEM,720707,0,0,254,254,
Tulsa,Lieutenant Governor,Matt Pinnell,REP,720707,0,0,477,477,
Tulsa,Lieutenant Governor,Anastasia Pittman,DEM,720707,0,0,193,193,
Tulsa,Lieutenant Governor,Ivan Holmes,IND,720707,0,0,22,22,
Tulsa,State Auditor,John Yeutter,LIB,720707,0,0,146,146,
Tulsa,State Auditor,Cindy Byrd,REP,720707,0,0,509,509,
Tulsa,Attorney General,Mike Hunter,REP,720707,0,0,479,479,
Tulsa,Attorney General,Mark Myles,DEM,720707,0,0,210,210,
Tulsa,State Treasurer,Randy Mcdaniel,REP,720707,0,0,485,485,
Tulsa,State Treasurer,Charles De Coune,IND,720707,0,0,169,169,
Tulsa,Superintendent of Public Instruction,Joy Hofmeister,REP,720707,0,0,408,408,
Tulsa,Superintendent of Public Instruction,John Cox,DEM,720707,0,0,228,228,
Tulsa,Superintendent of Public Instruction,Larry Huff,IND,720707,0,0,53,53,
Tulsa,Commissioner of Labor,Leslie Osborn,REP,720707,0,0,445,445,
Tulsa,Commissioner of Labor,Fred Dorrell,DEM,720707,0,0,199,199,
Tulsa,Commissioner of Labor,Brandt Dismukes,IND,720707,0,0,33,33,
Tulsa,Insurance Commissioner,Glen Mulready,REP,720707,0,0,466,466,
Tulsa,Insurance Commissioner,Kimberly Fobbs,DEM,720707,0,0,220,220,
Tulsa,Corporation Commissioner,Bob Anthony,REP,720707,0,0,434,434,
Tulsa,Corporation Commissioner,Ashley Nicole Mccray,DEM,720707,0,0,216,216,
Tulsa,Corporation Commissioner,Jackie Short,IND,720707,0,0,36,36,
Tulsa,U.S. House,Kevin Hern,REP,720707,0,0,467,467,1
Tulsa,U.S. House,Tim Gilpin,DEM,720707,0,0,222,222,1
Tulsa,State Senate,James Leewright,REP,720707,0,0,484,484,12
Tulsa,State Senate,Rick Parris,DEM,720707,0,0,203,203,12
Tulsa,State House,J. Lee Miller Jr.,LIB,720707,0,0,12,12,68
Tulsa,State House,Lonnie Sims,REP,720707,0,0,402,402,68
Tulsa,State House,Michael Ross,DEM,720707,0,0,182,182,68
Tulsa,State House,Heather Chenoweth,IND,720707,0,0,90,90,68
Tulsa,Governor,Chris Powell,LIB,720708,0,0,30,30,
Tulsa,Governor,Kevin Stitt,REP,720708,0,0,511,511,
Tulsa,Governor,Drew Edmondson,DEM,720708,0,0,296,296,
Tulsa,Lieutenant Governor,Matt Pinnell,REP,720708,0,0,560,560,
Tulsa,Lieutenant Governor,Anastasia Pittman,DEM,720708,0,0,238,238,
Tulsa,Lieutenant Governor,Ivan Holmes,IND,720708,0,0,32,32,
Tulsa,State Auditor,John Yeutter,LIB,720708,0,0,178,178,
Tulsa,State Auditor,Cindy Byrd,REP,720708,0,0,595,595,
Tulsa,Attorney General,Mike Hunter,REP,720708,0,0,588,588,
Tulsa,Attorney General,Mark Myles,DEM,720708,0,0,240,240,
Tulsa,State Treasurer,Randy Mcdaniel,REP,720708,0,0,577,577,
Tulsa,State Treasurer,Charles De Coune,IND,720708,0,0,193,193,
Tulsa,Superintendent of Public Instruction,Joy Hofmeister,REP,720708,0,0,511,511,
Tulsa,Superintendent of Public Instruction,John Cox,DEM,720708,0,0,241,241,
Tulsa,Superintendent of Public Instruction,Larry Huff,IND,720708,0,0,77,77,
Tulsa,Commissioner of Labor,Leslie Osborn,REP,720708,0,0,538,538,
Tulsa,Commissioner of Labor,Fred Dorrell,DEM,720708,0,0,239,239,
Tulsa,Commissioner of Labor,Brandt Dismukes,IND,720708,0,0,38,38,
Tulsa,Insurance Commissioner,Glen Mulready,REP,720708,0,0,580,580,
Tulsa,Insurance Commissioner,Kimberly Fobbs,DEM,720708,0,0,243,243,
Tulsa,Corporation Commissioner,Bob Anthony,REP,720708,0,0,550,550,
Tulsa,Corporation Commissioner,Ashley Nicole Mccray,DEM,720708,0,0,230,230,
Tulsa,Corporation Commissioner,Jackie Short,IND,720708,0,0,40,40,
Tulsa,U.S. House,Kevin Hern,REP,720708,0,0,564,564,1
Tulsa,U.S. House,Tim Gilpin,DEM,720708,0,0,264,264,1
Tulsa,State Senate,James Leewright,REP,720708,0,0,576,576,12
Tulsa,State Senate,Rick Parris,DEM,720708,0,0,250,250,12
Tulsa,Governor,Chris Powell,LIB,720709,0,0,23,23,
Tulsa,Governor,Kevin Stitt,REP,720709,0,0,618,618,
Tulsa,Governor,Drew Edmondson,DEM,720709,0,0,377,377,
Tulsa,Lieutenant Governor,Matt Pinnell,REP,720709,0,0,703,703,
Tulsa,Lieutenant Governor,Anastasia Pittman,DEM,720709,0,0,274,274,
Tulsa,Lieutenant Governor,Ivan Holmes,IND,720709,0,0,32,32,
Tulsa,State Auditor,John Yeutter,LIB,720709,0,0,196,196,
Tulsa,State Auditor,Cindy Byrd,REP,720709,0,0,753,753,
Tulsa,Attorney General,Mike Hunter,REP,720709,0,0,690,690,
Tulsa,Attorney General,Mark Myles,DEM,720709,0,0,313,313,
Tulsa,State Treasurer,Randy Mcdaniel,REP,720709,0,0,707,707,
Tulsa,State Treasurer,Charles De Coune,IND,720709,0,0,246,246,
Tulsa,Superintendent of Public Instruction,Joy Hofmeister,REP,720709,0,0,674,674,
Tulsa,Superintendent of Public Instruction,John Cox,DEM,720709,0,0,278,278,
Tulsa,Superintendent of Public Instruction,Larry Huff,IND,720709,0,0,52,52,
Tulsa,Commissioner of Labor,Leslie Osborn,REP,720709,0,0,645,645,
Tulsa,Commissioner of Labor,Fred Dorrell,DEM,720709,0,0,287,287,
Tulsa,Commissioner of Labor,Brandt Dismukes,IND,720709,0,0,53,53,
Tulsa,Insurance Commissioner,Glen Mulready,REP,720709,0,0,692,692,
Tulsa,Insurance Commissioner,Kimberly Fobbs,DEM,720709,0,0,301,301,
Tulsa,Corporation Commissioner,Bob Anthony,REP,720709,0,0,665,665,
Tulsa,Corporation Commissioner,Ashley Nicole Mccray,DEM,720709,0,0,286,286,
Tulsa,Corporation Commissioner,Jackie Short,IND,720709,0,0,42,42,
Tulsa,U.S. House,Kevin Hern,REP,720709,0,0,680,680,1
Tulsa,U.S. House,Tim Gilpin,DEM,720709,0,0,327,327,1
Tulsa,State House,Sheila Dills,REP,720709,0,0,685,685,69
Tulsa,State House,Andy Richardson,DEM,720709,0,0,320,320,69
Tulsa,Governor,Chris Powell,LIB,720710,0,0,4,4,
Tulsa,Governor,Kevin Stitt,REP,720710,0,0,244,244,
Tulsa,Governor,Drew Edmondson,DEM,720710,0,0,70,70,
Tulsa,Lieutenant Governor,Matt Pinnell,REP,720710,0,0,257,257,
Tulsa,Lieutenant Governor,Anastasia Pittman,DEM,720710,0,0,53,53,
Tulsa,Lieutenant Governor,Ivan Holmes,IND,720710,0,0,8,8,
Tulsa,State Auditor,John Yeutter,LIB,720710,0,0,33,33,
Tulsa,State Auditor,Cindy Byrd,REP,720710,0,0,266,266,
Tulsa,Attorney General,Mike Hunter,REP,720710,0,0,266,266,
Tulsa,Attorney General,Mark Myles,DEM,720710,0,0,50,50,
Tulsa,State Treasurer,Randy Mcdaniel,REP,720710,0,0,259,259,
Tulsa,State Treasurer,Charles De Coune,IND,720710,0,0,42,42,
Tulsa,Superintendent of Public Instruction,Joy Hofmeister,REP,720710,0,0,226,226,
Tulsa,Superintendent of Public Instruction,John Cox,DEM,720710,0,0,62,62,
Tulsa,Superintendent of Public Instruction,Larry Huff,IND,720710,0,0,28,28,
Tulsa,Commissioner of Labor,Leslie Osborn,REP,720710,0,0,251,251,
Tulsa,Commissioner of Labor,Fred Dorrell,DEM,720710,0,0,54,54,
Tulsa,Commissioner of Labor,Brandt Dismukes,IND,720710,0,0,9,9,
Tulsa,Insurance Commissioner,Glen Mulready,REP,720710,0,0,258,258,
Tulsa,Insurance Commissioner,Kimberly Fobbs,DEM,720710,0,0,55,55,
Tulsa,Corporation Commissioner,Bob Anthony,REP,720710,0,0,252,252,
Tulsa,Corporation Commissioner,Ashley Nicole Mccray,DEM,720710,0,0,49,49,
Tulsa,Corporation Commissioner,Jackie Short,IND,720710,0,0,17,17,
Tulsa,U.S. House,Kevin Hern,REP,720710,0,0,262,262,1
Tulsa,U.S. House,Tim Gilpin,DEM,720710,0,0,56,56,1
Tulsa,Governor,Chris Powell,LIB,720750,0,0,26,26,
Tulsa,Governor,Kevin Stitt,REP,720750,0,0,626,626,
Tulsa,Governor,Drew Edmondson,DEM,720750,0,0,346,346,
Tulsa,Lieutenant Governor,Matt Pinnell,REP,720750,0,0,694,694,
Tulsa,Lieutenant Governor,Anastasia Pittman,DEM,720750,0,0,261,261,
Tulsa,Lieutenant Governor,Ivan Holmes,IND,720750,0,0,32,32,
Tulsa,State Auditor,John Yeutter,LIB,720750,0,0,181,181,
Tulsa,State Auditor,Cindy Byrd,REP,720750,0,0,740,740,
Tulsa,Attorney General,Mike Hunter,REP,720750,0,0,710,710,
Tulsa,Attorney General,Mark Myles,DEM,720750,0,0,268,268,
Tulsa,State Treasurer,Randy Mcdaniel,REP,720750,0,0,704,704,
Tulsa,State Treasurer,Charles De Coune,IND,720750,0,0,211,211,
Tulsa,Superintendent of Public Instruction,Joy Hofmeister,REP,720750,0,0,665,665,
Tulsa,Superintendent of Public Instruction,John Cox,DEM,720750,0,0,258,258,
Tulsa,Superintendent of Public Instruction,Larry Huff,IND,720750,0,0,62,62,
Tulsa,Commissioner of Labor,Leslie Osborn,REP,720750,0,0,666,666,
Tulsa,Commissioner of Labor,Fred Dorrell,DEM,720750,0,0,261,261,
Tulsa,Commissioner of Labor,Brandt Dismukes,IND,720750,0,0,42,42,
Tulsa,Insurance Commissioner,Glen Mulready,REP,720750,0,0,677,677,
Tulsa,Insurance Commissioner,Kimberly Fobbs,DEM,720750,0,0,293,293,
Tulsa,Corporation Commissioner,Bob Anthony,REP,720750,0,0,675,675,
Tulsa,Corporation Commissioner,Ashley Nicole Mccray,DEM,720750,0,0,250,250,
Tulsa,Corporation Commissioner,Jackie Short,IND,720750,0,0,46,46,
Tulsa,U.S. House,Kevin Hern,REP,720750,0,0,688,688,1
Tulsa,U.S. House,Tim Gilpin,DEM,720750,0,0,295,295,1
Tulsa,Governor,Chris Powell,LIB,720751,0,0,43,43,
Tulsa,Governor,Kevin Stitt,REP,720751,0,0,706,706,
Tulsa,Governor,Drew Edmondson,DEM,720751,0,0,457,457,
Tulsa,Lieutenant Governor,Matt Pinnell,REP,720751,0,0,804,804,
Tulsa,Lieutenant Governor,Anastasia Pittman,DEM,720751,0,0,346,346,
Tulsa,Lieutenant Governor,Ivan Holmes,IND,720751,0,0,47,47,
Tulsa,State Auditor,John Yeutter,LIB,720751,0,0,244,244,
Tulsa,State Auditor,Cindy Byrd,REP,720751,0,0,866,866,
Tulsa,Attorney General,Mike Hunter,REP,720751,0,0,823,823,
Tulsa,Attorney General,Mark Myles,DEM,720751,0,0,365,365,
Tulsa,State Treasurer,Randy Mcdaniel,REP,720751,0,0,847,847,
Tulsa,State Treasurer,Charles De Coune,IND,720751,0,0,266,266,
Tulsa,Superintendent of Public Instruction,Joy Hofmeister,REP,720751,0,0,732,732,
Tulsa,Superintendent of Public Instruction,John Cox,DEM,720751,0,0,387,387,
Tulsa,Superintendent of Public Instruction,Larry Huff,IND,720751,0,0,72,72,
Tulsa,Commissioner of Labor,Leslie Osborn,REP,720751,0,0,768,768,
Tulsa,Commissioner of Labor,Fred Dorrell,DEM,720751,0,0,363,363,
Tulsa,Commissioner of Labor,Brandt Dismukes,IND,720751,0,0,47,47,
Tulsa,Insurance Commissioner,Glen Mulready,REP,720751,0,0,794,794,
Tulsa,Insurance Commissioner,Kimberly Fobbs,DEM,720751,0,0,382,382,
Tulsa,Corporation Commissioner,Bob Anthony,REP,720751,0,0,778,778,
Tulsa,Corporation Commissioner,Ashley Nicole Mccray,DEM,720751,0,0,354,354,
Tulsa,Corporation Commissioner,Jackie Short,IND,720751,0,0,51,51,
Tulsa,U.S. House,Kevin Hern,REP,720751,0,0,801,801,1
Tulsa,U.S. House,Tim Gilpin,DEM,720751,0,0,394,394,1
Tulsa,Governor,Chris Powell,LIB,720752,0,0,23,23,
Tulsa,Governor,Kevin Stitt,REP,720752,0,0,607,607,
Tulsa,Governor,Drew Edmondson,DEM,720752,0,0,366,366,
Tulsa,Lieutenant Governor,Matt Pinnell,REP,720752,0,0,711,711,
Tulsa,Lieutenant Governor,Anastasia Pittman,DEM,720752,0,0,255,255,
Tulsa,Lieutenant Governor,Ivan Holmes,IND,720752,0,0,18,18,
Tulsa,State Auditor,John Yeutter,LIB,720752,0,0,184,184,
Tulsa,State Auditor,Cindy Byrd,REP,720752,0,0,742,742,
Tulsa,Attorney General,Mike Hunter,REP,720752,0,0,704,704,
Tulsa,Attorney General,Mark Myles,DEM,720752,0,0,270,270,
Tulsa,State Treasurer,Randy Mcdaniel,REP,720752,0,0,739,739,
Tulsa,State Treasurer,Charles De Coune,IND,720752,0,0,182,182,
Tulsa,Superintendent of Public Instruction,Joy Hofmeister,REP,720752,0,0,626,626,
Tulsa,Superintendent of Public Instruction,John Cox,DEM,720752,0,0,282,282,
Tulsa,Superintendent of Public Instruction,Larry Huff,IND,720752,0,0,77,77,
Tulsa,Commissioner of Labor,Leslie Osborn,REP,720752,0,0,673,673,
Tulsa,Commissioner of Labor,Fred Dorrell,DEM,720752,0,0,263,263,
Tulsa,Commissioner of Labor,Brandt Dismukes,IND,720752,0,0,34,34,
Tulsa,Insurance Commissioner,Glen Mulready,REP,720752,0,0,679,679,
Tulsa,Insurance Commissioner,Kimberly Fobbs,DEM,720752,0,0,289,289,
Tulsa,Corporation Commissioner,Bob Anthony,REP,720752,0,0,664,664,
Tulsa,Corporation Commissioner,Ashley Nicole Mccray,DEM,720752,0,0,271,271,
Tulsa,Corporation Commissioner,Jackie Short,IND,720752,0,0,36,36,
Tulsa,U.S. House,Kevin Hern,REP,720752,0,0,690,690,1
Tulsa,U.S. House,Tim Gilpin,DEM,720752,0,0,293,293,1
Tulsa,Governor,Chris Powell,LIB,720753,0,0,24,24,
Tulsa,Governor,Kevin Stitt,REP,720753,0,0,352,352,
Tulsa,Governor,Drew Edmondson,DEM,720753,0,0,277,277,
Tulsa,Lieutenant Governor,Matt Pinnell,REP,720753,0,0,405,405,
Tulsa,Lieutenant Governor,Anastasia Pittman,DEM,720753,0,0,219,219,
Tulsa,Lieutenant Governor,Ivan Holmes,IND,720753,0,0,25,25,
Tulsa,State Auditor,John Yeutter,LIB,720753,0,0,156,156,
Tulsa,State Auditor,Cindy Byrd,REP,720753,0,0,445,445,
Tulsa,Attorney General,Mike Hunter,REP,720753,0,0,403,403,
Tulsa,Attorney General,Mark Myles,DEM,720753,0,0,242,242,
Tulsa,State Treasurer,Randy Mcdaniel,REP,720753,0,0,421,421,
Tulsa,State Treasurer,Charles De Coune,IND,720753,0,0,175,175,
Tulsa,Superintendent of Public Instruction,Joy Hofmeister,REP,720753,0,0,386,386,
Tulsa,Superintendent of Public Instruction,John Cox,DEM,720753,0,0,206,206,
Tulsa,Superintendent of Public Instruction,Larry Huff,IND,720753,0,0,51,51,
Tulsa,Commissioner of Labor,Leslie Osborn,REP,720753,0,0,374,374,
Tulsa,Commissioner of Labor,Fred Dorrell,DEM,720753,0,0,230,230,
Tulsa,Commissioner of Labor,Brandt Dismukes,IND,720753,0,0,32,32,
Tulsa,Insurance Commissioner,Glen Mulready,REP,720753,0,0,387,387,
Tulsa,Insurance Commissioner,Kimberly Fobbs,DEM,720753,0,0,250,250,
Tulsa,Corporation Commissioner,Bob Anthony,REP,720753,0,0,380,380,
Tulsa,Corporation Commissioner,Ashley Nicole Mccray,DEM,720753,0,0,230,230,
Tulsa,Corporation Commissioner,Jackie Short,IND,720753,0,0,31,31,
Tulsa,U.S. House,Kevin Hern,REP,720753,0,0,396,396,1
Tulsa,U.S. House,Tim Gilpin,DEM,720753,0,0,251,251,1
Tulsa,Governor,Chris Powell,LIB,720754,0,0,57,57,
Tulsa,Governor,Kevin Stitt,REP,720754,0,0,699,699,
Tulsa,Governor,Drew Edmondson,DEM,720754,0,0,454,454,
Tulsa,Lieutenant Governor,Matt Pinnell,REP,720754,0,0,810,810,
Tulsa,Lieutenant Governor,Anastasia Pittman,DEM,720754,0,0,355,355,
Tulsa,Lieutenant Governor,Ivan Holmes,IND,720754,0,0,40,40,
Tulsa,State Auditor,John Yeutter,LIB,720754,0,0,270,270,
Tulsa,State Auditor,Cindy Byrd,REP,720754,0,0,854,854,
Tulsa,Attorney General,Mike Hunter,REP,720754,0,0,827,827,
Tulsa,Attorney General,Mark Myles,DEM,720754,0,0,374,374,
Tulsa,State Treasurer,Randy Mcdaniel,REP,720754,0,0,828,828,
Tulsa,State Treasurer,Charles De Coune,IND,720754,0,0,298,298,
Tulsa,Superintendent of Public Instruction,Joy Hofmeister,REP,720754,0,0,737,737,
Tulsa,Superintendent of Public Instruction,John Cox,DEM,720754,0,0,354,354,
Tulsa,Superintendent of Public Instruction,Larry Huff,IND,720754,0,0,104,104,
Tulsa,Commissioner of Labor,Leslie Osborn,REP,720754,0,0,765,765,
Tulsa,Commissioner of Labor,Fred Dorrell,DEM,720754,0,0,347,347,
Tulsa,Commissioner of Labor,Brandt Dismukes,IND,720754,0,0,71,71,
Tulsa,Insurance Commissioner,Glen Mulready,REP,720754,0,0,800,800,
Tulsa,Insurance Commissioner,Kimberly Fobbs,DEM,720754,0,0,390,390,
Tulsa,Corporation Commissioner,Bob Anthony,REP,720754,0,0,769,769,
Tulsa,Corporation Commissioner,Ashley Nicole Mccray,DEM,720754,0,0,353,353,
Tulsa,Corporation Commissioner,Jackie Short,IND,720754,0,0,76,76,
Tulsa,U.S. House,Kevin Hern,REP,720754,0,0,824,824,1
Tulsa,U.S. House,Tim Gilpin,DEM,720754,0,0,381,381,1
Tulsa,Governor,Chris Powell,LIB,720755,0,0,54,54,
Tulsa,Governor,Kevin Stitt,REP,720755,0,0,1093,1093,
Tulsa,Governor,Drew Edmondson,DEM,720755,0,0,650,650,
Tulsa,Lieutenant Governor,Matt Pinnell,REP,720755,0,0,1245,1245,
Tulsa,Lieutenant Governor,Anastasia Pittman,DEM,720755,0,0,496,496,
Tulsa,Lieutenant Governor,Ivan Holmes,IND,720755,0,0,44,44,
Tulsa,State Auditor,John Yeutter,LIB,720755,0,0,362,362,
Tulsa,State Auditor,Cindy Byrd,REP,720755,0,0,1316,1316,
Tulsa,Attorney General,Mike Hunter,REP,720755,0,0,1247,1247,
Tulsa,Attorney General,Mark Myles,DEM,720755,0,0,522,522,
Tulsa,State Treasurer,Randy Mcdaniel,REP,720755,0,0,1263,1263,
Tulsa,State Treasurer,Charles De Coune,IND,720755,0,0,413,413,
Tulsa,Superintendent of Public Instruction,Joy Hofmeister,REP,720755,0,0,1135,1135,
Tulsa,Superintendent of Public Instruction,John Cox,DEM,720755,0,0,524,524,
Tulsa,Superintendent of Public Instruction,Larry Huff,IND,720755,0,0,121,121,
Tulsa,Commissioner of Labor,Leslie Osborn,REP,720755,0,0,1200,1200,
Tulsa,Commissioner of Labor,Fred Dorrell,DEM,720755,0,0,481,481,
Tulsa,Commissioner of Labor,Brandt Dismukes,IND,720755,0,0,68,68,
Tulsa,Insurance Commissioner,Glen Mulready,REP,720755,0,0,1230,1230,
Tulsa,Insurance Commissioner,Kimberly Fobbs,DEM,720755,0,0,525,525,
Tulsa,Corporation Commissioner,Bob Anthony,REP,720755,0,0,1202,1202,
Tulsa,Corporation Commissioner,Ashley Nicole Mccray,DEM,720755,0,0,473,473,
Tulsa,Corporation Commissioner,Jackie Short,IND,720755,0,0,83,83,
Tulsa,U.S. House,Kevin Hern,REP,720755,0,0,1251,1251,1
Tulsa,U.S. House,Tim Gilpin,DEM,720755,0,0,531,531,1
Tulsa,Governor,Chris Powell,LIB,720756,0,0,5,5,
Tulsa,Governor,Kevin Stitt,REP,720756,0,0,43,43,
Tulsa,Governor,Drew Edmondson,DEM,720756,0,0,17,17,
Tulsa,Lieutenant Governor,Matt Pinnell,REP,720756,0,0,47,47,
Tulsa,Lieutenant Governor,Anastasia Pittman,DEM,720756,0,0,15,15,
Tulsa,Lieutenant Governor,Ivan Holmes,IND,720756,0,0,3,3,
Tulsa,State Auditor,John Yeutter,LIB,720756,0,0,11,11,
Tulsa,State Auditor,Cindy Byrd,REP,720756,0,0,50,50,
Tulsa,Attorney General,Mike Hunter,REP,720756,0,0,46,46,
Tulsa,Attorney General,Mark Myles,DEM,720756,0,0,19,19,
Tulsa,State Treasurer,Randy Mcdaniel,REP,720756,0,0,49,49,
Tulsa,State Treasurer,Charles De Coune,IND,720756,0,0,12,12,
Tulsa,Superintendent of Public Instruction,Joy Hofmeister,REP,720756,0,0,47,47,
Tulsa,Superintendent of Public Instruction,John Cox,DEM,720756,0,0,12,12,
Tulsa,Superintendent of Public Instruction,Larry Huff,IND,720756,0,0,6,6,
Tulsa,Commissioner of Labor,Leslie Osborn,REP,720756,0,0,46,46,
Tulsa,Commissioner of Labor,Fred Dorrell,DEM,720756,0,0,14,14,
Tulsa,Commissioner of Labor,Brandt Dismukes,IND,720756,0,0,5,5,
Tulsa,Insurance Commissioner,Glen Mulready,REP,720756,0,0,46,46,
Tulsa,Insurance Commissioner,Kimberly Fobbs,DEM,720756,0,0,19,19,
Tulsa,Corporation Commissioner,Bob Anthony,REP,720756,0,0,44,44,
Tulsa,Corporation Commissioner,Ashley Nicole Mccray,DEM,720756,0,0,16,16,
Tulsa,Corporation Commissioner,Jackie Short,IND,720756,0,0,5,5,
Tulsa,U.S. House,Kevin Hern,REP,720756,0,0,47,47,1
Tulsa,U.S. House,Tim Gilpin,DEM,720756,0,0,18,18,1
Tulsa,Governor,Chris Powell,LIB,720757,0,0,47,47,
Tulsa,Governor,Kevin Stitt,REP,720757,0,0,1106,1106,
Tulsa,Governor,Drew Edmondson,DEM,720757,0,0,617,617,
Tulsa,Lieutenant Governor,Matt Pinnell,REP,720757,0,0,1244,1244,
Tulsa,Lieutenant Governor,Anastasia Pittman,DEM,720757,0,0,459,459,
Tulsa,Lieutenant Governor,Ivan Holmes,IND,720757,0,0,51,51,
Tulsa,State Auditor,John Yeutter,LIB,720757,0,0,312,312,
Tulsa,State Auditor,Cindy Byrd,REP,720757,0,0,1327,1327,
Tulsa,Attorney General,Mike Hunter,REP,720757,0,0,1276,1276,
Tulsa,Attorney General,Mark Myles,DEM,720757,0,0,465,465,
Tulsa,State Treasurer,Randy Mcdaniel,REP,720757,0,0,1277,1277,
Tulsa,State Treasurer,Charles De Coune,IND,720757,0,0,358,358,
Tulsa,Superintendent of Public Instruction,Joy Hofmeister,REP,720757,0,0,1141,1141,
Tulsa,Superintendent of Public Instruction,John Cox,DEM,720757,0,0,486,486,
Tulsa,Superintendent of Public Instruction,Larry Huff,IND,720757,0,0,124,124,
Tulsa,Commissioner of Labor,Leslie Osborn,REP,720757,0,0,1209,1209,
Tulsa,Commissioner of Labor,Fred Dorrell,DEM,720757,0,0,441,441,
Tulsa,Commissioner of Labor,Brandt Dismukes,IND,720757,0,0,80,80,
Tulsa,Insurance Commissioner,Glen Mulready,REP,720757,0,0,1247,1247,
Tulsa,Insurance Commissioner,Kimberly Fobbs,DEM,720757,0,0,488,488,
Tulsa,Corporation Commissioner,Bob Anthony,REP,720757,0,0,1183,1183,
Tulsa,Corporation Commissioner,Ashley Nicole Mccray,DEM,720757,0,0,457,457,
Tulsa,Corporation Commissioner,Jackie Short,IND,720757,0,0,97,97,
Tulsa,U.S. House,Kevin Hern,REP,720757,0,0,1256,1256,1
Tulsa,U.S. House,Tim Gilpin,DEM,720757,0,0,491,491,1
Tulsa,Governor,Chris Powell,LIB,720758,0,0,13,13,
Tulsa,Governor,Kevin Stitt,REP,720758,0,0,312,312,
Tulsa,Governor,Drew Edmondson,DEM,720758,0,0,195,195,
Tulsa,Lieutenant Governor,Matt Pinnell,REP,720758,0,0,363,363,
Tulsa,Lieutenant Governor,Anastasia Pittman,DEM,720758,0,0,136,136,
Tulsa,Lieutenant Governor,Ivan Holmes,IND,720758,0,0,13,13,
Tulsa,State Auditor,John Yeutter,LIB,720758,0,0,106,106,
Tulsa,State Auditor,Cindy Byrd,REP,720758,0,0,388,388,
Tulsa,Attorney General,Mike Hunter,REP,720758,0,0,360,360,
Tulsa,Attorney General,Mark Myles,DEM,720758,0,0,150,150,
Tulsa,State Treasurer,Randy Mcdaniel,REP,720758,0,0,370,370,
Tulsa,State Treasurer,Charles De Coune,IND,720758,0,0,123,123,
Tulsa,Superintendent of Public Instruction,Joy Hofmeister,REP,720758,0,0,318,318,
Tulsa,Superintendent of Public Instruction,John Cox,DEM,720758,0,0,153,153,
Tulsa,Superintendent of Public Instruction,Larry Huff,IND,720758,0,0,41,41,
Tulsa,Commissioner of Labor,Leslie Osborn,REP,720758,0,0,347,347,
Tulsa,Commissioner of Labor,Fred Dorrell,DEM,720758,0,0,131,131,
Tulsa,Commissioner of Labor,Brandt Dismukes,IND,720758,0,0,25,25,
Tulsa,Insurance Commissioner,Glen Mulready,REP,720758,0,0,351,351,
Tulsa,Insurance Commissioner,Kimberly Fobbs,DEM,720758,0,0,151,151,
Tulsa,Corporation Commissioner,Bob Anthony,REP,720758,0,0,338,338,
Tulsa,Corporation Commissioner,Ashley Nicole Mccray,DEM,720758,0,0,140,140,
Tulsa,Corporation Commissioner,Jackie Short,IND,720758,0,0,27,27,
Tulsa,U.S. House,Kevin Hern,REP,720758,0,0,353,353,1
Tulsa,U.S. House,Tim Gilpin,DEM,720758,0,0,158,158,1
Tulsa,Governor,Chris Powell,LIB,720759,0,0,44,44,
Tulsa,Governor,Kevin Stitt,REP,720759,0,0,544,544,
Tulsa,Governor,Drew Edmondson,DEM,720759,0,0,394,394,
Tulsa,Lieutenant Governor,Matt Pinnell,REP,720759,0,0,645,645,
Tulsa,Lieutenant Governor,Anastasia Pittman,DEM,720759,0,0,297,297,
Tulsa,Lieutenant Governor,Ivan Holmes,IND,720759,0,0,33,33,
Tulsa,State Auditor,John Yeutter,LIB,720759,0,0,231,231,
Tulsa,State Auditor,Cindy Byrd,REP,720759,0,0,675,675,
Tulsa,Attorney General,Mike Hunter,REP,720759,0,0,638,638,
Tulsa,Attorney General,Mark Myles,DEM,720759,0,0,331,331,
Tulsa,State Treasurer,Randy Mcdaniel,REP,720759,0,0,648,648,
Tulsa,State Treasurer,Charles De Coune,IND,720759,0,0,263,263,
Tulsa,Superintendent of Public Instruction,Joy Hofmeister,REP,720759,0,0,575,575,
Tulsa,Superintendent of Public Instruction,John Cox,DEM,720759,0,0,327,327,
Tulsa,Superintendent of Public Instruction,Larry Huff,IND,720759,0,0,69,69,
Tulsa,Commissioner of Labor,Leslie Osborn,REP,720759,0,0,604,604,
Tulsa,Commissioner of Labor,Fred Dorrell,DEM,720759,0,0,302,302,
Tulsa,Commissioner of Labor,Brandt Dismukes,IND,720759,0,0,44,44,
Tulsa,Insurance Commissioner,Glen Mulready,REP,720759,0,0,607,607,
Tulsa,Insurance Commissioner,Kimberly Fobbs,DEM,720759,0,0,343,343,
Tulsa,Corporation Commissioner,Bob Anthony,REP,720759,0,0,594,594,
Tulsa,Corporation Commissioner,Ashley Nicole Mccray,DEM,720759,0,0,322,322,
Tulsa,Corporation Commissioner,Jackie Short,IND,720759,0,0,46,46,
Tulsa,U.S. House,Kevin Hern,REP,720759,0,0,630,630,1
Tulsa,U.S. House,Tim Gilpin,DEM,720759,0,0,340,340,1
Tulsa,Governor,Chris Powell,LIB,720760,0,0,29,29,
Tulsa,Governor,Kevin Stitt,REP,720760,0,0,545,545,
Tulsa,Governor,Drew Edmondson,DEM,720760,0,0,391,391,
Tulsa,Lieutenant Governor,Matt Pinnell,REP,720760,0,0,603,603,
Tulsa,Lieutenant Governor,Anastasia Pittman,DEM,720760,0,0,317,317,
Tulsa,Lieutenant Governor,Ivan Holmes,IND,720760,0,0,37,37,
Tulsa,State Auditor,John Yeutter,LIB,720760,0,0,209,209,
Tulsa,State Auditor,Cindy Byrd,REP,720760,0,0,677,677,
Tulsa,Attorney General,Mike Hunter,REP,720760,0,0,643,643,
Tulsa,Attorney General,Mark Myles,DEM,720760,0,0,310,310,
Tulsa,State Treasurer,Randy Mcdaniel,REP,720760,0,0,646,646,
Tulsa,State Treasurer,Charles De Coune,IND,720760,0,0,235,235,
Tulsa,Superintendent of Public Instruction,Joy Hofmeister,REP,720760,0,0,577,577,
Tulsa,Superintendent of Public Instruction,John Cox,DEM,720760,0,0,306,306,
Tulsa,Superintendent of Public Instruction,Larry Huff,IND,720760,0,0,76,76,
Tulsa,Commissioner of Labor,Leslie Osborn,REP,720760,0,0,602,602,
Tulsa,Commissioner of Labor,Fred Dorrell,DEM,720760,0,0,294,294,
Tulsa,Commissioner of Labor,Brandt Dismukes,IND,720760,0,0,51,51,
Tulsa,Insurance Commissioner,Glen Mulready,REP,720760,0,0,614,614,
Tulsa,Insurance Commissioner,Kimberly Fobbs,DEM,720760,0,0,335,335,
Tulsa,Corporation Commissioner,Bob Anthony,REP,720760,0,0,568,568,
Tulsa,Corporation Commissioner,Ashley Nicole Mccray,DEM,720760,0,0,306,306,
Tulsa,Corporation Commissioner,Jackie Short,IND,720760,0,0,76,76,
Tulsa,U.S. House,Kevin Hern,REP,720760,0,0,616,616,1
Tulsa,U.S. House,Tim Gilpin,DEM,720760,0,0,342,342,1
Tulsa,Governor,Chris Powell,LIB,720801,0,0,18,18,
Tulsa,Governor,Kevin Stitt,REP,720801,0,0,399,399,
Tulsa,Governor,Drew Edmondson,DEM,720801,0,0,250,250,
Tulsa,Lieutenant Governor,Matt Pinnell,REP,720801,0,0,465,465,
Tulsa,Lieutenant Governor,Anastasia Pittman,DEM,720801,0,0,178,178,
Tulsa,Lieutenant Governor,Ivan Holmes,IND,720801,0,0,18,18,
Tulsa,State Auditor,John Yeutter,LIB,720801,0,0,108,108,
Tulsa,State Auditor,Cindy Byrd,REP,720801,0,0,504,504,
Tulsa,Attorney General,Mike Hunter,REP,720801,0,0,470,470,
Tulsa,Attorney General,Mark Myles,DEM,720801,0,0,187,187,
Tulsa,State Treasurer,Randy Mcdaniel,REP,720801,0,0,479,479,
Tulsa,State Treasurer,Charles De Coune,IND,720801,0,0,132,132,
Tulsa,Superintendent of Public Instruction,Joy Hofmeister,REP,720801,0,0,392,392,
Tulsa,Superintendent of Public Instruction,John Cox,DEM,720801,0,0,235,235,
Tulsa,Superintendent of Public Instruction,Larry Huff,IND,720801,0,0,33,33,
Tulsa,Commissioner of Labor,Leslie Osborn,REP,720801,0,0,444,444,
Tulsa,Commissioner of Labor,Fred Dorrell,DEM,720801,0,0,184,184,
Tulsa,Commissioner of Labor,Brandt Dismukes,IND,720801,0,0,22,22,
Tulsa,Insurance Commissioner,Glen Mulready,REP,720801,0,0,466,466,
Tulsa,Insurance Commissioner,Kimberly Fobbs,DEM,720801,0,0,188,188,
Tulsa,Corporation Commissioner,Bob Anthony,REP,720801,0,0,443,443,
Tulsa,Corporation Commissioner,Ashley Nicole Mccray,DEM,720801,0,0,175,175,
Tulsa,Corporation Commissioner,Jackie Short,IND,720801,0,0,36,36,
Tulsa,U.S. House,Kevin Hern,REP,720801,0,0,461,461,1
Tulsa,U.S. House,Tim Gilpin,DEM,720801,0,0,200,200,1
Tulsa,State House,Jadine Nollan,REP,720801,0,0,453,453,66
Tulsa,State House,Angela Graham,DEM,720801,0,0,201,201,66
Tulsa,Governor,Chris Powell,LIB,720802,0,0,14,14,
Tulsa,Governor,Kevin Stitt,REP,720802,0,0,278,278,
Tulsa,Governor,Drew Edmondson,DEM,720802,0,0,149,149,
Tulsa,Lieutenant Governor,Matt Pinnell,REP,720802,0,0,295,295,
Tulsa,Lieutenant Governor,Anastasia Pittman,DEM,720802,0,0,132,132,
Tulsa,Lieutenant Governor,Ivan Holmes,IND,720802,0,0,12,12,
Tulsa,State Auditor,John Yeutter,LIB,720802,0,0,89,89,
Tulsa,State Auditor,Cindy Byrd,REP,720802,0,0,316,316,
Tulsa,Attorney General,Mike Hunter,REP,720802,0,0,295,295,
Tulsa,Attorney General,Mark Myles,DEM,720802,0,0,142,142,
Tulsa,State Treasurer,Randy Mcdaniel,REP,720802,0,0,308,308,
Tulsa,State Treasurer,Charles De Coune,IND,720802,0,0,94,94,
Tulsa,Superintendent of Public Instruction,Joy Hofmeister,REP,720802,0,0,264,264,
Tulsa,Superintendent of Public Instruction,John Cox,DEM,720802,0,0,143,143,
Tulsa,Superintendent of Public Instruction,Larry Huff,IND,720802,0,0,29,29,
Tulsa,Commissioner of Labor,Leslie Osborn,REP,720802,0,0,288,288,
Tulsa,Commissioner of Labor,Fred Dorrell,DEM,720802,0,0,133,133,
Tulsa,Commissioner of Labor,Brandt Dismukes,IND,720802,0,0,15,15,
Tulsa,Insurance Commissioner,Glen Mulready,REP,720802,0,0,298,298,
Tulsa,Insurance Commissioner,Kimberly Fobbs,DEM,720802,0,0,139,139,
Tulsa,Corporation Commissioner,Bob Anthony,REP,720802,0,0,290,290,
Tulsa,Corporation Commissioner,Ashley Nicole Mccray,DEM,720802,0,0,126,126,
Tulsa,Corporation Commissioner,Jackie Short,IND,720802,0,0,22,22,
Tulsa,U.S. House,Kevin Hern,REP,720802,0,0,300,300,1
Tulsa,U.S. House,Tim Gilpin,DEM,720802,0,0,138,138,1
Tulsa,State House,J. Lee Miller Jr.,LIB,720802,0,0,6,6,68
Tulsa,State House,Lonnie Sims,REP,720802,0,0,264,264,68
Tulsa,State House,Michael Ross,DEM,720802,0,0,127,127,68
Tulsa,State House,Heather Chenoweth,IND,720802,0,0,40,40,68
Tulsa,Governor,Chris Powell,LIB,720851,0,0,22,22,
Tulsa,Governor,Kevin Stitt,REP,720851,0,0,400,400,
Tulsa,Governor,Drew Edmondson,DEM,720851,0,0,336,336,
Tulsa,Lieutenant Governor,Matt Pinnell,REP,720851,0,0,463,463,
Tulsa,Lieutenant Governor,Anastasia Pittman,DEM,720851,0,0,265,265,
Tulsa,Lieutenant Governor,Ivan Holmes,IND,720851,0,0,21,21,
Tulsa,State Auditor,John Yeutter,LIB,720851,0,0,156,156,
Tulsa,State Auditor,Cindy Byrd,REP,720851,0,0,527,527,
Tulsa,Attorney General,Mike Hunter,REP,720851,0,0,455,455,
Tulsa,Attorney General,Mark Myles,DEM,720851,0,0,287,287,
Tulsa,State Treasurer,Randy Mcdaniel,REP,720851,0,0,490,490,
Tulsa,State Treasurer,Charles De Coune,IND,720851,0,0,191,191,
Tulsa,Superintendent of Public Instruction,Joy Hofmeister,REP,720851,0,0,438,438,
Tulsa,Superintendent of Public Instruction,John Cox,DEM,720851,0,0,260,260,
Tulsa,Superintendent of Public Instruction,Larry Huff,IND,720851,0,0,49,49,
Tulsa,Commissioner of Labor,Leslie Osborn,REP,720851,0,0,442,442,
Tulsa,Commissioner of Labor,Fred Dorrell,DEM,720851,0,0,258,258,
Tulsa,Commissioner of Labor,Brandt Dismukes,IND,720851,0,0,32,32,
Tulsa,Insurance Commissioner,Glen Mulready,REP,720851,0,0,441,441,
Tulsa,Insurance Commissioner,Kimberly Fobbs,DEM,720851,0,0,293,293,
Tulsa,Corporation Commissioner,Bob Anthony,REP,720851,0,0,446,446,
Tulsa,Corporation Commissioner,Ashley Nicole Mccray,DEM,720851,0,0,251,251,
Tulsa,Corporation Commissioner,Jackie Short,IND,720851,0,0,35,35,
Tulsa,U.S. House,Kevin Hern,REP,720851,0,0,445,445,1
Tulsa,U.S. House,Tim Gilpin,DEM,720851,0,0,297,297,1
Tulsa,State House,Jadine Nollan,REP,720851,0,0,470,470,66
Tulsa,State House,Angela Graham,DEM,720851,0,0,284,284,66
Tulsa,Governor,Chris Powell,LIB,720852,0,0,24,24,
Tulsa,Governor,Kevin Stitt,REP,720852,0,0,234,234,
Tulsa,Governor,Drew Edmondson,DEM,720852,0,0,252,252,
Tulsa,Lieutenant Governor,Matt Pinnell,REP,720852,0,0,270,270,
Tulsa,Lieutenant Governor,Anastasia Pittman,DEM,720852,0,0,210,210,
Tulsa,Lieutenant Governor,Ivan Holmes,IND,720852,0,0,21,21,
Tulsa,State Auditor,John Yeutter,LIB,720852,0,0,169,169,
Tulsa,State Auditor,Cindy Byrd,REP,720852,0,0,293,293,
Tulsa,Attorney General,Mike Hunter,REP,720852,0,0,265,265,
Tulsa,Attorney General,Mark Myles,DEM,720852,0,0,234,234,
Tulsa,State Treasurer,Randy Mcdaniel,REP,720852,0,0,267,267,
Tulsa,State Treasurer,Charles De Coune,IND,720852,0,0,189,189,
Tulsa,Superintendent of Public Instruction,Joy Hofmeister,REP,720852,0,0,233,233,
Tulsa,Superintendent of Public Instruction,John Cox,DEM,720852,0,0,221,221,
Tulsa,Superintendent of Public Instruction,Larry Huff,IND,720852,0,0,47,47,
Tulsa,Commissioner of Labor,Leslie Osborn,REP,720852,0,0,252,252,
Tulsa,Commissioner of Labor,Fred Dorrell,DEM,720852,0,0,209,209,
Tulsa,Commissioner of Labor,Brandt Dismukes,IND,720852,0,0,34,34,
Tulsa,Insurance Commissioner,Glen Mulready,REP,720852,0,0,273,273,
Tulsa,Insurance Commissioner,Kimberly Fobbs,DEM,720852,0,0,221,221,
Tulsa,Corporation Commissioner,Bob Anthony,REP,720852,0,0,258,258,
Tulsa,Corporation Commissioner,Ashley Nicole Mccray,DEM,720852,0,0,210,210,
Tulsa,Corporation Commissioner,Jackie Short,IND,720852,0,0,32,32,
Tulsa,U.S. House,Kevin Hern,REP,720852,0,0,261,261,1
Tulsa,U.S. House,Tim Gilpin,DEM,720852,0,0,242,242,1
Tulsa,State House,Jadine Nollan,REP,720852,0,0,255,255,66
Tulsa,State House,Angela Graham,DEM,720852,0,0,250,250,66
Tulsa,Governor,Chris Powell,LIB,720853,0,0,30,30,
Tulsa,Governor,Kevin Stitt,REP,720853,0,0,362,362,
Tulsa,Governor,Drew Edmondson,DEM,720853,0,0,202,202,
Tulsa,Lieutenant Governor,Matt Pinnell,REP,720853,0,0,398,398,
Tulsa,Lieutenant Governor,Anastasia Pittman,DEM,720853,0,0,169,169,
Tulsa,Lieutenant Governor,Ivan Holmes,IND,720853,0,0,21,21,
Tulsa,State Auditor,John Yeutter,LIB,720853,0,0,133,133,
Tulsa,State Auditor,Cindy Byrd,REP,720853,0,0,420,420,
Tulsa,Attorney General,Mike Hunter,REP,720853,0,0,403,403,
Tulsa,Attorney General,Mark Myles,DEM,720853,0,0,181,181,
Tulsa,State Treasurer,Randy Mcdaniel,REP,720853,0,0,414,414,
Tulsa,State Treasurer,Charles De Coune,IND,720853,0,0,136,136,
Tulsa,Superintendent of Public Instruction,Joy Hofmeister,REP,720853,0,0,364,364,
Tulsa,Superintendent of Public Instruction,John Cox,DEM,720853,0,0,171,171,
Tulsa,Superintendent of Public Instruction,Larry Huff,IND,720853,0,0,54,54,
Tulsa,Commissioner of Labor,Leslie Osborn,REP,720853,0,0,370,370,
Tulsa,Commissioner of Labor,Fred Dorrell,DEM,720853,0,0,169,169,
Tulsa,Commissioner of Labor,Brandt Dismukes,IND,720853,0,0,38,38,
Tulsa,Insurance Commissioner,Glen Mulready,REP,720853,0,0,402,402,
Tulsa,Insurance Commissioner,Kimberly Fobbs,DEM,720853,0,0,176,176,
Tulsa,Corporation Commissioner,Bob Anthony,REP,720853,0,0,377,377,
Tulsa,Corporation Commissioner,Ashley Nicole Mccray,DEM,720853,0,0,155,155,
Tulsa,Corporation Commissioner,Jackie Short,IND,720853,0,0,48,48,
Tulsa,U.S. House,Kevin Hern,REP,720853,0,0,392,392,1
Tulsa,U.S. House,Tim Gilpin,DEM,720853,0,0,193,193,1
Tulsa,State House,Jadine Nollan,REP,720853,0,0,401,401,66
Tulsa,State House,Angela Graham,DEM,720853,0,0,187,187,66
Tulsa,Governor,Chris Powell,LIB,720854,0,0,40,40,
Tulsa,Governor,Kevin Stitt,REP,720854,0,0,734,734,
Tulsa,Governor,Drew Edmondson,DEM,720854,0,0,472,472,
Tulsa,Lieutenant Governor,Matt Pinnell,REP,720854,0,0,865,865,
Tulsa,Lieutenant Governor,Anastasia Pittman,DEM,720854,0,0,341,341,
Tulsa,Lieutenant Governor,Ivan Holmes,IND,720854,0,0,31,31,
Tulsa,State Auditor,John Yeutter,LIB,720854,0,0,215,215,
Tulsa,State Auditor,Cindy Byrd,REP,720854,0,0,927,927,
Tulsa,Attorney General,Mike Hunter,REP,720854,0,0,870,870,
Tulsa,Attorney General,Mark Myles,DEM,720854,0,0,361,361,
Tulsa,State Treasurer,Randy Mcdaniel,REP,720854,0,0,895,895,
Tulsa,State Treasurer,Charles De Coune,IND,720854,0,0,251,251,
Tulsa,Superintendent of Public Instruction,Joy Hofmeister,REP,720854,0,0,798,798,
Tulsa,Superintendent of Public Instruction,John Cox,DEM,720854,0,0,378,378,
Tulsa,Superintendent of Public Instruction,Larry Huff,IND,720854,0,0,65,65,
Tulsa,Commissioner of Labor,Leslie Osborn,REP,720854,0,0,844,844,
Tulsa,Commissioner of Labor,Fred Dorrell,DEM,720854,0,0,328,328,
Tulsa,Commissioner of Labor,Brandt Dismukes,IND,720854,0,0,39,39,
Tulsa,Insurance Commissioner,Glen Mulready,REP,720854,0,0,859,859,
Tulsa,Insurance Commissioner,Kimberly Fobbs,DEM,720854,0,0,367,367,
Tulsa,Corporation Commissioner,Bob Anthony,REP,720854,0,0,840,840,
Tulsa,Corporation Commissioner,Ashley Nicole Mccray,DEM,720854,0,0,331,331,
Tulsa,Corporation Commissioner,Jackie Short,IND,720854,0,0,52,52,
Tulsa,U.S. House,Kevin Hern,REP,720854,0,0,845,845,1
Tulsa,U.S. House,Tim Gilpin,DEM,720854,0,0,391,391,1
Tulsa,State House,Jadine Nollan,REP,720854,0,0,815,815,66
Tulsa,State House,Angela Graham,DEM,720854,0,0,424,424,66
Tulsa,Governor,Chris Powell,LIB,720855,0,0,25,25,
Tulsa,Governor,Kevin Stitt,REP,720855,0,0,741,741,
Tulsa,Governor,Drew Edmondson,DEM,720855,0,0,394,394,
Tulsa,Lieutenant Governor,Matt Pinnell,REP,720855,0,0,839,839,
Tulsa,Lieutenant Governor,Anastasia Pittman,DEM,720855,0,0,287,287,
Tulsa,Lieutenant Governor,Ivan Holmes,IND,720855,0,0,27,27,
Tulsa,State Auditor,John Yeutter,LIB,720855,0,0,179,179,
Tulsa,State Auditor,Cindy Byrd,REP,720855,0,0,892,892,
Tulsa,Attorney General,Mike Hunter,REP,720855,0,0,849,849,
Tulsa,Attorney General,Mark Myles,DEM,720855,0,0,296,296,
Tulsa,State Treasurer,Randy Mcdaniel,REP,720855,0,0,870,870,
Tulsa,State Treasurer,Charles De Coune,IND,720855,0,0,201,201,
Tulsa,Superintendent of Public Instruction,Joy Hofmeister,REP,720855,0,0,727,727,
Tulsa,Superintendent of Public Instruction,John Cox,DEM,720855,0,0,348,348,
Tulsa,Superintendent of Public Instruction,Larry Huff,IND,720855,0,0,76,76,
Tulsa,Commissioner of Labor,Leslie Osborn,REP,720855,0,0,778,778,
Tulsa,Commissioner of Labor,Fred Dorrell,DEM,720855,0,0,311,311,
Tulsa,Commissioner of Labor,Brandt Dismukes,IND,720855,0,0,41,41,
Tulsa,Insurance Commissioner,Glen Mulready,REP,720855,0,0,827,827,
Tulsa,Insurance Commissioner,Kimberly Fobbs,DEM,720855,0,0,314,314,
Tulsa,Corporation Commissioner,Bob Anthony,REP,720855,0,0,805,805,
Tulsa,Corporation Commissioner,Ashley Nicole Mccray,DEM,720855,0,0,289,289,
Tulsa,Corporation Commissioner,Jackie Short,IND,720855,0,0,47,47,
Tulsa,U.S. House,Kevin Hern,REP,720855,0,0,819,819,1
Tulsa,U.S. House,Tim Gilpin,DEM,720855,0,0,329,329,1
Tulsa,State House,Jadine Nollan,REP,720855,0,0,795,795,66
Tulsa,State House,Angela Graham,DEM,720855,0,0,362,362,66
Tulsa,Governor,Chris Powell,LIB,720856,0,0,29,29,
Tulsa,Governor,Kevin Stitt,REP,720856,0,0,805,805,
Tulsa,Governor,Drew Edmondson,DEM,720856,0,0,471,471,
Tulsa,Lieutenant Governor,Matt Pinnell,REP,720856,0,0,913,913,
Tulsa,Lieutenant Governor,Anastasia Pittman,DEM,720856,0,0,345,345,
Tulsa,Lieutenant Governor,Ivan Holmes,IND,720856,0,0,30,30,
Tulsa,State Auditor,John Yeutter,LIB,720856,0,0,247,247,
Tulsa,State Auditor,Cindy Byrd,REP,720856,0,0,964,964,
Tulsa,Attorney General,Mike Hunter,REP,720856,0,0,909,909,
Tulsa,Attorney General,Mark Myles,DEM,720856,0,0,372,372,
Tulsa,State Treasurer,Randy Mcdaniel,REP,720856,0,0,946,946,
Tulsa,State Treasurer,Charles De Coune,IND,720856,0,0,266,266,
Tulsa,Superintendent of Public Instruction,Joy Hofmeister,REP,720856,0,0,841,841,
Tulsa,Superintendent of Public Instruction,John Cox,DEM,720856,0,0,380,380,
Tulsa,Superintendent of Public Instruction,Larry Huff,IND,720856,0,0,70,70,
Tulsa,Commissioner of Labor,Leslie Osborn,REP,720856,0,0,874,874,
Tulsa,Commissioner of Labor,Fred Dorrell,DEM,720856,0,0,343,343,
Tulsa,Commissioner of Labor,Brandt Dismukes,IND,720856,0,0,48,48,
Tulsa,Insurance Commissioner,Glen Mulready,REP,720856,0,0,909,909,
Tulsa,Insurance Commissioner,Kimberly Fobbs,DEM,720856,0,0,362,362,
Tulsa,Corporation Commissioner,Bob Anthony,REP,720856,0,0,875,875,
Tulsa,Corporation Commissioner,Ashley Nicole Mccray,DEM,720856,0,0,341,341,
Tulsa,Corporation Commissioner,Jackie Short,IND,720856,0,0,61,61,
Tulsa,U.S. House,Kevin Hern,REP,720856,0,0,904,904,1
Tulsa,U.S. House,Tim Gilpin,DEM,720856,0,0,382,382,1
Tulsa,State House,Jadine Nollan,REP,720856,0,0,884,884,66
Tulsa,State House,Angela Graham,DEM,720856,0,0,403,403,66
Tulsa,Governor,Chris Powell,LIB,720857,0,0,33,33,
Tulsa,Governor,Kevin Stitt,REP,720857,0,0,417,417,
Tulsa,Governor,Drew Edmondson,DEM,720857,0,0,304,304,
Tulsa,Lieutenant Governor,Matt Pinnell,REP,720857,0,0,478,478,
Tulsa,Lieutenant Governor,Anastasia Pittman,DEM,720857,0,0,241,241,
Tulsa,Lieutenant Governor,Ivan Holmes,IND,720857,0,0,33,33,
Tulsa,State Auditor,John Yeutter,LIB,720857,0,0,192,192,
Tulsa,State Auditor,Cindy Byrd,REP,720857,0,0,503,503,
Tulsa,Attorney General,Mike Hunter,REP,720857,0,0,477,477,
Tulsa,Attorney General,Mark Myles,DEM,720857,0,0,270,270,
Tulsa,State Treasurer,Randy Mcdaniel,REP,720857,0,0,492,492,
Tulsa,State Treasurer,Charles De Coune,IND,720857,0,0,203,203,
Tulsa,Superintendent of Public Instruction,Joy Hofmeister,REP,720857,0,0,428,428,
Tulsa,Superintendent of Public Instruction,John Cox,DEM,720857,0,0,264,264,
Tulsa,Superintendent of Public Instruction,Larry Huff,IND,720857,0,0,60,60,
Tulsa,Commissioner of Labor,Leslie Osborn,REP,720857,0,0,451,451,
Tulsa,Commissioner of Labor,Fred Dorrell,DEM,720857,0,0,245,245,
Tulsa,Commissioner of Labor,Brandt Dismukes,IND,720857,0,0,51,51,
Tulsa,Insurance Commissioner,Glen Mulready,REP,720857,0,0,458,458,
Tulsa,Insurance Commissioner,Kimberly Fobbs,DEM,720857,0,0,290,290,
Tulsa,Corporation Commissioner,Bob Anthony,REP,720857,0,0,451,451,
Tulsa,Corporation Commissioner,Ashley Nicole Mccray,DEM,720857,0,0,242,242,
Tulsa,Corporation Commissioner,Jackie Short,IND,720857,0,0,56,56,
Tulsa,U.S. House,Kevin Hern,REP,720857,0,0,466,466,1
Tulsa,U.S. House,Tim Gilpin,DEM,720857,0,0,288,288,1
Tulsa,State House,Jadine Nollan,REP,720857,0,0,490,490,66
Tulsa,State House,Angela Graham,DEM,720857,0,0,263,263,66
Tulsa,Governor,Chris Powell,LIB,720858,0,0,19,19,
Tulsa,Governor,Kevin Stitt,REP,720858,0,0,275,275,
Tulsa,Governor,Drew Edmondson,DEM,720858,0,0,124,124,
Tulsa,Lieutenant Governor,Matt Pinnell,REP,720858,0,0,295,295,
Tulsa,Lieutenant Governor,Anastasia Pittman,DEM,720858,0,0,100,100,
Tulsa,Lieutenant Governor,Ivan Holmes,IND,720858,0,0,21,21,
Tulsa,State Auditor,John Yeutter,LIB,720858,0,0,80,80,
Tulsa,State Auditor,Cindy Byrd,REP,720858,0,0,307,307,
Tulsa,Attorney General,Mike Hunter,REP,720858,0,0,311,311,
Tulsa,Attorney General,Mark Myles,DEM,720858,0,0,103,103,
Tulsa,State Treasurer,Randy Mcdaniel,REP,720858,0,0,308,308,
Tulsa,State Treasurer,Charles De Coune,IND,720858,0,0,79,79,
Tulsa,Superintendent of Public Instruction,Joy Hofmeister,REP,720858,0,0,261,261,
Tulsa,Superintendent of Public Instruction,John Cox,DEM,720858,0,0,116,116,
Tulsa,Superintendent of Public Instruction,Larry Huff,IND,720858,0,0,37,37,
Tulsa,Commissioner of Labor,Leslie Osborn,REP,720858,0,0,289,289,
Tulsa,Commissioner of Labor,Fred Dorrell,DEM,720858,0,0,99,99,
Tulsa,Commissioner of Labor,Brandt Dismukes,IND,720858,0,0,22,22,
Tulsa,Insurance Commissioner,Glen Mulready,REP,720858,0,0,291,291,
Tulsa,Insurance Commissioner,Kimberly Fobbs,DEM,720858,0,0,115,115,
Tulsa,Corporation Commissioner,Bob Anthony,REP,720858,0,0,295,295,
Tulsa,Corporation Commissioner,Ashley Nicole Mccray,DEM,720858,0,0,94,94,
Tulsa,Corporation Commissioner,Jackie Short,IND,720858,0,0,21,21,
Tulsa,U.S. House,Kevin Hern,REP,720858,0,0,310,310,1
Tulsa,U.S. House,Tim Gilpin,DEM,720858,0,0,104,104,1
Tulsa,State House,Kyle Hilbert,REP,720858,0,0,297,297,29
Tulsa,State House,Jesse Goodwin,DEM,720858,0,0,113,113,29
Tulsa,Governor,Chris Powell,LIB,720880,0,0,35,35,
Tulsa,Governor,Kevin Stitt,REP,720880,0,0,616,616,
Tulsa,Governor,Drew Edmondson,DEM,720880,0,0,280,280,
Tulsa,Lieutenant Governor,Matt Pinnell,REP,720880,0,0,673,673,
Tulsa,Lieutenant Governor,Anastasia Pittman,DEM,720880,0,0,221,221,
Tulsa,Lieutenant Governor,Ivan Holmes,IND,720880,0,0,36,36,
Tulsa,State Auditor,John Yeutter,LIB,720880,0,0,170,170,
Tulsa,State Auditor,Cindy Byrd,REP,720880,0,0,706,706,
Tulsa,Attorney General,Mike Hunter,REP,720880,0,0,670,670,
Tulsa,Attorney General,Mark Myles,DEM,720880,0,0,255,255,
Tulsa,State Treasurer,Randy Mcdaniel,REP,720880,0,0,695,695,
Tulsa,State Treasurer,Charles De Coune,IND,720880,0,0,179,179,
Tulsa,Superintendent of Public Instruction,Joy Hofmeister,REP,720880,0,0,615,615,
Tulsa,Superintendent of Public Instruction,John Cox,DEM,720880,0,0,241,241,
Tulsa,Superintendent of Public Instruction,Larry Huff,IND,720880,0,0,73,73,
Tulsa,Commissioner of Labor,Leslie Osborn,REP,720880,0,0,634,634,
Tulsa,Commissioner of Labor,Fred Dorrell,DEM,720880,0,0,243,243,
Tulsa,Commissioner of Labor,Brandt Dismukes,IND,720880,0,0,41,41,
Tulsa,Insurance Commissioner,Glen Mulready,REP,720880,0,0,670,670,
Tulsa,Insurance Commissioner,Kimberly Fobbs,DEM,720880,0,0,247,247,
Tulsa,Corporation Commissioner,Bob Anthony,REP,720880,0,0,637,637,
Tulsa,Corporation Commissioner,Ashley Nicole Mccray,DEM,720880,0,0,236,236,
Tulsa,Corporation Commissioner,Jackie Short,IND,720880,0,0,50,50,
Tulsa,U.S. House,Kevin Hern,REP,720880,0,0,682,682,1
Tulsa,U.S. House,Tim Gilpin,DEM,720880,0,0,242,242,1
Tulsa,State House,Kyle Hilbert,REP,720880,0,0,658,658,29
Tulsa,State House,Jesse Goodwin,DEM,720880,0,0,258,258,29
Tulsa,Governor,Chris Powell,LIB,720881,0,0,29,29,
Tulsa,Governor,Kevin Stitt,REP,720881,0,0,413,413,
Tulsa,Governor,Drew Edmondson,DEM,720881,0,0,222,222,
Tulsa,Lieutenant Governor,Matt Pinnell,REP,720881,0,0,442,442,
Tulsa,Lieutenant Governor,Anastasia Pittman,DEM,720881,0,0,192,192,
Tulsa,Lieutenant Governor,Ivan Holmes,IND,720881,0,0,27,27,
Tulsa,State Auditor,John Yeutter,LIB,720881,0,0,140,140,
Tulsa,State Auditor,Cindy Byrd,REP,720881,0,0,474,474,
Tulsa,Attorney General,Mike Hunter,REP,720881,0,0,453,453,
Tulsa,Attorney General,Mark Myles,DEM,720881,0,0,200,200,
Tulsa,State Treasurer,Randy Mcdaniel,REP,720881,0,0,467,467,
Tulsa,State Treasurer,Charles De Coune,IND,720881,0,0,148,148,
Tulsa,Superintendent of Public Instruction,Joy Hofmeister,REP,720881,0,0,392,392,
Tulsa,Superintendent of Public Instruction,John Cox,DEM,720881,0,0,190,190,
Tulsa,Superintendent of Public Instruction,Larry Huff,IND,720881,0,0,77,77,
Tulsa,Commissioner of Labor,Leslie Osborn,REP,720881,0,0,429,429,
Tulsa,Commissioner of Labor,Fred Dorrell,DEM,720881,0,0,179,179,
Tulsa,Commissioner of Labor,Brandt Dismukes,IND,720881,0,0,36,36,
Tulsa,Insurance Commissioner,Glen Mulready,REP,720881,0,0,447,447,
Tulsa,Insurance Commissioner,Kimberly Fobbs,DEM,720881,0,0,204,204,
Tulsa,Corporation Commissioner,Bob Anthony,REP,720881,0,0,418,418,
Tulsa,Corporation Commissioner,Ashley Nicole Mccray,DEM,720881,0,0,191,191,
Tulsa,Corporation Commissioner,Jackie Short,IND,720881,0,0,46,46,
Tulsa,U.S. House,Kevin Hern,REP,720881,0,0,456,456,1
Tulsa,U.S. House,Tim Gilpin,DEM,720881,0,0,203,203,1
Tulsa,State House,Jadine Nollan,REP,720881,0,0,455,455,66
Tulsa,State House,Angela Graham,DEM,720881,0,0,200,200,66
Tulsa,Governor,Chris Powell,LIB,720900,0,0,29,29,
Tulsa,Governor,Kevin Stitt,REP,720900,0,0,746,746,
Tulsa,Governor,Drew Edmondson,DEM,720900,0,0,349,349,
Tulsa,Lieutenant Governor,Matt Pinnell,REP,720900,0,0,852,852,
Tulsa,Lieutenant Governor,Anastasia Pittman,DEM,720900,0,0,247,247,
Tulsa,Lieutenant Governor,Ivan Holmes,IND,720900,0,0,25,25,
Tulsa,State Auditor,John Yeutter,LIB,720900,0,0,187,187,
Tulsa,State Auditor,Cindy Byrd,REP,720900,0,0,884,884,
Tulsa,Attorney General,Mike Hunter,REP,720900,0,0,860,860,
Tulsa,Attorney General,Mark Myles,DEM,720900,0,0,256,256,
Tulsa,State Treasurer,Randy Mcdaniel,REP,720900,0,0,858,858,
Tulsa,State Treasurer,Charles De Coune,IND,720900,0,0,211,211,
Tulsa,Superintendent of Public Instruction,Joy Hofmeister,REP,720900,0,0,748,748,
Tulsa,Superintendent of Public Instruction,John Cox,DEM,720900,0,0,293,293,
Tulsa,Superintendent of Public Instruction,Larry Huff,IND,720900,0,0,75,75,
Tulsa,Commissioner of Labor,Leslie Osborn,REP,720900,0,0,809,809,
Tulsa,Commissioner of Labor,Fred Dorrell,DEM,720900,0,0,253,253,
Tulsa,Commissioner of Labor,Brandt Dismukes,IND,720900,0,0,47,47,
Tulsa,Insurance Commissioner,Glen Mulready,REP,720900,0,0,816,816,
Tulsa,Insurance Commissioner,Kimberly Fobbs,DEM,720900,0,0,289,289,
Tulsa,Corporation Commissioner,Bob Anthony,REP,720900,0,0,805,805,
Tulsa,Corporation Commissioner,Ashley Nicole Mccray,DEM,720900,0,0,254,254,
Tulsa,Corporation Commissioner,Jackie Short,IND,720900,0,0,46,46,
Tulsa,U.S. House,Kevin Hern,REP,720900,0,0,847,847,1
Tulsa,U.S. House,Tim Gilpin,DEM,720900,0,0,272,272,1
Tulsa,Governor,Chris Powell,LIB,729999,170,207,0,377,
Tulsa,Governor,Kevin Stitt,REP,729999,4675,5437,0,10112,
Tulsa,Governor,Drew Edmondson,DEM,729999,5254,7217,0,12471,
Tulsa,Lieutenant Governor,Matt Pinnell,REP,729999,5368,6235,0,11603,
Tulsa,Lieutenant Governor,Anastasia Pittman,DEM,729999,4400,6289,0,10689,
Tulsa,Lieutenant Governor,Ivan Holmes,IND,729999,238,295,0,533,
Tulsa,State Auditor,John Yeutter,LIB,729999,2282,3724,0,6006,
Tulsa,State Auditor,Cindy Byrd,REP,729999,6483,7571,0,14054,
Tulsa,Attorney General,Mike Hunter,REP,729999,5375,6274,0,11649,
Tulsa,Attorney General,Mark Myles,DEM,729999,4596,6491,0,11087,
Tulsa,State Treasurer,Randy Mcdaniel,REP,729999,5714,6754,0,12468,
Tulsa,State Treasurer,Charles De Coune,IND,729999,3039,4578,0,7617,
Tulsa,Superintendent of Public Instruction,Joy Hofmeister,REP,729999,5568,6400,0,11968,
Tulsa,Superintendent of Public Instruction,John Cox,DEM,729999,3974,5759,0,9733,
Tulsa,Superintendent of Public Instruction,Larry Huff,IND,729999,465,609,0,1074,
Tulsa,Commissioner of Labor,Leslie Osborn,REP,729999,5342,6097,0,11439,
Tulsa,Commissioner of Labor,Fred Dorrell,DEM,729999,4240,6162,0,10402,
Tulsa,Commissioner of Labor,Brandt Dismukes,IND,729999,288,406,0,694,
Tulsa,Insurance Commissioner,Glen Mulready,REP,729999,5314,6113,0,11427,
Tulsa,Insurance Commissioner,Kimberly Fobbs,DEM,729999,4545,6549,0,11094,
Tulsa,Corporation Commissioner,Bob Anthony,REP,729999,5285,6197,0,11482,
Tulsa,Corporation Commissioner,Ashley Nicole Mccray,DEM,729999,4248,6093,0,10341,
Tulsa,Corporation Commissioner,Jackie Short,IND,729999,398,412,0,810,
Tulsa,U.S. House,Kevin Hern,REP,729999,5096,5874,0,10970,1
Tulsa,U.S. House,Tim Gilpin,DEM,729999,4931,6944,0,11875,1
Tulsa,State Senate,James Leewright,REP,729999,66,55,0,121,12
Tulsa,State Senate,Rick Parris,DEM,729999,29,36,0,65,12
Tulsa,State Senate,Kim David,REP,729999,17,36,0,53,18
Tulsa,State Senate,Charles Arnall,DEM,729999,22,10,0,32,18
Tulsa,State Senate,John Haste,REP,729999,422,389,0,811,36
Tulsa,State Senate,Bryan O'Brien,DEM,729999,307,416,0,723,36
Tulsa,State House,Scott Fetgatter,REP,729999,6,0,0,6,16
Tulsa,State House,Chandler Torbett,DEM,729999,2,5,0,7,16
Tulsa,State House,James Delso,IND,729999,0,0,0,0,16
Tulsa,State House,Terry O'Donnell,REP,729999,90,65,0,155,23
Tulsa,State House,Craig John Hoxie,DEM,729999,76,123,0,199,23
Tulsa,State House,Kyle Hilbert,REP,729999,39,37,0,76,29
Tulsa,State House,Jesse Goodwin,DEM,729999,13,22,0,35,29
Tulsa,State House,Jadine Nollan,REP,729999,226,269,0,495,66
Tulsa,State House,Angela Graham,DEM,729999,199,334,0,533,66
Tulsa,State House,Jeff Boatman,REP,729999,638,1035,0,1673,67
Tulsa,State House,Carly Hotvedt,DEM,729999,458,709,0,1167,67
Tulsa,State House,J. Lee Miller Jr.,LIB,729999,13,12,0,25,68
Tulsa,State House,Lonnie Sims,REP,729999,292,355,0,647,68
Tulsa,State House,Michael Ross,DEM,729999,206,281,0,487,68
Tulsa,State House,Heather Chenoweth,IND,729999,25,33,0,58,68
Tulsa,State House,Sheila Dills,REP,729999,677,715,0,1392,69
Tulsa,State House,Andy Richardson,DEM,729999,360,428,0,788,69
Tulsa,State House,Carol Bush,REP,729999,542,530,0,1072,70
Tulsa,State House,Jj Burnam,DEM,729999,510,576,0,1086,70
Tulsa,State House,Cheryl Baber,REP,729999,302,339,0,641,71
Tulsa,State House,Denise Brewer,DEM,729999,436,596,0,1032,71
Tulsa,State House,Kelli Krebs,LIB,729999,9,15,0,24,75
Tulsa,State House,T. Marti,REP,729999,279,272,0,551,75
Tulsa,State House,Karen Gaddis,DEM,729999,237,293,0,530,75
Tulsa,State House,Ross Ford,REP,729999,370,475,0,845,76
Tulsa,State House,Forrest Mayer,DEM,729999,233,334,0,567,76
Tulsa,State House,Todd Blackburn,REP,729999,77,78,0,155,77
Tulsa,State House,John Waldron,DEM,729999,132,212,0,344,77
Tulsa,State House,Gene Bell,LIB,729999,22,23,0,45,78
Tulsa,State House,Paul Royse,REP,729999,176,232,0,408,78
Tulsa,State House,Meloyde Blancett,DEM,729999,384,616,0,1000,78
Tulsa,State House,Dan Hicks,REP,729999,351,367,0,718,79
Tulsa,State House,Melissa Provenzano,DEM,729999,384,493,0,877,79
Tulsa,State House,Stan May,REP,729999,413,498,0,911,80
Tulsa,State House,Janice Graham,DEM,729999,285,283,0,568,80
Tulsa,State House,Dean Davis,REP,729999,110,111,0,221,98
Tulsa,State House,Kilmyn Easley-Graf,DEM,729999,101,82,0,183,98
Tulsa,State House,Sean Parrish,IND,729999,2,3,0,5,98
Wagoner,Governor,Chris Powell,LIB,730101,1,0,30,31,
Wagoner,Governor,Kevin Stitt,REP,730101,9,16,328,353,
Wagoner,Governor,Drew Edmondson,DEM,730101,2,10,230,242,
Wagoner,Lieutenant Governor,Matt Pinnell,REP,730101,10,14,375,399,
Wagoner,Lieutenant Governor,Anastasia Pittman,DEM,730101,2,12,175,189,
Wagoner,Lieutenant Governor,Ivan Holmes,IND,730101,0,0,36,36,
Wagoner,State Auditor,John Yeutter,LIB,730101,1,6,162,169,
Wagoner,State Auditor,Cindy Byrd,REP,730101,10,16,386,412,
Wagoner,Attorney General,Mike Hunter,REP,730101,10,13,389,412,
Wagoner,Attorney General,Mark Myles,DEM,730101,2,12,188,202,
Wagoner,State Treasurer,Randy Mcdaniel,REP,730101,10,16,384,410,
Wagoner,State Treasurer,Charles De Coune,IND,730101,1,5,166,172,
Wagoner,Superintendent of Public Instruction,Joy Hofmeister,REP,730101,9,16,331,356,
Wagoner,Superintendent of Public Instruction,John Cox,DEM,730101,2,10,176,188,
Wagoner,Superintendent of Public Instruction,Larry Huff,IND,730101,1,0,71,72,
Wagoner,Commissioner of Labor,Leslie Osborn,REP,730101,9,14,336,359,
Wagoner,Commissioner of Labor,Fred Dorrell,DEM,730101,3,11,182,196,
Wagoner,Commissioner of Labor,Brandt Dismukes,IND,730101,0,0,53,53,
Wagoner,Insurance Commissioner,Glen Mulready,REP,730101,10,12,369,391,
Wagoner,Insurance Commissioner,Kimberly Fobbs,DEM,730101,2,13,206,221,
Wagoner,Corporation Commissioner,Bob Anthony,REP,730101,7,14,344,365,
Wagoner,Corporation Commissioner,Ashley Nicole Mccray,DEM,730101,4,11,183,198,
Wagoner,Corporation Commissioner,Jackie Short,IND,730101,1,1,48,50,
Wagoner,U.S. House,Kevin Hern,REP,730101,9,15,372,396,1
Wagoner,U.S. House,Tim Gilpin,DEM,730101,3,11,211,225,1
Wagoner,State Senate,Kim David,REP,730101,9,15,369,393,18
Wagoner,State Senate,Charles Arnall,DEM,730101,3,11,205,219,18
Wagoner,State House,Terry O'Donnell,REP,730101,9,15,361,385,23
Wagoner,State House,Craig John Hoxie,DEM,730101,2,11,220,233,23
Wagoner,Governor,Chris Powell,LIB,730102,1,2,26,29,
Wagoner,Governor,Kevin Stitt,REP,730102,13,23,456,492,
Wagoner,Governor,Drew Edmondson,DEM,730102,8,14,198,220,
Wagoner,Lieutenant Governor,Matt Pinnell,REP,730102,15,27,489,531,
Wagoner,Lieutenant Governor,Anastasia Pittman,DEM,730102,7,13,156,176,
Wagoner,Lieutenant Governor,Ivan Holmes,IND,730102,0,0,30,30,
Wagoner,State Auditor,John Yeutter,LIB,730102,5,3,124,132,
Wagoner,State Auditor,Cindy Byrd,REP,730102,16,30,525,571,
Wagoner,Attorney General,Mike Hunter,REP,730102,14,27,507,548,
Wagoner,Attorney General,Mark Myles,DEM,730102,8,13,170,191,
Wagoner,State Treasurer,Randy Mcdaniel,REP,730102,15,30,509,554,
Wagoner,State Treasurer,Charles De Coune,IND,730102,6,5,135,146,
Wagoner,Superintendent of Public Instruction,Joy Hofmeister,REP,730102,15,28,435,478,
Wagoner,Superintendent of Public Instruction,John Cox,DEM,730102,6,11,160,177,
Wagoner,Superintendent of Public Instruction,Larry Huff,IND,730102,1,1,80,82,
Wagoner,Commissioner of Labor,Leslie Osborn,REP,730102,13,27,457,497,
Wagoner,Commissioner of Labor,Fred Dorrell,DEM,730102,8,12,175,195,
Wagoner,Commissioner of Labor,Brandt Dismukes,IND,730102,1,0,41,42,
Wagoner,Insurance Commissioner,Glen Mulready,REP,730102,14,29,487,530,
Wagoner,Insurance Commissioner,Kimberly Fobbs,DEM,730102,8,11,186,205,
Wagoner,Corporation Commissioner,Bob Anthony,REP,730102,14,24,479,517,
Wagoner,Corporation Commissioner,Ashley Nicole Mccray,DEM,730102,7,15,152,174,
Wagoner,Corporation Commissioner,Jackie Short,IND,730102,1,1,45,47,
Wagoner,U.S. House,Kevin Hern,REP,730102,14,26,499,539,1
Wagoner,U.S. House,Tim Gilpin,DEM,730102,7,14,178,199,1
Wagoner,State Senate,Kim David,REP,730102,12,28,492,532,18
Wagoner,State Senate,Charles Arnall,DEM,730102,10,11,184,205,18
Wagoner,State House,Tom Gann,REP,730102,13,25,482,520,8
Wagoner,State House,Darrell Moore,DEM,730102,9,14,194,217,8
Wagoner,Governor,Chris Powell,LIB,730103,1,2,52,55,
Wagoner,Governor,Kevin Stitt,REP,730103,24,91,830,945,
Wagoner,Governor,Drew Edmondson,DEM,730103,31,51,596,678,
Wagoner,Lieutenant Governor,Matt Pinnell,REP,730103,29,99,910,1038,
Wagoner,Lieutenant Governor,Anastasia Pittman,DEM,730103,26,44,499,569,
Wagoner,Lieutenant Governor,Ivan Holmes,IND,730103,1,2,47,50,
Wagoner,State Auditor,John Yeutter,LIB,730103,17,29,341,387,
Wagoner,State Auditor,Cindy Byrd,REP,730103,33,107,1021,1161,
Wagoner,Attorney General,Mike Hunter,REP,730103,31,101,941,1073,
Wagoner,Attorney General,Mark Myles,DEM,730103,25,45,513,583,
Wagoner,State Treasurer,Randy Mcdaniel,REP,730103,31,102,957,1090,
Wagoner,State Treasurer,Charles De Coune,IND,730103,20,36,399,455,
Wagoner,Superintendent of Public Instruction,Joy Hofmeister,REP,730103,21,93,853,967,
Wagoner,Superintendent of Public Instruction,John Cox,DEM,730103,28,47,500,575,
Wagoner,Superintendent of Public Instruction,Larry Huff,IND,730103,7,6,105,118,
Wagoner,Commissioner of Labor,Leslie Osborn,REP,730103,26,92,897,1015,
Wagoner,Commissioner of Labor,Fred Dorrell,DEM,730103,27,49,490,566,
Wagoner,Commissioner of Labor,Brandt Dismukes,IND,730103,3,4,61,68,
Wagoner,Insurance Commissioner,Glen Mulready,REP,730103,27,97,901,1025,
Wagoner,Insurance Commissioner,Kimberly Fobbs,DEM,730103,28,48,548,624,
Wagoner,Corporation Commissioner,Bob Anthony,REP,730103,27,98,863,988,
Wagoner,Corporation Commissioner,Ashley Nicole Mccray,DEM,730103,26,41,504,571,
Wagoner,Corporation Commissioner,Jackie Short,IND,730103,3,5,80,88,
Wagoner,U.S. House,Kevin Hern,REP,730103,29,94,934,1057,1
Wagoner,U.S. House,Tim Gilpin,DEM,730103,27,52,530,609,1
Wagoner,State Senate,Kim David,REP,730103,31,96,942,1069,18
Wagoner,State Senate,Charles Arnall,DEM,730103,25,49,503,577,18
Wagoner,State House,Dean Davis,REP,730103,26,92,836,954,98
Wagoner,State House,Kilmyn Easley-Graf,DEM,730103,28,51,588,667,98
Wagoner,State House,Sean Parrish,IND,730103,2,3,35,40,98
Wagoner,Governor,Chris Powell,LIB,730104,0,0,0,0,
Wagoner,Governor,Kevin Stitt,REP,730104,0,0,0,0,
Wagoner,Governor,Drew Edmondson,DEM,730104,0,0,0,0,
Wagoner,Lieutenant Governor,Matt Pinnell,REP,730104,0,0,0,0,
Wagoner,Lieutenant Governor,Anastasia Pittman,DEM,730104,0,0,0,0,
Wagoner,Lieutenant Governor,Ivan Holmes,IND,730104,0,0,0,0,
Wagoner,State Auditor,John Yeutter,LIB,730104,0,0,0,0,
Wagoner,State Auditor,Cindy Byrd,REP,730104,0,0,0,0,
Wagoner,Attorney General,Mike Hunter,REP,730104,0,0,0,0,
Wagoner,Attorney General,Mark Myles,DEM,730104,0,0,0,0,
Wagoner,State Treasurer,Randy Mcdaniel,REP,730104,0,0,0,0,
Wagoner,State Treasurer,Charles De Coune,IND,730104,0,0,0,0,
Wagoner,Superintendent of Public Instruction,Joy Hofmeister,REP,730104,0,0,0,0,
Wagoner,Superintendent of Public Instruction,John Cox,DEM,730104,0,0,0,0,
Wagoner,Superintendent of Public Instruction,Larry Huff,IND,730104,0,0,0,0,
Wagoner,Commissioner of Labor,Leslie Osborn,REP,730104,0,0,0,0,
Wagoner,Commissioner of Labor,Fred Dorrell,DEM,730104,0,0,0,0,
Wagoner,Commissioner of Labor,Brandt Dismukes,IND,730104,0,0,0,0,
Wagoner,Insurance Commissioner,Glen Mulready,REP,730104,0,0,0,0,
Wagoner,Insurance Commissioner,Kimberly Fobbs,DEM,730104,0,0,0,0,
Wagoner,Corporation Commissioner,Bob Anthony,REP,730104,0,0,0,0,
Wagoner,Corporation Commissioner,Ashley Nicole Mccray,DEM,730104,0,0,0,0,
Wagoner,Corporation Commissioner,Jackie Short,IND,730104,0,0,0,0,
Wagoner,U.S. House,Kevin Hern,REP,730104,0,0,0,0,1
Wagoner,U.S. House,Tim Gilpin,DEM,730104,0,0,0,0,1
Wagoner,State Senate,Kim David,REP,730104,0,0,0,0,18
Wagoner,State Senate,Charles Arnall,DEM,730104,0,0,0,0,18
Wagoner,State House,Kevin Mcdugle,REP,730104,0,0,0,0,12
Wagoner,State House,Cyndi Ralston,DEM,730104,0,0,0,0,12
Wagoner,Governor,Chris Powell,LIB,730105,0,0,0,0,
Wagoner,Governor,Kevin Stitt,REP,730105,0,0,6,6,
Wagoner,Governor,Drew Edmondson,DEM,730105,0,0,0,0,
Wagoner,Lieutenant Governor,Matt Pinnell,REP,730105,0,0,6,6,
Wagoner,Lieutenant Governor,Anastasia Pittman,DEM,730105,0,0,0,0,
Wagoner,Lieutenant Governor,Ivan Holmes,IND,730105,0,0,0,0,
Wagoner,State Auditor,John Yeutter,LIB,730105,0,0,0,0,
Wagoner,State Auditor,Cindy Byrd,REP,730105,0,0,6,6,
Wagoner,Attorney General,Mike Hunter,REP,730105,0,0,6,6,
Wagoner,Attorney General,Mark Myles,DEM,730105,0,0,0,0,
Wagoner,State Treasurer,Randy Mcdaniel,REP,730105,0,0,6,6,
Wagoner,State Treasurer,Charles De Coune,IND,730105,0,0,0,0,
Wagoner,Superintendent of Public Instruction,Joy Hofmeister,REP,730105,0,0,6,6,
Wagoner,Superintendent of Public Instruction,John Cox,DEM,730105,0,0,0,0,
Wagoner,Superintendent of Public Instruction,Larry Huff,IND,730105,0,0,0,0,
Wagoner,Commissioner of Labor,Leslie Osborn,REP,730105,0,0,6,6,
Wagoner,Commissioner of Labor,Fred Dorrell,DEM,730105,0,0,0,0,
Wagoner,Commissioner of Labor,Brandt Dismukes,IND,730105,0,0,0,0,
Wagoner,Insurance Commissioner,Glen Mulready,REP,730105,0,0,6,6,
Wagoner,Insurance Commissioner,Kimberly Fobbs,DEM,730105,0,0,0,0,
Wagoner,Corporation Commissioner,Bob Anthony,REP,730105,0,0,6,6,
Wagoner,Corporation Commissioner,Ashley Nicole Mccray,DEM,730105,0,0,0,0,
Wagoner,Corporation Commissioner,Jackie Short,IND,730105,0,0,0,0,
Wagoner,U.S. House,Kevin Hern,REP,730105,0,0,6,6,1
Wagoner,U.S. House,Tim Gilpin,DEM,730105,0,0,0,0,1
Wagoner,State Senate,John Haste,REP,730105,0,0,6,6,36
Wagoner,State Senate,Bryan O'Brien,DEM,730105,0,0,0,0,36
Wagoner,State House,Tom Gann,REP,730105,0,0,6,6,8
Wagoner,State House,Darrell Moore,DEM,730105,0,0,0,0,8
Wagoner,Governor,Chris Powell,LIB,730106,4,4,52,60,
Wagoner,Governor,Kevin Stitt,REP,730106,40,118,832,990,
Wagoner,Governor,Drew Edmondson,DEM,730106,25,98,495,618,
Wagoner,Lieutenant Governor,Matt Pinnell,REP,730106,43,136,922,1101,
Wagoner,Lieutenant Governor,Anastasia Pittman,DEM,730106,23,80,406,509,
Wagoner,Lieutenant Governor,Ivan Holmes,IND,730106,3,4,48,55,
Wagoner,State Auditor,John Yeutter,LIB,730106,17,50,303,370,
Wagoner,State Auditor,Cindy Byrd,REP,730106,48,153,980,1181,
Wagoner,Attorney General,Mike Hunter,REP,730106,43,136,941,1120,
Wagoner,Attorney General,Mark Myles,DEM,730106,26,83,423,532,
Wagoner,State Treasurer,Randy Mcdaniel,REP,730106,43,139,953,1135,
Wagoner,State Treasurer,Charles De Coune,IND,730106,21,62,334,417,
Wagoner,Superintendent of Public Instruction,Joy Hofmeister,REP,730106,46,135,859,1040,
Wagoner,Superintendent of Public Instruction,John Cox,DEM,730106,19,72,396,487,
Wagoner,Superintendent of Public Instruction,Larry Huff,IND,730106,4,12,113,129,
Wagoner,Commissioner of Labor,Leslie Osborn,REP,730106,43,130,881,1054,
Wagoner,Commissioner of Labor,Fred Dorrell,DEM,730106,23,75,398,496,
Wagoner,Commissioner of Labor,Brandt Dismukes,IND,730106,3,12,72,87,
Wagoner,Insurance Commissioner,Glen Mulready,REP,730106,40,135,907,1082,
Wagoner,Insurance Commissioner,Kimberly Fobbs,DEM,730106,28,83,443,554,
Wagoner,Corporation Commissioner,Bob Anthony,REP,730106,42,135,883,1060,
Wagoner,Corporation Commissioner,Ashley Nicole Mccray,DEM,730106,24,79,392,495,
Wagoner,Corporation Commissioner,Jackie Short,IND,730106,2,4,80,86,
Wagoner,U.S. House,Kevin Hern,REP,730106,42,134,926,1102,1
Wagoner,U.S. House,Tim Gilpin,DEM,730106,27,85,440,552,1
Wagoner,State Senate,John Haste,REP,730106,42,133,917,1092,36
Wagoner,State Senate,Bryan O'Brien,DEM,730106,27,85,445,557,36
Wagoner,State House,Dean Davis,REP,730106,41,121,841,1003,98
Wagoner,State House,Kilmyn Easley-Graf,DEM,730106,27,95,486,608,98
Wagoner,State House,Sean Parrish,IND,730106,1,3,48,52,98
Wagoner,Governor,Chris Powell,LIB,730107,2,6,43,51,
Wagoner,Governor,Kevin Stitt,REP,730107,37,213,695,945,
Wagoner,Governor,Drew Edmondson,DEM,730107,25,116,370,511,
Wagoner,Lieutenant Governor,Matt Pinnell,REP,730107,40,231,768,1039,
Wagoner,Lieutenant Governor,Anastasia Pittman,DEM,730107,23,94,288,405,
Wagoner,Lieutenant Governor,Ivan Holmes,IND,730107,1,10,47,58,
Wagoner,State Auditor,John Yeutter,LIB,730107,11,54,214,279,
Wagoner,State Auditor,Cindy Byrd,REP,730107,46,248,817,1111,
Wagoner,Attorney General,Mike Hunter,REP,730107,42,238,776,1056,
Wagoner,Attorney General,Mark Myles,DEM,730107,22,95,323,440,
Wagoner,State Treasurer,Randy Mcdaniel,REP,730107,43,241,792,1076,
Wagoner,State Treasurer,Charles De Coune,IND,730107,14,63,237,314,
Wagoner,Superintendent of Public Instruction,Joy Hofmeister,REP,730107,38,226,726,990,
Wagoner,Superintendent of Public Instruction,John Cox,DEM,730107,24,86,304,414,
Wagoner,Superintendent of Public Instruction,Larry Huff,IND,730107,3,22,70,95,
Wagoner,Commissioner of Labor,Leslie Osborn,REP,730107,43,226,726,995,
Wagoner,Commissioner of Labor,Fred Dorrell,DEM,730107,20,96,310,426,
Wagoner,Commissioner of Labor,Brandt Dismukes,IND,730107,1,9,58,68,
Wagoner,Insurance Commissioner,Glen Mulready,REP,730107,40,225,760,1025,
Wagoner,Insurance Commissioner,Kimberly Fobbs,DEM,730107,25,104,336,465,
Wagoner,Corporation Commissioner,Bob Anthony,REP,730107,39,225,736,1000,
Wagoner,Corporation Commissioner,Ashley Nicole Mccray,DEM,730107,24,96,307,427,
Wagoner,Corporation Commissioner,Jackie Short,IND,730107,2,9,57,68,
Wagoner,U.S. House,Kevin Hern,REP,730107,38,232,774,1044,1
Wagoner,U.S. House,Tim Gilpin,DEM,730107,27,102,327,456,1
Wagoner,State Senate,John Haste,REP,730107,40,237,766,1043,36
Wagoner,State Senate,Bryan O'Brien,DEM,730107,25,96,337,458,36
Wagoner,State House,Dean Davis,REP,730107,36,212,693,941,98
Wagoner,State House,Kilmyn Easley-Graf,DEM,730107,27,119,389,535,98
Wagoner,State House,Sean Parrish,IND,730107,1,4,21,26,98
Wagoner,Governor,Chris Powell,LIB,730108,0,2,26,28,
Wagoner,Governor,Kevin Stitt,REP,730108,32,87,470,589,
Wagoner,Governor,Drew Edmondson,DEM,730108,11,55,210,276,
Wagoner,Lieutenant Governor,Matt Pinnell,REP,730108,33,96,537,666,
Wagoner,Lieutenant Governor,Anastasia Pittman,DEM,730108,10,42,146,198,
Wagoner,Lieutenant Governor,Ivan Holmes,IND,730108,0,2,19,21,
Wagoner,State Auditor,John Yeutter,LIB,730108,6,23,115,144,
Wagoner,State Auditor,Cindy Byrd,REP,730108,35,107,544,686,
Wagoner,Attorney General,Mike Hunter,REP,730108,33,99,544,676,
Wagoner,Attorney General,Mark Myles,DEM,730108,10,44,157,211,
Wagoner,State Treasurer,Randy Mcdaniel,REP,730108,31,108,535,674,
Wagoner,State Treasurer,Charles De Coune,IND,730108,10,22,118,150,
Wagoner,Superintendent of Public Instruction,Joy Hofmeister,REP,730108,35,98,486,619,
Wagoner,Superintendent of Public Instruction,John Cox,DEM,730108,8,36,161,205,
Wagoner,Superintendent of Public Instruction,Larry Huff,IND,730108,0,8,53,61,
Wagoner,Commissioner of Labor,Leslie Osborn,REP,730108,30,91,493,614,
Wagoner,Commissioner of Labor,Fred Dorrell,DEM,730108,13,45,168,226,
Wagoner,Commissioner of Labor,Brandt Dismukes,IND,730108,0,6,33,39,
Wagoner,Insurance Commissioner,Glen Mulready,REP,730108,33,94,526,653,
Wagoner,Insurance Commissioner,Kimberly Fobbs,DEM,730108,10,47,168,225,
Wagoner,Corporation Commissioner,Bob Anthony,REP,730108,30,96,508,634,
Wagoner,Corporation Commissioner,Ashley Nicole Mccray,DEM,730108,12,39,159,210,
Wagoner,Corporation Commissioner,Jackie Short,IND,730108,0,7,24,31,
Wagoner,U.S. House,Kevin Hern,REP,730108,32,96,525,653,1
Wagoner,U.S. House,Tim Gilpin,DEM,730108,10,46,178,234,1
Wagoner,State Senate,John Haste,REP,730108,32,100,525,657,36
Wagoner,State Senate,Bryan O'Brien,DEM,730108,10,43,173,226,36
Wagoner,State House,Kevin Mcdugle,REP,730108,30,84,478,592,12
Wagoner,State House,Cyndi Ralston,DEM,730108,12,59,218,289,12
Wagoner,Governor,Chris Powell,LIB,730109,0,5,18,23,
Wagoner,Governor,Kevin Stitt,REP,730109,37,118,554,709,
Wagoner,Governor,Drew Edmondson,DEM,730109,10,34,195,239,
Wagoner,Lieutenant Governor,Matt Pinnell,REP,730109,36,124,605,765,
Wagoner,Lieutenant Governor,Anastasia Pittman,DEM,730109,9,29,138,176,
Wagoner,Lieutenant Governor,Ivan Holmes,IND,730109,0,4,25,29,
Wagoner,State Auditor,John Yeutter,LIB,730109,6,15,106,127,
Wagoner,State Auditor,Cindy Byrd,REP,730109,38,134,628,800,
Wagoner,Attorney General,Mike Hunter,REP,730109,36,124,624,784,
Wagoner,Attorney General,Mark Myles,DEM,730109,10,32,139,181,
Wagoner,State Treasurer,Randy Mcdaniel,REP,730109,33,127,611,771,
Wagoner,State Treasurer,Charles De Coune,IND,730109,9,22,117,148,
Wagoner,Superintendent of Public Instruction,Joy Hofmeister,REP,730109,31,120,549,700,
Wagoner,Superintendent of Public Instruction,John Cox,DEM,730109,10,27,157,194,
Wagoner,Superintendent of Public Instruction,Larry Huff,IND,730109,3,10,58,71,
Wagoner,Commissioner of Labor,Leslie Osborn,REP,730109,37,120,569,726,
Wagoner,Commissioner of Labor,Fred Dorrell,DEM,730109,8,35,157,200,
Wagoner,Commissioner of Labor,Brandt Dismukes,IND,730109,0,1,28,29,
Wagoner,Insurance Commissioner,Glen Mulready,REP,730109,33,122,602,757,
Wagoner,Insurance Commissioner,Kimberly Fobbs,DEM,730109,12,34,158,204,
Wagoner,Corporation Commissioner,Bob Anthony,REP,730109,36,117,609,762,
Wagoner,Corporation Commissioner,Ashley Nicole Mccray,DEM,730109,10,31,137,178,
Wagoner,Corporation Commissioner,Jackie Short,IND,730109,0,8,16,24,
Wagoner,U.S. House,Kevin Hern,REP,730109,34,124,605,763,1
Wagoner,U.S. House,Tim Gilpin,DEM,730109,11,33,164,208,1
Wagoner,State Senate,Kim David,REP,730109,36,115,594,745,18
Wagoner,State Senate,Charles Arnall,DEM,730109,9,40,165,214,18
Wagoner,State House,Kevin Mcdugle,REP,730109,36,105,551,692,12
Wagoner,State House,Cyndi Ralston,DEM,730109,10,49,207,266,12
Wagoner,Governor,Chris Powell,LIB,730201,1,3,29,33,
Wagoner,Governor,Kevin Stitt,REP,730201,24,44,594,662,
Wagoner,Governor,Drew Edmondson,DEM,730201,10,20,300,330,
Wagoner,Lieutenant Governor,Matt Pinnell,REP,730201,28,50,659,737,
Wagoner,Lieutenant Governor,Anastasia Pittman,DEM,730201,7,17,222,246,
Wagoner,Lieutenant Governor,Ivan Holmes,IND,730201,0,0,35,35,
Wagoner,State Auditor,John Yeutter,LIB,730201,2,11,181,194,
Wagoner,State Auditor,Cindy Byrd,REP,730201,30,51,688,769,
Wagoner,Attorney General,Mike Hunter,REP,730201,26,50,687,763,
Wagoner,Attorney General,Mark Myles,DEM,730201,9,16,222,247,
Wagoner,State Treasurer,Randy Mcdaniel,REP,730201,26,50,675,751,
Wagoner,State Treasurer,Charles De Coune,IND,730201,6,15,188,209,
Wagoner,Superintendent of Public Instruction,Joy Hofmeister,REP,730201,26,45,586,657,
Wagoner,Superintendent of Public Instruction,John Cox,DEM,730201,7,16,247,270,
Wagoner,Superintendent of Public Instruction,Larry Huff,IND,730201,2,3,77,82,
Wagoner,Commissioner of Labor,Leslie Osborn,REP,730201,27,48,637,712,
Wagoner,Commissioner of Labor,Fred Dorrell,DEM,730201,8,17,220,245,
Wagoner,Commissioner of Labor,Brandt Dismukes,IND,730201,0,0,44,44,
Wagoner,Insurance Commissioner,Glen Mulready,REP,730201,26,48,659,733,
Wagoner,Insurance Commissioner,Kimberly Fobbs,DEM,730201,9,18,245,272,
Wagoner,Corporation Commissioner,Bob Anthony,REP,730201,24,47,632,703,
Wagoner,Corporation Commissioner,Ashley Nicole Mccray,DEM,730201,8,16,225,249,
Wagoner,Corporation Commissioner,Jackie Short,IND,730201,3,4,54,61,
Wagoner,U.S. House,Kevin Hern,REP,730201,26,49,677,752,1
Wagoner,U.S. House,Tim Gilpin,DEM,730201,9,18,236,263,1
Wagoner,State Senate,Kim David,REP,730201,29,50,659,738,18
Wagoner,State Senate,Charles Arnall,DEM,730201,6,16,249,271,18
Wagoner,State House,Kevin Mcdugle,REP,730201,20,41,586,647,12
Wagoner,State House,Cyndi Ralston,DEM,730201,13,25,327,365,12
Wagoner,Governor,Chris Powell,LIB,730202,1,0,40,41,
Wagoner,Governor,Kevin Stitt,REP,730202,24,55,727,806,
Wagoner,Governor,Drew Edmondson,DEM,730202,13,10,291,314,
Wagoner,Lieutenant Governor,Matt Pinnell,REP,730202,26,60,812,898,
Wagoner,Lieutenant Governor,Anastasia Pittman,DEM,730202,12,4,213,229,
Wagoner,Lieutenant Governor,Ivan Holmes,IND,730202,0,1,31,32,
Wagoner,State Auditor,John Yeutter,LIB,730202,7,5,157,169,
Wagoner,State Auditor,Cindy Byrd,REP,730202,26,57,855,938,
Wagoner,Attorney General,Mike Hunter,REP,730202,25,59,825,909,
Wagoner,Attorney General,Mark Myles,DEM,730202,13,6,225,244,
Wagoner,State Treasurer,Randy Mcdaniel,REP,730202,28,59,835,922,
Wagoner,State Treasurer,Charles De Coune,IND,730202,6,6,172,184,
Wagoner,Superintendent of Public Instruction,Joy Hofmeister,REP,730202,25,54,726,805,
Wagoner,Superintendent of Public Instruction,John Cox,DEM,730202,10,5,260,275,
Wagoner,Superintendent of Public Instruction,Larry Huff,IND,730202,2,6,68,76,
Wagoner,Commissioner of Labor,Leslie Osborn,REP,730202,24,59,761,844,
Wagoner,Commissioner of Labor,Fred Dorrell,DEM,730202,11,5,244,260,
Wagoner,Commissioner of Labor,Brandt Dismukes,IND,730202,2,1,43,46,
Wagoner,Insurance Commissioner,Glen Mulready,REP,730202,22,58,788,868,
Wagoner,Insurance Commissioner,Kimberly Fobbs,DEM,730202,14,7,258,279,
Wagoner,Corporation Commissioner,Bob Anthony,REP,730202,24,57,760,841,
Wagoner,Corporation Commissioner,Ashley Nicole Mccray,DEM,730202,11,7,219,237,
Wagoner,Corporation Commissioner,Jackie Short,IND,730202,2,1,61,64,
Wagoner,U.S. House,Kevin Hern,REP,730202,24,57,806,887,1
Wagoner,U.S. House,Tim Gilpin,DEM,730202,14,8,244,266,1
Wagoner,State Senate,Kim David,REP,730202,23,57,782,862,18
Wagoner,State Senate,Charles Arnall,DEM,730202,14,6,266,286,18
Wagoner,State House,Kevin Mcdugle,REP,730202,23,51,684,758,12
Wagoner,State House,Cyndi Ralston,DEM,730202,13,12,360,385,12
Wagoner,Governor,Chris Powell,LIB,730203,1,13,51,65,
Wagoner,Governor,Kevin Stitt,REP,730203,10,126,540,676,
Wagoner,Governor,Drew Edmondson,DEM,730203,14,61,372,447,
Wagoner,Lieutenant Governor,Matt Pinnell,REP,730203,11,135,642,788,
Wagoner,Lieutenant Governor,Anastasia Pittman,DEM,730203,13,49,289,351,
Wagoner,Lieutenant Governor,Ivan Holmes,IND,730203,1,15,29,45,
Wagoner,State Auditor,John Yeutter,LIB,730203,5,46,211,262,
Wagoner,State Auditor,Cindy Byrd,REP,730203,17,147,696,860,
Wagoner,Attorney General,Mike Hunter,REP,730203,12,142,664,818,
Wagoner,Attorney General,Mark Myles,DEM,730203,13,57,298,368,
Wagoner,State Treasurer,Randy Mcdaniel,REP,730203,14,148,673,835,
Wagoner,State Treasurer,Charles De Coune,IND,730203,9,45,235,289,
Wagoner,Superintendent of Public Instruction,Joy Hofmeister,REP,730203,11,115,553,679,
Wagoner,Superintendent of Public Instruction,John Cox,DEM,730203,13,70,321,404,
Wagoner,Superintendent of Public Instruction,Larry Huff,IND,730203,1,15,86,102,
Wagoner,Commissioner of Labor,Leslie Osborn,REP,730203,10,132,601,743,
Wagoner,Commissioner of Labor,Fred Dorrell,DEM,730203,13,51,296,360,
Wagoner,Commissioner of Labor,Brandt Dismukes,IND,730203,1,15,58,74,
Wagoner,Insurance Commissioner,Glen Mulready,REP,730203,10,137,622,769,
Wagoner,Insurance Commissioner,Kimberly Fobbs,DEM,730203,15,62,334,411,
Wagoner,Corporation Commissioner,Bob Anthony,REP,730203,10,130,607,747,
Wagoner,Corporation Commissioner,Ashley Nicole Mccray,DEM,730203,14,54,293,361,
Wagoner,Corporation Commissioner,Jackie Short,IND,730203,1,17,57,75,
Wagoner,U.S. House,Kevin Hern,REP,730203,14,136,639,789,1
Wagoner,U.S. House,Tim Gilpin,DEM,730203,11,64,319,394,1
Wagoner,State Senate,Kim David,REP,730203,14,121,546,681,18
Wagoner,State Senate,Charles Arnall,DEM,730203,11,76,414,501,18
Wagoner,State House,Kevin Mcdugle,REP,730203,11,115,491,617,12
Wagoner,State House,Cyndi Ralston,DEM,730203,14,85,466,565,12
Wagoner,Governor,Chris Powell,LIB,730204,3,6,27,36,
Wagoner,Governor,Kevin Stitt,REP,730204,11,39,393,443,
Wagoner,Governor,Drew Edmondson,DEM,730204,8,21,206,235,
Wagoner,Lieutenant Governor,Matt Pinnell,REP,730204,14,44,430,488,
Wagoner,Lieutenant Governor,Anastasia Pittman,DEM,730204,5,19,156,180,
Wagoner,Lieutenant Governor,Ivan Holmes,IND,730204,2,2,35,39,
Wagoner,State Auditor,John Yeutter,LIB,730204,7,14,131,152,
Wagoner,State Auditor,Cindy Byrd,REP,730204,13,45,448,506,
Wagoner,Attorney General,Mike Hunter,REP,730204,14,44,442,500,
Wagoner,Attorney General,Mark Myles,DEM,730204,7,22,175,204,
Wagoner,State Treasurer,Randy Mcdaniel,REP,730204,14,42,447,503,
Wagoner,State Treasurer,Charles De Coune,IND,730204,6,16,133,155,
Wagoner,Superintendent of Public Instruction,Joy Hofmeister,REP,730204,14,36,387,437,
Wagoner,Superintendent of Public Instruction,John Cox,DEM,730204,6,23,174,203,
Wagoner,Superintendent of Public Instruction,Larry Huff,IND,730204,1,6,62,69,
Wagoner,Commissioner of Labor,Leslie Osborn,REP,730204,14,43,404,461,
Wagoner,Commissioner of Labor,Fred Dorrell,DEM,730204,7,20,175,202,
Wagoner,Commissioner of Labor,Brandt Dismukes,IND,730204,0,1,35,36,
Wagoner,Insurance Commissioner,Glen Mulready,REP,730204,14,44,420,478,
Wagoner,Insurance Commissioner,Kimberly Fobbs,DEM,730204,7,22,195,224,
Wagoner,Corporation Commissioner,Bob Anthony,REP,730204,14,42,406,462,
Wagoner,Corporation Commissioner,Ashley Nicole Mccray,DEM,730204,7,20,166,193,
Wagoner,Corporation Commissioner,Jackie Short,IND,730204,0,3,42,45,
Wagoner,U.S. House,Kevin Hern,REP,730204,15,42,435,492,1
Wagoner,U.S. House,Tim Gilpin,DEM,730204,7,23,184,214,1
Wagoner,State Senate,Kim David,REP,730204,14,44,417,475,18
Wagoner,State Senate,Charles Arnall,DEM,730204,8,21,200,229,18
Wagoner,State House,Kevin Mcdugle,REP,730204,13,39,388,440,12
Wagoner,State House,Cyndi Ralston,DEM,730204,9,26,231,266,12
Wagoner,Governor,Chris Powell,LIB,730205,0,0,4,4,
Wagoner,Governor,Kevin Stitt,REP,730205,2,11,77,90,
Wagoner,Governor,Drew Edmondson,DEM,730205,2,8,28,38,
Wagoner,Lieutenant Governor,Matt Pinnell,REP,730205,2,13,80,95,
Wagoner,Lieutenant Governor,Anastasia Pittman,DEM,730205,2,3,26,31,
Wagoner,Lieutenant Governor,Ivan Holmes,IND,730205,0,3,2,5,
Wagoner,State Auditor,John Yeutter,LIB,730205,1,5,15,21,
Wagoner,State Auditor,Cindy Byrd,REP,730205,2,12,86,100,
Wagoner,Attorney General,Mike Hunter,REP,730205,2,13,81,96,
Wagoner,Attorney General,Mark Myles,DEM,730205,2,5,27,34,
Wagoner,State Treasurer,Randy Mcdaniel,REP,730205,2,13,79,94,
Wagoner,State Treasurer,Charles De Coune,IND,730205,1,5,22,28,
Wagoner,Superintendent of Public Instruction,Joy Hofmeister,REP,730205,2,11,74,87,
Wagoner,Superintendent of Public Instruction,John Cox,DEM,730205,2,4,25,31,
Wagoner,Superintendent of Public Instruction,Larry Huff,IND,730205,0,4,8,12,
Wagoner,Commissioner of Labor,Leslie Osborn,REP,730205,2,12,78,92,
Wagoner,Commissioner of Labor,Fred Dorrell,DEM,730205,2,4,24,30,
Wagoner,Commissioner of Labor,Brandt Dismukes,IND,730205,0,2,5,7,
Wagoner,Insurance Commissioner,Glen Mulready,REP,730205,2,13,79,94,
Wagoner,Insurance Commissioner,Kimberly Fobbs,DEM,730205,2,5,29,36,
Wagoner,Corporation Commissioner,Bob Anthony,REP,730205,2,12,75,89,
Wagoner,Corporation Commissioner,Ashley Nicole Mccray,DEM,730205,2,3,28,33,
Wagoner,Corporation Commissioner,Jackie Short,IND,730205,0,4,5,9,
Wagoner,U.S. House,Kevin Hern,REP,730205,1,13,77,91,1
Wagoner,U.S. House,Tim Gilpin,DEM,730205,3,6,31,40,1
Wagoner,State Senate,Kim David,REP,730205,1,13,78,92,18
Wagoner,State Senate,Charles Arnall,DEM,730205,3,6,31,40,18
Wagoner,State House,Kevin Mcdugle,REP,730205,2,13,80,95,12
Wagoner,State House,Cyndi Ralston,DEM,730205,2,6,29,37,12
Wagoner,Governor,Chris Powell,LIB,730206,0,0,3,3,
Wagoner,Governor,Kevin Stitt,REP,730206,0,2,31,33,
Wagoner,Governor,Drew Edmondson,DEM,730206,0,0,9,9,
Wagoner,Lieutenant Governor,Matt Pinnell,REP,730206,0,2,33,35,
Wagoner,Lieutenant Governor,Anastasia Pittman,DEM,730206,0,0,5,5,
Wagoner,Lieutenant Governor,Ivan Holmes,IND,730206,0,0,4,4,
Wagoner,State Auditor,John Yeutter,LIB,730206,0,0,9,9,
Wagoner,State Auditor,Cindy Byrd,REP,730206,0,2,31,33,
Wagoner,Attorney General,Mike Hunter,REP,730206,0,2,34,36,
Wagoner,Attorney General,Mark Myles,DEM,730206,0,0,8,8,
Wagoner,State Treasurer,Randy Mcdaniel,REP,730206,0,2,32,34,
Wagoner,State Treasurer,Charles De Coune,IND,730206,0,0,9,9,
Wagoner,Superintendent of Public Instruction,Joy Hofmeister,REP,730206,0,2,16,18,
Wagoner,Superintendent of Public Instruction,John Cox,DEM,730206,0,0,11,11,
Wagoner,Superintendent of Public Instruction,Larry Huff,IND,730206,0,0,15,15,
Wagoner,Commissioner of Labor,Leslie Osborn,REP,730206,0,2,23,25,
Wagoner,Commissioner of Labor,Fred Dorrell,DEM,730206,0,0,11,11,
Wagoner,Commissioner of Labor,Brandt Dismukes,IND,730206,0,0,7,7,
Wagoner,Insurance Commissioner,Glen Mulready,REP,730206,0,2,34,36,
Wagoner,Insurance Commissioner,Kimberly Fobbs,DEM,730206,0,0,8,8,
Wagoner,Corporation Commissioner,Bob Anthony,REP,730206,0,2,28,30,
Wagoner,Corporation Commissioner,Ashley Nicole Mccray,DEM,730206,0,0,7,7,
Wagoner,Corporation Commissioner,Jackie Short,IND,730206,0,0,8,8,
Wagoner,U.S. House,Kevin Hern,REP,730206,0,1,33,34,1
Wagoner,U.S. House,Tim Gilpin,DEM,730206,0,1,10,11,1
Wagoner,State Senate,Kim David,REP,730206,0,2,31,33,18
Wagoner,State Senate,Charles Arnall,DEM,730206,0,0,11,11,18
Wagoner,State House,Kevin Mcdugle,REP,730206,0,2,34,36,12
Wagoner,State House,Cyndi Ralston,DEM,730206,0,0,7,7,12
Wagoner,Governor,Chris Powell,LIB,730207,0,1,10,11,
Wagoner,Governor,Kevin Stitt,REP,730207,2,15,102,119,
Wagoner,Governor,Drew Edmondson,DEM,730207,2,19,221,242,
Wagoner,Lieutenant Governor,Matt Pinnell,REP,730207,3,18,117,138,
Wagoner,Lieutenant Governor,Anastasia Pittman,DEM,730207,1,15,202,218,
Wagoner,Lieutenant Governor,Ivan Holmes,IND,730207,0,2,11,13,
Wagoner,State Auditor,John Yeutter,LIB,730207,4,5,137,146,
Wagoner,State Auditor,Cindy Byrd,REP,730207,0,25,148,173,
Wagoner,Attorney General,Mike Hunter,REP,730207,3,19,128,150,
Wagoner,Attorney General,Mark Myles,DEM,730207,1,15,200,216,
Wagoner,State Treasurer,Randy Mcdaniel,REP,730207,1,18,145,164,
Wagoner,State Treasurer,Charles De Coune,IND,730207,3,11,138,152,
Wagoner,Superintendent of Public Instruction,Joy Hofmeister,REP,730207,0,16,102,118,
Wagoner,Superintendent of Public Instruction,John Cox,DEM,730207,2,14,208,224,
Wagoner,Superintendent of Public Instruction,Larry Huff,IND,730207,2,4,22,28,
Wagoner,Commissioner of Labor,Leslie Osborn,REP,730207,0,18,115,133,
Wagoner,Commissioner of Labor,Fred Dorrell,DEM,730207,2,15,195,212,
Wagoner,Commissioner of Labor,Brandt Dismukes,IND,730207,2,0,21,23,
Wagoner,Insurance Commissioner,Glen Mulready,REP,730207,3,15,121,139,
Wagoner,Insurance Commissioner,Kimberly Fobbs,DEM,730207,1,18,207,226,
Wagoner,Corporation Commissioner,Bob Anthony,REP,730207,3,15,115,133,
Wagoner,Corporation Commissioner,Ashley Nicole Mccray,DEM,730207,1,17,190,208,
Wagoner,Corporation Commissioner,Jackie Short,IND,730207,0,2,22,24,
Wagoner,U.S. House,Kevin Hern,REP,730207,2,16,133,151,1
Wagoner,U.S. House,Tim Gilpin,DEM,730207,2,17,195,214,1
Wagoner,State Senate,Kim David,REP,730207,3,16,129,148,18
Wagoner,State Senate,Charles Arnall,DEM,730207,1,18,201,220,18
Wagoner,State House,Kevin Mcdugle,REP,730207,2,14,101,117,12
Wagoner,State House,Cyndi Ralston,DEM,730207,2,20,229,251,12
Wagoner,Governor,Chris Powell,LIB,730208,0,2,58,60,
Wagoner,Governor,Kevin Stitt,REP,730208,10,162,624,796,
Wagoner,Governor,Drew Edmondson,DEM,730208,16,131,492,639,
Wagoner,Lieutenant Governor,Matt Pinnell,REP,730208,14,190,736,940,
Wagoner,Lieutenant Governor,Anastasia Pittman,DEM,730208,11,101,377,489,
Wagoner,Lieutenant Governor,Ivan Holmes,IND,730208,1,3,50,54,
Wagoner,State Auditor,John Yeutter,LIB,730208,6,60,290,356,
Wagoner,State Auditor,Cindy Byrd,REP,730208,18,199,804,1021,
Wagoner,Attorney General,Mike Hunter,REP,730208,15,193,763,971,
Wagoner,Attorney General,Mark Myles,DEM,730208,12,100,398,510,
Wagoner,State Treasurer,Randy Mcdaniel,REP,730208,14,206,799,1019,
Wagoner,State Treasurer,Charles De Coune,IND,730208,10,52,294,356,
Wagoner,Superintendent of Public Instruction,Joy Hofmeister,REP,730208,15,148,619,782,
Wagoner,Superintendent of Public Instruction,John Cox,DEM,730208,11,122,435,568,
Wagoner,Superintendent of Public Instruction,Larry Huff,IND,730208,1,20,115,136,
Wagoner,Commissioner of Labor,Leslie Osborn,REP,730208,13,171,696,880,
Wagoner,Commissioner of Labor,Fred Dorrell,DEM,730208,12,113,393,518,
Wagoner,Commissioner of Labor,Brandt Dismukes,IND,730208,2,6,65,73,
Wagoner,Insurance Commissioner,Glen Mulready,REP,730208,13,181,725,919,
Wagoner,Insurance Commissioner,Kimberly Fobbs,DEM,730208,14,111,433,558,
Wagoner,Corporation Commissioner,Bob Anthony,REP,730208,15,179,699,893,
Wagoner,Corporation Commissioner,Ashley Nicole Mccray,DEM,730208,10,103,389,502,
Wagoner,Corporation Commissioner,Jackie Short,IND,730208,1,10,74,85,
Wagoner,U.S. House,Kevin Hern,REP,730208,14,191,734,939,1
Wagoner,U.S. House,Tim Gilpin,DEM,730208,13,103,434,550,1
Wagoner,State Senate,Kim David,REP,730208,13,160,688,861,18
Wagoner,State Senate,Charles Arnall,DEM,730208,14,131,482,627,18
Wagoner,State House,Kevin Mcdugle,REP,730208,12,142,581,735,12
Wagoner,State House,Cyndi Ralston,DEM,730208,15,153,584,752,12
Wagoner,Governor,Chris Powell,LIB,730209,0,0,9,9,
Wagoner,Governor,Kevin Stitt,REP,730209,6,24,198,228,
Wagoner,Governor,Drew Edmondson,DEM,730209,4,24,110,138,
Wagoner,Lieutenant Governor,Matt Pinnell,REP,730209,7,28,227,262,
Wagoner,Lieutenant Governor,Anastasia Pittman,DEM,730209,3,18,82,103,
Wagoner,Lieutenant Governor,Ivan Holmes,IND,730209,0,2,9,11,
Wagoner,State Auditor,John Yeutter,LIB,730209,1,12,62,75,
Wagoner,State Auditor,Cindy Byrd,REP,730209,7,35,226,268,
Wagoner,Attorney General,Mike Hunter,REP,730209,6,29,215,250,
Wagoner,Attorney General,Mark Myles,DEM,730209,4,19,95,118,
Wagoner,State Treasurer,Randy Mcdaniel,REP,730209,7,36,231,274,
Wagoner,State Treasurer,Charles De Coune,IND,730209,1,11,57,69,
Wagoner,Superintendent of Public Instruction,Joy Hofmeister,REP,730209,7,34,202,243,
Wagoner,Superintendent of Public Instruction,John Cox,DEM,730209,3,12,92,107,
Wagoner,Superintendent of Public Instruction,Larry Huff,IND,730209,0,2,18,20,
Wagoner,Commissioner of Labor,Leslie Osborn,REP,730209,7,31,209,247,
Wagoner,Commissioner of Labor,Fred Dorrell,DEM,730209,3,15,88,106,
Wagoner,Commissioner of Labor,Brandt Dismukes,IND,730209,0,2,13,15,
Wagoner,Insurance Commissioner,Glen Mulready,REP,730209,7,31,215,253,
Wagoner,Insurance Commissioner,Kimberly Fobbs,DEM,730209,3,17,96,116,
Wagoner,Corporation Commissioner,Bob Anthony,REP,730209,7,33,213,253,
Wagoner,Corporation Commissioner,Ashley Nicole Mccray,DEM,730209,3,14,83,100,
Wagoner,Corporation Commissioner,Jackie Short,IND,730209,0,1,14,15,
Wagoner,U.S. House,Kevin Hern,REP,730209,7,31,211,249,1
Wagoner,U.S. House,Tim Gilpin,DEM,730209,3,17,99,119,1
Wagoner,State Senate,Kim David,REP,730209,6,29,205,240,18
Wagoner,State Senate,Charles Arnall,DEM,730209,4,19,110,133,18
Wagoner,State House,Kevin Mcdugle,REP,730209,6,23,205,234,12
Wagoner,State House,Cyndi Ralston,DEM,730209,3,25,108,136,12
Wagoner,Governor,Chris Powell,LIB,730210,0,3,48,51,
Wagoner,Governor,Kevin Stitt,REP,730210,14,68,500,582,
Wagoner,Governor,Drew Edmondson,DEM,730210,9,30,329,368,
Wagoner,Lieutenant Governor,Matt Pinnell,REP,730210,15,73,562,650,
Wagoner,Lieutenant Governor,Anastasia Pittman,DEM,730210,8,27,251,286,
Wagoner,Lieutenant Governor,Ivan Holmes,IND,730210,0,1,56,57,
Wagoner,State Auditor,John Yeutter,LIB,730210,3,16,221,240,
Wagoner,State Auditor,Cindy Byrd,REP,730210,19,76,610,705,
Wagoner,Attorney General,Mike Hunter,REP,730210,16,77,610,703,
Wagoner,Attorney General,Mark Myles,DEM,730210,7,24,263,294,
Wagoner,State Treasurer,Randy Mcdaniel,REP,730210,17,75,601,693,
Wagoner,State Treasurer,Charles De Coune,IND,730210,5,18,222,245,
Wagoner,Superintendent of Public Instruction,Joy Hofmeister,REP,730210,16,63,469,548,
Wagoner,Superintendent of Public Instruction,John Cox,DEM,730210,7,30,290,327,
Wagoner,Superintendent of Public Instruction,Larry Huff,IND,730210,0,8,113,121,
Wagoner,Commissioner of Labor,Leslie Osborn,REP,730210,15,70,524,609,
Wagoner,Commissioner of Labor,Fred Dorrell,DEM,730210,8,23,277,308,
Wagoner,Commissioner of Labor,Brandt Dismukes,IND,730210,0,5,60,65,
Wagoner,Insurance Commissioner,Glen Mulready,REP,730210,15,74,550,639,
Wagoner,Insurance Commissioner,Kimberly Fobbs,DEM,730210,8,26,310,344,
Wagoner,Corporation Commissioner,Bob Anthony,REP,730210,14,69,531,614,
Wagoner,Corporation Commissioner,Ashley Nicole Mccray,DEM,730210,9,28,261,298,
Wagoner,Corporation Commissioner,Jackie Short,IND,730210,0,3,73,76,
Wagoner,U.S. House,Kevin Hern,REP,730210,15,71,586,672,1
Wagoner,U.S. House,Tim Gilpin,DEM,730210,8,30,284,322,1
Wagoner,State Senate,Kim David,REP,730210,16,70,551,637,18
Wagoner,State Senate,Charles Arnall,DEM,730210,7,30,318,355,18
Wagoner,State House,Kevin Mcdugle,REP,730210,15,61,495,571,12
Wagoner,State House,Cyndi Ralston,DEM,730210,8,37,372,417,12
Wagoner,Governor,Chris Powell,LIB,730301,0,5,27,32,
Wagoner,Governor,Kevin Stitt,REP,730301,31,163,601,795,
Wagoner,Governor,Drew Edmondson,DEM,730301,15,67,325,407,
Wagoner,Lieutenant Governor,Matt Pinnell,REP,730301,30,173,670,873,
Wagoner,Lieutenant Governor,Anastasia Pittman,DEM,730301,16,57,247,320,
Wagoner,Lieutenant Governor,Ivan Holmes,IND,730301,0,6,27,33,
Wagoner,State Auditor,John Yeutter,LIB,730301,9,27,187,223,
Wagoner,State Auditor,Cindy Byrd,REP,730301,33,189,719,941,
Wagoner,Attorney General,Mike Hunter,REP,730301,33,174,690,897,
Wagoner,Attorney General,Mark Myles,DEM,730301,13,62,254,329,
Wagoner,State Treasurer,Randy Mcdaniel,REP,730301,29,184,690,903,
Wagoner,State Treasurer,Charles De Coune,IND,730301,13,34,210,257,
Wagoner,Superintendent of Public Instruction,Joy Hofmeister,REP,730301,30,174,649,853,
Wagoner,Superintendent of Public Instruction,John Cox,DEM,730301,11,52,223,286,
Wagoner,Superintendent of Public Instruction,Larry Huff,IND,730301,3,8,68,79,
Wagoner,Commissioner of Labor,Leslie Osborn,REP,730301,26,171,645,842,
Wagoner,Commissioner of Labor,Fred Dorrell,DEM,730301,12,57,253,322,
Wagoner,Commissioner of Labor,Brandt Dismukes,IND,730301,3,3,39,45,
Wagoner,Insurance Commissioner,Glen Mulready,REP,730301,32,175,655,862,
Wagoner,Insurance Commissioner,Kimberly Fobbs,DEM,730301,13,56,274,343,
Wagoner,Corporation Commissioner,Bob Anthony,REP,730301,30,172,631,833,
Wagoner,Corporation Commissioner,Ashley Nicole Mccray,DEM,730301,14,55,248,317,
Wagoner,Corporation Commissioner,Jackie Short,IND,730301,2,7,52,61,
Wagoner,U.S. House,Kevin Hern,REP,730301,29,172,670,871,1
Wagoner,U.S. House,Tim Gilpin,DEM,730301,15,64,275,354,1
Wagoner,State Senate,John Haste,REP,730301,30,175,678,883,36
Wagoner,State Senate,Bryan O'Brien,DEM,730301,16,59,265,340,36
Wagoner,State House,Dean Davis,REP,730301,32,164,603,799,98
Wagoner,State House,Kilmyn Easley-Graf,DEM,730301,15,69,328,412,98
Wagoner,State House,Sean Parrish,IND,730301,0,2,14,16,98
Wagoner,Governor,Chris Powell,LIB,730302,0,3,20,23,
Wagoner,Governor,Kevin Stitt,REP,730302,58,368,649,1075,
Wagoner,Governor,Drew Edmondson,DEM,730302,31,165,247,443,
Wagoner,Lieutenant Governor,Matt Pinnell,REP,730302,63,400,732,1195,
Wagoner,Lieutenant Governor,Anastasia Pittman,DEM,730302,23,129,161,313,
Wagoner,Lieutenant Governor,Ivan Holmes,IND,730302,2,4,20,26,
Wagoner,State Auditor,John Yeutter,LIB,730302,12,69,133,214,
Wagoner,State Auditor,Cindy Byrd,REP,730302,71,429,745,1245,
Wagoner,Attorney General,Mike Hunter,REP,730302,63,407,722,1192,
Wagoner,Attorney General,Mark Myles,DEM,730302,23,129,190,342,
Wagoner,State Treasurer,Randy Mcdaniel,REP,730302,64,424,729,1217,
Wagoner,State Treasurer,Charles De Coune,IND,730302,20,78,141,239,
Wagoner,Superintendent of Public Instruction,Joy Hofmeister,REP,730302,58,389,677,1124,
Wagoner,Superintendent of Public Instruction,John Cox,DEM,730302,23,118,175,316,
Wagoner,Superintendent of Public Instruction,Larry Huff,IND,730302,2,22,52,76,
Wagoner,Commissioner of Labor,Leslie Osborn,REP,730302,58,395,682,1135,
Wagoner,Commissioner of Labor,Fred Dorrell,DEM,730302,24,119,179,322,
Wagoner,Commissioner of Labor,Brandt Dismukes,IND,730302,3,10,36,49,
Wagoner,Insurance Commissioner,Glen Mulready,REP,730302,62,392,699,1153,
Wagoner,Insurance Commissioner,Kimberly Fobbs,DEM,730302,24,137,193,354,
Wagoner,Corporation Commissioner,Bob Anthony,REP,730302,63,382,696,1141,
Wagoner,Corporation Commissioner,Ashley Nicole Mccray,DEM,730302,21,133,168,322,
Wagoner,Corporation Commissioner,Jackie Short,IND,730302,2,16,39,57,
Wagoner,U.S. House,Kevin Hern,REP,730302,62,392,723,1177,1
Wagoner,U.S. House,Tim Gilpin,DEM,730302,25,140,184,349,1
Wagoner,State Senate,John Haste,REP,730302,62,397,715,1174,36
Wagoner,State Senate,Bryan O'Brien,DEM,730302,25,136,193,354,36
Wagoner,State House,Dean Davis,REP,730302,60,358,645,1063,98
Wagoner,State House,Kilmyn Easley-Graf,DEM,730302,27,172,242,441,98
Wagoner,State House,Sean Parrish,IND,730302,0,5,22,27,98
Wagoner,Governor,Chris Powell,LIB,730303,0,1,11,12,
Wagoner,Governor,Kevin Stitt,REP,730303,10,85,335,430,
Wagoner,Governor,Drew Edmondson,DEM,730303,13,48,133,194,
Wagoner,Lieutenant Governor,Matt Pinnell,REP,730303,11,96,364,471,
Wagoner,Lieutenant Governor,Anastasia Pittman,DEM,730303,12,37,96,145,
Wagoner,Lieutenant Governor,Ivan Holmes,IND,730303,0,1,19,20,
Wagoner,State Auditor,John Yeutter,LIB,730303,6,19,75,100,
Wagoner,State Auditor,Cindy Byrd,REP,730303,11,105,385,501,
Wagoner,Attorney General,Mike Hunter,REP,730303,9,96,371,476,
Wagoner,Attorney General,Mark Myles,DEM,730303,14,36,108,158,
Wagoner,State Treasurer,Randy Mcdaniel,REP,730303,10,102,380,492,
Wagoner,State Treasurer,Charles De Coune,IND,730303,10,25,79,114,
Wagoner,Superintendent of Public Instruction,Joy Hofmeister,REP,730303,8,96,325,429,
Wagoner,Superintendent of Public Instruction,John Cox,DEM,730303,14,34,111,159,
Wagoner,Superintendent of Public Instruction,Larry Huff,IND,730303,1,4,42,47,
Wagoner,Commissioner of Labor,Leslie Osborn,REP,730303,11,90,355,456,
Wagoner,Commissioner of Labor,Fred Dorrell,DEM,730303,12,38,95,145,
Wagoner,Commissioner of Labor,Brandt Dismukes,IND,730303,0,5,21,26,
Wagoner,Insurance Commissioner,Glen Mulready,REP,730303,9,95,355,459,
Wagoner,Insurance Commissioner,Kimberly Fobbs,DEM,730303,14,39,120,173,
Wagoner,Corporation Commissioner,Bob Anthony,REP,730303,8,92,357,457,
Wagoner,Corporation Commissioner,Ashley Nicole Mccray,DEM,730303,14,38,97,149,
Wagoner,Corporation Commissioner,Jackie Short,IND,730303,1,4,21,26,
Wagoner,U.S. House,Kevin Hern,REP,730303,10,92,370,472,1
Wagoner,U.S. House,Tim Gilpin,DEM,730303,13,43,111,167,1
Wagoner,State Senate,John Haste,REP,730303,10,93,373,476,36
Wagoner,State Senate,Bryan O'Brien,DEM,730303,13,42,107,162,36
Wagoner,State House,Kevin Mcdugle,REP,730303,10,74,318,402,12
Wagoner,State House,Cyndi Ralston,DEM,730303,13,58,157,228,12
Wagoner,Governor,Chris Powell,LIB,730304,3,6,41,50,
Wagoner,Governor,Kevin Stitt,REP,730304,14,47,527,588,
Wagoner,Governor,Drew Edmondson,DEM,730304,14,31,300,345,
Wagoner,Lieutenant Governor,Matt Pinnell,REP,730304,19,55,603,677,
Wagoner,Lieutenant Governor,Anastasia Pittman,DEM,730304,10,26,233,269,
Wagoner,Lieutenant Governor,Ivan Holmes,IND,730304,2,1,26,29,
Wagoner,State Auditor,John Yeutter,LIB,730304,11,20,177,208,
Wagoner,State Auditor,Cindy Byrd,REP,730304,19,59,647,725,
Wagoner,Attorney General,Mike Hunter,REP,730304,18,58,610,686,
Wagoner,Attorney General,Mark Myles,DEM,730304,13,25,246,284,
Wagoner,State Treasurer,Randy Mcdaniel,REP,730304,18,57,638,713,
Wagoner,State Treasurer,Charles De Coune,IND,730304,11,23,179,213,
Wagoner,Superintendent of Public Instruction,Joy Hofmeister,REP,730304,15,50,547,612,
Wagoner,Superintendent of Public Instruction,John Cox,DEM,730304,13,27,242,282,
Wagoner,Superintendent of Public Instruction,Larry Huff,IND,730304,3,6,69,78,
Wagoner,Commissioner of Labor,Leslie Osborn,REP,730304,17,53,564,634,
Wagoner,Commissioner of Labor,Fred Dorrell,DEM,730304,9,27,246,282,
Wagoner,Commissioner of Labor,Brandt Dismukes,IND,730304,3,3,41,47,
Wagoner,Insurance Commissioner,Glen Mulready,REP,730304,18,53,595,666,
Wagoner,Insurance Commissioner,Kimberly Fobbs,DEM,730304,11,29,254,294,
Wagoner,Corporation Commissioner,Bob Anthony,REP,730304,17,50,570,637,
Wagoner,Corporation Commissioner,Ashley Nicole Mccray,DEM,730304,11,28,234,273,
Wagoner,Corporation Commissioner,Jackie Short,IND,730304,1,4,48,53,
Wagoner,U.S. House,Kevin Hern,REP,730304,18,50,603,671,1
Wagoner,U.S. House,Tim Gilpin,DEM,730304,13,31,257,301,1
Wagoner,State Senate,Kim David,REP,730304,19,52,603,674,18
Wagoner,State Senate,Charles Arnall,DEM,730304,11,30,254,295,18
Wagoner,State House,Dean Davis,REP,730304,13,42,532,587,98
Wagoner,State House,Kilmyn Easley-Graf,DEM,730304,17,38,309,364,98
Wagoner,State House,Sean Parrish,IND,730304,0,3,25,28,98
Wagoner,Governor,Chris Powell,LIB,730305,0,0,5,5,
Wagoner,Governor,Kevin Stitt,REP,730305,5,8,59,72,
Wagoner,Governor,Drew Edmondson,DEM,730305,0,1,25,26,
Wagoner,Lieutenant Governor,Matt Pinnell,REP,730305,5,8,68,81,
Wagoner,Lieutenant Governor,Anastasia Pittman,DEM,730305,0,1,18,19,
Wagoner,Lieutenant Governor,Ivan Holmes,IND,730305,0,0,2,2,
Wagoner,State Auditor,John Yeutter,LIB,730305,0,1,19,20,
Wagoner,State Auditor,Cindy Byrd,REP,730305,5,8,67,80,
Wagoner,Attorney General,Mike Hunter,REP,730305,5,8,69,82,
Wagoner,Attorney General,Mark Myles,DEM,730305,0,1,19,20,
Wagoner,State Treasurer,Randy Mcdaniel,REP,730305,5,8,67,80,
Wagoner,State Treasurer,Charles De Coune,IND,730305,0,1,18,19,
Wagoner,Superintendent of Public Instruction,Joy Hofmeister,REP,730305,5,7,58,70,
Wagoner,Superintendent of Public Instruction,John Cox,DEM,730305,0,1,21,22,
Wagoner,Superintendent of Public Instruction,Larry Huff,IND,730305,0,1,9,10,
Wagoner,Commissioner of Labor,Leslie Osborn,REP,730305,5,8,64,77,
Wagoner,Commissioner of Labor,Fred Dorrell,DEM,730305,0,1,17,18,
Wagoner,Commissioner of Labor,Brandt Dismukes,IND,730305,0,0,6,6,
Wagoner,Insurance Commissioner,Glen Mulready,REP,730305,5,7,70,82,
Wagoner,Insurance Commissioner,Kimberly Fobbs,DEM,730305,0,1,18,19,
Wagoner,Corporation Commissioner,Bob Anthony,REP,730305,5,7,65,77,
Wagoner,Corporation Commissioner,Ashley Nicole Mccray,DEM,730305,0,2,15,17,
Wagoner,Corporation Commissioner,Jackie Short,IND,730305,0,0,7,7,
Wagoner,U.S. House,Kevin Hern,REP,730305,5,8,67,80,1
Wagoner,U.S. House,Tim Gilpin,DEM,730305,0,1,22,23,1
Wagoner,State Senate,Kim David,REP,730305,5,8,67,80,18
Wagoner,State Senate,Charles Arnall,DEM,730305,0,1,21,22,18
Wagoner,State House,Kevin Mcdugle,REP,730305,5,8,64,77,12
Wagoner,State House,Cyndi Ralston,DEM,730305,0,1,24,25,12
Wagoner,Governor,Chris Powell,LIB,730306,1,4,44,49,
Wagoner,Governor,Kevin Stitt,REP,730306,46,89,797,932,
Wagoner,Governor,Drew Edmondson,DEM,730306,17,55,319,391,
Wagoner,Lieutenant Governor,Matt Pinnell,REP,730306,47,105,862,1014,
Wagoner,Lieutenant Governor,Anastasia Pittman,DEM,730306,16,38,246,300,
Wagoner,Lieutenant Governor,Ivan Holmes,IND,730306,0,2,45,47,
Wagoner,State Auditor,John Yeutter,LIB,730306,12,26,221,259,
Wagoner,State Auditor,Cindy Byrd,REP,730306,47,101,878,1026,
Wagoner,Attorney General,Mike Hunter,REP,730306,49,104,876,1029,
Wagoner,Attorney General,Mark Myles,DEM,730306,14,41,270,325,
Wagoner,State Treasurer,Randy Mcdaniel,REP,730306,48,100,892,1040,
Wagoner,State Treasurer,Charles De Coune,IND,730306,9,29,204,242,
Wagoner,Superintendent of Public Instruction,Joy Hofmeister,REP,730306,47,101,816,964,
Wagoner,Superintendent of Public Instruction,John Cox,DEM,730306,14,37,243,294,
Wagoner,Superintendent of Public Instruction,Larry Huff,IND,730306,4,10,94,108,
Wagoner,Commissioner of Labor,Leslie Osborn,REP,730306,48,97,821,966,
Wagoner,Commissioner of Labor,Fred Dorrell,DEM,730306,14,43,261,318,
Wagoner,Commissioner of Labor,Brandt Dismukes,IND,730306,1,3,63,67,
Wagoner,Insurance Commissioner,Glen Mulready,REP,730306,48,96,837,981,
Wagoner,Insurance Commissioner,Kimberly Fobbs,DEM,730306,16,44,304,364,
Wagoner,Corporation Commissioner,Bob Anthony,REP,730306,45,93,827,965,
Wagoner,Corporation Commissioner,Ashley Nicole Mccray,DEM,730306,18,42,249,309,
Wagoner,Corporation Commissioner,Jackie Short,IND,730306,1,8,75,84,
Wagoner,U.S. House,Kevin Hern,REP,730306,49,99,856,1004,1
Wagoner,U.S. House,Tim Gilpin,DEM,730306,13,47,296,356,1
Wagoner,State Senate,Kim David,REP,730306,50,98,874,1022,18
Wagoner,State Senate,Charles Arnall,DEM,730306,13,44,273,330,18
Wagoner,State House,Stan May,REP,730306,48,91,845,984,80
Wagoner,State House,Janice Graham,DEM,730306,15,52,302,369,80
Wagoner,Governor,Chris Powell,LIB,730307,1,0,21,22,
Wagoner,Governor,Kevin Stitt,REP,730307,31,64,630,725,
Wagoner,Governor,Drew Edmondson,DEM,730307,8,28,201,237,
Wagoner,Lieutenant Governor,Matt Pinnell,REP,730307,32,67,668,767,
Wagoner,Lieutenant Governor,Anastasia Pittman,DEM,730307,8,26,159,193,
Wagoner,Lieutenant Governor,Ivan Holmes,IND,730307,0,0,20,20,
Wagoner,State Auditor,John Yeutter,LIB,730307,2,14,112,128,
Wagoner,State Auditor,Cindy Byrd,REP,730307,36,77,703,816,
Wagoner,Attorney General,Mike Hunter,REP,730307,30,67,679,776,
Wagoner,Attorney General,Mark Myles,DEM,730307,9,25,167,201,
Wagoner,State Treasurer,Randy Mcdaniel,REP,730307,34,77,681,792,
Wagoner,State Treasurer,Charles De Coune,IND,730307,3,14,132,149,
Wagoner,Superintendent of Public Instruction,Joy Hofmeister,REP,730307,28,65,623,716,
Wagoner,Superintendent of Public Instruction,John Cox,DEM,730307,7,24,158,189,
Wagoner,Superintendent of Public Instruction,Larry Huff,IND,730307,5,3,62,70,
Wagoner,Commissioner of Labor,Leslie Osborn,REP,730307,31,69,652,752,
Wagoner,Commissioner of Labor,Fred Dorrell,DEM,730307,9,21,151,181,
Wagoner,Commissioner of Labor,Brandt Dismukes,IND,730307,0,3,33,36,
Wagoner,Insurance Commissioner,Glen Mulready,REP,730307,30,66,646,742,
Wagoner,Insurance Commissioner,Kimberly Fobbs,DEM,730307,10,27,187,224,
Wagoner,Corporation Commissioner,Bob Anthony,REP,730307,32,64,649,745,
Wagoner,Corporation Commissioner,Ashley Nicole Mccray,DEM,730307,6,23,150,179,
Wagoner,Corporation Commissioner,Jackie Short,IND,730307,2,5,39,46,
Wagoner,U.S. House,Kevin Hern,REP,730307,33,67,677,777,1
Wagoner,U.S. House,Tim Gilpin,DEM,730307,7,26,173,206,1
Wagoner,State Senate,Kim David,REP,730307,32,67,672,771,18
Wagoner,State Senate,Charles Arnall,DEM,730307,8,26,172,206,18
Wagoner,State House,Scott Fetgatter,REP,730307,32,65,639,736,16
Wagoner,State House,Chandler Torbett,DEM,730307,7,25,160,192,16
Wagoner,State House,James Delso,IND,730307,1,3,42,46,16
Wagoner,Governor,Chris Powell,LIB,730308,0,0,35,35,
Wagoner,Governor,Kevin Stitt,REP,730308,23,29,514,566,
Wagoner,Governor,Drew Edmondson,DEM,730308,10,19,229,258,
Wagoner,Lieutenant Governor,Matt Pinnell,REP,730308,26,32,574,632,
Wagoner,Lieutenant Governor,Anastasia Pittman,DEM,730308,7,14,167,188,
Wagoner,Lieutenant Governor,Ivan Holmes,IND,730308,0,2,27,29,
Wagoner,State Auditor,John Yeutter,LIB,730308,4,9,148,161,
Wagoner,State Auditor,Cindy Byrd,REP,730308,28,36,590,654,
Wagoner,Attorney General,Mike Hunter,REP,730308,28,31,590,649,
Wagoner,Attorney General,Mark Myles,DEM,730308,5,17,174,196,
Wagoner,State Treasurer,Randy Mcdaniel,REP,730308,28,31,598,657,
Wagoner,State Treasurer,Charles De Coune,IND,730308,4,13,135,152,
Wagoner,Superintendent of Public Instruction,Joy Hofmeister,REP,730308,26,30,510,566,
Wagoner,Superintendent of Public Instruction,John Cox,DEM,730308,7,14,207,228,
Wagoner,Superintendent of Public Instruction,Larry Huff,IND,730308,0,3,50,53,
Wagoner,Commissioner of Labor,Leslie Osborn,REP,730308,27,31,552,610,
Wagoner,Commissioner of Labor,Fred Dorrell,DEM,730308,6,14,172,192,
Wagoner,Commissioner of Labor,Brandt Dismukes,IND,730308,0,2,37,39,
Wagoner,Insurance Commissioner,Glen Mulready,REP,730308,26,32,548,606,
Wagoner,Insurance Commissioner,Kimberly Fobbs,DEM,730308,7,15,206,228,
Wagoner,Corporation Commissioner,Bob Anthony,REP,730308,25,31,543,599,
Wagoner,Corporation Commissioner,Ashley Nicole Mccray,DEM,730308,8,12,178,198,
Wagoner,Corporation Commissioner,Jackie Short,IND,730308,0,4,42,46,
Wagoner,U.S. House,Kevin Hern,REP,730308,28,31,585,644,1
Wagoner,U.S. House,Tim Gilpin,DEM,730308,5,17,188,210,1
Wagoner,State Senate,Kim David,REP,730308,26,37,578,641,18
Wagoner,State Senate,Charles Arnall,DEM,730308,7,11,189,207,18
Wagoner,State House,Scott Fetgatter,REP,730308,24,33,547,604,16
Wagoner,State House,Chandler Torbett,DEM,730308,7,14,182,203,16
Wagoner,State House,James Delso,IND,730308,2,0,33,35,16
Wagoner,Governor,Chris Powell,LIB,730309,0,0,34,34,
Wagoner,Governor,Kevin Stitt,REP,730309,12,34,530,576,
Wagoner,Governor,Drew Edmondson,DEM,730309,13,11,294,318,
Wagoner,Lieutenant Governor,Matt Pinnell,REP,730309,12,36,613,661,
Wagoner,Lieutenant Governor,Anastasia Pittman,DEM,730309,11,9,212,232,
Wagoner,Lieutenant Governor,Ivan Holmes,IND,730309,3,0,32,35,
Wagoner,State Auditor,John Yeutter,LIB,730309,5,7,181,193,
Wagoner,State Auditor,Cindy Byrd,REP,730309,18,37,643,698,
Wagoner,Attorney General,Mike Hunter,REP,730309,14,34,605,653,
Wagoner,Attorney General,Mark Myles,DEM,730309,11,11,250,272,
Wagoner,State Treasurer,Randy Mcdaniel,REP,730309,12,35,624,671,
Wagoner,State Treasurer,Charles De Coune,IND,730309,11,10,202,223,
Wagoner,Superintendent of Public Instruction,Joy Hofmeister,REP,730309,12,32,530,574,
Wagoner,Superintendent of Public Instruction,John Cox,DEM,730309,10,12,245,267,
Wagoner,Superintendent of Public Instruction,Larry Huff,IND,730309,3,1,83,87,
Wagoner,Commissioner of Labor,Leslie Osborn,REP,730309,13,35,582,630,
Wagoner,Commissioner of Labor,Fred Dorrell,DEM,730309,10,10,228,248,
Wagoner,Commissioner of Labor,Brandt Dismukes,IND,730309,2,0,43,45,
Wagoner,Insurance Commissioner,Glen Mulready,REP,730309,12,36,585,633,
Wagoner,Insurance Commissioner,Kimberly Fobbs,DEM,730309,13,9,262,284,
Wagoner,Corporation Commissioner,Bob Anthony,REP,730309,11,35,573,619,
Wagoner,Corporation Commissioner,Ashley Nicole Mccray,DEM,730309,11,9,218,238,
Wagoner,Corporation Commissioner,Jackie Short,IND,730309,2,1,62,65,
Wagoner,U.S. House,Kevin Hern,REP,730309,12,37,613,662,1
Wagoner,U.S. House,Tim Gilpin,DEM,730309,13,8,239,260,1
Wagoner,State Senate,Kim David,REP,730309,13,35,588,636,18
Wagoner,State Senate,Charles Arnall,DEM,730309,11,10,268,289,18
Wagoner,State House,Kevin Mcdugle,REP,730309,10,30,517,557,12
Wagoner,State House,Cyndi Ralston,DEM,730309,14,15,338,367,12
Wagoner,Governor,Chris Powell,LIB,730310,0,1,14,15,
Wagoner,Governor,Kevin Stitt,REP,730310,8,11,263,282,
Wagoner,Governor,Drew Edmondson,DEM,730310,2,0,97,99,
Wagoner,Lieutenant Governor,Matt Pinnell,REP,730310,8,12,284,304,
Wagoner,Lieutenant Governor,Anastasia Pittman,DEM,730310,2,0,77,79,
Wagoner,Lieutenant Governor,Ivan Holmes,IND,730310,0,0,11,11,
Wagoner,State Auditor,John Yeutter,LIB,730310,2,2,51,55,
Wagoner,State Auditor,Cindy Byrd,REP,730310,7,10,306,323,
Wagoner,Attorney General,Mike Hunter,REP,730310,8,12,283,303,
Wagoner,Attorney General,Mark Myles,DEM,730310,2,0,86,88,
Wagoner,State Treasurer,Randy Mcdaniel,REP,730310,7,11,293,311,
Wagoner,State Treasurer,Charles De Coune,IND,730310,2,1,61,64,
Wagoner,Superintendent of Public Instruction,Joy Hofmeister,REP,730310,7,10,251,268,
Wagoner,Superintendent of Public Instruction,John Cox,DEM,730310,3,1,79,83,
Wagoner,Superintendent of Public Instruction,Larry Huff,IND,730310,0,1,41,42,
Wagoner,Commissioner of Labor,Leslie Osborn,REP,730310,8,10,274,292,
Wagoner,Commissioner of Labor,Fred Dorrell,DEM,730310,2,1,72,75,
Wagoner,Commissioner of Labor,Brandt Dismukes,IND,730310,0,1,20,21,
Wagoner,Insurance Commissioner,Glen Mulready,REP,730310,8,12,278,298,
Wagoner,Insurance Commissioner,Kimberly Fobbs,DEM,730310,2,0,88,90,
Wagoner,Corporation Commissioner,Bob Anthony,REP,730310,7,11,269,287,
Wagoner,Corporation Commissioner,Ashley Nicole Mccray,DEM,730310,2,0,81,83,
Wagoner,Corporation Commissioner,Jackie Short,IND,730310,1,1,16,18,
Wagoner,U.S. House,Kevin Hern,REP,730310,8,11,279,298,1
Wagoner,U.S. House,Tim Gilpin,DEM,730310,2,1,89,92,1
Wagoner,State Senate,Kim David,REP,730310,8,10,281,299,18
Wagoner,State Senate,Charles Arnall,DEM,730310,2,2,86,90,18
Wagoner,State House,Scott Fetgatter,REP,730310,8,10,269,287,16
Wagoner,State House,Chandler Torbett,DEM,730310,2,1,80,83,16
Wagoner,State House,James Delso,IND,730310,0,1,15,16,16
Wagoner,Governor,Chris Powell,LIB,730311,0,0,8,8,
Wagoner,Governor,Kevin Stitt,REP,730311,1,8,152,161,
Wagoner,Governor,Drew Edmondson,DEM,730311,5,0,62,67,
Wagoner,Lieutenant Governor,Matt Pinnell,REP,730311,1,8,158,167,
Wagoner,Lieutenant Governor,Anastasia Pittman,DEM,730311,5,0,52,57,
Wagoner,Lieutenant Governor,Ivan Holmes,IND,730311,0,0,10,10,
Wagoner,State Auditor,John Yeutter,LIB,730311,1,0,36,37,
Wagoner,State Auditor,Cindy Byrd,REP,730311,4,8,173,185,
Wagoner,Attorney General,Mike Hunter,REP,730311,1,8,161,170,
Wagoner,Attorney General,Mark Myles,DEM,730311,5,0,60,65,
Wagoner,State Treasurer,Randy Mcdaniel,REP,730311,2,8,171,181,
Wagoner,State Treasurer,Charles De Coune,IND,730311,3,0,41,44,
Wagoner,Superintendent of Public Instruction,Joy Hofmeister,REP,730311,2,7,131,140,
Wagoner,Superintendent of Public Instruction,John Cox,DEM,730311,4,1,63,68,
Wagoner,Superintendent of Public Instruction,Larry Huff,IND,730311,0,0,25,25,
Wagoner,Commissioner of Labor,Leslie Osborn,REP,730311,1,8,149,158,
Wagoner,Commissioner of Labor,Fred Dorrell,DEM,730311,3,0,57,60,
Wagoner,Commissioner of Labor,Brandt Dismukes,IND,730311,1,0,13,14,
Wagoner,Insurance Commissioner,Glen Mulready,REP,730311,1,8,155,164,
Wagoner,Insurance Commissioner,Kimberly Fobbs,DEM,730311,4,0,66,70,
Wagoner,Corporation Commissioner,Bob Anthony,REP,730311,1,8,160,169,
Wagoner,Corporation Commissioner,Ashley Nicole Mccray,DEM,730311,4,0,44,48,
Wagoner,Corporation Commissioner,Jackie Short,IND,730311,0,0,15,15,
Wagoner,U.S. House,Kevin Hern,REP,730311,1,8,164,173,1
Wagoner,U.S. House,Tim Gilpin,DEM,730311,5,0,57,62,1
Wagoner,State Senate,Kim David,REP,730311,1,8,155,164,18
Wagoner,State Senate,Charles Arnall,DEM,730311,5,0,65,70,18
Wagoner,State House,Scott Fetgatter,REP,730311,1,8,152,161,16
Wagoner,State House,Chandler Torbett,DEM,730311,5,0,59,64,16
Wagoner,State House,James Delso,IND,730311,0,0,9,9,16
Wagoner,Governor,Chris Powell,LIB,730312,0,1,14,15,
Wagoner,Governor,Kevin Stitt,REP,730312,12,51,444,507,
Wagoner,Governor,Drew Edmondson,DEM,730312,15,15,205,235,
Wagoner,Lieutenant Governor,Matt Pinnell,REP,730312,12,55,469,536,
Wagoner,Lieutenant Governor,Anastasia Pittman,DEM,730312,15,12,160,187,
Wagoner,Lieutenant Governor,Ivan Holmes,IND,730312,0,0,27,27,
Wagoner,State Auditor,John Yeutter,LIB,730312,7,8,121,136,
Wagoner,State Auditor,Cindy Byrd,REP,730312,16,55,508,579,
Wagoner,Attorney General,Mike Hunter,REP,730312,13,48,469,530,
Wagoner,Attorney General,Mark Myles,DEM,730312,13,18,185,216,
Wagoner,State Treasurer,Randy Mcdaniel,REP,730312,14,53,499,566,
Wagoner,State Treasurer,Charles De Coune,IND,730312,8,10,127,145,
Wagoner,Superintendent of Public Instruction,Joy Hofmeister,REP,730312,14,45,409,468,
Wagoner,Superintendent of Public Instruction,John Cox,DEM,730312,13,16,196,225,
Wagoner,Superintendent of Public Instruction,Larry Huff,IND,730312,0,6,53,59,
Wagoner,Commissioner of Labor,Leslie Osborn,REP,730312,11,52,438,501,
Wagoner,Commissioner of Labor,Fred Dorrell,DEM,730312,12,10,185,207,
Wagoner,Commissioner of Labor,Brandt Dismukes,IND,730312,2,4,29,35,
Wagoner,Insurance Commissioner,Glen Mulready,REP,730312,12,53,459,524,
Wagoner,Insurance Commissioner,Kimberly Fobbs,DEM,730312,13,13,193,219,
Wagoner,Corporation Commissioner,Bob Anthony,REP,730312,11,47,454,512,
Wagoner,Corporation Commissioner,Ashley Nicole Mccray,DEM,730312,14,12,169,195,
Wagoner,Corporation Commissioner,Jackie Short,IND,730312,1,7,29,37,
Wagoner,U.S. House,Kevin Hern,REP,730312,14,53,478,545,1
Wagoner,U.S. House,Tim Gilpin,DEM,730312,13,14,176,203,1
Wagoner,State Senate,Kim David,REP,730312,13,47,463,523,18
Wagoner,State Senate,Charles Arnall,DEM,730312,14,19,189,222,18
Wagoner,State House,Kevin Mcdugle,REP,730312,8,45,396,449,12
Wagoner,State House,Cyndi Ralston,DEM,730312,17,22,255,294,12
Wagoner,Governor,Chris Powell,LIB,730313,0,0,11,11,
Wagoner,Governor,Kevin Stitt,REP,730313,11,16,146,173,
Wagoner,Governor,Drew Edmondson,DEM,730313,1,7,128,136,
Wagoner,Lieutenant Governor,Matt Pinnell,REP,730313,10,15,152,177,
Wagoner,Lieutenant Governor,Anastasia Pittman,DEM,730313,1,8,113,122,
Wagoner,Lieutenant Governor,Ivan Holmes,IND,730313,0,0,14,14,
Wagoner,State Auditor,John Yeutter,LIB,730313,1,4,77,82,
Wagoner,State Auditor,Cindy Byrd,REP,730313,9,17,176,202,
Wagoner,Attorney General,Mike Hunter,REP,730313,10,16,160,186,
Wagoner,Attorney General,Mark Myles,DEM,730313,1,7,117,125,
Wagoner,State Treasurer,Randy Mcdaniel,REP,730313,10,16,169,195,
Wagoner,State Treasurer,Charles De Coune,IND,730313,0,5,80,85,
Wagoner,Superintendent of Public Instruction,Joy Hofmeister,REP,730313,11,16,144,171,
Wagoner,Superintendent of Public Instruction,John Cox,DEM,730313,1,6,116,123,
Wagoner,Superintendent of Public Instruction,Larry Huff,IND,730313,0,1,19,20,
Wagoner,Commissioner of Labor,Leslie Osborn,REP,730313,10,16,137,163,
Wagoner,Commissioner of Labor,Fred Dorrell,DEM,730313,1,7,119,127,
Wagoner,Commissioner of Labor,Brandt Dismukes,IND,730313,0,0,14,14,
Wagoner,Insurance Commissioner,Glen Mulready,REP,730313,10,16,151,177,
Wagoner,Insurance Commissioner,Kimberly Fobbs,DEM,730313,1,7,122,130,
Wagoner,Corporation Commissioner,Bob Anthony,REP,730313,10,14,149,173,
Wagoner,Corporation Commissioner,Ashley Nicole Mccray,DEM,730313,2,9,115,126,
Wagoner,Corporation Commissioner,Jackie Short,IND,730313,0,0,13,13,
Wagoner,U.S. House,Kevin Hern,REP,730313,10,16,161,187,1
Wagoner,U.S. House,Tim Gilpin,DEM,730313,1,7,121,129,1
Wagoner,State Senate,Kim David,REP,730313,9,15,166,190,18
Wagoner,State Senate,Charles Arnall,DEM,730313,2,8,113,123,18
Wagoner,State House,Kevin Mcdugle,REP,730313,9,13,135,157,12
Wagoner,State House,Cyndi Ralston,DEM,730313,2,10,149,161,12
Washington,Governor,Chris Powell,LIB,740011,1,2,15,18,
Washington,Governor,Kevin Stitt,REP,740011,17,64,415,496,
Washington,Governor,Drew Edmondson,DEM,740011,12,46,251,309,
Washington,Lieutenant Governor,Matt Pinnell,REP,740011,18,76,482,576,
Washington,Lieutenant Governor,Anastasia Pittman,DEM,740011,10,32,177,219,
Washington,Lieutenant Governor,Ivan Holmes,IND,740011,2,4,17,23,
Washington,State Auditor,John Yeutter,LIB,740011,4,21,130,155,
Washington,State Auditor,Cindy Byrd,REP,740011,22,84,510,616,
Washington,Attorney General,Mike Hunter,REP,740011,19,75,479,573,
Washington,Attorney General,Mark Myles,DEM,740011,11,35,193,239,
Washington,State Treasurer,Randy Mcdaniel,REP,740011,22,78,497,597,
Washington,State Treasurer,Charles De Coune,IND,740011,3,26,146,175,
Washington,Superintendent of Public Instruction,Joy Hofmeister,REP,740011,21,76,464,561,
Washington,Superintendent of Public Instruction,John Cox,DEM,740011,8,28,171,207,
Washington,Superintendent of Public Instruction,Larry Huff,IND,740011,1,6,40,47,
Washington,Commissioner of Labor,Leslie Osborn,REP,740011,22,74,466,562,
Washington,Commissioner of Labor,Fred Dorrell,DEM,740011,7,31,176,214,
Washington,Commissioner of Labor,Brandt Dismukes,IND,740011,0,5,26,31,
Washington,Insurance Commissioner,Glen Mulready,REP,740011,21,73,457,551,
Washington,Insurance Commissioner,Kimberly Fobbs,DEM,740011,8,38,206,252,
Washington,Corporation Commissioner,Bob Anthony,REP,740011,20,75,459,554,
Washington,Corporation Commissioner,Ashley Nicole Mccray,DEM,740011,10,30,178,218,
Washington,Corporation Commissioner,Jackie Short,IND,740011,0,4,32,36,
Washington,U.S. House,Kevin Hern,REP,740011,19,72,462,553,1
Washington,U.S. House,Tim Gilpin,DEM,740011,12,39,216,267,1
Washington,Governor,Chris Powell,LIB,740012,1,0,8,9,
Washington,Governor,Kevin Stitt,REP,740012,3,23,107,133,
Washington,Governor,Drew Edmondson,DEM,740012,6,12,66,84,
Washington,Lieutenant Governor,Matt Pinnell,REP,740012,4,26,128,158,
Washington,Lieutenant Governor,Anastasia Pittman,DEM,740012,6,7,47,60,
Washington,Lieutenant Governor,Ivan Holmes,IND,740012,0,1,5,6,
Washington,State Auditor,John Yeutter,LIB,740012,4,5,34,43,
Washington,State Auditor,Cindy Byrd,REP,740012,4,27,129,160,
Washington,Attorney General,Mike Hunter,REP,740012,4,27,125,156,
Washington,Attorney General,Mark Myles,DEM,740012,6,8,55,69,
Washington,State Treasurer,Randy Mcdaniel,REP,740012,4,27,125,156,
Washington,State Treasurer,Charles De Coune,IND,740012,5,6,40,51,
Washington,Superintendent of Public Instruction,Joy Hofmeister,REP,740012,5,28,120,153,
Washington,Superintendent of Public Instruction,John Cox,DEM,740012,5,5,49,59,
Washington,Superintendent of Public Instruction,Larry Huff,IND,740012,0,2,11,13,
Washington,Commissioner of Labor,Leslie Osborn,REP,740012,4,28,118,150,
Washington,Commissioner of Labor,Fred Dorrell,DEM,740012,6,6,55,67,
Washington,Commissioner of Labor,Brandt Dismukes,IND,740012,0,1,5,6,
Washington,Insurance Commissioner,Glen Mulready,REP,740012,4,26,128,158,
Washington,Insurance Commissioner,Kimberly Fobbs,DEM,740012,6,9,51,66,
Washington,Corporation Commissioner,Bob Anthony,REP,740012,5,27,117,149,
Washington,Corporation Commissioner,Ashley Nicole Mccray,DEM,740012,5,6,53,64,
Washington,Corporation Commissioner,Jackie Short,IND,740012,0,2,9,11,
Washington,U.S. House,Kevin Hern,REP,740012,4,25,123,152,1
Washington,U.S. House,Tim Gilpin,DEM,740012,6,10,56,72,1
Washington,Governor,Chris Powell,LIB,740013,1,0,28,29,
Washington,Governor,Kevin Stitt,REP,740013,9,30,440,479,
Washington,Governor,Drew Edmondson,DEM,740013,4,23,212,239,
Washington,Lieutenant Governor,Matt Pinnell,REP,740013,9,37,490,536,
Washington,Lieutenant Governor,Anastasia Pittman,DEM,740013,5,15,166,186,
Washington,Lieutenant Governor,Ivan Holmes,IND,740013,0,1,20,21,
Washington,State Auditor,John Yeutter,LIB,740013,1,6,120,127,
Washington,State Auditor,Cindy Byrd,REP,740013,13,45,515,573,
Washington,Attorney General,Mike Hunter,REP,740013,12,36,503,551,
Washington,Attorney General,Mark Myles,DEM,740013,2,18,172,192,
Washington,State Treasurer,Randy Mcdaniel,REP,740013,12,38,503,553,
Washington,State Treasurer,Charles De Coune,IND,740013,1,12,126,139,
Washington,Superintendent of Public Instruction,Joy Hofmeister,REP,740013,10,34,465,509,
Washington,Superintendent of Public Instruction,John Cox,DEM,740013,3,17,154,174,
Washington,Superintendent of Public Instruction,Larry Huff,IND,740013,1,3,55,59,
Washington,Commissioner of Labor,Leslie Osborn,REP,740013,10,35,473,518,
Washington,Commissioner of Labor,Fred Dorrell,DEM,740013,3,18,168,189,
Washington,Commissioner of Labor,Brandt Dismukes,IND,740013,1,0,27,28,
Washington,Insurance Commissioner,Glen Mulready,REP,740013,10,34,487,531,
Washington,Insurance Commissioner,Kimberly Fobbs,DEM,740013,4,19,177,200,
Washington,Corporation Commissioner,Bob Anthony,REP,740013,10,36,462,508,
Washington,Corporation Commissioner,Ashley Nicole Mccray,DEM,740013,3,17,168,188,
Washington,Corporation Commissioner,Jackie Short,IND,740013,1,1,38,40,
Washington,U.S. House,Kevin Hern,REP,740013,10,34,485,529,1
Washington,U.S. House,Tim Gilpin,DEM,740013,4,20,190,214,1
Washington,State House,Judd Strom,REP,740013,11,38,495,544,10
Washington,State House,Kevin Stacy,DEM,740013,3,16,180,199,10
Washington,Governor,Chris Powell,LIB,740015,0,6,34,40,
Washington,Governor,Kevin Stitt,REP,740015,8,69,500,577,
Washington,Governor,Drew Edmondson,DEM,740015,13,36,264,313,
Washington,Lieutenant Governor,Matt Pinnell,REP,740015,9,77,580,666,
Washington,Lieutenant Governor,Anastasia Pittman,DEM,740015,10,30,190,230,
Washington,Lieutenant Governor,Ivan Holmes,IND,740015,2,4,19,25,
Washington,State Auditor,John Yeutter,LIB,740015,6,15,151,172,
Washington,State Auditor,Cindy Byrd,REP,740015,13,86,599,698,
Washington,Attorney General,Mike Hunter,REP,740015,10,78,592,680,
Washington,Attorney General,Mark Myles,DEM,740015,11,31,195,237,
Washington,State Treasurer,Randy Mcdaniel,REP,740015,13,84,603,700,
Washington,State Treasurer,Charles De Coune,IND,740015,5,18,145,168,
Washington,Superintendent of Public Instruction,Joy Hofmeister,REP,740015,10,71,544,625,
Washington,Superintendent of Public Instruction,John Cox,DEM,740015,11,29,196,236,
Washington,Superintendent of Public Instruction,Larry Huff,IND,740015,0,8,53,61,
Washington,Commissioner of Labor,Leslie Osborn,REP,740015,12,73,546,631,
Washington,Commissioner of Labor,Fred Dorrell,DEM,740015,8,31,198,237,
Washington,Commissioner of Labor,Brandt Dismukes,IND,740015,1,4,35,40,
Washington,Insurance Commissioner,Glen Mulready,REP,740015,10,73,572,655,
Washington,Insurance Commissioner,Kimberly Fobbs,DEM,740015,10,36,204,250,
Washington,Corporation Commissioner,Bob Anthony,REP,740015,11,76,544,631,
Washington,Corporation Commissioner,Ashley Nicole Mccray,DEM,740015,9,30,191,230,
Washington,Corporation Commissioner,Jackie Short,IND,740015,1,3,50,54,
Washington,U.S. House,Kevin Hern,REP,740015,10,76,574,660,1
Washington,U.S. House,Tim Gilpin,DEM,740015,11,34,217,262,1
Washington,State House,Judd Strom,REP,740015,12,76,575,663,10
Washington,State House,Kevin Stacy,DEM,740015,9,30,219,258,10
Washington,Governor,Chris Powell,LIB,740022,0,5,38,43,
Washington,Governor,Kevin Stitt,REP,740022,50,208,1003,1261,
Washington,Governor,Drew Edmondson,DEM,740022,50,180,479,709,
Washington,Lieutenant Governor,Matt Pinnell,REP,740022,53,263,1181,1497,
Washington,Lieutenant Governor,Anastasia Pittman,DEM,740022,46,121,299,466,
Washington,Lieutenant Governor,Ivan Holmes,IND,740022,1,9,33,43,
Washington,State Auditor,John Yeutter,LIB,740022,29,61,199,289,
Washington,State Auditor,Cindy Byrd,REP,740022,59,293,1218,1570,
Washington,Attorney General,Mike Hunter,REP,740022,52,249,1166,1467,
Washington,Attorney General,Mark Myles,DEM,740022,48,140,330,518,
Washington,State Treasurer,Randy Mcdaniel,REP,740022,56,266,1197,1519,
Washington,State Treasurer,Charles De Coune,IND,740022,33,93,223,349,
Washington,Superintendent of Public Instruction,Joy Hofmeister,REP,740022,52,257,1152,1461,
Washington,Superintendent of Public Instruction,John Cox,DEM,740022,45,112,282,439,
Washington,Superintendent of Public Instruction,Larry Huff,IND,740022,3,19,73,95,
Washington,Commissioner of Labor,Leslie Osborn,REP,740022,51,256,1120,1427,
Washington,Commissioner of Labor,Fred Dorrell,DEM,740022,48,123,312,483,
Washington,Commissioner of Labor,Brandt Dismukes,IND,740022,1,7,47,55,
Washington,Insurance Commissioner,Glen Mulready,REP,740022,51,252,1120,1423,
Washington,Insurance Commissioner,Kimberly Fobbs,DEM,740022,49,131,362,542,
Washington,Corporation Commissioner,Bob Anthony,REP,740022,54,254,1142,1450,
Washington,Corporation Commissioner,Ashley Nicole Mccray,DEM,740022,42,121,291,454,
Washington,Corporation Commissioner,Jackie Short,IND,740022,3,8,55,66,
Washington,U.S. House,Kevin Hern,REP,740022,53,234,1117,1404,1
Washington,U.S. House,Tim Gilpin,DEM,740022,48,156,397,601,1
Washington,Governor,Chris Powell,LIB,740027,0,1,12,13,
Washington,Governor,Kevin Stitt,REP,740027,5,22,223,250,
Washington,Governor,Drew Edmondson,DEM,740027,10,24,115,149,
Washington,Lieutenant Governor,Matt Pinnell,REP,740027,7,23,235,265,
Washington,Lieutenant Governor,Anastasia Pittman,DEM,740027,8,22,97,127,
Washington,Lieutenant Governor,Ivan Holmes,IND,740027,0,2,17,19,
Washington,State Auditor,John Yeutter,LIB,740027,4,13,80,97,
Washington,State Auditor,Cindy Byrd,REP,740027,9,26,242,277,
Washington,Attorney General,Mike Hunter,REP,740027,8,22,247,277,
Washington,Attorney General,Mark Myles,DEM,740027,7,25,101,133,
Washington,State Treasurer,Randy Mcdaniel,REP,740027,8,24,236,268,
Washington,State Treasurer,Charles De Coune,IND,740027,6,16,85,107,
Washington,Superintendent of Public Instruction,Joy Hofmeister,REP,740027,7,24,213,244,
Washington,Superintendent of Public Instruction,John Cox,DEM,740027,7,20,98,125,
Washington,Superintendent of Public Instruction,Larry Huff,IND,740027,1,2,35,38,
Washington,Commissioner of Labor,Leslie Osborn,REP,740027,9,23,225,257,
Washington,Commissioner of Labor,Fred Dorrell,DEM,740027,6,22,99,127,
Washington,Commissioner of Labor,Brandt Dismukes,IND,740027,0,1,22,23,
Washington,Insurance Commissioner,Glen Mulready,REP,740027,9,23,247,279,
Washington,Insurance Commissioner,Kimberly Fobbs,DEM,740027,5,24,98,127,
Washington,Corporation Commissioner,Bob Anthony,REP,740027,8,21,225,254,
Washington,Corporation Commissioner,Ashley Nicole Mccray,DEM,740027,6,24,88,118,
Washington,Corporation Commissioner,Jackie Short,IND,740027,0,1,33,34,
Washington,U.S. House,Kevin Hern,REP,740027,7,23,245,275,1
Washington,U.S. House,Tim Gilpin,DEM,740027,8,24,104,136,1
Washington,State House,Judd Strom,REP,740027,7,21,245,273,10
Washington,State House,Kevin Stacy,DEM,740027,7,26,101,134,10
Washington,Governor,Chris Powell,LIB,740028,2,10,58,70,
Washington,Governor,Kevin Stitt,REP,740028,42,167,1013,1222,
Washington,Governor,Drew Edmondson,DEM,740028,36,123,532,691,
Washington,Lieutenant Governor,Matt Pinnell,REP,740028,46,198,1181,1425,
Washington,Lieutenant Governor,Anastasia Pittman,DEM,740028,30,95,362,487,
Washington,Lieutenant Governor,Ivan Holmes,IND,740028,3,5,54,62,
Washington,State Auditor,John Yeutter,LIB,740028,19,58,273,350,
Washington,State Auditor,Cindy Byrd,REP,740028,55,218,1221,1494,
Washington,Attorney General,Mike Hunter,REP,740028,47,196,1179,1422,
Washington,Attorney General,Mark Myles,DEM,740028,31,101,405,537,
Washington,State Treasurer,Randy Mcdaniel,REP,740028,50,207,1198,1455,
Washington,State Treasurer,Charles De Coune,IND,740028,25,67,301,393,
Washington,Superintendent of Public Instruction,Joy Hofmeister,REP,740028,46,195,1103,1344,
Washington,Superintendent of Public Instruction,John Cox,DEM,740028,26,87,355,468,
Washington,Superintendent of Public Instruction,Larry Huff,IND,740028,6,14,126,146,
Washington,Commissioner of Labor,Leslie Osborn,REP,740028,45,196,1125,1366,
Washington,Commissioner of Labor,Fred Dorrell,DEM,740028,29,94,365,488,
Washington,Commissioner of Labor,Brandt Dismukes,IND,740028,3,4,79,86,
Washington,Insurance Commissioner,Glen Mulready,REP,740028,43,190,1150,1383,
Washington,Insurance Commissioner,Kimberly Fobbs,DEM,740028,32,105,420,557,
Washington,Corporation Commissioner,Bob Anthony,REP,740028,46,200,1112,1358,
Washington,Corporation Commissioner,Ashley Nicole Mccray,DEM,740028,27,86,374,487,
Washington,Corporation Commissioner,Jackie Short,IND,740028,6,10,84,100,
Washington,U.S. House,Kevin Hern,REP,740028,44,177,1144,1365,1
Washington,U.S. House,Tim Gilpin,DEM,740028,36,122,448,606,1
Washington,Governor,Chris Powell,LIB,740031,2,3,48,53,
Washington,Governor,Kevin Stitt,REP,740031,27,100,626,753,
Washington,Governor,Drew Edmondson,DEM,740031,34,104,556,694,
Washington,Lieutenant Governor,Matt Pinnell,REP,740031,28,114,737,879,
Washington,Lieutenant Governor,Anastasia Pittman,DEM,740031,32,87,431,550,
Washington,Lieutenant Governor,Ivan Holmes,IND,740031,3,4,56,63,
Washington,State Auditor,John Yeutter,LIB,740031,18,48,323,389,
Washington,State Auditor,Cindy Byrd,REP,740031,34,133,795,962,
Washington,Attorney General,Mike Hunter,REP,740031,29,105,739,873,
Washington,Attorney General,Mark Myles,DEM,740031,32,100,478,610,
Washington,State Treasurer,Randy Mcdaniel,REP,740031,30,123,758,911,
Washington,State Treasurer,Charles De Coune,IND,740031,28,61,367,456,
Washington,Superintendent of Public Instruction,Joy Hofmeister,REP,740031,30,119,714,863,
Washington,Superintendent of Public Instruction,John Cox,DEM,740031,28,79,399,506,
Washington,Superintendent of Public Instruction,Larry Huff,IND,740031,4,5,101,110,
Washington,Commissioner of Labor,Leslie Osborn,REP,740031,32,113,702,847,
Washington,Commissioner of Labor,Fred Dorrell,DEM,740031,28,87,429,544,
Washington,Commissioner of Labor,Brandt Dismukes,IND,740031,3,4,73,80,
Washington,Insurance Commissioner,Glen Mulready,REP,740031,31,105,711,847,
Washington,Insurance Commissioner,Kimberly Fobbs,DEM,740031,31,99,494,624,
Washington,Corporation Commissioner,Bob Anthony,REP,740031,32,111,684,827,
Washington,Corporation Commissioner,Ashley Nicole Mccray,DEM,740031,27,87,435,549,
Washington,Corporation Commissioner,Jackie Short,IND,740031,4,8,98,110,
Washington,U.S. House,Kevin Hern,REP,740031,28,105,709,842,1
Washington,U.S. House,Tim Gilpin,DEM,740031,34,103,514,651,1
Washington,Governor,Chris Powell,LIB,740033,0,2,24,26,
Washington,Governor,Kevin Stitt,REP,740033,4,9,209,222,
Washington,Governor,Drew Edmondson,DEM,740033,5,16,182,203,
Washington,Lieutenant Governor,Matt Pinnell,REP,740033,4,10,223,237,
Washington,Lieutenant Governor,Anastasia Pittman,DEM,740033,5,16,165,186,
Washington,Lieutenant Governor,Ivan Holmes,IND,740033,0,1,24,25,
Washington,State Auditor,John Yeutter,LIB,740033,1,13,129,143,
Washington,State Auditor,Cindy Byrd,REP,740033,6,10,247,263,
Washington,Attorney General,Mike Hunter,REP,740033,4,9,233,246,
Washington,Attorney General,Mark Myles,DEM,740033,5,18,174,197,
Washington,State Treasurer,Randy Mcdaniel,REP,740033,6,10,241,257,
Washington,State Treasurer,Charles De Coune,IND,740033,1,13,136,150,
Washington,Superintendent of Public Instruction,Joy Hofmeister,REP,740033,4,8,204,216,
Washington,Superintendent of Public Instruction,John Cox,DEM,740033,4,17,157,178,
Washington,Superintendent of Public Instruction,Larry Huff,IND,740033,1,2,50,53,
Washington,Commissioner of Labor,Leslie Osborn,REP,740033,3,9,212,224,
Washington,Commissioner of Labor,Fred Dorrell,DEM,740033,6,17,167,190,
Washington,Commissioner of Labor,Brandt Dismukes,IND,740033,0,1,30,31,
Washington,Insurance Commissioner,Glen Mulready,REP,740033,3,10,221,234,
Washington,Insurance Commissioner,Kimberly Fobbs,DEM,740033,6,17,185,208,
Washington,Corporation Commissioner,Bob Anthony,REP,740033,4,9,203,216,
Washington,Corporation Commissioner,Ashley Nicole Mccray,DEM,740033,4,18,173,195,
Washington,Corporation Commissioner,Jackie Short,IND,740033,1,0,33,34,
Washington,U.S. House,Kevin Hern,REP,740033,5,11,231,247,1
Washington,U.S. House,Tim Gilpin,DEM,740033,4,16,179,199,1
Washington,Governor,Chris Powell,LIB,740046,0,0,13,13,
Washington,Governor,Kevin Stitt,REP,740046,6,6,215,227,
Washington,Governor,Drew Edmondson,DEM,740046,2,4,151,157,
Washington,Lieutenant Governor,Matt Pinnell,REP,740046,8,6,225,239,
Washington,Lieutenant Governor,Anastasia Pittman,DEM,740046,0,4,137,141,
Washington,Lieutenant Governor,Ivan Holmes,IND,740046,0,0,16,16,
Washington,State Auditor,John Yeutter,LIB,740046,1,0,103,104,
Washington,State Auditor,Cindy Byrd,REP,740046,7,10,249,266,
Washington,Attorney General,Mike Hunter,REP,740046,8,7,237,252,
Washington,Attorney General,Mark Myles,DEM,740046,0,3,139,142,
Washington,State Treasurer,Randy Mcdaniel,REP,740046,8,8,251,267,
Washington,State Treasurer,Charles De Coune,IND,740046,0,2,101,103,
Washington,Superintendent of Public Instruction,Joy Hofmeister,REP,740046,7,6,201,214,
Washington,Superintendent of Public Instruction,John Cox,DEM,740046,1,3,126,130,
Washington,Superintendent of Public Instruction,Larry Huff,IND,740046,0,1,46,47,
Washington,Commissioner of Labor,Leslie Osborn,REP,740046,7,8,213,228,
Washington,Commissioner of Labor,Fred Dorrell,DEM,740046,1,2,130,133,
Washington,Commissioner of Labor,Brandt Dismukes,IND,740046,0,0,30,30,
Washington,Insurance Commissioner,Glen Mulready,REP,740046,8,6,226,240,
Washington,Insurance Commissioner,Kimberly Fobbs,DEM,740046,0,4,146,150,
Washington,Corporation Commissioner,Bob Anthony,REP,740046,7,7,210,224,
Washington,Corporation Commissioner,Ashley Nicole Mccray,DEM,740046,0,3,139,142,
Washington,Corporation Commissioner,Jackie Short,IND,740046,1,0,27,28,
Washington,U.S. House,Kevin Hern,REP,740046,8,6,239,253,1
Washington,U.S. House,Tim Gilpin,DEM,740046,0,4,136,140,1
Washington,State House,Judd Strom,REP,740046,7,7,230,244,10
Washington,State House,Kevin Stacy,DEM,740046,1,3,144,148,10
Washington,Governor,Chris Powell,LIB,740048,1,0,28,29,
Washington,Governor,Kevin Stitt,REP,740048,7,30,319,356,
Washington,Governor,Drew Edmondson,DEM,740048,17,21,202,240,
Washington,Lieutenant Governor,Matt Pinnell,REP,740048,10,31,353,394,
Washington,Lieutenant Governor,Anastasia Pittman,DEM,740048,13,17,166,196,
Washington,Lieutenant Governor,Ivan Holmes,IND,740048,2,2,26,30,
Washington,State Auditor,John Yeutter,LIB,740048,9,15,125,149,
Washington,State Auditor,Cindy Byrd,REP,740048,11,33,380,424,
Washington,Attorney General,Mike Hunter,REP,740048,12,34,372,418,
Washington,Attorney General,Mark Myles,DEM,740048,13,17,173,203,
Washington,State Treasurer,Randy Mcdaniel,REP,740048,11,35,372,418,
Washington,State Treasurer,Charles De Coune,IND,740048,9,13,136,158,
Washington,Superintendent of Public Instruction,Joy Hofmeister,REP,740048,12,33,333,378,
Washington,Superintendent of Public Instruction,John Cox,DEM,740048,13,17,169,199,
Washington,Superintendent of Public Instruction,Larry Huff,IND,740048,0,1,46,47,
Washington,Commissioner of Labor,Leslie Osborn,REP,740048,9,35,339,383,
Washington,Commissioner of Labor,Fred Dorrell,DEM,740048,15,13,157,185,
Washington,Commissioner of Labor,Brandt Dismukes,IND,740048,1,3,47,51,
Washington,Insurance Commissioner,Glen Mulready,REP,740048,10,31,357,398,
Washington,Insurance Commissioner,Kimberly Fobbs,DEM,740048,15,19,185,219,
Washington,Corporation Commissioner,Bob Anthony,REP,740048,10,29,348,387,
Washington,Corporation Commissioner,Ashley Nicole Mccray,DEM,740048,14,18,158,190,
Washington,Corporation Commissioner,Jackie Short,IND,740048,1,4,39,44,
Washington,U.S. House,Kevin Hern,REP,740048,11,33,375,419,1
Washington,U.S. House,Tim Gilpin,DEM,740048,14,18,171,203,1
Washington,State House,Judd Strom,REP,740048,13,33,375,421,10
Washington,State House,Kevin Stacy,DEM,740048,12,18,175,205,10
Washington,Governor,Chris Powell,LIB,740051,1,4,23,28,
Washington,Governor,Kevin Stitt,REP,740051,22,73,589,684,
Washington,Governor,Drew Edmondson,DEM,740051,21,49,283,353,
Washington,Lieutenant Governor,Matt Pinnell,REP,740051,23,83,676,782,
Washington,Lieutenant Governor,Anastasia Pittman,DEM,740051,21,37,186,244,
Washington,Lieutenant Governor,Ivan Holmes,IND,740051,0,6,21,27,
Washington,State Auditor,John Yeutter,LIB,740051,8,19,135,162,
Washington,State Auditor,Cindy Byrd,REP,740051,32,100,701,833,
Washington,Attorney General,Mike Hunter,REP,740051,24,86,676,786,
Washington,Attorney General,Mark Myles,DEM,740051,20,39,199,258,
Washington,State Treasurer,Randy Mcdaniel,REP,740051,29,96,690,815,
Washington,State Treasurer,Charles De Coune,IND,740051,12,23,146,181,
Washington,Superintendent of Public Instruction,Joy Hofmeister,REP,740051,32,82,650,764,
Washington,Superintendent of Public Instruction,John Cox,DEM,740051,10,38,183,231,
Washington,Superintendent of Public Instruction,Larry Huff,IND,740051,1,6,48,55,
Washington,Commissioner of Labor,Leslie Osborn,REP,740051,22,90,655,767,
Washington,Commissioner of Labor,Fred Dorrell,DEM,740051,20,32,175,227,
Washington,Commissioner of Labor,Brandt Dismukes,IND,740051,1,2,36,39,
Washington,Insurance Commissioner,Glen Mulready,REP,740051,27,81,657,765,
Washington,Insurance Commissioner,Kimberly Fobbs,DEM,740051,16,44,203,263,
Washington,Corporation Commissioner,Bob Anthony,REP,740051,22,86,645,753,
Washington,Corporation Commissioner,Ashley Nicole Mccray,DEM,740051,21,38,175,234,
Washington,Corporation Commissioner,Jackie Short,IND,740051,0,2,47,49,
Washington,U.S. House,Kevin Hern,REP,740051,25,81,647,753,1
Washington,U.S. House,Tim Gilpin,DEM,740051,19,45,234,298,1
Washington,State House,Judd Strom,REP,740051,23,91,670,784,10
Washington,State House,Kevin Stacy,DEM,740051,21,35,215,271,10
Washington,Governor,Chris Powell,LIB,740054,0,5,36,41,
Washington,Governor,Kevin Stitt,REP,740054,33,70,690,793,
Washington,Governor,Drew Edmondson,DEM,740054,26,47,402,475,
Washington,Lieutenant Governor,Matt Pinnell,REP,740054,39,82,818,939,
Washington,Lieutenant Governor,Anastasia Pittman,DEM,740054,19,37,269,325,
Washington,Lieutenant Governor,Ivan Holmes,IND,740054,1,3,34,38,
Washington,State Auditor,John Yeutter,LIB,740054,6,23,199,228,
Washington,State Auditor,Cindy Byrd,REP,740054,47,91,846,984,
Washington,Attorney General,Mike Hunter,REP,740054,41,86,802,929,
Washington,Attorney General,Mark Myles,DEM,740054,18,36,307,361,
Washington,State Treasurer,Randy Mcdaniel,REP,740054,42,89,830,961,
Washington,State Treasurer,Charles De Coune,IND,740054,12,24,223,259,
Washington,Superintendent of Public Instruction,Joy Hofmeister,REP,740054,41,76,753,870,
Washington,Superintendent of Public Instruction,John Cox,DEM,740054,17,38,281,336,
Washington,Superintendent of Public Instruction,Larry Huff,IND,740054,1,5,82,88,
Washington,Commissioner of Labor,Leslie Osborn,REP,740054,39,84,784,907,
Washington,Commissioner of Labor,Fred Dorrell,DEM,740054,17,33,275,325,
Washington,Commissioner of Labor,Brandt Dismukes,IND,740054,2,2,46,50,
Washington,Insurance Commissioner,Glen Mulready,REP,740054,39,83,798,920,
Washington,Insurance Commissioner,Kimberly Fobbs,DEM,740054,19,38,302,359,
Washington,Corporation Commissioner,Bob Anthony,REP,740054,38,83,779,900,
Washington,Corporation Commissioner,Ashley Nicole Mccray,DEM,740054,19,34,267,320,
Washington,Corporation Commissioner,Jackie Short,IND,740054,2,5,57,64,
Washington,U.S. House,Kevin Hern,REP,740054,35,76,772,883,1
Washington,U.S. House,Tim Gilpin,DEM,740054,23,45,346,414,1
Washington,Governor,Chris Powell,LIB,740062,3,0,33,36,
Washington,Governor,Kevin Stitt,REP,740062,21,27,588,636,
Washington,Governor,Drew Edmondson,DEM,740062,20,22,256,298,
Washington,Lieutenant Governor,Matt Pinnell,REP,740062,21,31,652,704,
Washington,Lieutenant Governor,Anastasia Pittman,DEM,740062,20,18,191,229,
Washington,Lieutenant Governor,Ivan Holmes,IND,740062,3,0,30,33,
Washington,State Auditor,John Yeutter,LIB,740062,9,9,170,188,
Washington,State Auditor,Cindy Byrd,REP,740062,27,36,671,734,
Washington,Attorney General,Mike Hunter,REP,740062,24,30,653,707,
Washington,Attorney General,Mark Myles,DEM,740062,20,19,217,256,
Washington,State Treasurer,Randy Mcdaniel,REP,740062,27,33,670,730,
Washington,State Treasurer,Charles De Coune,IND,740062,9,12,163,184,
Washington,Superintendent of Public Instruction,Joy Hofmeister,REP,740062,24,24,583,631,
Washington,Superintendent of Public Instruction,John Cox,DEM,740062,16,21,207,244,
Washington,Superintendent of Public Instruction,Larry Huff,IND,740062,4,4,85,93,
Washington,Commissioner of Labor,Leslie Osborn,REP,740062,22,30,613,665,
Washington,Commissioner of Labor,Fred Dorrell,DEM,740062,18,17,213,248,
Washington,Commissioner of Labor,Brandt Dismukes,IND,740062,2,2,42,46,
Washington,Insurance Commissioner,Glen Mulready,REP,740062,21,32,640,693,
Washington,Insurance Commissioner,Kimberly Fobbs,DEM,740062,21,17,225,263,
Washington,Corporation Commissioner,Bob Anthony,REP,740062,20,28,611,659,
Washington,Corporation Commissioner,Ashley Nicole Mccray,DEM,740062,20,20,205,245,
Washington,Corporation Commissioner,Jackie Short,IND,740062,2,1,52,55,
Washington,U.S. House,Kevin Hern,REP,740062,22,34,646,702,1
Washington,U.S. House,Tim Gilpin,DEM,740062,21,15,223,259,1
Washington,State House,Judd Strom,REP,740062,22,30,658,710,10
Washington,State House,Kevin Stacy,DEM,740062,21,19,215,255,10
Washington,Governor,Chris Powell,LIB,740071,0,0,15,15,
Washington,Governor,Kevin Stitt,REP,740071,7,21,523,551,
Washington,Governor,Drew Edmondson,DEM,740071,1,2,169,172,
Washington,Lieutenant Governor,Matt Pinnell,REP,740071,6,22,557,585,
Washington,Lieutenant Governor,Anastasia Pittman,DEM,740071,1,1,126,128,
Washington,Lieutenant Governor,Ivan Holmes,IND,740071,1,0,18,19,
Washington,State Auditor,John Yeutter,LIB,740071,0,0,100,100,
Washington,State Auditor,Cindy Byrd,REP,740071,7,22,574,603,
Washington,Attorney General,Mike Hunter,REP,740071,6,20,565,591,
Washington,Attorney General,Mark Myles,DEM,740071,2,2,133,137,
Washington,State Treasurer,Randy Mcdaniel,REP,740071,6,20,579,605,
Washington,State Treasurer,Charles De Coune,IND,740071,1,2,97,100,
Washington,Superintendent of Public Instruction,Joy Hofmeister,REP,740071,5,20,484,509,
Washington,Superintendent of Public Instruction,John Cox,DEM,740071,2,2,155,159,
Washington,Superintendent of Public Instruction,Larry Huff,IND,740071,1,1,63,65,
Washington,Commissioner of Labor,Leslie Osborn,REP,740071,7,21,524,552,
Washington,Commissioner of Labor,Fred Dorrell,DEM,740071,1,2,144,147,
Washington,Commissioner of Labor,Brandt Dismukes,IND,740071,0,0,28,28,
Washington,Insurance Commissioner,Glen Mulready,REP,740071,7,20,536,563,
Washington,Insurance Commissioner,Kimberly Fobbs,DEM,740071,1,3,157,161,
Washington,Corporation Commissioner,Bob Anthony,REP,740071,7,21,539,567,
Washington,Corporation Commissioner,Ashley Nicole Mccray,DEM,740071,1,2,122,125,
Washington,Corporation Commissioner,Jackie Short,IND,740071,0,0,38,38,
Washington,U.S. House,Kevin Hern,REP,740071,7,21,560,588,1
Washington,U.S. House,Tim Gilpin,DEM,740071,1,2,143,146,1
Washington,State House,Judd Strom,REP,740071,7,20,551,578,10
Washington,State House,Kevin Stacy,DEM,740071,1,3,157,161,10
Washington,Governor,Chris Powell,LIB,740073,1,1,3,5,
Washington,Governor,Kevin Stitt,REP,740073,3,5,300,308,
Washington,Governor,Drew Edmondson,DEM,740073,8,8,88,104,
Washington,Lieutenant Governor,Matt Pinnell,REP,740073,5,9,321,335,
Washington,Lieutenant Governor,Anastasia Pittman,DEM,740073,7,4,62,73,
Washington,Lieutenant Governor,Ivan Holmes,IND,740073,0,1,7,8,
Washington,State Auditor,John Yeutter,LIB,740073,3,2,36,41,
Washington,State Auditor,Cindy Byrd,REP,740073,8,11,333,352,
Washington,Attorney General,Mike Hunter,REP,740073,5,8,333,346,
Washington,Attorney General,Mark Myles,DEM,740073,7,6,54,67,
Washington,State Treasurer,Randy Mcdaniel,REP,740073,5,8,318,331,
Washington,State Treasurer,Charles De Coune,IND,740073,6,5,52,63,
Washington,Superintendent of Public Instruction,Joy Hofmeister,REP,740073,3,9,303,315,
Washington,Superintendent of Public Instruction,John Cox,DEM,740073,9,5,56,70,
Washington,Superintendent of Public Instruction,Larry Huff,IND,740073,0,0,30,30,
Washington,Commissioner of Labor,Leslie Osborn,REP,740073,5,8,310,323,
Washington,Commissioner of Labor,Fred Dorrell,DEM,740073,7,5,60,72,
Washington,Commissioner of Labor,Brandt Dismukes,IND,740073,0,1,19,20,
Washington,Insurance Commissioner,Glen Mulready,REP,740073,5,8,321,334,
Washington,Insurance Commissioner,Kimberly Fobbs,DEM,740073,7,6,63,76,
Washington,Corporation Commissioner,Bob Anthony,REP,740073,6,8,305,319,
Washington,Corporation Commissioner,Ashley Nicole Mccray,DEM,740073,6,5,57,68,
Washington,Corporation Commissioner,Jackie Short,IND,740073,0,0,26,26,
Washington,U.S. House,Kevin Hern,REP,740073,5,8,323,336,1
Washington,U.S. House,Tim Gilpin,DEM,740073,7,6,67,80,1
Washington,State House,Judd Strom,REP,740073,6,8,320,334,10
Washington,State House,Kevin Stacy,DEM,740073,6,6,72,84,10
Washington,Governor,Chris Powell,LIB,740074,0,0,11,11,
Washington,Governor,Kevin Stitt,REP,740074,8,17,256,281,
Washington,Governor,Drew Edmondson,DEM,740074,3,6,67,76,
Washington,Lieutenant Governor,Matt Pinnell,REP,740074,10,18,277,305,
Washington,Lieutenant Governor,Anastasia Pittman,DEM,740074,0,5,45,50,
Washington,Lieutenant Governor,Ivan Holmes,IND,740074,1,0,9,10,
Washington,State Auditor,John Yeutter,LIB,740074,2,2,38,42,
Washington,State Auditor,Cindy Byrd,REP,740074,9,18,281,308,
Washington,Attorney General,Mike Hunter,REP,740074,10,19,279,308,
Washington,Attorney General,Mark Myles,DEM,740074,1,4,48,53,
Washington,State Treasurer,Randy Mcdaniel,REP,740074,11,17,273,301,
Washington,State Treasurer,Charles De Coune,IND,740074,0,3,40,43,
Washington,Superintendent of Public Instruction,Joy Hofmeister,REP,740074,10,17,252,279,
Washington,Superintendent of Public Instruction,John Cox,DEM,740074,1,5,50,56,
Washington,Superintendent of Public Instruction,Larry Huff,IND,740074,0,1,28,29,
Washington,Commissioner of Labor,Leslie Osborn,REP,740074,10,15,265,290,
Washington,Commissioner of Labor,Fred Dorrell,DEM,740074,1,6,49,56,
Washington,Commissioner of Labor,Brandt Dismukes,IND,740074,0,2,16,18,
Washington,Insurance Commissioner,Glen Mulready,REP,740074,10,17,271,298,
Washington,Insurance Commissioner,Kimberly Fobbs,DEM,740074,1,6,55,62,
Washington,Corporation Commissioner,Bob Anthony,REP,740074,8,16,258,282,
Washington,Corporation Commissioner,Ashley Nicole Mccray,DEM,740074,3,5,53,61,
Washington,Corporation Commissioner,Jackie Short,IND,740074,0,2,17,19,
Washington,U.S. House,Kevin Hern,REP,740074,10,18,277,305,1
Washington,U.S. House,Tim Gilpin,DEM,740074,1,5,54,60,1
Washington,State House,Judd Strom,REP,740074,9,17,263,289,10
Washington,State House,Kevin Stacy,DEM,740074,2,6,70,78,10
Washington,Governor,Chris Powell,LIB,740075,0,2,20,22,
Washington,Governor,Kevin Stitt,REP,740075,14,40,379,433,
Washington,Governor,Drew Edmondson,DEM,740075,6,13,105,124,
Washington,Lieutenant Governor,Matt Pinnell,REP,740075,15,49,425,489,
Washington,Lieutenant Governor,Anastasia Pittman,DEM,740075,5,6,64,75,
Washington,Lieutenant Governor,Ivan Holmes,IND,740075,0,0,14,14,
Washington,State Auditor,John Yeutter,LIB,740075,1,5,66,72,
Washington,State Auditor,Cindy Byrd,REP,740075,17,49,420,486,
Washington,Attorney General,Mike Hunter,REP,740075,15,49,411,475,
Washington,Attorney General,Mark Myles,DEM,740075,5,6,88,99,
Washington,State Treasurer,Randy Mcdaniel,REP,740075,14,46,415,475,
Washington,State Treasurer,Charles De Coune,IND,740075,4,9,73,86,
Washington,Superintendent of Public Instruction,Joy Hofmeister,REP,740075,17,44,387,448,
Washington,Superintendent of Public Instruction,John Cox,DEM,740075,3,7,79,89,
Washington,Superintendent of Public Instruction,Larry Huff,IND,740075,0,3,33,36,
Washington,Commissioner of Labor,Leslie Osborn,REP,740075,16,47,401,464,
Washington,Commissioner of Labor,Fred Dorrell,DEM,740075,3,4,81,88,
Washington,Commissioner of Labor,Brandt Dismukes,IND,740075,0,4,13,17,
Washington,Insurance Commissioner,Glen Mulready,REP,740075,14,48,400,462,
Washington,Insurance Commissioner,Kimberly Fobbs,DEM,740075,6,7,94,107,
Washington,Corporation Commissioner,Bob Anthony,REP,740075,16,44,403,463,
Washington,Corporation Commissioner,Ashley Nicole Mccray,DEM,740075,4,6,74,84,
Washington,Corporation Commissioner,Jackie Short,IND,740075,0,5,19,24,
Washington,U.S. House,Kevin Hern,REP,740075,14,48,414,476,1
Washington,U.S. House,Tim Gilpin,DEM,740075,6,7,88,101,1
Washington,Governor,Chris Powell,LIB,740076,0,0,13,13,
Washington,Governor,Kevin Stitt,REP,740076,11,19,273,303,
Washington,Governor,Drew Edmondson,DEM,740076,0,7,101,108,
Washington,Lieutenant Governor,Matt Pinnell,REP,740076,11,20,302,333,
Washington,Lieutenant Governor,Anastasia Pittman,DEM,740076,0,6,77,83,
Washington,Lieutenant Governor,Ivan Holmes,IND,740076,0,0,6,6,
Washington,State Auditor,John Yeutter,LIB,740076,0,5,57,62,
Washington,State Auditor,Cindy Byrd,REP,740076,11,19,309,339,
Washington,Attorney General,Mike Hunter,REP,740076,11,20,303,334,
Washington,Attorney General,Mark Myles,DEM,740076,0,6,80,86,
Washington,State Treasurer,Randy Mcdaniel,REP,740076,11,20,305,336,
Washington,State Treasurer,Charles De Coune,IND,740076,0,4,63,67,
Washington,Superintendent of Public Instruction,Joy Hofmeister,REP,740076,9,12,264,285,
Washington,Superintendent of Public Instruction,John Cox,DEM,740076,2,9,87,98,
Washington,Superintendent of Public Instruction,Larry Huff,IND,740076,0,5,32,37,
Washington,Commissioner of Labor,Leslie Osborn,REP,740076,11,18,282,311,
Washington,Commissioner of Labor,Fred Dorrell,DEM,740076,0,8,83,91,
Washington,Commissioner of Labor,Brandt Dismukes,IND,740076,0,0,16,16,
Washington,Insurance Commissioner,Glen Mulready,REP,740076,11,17,295,323,
Washington,Insurance Commissioner,Kimberly Fobbs,DEM,740076,0,8,87,95,
Washington,Corporation Commissioner,Bob Anthony,REP,740076,11,19,278,308,
Washington,Corporation Commissioner,Ashley Nicole Mccray,DEM,740076,0,7,81,88,
Washington,Corporation Commissioner,Jackie Short,IND,740076,0,0,22,22,
Washington,U.S. House,Kevin Hern,REP,740076,11,19,296,326,1
Washington,U.S. House,Tim Gilpin,DEM,740076,0,7,93,100,1
Washington,Governor,Chris Powell,LIB,740077,2,1,15,18,
Washington,Governor,Kevin Stitt,REP,740077,11,15,421,447,
Washington,Governor,Drew Edmondson,DEM,740077,10,10,156,176,
Washington,Lieutenant Governor,Matt Pinnell,REP,740077,16,18,466,500,
Washington,Lieutenant Governor,Anastasia Pittman,DEM,740077,6,7,109,122,
Washington,Lieutenant Governor,Ivan Holmes,IND,740077,1,1,16,18,
Washington,State Auditor,John Yeutter,LIB,740077,7,4,89,100,
Washington,State Auditor,Cindy Byrd,REP,740077,15,21,477,513,
Washington,Attorney General,Mike Hunter,REP,740077,14,18,468,500,
Washington,Attorney General,Mark Myles,DEM,740077,9,8,121,138,
Washington,State Treasurer,Randy Mcdaniel,REP,740077,14,21,474,509,
Washington,State Treasurer,Charles De Coune,IND,740077,9,4,94,107,
Washington,Superintendent of Public Instruction,Joy Hofmeister,REP,740077,11,17,418,446,
Washington,Superintendent of Public Instruction,John Cox,DEM,740077,10,8,139,157,
Washington,Superintendent of Public Instruction,Larry Huff,IND,740077,2,1,33,36,
Washington,Commissioner of Labor,Leslie Osborn,REP,740077,15,18,453,486,
Washington,Commissioner of Labor,Fred Dorrell,DEM,740077,7,7,117,131,
Washington,Commissioner of Labor,Brandt Dismukes,IND,740077,1,1,14,16,
Washington,Insurance Commissioner,Glen Mulready,REP,740077,16,18,460,494,
Washington,Insurance Commissioner,Kimberly Fobbs,DEM,740077,6,8,126,140,
Washington,Corporation Commissioner,Bob Anthony,REP,740077,15,17,453,485,
Washington,Corporation Commissioner,Ashley Nicole Mccray,DEM,740077,6,8,107,121,
Washington,Corporation Commissioner,Jackie Short,IND,740077,2,1,28,31,
Washington,U.S. House,Kevin Hern,REP,740077,14,18,459,491,1
Washington,U.S. House,Tim Gilpin,DEM,740077,8,8,134,150,1
Washington,Governor,Chris Powell,LIB,740078,1,1,25,27,
Washington,Governor,Kevin Stitt,REP,740078,7,7,331,345,
Washington,Governor,Drew Edmondson,DEM,740078,10,3,134,147,
Washington,Lieutenant Governor,Matt Pinnell,REP,740078,8,8,366,382,
Washington,Lieutenant Governor,Anastasia Pittman,DEM,740078,10,3,113,126,
Washington,Lieutenant Governor,Ivan Holmes,IND,740078,0,0,9,9,
Washington,State Auditor,John Yeutter,LIB,740078,9,5,102,116,
Washington,State Auditor,Cindy Byrd,REP,740078,6,6,373,385,
Washington,Attorney General,Mike Hunter,REP,740078,6,8,359,373,
Washington,Attorney General,Mark Myles,DEM,740078,12,3,129,144,
Washington,State Treasurer,Randy Mcdaniel,REP,740078,6,7,370,383,
Washington,State Treasurer,Charles De Coune,IND,740078,9,4,101,114,
Washington,Superintendent of Public Instruction,Joy Hofmeister,REP,740078,6,7,318,331,
Washington,Superintendent of Public Instruction,John Cox,DEM,740078,10,3,128,141,
Washington,Superintendent of Public Instruction,Larry Huff,IND,740078,2,1,39,42,
Washington,Commissioner of Labor,Leslie Osborn,REP,740078,6,7,352,365,
Washington,Commissioner of Labor,Fred Dorrell,DEM,740078,11,3,112,126,
Washington,Commissioner of Labor,Brandt Dismukes,IND,740078,1,1,22,24,
Washington,Insurance Commissioner,Glen Mulready,REP,740078,8,8,355,371,
Washington,Insurance Commissioner,Kimberly Fobbs,DEM,740078,10,3,132,145,
Washington,Corporation Commissioner,Bob Anthony,REP,740078,6,6,332,344,
Washington,Corporation Commissioner,Ashley Nicole Mccray,DEM,740078,11,3,120,134,
Washington,Corporation Commissioner,Jackie Short,IND,740078,1,2,35,38,
Washington,U.S. House,Kevin Hern,REP,740078,8,8,375,391,1
Washington,U.S. House,Tim Gilpin,DEM,740078,10,3,114,127,1
Washington,State House,Judd Strom,REP,740078,7,8,326,341,10
Washington,State House,Kevin Stacy,DEM,740078,11,3,163,177,10
Washington,Governor,Chris Powell,LIB,740079,0,1,20,21,
Washington,Governor,Kevin Stitt,REP,740079,2,10,345,357,
Washington,Governor,Drew Edmondson,DEM,740079,10,5,142,157,
Washington,Lieutenant Governor,Matt Pinnell,REP,740079,5,13,373,391,
Washington,Lieutenant Governor,Anastasia Pittman,DEM,740079,6,3,113,122,
Washington,Lieutenant Governor,Ivan Holmes,IND,740079,1,0,18,19,
Washington,State Auditor,John Yeutter,LIB,740079,6,5,91,102,
Washington,State Auditor,Cindy Byrd,REP,740079,4,11,388,403,
Washington,Attorney General,Mike Hunter,REP,740079,3,12,383,398,
Washington,Attorney General,Mark Myles,DEM,740079,9,4,118,131,
Washington,State Treasurer,Randy Mcdaniel,REP,740079,3,13,381,397,
Washington,State Treasurer,Charles De Coune,IND,740079,7,3,96,106,
Washington,Superintendent of Public Instruction,Joy Hofmeister,REP,740079,3,9,331,343,
Washington,Superintendent of Public Instruction,John Cox,DEM,740079,9,5,131,145,
Washington,Superintendent of Public Instruction,Larry Huff,IND,740079,0,2,43,45,
Washington,Commissioner of Labor,Leslie Osborn,REP,740079,3,11,347,361,
Washington,Commissioner of Labor,Fred Dorrell,DEM,740079,9,4,130,143,
Washington,Commissioner of Labor,Brandt Dismukes,IND,740079,0,1,24,25,
Washington,Insurance Commissioner,Glen Mulready,REP,740079,3,10,368,381,
Washington,Insurance Commissioner,Kimberly Fobbs,DEM,740079,9,6,130,145,
Washington,Corporation Commissioner,Bob Anthony,REP,740079,2,12,348,362,
Washington,Corporation Commissioner,Ashley Nicole Mccray,DEM,740079,9,4,122,135,
Washington,Corporation Commissioner,Jackie Short,IND,740079,1,0,31,32,
Washington,U.S. House,Kevin Hern,REP,740079,3,12,379,394,1
Washington,U.S. House,Tim Gilpin,DEM,740079,9,4,124,137,1
Washington,State House,Judd Strom,REP,740079,4,9,355,368,10
Washington,State House,Kevin Stacy,DEM,740079,8,7,147,162,10
Washington,Governor,Chris Powell,LIB,740711,0,2,6,8,
Washington,Governor,Kevin Stitt,REP,740711,5,14,93,112,
Washington,Governor,Drew Edmondson,DEM,740711,3,14,22,39,
Washington,Lieutenant Governor,Matt Pinnell,REP,740711,5,22,106,133,
Washington,Lieutenant Governor,Anastasia Pittman,DEM,740711,2,7,11,20,
Washington,Lieutenant Governor,Ivan Holmes,IND,740711,1,2,4,7,
Washington,State Auditor,John Yeutter,LIB,740711,1,3,11,15,
Washington,State Auditor,Cindy Byrd,REP,740711,6,27,105,138,
Washington,Attorney General,Mike Hunter,REP,740711,5,23,101,129,
Washington,Attorney General,Mark Myles,DEM,740711,2,7,16,25,
Washington,State Treasurer,Randy Mcdaniel,REP,740711,5,26,101,132,
Washington,State Treasurer,Charles De Coune,IND,740711,2,4,12,18,
Washington,Superintendent of Public Instruction,Joy Hofmeister,REP,740711,6,24,98,128,
Washington,Superintendent of Public Instruction,John Cox,DEM,740711,0,4,17,21,
Washington,Superintendent of Public Instruction,Larry Huff,IND,740711,1,3,5,9,
Washington,Commissioner of Labor,Leslie Osborn,REP,740711,5,25,98,128,
Washington,Commissioner of Labor,Fred Dorrell,DEM,740711,1,4,13,18,
Washington,Commissioner of Labor,Brandt Dismukes,IND,740711,1,1,5,7,
Washington,Insurance Commissioner,Glen Mulready,REP,740711,5,25,100,130,
Washington,Insurance Commissioner,Kimberly Fobbs,DEM,740711,1,5,17,23,
Washington,Corporation Commissioner,Bob Anthony,REP,740711,5,27,95,127,
Washington,Corporation Commissioner,Ashley Nicole Mccray,DEM,740711,1,2,16,19,
Washington,Corporation Commissioner,Jackie Short,IND,740711,1,1,6,8,
Washington,U.S. House,Kevin Hern,REP,740711,6,21,100,127,1
Washington,U.S. House,Tim Gilpin,DEM,740711,1,10,19,30,1
Washington,State House,Judd Strom,REP,740711,5,27,101,133,10
Washington,State House,Kevin Stacy,DEM,740711,1,4,17,22,10
Washita,Governor,Chris Powell,LIB,750003,1,0,4,5,
Washita,Governor,Kevin Stitt,REP,750003,6,3,71,80,
Washita,Governor,Drew Edmondson,DEM,750003,4,0,30,34,
Washita,Lieutenant Governor,Matt Pinnell,REP,750003,6,3,86,95,
Washita,Lieutenant Governor,Anastasia Pittman,DEM,750003,4,0,18,22,
Washita,Lieutenant Governor,Ivan Holmes,IND,750003,1,0,1,2,
Washita,State Auditor,John Yeutter,LIB,750003,2,0,17,19,
Washita,State Auditor,Cindy Byrd,REP,750003,8,3,87,98,
Washita,Attorney General,Mike Hunter,REP,750003,5,3,90,98,
Washita,Attorney General,Mark Myles,DEM,750003,6,0,13,19,
Washita,State Treasurer,Randy Mcdaniel,REP,750003,7,3,92,102,
Washita,State Treasurer,Charles De Coune,IND,750003,4,0,10,14,
Washita,Superintendent of Public Instruction,Joy Hofmeister,REP,750003,5,3,75,83,
Washita,Superintendent of Public Instruction,John Cox,DEM,750003,5,0,22,27,
Washita,Superintendent of Public Instruction,Larry Huff,IND,750003,1,0,7,8,
Washita,Commissioner of Labor,Leslie Osborn,REP,750003,7,3,82,92,
Washita,Commissioner of Labor,Fred Dorrell,DEM,750003,3,0,19,22,
Washita,Commissioner of Labor,Brandt Dismukes,IND,750003,1,0,3,4,
Washita,Insurance Commissioner,Glen Mulready,REP,750003,9,3,80,92,
Washita,Insurance Commissioner,Kimberly Fobbs,DEM,750003,2,0,23,25,
Washita,Corporation Commissioner,Bob Anthony,REP,750003,5,3,80,88,
Washita,Corporation Commissioner,Ashley Nicole Mccray,DEM,750003,5,0,14,19,
Washita,Corporation Commissioner,Jackie Short,IND,750003,1,0,8,9,
Washita,U.S. House,Frank Lucas,REP,750003,5,3,88,96,3
Washita,U.S. House,Frankie Robbins,DEM,750003,6,0,15,21,3
Washita,State Senate,Brent Howard,REP,750003,6,3,77,86,38
Washita,State Senate,Jeff Berrong,DEM,750003,5,0,27,32,38
Washita,State House,Todd Russ,REP,750003,3,3,54,60,55
Washita,State House,Dennis Dugger,DEM,750003,8,0,50,58,55
Washita,Governor,Chris Powell,LIB,750004,0,4,39,43,
Washita,Governor,Kevin Stitt,REP,750004,22,64,368,454,
Washita,Governor,Drew Edmondson,DEM,750004,19,43,178,240,
Washita,Lieutenant Governor,Matt Pinnell,REP,750004,25,70,401,496,
Washita,Lieutenant Governor,Anastasia Pittman,DEM,750004,13,37,146,196,
Washita,Lieutenant Governor,Ivan Holmes,IND,750004,2,3,34,39,
Washita,State Auditor,John Yeutter,LIB,750004,10,14,88,112,
Washita,State Auditor,Cindy Byrd,REP,750004,26,90,468,584,
Washita,Attorney General,Mike Hunter,REP,750004,27,75,424,526,
Washita,Attorney General,Mark Myles,DEM,750004,13,36,156,205,
Washita,State Treasurer,Randy Mcdaniel,REP,750004,27,80,475,582,
Washita,State Treasurer,Charles De Coune,IND,750004,9,24,85,118,
Washita,Superintendent of Public Instruction,Joy Hofmeister,REP,750004,28,70,401,499,
Washita,Superintendent of Public Instruction,John Cox,DEM,750004,9,32,117,158,
Washita,Superintendent of Public Instruction,Larry Huff,IND,750004,3,9,63,75,
Washita,Commissioner of Labor,Leslie Osborn,REP,750004,22,66,400,488,
Washita,Commissioner of Labor,Fred Dorrell,DEM,750004,17,38,139,194,
Washita,Commissioner of Labor,Brandt Dismukes,IND,750004,0,4,35,39,
Washita,Insurance Commissioner,Glen Mulready,REP,750004,25,66,397,488,
Washita,Insurance Commissioner,Kimberly Fobbs,DEM,750004,14,42,175,231,
Washita,Corporation Commissioner,Bob Anthony,REP,750004,27,67,390,484,
Washita,Corporation Commissioner,Ashley Nicole Mccray,DEM,750004,11,38,145,194,
Washita,Corporation Commissioner,Jackie Short,IND,750004,2,6,44,52,
Washita,U.S. House,Frank Lucas,REP,750004,32,83,458,573,3
Washita,U.S. House,Frankie Robbins,DEM,750004,8,28,125,161,3
Washita,State Senate,Brent Howard,REP,750004,17,56,333,406,38
Washita,State Senate,Jeff Berrong,DEM,750004,21,55,249,325,38
Washita,State House,Todd Russ,REP,750004,22,44,303,369,55
Washita,State House,Dennis Dugger,DEM,750004,18,68,281,367,55
Washita,Governor,Chris Powell,LIB,750007,0,0,9,9,
Washita,Governor,Kevin Stitt,REP,750007,9,8,230,247,
Washita,Governor,Drew Edmondson,DEM,750007,0,4,32,36,
Washita,Lieutenant Governor,Matt Pinnell,REP,750007,9,11,233,253,
Washita,Lieutenant Governor,Anastasia Pittman,DEM,750007,0,1,27,28,
Washita,Lieutenant Governor,Ivan Holmes,IND,750007,0,0,8,8,
Washita,State Auditor,John Yeutter,LIB,750007,0,1,17,18,
Washita,State Auditor,Cindy Byrd,REP,750007,9,10,246,265,
Washita,Attorney General,Mike Hunter,REP,750007,8,11,242,261,
Washita,Attorney General,Mark Myles,DEM,750007,1,1,26,28,
Washita,State Treasurer,Randy Mcdaniel,REP,750007,9,10,239,258,
Washita,State Treasurer,Charles De Coune,IND,750007,0,1,20,21,
Washita,Superintendent of Public Instruction,Joy Hofmeister,REP,750007,9,8,212,229,
Washita,Superintendent of Public Instruction,John Cox,DEM,750007,0,3,31,34,
Washita,Superintendent of Public Instruction,Larry Huff,IND,750007,0,1,25,26,
Washita,Commissioner of Labor,Leslie Osborn,REP,750007,9,8,234,251,
Washita,Commissioner of Labor,Fred Dorrell,DEM,750007,0,2,28,30,
Washita,Commissioner of Labor,Brandt Dismukes,IND,750007,0,0,4,4,
Washita,Insurance Commissioner,Glen Mulready,REP,750007,8,10,238,256,
Washita,Insurance Commissioner,Kimberly Fobbs,DEM,750007,1,2,26,29,
Washita,Corporation Commissioner,Bob Anthony,REP,750007,9,10,237,256,
Washita,Corporation Commissioner,Ashley Nicole Mccray,DEM,750007,0,2,21,23,
Washita,Corporation Commissioner,Jackie Short,IND,750007,0,0,8,8,
Washita,U.S. House,Frank Lucas,REP,750007,9,11,248,268,3
Washita,U.S. House,Frankie Robbins,DEM,750007,0,1,23,24,3
Washita,State Senate,Brent Howard,REP,750007,7,8,214,229,38
Washita,State Senate,Jeff Berrong,DEM,750007,2,4,57,63,38
Washita,State House,Todd Russ,REP,750007,9,6,203,218,55
Washita,State House,Dennis Dugger,DEM,750007,0,6,67,73,55
Washita,Governor,Chris Powell,LIB,750009,1,0,12,13,
Washita,Governor,Kevin Stitt,REP,750009,2,15,140,157,
Washita,Governor,Drew Edmondson,DEM,750009,1,1,33,35,
Washita,Lieutenant Governor,Matt Pinnell,REP,750009,3,12,144,159,
Washita,Lieutenant Governor,Anastasia Pittman,DEM,750009,1,2,27,30,
Washita,Lieutenant Governor,Ivan Holmes,IND,750009,0,2,11,13,
Washita,State Auditor,John Yeutter,LIB,750009,1,0,20,21,
Washita,State Auditor,Cindy Byrd,REP,750009,3,16,155,174,
Washita,Attorney General,Mike Hunter,REP,750009,3,13,153,169,
Washita,Attorney General,Mark Myles,DEM,750009,1,3,29,33,
Washita,State Treasurer,Randy Mcdaniel,REP,750009,3,14,157,174,
Washita,State Treasurer,Charles De Coune,IND,750009,1,2,21,24,
Washita,Superintendent of Public Instruction,Joy Hofmeister,REP,750009,3,11,137,151,
Washita,Superintendent of Public Instruction,John Cox,DEM,750009,0,2,25,27,
Washita,Superintendent of Public Instruction,Larry Huff,IND,750009,1,3,22,26,
Washita,Commissioner of Labor,Leslie Osborn,REP,750009,3,12,144,159,
Washita,Commissioner of Labor,Fred Dorrell,DEM,750009,0,3,24,27,
Washita,Commissioner of Labor,Brandt Dismukes,IND,750009,1,1,12,14,
Washita,Insurance Commissioner,Glen Mulready,REP,750009,3,13,151,167,
Washita,Insurance Commissioner,Kimberly Fobbs,DEM,750009,1,3,30,34,
Washita,Corporation Commissioner,Bob Anthony,REP,750009,3,11,141,155,
Washita,Corporation Commissioner,Ashley Nicole Mccray,DEM,750009,0,2,31,33,
Washita,Corporation Commissioner,Jackie Short,IND,750009,1,3,11,15,
Washita,U.S. House,Frank Lucas,REP,750009,3,16,165,184,3
Washita,U.S. House,Frankie Robbins,DEM,750009,1,0,21,22,3
Washita,State Senate,Brent Howard,REP,750009,3,14,134,151,38
Washita,State Senate,Jeff Berrong,DEM,750009,1,2,48,51,38
Washita,State House,Todd Russ,REP,750009,2,12,135,149,55
Washita,State House,Dennis Dugger,DEM,750009,2,4,49,55,55
Washita,Governor,Chris Powell,LIB,750012,1,1,5,7,
Washita,Governor,Kevin Stitt,REP,750012,7,4,138,149,
Washita,Governor,Drew Edmondson,DEM,750012,2,1,54,57,
Washita,Lieutenant Governor,Matt Pinnell,REP,750012,9,4,151,164,
Washita,Lieutenant Governor,Anastasia Pittman,DEM,750012,1,2,43,46,
Washita,Lieutenant Governor,Ivan Holmes,IND,750012,0,0,3,3,
Washita,State Auditor,John Yeutter,LIB,750012,1,1,30,32,
Washita,State Auditor,Cindy Byrd,REP,750012,9,5,164,178,
Washita,Attorney General,Mike Hunter,REP,750012,7,3,153,163,
Washita,Attorney General,Mark Myles,DEM,750012,3,3,44,50,
Washita,State Treasurer,Randy Mcdaniel,REP,750012,8,5,164,177,
Washita,State Treasurer,Charles De Coune,IND,750012,2,1,30,33,
Washita,Superintendent of Public Instruction,Joy Hofmeister,REP,750012,7,3,134,144,
Washita,Superintendent of Public Instruction,John Cox,DEM,750012,2,2,41,45,
Washita,Superintendent of Public Instruction,Larry Huff,IND,750012,1,1,20,22,
Washita,Commissioner of Labor,Leslie Osborn,REP,750012,7,5,150,162,
Washita,Commissioner of Labor,Fred Dorrell,DEM,750012,2,1,40,43,
Washita,Commissioner of Labor,Brandt Dismukes,IND,750012,1,0,6,7,
Washita,Insurance Commissioner,Glen Mulready,REP,750012,8,5,140,153,
Washita,Insurance Commissioner,Kimberly Fobbs,DEM,750012,2,1,54,57,
Washita,Corporation Commissioner,Bob Anthony,REP,750012,8,1,143,152,
Washita,Corporation Commissioner,Ashley Nicole Mccray,DEM,750012,1,3,43,47,
Washita,Corporation Commissioner,Jackie Short,IND,750012,1,2,11,14,
Washita,U.S. House,Frank Lucas,REP,750012,9,5,161,175,3
Washita,U.S. House,Frankie Robbins,DEM,750012,1,1,36,38,3
Washita,State Senate,Brent Howard,REP,750012,8,5,144,157,38
Washita,State Senate,Jeff Berrong,DEM,750012,2,1,53,56,38
Washita,State House,Todd Russ,REP,750012,8,2,112,122,55
Washita,State House,Dennis Dugger,DEM,750012,2,4,85,91,55
Washita,Governor,Chris Powell,LIB,750014,0,0,10,10,
Washita,Governor,Kevin Stitt,REP,750014,12,1,343,356,
Washita,Governor,Drew Edmondson,DEM,750014,8,4,98,110,
Washita,Lieutenant Governor,Matt Pinnell,REP,750014,15,1,361,377,
Washita,Lieutenant Governor,Anastasia Pittman,DEM,750014,4,4,69,77,
Washita,Lieutenant Governor,Ivan Holmes,IND,750014,0,0,15,15,
Washita,State Auditor,John Yeutter,LIB,750014,4,2,49,55,
Washita,State Auditor,Cindy Byrd,REP,750014,15,3,381,399,
Washita,Attorney General,Mike Hunter,REP,750014,15,2,365,382,
Washita,Attorney General,Mark Myles,DEM,750014,4,3,78,85,
Washita,State Treasurer,Randy Mcdaniel,REP,750014,17,2,387,406,
Washita,State Treasurer,Charles De Coune,IND,750014,1,3,45,49,
Washita,Superintendent of Public Instruction,Joy Hofmeister,REP,750014,14,3,327,344,
Washita,Superintendent of Public Instruction,John Cox,DEM,750014,3,2,86,91,
Washita,Superintendent of Public Instruction,Larry Huff,IND,750014,2,0,33,35,
Washita,Commissioner of Labor,Leslie Osborn,REP,750014,12,1,353,366,
Washita,Commissioner of Labor,Fred Dorrell,DEM,750014,4,4,70,78,
Washita,Commissioner of Labor,Brandt Dismukes,IND,750014,2,0,16,18,
Washita,Insurance Commissioner,Glen Mulready,REP,750014,13,1,366,380,
Washita,Insurance Commissioner,Kimberly Fobbs,DEM,750014,5,4,74,83,
Washita,Corporation Commissioner,Bob Anthony,REP,750014,13,2,325,340,
Washita,Corporation Commissioner,Ashley Nicole Mccray,DEM,750014,3,3,89,95,
Washita,Corporation Commissioner,Jackie Short,IND,750014,2,0,29,31,
Washita,U.S. House,Frank Lucas,REP,750014,17,2,382,401,3
Washita,U.S. House,Frankie Robbins,DEM,750014,3,3,62,68,3
Washita,State Senate,Brent Howard,REP,750014,14,1,310,325,38
Washita,State Senate,Jeff Berrong,DEM,750014,5,4,133,142,38
Washita,State House,Todd Russ,REP,750014,10,2,228,240,55
Washita,State House,Dennis Dugger,DEM,750014,10,3,218,231,55
Washita,Governor,Chris Powell,LIB,750016,2,2,22,26,
Washita,Governor,Kevin Stitt,REP,750016,22,17,280,319,
Washita,Governor,Drew Edmondson,DEM,750016,3,1,97,101,
Washita,Lieutenant Governor,Matt Pinnell,REP,750016,23,16,302,341,
Washita,Lieutenant Governor,Anastasia Pittman,DEM,750016,2,2,74,78,
Washita,Lieutenant Governor,Ivan Holmes,IND,750016,2,2,18,22,
Washita,State Auditor,John Yeutter,LIB,750016,2,2,69,73,
Washita,State Auditor,Cindy Byrd,REP,750016,24,17,314,355,
Washita,Attorney General,Mike Hunter,REP,750016,25,19,314,358,
Washita,Attorney General,Mark Myles,DEM,750016,2,1,82,85,
Washita,State Treasurer,Randy Mcdaniel,REP,750016,23,18,323,364,
Washita,State Treasurer,Charles De Coune,IND,750016,3,1,65,69,
Washita,Superintendent of Public Instruction,Joy Hofmeister,REP,750016,22,14,280,316,
Washita,Superintendent of Public Instruction,John Cox,DEM,750016,3,4,73,80,
Washita,Superintendent of Public Instruction,Larry Huff,IND,750016,1,2,44,47,
Washita,Commissioner of Labor,Leslie Osborn,REP,750016,24,18,296,338,
Washita,Commissioner of Labor,Fred Dorrell,DEM,750016,3,1,76,80,
Washita,Commissioner of Labor,Brandt Dismukes,IND,750016,0,1,23,24,
Washita,Insurance Commissioner,Glen Mulready,REP,750016,25,17,300,342,
Washita,Insurance Commissioner,Kimberly Fobbs,DEM,750016,2,3,95,100,
Washita,Corporation Commissioner,Bob Anthony,REP,750016,25,16,286,327,
Washita,Corporation Commissioner,Ashley Nicole Mccray,DEM,750016,2,2,81,85,
Washita,Corporation Commissioner,Jackie Short,IND,750016,0,2,31,33,
Washita,U.S. House,Frank Lucas,REP,750016,23,19,328,370,3
Washita,U.S. House,Frankie Robbins,DEM,750016,4,1,71,76,3
Washita,State Senate,Brent Howard,REP,750016,25,17,280,322,38
Washita,State Senate,Jeff Berrong,DEM,750016,2,3,118,123,38
Washita,State House,Todd Russ,REP,750016,19,13,200,232,55
Washita,State House,Dennis Dugger,DEM,750016,8,7,196,211,55
Washita,Governor,Chris Powell,LIB,750017,0,0,13,13,
Washita,Governor,Kevin Stitt,REP,750017,2,3,147,152,
Washita,Governor,Drew Edmondson,DEM,750017,0,1,44,45,
Washita,Lieutenant Governor,Matt Pinnell,REP,750017,2,2,155,159,
Washita,Lieutenant Governor,Anastasia Pittman,DEM,750017,0,1,38,39,
Washita,Lieutenant Governor,Ivan Holmes,IND,750017,0,1,5,6,
Washita,State Auditor,John Yeutter,LIB,750017,0,0,35,35,
Washita,State Auditor,Cindy Byrd,REP,750017,2,4,164,170,
Washita,Attorney General,Mike Hunter,REP,750017,2,3,161,166,
Washita,Attorney General,Mark Myles,DEM,750017,0,1,41,42,
Washita,State Treasurer,Randy Mcdaniel,REP,750017,2,3,163,168,
Washita,State Treasurer,Charles De Coune,IND,750017,0,1,34,35,
Washita,Superintendent of Public Instruction,Joy Hofmeister,REP,750017,2,2,142,146,
Washita,Superintendent of Public Instruction,John Cox,DEM,750017,0,2,45,47,
Washita,Superintendent of Public Instruction,Larry Huff,IND,750017,0,0,14,14,
Washita,Commissioner of Labor,Leslie Osborn,REP,750017,2,2,149,153,
Washita,Commissioner of Labor,Fred Dorrell,DEM,750017,0,2,41,43,
Washita,Commissioner of Labor,Brandt Dismukes,IND,750017,0,0,12,12,
Washita,Insurance Commissioner,Glen Mulready,REP,750017,2,2,152,156,
Washita,Insurance Commissioner,Kimberly Fobbs,DEM,750017,0,2,46,48,
Washita,Corporation Commissioner,Bob Anthony,REP,750017,3,1,149,153,
Washita,Corporation Commissioner,Ashley Nicole Mccray,DEM,750017,0,3,43,46,
Washita,Corporation Commissioner,Jackie Short,IND,750017,0,0,10,10,
Washita,U.S. House,Frank Lucas,REP,750017,2,4,173,179,3
Washita,U.S. House,Frankie Robbins,DEM,750017,1,0,30,31,3
Washita,State Senate,Brent Howard,REP,750017,3,2,143,148,38
Washita,State Senate,Jeff Berrong,DEM,750017,0,2,58,60,38
Washita,State House,Todd Russ,REP,750017,2,1,110,113,55
Washita,State House,Dennis Dugger,DEM,750017,0,3,92,95,55
Washita,Governor,Chris Powell,LIB,750018,1,1,13,15,
Washita,Governor,Kevin Stitt,REP,750018,5,7,136,148,
Washita,Governor,Drew Edmondson,DEM,750018,4,6,46,56,
Washita,Lieutenant Governor,Matt Pinnell,REP,750018,6,6,152,164,
Washita,Lieutenant Governor,Anastasia Pittman,DEM,750018,3,7,31,41,
Washita,Lieutenant Governor,Ivan Holmes,IND,750018,1,1,11,13,
Washita,State Auditor,John Yeutter,LIB,750018,2,3,16,21,
Washita,State Auditor,Cindy Byrd,REP,750018,7,9,173,189,
Washita,Attorney General,Mike Hunter,REP,750018,7,8,156,171,
Washita,Attorney General,Mark Myles,DEM,750018,3,6,39,48,
Washita,State Treasurer,Randy Mcdaniel,REP,750018,6,9,162,177,
Washita,State Treasurer,Charles De Coune,IND,750018,2,3,26,31,
Washita,Superintendent of Public Instruction,Joy Hofmeister,REP,750018,5,7,148,160,
Washita,Superintendent of Public Instruction,John Cox,DEM,750018,3,4,29,36,
Washita,Superintendent of Public Instruction,Larry Huff,IND,750018,2,3,19,24,
Washita,Commissioner of Labor,Leslie Osborn,REP,750018,5,9,153,167,
Washita,Commissioner of Labor,Fred Dorrell,DEM,750018,3,5,28,36,
Washita,Commissioner of Labor,Brandt Dismukes,IND,750018,2,0,13,15,
Washita,Insurance Commissioner,Glen Mulready,REP,750018,6,6,145,157,
Washita,Insurance Commissioner,Kimberly Fobbs,DEM,750018,4,8,48,60,
Washita,Corporation Commissioner,Bob Anthony,REP,750018,5,8,148,161,
Washita,Corporation Commissioner,Ashley Nicole Mccray,DEM,750018,3,6,29,38,
Washita,Corporation Commissioner,Jackie Short,IND,750018,2,0,16,18,
Washita,U.S. House,Frank Lucas,REP,750018,7,9,162,178,3
Washita,U.S. House,Frankie Robbins,DEM,750018,3,5,33,41,3
Washita,State Senate,Brent Howard,REP,750018,7,5,118,130,38
Washita,State Senate,Jeff Berrong,DEM,750018,3,9,77,89,38
Washita,State House,Todd Russ,REP,750018,5,3,97,105,55
Washita,State House,Dennis Dugger,DEM,750018,5,11,99,115,55
Washita,Governor,Chris Powell,LIB,750019,0,0,18,18,
Washita,Governor,Kevin Stitt,REP,750019,7,12,250,269,
Washita,Governor,Drew Edmondson,DEM,750019,6,5,76,87,
Washita,Lieutenant Governor,Matt Pinnell,REP,750019,8,14,271,293,
Washita,Lieutenant Governor,Anastasia Pittman,DEM,750019,5,4,61,70,
Washita,Lieutenant Governor,Ivan Holmes,IND,750019,0,0,11,11,
Washita,State Auditor,John Yeutter,LIB,750019,4,2,39,45,
Washita,State Auditor,Cindy Byrd,REP,750019,8,16,294,318,
Washita,Attorney General,Mike Hunter,REP,750019,7,14,274,295,
Washita,Attorney General,Mark Myles,DEM,750019,6,3,69,78,
Washita,State Treasurer,Randy Mcdaniel,REP,750019,9,16,296,321,
Washita,State Treasurer,Charles De Coune,IND,750019,4,2,37,43,
Washita,Superintendent of Public Instruction,Joy Hofmeister,REP,750019,6,13,249,268,
Washita,Superintendent of Public Instruction,John Cox,DEM,750019,5,4,61,70,
Washita,Superintendent of Public Instruction,Larry Huff,IND,750019,2,0,34,36,
Washita,Commissioner of Labor,Leslie Osborn,REP,750019,7,14,265,286,
Washita,Commissioner of Labor,Fred Dorrell,DEM,750019,5,3,61,69,
Washita,Commissioner of Labor,Brandt Dismukes,IND,750019,1,1,14,16,
Washita,Insurance Commissioner,Glen Mulready,REP,750019,8,14,257,279,
Washita,Insurance Commissioner,Kimberly Fobbs,DEM,750019,5,4,83,92,
Washita,Corporation Commissioner,Bob Anthony,REP,750019,6,10,254,270,
Washita,Corporation Commissioner,Ashley Nicole Mccray,DEM,750019,7,6,68,81,
Washita,Corporation Commissioner,Jackie Short,IND,750019,0,1,20,21,
Washita,U.S. House,Frank Lucas,REP,750019,9,17,295,321,3
Washita,U.S. House,Frankie Robbins,DEM,750019,4,1,50,55,3
Washita,State Senate,Brent Howard,REP,750019,7,12,236,255,38
Washita,State Senate,Jeff Berrong,DEM,750019,6,6,106,118,38
Washita,State House,Todd Russ,REP,750019,5,9,155,169,55
Washita,State House,Dennis Dugger,DEM,750019,8,9,189,206,55
Washita,Governor,Chris Powell,LIB,750020,1,0,6,7,
Washita,Governor,Kevin Stitt,REP,750020,3,1,115,119,
Washita,Governor,Drew Edmondson,DEM,750020,4,1,51,56,
Washita,Lieutenant Governor,Matt Pinnell,REP,750020,3,1,131,135,
Washita,Lieutenant Governor,Anastasia Pittman,DEM,750020,4,1,38,43,
Washita,Lieutenant Governor,Ivan Holmes,IND,750020,1,0,3,4,
Washita,State Auditor,John Yeutter,LIB,750020,3,0,33,36,
Washita,State Auditor,Cindy Byrd,REP,750020,5,2,134,141,
Washita,Attorney General,Mike Hunter,REP,750020,6,1,133,140,
Washita,Attorney General,Mark Myles,DEM,750020,2,1,40,43,
Washita,State Treasurer,Randy Mcdaniel,REP,750020,5,1,131,137,
Washita,State Treasurer,Charles De Coune,IND,750020,3,0,35,38,
Washita,Superintendent of Public Instruction,Joy Hofmeister,REP,750020,6,1,126,133,
Washita,Superintendent of Public Instruction,John Cox,DEM,750020,1,0,34,35,
Washita,Superintendent of Public Instruction,Larry Huff,IND,750020,1,0,13,14,
Washita,Commissioner of Labor,Leslie Osborn,REP,750020,5,0,123,128,
Washita,Commissioner of Labor,Fred Dorrell,DEM,750020,3,2,38,43,
Washita,Commissioner of Labor,Brandt Dismukes,IND,750020,0,0,9,9,
Washita,Insurance Commissioner,Glen Mulready,REP,750020,4,1,126,131,
Washita,Insurance Commissioner,Kimberly Fobbs,DEM,750020,4,0,43,47,
Washita,Corporation Commissioner,Bob Anthony,REP,750020,4,1,115,120,
Washita,Corporation Commissioner,Ashley Nicole Mccray,DEM,750020,3,0,39,42,
Washita,Corporation Commissioner,Jackie Short,IND,750020,1,0,17,18,
Washita,U.S. House,Frank Lucas,REP,750020,5,1,141,147,3
Washita,U.S. House,Frankie Robbins,DEM,750020,3,0,32,35,3
Washita,State Senate,Brent Howard,REP,750020,3,0,111,114,38
Washita,State Senate,Jeff Berrong,DEM,750020,5,1,61,67,38
Washita,State House,Todd Russ,REP,750020,3,2,106,111,55
Washita,State House,Dennis Dugger,DEM,750020,5,0,64,69,55
Washita,Governor,Chris Powell,LIB,750030,1,3,19,23,
Washita,Governor,Kevin Stitt,REP,750030,14,24,165,203,
Washita,Governor,Drew Edmondson,DEM,750030,3,17,86,106,
Washita,Lieutenant Governor,Matt Pinnell,REP,750030,14,27,187,228,
Washita,Lieutenant Governor,Anastasia Pittman,DEM,750030,2,14,62,78,
Washita,Lieutenant Governor,Ivan Holmes,IND,750030,1,4,17,22,
Washita,State Auditor,John Yeutter,LIB,750030,1,11,49,61,
Washita,State Auditor,Cindy Byrd,REP,750030,16,31,210,257,
Washita,Attorney General,Mike Hunter,REP,750030,16,32,191,239,
Washita,Attorney General,Mark Myles,DEM,750030,2,13,75,90,
Washita,State Treasurer,Randy Mcdaniel,REP,750030,16,31,214,261,
Washita,State Treasurer,Charles De Coune,IND,750030,2,11,43,56,
Washita,Superintendent of Public Instruction,Joy Hofmeister,REP,750030,14,25,173,212,
Washita,Superintendent of Public Instruction,John Cox,DEM,750030,1,14,62,77,
Washita,Superintendent of Public Instruction,Larry Huff,IND,750030,3,6,31,40,
Washita,Commissioner of Labor,Leslie Osborn,REP,750030,15,25,186,226,
Washita,Commissioner of Labor,Fred Dorrell,DEM,750030,1,13,60,74,
Washita,Commissioner of Labor,Brandt Dismukes,IND,750030,2,6,15,23,
Washita,Insurance Commissioner,Glen Mulready,REP,750030,15,28,191,234,
Washita,Insurance Commissioner,Kimberly Fobbs,DEM,750030,2,16,69,87,
Washita,Corporation Commissioner,Bob Anthony,REP,750030,13,27,177,217,
Washita,Corporation Commissioner,Ashley Nicole Mccray,DEM,750030,3,15,71,89,
Washita,Corporation Commissioner,Jackie Short,IND,750030,3,3,15,21,
Washita,U.S. House,Frank Lucas,REP,750030,16,31,209,256,3
Washita,U.S. House,Frankie Robbins,DEM,750030,2,14,62,78,3
Washita,State Senate,Brent Howard,REP,750030,13,20,160,193,38
Washita,State Senate,Jeff Berrong,DEM,750030,6,25,110,141,38
Washita,State House,Todd Russ,REP,750030,16,18,114,148,55
Washita,State House,Dennis Dugger,DEM,750030,4,27,159,190,55
Woods,Governor,Chris Powell,LIB,760001,0,7,26,33,
Woods,Governor,Kevin Stitt,REP,760001,16,95,384,495,
Woods,Governor,Drew Edmondson,DEM,760001,5,55,187,247,
Woods,Lieutenant Governor,Matt Pinnell,REP,760001,17,110,462,589,
Woods,Lieutenant Governor,Anastasia Pittman,DEM,760001,4,47,111,162,
Woods,Lieutenant Governor,Ivan Holmes,IND,760001,0,0,17,17,
Woods,State Auditor,John Yeutter,LIB,760001,2,20,86,108,
Woods,State Auditor,Cindy Byrd,REP,760001,19,127,494,640,
Woods,Attorney General,Mike Hunter,REP,760001,17,119,475,611,
Woods,Attorney General,Mark Myles,DEM,760001,4,38,112,154,
Woods,State Treasurer,Randy Mcdaniel,REP,760001,18,130,510,658,
Woods,State Treasurer,Charles De Coune,IND,760001,3,22,76,101,
Woods,Superintendent of Public Instruction,Joy Hofmeister,REP,760001,16,105,432,553,
Woods,Superintendent of Public Instruction,John Cox,DEM,760001,4,44,110,158,
Woods,Superintendent of Public Instruction,Larry Huff,IND,760001,1,7,53,61,
Woods,Commissioner of Labor,Leslie Osborn,REP,760001,17,108,473,598,
Woods,Commissioner of Labor,Fred Dorrell,DEM,760001,4,43,91,138,
Woods,Commissioner of Labor,Brandt Dismukes,IND,760001,0,5,23,28,
Woods,Insurance Commissioner,Glen Mulready,REP,760001,17,108,464,589,
Woods,Insurance Commissioner,Kimberly Fobbs,DEM,760001,4,47,121,172,
Woods,Corporation Commissioner,Bob Anthony,REP,760001,17,108,440,565,
Woods,Corporation Commissioner,Ashley Nicole Mccray,DEM,760001,4,43,116,163,
Woods,Corporation Commissioner,Jackie Short,IND,760001,0,6,36,42,
Woods,U.S. House,Frank Lucas,REP,760001,17,114,491,622,3
Woods,U.S. House,Frankie Robbins,DEM,760001,4,44,100,148,3
Woods,Governor,Chris Powell,LIB,760002,2,1,14,17,
Woods,Governor,Kevin Stitt,REP,760002,11,11,322,344,
Woods,Governor,Drew Edmondson,DEM,760002,10,11,82,103,
Woods,Lieutenant Governor,Matt Pinnell,REP,760002,14,13,352,379,
Woods,Lieutenant Governor,Anastasia Pittman,DEM,760002,6,9,62,77,
Woods,Lieutenant Governor,Ivan Holmes,IND,760002,3,1,5,9,
Woods,State Auditor,John Yeutter,LIB,760002,10,9,35,54,
Woods,State Auditor,Cindy Byrd,REP,760002,11,11,379,401,
Woods,Attorney General,Mike Hunter,REP,760002,14,15,352,381,
Woods,Attorney General,Mark Myles,DEM,760002,9,8,67,84,
Woods,State Treasurer,Randy Mcdaniel,REP,760002,17,14,364,395,
Woods,State Treasurer,Charles De Coune,IND,760002,4,7,49,60,
Woods,Superintendent of Public Instruction,Joy Hofmeister,REP,760002,13,14,317,344,
Woods,Superintendent of Public Instruction,John Cox,DEM,760002,7,8,73,88,
Woods,Superintendent of Public Instruction,Larry Huff,IND,760002,3,1,27,31,
Woods,Commissioner of Labor,Leslie Osborn,REP,760002,17,15,350,382,
Woods,Commissioner of Labor,Fred Dorrell,DEM,760002,5,7,59,71,
Woods,Commissioner of Labor,Brandt Dismukes,IND,760002,0,1,6,7,
Woods,Insurance Commissioner,Glen Mulready,REP,760002,15,14,343,372,
Woods,Insurance Commissioner,Kimberly Fobbs,DEM,760002,7,8,71,86,
Woods,Corporation Commissioner,Bob Anthony,REP,760002,17,12,340,369,
Woods,Corporation Commissioner,Ashley Nicole Mccray,DEM,760002,4,10,66,80,
Woods,Corporation Commissioner,Jackie Short,IND,760002,2,1,12,15,
Woods,U.S. House,Frank Lucas,REP,760002,17,14,368,399,3
Woods,U.S. House,Frankie Robbins,DEM,760002,6,9,51,66,3
Woods,Governor,Chris Powell,LIB,760003,0,1,8,9,
Woods,Governor,Kevin Stitt,REP,760003,1,33,161,195,
Woods,Governor,Drew Edmondson,DEM,760003,14,21,83,118,
Woods,Lieutenant Governor,Matt Pinnell,REP,760003,3,35,186,224,
Woods,Lieutenant Governor,Anastasia Pittman,DEM,760003,11,20,59,90,
Woods,Lieutenant Governor,Ivan Holmes,IND,760003,1,0,6,7,
Woods,State Auditor,John Yeutter,LIB,760003,2,12,36,50,
Woods,State Auditor,Cindy Byrd,REP,760003,6,40,206,252,
Woods,Attorney General,Mike Hunter,REP,760003,3,37,182,222,
Woods,Attorney General,Mark Myles,DEM,760003,11,17,69,97,
Woods,State Treasurer,Randy Mcdaniel,REP,760003,10,47,209,266,
Woods,State Treasurer,Charles De Coune,IND,760003,1,8,35,44,
Woods,Superintendent of Public Instruction,Joy Hofmeister,REP,760003,4,38,177,219,
Woods,Superintendent of Public Instruction,John Cox,DEM,760003,10,13,57,80,
Woods,Superintendent of Public Instruction,Larry Huff,IND,760003,1,4,16,21,
Woods,Commissioner of Labor,Leslie Osborn,REP,760003,3,36,183,222,
Woods,Commissioner of Labor,Fred Dorrell,DEM,760003,10,19,52,81,
Woods,Commissioner of Labor,Brandt Dismukes,IND,760003,1,0,14,15,
Woods,Insurance Commissioner,Glen Mulready,REP,760003,2,38,183,223,
Woods,Insurance Commissioner,Kimberly Fobbs,DEM,760003,12,17,65,94,
Woods,Corporation Commissioner,Bob Anthony,REP,760003,4,40,172,216,
Woods,Corporation Commissioner,Ashley Nicole Mccray,DEM,760003,9,13,64,86,
Woods,Corporation Commissioner,Jackie Short,IND,760003,1,2,14,17,
Woods,U.S. House,Frank Lucas,REP,760003,5,40,197,242,3
Woods,U.S. House,Frankie Robbins,DEM,760003,10,15,56,81,3
Woods,Governor,Chris Powell,LIB,760004,0,2,5,7,
Woods,Governor,Kevin Stitt,REP,760004,1,8,83,92,
Woods,Governor,Drew Edmondson,DEM,760004,2,3,29,34,
Woods,Lieutenant Governor,Matt Pinnell,REP,760004,3,11,94,108,
Woods,Lieutenant Governor,Anastasia Pittman,DEM,760004,0,2,21,23,
Woods,Lieutenant Governor,Ivan Holmes,IND,760004,0,0,2,2,
Woods,State Auditor,John Yeutter,LIB,760004,1,2,20,23,
Woods,State Auditor,Cindy Byrd,REP,760004,2,11,94,107,
Woods,Attorney General,Mike Hunter,REP,760004,3,9,91,103,
Woods,Attorney General,Mark Myles,DEM,760004,0,3,24,27,
Woods,State Treasurer,Randy Mcdaniel,REP,760004,2,8,97,107,
Woods,State Treasurer,Charles De Coune,IND,760004,1,3,17,21,
Woods,Superintendent of Public Instruction,Joy Hofmeister,REP,760004,2,10,78,90,
Woods,Superintendent of Public Instruction,John Cox,DEM,760004,1,1,24,26,
Woods,Superintendent of Public Instruction,Larry Huff,IND,760004,0,1,14,15,
Woods,Commissioner of Labor,Leslie Osborn,REP,760004,2,8,90,100,
Woods,Commissioner of Labor,Fred Dorrell,DEM,760004,1,3,20,24,
Woods,Commissioner of Labor,Brandt Dismukes,IND,760004,0,0,6,6,
Woods,Insurance Commissioner,Glen Mulready,REP,760004,3,10,88,101,
Woods,Insurance Commissioner,Kimberly Fobbs,DEM,760004,0,2,27,29,
Woods,Corporation Commissioner,Bob Anthony,REP,760004,2,9,85,96,
Woods,Corporation Commissioner,Ashley Nicole Mccray,DEM,760004,1,2,23,26,
Woods,Corporation Commissioner,Jackie Short,IND,760004,0,2,7,9,
Woods,U.S. House,Frank Lucas,REP,760004,1,13,100,114,3
Woods,U.S. House,Frankie Robbins,DEM,760004,2,0,16,18,3
Woods,Governor,Chris Powell,LIB,760005,2,10,34,46,
Woods,Governor,Kevin Stitt,REP,760005,34,120,467,621,
Woods,Governor,Drew Edmondson,DEM,760005,15,60,191,266,
Woods,Lieutenant Governor,Matt Pinnell,REP,760005,39,131,526,696,
Woods,Lieutenant Governor,Anastasia Pittman,DEM,760005,8,53,140,201,
Woods,Lieutenant Governor,Ivan Holmes,IND,760005,3,2,23,28,
Woods,State Auditor,John Yeutter,LIB,760005,11,18,98,127,
Woods,State Auditor,Cindy Byrd,REP,760005,37,151,572,760,
Woods,Attorney General,Mike Hunter,REP,760005,39,145,545,729,
Woods,Attorney General,Mark Myles,DEM,760005,12,42,144,198,
Woods,State Treasurer,Randy Mcdaniel,REP,760005,41,150,569,760,
Woods,State Treasurer,Charles De Coune,IND,760005,7,30,104,141,
Woods,Superintendent of Public Instruction,Joy Hofmeister,REP,760005,37,139,485,661,
Woods,Superintendent of Public Instruction,John Cox,DEM,760005,11,41,144,196,
Woods,Superintendent of Public Instruction,Larry Huff,IND,760005,3,8,61,72,
Woods,Commissioner of Labor,Leslie Osborn,REP,760005,37,130,524,691,
Woods,Commissioner of Labor,Fred Dorrell,DEM,760005,12,48,127,187,
Woods,Commissioner of Labor,Brandt Dismukes,IND,760005,1,7,36,44,
Woods,Insurance Commissioner,Glen Mulready,REP,760005,38,139,514,691,
Woods,Insurance Commissioner,Kimberly Fobbs,DEM,760005,11,50,168,229,
Woods,Corporation Commissioner,Bob Anthony,REP,760005,42,130,485,657,
Woods,Corporation Commissioner,Ashley Nicole Mccray,DEM,760005,6,52,155,213,
Woods,Corporation Commissioner,Jackie Short,IND,760005,3,8,48,59,
Woods,U.S. House,Frank Lucas,REP,760005,41,144,566,751,3
Woods,U.S. House,Frankie Robbins,DEM,760005,10,44,122,176,3
Woods,Governor,Chris Powell,LIB,760008,0,0,6,6,
Woods,Governor,Kevin Stitt,REP,760008,15,8,159,182,
Woods,Governor,Drew Edmondson,DEM,760008,2,2,25,29,
Woods,Lieutenant Governor,Matt Pinnell,REP,760008,14,9,165,188,
Woods,Lieutenant Governor,Anastasia Pittman,DEM,760008,2,1,17,20,
Woods,Lieutenant Governor,Ivan Holmes,IND,760008,1,0,8,9,
Woods,State Auditor,John Yeutter,LIB,760008,1,2,17,20,
Woods,State Auditor,Cindy Byrd,REP,760008,15,8,174,197,
Woods,Attorney General,Mike Hunter,REP,760008,15,8,173,196,
Woods,Attorney General,Mark Myles,DEM,760008,2,2,18,22,
Woods,State Treasurer,Randy Mcdaniel,REP,760008,11,8,171,190,
Woods,State Treasurer,Charles De Coune,IND,760008,4,2,20,26,
Woods,Superintendent of Public Instruction,Joy Hofmeister,REP,760008,11,7,153,171,
Woods,Superintendent of Public Instruction,John Cox,DEM,760008,1,1,18,20,
Woods,Superintendent of Public Instruction,Larry Huff,IND,760008,3,1,20,24,
Woods,Commissioner of Labor,Leslie Osborn,REP,760008,15,8,166,189,
Woods,Commissioner of Labor,Fred Dorrell,DEM,760008,1,2,14,17,
Woods,Commissioner of Labor,Brandt Dismukes,IND,760008,0,0,11,11,
Woods,Insurance Commissioner,Glen Mulready,REP,760008,14,10,165,189,
Woods,Insurance Commissioner,Kimberly Fobbs,DEM,760008,2,0,26,28,
Woods,Corporation Commissioner,Bob Anthony,REP,760008,15,8,155,178,
Woods,Corporation Commissioner,Ashley Nicole Mccray,DEM,760008,2,1,19,22,
Woods,Corporation Commissioner,Jackie Short,IND,760008,0,1,17,18,
Woods,U.S. House,Frank Lucas,REP,760008,15,9,172,196,3
Woods,U.S. House,Frankie Robbins,DEM,760008,2,0,18,20,3
Woodward,Governor,Chris Powell,LIB,770101,0,3,21,24,
Woodward,Governor,Kevin Stitt,REP,770101,8,50,288,346,
Woodward,Governor,Drew Edmondson,DEM,770101,3,15,102,120,
Woodward,Lieutenant Governor,Matt Pinnell,REP,770101,7,53,316,376,
Woodward,Lieutenant Governor,Anastasia Pittman,DEM,770101,3,14,77,94,
Woodward,Lieutenant Governor,Ivan Holmes,IND,770101,1,1,14,16,
Woodward,State Auditor,John Yeutter,LIB,770101,1,14,45,60,
Woodward,State Auditor,Cindy Byrd,REP,770101,8,51,352,411,
Woodward,Attorney General,Mike Hunter,REP,770101,8,51,333,392,
Woodward,Attorney General,Mark Myles,DEM,770101,3,17,76,96,
Woodward,State Treasurer,Randy Mcdaniel,REP,770101,8,53,335,396,
Woodward,State Treasurer,Charles De Coune,IND,770101,1,13,59,73,
Woodward,Superintendent of Public Instruction,Joy Hofmeister,REP,770101,7,53,302,362,
Woodward,Superintendent of Public Instruction,John Cox,DEM,770101,2,12,67,81,
Woodward,Superintendent of Public Instruction,Larry Huff,IND,770101,1,3,39,43,
Woodward,Commissioner of Labor,Leslie Osborn,REP,770101,8,52,319,379,
Woodward,Commissioner of Labor,Fred Dorrell,DEM,770101,3,13,61,77,
Woodward,Commissioner of Labor,Brandt Dismukes,IND,770101,0,3,28,31,
Woodward,Insurance Commissioner,Glen Mulready,REP,770101,8,55,311,374,
Woodward,Insurance Commissioner,Kimberly Fobbs,DEM,770101,3,14,96,113,
Woodward,Corporation Commissioner,Bob Anthony,REP,770101,7,48,300,355,
Woodward,Corporation Commissioner,Ashley Nicole Mccray,DEM,770101,4,14,76,94,
Woodward,Corporation Commissioner,Jackie Short,IND,770101,0,7,33,40,
Woodward,U.S. House,Frank Lucas,REP,770101,7,54,343,404,3
Woodward,U.S. House,Frankie Robbins,DEM,770101,4,15,67,86,3
Woodward,Governor,Chris Powell,LIB,770102,0,2,23,25,
Woodward,Governor,Kevin Stitt,REP,770102,4,26,167,197,
Woodward,Governor,Drew Edmondson,DEM,770102,1,7,83,91,
Woodward,Lieutenant Governor,Matt Pinnell,REP,770102,4,26,192,222,
Woodward,Lieutenant Governor,Anastasia Pittman,DEM,770102,1,9,61,71,
Woodward,Lieutenant Governor,Ivan Holmes,IND,770102,0,0,20,20,
Woodward,State Auditor,John Yeutter,LIB,770102,0,5,59,64,
Woodward,State Auditor,Cindy Byrd,REP,770102,4,30,203,237,
Woodward,Attorney General,Mike Hunter,REP,770102,4,29,202,235,
Woodward,Attorney General,Mark Myles,DEM,770102,1,6,69,76,
Woodward,State Treasurer,Randy Mcdaniel,REP,770102,3,29,203,235,
Woodward,State Treasurer,Charles De Coune,IND,770102,1,5,58,64,
Woodward,Superintendent of Public Instruction,Joy Hofmeister,REP,770102,3,29,180,212,
Woodward,Superintendent of Public Instruction,John Cox,DEM,770102,1,5,63,69,
Woodward,Superintendent of Public Instruction,Larry Huff,IND,770102,1,1,29,31,
Woodward,Commissioner of Labor,Leslie Osborn,REP,770102,4,28,192,224,
Woodward,Commissioner of Labor,Fred Dorrell,DEM,770102,1,5,57,63,
Woodward,Commissioner of Labor,Brandt Dismukes,IND,770102,0,2,23,25,
Woodward,Insurance Commissioner,Glen Mulready,REP,770102,4,26,195,225,
Woodward,Insurance Commissioner,Kimberly Fobbs,DEM,770102,1,8,77,86,
Woodward,Corporation Commissioner,Bob Anthony,REP,770102,3,29,180,212,
Woodward,Corporation Commissioner,Ashley Nicole Mccray,DEM,770102,1,6,66,73,
Woodward,Corporation Commissioner,Jackie Short,IND,770102,0,0,26,26,
Woodward,U.S. House,Frank Lucas,REP,770102,4,30,212,246,3
Woodward,U.S. House,Frankie Robbins,DEM,770102,1,5,59,65,3
Woodward,Governor,Chris Powell,LIB,770104,0,0,0,0,
Woodward,Governor,Kevin Stitt,REP,770104,2,0,2,4,
Woodward,Governor,Drew Edmondson,DEM,770104,0,0,0,0,
Woodward,Lieutenant Governor,Matt Pinnell,REP,770104,2,0,2,4,
Woodward,Lieutenant Governor,Anastasia Pittman,DEM,770104,0,0,0,0,
Woodward,Lieutenant Governor,Ivan Holmes,IND,770104,0,0,0,0,
Woodward,State Auditor,John Yeutter,LIB,770104,0,0,0,0,
Woodward,State Auditor,Cindy Byrd,REP,770104,2,0,2,4,
Woodward,Attorney General,Mike Hunter,REP,770104,2,0,2,4,
Woodward,Attorney General,Mark Myles,DEM,770104,0,0,0,0,
Woodward,State Treasurer,Randy Mcdaniel,REP,770104,2,0,2,4,
Woodward,State Treasurer,Charles De Coune,IND,770104,0,0,0,0,
Woodward,Superintendent of Public Instruction,Joy Hofmeister,REP,770104,2,0,2,4,
Woodward,Superintendent of Public Instruction,John Cox,DEM,770104,0,0,0,0,
Woodward,Superintendent of Public Instruction,Larry Huff,IND,770104,0,0,0,0,
Woodward,Commissioner of Labor,Leslie Osborn,REP,770104,2,0,2,4,
Woodward,Commissioner of Labor,Fred Dorrell,DEM,770104,0,0,0,0,
Woodward,Commissioner of Labor,Brandt Dismukes,IND,770104,0,0,0,0,
Woodward,Insurance Commissioner,Glen Mulready,REP,770104,2,0,2,4,
Woodward,Insurance Commissioner,Kimberly Fobbs,DEM,770104,0,0,0,0,
Woodward,Corporation Commissioner,Bob Anthony,REP,770104,2,0,2,4,
Woodward,Corporation Commissioner,Ashley Nicole Mccray,DEM,770104,0,0,0,0,
Woodward,Corporation Commissioner,Jackie Short,IND,770104,0,0,0,0,
Woodward,U.S. House,Frank Lucas,REP,770104,2,0,2,4,3
Woodward,U.S. House,Frankie Robbins,DEM,770104,0,0,0,0,3
Woodward,Governor,Chris Powell,LIB,770105,0,0,22,22,
Woodward,Governor,Kevin Stitt,REP,770105,12,27,484,523,
Woodward,Governor,Drew Edmondson,DEM,770105,8,9,132,149,
Woodward,Lieutenant Governor,Matt Pinnell,REP,770105,12,27,527,566,
Woodward,Lieutenant Governor,Anastasia Pittman,DEM,770105,6,9,87,102,
Woodward,Lieutenant Governor,Ivan Holmes,IND,770105,1,0,21,22,
Woodward,State Auditor,John Yeutter,LIB,770105,2,3,50,55,
Woodward,State Auditor,Cindy Byrd,REP,770105,14,31,565,610,
Woodward,Attorney General,Mike Hunter,REP,770105,13,30,538,581,
Woodward,Attorney General,Mark Myles,DEM,770105,6,6,97,109,
Woodward,State Treasurer,Randy Mcdaniel,REP,770105,13,29,564,606,
Woodward,State Treasurer,Charles De Coune,IND,770105,3,5,49,57,
Woodward,Superintendent of Public Instruction,Joy Hofmeister,REP,770105,11,24,489,524,
Woodward,Superintendent of Public Instruction,John Cox,DEM,770105,7,7,97,111,
Woodward,Superintendent of Public Instruction,Larry Huff,IND,770105,1,4,45,50,
Woodward,Commissioner of Labor,Leslie Osborn,REP,770105,11,28,510,549,
Woodward,Commissioner of Labor,Fred Dorrell,DEM,770105,7,6,89,102,
Woodward,Commissioner of Labor,Brandt Dismukes,IND,770105,1,1,27,29,
Woodward,Insurance Commissioner,Glen Mulready,REP,770105,12,28,519,559,
Woodward,Insurance Commissioner,Kimberly Fobbs,DEM,770105,7,7,110,124,
Woodward,Corporation Commissioner,Bob Anthony,REP,770105,11,28,492,531,
Woodward,Corporation Commissioner,Ashley Nicole Mccray,DEM,770105,7,6,97,110,
Woodward,Corporation Commissioner,Jackie Short,IND,770105,1,1,39,41,
Woodward,U.S. House,Frank Lucas,REP,770105,14,30,561,605,3
Woodward,U.S. House,Frankie Robbins,DEM,770105,6,6,74,86,3
Woodward,Governor,Chris Powell,LIB,770106,0,0,3,3,
Woodward,Governor,Kevin Stitt,REP,770106,8,3,62,73,
Woodward,Governor,Drew Edmondson,DEM,770106,3,0,5,8,
Woodward,Lieutenant Governor,Matt Pinnell,REP,770106,10,3,65,78,
Woodward,Lieutenant Governor,Anastasia Pittman,DEM,770106,1,0,4,5,
Woodward,Lieutenant Governor,Ivan Holmes,IND,770106,0,0,1,1,
Woodward,State Auditor,John Yeutter,LIB,770106,2,0,9,11,
Woodward,State Auditor,Cindy Byrd,REP,770106,9,3,61,73,
Woodward,Attorney General,Mike Hunter,REP,770106,10,3,67,80,
Woodward,Attorney General,Mark Myles,DEM,770106,1,0,3,4,
Woodward,State Treasurer,Randy Mcdaniel,REP,770106,8,3,65,76,
Woodward,State Treasurer,Charles De Coune,IND,770106,3,0,4,7,
Woodward,Superintendent of Public Instruction,Joy Hofmeister,REP,770106,8,2,54,64,
Woodward,Superintendent of Public Instruction,John Cox,DEM,770106,3,1,7,11,
Woodward,Superintendent of Public Instruction,Larry Huff,IND,770106,0,0,8,8,
Woodward,Commissioner of Labor,Leslie Osborn,REP,770106,8,2,65,75,
Woodward,Commissioner of Labor,Fred Dorrell,DEM,770106,3,1,3,7,
Woodward,Commissioner of Labor,Brandt Dismukes,IND,770106,0,0,1,1,
Woodward,Insurance Commissioner,Glen Mulready,REP,770106,7,3,65,75,
Woodward,Insurance Commissioner,Kimberly Fobbs,DEM,770106,4,0,5,9,
Woodward,Corporation Commissioner,Bob Anthony,REP,770106,7,1,64,72,
Woodward,Corporation Commissioner,Ashley Nicole Mccray,DEM,770106,2,2,4,8,
Woodward,Corporation Commissioner,Jackie Short,IND,770106,2,0,2,4,
Woodward,U.S. House,Frank Lucas,REP,770106,10,3,65,78,3
Woodward,U.S. House,Frankie Robbins,DEM,770106,1,0,5,6,3
Woodward,Governor,Chris Powell,LIB,770201,0,2,22,24,
Woodward,Governor,Kevin Stitt,REP,770201,19,93,386,498,
Woodward,Governor,Drew Edmondson,DEM,770201,6,48,168,222,
Woodward,Lieutenant Governor,Matt Pinnell,REP,770201,20,106,424,550,
Woodward,Lieutenant Governor,Anastasia Pittman,DEM,770201,5,33,129,167,
Woodward,Lieutenant Governor,Ivan Holmes,IND,770201,0,4,22,26,
Woodward,State Auditor,John Yeutter,LIB,770201,4,19,88,111,
Woodward,State Auditor,Cindy Byrd,REP,770201,20,116,468,604,
Woodward,Attorney General,Mike Hunter,REP,770201,21,106,450,577,
Woodward,Attorney General,Mark Myles,DEM,770201,4,35,121,160,
Woodward,State Treasurer,Randy Mcdaniel,REP,770201,21,106,459,586,
Woodward,State Treasurer,Charles De Coune,IND,770201,3,28,93,124,
Woodward,Superintendent of Public Instruction,Joy Hofmeister,REP,770201,22,103,388,513,
Woodward,Superintendent of Public Instruction,John Cox,DEM,770201,2,30,141,173,
Woodward,Superintendent of Public Instruction,Larry Huff,IND,770201,1,8,42,51,
Woodward,Commissioner of Labor,Leslie Osborn,REP,770201,23,108,427,558,
Woodward,Commissioner of Labor,Fred Dorrell,DEM,770201,2,31,116,149,
Woodward,Commissioner of Labor,Brandt Dismukes,IND,770201,0,2,25,27,
Woodward,Insurance Commissioner,Glen Mulready,REP,770201,21,104,428,553,
Woodward,Insurance Commissioner,Kimberly Fobbs,DEM,770201,4,38,140,182,
Woodward,Corporation Commissioner,Bob Anthony,REP,770201,21,102,419,542,
Woodward,Corporation Commissioner,Ashley Nicole Mccray,DEM,770201,3,37,129,169,
Woodward,Corporation Commissioner,Jackie Short,IND,770201,1,3,23,27,
Woodward,U.S. House,Frank Lucas,REP,770201,21,107,457,585,3
Woodward,U.S. House,Frankie Robbins,DEM,770201,4,35,119,158,3
Woodward,Governor,Chris Powell,LIB,770202,0,3,27,30,
Woodward,Governor,Kevin Stitt,REP,770202,10,120,617,747,
Woodward,Governor,Drew Edmondson,DEM,770202,10,54,224,288,
Woodward,Lieutenant Governor,Matt Pinnell,REP,770202,13,133,690,836,
Woodward,Lieutenant Governor,Anastasia Pittman,DEM,770202,7,41,150,198,
Woodward,Lieutenant Governor,Ivan Holmes,IND,770202,0,5,26,31,
Woodward,State Auditor,John Yeutter,LIB,770202,3,23,95,121,
Woodward,State Auditor,Cindy Byrd,REP,770202,17,153,744,914,
Woodward,Attorney General,Mike Hunter,REP,770202,13,141,707,861,
Woodward,Attorney General,Mark Myles,DEM,770202,7,37,154,198,
Woodward,State Treasurer,Randy Mcdaniel,REP,770202,14,148,730,892,
Woodward,State Treasurer,Charles De Coune,IND,770202,5,29,105,139,
Woodward,Superintendent of Public Instruction,Joy Hofmeister,REP,770202,12,138,659,809,
Woodward,Superintendent of Public Instruction,John Cox,DEM,770202,7,31,142,180,
Woodward,Superintendent of Public Instruction,Larry Huff,IND,770202,1,10,62,73,
Woodward,Commissioner of Labor,Leslie Osborn,REP,770202,14,142,689,845,
Woodward,Commissioner of Labor,Fred Dorrell,DEM,770202,6,32,129,167,
Woodward,Commissioner of Labor,Brandt Dismukes,IND,770202,0,4,42,46,
Woodward,Insurance Commissioner,Glen Mulready,REP,770202,13,139,673,825,
Woodward,Insurance Commissioner,Kimberly Fobbs,DEM,770202,7,40,181,228,
Woodward,Corporation Commissioner,Bob Anthony,REP,770202,14,130,660,804,
Woodward,Corporation Commissioner,Ashley Nicole Mccray,DEM,770202,6,44,138,188,
Woodward,Corporation Commissioner,Jackie Short,IND,770202,0,5,61,66,
Woodward,U.S. House,Frank Lucas,REP,770202,14,137,718,869,3
Woodward,U.S. House,Frankie Robbins,DEM,770202,6,42,147,195,3
Woodward,Governor,Chris Powell,LIB,770203,0,1,9,10,
Woodward,Governor,Kevin Stitt,REP,770203,9,29,279,317,
Woodward,Governor,Drew Edmondson,DEM,770203,3,7,63,73,
Woodward,Lieutenant Governor,Matt Pinnell,REP,770203,10,32,299,341,
Woodward,Lieutenant Governor,Anastasia Pittman,DEM,770203,2,3,48,53,
Woodward,Lieutenant Governor,Ivan Holmes,IND,770203,0,1,7,8,
Woodward,State Auditor,John Yeutter,LIB,770203,0,5,45,50,
Woodward,State Auditor,Cindy Byrd,REP,770203,11,28,301,340,
Woodward,Attorney General,Mike Hunter,REP,770203,10,32,310,352,
Woodward,Attorney General,Mark Myles,DEM,770203,2,4,42,48,
Woodward,State Treasurer,Randy Mcdaniel,REP,770203,10,32,306,348,
Woodward,State Treasurer,Charles De Coune,IND,770203,0,2,41,43,
Woodward,Superintendent of Public Instruction,Joy Hofmeister,REP,770203,10,31,287,328,
Woodward,Superintendent of Public Instruction,John Cox,DEM,770203,2,4,39,45,
Woodward,Superintendent of Public Instruction,Larry Huff,IND,770203,0,1,28,29,
Woodward,Commissioner of Labor,Leslie Osborn,REP,770203,11,31,301,343,
Woodward,Commissioner of Labor,Fred Dorrell,DEM,770203,1,4,35,40,
Woodward,Commissioner of Labor,Brandt Dismukes,IND,770203,0,1,12,13,
Woodward,Insurance Commissioner,Glen Mulready,REP,770203,9,27,292,328,
Woodward,Insurance Commissioner,Kimberly Fobbs,DEM,770203,3,7,58,68,
Woodward,Corporation Commissioner,Bob Anthony,REP,770203,8,31,288,327,
Woodward,Corporation Commissioner,Ashley Nicole Mccray,DEM,770203,4,3,41,48,
Woodward,Corporation Commissioner,Jackie Short,IND,770203,0,1,20,21,
Woodward,U.S. House,Frank Lucas,REP,770203,11,32,314,357,3
Woodward,U.S. House,Frankie Robbins,DEM,770203,1,4,41,46,3
Woodward,Governor,Chris Powell,LIB,770204,0,0,7,7,
Woodward,Governor,Kevin Stitt,REP,770204,5,12,116,133,
Woodward,Governor,Drew Edmondson,DEM,770204,0,1,27,28,
Woodward,Lieutenant Governor,Matt Pinnell,REP,770204,5,12,121,138,
Woodward,Lieutenant Governor,Anastasia Pittman,DEM,770204,0,0,19,19,
Woodward,Lieutenant Governor,Ivan Holmes,IND,770204,0,1,10,11,
Woodward,State Auditor,John Yeutter,LIB,770204,0,1,17,18,
Woodward,State Auditor,Cindy Byrd,REP,770204,5,11,126,142,
Woodward,Attorney General,Mike Hunter,REP,770204,5,12,126,143,
Woodward,Attorney General,Mark Myles,DEM,770204,0,1,24,25,
Woodward,State Treasurer,Randy Mcdaniel,REP,770204,5,12,127,144,
Woodward,State Treasurer,Charles De Coune,IND,770204,0,1,16,17,
Woodward,Superintendent of Public Instruction,Joy Hofmeister,REP,770204,4,8,106,118,
Woodward,Superintendent of Public Instruction,John Cox,DEM,770204,1,3,29,33,
Woodward,Superintendent of Public Instruction,Larry Huff,IND,770204,0,1,15,16,
Woodward,Commissioner of Labor,Leslie Osborn,REP,770204,5,10,115,130,
Woodward,Commissioner of Labor,Fred Dorrell,DEM,770204,0,1,25,26,
Woodward,Commissioner of Labor,Brandt Dismukes,IND,770204,0,1,7,8,
Woodward,Insurance Commissioner,Glen Mulready,REP,770204,5,12,122,139,
Woodward,Insurance Commissioner,Kimberly Fobbs,DEM,770204,0,1,27,28,
Woodward,Corporation Commissioner,Bob Anthony,REP,770204,3,12,109,124,
Woodward,Corporation Commissioner,Ashley Nicole Mccray,DEM,770204,2,1,30,33,
Woodward,Corporation Commissioner,Jackie Short,IND,770204,0,0,11,11,
Woodward,U.S. House,Frank Lucas,REP,770204,5,12,129,146,3
Woodward,U.S. House,Frankie Robbins,DEM,770204,0,1,21,22,3
Woodward,Governor,Chris Powell,LIB,770301,0,2,3,5,
Woodward,Governor,Kevin Stitt,REP,770301,3,28,116,147,
Woodward,Governor,Drew Edmondson,DEM,770301,2,9,48,59,
Woodward,Lieutenant Governor,Matt Pinnell,REP,770301,4,30,127,161,
Woodward,Lieutenant Governor,Anastasia Pittman,DEM,770301,1,7,36,44,
Woodward,Lieutenant Governor,Ivan Holmes,IND,770301,0,2,4,6,
Woodward,State Auditor,John Yeutter,LIB,770301,0,4,19,23,
Woodward,State Auditor,Cindy Byrd,REP,770301,4,31,143,178,
Woodward,Attorney General,Mike Hunter,REP,770301,3,34,134,171,
Woodward,Attorney General,Mark Myles,DEM,770301,2,5,32,39,
Woodward,State Treasurer,Randy Mcdaniel,REP,770301,4,31,142,177,
Woodward,State Treasurer,Charles De Coune,IND,770301,0,4,21,25,
Woodward,Superintendent of Public Instruction,Joy Hofmeister,REP,770301,4,28,124,156,
Woodward,Superintendent of Public Instruction,John Cox,DEM,770301,1,7,30,38,
Woodward,Superintendent of Public Instruction,Larry Huff,IND,770301,0,4,12,16,
Woodward,Commissioner of Labor,Leslie Osborn,REP,770301,4,28,136,168,
Woodward,Commissioner of Labor,Fred Dorrell,DEM,770301,1,7,26,34,
Woodward,Commissioner of Labor,Brandt Dismukes,IND,770301,0,4,2,6,
Woodward,Insurance Commissioner,Glen Mulready,REP,770301,4,29,127,160,
Woodward,Insurance Commissioner,Kimberly Fobbs,DEM,770301,1,10,40,51,
Woodward,Corporation Commissioner,Bob Anthony,REP,770301,4,27,128,159,
Woodward,Corporation Commissioner,Ashley Nicole Mccray,DEM,770301,1,9,32,42,
Woodward,Corporation Commissioner,Jackie Short,IND,770301,0,3,7,10,
Woodward,U.S. House,Frank Lucas,REP,770301,5,30,141,176,3
Woodward,U.S. House,Frankie Robbins,DEM,770301,0,9,25,34,3
Woodward,Governor,Chris Powell,LIB,770302,0,0,4,4,
Woodward,Governor,Kevin Stitt,REP,770302,5,40,139,184,
Woodward,Governor,Drew Edmondson,DEM,770302,2,14,25,41,
Woodward,Lieutenant Governor,Matt Pinnell,REP,770302,5,44,144,193,
Woodward,Lieutenant Governor,Anastasia Pittman,DEM,770302,2,7,17,26,
Woodward,Lieutenant Governor,Ivan Holmes,IND,770302,0,3,3,6,
Woodward,State Auditor,John Yeutter,LIB,770302,1,6,20,27,
Woodward,State Auditor,Cindy Byrd,REP,770302,5,47,143,195,
Woodward,Attorney General,Mike Hunter,REP,770302,4,45,144,193,
Woodward,Attorney General,Mark Myles,DEM,770302,2,9,24,35,
Woodward,State Treasurer,Randy Mcdaniel,REP,770302,5,44,147,196,
Woodward,State Treasurer,Charles De Coune,IND,770302,1,9,17,27,
Woodward,Superintendent of Public Instruction,Joy Hofmeister,REP,770302,5,50,129,184,
Woodward,Superintendent of Public Instruction,John Cox,DEM,770302,2,4,28,34,
Woodward,Superintendent of Public Instruction,Larry Huff,IND,770302,0,0,10,10,
Woodward,Commissioner of Labor,Leslie Osborn,REP,770302,5,45,139,189,
Woodward,Commissioner of Labor,Fred Dorrell,DEM,770302,2,8,20,30,
Woodward,Commissioner of Labor,Brandt Dismukes,IND,770302,0,1,7,8,
Woodward,Insurance Commissioner,Glen Mulready,REP,770302,5,46,142,193,
Woodward,Insurance Commissioner,Kimberly Fobbs,DEM,770302,2,8,23,33,
Woodward,Corporation Commissioner,Bob Anthony,REP,770302,5,43,135,183,
Woodward,Corporation Commissioner,Ashley Nicole Mccray,DEM,770302,2,9,23,34,
Woodward,Corporation Commissioner,Jackie Short,IND,770302,0,2,10,12,
Woodward,U.S. House,Frank Lucas,REP,770302,5,45,152,202,3
Woodward,U.S. House,Frankie Robbins,DEM,770302,2,9,16,27,3
Woodward,Governor,Chris Powell,LIB,770303,0,0,0,0,
Woodward,Governor,Kevin Stitt,REP,770303,0,2,0,2,
Woodward,Governor,Drew Edmondson,DEM,770303,0,0,0,0,
Woodward,Lieutenant Governor,Matt Pinnell,REP,770303,0,2,0,2,
Woodward,Lieutenant Governor,Anastasia Pittman,DEM,770303,0,0,0,0,
Woodward,Lieutenant Governor,Ivan Holmes,IND,770303,0,0,0,0,
Woodward,State Auditor,John Yeutter,LIB,770303,0,1,0,1,
Woodward,State Auditor,Cindy Byrd,REP,770303,0,0,0,0,
Woodward,Attorney General,Mike Hunter,REP,770303,0,2,0,2,
Woodward,Attorney General,Mark Myles,DEM,770303,0,0,0,0,
Woodward,State Treasurer,Randy Mcdaniel,REP,770303,0,2,0,2,
Woodward,State Treasurer,Charles De Coune,IND,770303,0,0,0,0,
Woodward,Superintendent of Public Instruction,Joy Hofmeister,REP,770303,0,2,0,2,
Woodward,Superintendent of Public Instruction,John Cox,DEM,770303,0,0,0,0,
Woodward,Superintendent of Public Instruction,Larry Huff,IND,770303,0,0,0,0,
Woodward,Commissioner of Labor,Leslie Osborn,REP,770303,0,1,0,1,
Woodward,Commissioner of Labor,Fred Dorrell,DEM,770303,0,0,0,0,
Woodward,Commissioner of Labor,Brandt Dismukes,IND,770303,0,0,0,0,
Woodward,Insurance Commissioner,Glen Mulready,REP,770303,0,2,0,2,
Woodward,Insurance Commissioner,Kimberly Fobbs,DEM,770303,0,0,0,0,
Woodward,Corporation Commissioner,Bob Anthony,REP,770303,0,2,0,2,
Woodward,Corporation Commissioner,Ashley Nicole Mccray,DEM,770303,0,0,0,0,
Woodward,Corporation Commissioner,Jackie Short,IND,770303,0,0,0,0,
Woodward,U.S. House,Frank Lucas,REP,770303,0,2,0,2,3
Woodward,U.S. House,Frankie Robbins,DEM,770303,0,0,0,0,3
Woodward,Governor,Chris Powell,LIB,770304,0,1,5,6,
Woodward,Governor,Kevin Stitt,REP,770304,2,16,123,141,
Woodward,Governor,Drew Edmondson,DEM,770304,2,3,32,37,
Woodward,Lieutenant Governor,Matt Pinnell,REP,770304,4,18,131,153,
Woodward,Lieutenant Governor,Anastasia Pittman,DEM,770304,0,1,25,26,
Woodward,Lieutenant Governor,Ivan Holmes,IND,770304,0,1,4,5,
Woodward,State Auditor,John Yeutter,LIB,770304,0,4,16,20,
Woodward,State Auditor,Cindy Byrd,REP,770304,4,15,137,156,
Woodward,Attorney General,Mike Hunter,REP,770304,3,16,131,150,
Woodward,Attorney General,Mark Myles,DEM,770304,1,4,26,31,
Woodward,State Treasurer,Randy Mcdaniel,REP,770304,4,17,132,153,
Woodward,State Treasurer,Charles De Coune,IND,770304,0,2,21,23,
Woodward,Superintendent of Public Instruction,Joy Hofmeister,REP,770304,3,14,117,134,
Woodward,Superintendent of Public Instruction,John Cox,DEM,770304,1,4,31,36,
Woodward,Superintendent of Public Instruction,Larry Huff,IND,770304,0,2,11,13,
Woodward,Commissioner of Labor,Leslie Osborn,REP,770304,4,19,125,148,
Woodward,Commissioner of Labor,Fred Dorrell,DEM,770304,0,1,27,28,
Woodward,Commissioner of Labor,Brandt Dismukes,IND,770304,0,0,7,7,
Woodward,Insurance Commissioner,Glen Mulready,REP,770304,4,19,129,152,
Woodward,Insurance Commissioner,Kimberly Fobbs,DEM,770304,0,1,29,30,
Woodward,Corporation Commissioner,Bob Anthony,REP,770304,4,19,122,145,
Woodward,Corporation Commissioner,Ashley Nicole Mccray,DEM,770304,0,1,32,33,
Woodward,Corporation Commissioner,Jackie Short,IND,770304,0,0,5,5,
Woodward,U.S. House,Frank Lucas,REP,770304,3,19,132,154,3
Woodward,U.S. House,Frankie Robbins,DEM,770304,1,1,27,29,3
Woodward,Governor,Chris Powell,LIB,770306,0,3,20,23,
Woodward,Governor,Kevin Stitt,REP,770306,26,170,741,937,
Woodward,Governor,Drew Edmondson,DEM,770306,7,46,188,241,
Woodward,Lieutenant Governor,Matt Pinnell,REP,770306,30,189,816,1035,
Woodward,Lieutenant Governor,Anastasia Pittman,DEM,770306,3,27,108,138,
Woodward,Lieutenant Governor,Ivan Holmes,IND,770306,0,4,24,28,
Woodward,State Auditor,John Yeutter,LIB,770306,3,20,104,127,
Woodward,State Auditor,Cindy Byrd,REP,770306,30,194,829,1053,
Woodward,Attorney General,Mike Hunter,REP,770306,27,195,810,1032,
Woodward,Attorney General,Mark Myles,DEM,770306,5,24,135,164,
Woodward,State Treasurer,Randy Mcdaniel,REP,770306,27,193,833,1053,
Woodward,State Treasurer,Charles De Coune,IND,770306,4,20,97,121,
Woodward,Superintendent of Public Instruction,Joy Hofmeister,REP,770306,28,184,741,953,
Woodward,Superintendent of Public Instruction,John Cox,DEM,770306,4,21,139,164,
Woodward,Superintendent of Public Instruction,Larry Huff,IND,770306,1,14,66,81,
Woodward,Commissioner of Labor,Leslie Osborn,REP,770306,29,193,791,1013,
Woodward,Commissioner of Labor,Fred Dorrell,DEM,770306,3,20,116,139,
Woodward,Commissioner of Labor,Brandt Dismukes,IND,770306,1,6,33,40,
Woodward,Insurance Commissioner,Glen Mulready,REP,770306,26,187,778,991,
Woodward,Insurance Commissioner,Kimberly Fobbs,DEM,770306,6,30,162,198,
Woodward,Corporation Commissioner,Bob Anthony,REP,770306,27,175,741,943,
Woodward,Corporation Commissioner,Ashley Nicole Mccray,DEM,770306,5,31,148,184,
Woodward,Corporation Commissioner,Jackie Short,IND,770306,1,13,49,63,
Woodward,U.S. House,Frank Lucas,REP,770306,29,196,826,1051,3
Woodward,U.S. House,Frankie Robbins,DEM,770306,4,23,116,143,3
Woodward,Governor,Chris Powell,LIB,770307,0,0,1,1,
Woodward,Governor,Kevin Stitt,REP,770307,1,1,75,77,
Woodward,Governor,Drew Edmondson,DEM,770307,0,3,28,31,
Woodward,Lieutenant Governor,Matt Pinnell,REP,770307,1,3,76,80,
Woodward,Lieutenant Governor,Anastasia Pittman,DEM,770307,0,1,23,24,
Woodward,Lieutenant Governor,Ivan Holmes,IND,770307,0,0,4,4,
Woodward,State Auditor,John Yeutter,LIB,770307,0,0,17,17,
Woodward,State Auditor,Cindy Byrd,REP,770307,1,4,82,87,
Woodward,Attorney General,Mike Hunter,REP,770307,1,3,76,80,
Woodward,Attorney General,Mark Myles,DEM,770307,0,1,26,27,
Woodward,State Treasurer,Randy Mcdaniel,REP,770307,1,3,80,84,
Woodward,State Treasurer,Charles De Coune,IND,770307,0,1,21,22,
Woodward,Superintendent of Public Instruction,Joy Hofmeister,REP,770307,1,3,67,71,
Woodward,Superintendent of Public Instruction,John Cox,DEM,770307,0,1,27,28,
Woodward,Superintendent of Public Instruction,Larry Huff,IND,770307,0,0,9,9,
Woodward,Commissioner of Labor,Leslie Osborn,REP,770307,1,1,69,71,
Woodward,Commissioner of Labor,Fred Dorrell,DEM,770307,0,2,24,26,
Woodward,Commissioner of Labor,Brandt Dismukes,IND,770307,0,0,7,7,
Woodward,Insurance Commissioner,Glen Mulready,REP,770307,1,2,71,74,
Woodward,Insurance Commissioner,Kimberly Fobbs,DEM,770307,0,2,30,32,
Woodward,Corporation Commissioner,Bob Anthony,REP,770307,1,2,72,75,
Woodward,Corporation Commissioner,Ashley Nicole Mccray,DEM,770307,0,2,25,27,
Woodward,Corporation Commissioner,Jackie Short,IND,770307,0,0,5,5,
Woodward,U.S. House,Frank Lucas,REP,770307,1,4,75,80,3
Woodward,U.S. House,Frankie Robbins,DEM,770307,0,0,27,27,3
Woodward,State House,Kenton Patzkowsky,REP,770307,1,3,70,74,61
Woodward,State House,Ashley Lehnert,DEM,770307,0,1,32,33,61
