county,office,candidate,party,precinct,mail_votes,early_votes,elec_day_votes,total_votes,district
Adair,Governor,Mick Cornett,REP,10001,0,0,17,17,
Adair,Governor,Kevin Stitt,REP,10001,0,0,29,29,
Adair,Lieutenant Governor,Dana Murphy,REP,10001,0,0,24,24,
Adair,Lieutenant Governor,Matt Pinnell,REP,10001,0,0,21,21,
Adair,State Auditor,Cindy Byrd,REP,10001,0,0,22,22,
Adair,State Auditor,Charlie Prater,REP,10001,0,0,20,20,
Adair,Attorney General,Mike Hunter,REP,10001,0,0,19,19,
Adair,Attorney General,Gentner Drummond,REP,10001,0,0,26,26,
Adair,Superintendent of Public Instruction,Joy Hofmeister,REP,10001,0,0,23,23,
Adair,Superintendent of Public Instruction,Linda Murphy,REP,10001,0,0,22,22,
Adair,Commissioner of Labor,Cathy Costello,REP,10001,0,0,16,16,
Adair,Commissioner of Labor,Leslie Osborn,REP,10001,0,0,28,28,
Adair,Corporation Commissioner,Bob Anthony,REP,10001,0,0,20,20,
Adair,Corporation Commissioner,Brian Bingman,REP,10001,0,0,23,23,
Adair,Governor,Chris Powell,LIB,10001,0,0,0,0,
Adair,Governor,Rex Lawhorn,LIB,10001,0,0,2,2,
Adair,Corporation Commissioner,Ashley Nicole Mccray,DEM,10001,0,5,31,36,
Adair,Corporation Commissioner,Blake Cummings,DEM,10001,10,5,36,51,
Adair,U.S. House,Jason Nichols,DEM,10001,1,4,44,49,02
Adair,U.S. House,Clay Padgett,DEM,10001,11,6,25,42,02
Adair,Governor,Mick Cornett,REP,10002,0,0,13,13,
Adair,Governor,Kevin Stitt,REP,10002,0,2,33,35,
Adair,Lieutenant Governor,Dana Murphy,REP,10002,0,1,20,21,
Adair,Lieutenant Governor,Matt Pinnell,REP,10002,0,0,24,24,
Adair,State Auditor,Cindy Byrd,REP,10002,0,1,21,22,
Adair,State Auditor,Charlie Prater,REP,10002,0,0,23,23,
Adair,Attorney General,Mike Hunter,REP,10002,0,1,18,19,
Adair,Attorney General,Gentner Drummond,REP,10002,0,1,30,31,
Adair,Superintendent of Public Instruction,Joy Hofmeister,REP,10002,0,0,23,23,
Adair,Superintendent of Public Instruction,Linda Murphy,REP,10002,0,0,25,25,
Adair,Commissioner of Labor,Cathy Costello,REP,10002,0,0,21,21,
Adair,Commissioner of Labor,Leslie Osborn,REP,10002,0,0,24,24,
Adair,Corporation Commissioner,Bob Anthony,REP,10002,0,0,20,20,
Adair,Corporation Commissioner,Brian Bingman,REP,10002,0,0,26,26,
Adair,Governor,Chris Powell,LIB,10002,0,0,0,0,
Adair,Governor,Rex Lawhorn,LIB,10002,0,0,0,0,
Adair,Corporation Commissioner,Ashley Nicole Mccray,DEM,10002,1,2,28,31,
Adair,Corporation Commissioner,Blake Cummings,DEM,10002,1,1,30,32,
Adair,U.S. House,Jason Nichols,DEM,10002,2,2,44,48,02
Adair,U.S. House,Clay Padgett,DEM,10002,1,1,15,17,02
Adair,Governor,Mick Cornett,REP,10003,2,0,10,12,
Adair,Governor,Kevin Stitt,REP,10003,0,0,23,23,
Adair,Lieutenant Governor,Dana Murphy,REP,10003,0,0,8,8,
Adair,Lieutenant Governor,Matt Pinnell,REP,10003,2,0,25,27,
Adair,State Auditor,Cindy Byrd,REP,10003,0,0,16,16,
Adair,State Auditor,Charlie Prater,REP,10003,2,0,17,19,
Adair,Attorney General,Mike Hunter,REP,10003,0,0,17,17,
Adair,Attorney General,Gentner Drummond,REP,10003,2,0,16,18,
Adair,Superintendent of Public Instruction,Joy Hofmeister,REP,10003,2,0,16,18,
Adair,Superintendent of Public Instruction,Linda Murphy,REP,10003,0,0,17,17,
Adair,Commissioner of Labor,Cathy Costello,REP,10003,2,0,18,20,
Adair,Commissioner of Labor,Leslie Osborn,REP,10003,0,0,14,14,
Adair,Corporation Commissioner,Bob Anthony,REP,10003,0,0,16,16,
Adair,Corporation Commissioner,Brian Bingman,REP,10003,2,0,16,18,
Adair,Governor,Chris Powell,LIB,10003,0,0,0,0,
Adair,Governor,Rex Lawhorn,LIB,10003,0,0,0,0,
Adair,Corporation Commissioner,Ashley Nicole Mccray,DEM,10003,0,0,15,15,
Adair,Corporation Commissioner,Blake Cummings,DEM,10003,0,0,12,12,
Adair,U.S. House,Jason Nichols,DEM,10003,0,0,18,18,02
Adair,U.S. House,Clay Padgett,DEM,10003,0,0,9,9,02
Adair,Governor,Mick Cornett,REP,10004,0,3,10,13,
Adair,Governor,Kevin Stitt,REP,10004,3,3,25,31,
Adair,Lieutenant Governor,Dana Murphy,REP,10004,2,3,18,23,
Adair,Lieutenant Governor,Matt Pinnell,REP,10004,1,3,15,19,
Adair,State Auditor,Cindy Byrd,REP,10004,1,5,15,21,
Adair,State Auditor,Charlie Prater,REP,10004,2,1,18,21,
Adair,Attorney General,Mike Hunter,REP,10004,2,0,18,20,
Adair,Attorney General,Gentner Drummond,REP,10004,1,6,17,24,
Adair,Superintendent of Public Instruction,Joy Hofmeister,REP,10004,2,6,15,23,
Adair,Superintendent of Public Instruction,Linda Murphy,REP,10004,1,0,18,19,
Adair,Commissioner of Labor,Cathy Costello,REP,10004,2,3,18,23,
Adair,Commissioner of Labor,Leslie Osborn,REP,10004,1,3,13,17,
Adair,Corporation Commissioner,Bob Anthony,REP,10004,2,5,14,21,
Adair,Corporation Commissioner,Brian Bingman,REP,10004,1,1,18,20,
Adair,Governor,Chris Powell,LIB,10004,0,0,0,0,
Adair,Governor,Rex Lawhorn,LIB,10004,0,0,0,0,
Adair,Corporation Commissioner,Ashley Nicole Mccray,DEM,10004,0,7,26,33,
Adair,Corporation Commissioner,Blake Cummings,DEM,10004,1,2,34,37,
Adair,U.S. House,Jason Nichols,DEM,10004,2,5,33,40,02
Adair,U.S. House,Clay Padgett,DEM,10004,0,4,27,31,02
Adair,Governor,Mick Cornett,REP,10005,0,0,14,14,
Adair,Governor,Kevin Stitt,REP,10005,0,5,43,48,
Adair,Lieutenant Governor,Dana Murphy,REP,10005,0,2,22,24,
Adair,Lieutenant Governor,Matt Pinnell,REP,10005,0,3,34,37,
Adair,State Auditor,Cindy Byrd,REP,10005,0,4,33,37,
Adair,State Auditor,Charlie Prater,REP,10005,0,1,23,24,
Adair,Attorney General,Mike Hunter,REP,10005,0,2,25,27,
Adair,Attorney General,Gentner Drummond,REP,10005,0,3,32,35,
Adair,Superintendent of Public Instruction,Joy Hofmeister,REP,10005,0,2,34,36,
Adair,Superintendent of Public Instruction,Linda Murphy,REP,10005,0,3,21,24,
Adair,Commissioner of Labor,Cathy Costello,REP,10005,0,4,27,31,
Adair,Commissioner of Labor,Leslie Osborn,REP,10005,0,1,28,29,
Adair,Corporation Commissioner,Bob Anthony,REP,10005,0,4,24,28,
Adair,Corporation Commissioner,Brian Bingman,REP,10005,0,1,31,32,
Adair,Governor,Chris Powell,LIB,10005,0,0,0,0,
Adair,Governor,Rex Lawhorn,LIB,10005,0,0,0,0,
Adair,Corporation Commissioner,Ashley Nicole Mccray,DEM,10005,1,2,21,24,
Adair,Corporation Commissioner,Blake Cummings,DEM,10005,1,1,37,39,
Adair,U.S. House,Jason Nichols,DEM,10005,1,3,38,42,02
Adair,U.S. House,Clay Padgett,DEM,10005,1,0,21,22,02
Adair,Governor,Mick Cornett,REP,10006,0,0,28,28,
Adair,Governor,Kevin Stitt,REP,10006,1,6,45,52,
Adair,Lieutenant Governor,Dana Murphy,REP,10006,0,3,23,26,
Adair,Lieutenant Governor,Matt Pinnell,REP,10006,1,2,49,52,
Adair,State Auditor,Cindy Byrd,REP,10006,1,5,33,39,
Adair,State Auditor,Charlie Prater,REP,10006,0,0,39,39,
Adair,Attorney General,Mike Hunter,REP,10006,1,2,35,38,
Adair,Attorney General,Gentner Drummond,REP,10006,0,3,38,41,
Adair,Superintendent of Public Instruction,Joy Hofmeister,REP,10006,0,1,44,45,
Adair,Superintendent of Public Instruction,Linda Murphy,REP,10006,1,4,28,33,
Adair,Commissioner of Labor,Cathy Costello,REP,10006,0,1,21,22,
Adair,Commissioner of Labor,Leslie Osborn,REP,10006,1,4,51,56,
Adair,Corporation Commissioner,Bob Anthony,REP,10006,0,2,32,34,
Adair,Corporation Commissioner,Brian Bingman,REP,10006,1,3,39,43,
Adair,Governor,Chris Powell,LIB,10006,0,0,0,0,
Adair,Governor,Rex Lawhorn,LIB,10006,0,0,0,0,
Adair,Corporation Commissioner,Ashley Nicole Mccray,DEM,10006,0,8,74,82,
Adair,Corporation Commissioner,Blake Cummings,DEM,10006,3,5,84,92,
Adair,U.S. House,Jason Nichols,DEM,10006,3,7,116,126,02
Adair,U.S. House,Clay Padgett,DEM,10006,0,6,45,51,02
Adair,Governor,Mick Cornett,REP,10007,0,1,23,24,
Adair,Governor,Kevin Stitt,REP,10007,0,1,42,43,
Adair,Lieutenant Governor,Dana Murphy,REP,10007,0,0,18,18,
Adair,Lieutenant Governor,Matt Pinnell,REP,10007,0,2,46,48,
Adair,State Auditor,Cindy Byrd,REP,10007,0,0,30,30,
Adair,State Auditor,Charlie Prater,REP,10007,0,2,35,37,
Adair,Attorney General,Mike Hunter,REP,10007,0,0,36,36,
Adair,Attorney General,Gentner Drummond,REP,10007,0,2,28,30,
Adair,Superintendent of Public Instruction,Joy Hofmeister,REP,10007,0,1,25,26,
Adair,Superintendent of Public Instruction,Linda Murphy,REP,10007,0,1,38,39,
Adair,Commissioner of Labor,Cathy Costello,REP,10007,0,2,27,29,
Adair,Commissioner of Labor,Leslie Osborn,REP,10007,0,0,35,35,
Adair,Corporation Commissioner,Bob Anthony,REP,10007,0,1,32,33,
Adair,Corporation Commissioner,Brian Bingman,REP,10007,0,1,31,32,
Adair,Governor,Chris Powell,LIB,10007,0,0,0,0,
Adair,Governor,Rex Lawhorn,LIB,10007,0,0,0,0,
Adair,Corporation Commissioner,Ashley Nicole Mccray,DEM,10007,7,6,67,80,
Adair,Corporation Commissioner,Blake Cummings,DEM,10007,1,4,75,80,
Adair,U.S. House,Jason Nichols,DEM,10007,7,6,97,110,02
Adair,U.S. House,Clay Padgett,DEM,10007,1,4,49,54,02
Adair,Governor,Mick Cornett,REP,10008,0,0,13,13,
Adair,Governor,Kevin Stitt,REP,10008,0,3,35,38,
Adair,Lieutenant Governor,Dana Murphy,REP,10008,0,1,13,14,
Adair,Lieutenant Governor,Matt Pinnell,REP,10008,0,2,35,37,
Adair,State Auditor,Cindy Byrd,REP,10008,0,2,18,20,
Adair,State Auditor,Charlie Prater,REP,10008,0,1,30,31,
Adair,Attorney General,Mike Hunter,REP,10008,0,1,22,23,
Adair,Attorney General,Gentner Drummond,REP,10008,0,2,26,28,
Adair,Superintendent of Public Instruction,Joy Hofmeister,REP,10008,0,2,18,20,
Adair,Superintendent of Public Instruction,Linda Murphy,REP,10008,0,1,29,30,
Adair,Commissioner of Labor,Cathy Costello,REP,10008,0,1,17,18,
Adair,Commissioner of Labor,Leslie Osborn,REP,10008,0,2,30,32,
Adair,Corporation Commissioner,Bob Anthony,REP,10008,0,3,15,18,
Adair,Corporation Commissioner,Brian Bingman,REP,10008,0,0,33,33,
Adair,Governor,Chris Powell,LIB,10008,0,0,0,0,
Adair,Governor,Rex Lawhorn,LIB,10008,0,0,0,0,
Adair,Corporation Commissioner,Ashley Nicole Mccray,DEM,10008,0,3,18,21,
Adair,Corporation Commissioner,Blake Cummings,DEM,10008,0,1,19,20,
Adair,U.S. House,Jason Nichols,DEM,10008,0,1,21,22,02
Adair,U.S. House,Clay Padgett,DEM,10008,0,3,16,19,02
Adair,Governor,Mick Cornett,REP,10010,0,0,6,6,
Adair,Governor,Kevin Stitt,REP,10010,0,1,10,11,
Adair,Lieutenant Governor,Dana Murphy,REP,10010,0,0,6,6,
Adair,Lieutenant Governor,Matt Pinnell,REP,10010,0,1,10,11,
Adair,State Auditor,Cindy Byrd,REP,10010,0,1,5,6,
Adair,State Auditor,Charlie Prater,REP,10010,0,0,11,11,
Adair,Attorney General,Mike Hunter,REP,10010,0,0,6,6,
Adair,Attorney General,Gentner Drummond,REP,10010,0,1,10,11,
Adair,Superintendent of Public Instruction,Joy Hofmeister,REP,10010,0,0,7,7,
Adair,Superintendent of Public Instruction,Linda Murphy,REP,10010,0,1,9,10,
Adair,Commissioner of Labor,Cathy Costello,REP,10010,0,1,10,11,
Adair,Commissioner of Labor,Leslie Osborn,REP,10010,0,0,6,6,
Adair,Corporation Commissioner,Bob Anthony,REP,10010,0,1,5,6,
Adair,Corporation Commissioner,Brian Bingman,REP,10010,0,0,11,11,
Adair,Governor,Chris Powell,LIB,10010,0,0,0,0,
Adair,Governor,Rex Lawhorn,LIB,10010,0,0,0,0,
Adair,Corporation Commissioner,Ashley Nicole Mccray,DEM,10010,0,3,8,11,
Adair,Corporation Commissioner,Blake Cummings,DEM,10010,0,0,15,15,
Adair,U.S. House,Jason Nichols,DEM,10010,0,2,15,17,02
Adair,U.S. House,Clay Padgett,DEM,10010,0,1,8,9,02
Adair,Governor,Mick Cornett,REP,10011,0,0,8,8,
Adair,Governor,Kevin Stitt,REP,10011,0,0,6,6,
Adair,Lieutenant Governor,Dana Murphy,REP,10011,0,0,5,5,
Adair,Lieutenant Governor,Matt Pinnell,REP,10011,0,0,9,9,
Adair,State Auditor,Cindy Byrd,REP,10011,0,0,5,5,
Adair,State Auditor,Charlie Prater,REP,10011,0,0,9,9,
Adair,Attorney General,Mike Hunter,REP,10011,0,0,6,6,
Adair,Attorney General,Gentner Drummond,REP,10011,0,0,8,8,
Adair,Superintendent of Public Instruction,Joy Hofmeister,REP,10011,0,0,7,7,
Adair,Superintendent of Public Instruction,Linda Murphy,REP,10011,0,0,7,7,
Adair,Commissioner of Labor,Cathy Costello,REP,10011,0,0,3,3,
Adair,Commissioner of Labor,Leslie Osborn,REP,10011,0,0,11,11,
Adair,Corporation Commissioner,Bob Anthony,REP,10011,0,0,5,5,
Adair,Corporation Commissioner,Brian Bingman,REP,10011,0,0,9,9,
Adair,Governor,Chris Powell,LIB,10011,0,0,0,0,
Adair,Governor,Rex Lawhorn,LIB,10011,0,0,0,0,
Adair,Corporation Commissioner,Ashley Nicole Mccray,DEM,10011,0,0,5,5,
Adair,Corporation Commissioner,Blake Cummings,DEM,10011,0,3,14,17,
Adair,U.S. House,Jason Nichols,DEM,10011,0,2,11,13,02
Adair,U.S. House,Clay Padgett,DEM,10011,0,2,8,10,02
Adair,Governor,Mick Cornett,REP,10012,0,1,33,34,
Adair,Governor,Kevin Stitt,REP,10012,1,9,42,52,
Adair,Lieutenant Governor,Dana Murphy,REP,10012,0,4,17,21,
Adair,Lieutenant Governor,Matt Pinnell,REP,10012,1,6,58,65,
Adair,State Auditor,Cindy Byrd,REP,10012,0,3,24,27,
Adair,State Auditor,Charlie Prater,REP,10012,1,6,51,58,
Adair,Attorney General,Mike Hunter,REP,10012,0,2,28,30,
Adair,Attorney General,Gentner Drummond,REP,10012,1,7,46,54,
Adair,Superintendent of Public Instruction,Joy Hofmeister,REP,10012,0,4,35,39,
Adair,Superintendent of Public Instruction,Linda Murphy,REP,10012,0,6,40,46,
Adair,Commissioner of Labor,Cathy Costello,REP,10012,0,5,24,29,
Adair,Commissioner of Labor,Leslie Osborn,REP,10012,0,4,49,53,
Adair,Corporation Commissioner,Bob Anthony,REP,10012,0,5,26,31,
Adair,Corporation Commissioner,Brian Bingman,REP,10012,1,3,48,52,
Adair,Governor,Chris Powell,LIB,10012,0,0,0,0,
Adair,Governor,Rex Lawhorn,LIB,10012,0,0,0,0,
Adair,Corporation Commissioner,Ashley Nicole Mccray,DEM,10012,1,1,10,12,
Adair,Corporation Commissioner,Blake Cummings,DEM,10012,0,1,26,27,
Adair,U.S. House,Jason Nichols,DEM,10012,1,1,14,16,02
Adair,U.S. House,Clay Padgett,DEM,10012,0,1,22,23,02
Adair,Governor,Mick Cornett,REP,10013,2,0,11,13,
Adair,Governor,Kevin Stitt,REP,10013,0,2,23,25,
Adair,Lieutenant Governor,Dana Murphy,REP,10013,2,0,9,11,
Adair,Lieutenant Governor,Matt Pinnell,REP,10013,0,2,25,27,
Adair,State Auditor,Cindy Byrd,REP,10013,2,0,9,11,
Adair,State Auditor,Charlie Prater,REP,10013,0,2,25,27,
Adair,Attorney General,Mike Hunter,REP,10013,0,2,16,18,
Adair,Attorney General,Gentner Drummond,REP,10013,2,0,18,20,
Adair,Superintendent of Public Instruction,Joy Hofmeister,REP,10013,2,0,15,17,
Adair,Superintendent of Public Instruction,Linda Murphy,REP,10013,0,2,19,21,
Adair,Commissioner of Labor,Cathy Costello,REP,10013,2,2,5,9,
Adair,Commissioner of Labor,Leslie Osborn,REP,10013,0,0,29,29,
Adair,Corporation Commissioner,Bob Anthony,REP,10013,2,2,14,18,
Adair,Corporation Commissioner,Brian Bingman,REP,10013,0,0,20,20,
Adair,Governor,Chris Powell,LIB,10013,0,0,0,0,
Adair,Governor,Rex Lawhorn,LIB,10013,0,0,0,0,
Adair,Corporation Commissioner,Ashley Nicole Mccray,DEM,10013,3,1,20,24,
Adair,Corporation Commissioner,Blake Cummings,DEM,10013,6,2,29,37,
Adair,U.S. House,Jason Nichols,DEM,10013,7,1,34,42,02
Adair,U.S. House,Clay Padgett,DEM,10013,2,2,15,19,02
Adair,Governor,Mick Cornett,REP,10014,0,3,12,15,
Adair,Governor,Kevin Stitt,REP,10014,0,3,44,47,
Adair,Lieutenant Governor,Dana Murphy,REP,10014,0,4,24,28,
Adair,Lieutenant Governor,Matt Pinnell,REP,10014,0,2,32,34,
Adair,State Auditor,Cindy Byrd,REP,10014,0,4,24,28,
Adair,State Auditor,Charlie Prater,REP,10014,0,2,30,32,
Adair,Attorney General,Mike Hunter,REP,10014,0,2,22,24,
Adair,Attorney General,Gentner Drummond,REP,10014,0,4,34,38,
Adair,Superintendent of Public Instruction,Joy Hofmeister,REP,10014,0,2,18,20,
Adair,Superintendent of Public Instruction,Linda Murphy,REP,10014,0,4,38,42,
Adair,Commissioner of Labor,Cathy Costello,REP,10014,0,2,25,27,
Adair,Commissioner of Labor,Leslie Osborn,REP,10014,0,3,31,34,
Adair,Corporation Commissioner,Bob Anthony,REP,10014,0,1,23,24,
Adair,Corporation Commissioner,Brian Bingman,REP,10014,0,3,33,36,
Adair,Governor,Chris Powell,LIB,10014,0,0,0,0,
Adair,Governor,Rex Lawhorn,LIB,10014,0,0,0,0,
Adair,Corporation Commissioner,Ashley Nicole Mccray,DEM,10014,3,6,35,44,
Adair,Corporation Commissioner,Blake Cummings,DEM,10014,1,2,22,25,
Adair,U.S. House,Jason Nichols,DEM,10014,3,2,38,43,02
Adair,U.S. House,Clay Padgett,DEM,10014,1,5,19,25,02
Adair,Governor,Mick Cornett,REP,10016,1,0,27,28,
Adair,Governor,Kevin Stitt,REP,10016,2,0,36,38,
Adair,Lieutenant Governor,Dana Murphy,REP,10016,2,0,25,27,
Adair,Lieutenant Governor,Matt Pinnell,REP,10016,1,0,38,39,
Adair,State Auditor,Cindy Byrd,REP,10016,1,0,24,25,
Adair,State Auditor,Charlie Prater,REP,10016,2,0,38,40,
Adair,Attorney General,Mike Hunter,REP,10016,1,0,26,27,
Adair,Attorney General,Gentner Drummond,REP,10016,2,0,37,39,
Adair,Superintendent of Public Instruction,Joy Hofmeister,REP,10016,1,0,31,32,
Adair,Superintendent of Public Instruction,Linda Murphy,REP,10016,2,0,32,34,
Adair,Commissioner of Labor,Cathy Costello,REP,10016,3,0,29,32,
Adair,Commissioner of Labor,Leslie Osborn,REP,10016,0,0,34,34,
Adair,Corporation Commissioner,Bob Anthony,REP,10016,1,0,31,32,
Adair,Corporation Commissioner,Brian Bingman,REP,10016,2,0,32,34,
Adair,Governor,Chris Powell,LIB,10016,0,0,0,0,
Adair,Governor,Rex Lawhorn,LIB,10016,0,0,0,0,
Adair,Corporation Commissioner,Ashley Nicole Mccray,DEM,10016,2,0,15,17,
Adair,Corporation Commissioner,Blake Cummings,DEM,10016,0,1,11,12,
Adair,U.S. House,Jason Nichols,DEM,10016,1,1,23,25,02
Adair,U.S. House,Clay Padgett,DEM,10016,1,0,3,4,02
Adair,Governor,Mick Cornett,REP,10017,1,0,21,22,
Adair,Governor,Kevin Stitt,REP,10017,0,0,35,35,
Adair,Lieutenant Governor,Dana Murphy,REP,10017,1,0,22,23,
Adair,Lieutenant Governor,Matt Pinnell,REP,10017,0,0,34,34,
Adair,State Auditor,Cindy Byrd,REP,10017,1,0,29,30,
Adair,State Auditor,Charlie Prater,REP,10017,0,0,29,29,
Adair,Attorney General,Mike Hunter,REP,10017,1,0,27,28,
Adair,Attorney General,Gentner Drummond,REP,10017,0,0,31,31,
Adair,Superintendent of Public Instruction,Joy Hofmeister,REP,10017,0,0,30,30,
Adair,Superintendent of Public Instruction,Linda Murphy,REP,10017,1,0,26,27,
Adair,Commissioner of Labor,Cathy Costello,REP,10017,0,0,31,31,
Adair,Commissioner of Labor,Leslie Osborn,REP,10017,1,0,25,26,
Adair,Corporation Commissioner,Bob Anthony,REP,10017,1,0,30,31,
Adair,Corporation Commissioner,Brian Bingman,REP,10017,0,0,26,26,
Adair,Governor,Chris Powell,LIB,10017,0,0,0,0,
Adair,Governor,Rex Lawhorn,LIB,10017,0,0,0,0,
Adair,Corporation Commissioner,Ashley Nicole Mccray,DEM,10017,0,0,32,32,
Adair,Corporation Commissioner,Blake Cummings,DEM,10017,0,0,24,24,
Adair,U.S. House,Jason Nichols,DEM,10017,0,0,46,46,02
Adair,U.S. House,Clay Padgett,DEM,10017,0,0,11,11,02
Adair,Governor,Mick Cornett,REP,10018,0,0,17,17,
Adair,Governor,Kevin Stitt,REP,10018,0,0,35,35,
Adair,Lieutenant Governor,Dana Murphy,REP,10018,0,0,18,18,
Adair,Lieutenant Governor,Matt Pinnell,REP,10018,0,0,33,33,
Adair,State Auditor,Cindy Byrd,REP,10018,0,0,29,29,
Adair,State Auditor,Charlie Prater,REP,10018,0,0,20,20,
Adair,Attorney General,Mike Hunter,REP,10018,0,0,21,21,
Adair,Attorney General,Gentner Drummond,REP,10018,0,0,30,30,
Adair,Superintendent of Public Instruction,Joy Hofmeister,REP,10018,0,0,23,23,
Adair,Superintendent of Public Instruction,Linda Murphy,REP,10018,0,0,27,27,
Adair,Commissioner of Labor,Cathy Costello,REP,10018,0,0,22,22,
Adair,Commissioner of Labor,Leslie Osborn,REP,10018,0,0,26,26,
Adair,Corporation Commissioner,Bob Anthony,REP,10018,0,0,17,17,
Adair,Corporation Commissioner,Brian Bingman,REP,10018,0,0,30,30,
Adair,Governor,Chris Powell,LIB,10018,0,0,0,0,
Adair,Governor,Rex Lawhorn,LIB,10018,0,0,0,0,
Adair,Corporation Commissioner,Ashley Nicole Mccray,DEM,10018,0,5,31,36,
Adair,Corporation Commissioner,Blake Cummings,DEM,10018,0,4,28,32,
Adair,U.S. House,Jason Nichols,DEM,10018,0,6,42,48,02
Adair,U.S. House,Clay Padgett,DEM,10018,0,3,17,20,02
Adair,Governor,Mick Cornett,REP,10019,0,2,34,36,
Adair,Governor,Kevin Stitt,REP,10019,0,5,76,81,
Adair,Lieutenant Governor,Dana Murphy,REP,10019,0,1,28,29,
Adair,Lieutenant Governor,Matt Pinnell,REP,10019,0,6,79,85,
Adair,State Auditor,Cindy Byrd,REP,10019,0,4,51,55,
Adair,State Auditor,Charlie Prater,REP,10019,0,3,55,58,
Adair,Attorney General,Mike Hunter,REP,10019,0,3,47,50,
Adair,Attorney General,Gentner Drummond,REP,10019,0,4,63,67,
Adair,Superintendent of Public Instruction,Joy Hofmeister,REP,10019,0,3,59,62,
Adair,Superintendent of Public Instruction,Linda Murphy,REP,10019,0,4,49,53,
Adair,Commissioner of Labor,Cathy Costello,REP,10019,0,5,40,45,
Adair,Commissioner of Labor,Leslie Osborn,REP,10019,0,2,67,69,
Adair,Corporation Commissioner,Bob Anthony,REP,10019,0,4,32,36,
Adair,Corporation Commissioner,Brian Bingman,REP,10019,0,3,73,76,
Adair,Governor,Chris Powell,LIB,10019,0,0,1,1,
Adair,Governor,Rex Lawhorn,LIB,10019,0,0,0,0,
Adair,Corporation Commissioner,Ashley Nicole Mccray,DEM,10019,1,0,47,48,
Adair,Corporation Commissioner,Blake Cummings,DEM,10019,0,0,30,30,
Adair,U.S. House,Jason Nichols,DEM,10019,0,0,57,57,02
Adair,U.S. House,Clay Padgett,DEM,10019,1,0,20,21,02
Alfalfa,Governor,Mick Cornett,REP,20110,0,1,28,29,
Alfalfa,Governor,Kevin Stitt,REP,20110,1,0,60,61,
Alfalfa,Lieutenant Governor,Dana Murphy,REP,20110,1,1,34,36,
Alfalfa,Lieutenant Governor,Matt Pinnell,REP,20110,0,0,53,53,
Alfalfa,State Auditor,Cindy Byrd,REP,20110,1,1,39,41,
Alfalfa,State Auditor,Charlie Prater,REP,20110,0,0,49,49,
Alfalfa,Attorney General,Mike Hunter,REP,20110,1,1,52,54,
Alfalfa,Attorney General,Gentner Drummond,REP,20110,0,0,35,35,
Alfalfa,Superintendent of Public Instruction,Joy Hofmeister,REP,20110,0,1,64,65,
Alfalfa,Superintendent of Public Instruction,Linda Murphy,REP,20110,1,0,24,25,
Alfalfa,Commissioner of Labor,Cathy Costello,REP,20110,1,0,29,30,
Alfalfa,Commissioner of Labor,Leslie Osborn,REP,20110,0,1,57,58,
Alfalfa,Corporation Commissioner,Bob Anthony,REP,20110,1,0,53,54,
Alfalfa,Corporation Commissioner,Brian Bingman,REP,20110,0,1,34,35,
Alfalfa,Governor,Chris Powell,LIB,20110,0,0,0,0,
Alfalfa,Governor,Rex Lawhorn,LIB,20110,0,0,0,0,
Alfalfa,Corporation Commissioner,Ashley Nicole Mccray,DEM,20110,0,0,6,6,
Alfalfa,Corporation Commissioner,Blake Cummings,DEM,20110,0,0,10,10,
Alfalfa,Governor,Mick Cornett,REP,20120,2,4,30,36,
Alfalfa,Governor,Kevin Stitt,REP,20120,2,0,41,43,
Alfalfa,Lieutenant Governor,Dana Murphy,REP,20120,2,2,32,36,
Alfalfa,Lieutenant Governor,Matt Pinnell,REP,20120,2,0,38,40,
Alfalfa,State Auditor,Cindy Byrd,REP,20120,4,2,37,43,
Alfalfa,State Auditor,Charlie Prater,REP,20120,0,0,32,32,
Alfalfa,Attorney General,Mike Hunter,REP,20120,4,1,28,33,
Alfalfa,Attorney General,Gentner Drummond,REP,20120,0,2,42,44,
Alfalfa,Superintendent of Public Instruction,Joy Hofmeister,REP,20120,2,1,41,44,
Alfalfa,Superintendent of Public Instruction,Linda Murphy,REP,20120,2,3,30,35,
Alfalfa,Commissioner of Labor,Cathy Costello,REP,20120,2,1,29,32,
Alfalfa,Commissioner of Labor,Leslie Osborn,REP,20120,2,1,40,43,
Alfalfa,Corporation Commissioner,Bob Anthony,REP,20120,2,2,35,39,
Alfalfa,Corporation Commissioner,Brian Bingman,REP,20120,2,0,35,37,
Alfalfa,Governor,Chris Powell,LIB,20120,0,0,0,0,
Alfalfa,Governor,Rex Lawhorn,LIB,20120,0,0,2,2,
Alfalfa,Corporation Commissioner,Ashley Nicole Mccray,DEM,20120,0,0,8,8,
Alfalfa,Corporation Commissioner,Blake Cummings,DEM,20120,0,0,7,7,
Alfalfa,Governor,Mick Cornett,REP,20140,2,7,85,94,
Alfalfa,Governor,Kevin Stitt,REP,20140,2,2,37,41,
Alfalfa,Lieutenant Governor,Dana Murphy,REP,20140,3,5,66,74,
Alfalfa,Lieutenant Governor,Matt Pinnell,REP,20140,0,4,56,60,
Alfalfa,State Auditor,Cindy Byrd,REP,20140,2,7,56,65,
Alfalfa,State Auditor,Charlie Prater,REP,20140,0,2,65,67,
Alfalfa,Attorney General,Mike Hunter,REP,20140,0,5,63,68,
Alfalfa,Attorney General,Gentner Drummond,REP,20140,2,4,59,65,
Alfalfa,Superintendent of Public Instruction,Joy Hofmeister,REP,20140,1,4,66,71,
Alfalfa,Superintendent of Public Instruction,Linda Murphy,REP,20140,2,5,55,62,
Alfalfa,Commissioner of Labor,Cathy Costello,REP,20140,1,2,52,55,
Alfalfa,Commissioner of Labor,Leslie Osborn,REP,20140,1,7,67,75,
Alfalfa,Corporation Commissioner,Bob Anthony,REP,20140,1,6,68,75,
Alfalfa,Corporation Commissioner,Brian Bingman,REP,20140,2,3,53,58,
Alfalfa,Governor,Chris Powell,LIB,20140,0,0,0,0,
Alfalfa,Governor,Rex Lawhorn,LIB,20140,0,0,1,1,
Alfalfa,Corporation Commissioner,Ashley Nicole Mccray,DEM,20140,0,0,10,10,
Alfalfa,Corporation Commissioner,Blake Cummings,DEM,20140,0,1,7,8,
Alfalfa,Governor,Mick Cornett,REP,20220,1,8,89,98,
Alfalfa,Governor,Kevin Stitt,REP,20220,3,14,62,79,
Alfalfa,Lieutenant Governor,Dana Murphy,REP,20220,2,12,85,99,
Alfalfa,Lieutenant Governor,Matt Pinnell,REP,20220,2,10,65,77,
Alfalfa,State Auditor,Cindy Byrd,REP,20220,1,11,81,93,
Alfalfa,State Auditor,Charlie Prater,REP,20220,3,11,65,79,
Alfalfa,Attorney General,Mike Hunter,REP,20220,1,5,77,83,
Alfalfa,Attorney General,Gentner Drummond,REP,20220,3,17,72,92,
Alfalfa,Superintendent of Public Instruction,Joy Hofmeister,REP,20220,2,10,87,99,
Alfalfa,Superintendent of Public Instruction,Linda Murphy,REP,20220,2,12,60,74,
Alfalfa,Commissioner of Labor,Cathy Costello,REP,20220,4,6,54,64,
Alfalfa,Commissioner of Labor,Leslie Osborn,REP,20220,0,16,93,109,
Alfalfa,Corporation Commissioner,Bob Anthony,REP,20220,1,13,89,103,
Alfalfa,Corporation Commissioner,Brian Bingman,REP,20220,3,9,58,70,
Alfalfa,Governor,Chris Powell,LIB,20220,0,0,0,0,
Alfalfa,Governor,Rex Lawhorn,LIB,20220,0,0,1,1,
Alfalfa,Corporation Commissioner,Ashley Nicole Mccray,DEM,20220,0,1,8,9,
Alfalfa,Corporation Commissioner,Blake Cummings,DEM,20220,3,1,14,18,
Alfalfa,Governor,Mick Cornett,REP,20230,3,2,52,57,
Alfalfa,Governor,Kevin Stitt,REP,20230,1,2,52,55,
Alfalfa,Lieutenant Governor,Dana Murphy,REP,20230,3,2,52,57,
Alfalfa,Lieutenant Governor,Matt Pinnell,REP,20230,1,2,54,57,
Alfalfa,State Auditor,Cindy Byrd,REP,20230,2,2,45,49,
Alfalfa,State Auditor,Charlie Prater,REP,20230,2,2,59,63,
Alfalfa,Attorney General,Mike Hunter,REP,20230,1,3,51,55,
Alfalfa,Attorney General,Gentner Drummond,REP,20230,3,1,53,57,
Alfalfa,Superintendent of Public Instruction,Joy Hofmeister,REP,20230,1,3,54,58,
Alfalfa,Superintendent of Public Instruction,Linda Murphy,REP,20230,3,1,50,54,
Alfalfa,Commissioner of Labor,Cathy Costello,REP,20230,1,1,44,46,
Alfalfa,Commissioner of Labor,Leslie Osborn,REP,20230,3,3,59,65,
Alfalfa,Corporation Commissioner,Bob Anthony,REP,20230,3,1,53,57,
Alfalfa,Corporation Commissioner,Brian Bingman,REP,20230,1,3,50,54,
Alfalfa,Governor,Chris Powell,LIB,20230,0,0,0,0,
Alfalfa,Governor,Rex Lawhorn,LIB,20230,0,0,0,0,
Alfalfa,Corporation Commissioner,Ashley Nicole Mccray,DEM,20230,2,0,7,9,
Alfalfa,Corporation Commissioner,Blake Cummings,DEM,20230,0,0,7,7,
Alfalfa,Governor,Mick Cornett,REP,20310,1,1,58,60,
Alfalfa,Governor,Kevin Stitt,REP,20310,2,5,55,62,
Alfalfa,Lieutenant Governor,Dana Murphy,REP,20310,0,2,45,47,
Alfalfa,Lieutenant Governor,Matt Pinnell,REP,20310,3,4,68,75,
Alfalfa,State Auditor,Cindy Byrd,REP,20310,0,3,40,43,
Alfalfa,State Auditor,Charlie Prater,REP,20310,3,3,73,79,
Alfalfa,Attorney General,Mike Hunter,REP,20310,1,2,55,58,
Alfalfa,Attorney General,Gentner Drummond,REP,20310,2,4,57,63,
Alfalfa,Superintendent of Public Instruction,Joy Hofmeister,REP,20310,2,4,77,83,
Alfalfa,Superintendent of Public Instruction,Linda Murphy,REP,20310,0,2,36,38,
Alfalfa,Commissioner of Labor,Cathy Costello,REP,20310,1,4,45,50,
Alfalfa,Commissioner of Labor,Leslie Osborn,REP,20310,2,2,67,71,
Alfalfa,Corporation Commissioner,Bob Anthony,REP,20310,3,3,62,68,
Alfalfa,Corporation Commissioner,Brian Bingman,REP,20310,0,3,50,53,
Alfalfa,Governor,Chris Powell,LIB,20310,0,0,2,2,
Alfalfa,Governor,Rex Lawhorn,LIB,20310,0,0,0,0,
Alfalfa,Corporation Commissioner,Ashley Nicole Mccray,DEM,20310,3,0,15,18,
Alfalfa,Corporation Commissioner,Blake Cummings,DEM,20310,0,0,9,9,
Alfalfa,Governor,Mick Cornett,REP,20320,0,0,31,31,
Alfalfa,Governor,Kevin Stitt,REP,20320,0,0,50,50,
Alfalfa,Lieutenant Governor,Dana Murphy,REP,20320,0,0,36,36,
Alfalfa,Lieutenant Governor,Matt Pinnell,REP,20320,0,0,44,44,
Alfalfa,State Auditor,Cindy Byrd,REP,20320,0,0,27,27,
Alfalfa,State Auditor,Charlie Prater,REP,20320,0,0,51,51,
Alfalfa,Attorney General,Mike Hunter,REP,20320,0,0,35,35,
Alfalfa,Attorney General,Gentner Drummond,REP,20320,0,0,46,46,
Alfalfa,Superintendent of Public Instruction,Joy Hofmeister,REP,20320,0,0,45,45,
Alfalfa,Superintendent of Public Instruction,Linda Murphy,REP,20320,0,0,33,33,
Alfalfa,Commissioner of Labor,Cathy Costello,REP,20320,0,0,42,42,
Alfalfa,Commissioner of Labor,Leslie Osborn,REP,20320,0,0,37,37,
Alfalfa,Corporation Commissioner,Bob Anthony,REP,20320,0,0,35,35,
Alfalfa,Corporation Commissioner,Brian Bingman,REP,20320,0,0,43,43,
Alfalfa,Governor,Chris Powell,LIB,20320,0,0,0,0,
Alfalfa,Governor,Rex Lawhorn,LIB,20320,0,0,0,0,
Alfalfa,Corporation Commissioner,Ashley Nicole Mccray,DEM,20320,0,0,4,4,
Alfalfa,Corporation Commissioner,Blake Cummings,DEM,20320,0,0,2,2,
Alfalfa,Governor,Mick Cornett,REP,20330,1,4,32,37,
Alfalfa,Governor,Kevin Stitt,REP,20330,0,3,42,45,
Alfalfa,Lieutenant Governor,Dana Murphy,REP,20330,0,4,33,37,
Alfalfa,Lieutenant Governor,Matt Pinnell,REP,20330,1,3,39,43,
Alfalfa,State Auditor,Cindy Byrd,REP,20330,1,2,21,24,
Alfalfa,State Auditor,Charlie Prater,REP,20330,0,4,52,56,
Alfalfa,Attorney General,Mike Hunter,REP,20330,0,1,30,31,
Alfalfa,Attorney General,Gentner Drummond,REP,20330,1,6,43,50,
Alfalfa,Superintendent of Public Instruction,Joy Hofmeister,REP,20330,0,4,48,52,
Alfalfa,Superintendent of Public Instruction,Linda Murphy,REP,20330,1,3,25,29,
Alfalfa,Commissioner of Labor,Cathy Costello,REP,20330,1,4,22,27,
Alfalfa,Commissioner of Labor,Leslie Osborn,REP,20330,0,3,51,54,
Alfalfa,Corporation Commissioner,Bob Anthony,REP,20330,1,5,37,43,
Alfalfa,Corporation Commissioner,Brian Bingman,REP,20330,0,2,37,39,
Alfalfa,Governor,Chris Powell,LIB,20330,0,0,0,0,
Alfalfa,Governor,Rex Lawhorn,LIB,20330,0,0,0,0,
Alfalfa,Corporation Commissioner,Ashley Nicole Mccray,DEM,20330,0,0,5,5,
Alfalfa,Corporation Commissioner,Blake Cummings,DEM,20330,0,0,3,3,
Atoka,Governor,Mick Cornett,REP,30001,0,1,10,11,
Atoka,Governor,Kevin Stitt,REP,30001,1,3,23,27,
Atoka,Lieutenant Governor,Dana Murphy,REP,30001,0,1,16,17,
Atoka,Lieutenant Governor,Matt Pinnell,REP,30001,1,3,18,22,
Atoka,State Auditor,Cindy Byrd,REP,30001,1,3,19,23,
Atoka,State Auditor,Charlie Prater,REP,30001,0,1,16,17,
Atoka,Attorney General,Mike Hunter,REP,30001,0,3,18,21,
Atoka,Attorney General,Gentner Drummond,REP,30001,1,1,16,18,
Atoka,Superintendent of Public Instruction,Joy Hofmeister,REP,30001,0,0,14,14,
Atoka,Superintendent of Public Instruction,Linda Murphy,REP,30001,1,4,20,25,
Atoka,Commissioner of Labor,Cathy Costello,REP,30001,1,2,15,18,
Atoka,Commissioner of Labor,Leslie Osborn,REP,30001,0,2,18,20,
Atoka,Corporation Commissioner,Bob Anthony,REP,30001,0,3,17,20,
Atoka,Corporation Commissioner,Brian Bingman,REP,30001,1,1,17,19,
Atoka,Governor,Chris Powell,LIB,30001,0,0,0,0,
Atoka,Governor,Rex Lawhorn,LIB,30001,0,0,0,0,
Atoka,Corporation Commissioner,Ashley Nicole Mccray,DEM,30001,0,7,50,57,
Atoka,Corporation Commissioner,Blake Cummings,DEM,30001,3,12,50,65,
Atoka,U.S. House,Jason Nichols,DEM,30001,1,3,36,40,02
Atoka,U.S. House,Clay Padgett,DEM,30001,2,16,66,84,02
Atoka,Governor,Mick Cornett,REP,30002,1,1,12,14,
Atoka,Governor,Kevin Stitt,REP,30002,4,5,24,33,
Atoka,Lieutenant Governor,Dana Murphy,REP,30002,2,0,10,12,
Atoka,Lieutenant Governor,Matt Pinnell,REP,30002,3,5,23,31,
Atoka,State Auditor,Cindy Byrd,REP,30002,4,2,25,31,
Atoka,State Auditor,Charlie Prater,REP,30002,1,3,9,13,
Atoka,Attorney General,Mike Hunter,REP,30002,2,1,11,14,
Atoka,Attorney General,Gentner Drummond,REP,30002,3,4,25,32,
Atoka,Superintendent of Public Instruction,Joy Hofmeister,REP,30002,3,3,25,31,
Atoka,Superintendent of Public Instruction,Linda Murphy,REP,30002,2,2,11,15,
Atoka,Commissioner of Labor,Cathy Costello,REP,30002,3,5,21,29,
Atoka,Commissioner of Labor,Leslie Osborn,REP,30002,2,0,13,15,
Atoka,Corporation Commissioner,Bob Anthony,REP,30002,3,3,19,25,
Atoka,Corporation Commissioner,Brian Bingman,REP,30002,2,2,15,19,
Atoka,Governor,Chris Powell,LIB,30002,0,0,0,0,
Atoka,Governor,Rex Lawhorn,LIB,30002,0,0,0,0,
Atoka,Corporation Commissioner,Ashley Nicole Mccray,DEM,30002,1,3,19,23,
Atoka,Corporation Commissioner,Blake Cummings,DEM,30002,1,1,28,30,
Atoka,U.S. House,Jason Nichols,DEM,30002,0,1,20,21,02
Atoka,U.S. House,Clay Padgett,DEM,30002,1,3,27,31,02
Atoka,Governor,Mick Cornett,REP,30003,0,0,5,5,
Atoka,Governor,Kevin Stitt,REP,30003,2,1,14,17,
Atoka,Lieutenant Governor,Dana Murphy,REP,30003,1,0,5,6,
Atoka,Lieutenant Governor,Matt Pinnell,REP,30003,1,1,13,15,
Atoka,State Auditor,Cindy Byrd,REP,30003,2,1,11,14,
Atoka,State Auditor,Charlie Prater,REP,30003,0,0,8,8,
Atoka,Attorney General,Mike Hunter,REP,30003,2,0,8,10,
Atoka,Attorney General,Gentner Drummond,REP,30003,0,1,11,12,
Atoka,Superintendent of Public Instruction,Joy Hofmeister,REP,30003,0,0,11,11,
Atoka,Superintendent of Public Instruction,Linda Murphy,REP,30003,2,1,8,11,
Atoka,Commissioner of Labor,Cathy Costello,REP,30003,2,1,12,15,
Atoka,Commissioner of Labor,Leslie Osborn,REP,30003,0,0,7,7,
Atoka,Corporation Commissioner,Bob Anthony,REP,30003,2,1,11,14,
Atoka,Corporation Commissioner,Brian Bingman,REP,30003,0,0,7,7,
Atoka,Governor,Chris Powell,LIB,30003,0,0,0,0,
Atoka,Governor,Rex Lawhorn,LIB,30003,0,0,0,0,
Atoka,Corporation Commissioner,Ashley Nicole Mccray,DEM,30003,0,6,15,21,
Atoka,Corporation Commissioner,Blake Cummings,DEM,30003,0,5,19,24,
Atoka,U.S. House,Jason Nichols,DEM,30003,0,1,13,14,02
Atoka,U.S. House,Clay Padgett,DEM,30003,0,10,20,30,02
Atoka,Governor,Mick Cornett,REP,30006,0,1,7,8,
Atoka,Governor,Kevin Stitt,REP,30006,0,2,11,13,
Atoka,Lieutenant Governor,Dana Murphy,REP,30006,0,2,8,10,
Atoka,Lieutenant Governor,Matt Pinnell,REP,30006,0,1,11,12,
Atoka,State Auditor,Cindy Byrd,REP,30006,0,4,10,14,
Atoka,State Auditor,Charlie Prater,REP,30006,0,0,8,8,
Atoka,Attorney General,Mike Hunter,REP,30006,0,0,9,9,
Atoka,Attorney General,Gentner Drummond,REP,30006,0,3,9,12,
Atoka,Superintendent of Public Instruction,Joy Hofmeister,REP,30006,0,0,7,7,
Atoka,Superintendent of Public Instruction,Linda Murphy,REP,30006,0,3,12,15,
Atoka,Commissioner of Labor,Cathy Costello,REP,30006,0,3,13,16,
Atoka,Commissioner of Labor,Leslie Osborn,REP,30006,0,1,6,7,
Atoka,Corporation Commissioner,Bob Anthony,REP,30006,0,2,12,14,
Atoka,Corporation Commissioner,Brian Bingman,REP,30006,0,1,7,8,
Atoka,Governor,Chris Powell,LIB,30006,0,0,0,0,
Atoka,Governor,Rex Lawhorn,LIB,30006,0,0,0,0,
Atoka,Corporation Commissioner,Ashley Nicole Mccray,DEM,30006,1,3,10,14,
Atoka,Corporation Commissioner,Blake Cummings,DEM,30006,0,3,13,16,
Atoka,U.S. House,Jason Nichols,DEM,30006,1,2,6,9,02
Atoka,U.S. House,Clay Padgett,DEM,30006,0,4,17,21,02
Atoka,Governor,Mick Cornett,REP,30007,0,1,8,9,
Atoka,Governor,Kevin Stitt,REP,30007,2,3,30,35,
Atoka,Lieutenant Governor,Dana Murphy,REP,30007,0,2,14,16,
Atoka,Lieutenant Governor,Matt Pinnell,REP,30007,2,2,25,29,
Atoka,State Auditor,Cindy Byrd,REP,30007,1,3,29,33,
Atoka,State Auditor,Charlie Prater,REP,30007,1,1,7,9,
Atoka,Attorney General,Mike Hunter,REP,30007,1,2,18,21,
Atoka,Attorney General,Gentner Drummond,REP,30007,1,2,20,23,
Atoka,Superintendent of Public Instruction,Joy Hofmeister,REP,30007,2,1,19,22,
Atoka,Superintendent of Public Instruction,Linda Murphy,REP,30007,0,3,20,23,
Atoka,Commissioner of Labor,Cathy Costello,REP,30007,0,0,22,22,
Atoka,Commissioner of Labor,Leslie Osborn,REP,30007,2,3,15,20,
Atoka,Corporation Commissioner,Bob Anthony,REP,30007,1,4,22,27,
Atoka,Corporation Commissioner,Brian Bingman,REP,30007,1,0,14,15,
Atoka,Governor,Chris Powell,LIB,30007,0,0,0,0,
Atoka,Governor,Rex Lawhorn,LIB,30007,0,0,0,0,
Atoka,Corporation Commissioner,Ashley Nicole Mccray,DEM,30007,0,1,28,29,
Atoka,Corporation Commissioner,Blake Cummings,DEM,30007,0,0,28,28,
Atoka,U.S. House,Jason Nichols,DEM,30007,0,0,25,25,02
Atoka,U.S. House,Clay Padgett,DEM,30007,0,1,31,32,02
Atoka,Governor,Mick Cornett,REP,30008,0,0,11,11,
Atoka,Governor,Kevin Stitt,REP,30008,0,0,30,30,
Atoka,Lieutenant Governor,Dana Murphy,REP,30008,0,0,13,13,
Atoka,Lieutenant Governor,Matt Pinnell,REP,30008,0,0,27,27,
Atoka,State Auditor,Cindy Byrd,REP,30008,0,0,23,23,
Atoka,State Auditor,Charlie Prater,REP,30008,0,0,16,16,
Atoka,Attorney General,Mike Hunter,REP,30008,0,0,13,13,
Atoka,Attorney General,Gentner Drummond,REP,30008,0,0,27,27,
Atoka,Superintendent of Public Instruction,Joy Hofmeister,REP,30008,0,0,13,13,
Atoka,Superintendent of Public Instruction,Linda Murphy,REP,30008,0,0,26,26,
Atoka,Commissioner of Labor,Cathy Costello,REP,30008,0,0,21,21,
Atoka,Commissioner of Labor,Leslie Osborn,REP,30008,0,0,19,19,
Atoka,Corporation Commissioner,Bob Anthony,REP,30008,0,0,24,24,
Atoka,Corporation Commissioner,Brian Bingman,REP,30008,0,0,16,16,
Atoka,Governor,Chris Powell,LIB,30008,0,0,0,0,
Atoka,Governor,Rex Lawhorn,LIB,30008,0,0,0,0,
Atoka,Corporation Commissioner,Ashley Nicole Mccray,DEM,30008,0,2,12,14,
Atoka,Corporation Commissioner,Blake Cummings,DEM,30008,2,0,31,33,
Atoka,U.S. House,Jason Nichols,DEM,30008,0,0,16,16,02
Atoka,U.S. House,Clay Padgett,DEM,30008,2,2,27,31,02
Atoka,Governor,Mick Cornett,REP,30009,1,0,7,8,
Atoka,Governor,Kevin Stitt,REP,30009,3,1,13,17,
Atoka,Lieutenant Governor,Dana Murphy,REP,30009,0,0,3,3,
Atoka,Lieutenant Governor,Matt Pinnell,REP,30009,4,1,18,23,
Atoka,State Auditor,Cindy Byrd,REP,30009,0,1,13,14,
Atoka,State Auditor,Charlie Prater,REP,30009,4,0,8,12,
Atoka,Attorney General,Mike Hunter,REP,30009,2,1,11,14,
Atoka,Attorney General,Gentner Drummond,REP,30009,2,0,10,12,
Atoka,Superintendent of Public Instruction,Joy Hofmeister,REP,30009,0,1,5,6,
Atoka,Superintendent of Public Instruction,Linda Murphy,REP,30009,4,0,15,19,
Atoka,Commissioner of Labor,Cathy Costello,REP,30009,0,1,10,11,
Atoka,Commissioner of Labor,Leslie Osborn,REP,30009,4,0,11,15,
Atoka,Corporation Commissioner,Bob Anthony,REP,30009,1,1,10,12,
Atoka,Corporation Commissioner,Brian Bingman,REP,30009,3,0,10,13,
Atoka,Governor,Chris Powell,LIB,30009,0,0,0,0,
Atoka,Governor,Rex Lawhorn,LIB,30009,0,0,0,0,
Atoka,Corporation Commissioner,Ashley Nicole Mccray,DEM,30009,3,6,16,25,
Atoka,Corporation Commissioner,Blake Cummings,DEM,30009,0,5,13,18,
Atoka,U.S. House,Jason Nichols,DEM,30009,0,0,5,5,02
Atoka,U.S. House,Clay Padgett,DEM,30009,3,11,24,38,02
Atoka,Governor,Mick Cornett,REP,30010,0,0,4,4,
Atoka,Governor,Kevin Stitt,REP,30010,0,0,7,7,
Atoka,Lieutenant Governor,Dana Murphy,REP,30010,0,0,4,4,
Atoka,Lieutenant Governor,Matt Pinnell,REP,30010,0,0,6,6,
Atoka,State Auditor,Cindy Byrd,REP,30010,0,0,4,4,
Atoka,State Auditor,Charlie Prater,REP,30010,0,0,6,6,
Atoka,Attorney General,Mike Hunter,REP,30010,0,0,5,5,
Atoka,Attorney General,Gentner Drummond,REP,30010,0,0,4,4,
Atoka,Superintendent of Public Instruction,Joy Hofmeister,REP,30010,0,0,4,4,
Atoka,Superintendent of Public Instruction,Linda Murphy,REP,30010,0,0,5,5,
Atoka,Commissioner of Labor,Cathy Costello,REP,30010,0,0,6,6,
Atoka,Commissioner of Labor,Leslie Osborn,REP,30010,0,0,3,3,
Atoka,Corporation Commissioner,Bob Anthony,REP,30010,0,0,4,4,
Atoka,Corporation Commissioner,Brian Bingman,REP,30010,0,0,6,6,
Atoka,Governor,Chris Powell,LIB,30010,0,0,0,0,
Atoka,Governor,Rex Lawhorn,LIB,30010,0,0,0,0,
Atoka,Corporation Commissioner,Ashley Nicole Mccray,DEM,30010,0,0,21,21,
Atoka,Corporation Commissioner,Blake Cummings,DEM,30010,0,1,13,14,
Atoka,U.S. House,Jason Nichols,DEM,30010,0,0,19,19,02
Atoka,U.S. House,Clay Padgett,DEM,30010,0,1,17,18,02
Atoka,Governor,Mick Cornett,REP,30011,0,1,7,8,
Atoka,Governor,Kevin Stitt,REP,30011,0,5,51,56,
Atoka,Lieutenant Governor,Dana Murphy,REP,30011,0,1,18,19,
Atoka,Lieutenant Governor,Matt Pinnell,REP,30011,0,5,39,44,
Atoka,State Auditor,Cindy Byrd,REP,30011,0,4,33,37,
Atoka,State Auditor,Charlie Prater,REP,30011,0,2,21,23,
Atoka,Attorney General,Mike Hunter,REP,30011,0,4,25,29,
Atoka,Attorney General,Gentner Drummond,REP,30011,0,2,33,35,
Atoka,Superintendent of Public Instruction,Joy Hofmeister,REP,30011,0,6,27,33,
Atoka,Superintendent of Public Instruction,Linda Murphy,REP,30011,0,0,29,29,
Atoka,Commissioner of Labor,Cathy Costello,REP,30011,0,5,28,33,
Atoka,Commissioner of Labor,Leslie Osborn,REP,30011,0,1,23,24,
Atoka,Corporation Commissioner,Bob Anthony,REP,30011,0,3,21,24,
Atoka,Corporation Commissioner,Brian Bingman,REP,30011,0,3,28,31,
Atoka,Governor,Chris Powell,LIB,30011,0,0,0,0,
Atoka,Governor,Rex Lawhorn,LIB,30011,0,0,0,0,
Atoka,Corporation Commissioner,Ashley Nicole Mccray,DEM,30011,1,11,25,37,
Atoka,Corporation Commissioner,Blake Cummings,DEM,30011,2,19,33,54,
Atoka,U.S. House,Jason Nichols,DEM,30011,1,5,16,22,02
Atoka,U.S. House,Clay Padgett,DEM,30011,2,27,42,71,02
Atoka,Governor,Mick Cornett,REP,30012,0,1,4,5,
Atoka,Governor,Kevin Stitt,REP,30012,0,0,22,22,
Atoka,Lieutenant Governor,Dana Murphy,REP,30012,0,1,7,8,
Atoka,Lieutenant Governor,Matt Pinnell,REP,30012,0,0,18,18,
Atoka,State Auditor,Cindy Byrd,REP,30012,0,1,8,9,
Atoka,State Auditor,Charlie Prater,REP,30012,0,0,17,17,
Atoka,Attorney General,Mike Hunter,REP,30012,0,1,13,14,
Atoka,Attorney General,Gentner Drummond,REP,30012,0,0,13,13,
Atoka,Superintendent of Public Instruction,Joy Hofmeister,REP,30012,0,1,10,11,
Atoka,Superintendent of Public Instruction,Linda Murphy,REP,30012,0,0,16,16,
Atoka,Commissioner of Labor,Cathy Costello,REP,30012,0,0,10,10,
Atoka,Commissioner of Labor,Leslie Osborn,REP,30012,0,1,17,18,
Atoka,Corporation Commissioner,Bob Anthony,REP,30012,0,0,9,9,
Atoka,Corporation Commissioner,Brian Bingman,REP,30012,0,1,18,19,
Atoka,Governor,Chris Powell,LIB,30012,0,0,0,0,
Atoka,Governor,Rex Lawhorn,LIB,30012,0,0,0,0,
Atoka,Corporation Commissioner,Ashley Nicole Mccray,DEM,30012,1,0,25,26,
Atoka,Corporation Commissioner,Blake Cummings,DEM,30012,0,0,39,39,
Atoka,U.S. House,Jason Nichols,DEM,30012,0,0,36,36,02
Atoka,U.S. House,Clay Padgett,DEM,30012,1,0,29,30,02
Atoka,Governor,Mick Cornett,REP,30013,0,0,5,5,
Atoka,Governor,Kevin Stitt,REP,30013,0,1,16,17,
Atoka,Lieutenant Governor,Dana Murphy,REP,30013,0,1,5,6,
Atoka,Lieutenant Governor,Matt Pinnell,REP,30013,0,0,16,16,
Atoka,State Auditor,Cindy Byrd,REP,30013,0,1,9,10,
Atoka,State Auditor,Charlie Prater,REP,30013,0,0,12,12,
Atoka,Attorney General,Mike Hunter,REP,30013,0,0,11,11,
Atoka,Attorney General,Gentner Drummond,REP,30013,0,1,10,11,
Atoka,Superintendent of Public Instruction,Joy Hofmeister,REP,30013,0,0,6,6,
Atoka,Superintendent of Public Instruction,Linda Murphy,REP,30013,0,1,15,16,
Atoka,Commissioner of Labor,Cathy Costello,REP,30013,0,1,14,15,
Atoka,Commissioner of Labor,Leslie Osborn,REP,30013,0,0,7,7,
Atoka,Corporation Commissioner,Bob Anthony,REP,30013,0,1,15,16,
Atoka,Corporation Commissioner,Brian Bingman,REP,30013,0,0,6,6,
Atoka,Governor,Chris Powell,LIB,30013,0,0,0,0,
Atoka,Governor,Rex Lawhorn,LIB,30013,0,0,0,0,
Atoka,Corporation Commissioner,Ashley Nicole Mccray,DEM,30013,0,1,43,44,
Atoka,Corporation Commissioner,Blake Cummings,DEM,30013,0,1,72,73,
Atoka,U.S. House,Jason Nichols,DEM,30013,0,1,50,51,02
Atoka,U.S. House,Clay Padgett,DEM,30013,0,1,67,68,02
Atoka,Governor,Mick Cornett,REP,30014,0,0,7,7,
Atoka,Governor,Kevin Stitt,REP,30014,0,1,11,12,
Atoka,Lieutenant Governor,Dana Murphy,REP,30014,0,0,8,8,
Atoka,Lieutenant Governor,Matt Pinnell,REP,30014,0,1,9,10,
Atoka,State Auditor,Cindy Byrd,REP,30014,0,0,7,7,
Atoka,State Auditor,Charlie Prater,REP,30014,0,1,10,11,
Atoka,Attorney General,Mike Hunter,REP,30014,0,1,7,8,
Atoka,Attorney General,Gentner Drummond,REP,30014,0,0,10,10,
Atoka,Superintendent of Public Instruction,Joy Hofmeister,REP,30014,0,0,7,7,
Atoka,Superintendent of Public Instruction,Linda Murphy,REP,30014,0,1,10,11,
Atoka,Commissioner of Labor,Cathy Costello,REP,30014,0,0,7,7,
Atoka,Commissioner of Labor,Leslie Osborn,REP,30014,0,1,9,10,
Atoka,Corporation Commissioner,Bob Anthony,REP,30014,0,0,9,9,
Atoka,Corporation Commissioner,Brian Bingman,REP,30014,0,1,7,8,
Atoka,Governor,Chris Powell,LIB,30014,0,0,0,0,
Atoka,Governor,Rex Lawhorn,LIB,30014,0,0,0,0,
Atoka,Corporation Commissioner,Ashley Nicole Mccray,DEM,30014,0,4,12,16,
Atoka,Corporation Commissioner,Blake Cummings,DEM,30014,1,0,30,31,
Atoka,U.S. House,Jason Nichols,DEM,30014,1,1,16,18,02
Atoka,U.S. House,Clay Padgett,DEM,30014,0,4,26,30,02
Atoka,Governor,Mick Cornett,REP,30015,0,0,1,1,
Atoka,Governor,Kevin Stitt,REP,30015,0,0,8,8,
Atoka,Lieutenant Governor,Dana Murphy,REP,30015,0,0,2,2,
Atoka,Lieutenant Governor,Matt Pinnell,REP,30015,0,0,6,6,
Atoka,State Auditor,Cindy Byrd,REP,30015,0,0,3,3,
Atoka,State Auditor,Charlie Prater,REP,30015,0,0,5,5,
Atoka,Attorney General,Mike Hunter,REP,30015,0,0,3,3,
Atoka,Attorney General,Gentner Drummond,REP,30015,0,0,5,5,
Atoka,Superintendent of Public Instruction,Joy Hofmeister,REP,30015,0,0,2,2,
Atoka,Superintendent of Public Instruction,Linda Murphy,REP,30015,0,0,6,6,
Atoka,Commissioner of Labor,Cathy Costello,REP,30015,0,0,1,1,
Atoka,Commissioner of Labor,Leslie Osborn,REP,30015,0,0,7,7,
Atoka,Corporation Commissioner,Bob Anthony,REP,30015,0,0,3,3,
Atoka,Corporation Commissioner,Brian Bingman,REP,30015,0,0,5,5,
Atoka,Governor,Chris Powell,LIB,30015,0,0,0,0,
Atoka,Governor,Rex Lawhorn,LIB,30015,0,0,0,0,
Atoka,Corporation Commissioner,Ashley Nicole Mccray,DEM,30015,0,0,8,8,
Atoka,Corporation Commissioner,Blake Cummings,DEM,30015,0,1,7,8,
Atoka,U.S. House,Jason Nichols,DEM,30015,0,0,2,2,02
Atoka,U.S. House,Clay Padgett,DEM,30015,0,1,13,14,02
Atoka,Governor,Mick Cornett,REP,30016,0,0,0,0,
Atoka,Governor,Kevin Stitt,REP,30016,0,0,0,0,
Atoka,Lieutenant Governor,Dana Murphy,REP,30016,0,0,0,0,
Atoka,Lieutenant Governor,Matt Pinnell,REP,30016,0,0,0,0,
Atoka,State Auditor,Cindy Byrd,REP,30016,0,0,0,0,
Atoka,State Auditor,Charlie Prater,REP,30016,0,0,0,0,
Atoka,Attorney General,Mike Hunter,REP,30016,0,0,0,0,
Atoka,Attorney General,Gentner Drummond,REP,30016,0,0,0,0,
Atoka,Superintendent of Public Instruction,Joy Hofmeister,REP,30016,0,0,0,0,
Atoka,Superintendent of Public Instruction,Linda Murphy,REP,30016,0,0,0,0,
Atoka,Commissioner of Labor,Cathy Costello,REP,30016,0,0,0,0,
Atoka,Commissioner of Labor,Leslie Osborn,REP,30016,0,0,0,0,
Atoka,Corporation Commissioner,Bob Anthony,REP,30016,0,0,0,0,
Atoka,Corporation Commissioner,Brian Bingman,REP,30016,0,0,0,0,
Atoka,Governor,Chris Powell,LIB,30016,0,0,0,0,
Atoka,Governor,Rex Lawhorn,LIB,30016,0,0,0,0,
Atoka,Corporation Commissioner,Ashley Nicole Mccray,DEM,30016,0,0,0,0,
Atoka,Corporation Commissioner,Blake Cummings,DEM,30016,0,0,0,0,
Atoka,U.S. House,Jason Nichols,DEM,30016,0,0,0,0,02
Atoka,U.S. House,Clay Padgett,DEM,30016,0,0,0,0,02
Atoka,Governor,Mick Cornett,REP,30017,0,0,0,0,
Atoka,Governor,Kevin Stitt,REP,30017,0,0,0,0,
Atoka,Lieutenant Governor,Dana Murphy,REP,30017,0,0,0,0,
Atoka,Lieutenant Governor,Matt Pinnell,REP,30017,0,0,0,0,
Atoka,State Auditor,Cindy Byrd,REP,30017,0,0,0,0,
Atoka,State Auditor,Charlie Prater,REP,30017,0,0,0,0,
Atoka,Attorney General,Mike Hunter,REP,30017,0,0,0,0,
Atoka,Attorney General,Gentner Drummond,REP,30017,0,0,0,0,
Atoka,Superintendent of Public Instruction,Joy Hofmeister,REP,30017,0,0,0,0,
Atoka,Superintendent of Public Instruction,Linda Murphy,REP,30017,0,0,0,0,
Atoka,Commissioner of Labor,Cathy Costello,REP,30017,0,0,0,0,
Atoka,Commissioner of Labor,Leslie Osborn,REP,30017,0,0,0,0,
Atoka,Corporation Commissioner,Bob Anthony,REP,30017,0,0,0,0,
Atoka,Corporation Commissioner,Brian Bingman,REP,30017,0,0,0,0,
Atoka,Governor,Chris Powell,LIB,30017,0,0,0,0,
Atoka,Governor,Rex Lawhorn,LIB,30017,0,0,0,0,
Atoka,Corporation Commissioner,Ashley Nicole Mccray,DEM,30017,0,0,0,0,
Atoka,Corporation Commissioner,Blake Cummings,DEM,30017,0,0,0,0,
Atoka,U.S. House,Jason Nichols,DEM,30017,0,0,0,0,02
Atoka,U.S. House,Clay Padgett,DEM,30017,0,0,0,0,02
Atoka,Governor,Mick Cornett,REP,30018,0,0,0,0,
Atoka,Governor,Kevin Stitt,REP,30018,0,0,0,0,
Atoka,Lieutenant Governor,Dana Murphy,REP,30018,0,0,0,0,
Atoka,Lieutenant Governor,Matt Pinnell,REP,30018,0,0,0,0,
Atoka,State Auditor,Cindy Byrd,REP,30018,0,0,0,0,
Atoka,State Auditor,Charlie Prater,REP,30018,0,0,0,0,
Atoka,Attorney General,Mike Hunter,REP,30018,0,0,0,0,
Atoka,Attorney General,Gentner Drummond,REP,30018,0,0,0,0,
Atoka,Superintendent of Public Instruction,Joy Hofmeister,REP,30018,0,0,0,0,
Atoka,Superintendent of Public Instruction,Linda Murphy,REP,30018,0,0,0,0,
Atoka,Commissioner of Labor,Cathy Costello,REP,30018,0,0,0,0,
Atoka,Commissioner of Labor,Leslie Osborn,REP,30018,0,0,0,0,
Atoka,Corporation Commissioner,Bob Anthony,REP,30018,0,0,0,0,
Atoka,Corporation Commissioner,Brian Bingman,REP,30018,0,0,0,0,
Atoka,Governor,Chris Powell,LIB,30018,0,0,0,0,
Atoka,Governor,Rex Lawhorn,LIB,30018,0,0,0,0,
Atoka,Corporation Commissioner,Ashley Nicole Mccray,DEM,30018,0,0,0,0,
Atoka,Corporation Commissioner,Blake Cummings,DEM,30018,0,0,0,0,
Atoka,U.S. House,Jason Nichols,DEM,30018,0,0,0,0,02
Atoka,U.S. House,Clay Padgett,DEM,30018,0,0,0,0,02
Atoka,Governor,Mick Cornett,REP,30019,0,0,2,2,
Atoka,Governor,Kevin Stitt,REP,30019,0,0,2,2,
Atoka,Lieutenant Governor,Dana Murphy,REP,30019,0,0,2,2,
Atoka,Lieutenant Governor,Matt Pinnell,REP,30019,0,0,2,2,
Atoka,State Auditor,Cindy Byrd,REP,30019,0,0,0,0,
Atoka,State Auditor,Charlie Prater,REP,30019,0,0,2,2,
Atoka,Attorney General,Mike Hunter,REP,30019,0,0,2,2,
Atoka,Attorney General,Gentner Drummond,REP,30019,0,0,2,2,
Atoka,Superintendent of Public Instruction,Joy Hofmeister,REP,30019,0,0,4,4,
Atoka,Superintendent of Public Instruction,Linda Murphy,REP,30019,0,0,0,0,
Atoka,Commissioner of Labor,Cathy Costello,REP,30019,0,0,1,1,
Atoka,Commissioner of Labor,Leslie Osborn,REP,30019,0,0,2,2,
Atoka,Corporation Commissioner,Bob Anthony,REP,30019,0,0,0,0,
Atoka,Corporation Commissioner,Brian Bingman,REP,30019,0,0,2,2,
Atoka,Governor,Chris Powell,LIB,30019,0,0,1,1,
Atoka,Governor,Rex Lawhorn,LIB,30019,0,0,0,0,
Atoka,Corporation Commissioner,Ashley Nicole Mccray,DEM,30019,0,0,6,6,
Atoka,Corporation Commissioner,Blake Cummings,DEM,30019,0,0,3,3,
Atoka,U.S. House,Jason Nichols,DEM,30019,0,0,4,4,02
Atoka,U.S. House,Clay Padgett,DEM,30019,0,0,5,5,02
Beaver,Governor,Mick Cornett,REP,40011,0,3,23,26,
Beaver,Governor,Kevin Stitt,REP,40011,3,6,89,98,
Beaver,Lieutenant Governor,Dana Murphy,REP,40011,2,7,77,86,
Beaver,Lieutenant Governor,Matt Pinnell,REP,40011,1,2,36,39,
Beaver,State Auditor,Cindy Byrd,REP,40011,2,3,56,61,
Beaver,State Auditor,Charlie Prater,REP,40011,1,6,53,60,
Beaver,Attorney General,Mike Hunter,REP,40011,1,6,41,48,
Beaver,Attorney General,Gentner Drummond,REP,40011,2,3,71,76,
Beaver,Superintendent of Public Instruction,Joy Hofmeister,REP,40011,2,4,61,67,
Beaver,Superintendent of Public Instruction,Linda Murphy,REP,40011,1,5,49,55,
Beaver,Commissioner of Labor,Cathy Costello,REP,40011,2,4,67,73,
Beaver,Commissioner of Labor,Leslie Osborn,REP,40011,1,5,43,49,
Beaver,Corporation Commissioner,Bob Anthony,REP,40011,3,5,55,63,
Beaver,Corporation Commissioner,Brian Bingman,REP,40011,0,4,54,58,
Beaver,State House,Kenton Patzkowsky,REP,40011,3,9,68,80,61
Beaver,State House,Brad Raven,REP,40011,0,0,45,45,61
Beaver,Governor,Chris Powell,LIB,40011,0,0,0,0,
Beaver,Governor,Rex Lawhorn,LIB,40011,0,0,0,0,
Beaver,Corporation Commissioner,Ashley Nicole Mccray,DEM,40011,0,0,4,4,
Beaver,Corporation Commissioner,Blake Cummings,DEM,40011,0,0,4,4,
Beaver,Governor,Mick Cornett,REP,40013,2,2,17,21,
Beaver,Governor,Kevin Stitt,REP,40013,3,2,35,40,
Beaver,Lieutenant Governor,Dana Murphy,REP,40013,5,4,22,31,
Beaver,Lieutenant Governor,Matt Pinnell,REP,40013,0,0,28,28,
Beaver,State Auditor,Cindy Byrd,REP,40013,2,2,14,18,
Beaver,State Auditor,Charlie Prater,REP,40013,3,2,36,41,
Beaver,Attorney General,Mike Hunter,REP,40013,5,3,24,32,
Beaver,Attorney General,Gentner Drummond,REP,40013,0,1,27,28,
Beaver,Superintendent of Public Instruction,Joy Hofmeister,REP,40013,3,2,27,32,
Beaver,Superintendent of Public Instruction,Linda Murphy,REP,40013,2,2,22,26,
Beaver,Commissioner of Labor,Cathy Costello,REP,40013,2,4,30,36,
Beaver,Commissioner of Labor,Leslie Osborn,REP,40013,3,0,19,22,
Beaver,Corporation Commissioner,Bob Anthony,REP,40013,1,3,34,38,
Beaver,Corporation Commissioner,Brian Bingman,REP,40013,4,1,17,22,
Beaver,State House,Kenton Patzkowsky,REP,40013,1,3,37,41,61
Beaver,State House,Brad Raven,REP,40013,4,1,14,19,61
Beaver,Governor,Chris Powell,LIB,40013,0,0,0,0,
Beaver,Governor,Rex Lawhorn,LIB,40013,0,0,0,0,
Beaver,Corporation Commissioner,Ashley Nicole Mccray,DEM,40013,0,0,0,0,
Beaver,Corporation Commissioner,Blake Cummings,DEM,40013,0,0,1,1,
Beaver,Governor,Mick Cornett,REP,40023,5,29,139,173,
Beaver,Governor,Kevin Stitt,REP,40023,11,27,155,193,
Beaver,Lieutenant Governor,Dana Murphy,REP,40023,6,33,166,205,
Beaver,Lieutenant Governor,Matt Pinnell,REP,40023,8,23,125,156,
Beaver,State Auditor,Cindy Byrd,REP,40023,8,32,134,174,
Beaver,State Auditor,Charlie Prater,REP,40023,3,22,148,173,
Beaver,Attorney General,Mike Hunter,REP,40023,5,33,167,205,
Beaver,Attorney General,Gentner Drummond,REP,40023,9,22,119,150,
Beaver,Superintendent of Public Instruction,Joy Hofmeister,REP,40023,3,33,115,151,
Beaver,Superintendent of Public Instruction,Linda Murphy,REP,40023,10,20,166,196,
Beaver,Commissioner of Labor,Cathy Costello,REP,40023,7,22,139,168,
Beaver,Commissioner of Labor,Leslie Osborn,REP,40023,5,29,139,173,
Beaver,Corporation Commissioner,Bob Anthony,REP,40023,8,34,145,187,
Beaver,Corporation Commissioner,Brian Bingman,REP,40023,4,22,130,156,
Beaver,State House,Kenton Patzkowsky,REP,40023,14,42,215,271,61
Beaver,State House,Brad Raven,REP,40023,1,12,85,98,61
Beaver,Governor,Chris Powell,LIB,40023,0,0,0,0,
Beaver,Governor,Rex Lawhorn,LIB,40023,0,0,1,1,
Beaver,Corporation Commissioner,Ashley Nicole Mccray,DEM,40023,1,3,17,21,
Beaver,Corporation Commissioner,Blake Cummings,DEM,40023,1,2,11,14,
Beaver,Governor,Mick Cornett,REP,40025,1,0,27,28,
Beaver,Governor,Kevin Stitt,REP,40025,3,6,45,54,
Beaver,Lieutenant Governor,Dana Murphy,REP,40025,0,5,35,40,
Beaver,Lieutenant Governor,Matt Pinnell,REP,40025,2,1,34,37,
Beaver,State Auditor,Cindy Byrd,REP,40025,0,4,20,24,
Beaver,State Auditor,Charlie Prater,REP,40025,2,2,44,48,
Beaver,Attorney General,Mike Hunter,REP,40025,0,3,34,37,
Beaver,Attorney General,Gentner Drummond,REP,40025,2,3,35,40,
Beaver,Superintendent of Public Instruction,Joy Hofmeister,REP,40025,0,2,30,32,
Beaver,Superintendent of Public Instruction,Linda Murphy,REP,40025,2,4,35,41,
Beaver,Commissioner of Labor,Cathy Costello,REP,40025,1,3,25,29,
Beaver,Commissioner of Labor,Leslie Osborn,REP,40025,1,3,39,43,
Beaver,Corporation Commissioner,Bob Anthony,REP,40025,1,4,27,32,
Beaver,Corporation Commissioner,Brian Bingman,REP,40025,1,2,39,42,
Beaver,State House,Kenton Patzkowsky,REP,40025,1,3,46,50,61
Beaver,State House,Brad Raven,REP,40025,3,4,26,33,61
Beaver,Governor,Chris Powell,LIB,40025,0,0,0,0,
Beaver,Governor,Rex Lawhorn,LIB,40025,0,0,0,0,
Beaver,Corporation Commissioner,Ashley Nicole Mccray,DEM,40025,0,0,3,3,
Beaver,Corporation Commissioner,Blake Cummings,DEM,40025,0,0,6,6,
Beaver,Governor,Mick Cornett,REP,40026,2,0,7,9,
Beaver,Governor,Kevin Stitt,REP,40026,0,3,13,16,
Beaver,Lieutenant Governor,Dana Murphy,REP,40026,2,3,9,14,
Beaver,Lieutenant Governor,Matt Pinnell,REP,40026,0,0,11,11,
Beaver,State Auditor,Cindy Byrd,REP,40026,2,0,9,11,
Beaver,State Auditor,Charlie Prater,REP,40026,0,3,10,13,
Beaver,Attorney General,Mike Hunter,REP,40026,0,0,11,11,
Beaver,Attorney General,Gentner Drummond,REP,40026,2,3,9,14,
Beaver,Superintendent of Public Instruction,Joy Hofmeister,REP,40026,0,1,7,8,
Beaver,Superintendent of Public Instruction,Linda Murphy,REP,40026,2,2,13,17,
Beaver,Commissioner of Labor,Cathy Costello,REP,40026,0,3,13,16,
Beaver,Commissioner of Labor,Leslie Osborn,REP,40026,2,0,7,9,
Beaver,Corporation Commissioner,Bob Anthony,REP,40026,2,3,12,17,
Beaver,Corporation Commissioner,Brian Bingman,REP,40026,0,0,8,8,
Beaver,State House,Kenton Patzkowsky,REP,40026,2,0,16,18,61
Beaver,State House,Brad Raven,REP,40026,0,3,4,7,61
Beaver,Governor,Chris Powell,LIB,40026,0,0,0,0,
Beaver,Governor,Rex Lawhorn,LIB,40026,0,0,0,0,
Beaver,Corporation Commissioner,Ashley Nicole Mccray,DEM,40026,0,0,0,0,
Beaver,Corporation Commissioner,Blake Cummings,DEM,40026,0,1,0,1,
Beaver,Governor,Mick Cornett,REP,40031,1,2,33,36,
Beaver,Governor,Kevin Stitt,REP,40031,0,2,59,61,
Beaver,Lieutenant Governor,Dana Murphy,REP,40031,0,2,54,56,
Beaver,Lieutenant Governor,Matt Pinnell,REP,40031,1,2,37,40,
Beaver,State Auditor,Cindy Byrd,REP,40031,0,1,34,35,
Beaver,State Auditor,Charlie Prater,REP,40031,1,3,53,57,
Beaver,Attorney General,Mike Hunter,REP,40031,1,2,46,49,
Beaver,Attorney General,Gentner Drummond,REP,40031,0,2,42,44,
Beaver,Superintendent of Public Instruction,Joy Hofmeister,REP,40031,1,1,38,40,
Beaver,Superintendent of Public Instruction,Linda Murphy,REP,40031,0,3,52,55,
Beaver,Commissioner of Labor,Cathy Costello,REP,40031,1,0,37,38,
Beaver,Commissioner of Labor,Leslie Osborn,REP,40031,0,4,47,51,
Beaver,Corporation Commissioner,Bob Anthony,REP,40031,1,4,44,49,
Beaver,Corporation Commissioner,Brian Bingman,REP,40031,0,0,40,40,
Beaver,State House,Kenton Patzkowsky,REP,40031,1,4,81,86,61
Beaver,State House,Brad Raven,REP,40031,0,0,14,14,61
Beaver,Governor,Chris Powell,LIB,40031,0,0,0,0,
Beaver,Governor,Rex Lawhorn,LIB,40031,0,0,0,0,
Beaver,Corporation Commissioner,Ashley Nicole Mccray,DEM,40031,1,0,1,2,
Beaver,Corporation Commissioner,Blake Cummings,DEM,40031,0,0,6,6,
Beaver,Governor,Mick Cornett,REP,40033,3,2,69,74,
Beaver,Governor,Kevin Stitt,REP,40033,4,0,86,90,
Beaver,Lieutenant Governor,Dana Murphy,REP,40033,3,1,77,81,
Beaver,Lieutenant Governor,Matt Pinnell,REP,40033,4,1,74,79,
Beaver,State Auditor,Cindy Byrd,REP,40033,4,1,59,64,
Beaver,State Auditor,Charlie Prater,REP,40033,3,1,89,93,
Beaver,Attorney General,Mike Hunter,REP,40033,4,1,77,82,
Beaver,Attorney General,Gentner Drummond,REP,40033,3,1,75,79,
Beaver,Superintendent of Public Instruction,Joy Hofmeister,REP,40033,1,1,63,65,
Beaver,Superintendent of Public Instruction,Linda Murphy,REP,40033,6,1,83,90,
Beaver,Commissioner of Labor,Cathy Costello,REP,40033,4,1,64,69,
Beaver,Commissioner of Labor,Leslie Osborn,REP,40033,3,1,79,83,
Beaver,Corporation Commissioner,Bob Anthony,REP,40033,6,0,79,85,
Beaver,Corporation Commissioner,Brian Bingman,REP,40033,1,2,65,68,
Beaver,State House,Kenton Patzkowsky,REP,40033,5,2,112,119,61
Beaver,State House,Brad Raven,REP,40033,1,0,50,51,61
Beaver,Governor,Chris Powell,LIB,40033,0,0,0,0,
Beaver,Governor,Rex Lawhorn,LIB,40033,0,0,0,0,
Beaver,Corporation Commissioner,Ashley Nicole Mccray,DEM,40033,0,0,10,10,
Beaver,Corporation Commissioner,Blake Cummings,DEM,40033,0,0,1,1,
Beckham,Governor,Mick Cornett,REP,50111,2,8,53,63,
Beckham,Governor,Kevin Stitt,REP,50111,1,3,48,52,
Beckham,Lieutenant Governor,Dana Murphy,REP,50111,0,1,34,35,
Beckham,Lieutenant Governor,Matt Pinnell,REP,50111,3,10,67,80,
Beckham,State Auditor,Cindy Byrd,REP,50111,3,9,40,52,
Beckham,State Auditor,Charlie Prater,REP,50111,0,2,59,61,
Beckham,Attorney General,Mike Hunter,REP,50111,1,7,47,55,
Beckham,Attorney General,Gentner Drummond,REP,50111,2,4,52,58,
Beckham,Superintendent of Public Instruction,Joy Hofmeister,REP,50111,1,8,57,66,
Beckham,Superintendent of Public Instruction,Linda Murphy,REP,50111,2,3,42,47,
Beckham,Commissioner of Labor,Cathy Costello,REP,50111,1,5,44,50,
Beckham,Commissioner of Labor,Leslie Osborn,REP,50111,2,6,52,60,
Beckham,Corporation Commissioner,Bob Anthony,REP,50111,2,5,49,56,
Beckham,Corporation Commissioner,Brian Bingman,REP,50111,1,6,49,56,
Beckham,Governor,Chris Powell,LIB,50111,0,0,0,0,
Beckham,Governor,Rex Lawhorn,LIB,50111,0,0,0,0,
Beckham,Corporation Commissioner,Ashley Nicole Mccray,DEM,50111,5,1,19,25,
Beckham,Corporation Commissioner,Blake Cummings,DEM,50111,3,3,26,32,
Beckham,Governor,Mick Cornett,REP,50112,0,1,17,18,
Beckham,Governor,Kevin Stitt,REP,50112,2,6,38,46,
Beckham,Lieutenant Governor,Dana Murphy,REP,50112,2,6,22,30,
Beckham,Lieutenant Governor,Matt Pinnell,REP,50112,0,1,33,34,
Beckham,State Auditor,Cindy Byrd,REP,50112,2,3,32,37,
Beckham,State Auditor,Charlie Prater,REP,50112,0,4,23,27,
Beckham,Attorney General,Mike Hunter,REP,50112,2,5,33,40,
Beckham,Attorney General,Gentner Drummond,REP,50112,0,2,22,24,
Beckham,Superintendent of Public Instruction,Joy Hofmeister,REP,50112,0,5,31,36,
Beckham,Superintendent of Public Instruction,Linda Murphy,REP,50112,2,2,23,27,
Beckham,Commissioner of Labor,Cathy Costello,REP,50112,0,3,30,33,
Beckham,Commissioner of Labor,Leslie Osborn,REP,50112,2,4,24,30,
Beckham,Corporation Commissioner,Bob Anthony,REP,50112,2,6,28,36,
Beckham,Corporation Commissioner,Brian Bingman,REP,50112,0,1,26,27,
Beckham,Governor,Chris Powell,LIB,50112,0,0,0,0,
Beckham,Governor,Rex Lawhorn,LIB,50112,0,0,0,0,
Beckham,Corporation Commissioner,Ashley Nicole Mccray,DEM,50112,0,1,5,6,
Beckham,Corporation Commissioner,Blake Cummings,DEM,50112,0,1,9,10,
Beckham,Governor,Mick Cornett,REP,50115,1,4,6,11,
Beckham,Governor,Kevin Stitt,REP,50115,2,8,7,17,
Beckham,Lieutenant Governor,Dana Murphy,REP,50115,1,5,6,12,
Beckham,Lieutenant Governor,Matt Pinnell,REP,50115,2,6,7,15,
Beckham,State Auditor,Cindy Byrd,REP,50115,2,6,6,14,
Beckham,State Auditor,Charlie Prater,REP,50115,1,6,7,14,
Beckham,Attorney General,Mike Hunter,REP,50115,0,5,4,9,
Beckham,Attorney General,Gentner Drummond,REP,50115,3,7,9,19,
Beckham,Superintendent of Public Instruction,Joy Hofmeister,REP,50115,2,11,7,20,
Beckham,Superintendent of Public Instruction,Linda Murphy,REP,50115,1,1,6,8,
Beckham,Commissioner of Labor,Cathy Costello,REP,50115,3,3,9,15,
Beckham,Commissioner of Labor,Leslie Osborn,REP,50115,0,9,4,13,
Beckham,Corporation Commissioner,Bob Anthony,REP,50115,3,6,5,14,
Beckham,Corporation Commissioner,Brian Bingman,REP,50115,0,6,8,14,
Beckham,Governor,Chris Powell,LIB,50115,0,0,0,0,
Beckham,Governor,Rex Lawhorn,LIB,50115,0,0,0,0,
Beckham,Corporation Commissioner,Ashley Nicole Mccray,DEM,50115,0,1,4,5,
Beckham,Corporation Commissioner,Blake Cummings,DEM,50115,0,0,4,4,
Beckham,Governor,Mick Cornett,REP,50141,3,2,51,56,
Beckham,Governor,Kevin Stitt,REP,50141,2,2,68,72,
Beckham,Lieutenant Governor,Dana Murphy,REP,50141,3,1,52,56,
Beckham,Lieutenant Governor,Matt Pinnell,REP,50141,2,3,65,70,
Beckham,State Auditor,Cindy Byrd,REP,50141,4,3,53,60,
Beckham,State Auditor,Charlie Prater,REP,50141,1,1,64,66,
Beckham,Attorney General,Mike Hunter,REP,50141,4,2,64,70,
Beckham,Attorney General,Gentner Drummond,REP,50141,1,2,55,58,
Beckham,Superintendent of Public Instruction,Joy Hofmeister,REP,50141,3,2,71,76,
Beckham,Superintendent of Public Instruction,Linda Murphy,REP,50141,2,2,47,51,
Beckham,Commissioner of Labor,Cathy Costello,REP,50141,3,3,63,69,
Beckham,Commissioner of Labor,Leslie Osborn,REP,50141,2,1,53,56,
Beckham,Corporation Commissioner,Bob Anthony,REP,50141,1,1,58,60,
Beckham,Corporation Commissioner,Brian Bingman,REP,50141,4,3,60,67,
Beckham,Governor,Chris Powell,LIB,50141,0,0,0,0,
Beckham,Governor,Rex Lawhorn,LIB,50141,0,0,0,0,
Beckham,Corporation Commissioner,Ashley Nicole Mccray,DEM,50141,1,1,9,11,
Beckham,Corporation Commissioner,Blake Cummings,DEM,50141,1,0,18,19,
Beckham,Governor,Mick Cornett,REP,50231,2,1,21,24,
Beckham,Governor,Kevin Stitt,REP,50231,0,2,22,24,
Beckham,Lieutenant Governor,Dana Murphy,REP,50231,1,2,20,23,
Beckham,Lieutenant Governor,Matt Pinnell,REP,50231,1,1,23,25,
Beckham,State Auditor,Cindy Byrd,REP,50231,1,1,18,20,
Beckham,State Auditor,Charlie Prater,REP,50231,1,2,23,26,
Beckham,Attorney General,Mike Hunter,REP,50231,2,0,17,19,
Beckham,Attorney General,Gentner Drummond,REP,50231,0,3,26,29,
Beckham,Superintendent of Public Instruction,Joy Hofmeister,REP,50231,1,0,29,30,
Beckham,Superintendent of Public Instruction,Linda Murphy,REP,50231,1,3,14,18,
Beckham,Commissioner of Labor,Cathy Costello,REP,50231,1,1,20,22,
Beckham,Commissioner of Labor,Leslie Osborn,REP,50231,1,2,23,26,
Beckham,Corporation Commissioner,Bob Anthony,REP,50231,1,2,19,22,
Beckham,Corporation Commissioner,Brian Bingman,REP,50231,1,1,24,26,
Beckham,Governor,Chris Powell,LIB,50231,0,0,1,1,
Beckham,Governor,Rex Lawhorn,LIB,50231,0,0,0,0,
Beckham,Corporation Commissioner,Ashley Nicole Mccray,DEM,50231,0,0,6,6,
Beckham,Corporation Commissioner,Blake Cummings,DEM,50231,1,0,5,6,
Beckham,Governor,Mick Cornett,REP,50232,3,1,6,10,
Beckham,Governor,Kevin Stitt,REP,50232,1,1,10,12,
Beckham,Lieutenant Governor,Dana Murphy,REP,50232,2,0,7,9,
Beckham,Lieutenant Governor,Matt Pinnell,REP,50232,2,2,9,13,
Beckham,State Auditor,Cindy Byrd,REP,50232,4,1,7,12,
Beckham,State Auditor,Charlie Prater,REP,50232,0,1,8,9,
Beckham,Attorney General,Mike Hunter,REP,50232,2,1,7,10,
Beckham,Attorney General,Gentner Drummond,REP,50232,2,1,9,12,
Beckham,Superintendent of Public Instruction,Joy Hofmeister,REP,50232,4,0,7,11,
Beckham,Superintendent of Public Instruction,Linda Murphy,REP,50232,0,2,9,11,
Beckham,Commissioner of Labor,Cathy Costello,REP,50232,4,1,5,10,
Beckham,Commissioner of Labor,Leslie Osborn,REP,50232,0,1,11,12,
Beckham,Corporation Commissioner,Bob Anthony,REP,50232,2,1,4,7,
Beckham,Corporation Commissioner,Brian Bingman,REP,50232,2,1,11,14,
Beckham,Governor,Chris Powell,LIB,50232,0,0,0,0,
Beckham,Governor,Rex Lawhorn,LIB,50232,0,0,0,0,
Beckham,Corporation Commissioner,Ashley Nicole Mccray,DEM,50232,0,0,4,4,
Beckham,Corporation Commissioner,Blake Cummings,DEM,50232,0,0,0,0,
Beckham,Governor,Mick Cornett,REP,50235,2,2,126,130,
Beckham,Governor,Kevin Stitt,REP,50235,7,3,131,141,
Beckham,Lieutenant Governor,Dana Murphy,REP,50235,3,2,110,115,
Beckham,Lieutenant Governor,Matt Pinnell,REP,50235,4,3,146,153,
Beckham,State Auditor,Cindy Byrd,REP,50235,4,2,119,125,
Beckham,State Auditor,Charlie Prater,REP,50235,3,3,134,140,
Beckham,Attorney General,Mike Hunter,REP,50235,6,3,124,133,
Beckham,Attorney General,Gentner Drummond,REP,50235,3,2,125,130,
Beckham,Superintendent of Public Instruction,Joy Hofmeister,REP,50235,3,0,135,138,
Beckham,Superintendent of Public Instruction,Linda Murphy,REP,50235,6,5,118,129,
Beckham,Commissioner of Labor,Cathy Costello,REP,50235,4,2,128,134,
Beckham,Commissioner of Labor,Leslie Osborn,REP,50235,5,3,122,130,
Beckham,Corporation Commissioner,Bob Anthony,REP,50235,1,3,113,117,
Beckham,Corporation Commissioner,Brian Bingman,REP,50235,7,2,137,146,
Beckham,Governor,Chris Powell,LIB,50235,0,0,0,0,
Beckham,Governor,Rex Lawhorn,LIB,50235,0,0,0,0,
Beckham,Corporation Commissioner,Ashley Nicole Mccray,DEM,50235,2,1,28,31,
Beckham,Corporation Commissioner,Blake Cummings,DEM,50235,3,1,31,35,
Beckham,Governor,Mick Cornett,REP,50242,0,0,16,16,
Beckham,Governor,Kevin Stitt,REP,50242,0,0,27,27,
Beckham,Lieutenant Governor,Dana Murphy,REP,50242,0,0,21,21,
Beckham,Lieutenant Governor,Matt Pinnell,REP,50242,0,0,22,22,
Beckham,State Auditor,Cindy Byrd,REP,50242,0,0,20,20,
Beckham,State Auditor,Charlie Prater,REP,50242,0,0,23,23,
Beckham,Attorney General,Mike Hunter,REP,50242,0,0,16,16,
Beckham,Attorney General,Gentner Drummond,REP,50242,0,0,27,27,
Beckham,Superintendent of Public Instruction,Joy Hofmeister,REP,50242,0,0,17,17,
Beckham,Superintendent of Public Instruction,Linda Murphy,REP,50242,0,0,26,26,
Beckham,Commissioner of Labor,Cathy Costello,REP,50242,0,0,20,20,
Beckham,Commissioner of Labor,Leslie Osborn,REP,50242,0,0,22,22,
Beckham,Corporation Commissioner,Bob Anthony,REP,50242,0,0,19,19,
Beckham,Corporation Commissioner,Brian Bingman,REP,50242,0,0,24,24,
Beckham,Governor,Chris Powell,LIB,50242,0,0,0,0,
Beckham,Governor,Rex Lawhorn,LIB,50242,0,0,0,0,
Beckham,Corporation Commissioner,Ashley Nicole Mccray,DEM,50242,0,0,13,13,
Beckham,Corporation Commissioner,Blake Cummings,DEM,50242,0,0,15,15,
Beckham,Governor,Mick Cornett,REP,50320,1,4,15,20,
Beckham,Governor,Kevin Stitt,REP,50320,0,3,38,41,
Beckham,Lieutenant Governor,Dana Murphy,REP,50320,0,1,17,18,
Beckham,Lieutenant Governor,Matt Pinnell,REP,50320,1,6,35,42,
Beckham,State Auditor,Cindy Byrd,REP,50320,0,5,15,20,
Beckham,State Auditor,Charlie Prater,REP,50320,1,2,35,38,
Beckham,Attorney General,Mike Hunter,REP,50320,1,5,26,32,
Beckham,Attorney General,Gentner Drummond,REP,50320,0,1,27,28,
Beckham,Superintendent of Public Instruction,Joy Hofmeister,REP,50320,1,4,29,34,
Beckham,Superintendent of Public Instruction,Linda Murphy,REP,50320,0,3,23,26,
Beckham,Commissioner of Labor,Cathy Costello,REP,50320,1,4,22,27,
Beckham,Commissioner of Labor,Leslie Osborn,REP,50320,0,3,31,34,
Beckham,Corporation Commissioner,Bob Anthony,REP,50320,1,0,19,20,
Beckham,Corporation Commissioner,Brian Bingman,REP,50320,0,7,33,40,
Beckham,Governor,Chris Powell,LIB,50320,0,0,0,0,
Beckham,Governor,Rex Lawhorn,LIB,50320,0,0,0,0,
Beckham,Corporation Commissioner,Ashley Nicole Mccray,DEM,50320,0,0,11,11,
Beckham,Corporation Commissioner,Blake Cummings,DEM,50320,1,0,9,10,
Beckham,Governor,Mick Cornett,REP,50330,0,1,22,23,
Beckham,Governor,Kevin Stitt,REP,50330,5,8,38,51,
Beckham,Lieutenant Governor,Dana Murphy,REP,50330,1,5,23,29,
Beckham,Lieutenant Governor,Matt Pinnell,REP,50330,4,4,35,43,
Beckham,State Auditor,Cindy Byrd,REP,50330,3,5,29,37,
Beckham,State Auditor,Charlie Prater,REP,50330,2,4,30,36,
Beckham,Attorney General,Mike Hunter,REP,50330,3,4,34,41,
Beckham,Attorney General,Gentner Drummond,REP,50330,2,5,27,34,
Beckham,Superintendent of Public Instruction,Joy Hofmeister,REP,50330,3,3,33,39,
Beckham,Superintendent of Public Instruction,Linda Murphy,REP,50330,2,6,25,33,
Beckham,Commissioner of Labor,Cathy Costello,REP,50330,5,2,23,30,
Beckham,Commissioner of Labor,Leslie Osborn,REP,50330,0,7,37,44,
Beckham,Corporation Commissioner,Bob Anthony,REP,50330,2,4,27,33,
Beckham,Corporation Commissioner,Brian Bingman,REP,50330,3,5,32,40,
Beckham,Governor,Chris Powell,LIB,50330,0,0,0,0,
Beckham,Governor,Rex Lawhorn,LIB,50330,0,0,0,0,
Beckham,Corporation Commissioner,Ashley Nicole Mccray,DEM,50330,0,0,3,3,
Beckham,Corporation Commissioner,Blake Cummings,DEM,50330,0,0,3,3,
Beckham,Governor,Mick Cornett,REP,50332,2,0,87,89,
Beckham,Governor,Kevin Stitt,REP,50332,5,2,95,102,
Beckham,Lieutenant Governor,Dana Murphy,REP,50332,4,2,92,98,
Beckham,Lieutenant Governor,Matt Pinnell,REP,50332,3,0,87,90,
Beckham,State Auditor,Cindy Byrd,REP,50332,3,1,86,90,
Beckham,State Auditor,Charlie Prater,REP,50332,2,1,88,91,
Beckham,Attorney General,Mike Hunter,REP,50332,2,2,89,93,
Beckham,Attorney General,Gentner Drummond,REP,50332,6,0,90,96,
Beckham,Superintendent of Public Instruction,Joy Hofmeister,REP,50332,2,0,119,121,
Beckham,Superintendent of Public Instruction,Linda Murphy,REP,50332,4,2,62,68,
Beckham,Commissioner of Labor,Cathy Costello,REP,50332,1,1,94,96,
Beckham,Commissioner of Labor,Leslie Osborn,REP,50332,6,1,79,86,
Beckham,Corporation Commissioner,Bob Anthony,REP,50332,3,0,93,96,
Beckham,Corporation Commissioner,Brian Bingman,REP,50332,4,2,86,92,
Beckham,Governor,Chris Powell,LIB,50332,0,0,0,0,
Beckham,Governor,Rex Lawhorn,LIB,50332,0,0,0,0,
Beckham,Corporation Commissioner,Ashley Nicole Mccray,DEM,50332,2,0,23,25,
Beckham,Corporation Commissioner,Blake Cummings,DEM,50332,0,0,21,21,
Beckham,Governor,Mick Cornett,REP,50333,3,2,79,84,
Beckham,Governor,Kevin Stitt,REP,50333,3,1,65,69,
Beckham,Lieutenant Governor,Dana Murphy,REP,50333,4,2,68,74,
Beckham,Lieutenant Governor,Matt Pinnell,REP,50333,2,1,75,78,
Beckham,State Auditor,Cindy Byrd,REP,50333,4,1,63,68,
Beckham,State Auditor,Charlie Prater,REP,50333,2,2,73,77,
Beckham,Attorney General,Mike Hunter,REP,50333,3,0,90,93,
Beckham,Attorney General,Gentner Drummond,REP,50333,3,3,54,60,
Beckham,Superintendent of Public Instruction,Joy Hofmeister,REP,50333,4,1,96,101,
Beckham,Superintendent of Public Instruction,Linda Murphy,REP,50333,2,2,44,48,
Beckham,Commissioner of Labor,Cathy Costello,REP,50333,3,3,72,78,
Beckham,Commissioner of Labor,Leslie Osborn,REP,50333,3,0,64,67,
Beckham,Corporation Commissioner,Bob Anthony,REP,50333,5,1,72,78,
Beckham,Corporation Commissioner,Brian Bingman,REP,50333,1,2,67,70,
Beckham,Governor,Chris Powell,LIB,50333,0,0,0,0,
Beckham,Governor,Rex Lawhorn,LIB,50333,0,0,0,0,
Beckham,Corporation Commissioner,Ashley Nicole Mccray,DEM,50333,1,0,16,17,
Beckham,Corporation Commissioner,Blake Cummings,DEM,50333,1,0,14,15,
Beckham,Governor,Mick Cornett,REP,50343,0,4,7,11,
Beckham,Governor,Kevin Stitt,REP,50343,0,3,17,20,
Beckham,Lieutenant Governor,Dana Murphy,REP,50343,0,2,10,12,
Beckham,Lieutenant Governor,Matt Pinnell,REP,50343,0,5,14,19,
Beckham,State Auditor,Cindy Byrd,REP,50343,0,5,7,12,
Beckham,State Auditor,Charlie Prater,REP,50343,0,2,17,19,
Beckham,Attorney General,Mike Hunter,REP,50343,0,7,12,19,
Beckham,Attorney General,Gentner Drummond,REP,50343,0,0,12,12,
Beckham,Superintendent of Public Instruction,Joy Hofmeister,REP,50343,0,5,12,17,
Beckham,Superintendent of Public Instruction,Linda Murphy,REP,50343,0,2,12,14,
Beckham,Commissioner of Labor,Cathy Costello,REP,50343,0,4,9,13,
Beckham,Commissioner of Labor,Leslie Osborn,REP,50343,0,3,15,18,
Beckham,Corporation Commissioner,Bob Anthony,REP,50343,0,4,12,16,
Beckham,Corporation Commissioner,Brian Bingman,REP,50343,0,3,12,15,
Beckham,Governor,Chris Powell,LIB,50343,0,0,0,0,
Beckham,Governor,Rex Lawhorn,LIB,50343,0,0,0,0,
Beckham,Corporation Commissioner,Ashley Nicole Mccray,DEM,50343,3,0,1,4,
Beckham,Corporation Commissioner,Blake Cummings,DEM,50343,0,2,2,4,
Blaine,Governor,Mick Cornett,REP,60002,3,1,89,93,
Blaine,Governor,Kevin Stitt,REP,60002,3,5,110,118,
Blaine,Lieutenant Governor,Dana Murphy,REP,60002,5,3,94,102,
Blaine,Lieutenant Governor,Matt Pinnell,REP,60002,1,3,101,105,
Blaine,State Auditor,Cindy Byrd,REP,60002,2,0,58,60,
Blaine,State Auditor,Charlie Prater,REP,60002,4,6,135,145,
Blaine,Attorney General,Mike Hunter,REP,60002,6,2,88,96,
Blaine,Attorney General,Gentner Drummond,REP,60002,0,3,107,110,
Blaine,Superintendent of Public Instruction,Joy Hofmeister,REP,60002,3,4,116,123,
Blaine,Superintendent of Public Instruction,Linda Murphy,REP,60002,3,2,78,83,
Blaine,Commissioner of Labor,Cathy Costello,REP,60002,3,2,76,81,
Blaine,Commissioner of Labor,Leslie Osborn,REP,60002,3,4,114,121,
Blaine,Corporation Commissioner,Bob Anthony,REP,60002,4,3,107,114,
Blaine,Corporation Commissioner,Brian Bingman,REP,60002,2,3,87,92,
Blaine,Governor,Chris Powell,LIB,60002,0,0,0,0,
Blaine,Governor,Rex Lawhorn,LIB,60002,0,0,0,0,
Blaine,Corporation Commissioner,Ashley Nicole Mccray,DEM,60002,0,0,16,16,
Blaine,Corporation Commissioner,Blake Cummings,DEM,60002,1,0,19,20,
Blaine,Governor,Mick Cornett,REP,60007,1,3,47,51,
Blaine,Governor,Kevin Stitt,REP,60007,0,2,109,111,
Blaine,Lieutenant Governor,Dana Murphy,REP,60007,1,2,68,71,
Blaine,Lieutenant Governor,Matt Pinnell,REP,60007,0,3,88,91,
Blaine,State Auditor,Cindy Byrd,REP,60007,1,3,58,62,
Blaine,State Auditor,Charlie Prater,REP,60007,0,2,97,99,
Blaine,Attorney General,Mike Hunter,REP,60007,1,1,75,77,
Blaine,Attorney General,Gentner Drummond,REP,60007,0,4,81,85,
Blaine,Superintendent of Public Instruction,Joy Hofmeister,REP,60007,1,0,78,79,
Blaine,Superintendent of Public Instruction,Linda Murphy,REP,60007,0,5,77,82,
Blaine,Commissioner of Labor,Cathy Costello,REP,60007,1,1,69,71,
Blaine,Commissioner of Labor,Leslie Osborn,REP,60007,0,4,85,89,
Blaine,Corporation Commissioner,Bob Anthony,REP,60007,1,3,67,71,
Blaine,Corporation Commissioner,Brian Bingman,REP,60007,0,2,87,89,
Blaine,Governor,Chris Powell,LIB,60007,0,0,0,0,
Blaine,Governor,Rex Lawhorn,LIB,60007,0,0,0,0,
Blaine,Corporation Commissioner,Ashley Nicole Mccray,DEM,60007,2,0,22,24,
Blaine,Corporation Commissioner,Blake Cummings,DEM,60007,1,1,21,23,
Blaine,Governor,Mick Cornett,REP,60010,0,2,44,46,
Blaine,Governor,Kevin Stitt,REP,60010,3,5,32,40,
Blaine,Lieutenant Governor,Dana Murphy,REP,60010,3,4,48,55,
Blaine,Lieutenant Governor,Matt Pinnell,REP,60010,0,3,29,32,
Blaine,State Auditor,Cindy Byrd,REP,60010,2,3,36,41,
Blaine,State Auditor,Charlie Prater,REP,60010,1,4,40,45,
Blaine,Attorney General,Mike Hunter,REP,60010,2,0,45,47,
Blaine,Attorney General,Gentner Drummond,REP,60010,1,7,32,40,
Blaine,Superintendent of Public Instruction,Joy Hofmeister,REP,60010,3,5,42,50,
Blaine,Superintendent of Public Instruction,Linda Murphy,REP,60010,0,2,32,34,
Blaine,Commissioner of Labor,Cathy Costello,REP,60010,2,3,36,41,
Blaine,Commissioner of Labor,Leslie Osborn,REP,60010,1,4,40,45,
Blaine,Corporation Commissioner,Bob Anthony,REP,60010,3,4,43,50,
Blaine,Corporation Commissioner,Brian Bingman,REP,60010,0,3,32,35,
Blaine,Governor,Chris Powell,LIB,60010,0,0,0,0,
Blaine,Governor,Rex Lawhorn,LIB,60010,0,0,0,0,
Blaine,Corporation Commissioner,Ashley Nicole Mccray,DEM,60010,0,0,8,8,
Blaine,Corporation Commissioner,Blake Cummings,DEM,60010,0,0,5,5,
Blaine,Governor,Mick Cornett,REP,60011,0,2,23,25,
Blaine,Governor,Kevin Stitt,REP,60011,1,3,18,22,
Blaine,Lieutenant Governor,Dana Murphy,REP,60011,0,1,22,23,
Blaine,Lieutenant Governor,Matt Pinnell,REP,60011,1,4,19,24,
Blaine,State Auditor,Cindy Byrd,REP,60011,0,3,19,22,
Blaine,State Auditor,Charlie Prater,REP,60011,1,2,22,25,
Blaine,Attorney General,Mike Hunter,REP,60011,0,3,23,26,
Blaine,Attorney General,Gentner Drummond,REP,60011,1,2,18,21,
Blaine,Superintendent of Public Instruction,Joy Hofmeister,REP,60011,0,4,14,18,
Blaine,Superintendent of Public Instruction,Linda Murphy,REP,60011,0,1,25,26,
Blaine,Commissioner of Labor,Cathy Costello,REP,60011,0,2,15,17,
Blaine,Commissioner of Labor,Leslie Osborn,REP,60011,0,3,24,27,
Blaine,Corporation Commissioner,Bob Anthony,REP,60011,0,3,23,26,
Blaine,Corporation Commissioner,Brian Bingman,REP,60011,1,2,18,21,
Blaine,Governor,Chris Powell,LIB,60011,0,0,0,0,
Blaine,Governor,Rex Lawhorn,LIB,60011,0,0,0,0,
Blaine,Corporation Commissioner,Ashley Nicole Mccray,DEM,60011,0,2,10,12,
Blaine,Corporation Commissioner,Blake Cummings,DEM,60011,0,1,11,12,
Blaine,Governor,Mick Cornett,REP,60012,9,20,112,141,
Blaine,Governor,Kevin Stitt,REP,60012,5,19,88,112,
Blaine,Lieutenant Governor,Dana Murphy,REP,60012,8,24,100,132,
Blaine,Lieutenant Governor,Matt Pinnell,REP,60012,6,15,94,115,
Blaine,State Auditor,Cindy Byrd,REP,60012,10,15,79,104,
Blaine,State Auditor,Charlie Prater,REP,60012,4,24,109,137,
Blaine,Attorney General,Mike Hunter,REP,60012,9,22,101,132,
Blaine,Attorney General,Gentner Drummond,REP,60012,5,15,96,116,
Blaine,Superintendent of Public Instruction,Joy Hofmeister,REP,60012,6,21,115,142,
Blaine,Superintendent of Public Instruction,Linda Murphy,REP,60012,8,18,81,107,
Blaine,Commissioner of Labor,Cathy Costello,REP,60012,7,15,93,115,
Blaine,Commissioner of Labor,Leslie Osborn,REP,60012,7,24,101,132,
Blaine,Corporation Commissioner,Bob Anthony,REP,60012,8,26,99,133,
Blaine,Corporation Commissioner,Brian Bingman,REP,60012,6,13,95,114,
Blaine,Governor,Chris Powell,LIB,60012,0,0,0,0,
Blaine,Governor,Rex Lawhorn,LIB,60012,0,0,0,0,
Blaine,Corporation Commissioner,Ashley Nicole Mccray,DEM,60012,5,5,32,42,
Blaine,Corporation Commissioner,Blake Cummings,DEM,60012,2,2,21,25,
Blaine,Governor,Mick Cornett,REP,60016,1,3,23,27,
Blaine,Governor,Kevin Stitt,REP,60016,0,2,22,24,
Blaine,Lieutenant Governor,Dana Murphy,REP,60016,1,3,21,25,
Blaine,Lieutenant Governor,Matt Pinnell,REP,60016,0,2,23,25,
Blaine,State Auditor,Cindy Byrd,REP,60016,1,4,12,17,
Blaine,State Auditor,Charlie Prater,REP,60016,0,1,29,30,
Blaine,Attorney General,Mike Hunter,REP,60016,1,1,12,14,
Blaine,Attorney General,Gentner Drummond,REP,60016,0,4,29,33,
Blaine,Superintendent of Public Instruction,Joy Hofmeister,REP,60016,0,2,14,16,
Blaine,Superintendent of Public Instruction,Linda Murphy,REP,60016,1,3,31,35,
Blaine,Commissioner of Labor,Cathy Costello,REP,60016,1,1,24,26,
Blaine,Commissioner of Labor,Leslie Osborn,REP,60016,0,4,19,23,
Blaine,Corporation Commissioner,Bob Anthony,REP,60016,1,4,24,29,
Blaine,Corporation Commissioner,Brian Bingman,REP,60016,0,1,18,19,
Blaine,Governor,Chris Powell,LIB,60016,0,0,0,0,
Blaine,Governor,Rex Lawhorn,LIB,60016,0,0,0,0,
Blaine,Corporation Commissioner,Ashley Nicole Mccray,DEM,60016,0,2,3,5,
Blaine,Corporation Commissioner,Blake Cummings,DEM,60016,0,0,6,6,
Blaine,Governor,Mick Cornett,REP,60017,3,1,43,47,
Blaine,Governor,Kevin Stitt,REP,60017,1,1,54,56,
Blaine,Lieutenant Governor,Dana Murphy,REP,60017,1,2,42,45,
Blaine,Lieutenant Governor,Matt Pinnell,REP,60017,3,0,51,54,
Blaine,State Auditor,Cindy Byrd,REP,60017,0,2,39,41,
Blaine,State Auditor,Charlie Prater,REP,60017,4,0,51,55,
Blaine,Attorney General,Mike Hunter,REP,60017,1,2,42,45,
Blaine,Attorney General,Gentner Drummond,REP,60017,3,0,52,55,
Blaine,Superintendent of Public Instruction,Joy Hofmeister,REP,60017,3,1,39,43,
Blaine,Superintendent of Public Instruction,Linda Murphy,REP,60017,1,1,52,54,
Blaine,Commissioner of Labor,Cathy Costello,REP,60017,2,2,39,43,
Blaine,Commissioner of Labor,Leslie Osborn,REP,60017,2,0,50,52,
Blaine,Corporation Commissioner,Bob Anthony,REP,60017,3,1,34,38,
Blaine,Corporation Commissioner,Brian Bingman,REP,60017,1,1,57,59,
Blaine,Governor,Chris Powell,LIB,60017,0,0,0,0,
Blaine,Governor,Rex Lawhorn,LIB,60017,0,0,0,0,
Blaine,Corporation Commissioner,Ashley Nicole Mccray,DEM,60017,0,0,18,18,
Blaine,Corporation Commissioner,Blake Cummings,DEM,60017,0,0,22,22,
Blaine,Governor,Mick Cornett,REP,60020,3,2,30,35,
Blaine,Governor,Kevin Stitt,REP,60020,3,0,45,48,
Blaine,Lieutenant Governor,Dana Murphy,REP,60020,6,2,41,49,
Blaine,Lieutenant Governor,Matt Pinnell,REP,60020,0,0,32,32,
Blaine,State Auditor,Cindy Byrd,REP,60020,3,1,37,41,
Blaine,State Auditor,Charlie Prater,REP,60020,3,1,34,38,
Blaine,Attorney General,Mike Hunter,REP,60020,5,1,39,45,
Blaine,Attorney General,Gentner Drummond,REP,60020,0,1,34,35,
Blaine,Superintendent of Public Instruction,Joy Hofmeister,REP,60020,3,0,40,43,
Blaine,Superintendent of Public Instruction,Linda Murphy,REP,60020,3,2,34,39,
Blaine,Commissioner of Labor,Cathy Costello,REP,60020,2,0,28,30,
Blaine,Commissioner of Labor,Leslie Osborn,REP,60020,4,2,45,51,
Blaine,Corporation Commissioner,Bob Anthony,REP,60020,5,2,42,49,
Blaine,Corporation Commissioner,Brian Bingman,REP,60020,1,0,30,31,
Blaine,Governor,Chris Powell,LIB,60020,0,0,0,0,
Blaine,Governor,Rex Lawhorn,LIB,60020,0,0,0,0,
Blaine,Corporation Commissioner,Ashley Nicole Mccray,DEM,60020,0,0,8,8,
Blaine,Corporation Commissioner,Blake Cummings,DEM,60020,0,0,9,9,
Blaine,Governor,Mick Cornett,REP,60022,1,1,2,4,
Blaine,Governor,Kevin Stitt,REP,60022,0,1,11,12,
Blaine,Lieutenant Governor,Dana Murphy,REP,60022,1,1,5,7,
Blaine,Lieutenant Governor,Matt Pinnell,REP,60022,0,1,8,9,
Blaine,State Auditor,Cindy Byrd,REP,60022,1,0,4,5,
Blaine,State Auditor,Charlie Prater,REP,60022,0,2,9,11,
Blaine,Attorney General,Mike Hunter,REP,60022,1,1,10,12,
Blaine,Attorney General,Gentner Drummond,REP,60022,0,1,3,4,
Blaine,Superintendent of Public Instruction,Joy Hofmeister,REP,60022,1,0,8,9,
Blaine,Superintendent of Public Instruction,Linda Murphy,REP,60022,0,2,5,7,
Blaine,Commissioner of Labor,Cathy Costello,REP,60022,1,1,7,9,
Blaine,Commissioner of Labor,Leslie Osborn,REP,60022,0,1,6,7,
Blaine,Corporation Commissioner,Bob Anthony,REP,60022,1,1,10,12,
Blaine,Corporation Commissioner,Brian Bingman,REP,60022,0,1,3,4,
Blaine,Governor,Chris Powell,LIB,60022,0,0,0,0,
Blaine,Governor,Rex Lawhorn,LIB,60022,0,0,0,0,
Blaine,Corporation Commissioner,Ashley Nicole Mccray,DEM,60022,0,0,3,3,
Blaine,Corporation Commissioner,Blake Cummings,DEM,60022,0,0,2,2,
Bryan,Governor,Mick Cornett,REP,70003,1,0,9,10,
Bryan,Governor,Kevin Stitt,REP,70003,2,5,34,41,
Bryan,Lieutenant Governor,Dana Murphy,REP,70003,1,0,16,17,
Bryan,Lieutenant Governor,Matt Pinnell,REP,70003,2,4,28,34,
Bryan,State Auditor,Cindy Byrd,REP,70003,1,3,23,27,
Bryan,State Auditor,Charlie Prater,REP,70003,2,2,19,23,
Bryan,Attorney General,Mike Hunter,REP,70003,1,2,23,26,
Bryan,Attorney General,Gentner Drummond,REP,70003,2,3,20,25,
Bryan,Superintendent of Public Instruction,Joy Hofmeister,REP,70003,0,4,28,32,
Bryan,Superintendent of Public Instruction,Linda Murphy,REP,70003,3,0,15,18,
Bryan,Commissioner of Labor,Cathy Costello,REP,70003,2,3,28,33,
Bryan,Commissioner of Labor,Leslie Osborn,REP,70003,1,1,14,16,
Bryan,Corporation Commissioner,Bob Anthony,REP,70003,0,4,23,27,
Bryan,Corporation Commissioner,Brian Bingman,REP,70003,3,1,14,18,
Bryan,Governor,Chris Powell,LIB,70003,0,0,2,2,
Bryan,Governor,Rex Lawhorn,LIB,70003,0,0,1,1,
Bryan,Corporation Commissioner,Ashley Nicole Mccray,DEM,70003,0,2,30,32,
Bryan,Corporation Commissioner,Blake Cummings,DEM,70003,2,0,20,22,
Bryan,U.S. House,Jason Nichols,DEM,70003,0,0,12,12,02
Bryan,U.S. House,Clay Padgett,DEM,70003,2,2,38,42,02
Bryan,Governor,Mick Cornett,REP,70004,2,0,9,11,
Bryan,Governor,Kevin Stitt,REP,70004,0,1,23,24,
Bryan,Lieutenant Governor,Dana Murphy,REP,70004,0,0,9,9,
Bryan,Lieutenant Governor,Matt Pinnell,REP,70004,2,1,23,26,
Bryan,State Auditor,Cindy Byrd,REP,70004,2,0,23,25,
Bryan,State Auditor,Charlie Prater,REP,70004,0,1,10,11,
Bryan,Attorney General,Mike Hunter,REP,70004,0,0,19,19,
Bryan,Attorney General,Gentner Drummond,REP,70004,2,1,14,17,
Bryan,Superintendent of Public Instruction,Joy Hofmeister,REP,70004,2,1,16,19,
Bryan,Superintendent of Public Instruction,Linda Murphy,REP,70004,0,0,18,18,
Bryan,Commissioner of Labor,Cathy Costello,REP,70004,0,1,21,22,
Bryan,Commissioner of Labor,Leslie Osborn,REP,70004,2,0,12,14,
Bryan,Corporation Commissioner,Bob Anthony,REP,70004,2,1,19,22,
Bryan,Corporation Commissioner,Brian Bingman,REP,70004,0,0,13,13,
Bryan,Governor,Chris Powell,LIB,70004,0,0,0,0,
Bryan,Governor,Rex Lawhorn,LIB,70004,0,0,0,0,
Bryan,Corporation Commissioner,Ashley Nicole Mccray,DEM,70004,1,3,28,32,
Bryan,Corporation Commissioner,Blake Cummings,DEM,70004,6,3,22,31,
Bryan,U.S. House,Jason Nichols,DEM,70004,1,6,31,38,02
Bryan,U.S. House,Clay Padgett,DEM,70004,6,0,18,24,02
Bryan,Governor,Mick Cornett,REP,70005,2,2,17,21,
Bryan,Governor,Kevin Stitt,REP,70005,1,5,33,39,
Bryan,Lieutenant Governor,Dana Murphy,REP,70005,1,1,22,24,
Bryan,Lieutenant Governor,Matt Pinnell,REP,70005,2,6,27,35,
Bryan,State Auditor,Cindy Byrd,REP,70005,0,4,39,43,
Bryan,State Auditor,Charlie Prater,REP,70005,3,3,9,15,
Bryan,Attorney General,Mike Hunter,REP,70005,3,5,24,32,
Bryan,Attorney General,Gentner Drummond,REP,70005,1,2,26,29,
Bryan,Superintendent of Public Instruction,Joy Hofmeister,REP,70005,4,4,24,32,
Bryan,Superintendent of Public Instruction,Linda Murphy,REP,70005,0,3,25,28,
Bryan,Commissioner of Labor,Cathy Costello,REP,70005,3,4,25,32,
Bryan,Commissioner of Labor,Leslie Osborn,REP,70005,1,3,23,27,
Bryan,Corporation Commissioner,Bob Anthony,REP,70005,2,3,20,25,
Bryan,Corporation Commissioner,Brian Bingman,REP,70005,2,4,27,33,
Bryan,Governor,Chris Powell,LIB,70005,0,0,0,0,
Bryan,Governor,Rex Lawhorn,LIB,70005,0,0,0,0,
Bryan,Corporation Commissioner,Ashley Nicole Mccray,DEM,70005,3,0,50,53,
Bryan,Corporation Commissioner,Blake Cummings,DEM,70005,4,0,23,27,
Bryan,U.S. House,Jason Nichols,DEM,70005,1,0,30,31,02
Bryan,U.S. House,Clay Padgett,DEM,70005,6,0,42,48,02
Bryan,Governor,Mick Cornett,REP,70008,3,0,17,20,
Bryan,Governor,Kevin Stitt,REP,70008,2,6,35,43,
Bryan,Lieutenant Governor,Dana Murphy,REP,70008,4,1,15,20,
Bryan,Lieutenant Governor,Matt Pinnell,REP,70008,1,4,37,42,
Bryan,State Auditor,Cindy Byrd,REP,70008,3,2,28,33,
Bryan,State Auditor,Charlie Prater,REP,70008,2,3,25,30,
Bryan,Attorney General,Mike Hunter,REP,70008,2,1,29,32,
Bryan,Attorney General,Gentner Drummond,REP,70008,3,5,24,32,
Bryan,Superintendent of Public Instruction,Joy Hofmeister,REP,70008,3,3,25,31,
Bryan,Superintendent of Public Instruction,Linda Murphy,REP,70008,2,1,28,31,
Bryan,Commissioner of Labor,Cathy Costello,REP,70008,2,3,37,42,
Bryan,Commissioner of Labor,Leslie Osborn,REP,70008,3,1,15,19,
Bryan,Corporation Commissioner,Bob Anthony,REP,70008,2,4,33,39,
Bryan,Corporation Commissioner,Brian Bingman,REP,70008,2,1,20,23,
Bryan,Governor,Chris Powell,LIB,70008,0,0,0,0,
Bryan,Governor,Rex Lawhorn,LIB,70008,0,0,0,0,
Bryan,Corporation Commissioner,Ashley Nicole Mccray,DEM,70008,5,2,38,45,
Bryan,Corporation Commissioner,Blake Cummings,DEM,70008,6,1,31,38,
Bryan,U.S. House,Jason Nichols,DEM,70008,7,2,30,39,02
Bryan,U.S. House,Clay Padgett,DEM,70008,5,1,40,46,02
Bryan,Governor,Mick Cornett,REP,70010,0,0,11,11,
Bryan,Governor,Kevin Stitt,REP,70010,0,0,23,23,
Bryan,Lieutenant Governor,Dana Murphy,REP,70010,0,0,10,10,
Bryan,Lieutenant Governor,Matt Pinnell,REP,70010,0,0,24,24,
Bryan,State Auditor,Cindy Byrd,REP,70010,0,0,22,22,
Bryan,State Auditor,Charlie Prater,REP,70010,0,0,11,11,
Bryan,Attorney General,Mike Hunter,REP,70010,0,0,17,17,
Bryan,Attorney General,Gentner Drummond,REP,70010,0,0,17,17,
Bryan,Superintendent of Public Instruction,Joy Hofmeister,REP,70010,0,0,12,12,
Bryan,Superintendent of Public Instruction,Linda Murphy,REP,70010,0,0,20,20,
Bryan,Commissioner of Labor,Cathy Costello,REP,70010,0,0,15,15,
Bryan,Commissioner of Labor,Leslie Osborn,REP,70010,0,0,17,17,
Bryan,Corporation Commissioner,Bob Anthony,REP,70010,0,0,15,15,
Bryan,Corporation Commissioner,Brian Bingman,REP,70010,0,0,17,17,
Bryan,Governor,Chris Powell,LIB,70010,0,0,1,1,
Bryan,Governor,Rex Lawhorn,LIB,70010,0,0,0,0,
Bryan,Corporation Commissioner,Ashley Nicole Mccray,DEM,70010,0,0,11,11,
Bryan,Corporation Commissioner,Blake Cummings,DEM,70010,1,0,12,13,
Bryan,U.S. House,Jason Nichols,DEM,70010,1,0,14,15,02
Bryan,U.S. House,Clay Padgett,DEM,70010,0,0,9,9,02
Bryan,Governor,Mick Cornett,REP,70011,0,0,6,6,
Bryan,Governor,Kevin Stitt,REP,70011,0,0,11,11,
Bryan,Lieutenant Governor,Dana Murphy,REP,70011,0,0,2,2,
Bryan,Lieutenant Governor,Matt Pinnell,REP,70011,0,0,15,15,
Bryan,State Auditor,Cindy Byrd,REP,70011,0,0,6,6,
Bryan,State Auditor,Charlie Prater,REP,70011,0,0,11,11,
Bryan,Attorney General,Mike Hunter,REP,70011,0,0,7,7,
Bryan,Attorney General,Gentner Drummond,REP,70011,0,0,10,10,
Bryan,Superintendent of Public Instruction,Joy Hofmeister,REP,70011,0,0,4,4,
Bryan,Superintendent of Public Instruction,Linda Murphy,REP,70011,0,0,11,11,
Bryan,Commissioner of Labor,Cathy Costello,REP,70011,0,0,6,6,
Bryan,Commissioner of Labor,Leslie Osborn,REP,70011,0,0,9,9,
Bryan,Corporation Commissioner,Bob Anthony,REP,70011,0,0,7,7,
Bryan,Corporation Commissioner,Brian Bingman,REP,70011,0,0,9,9,
Bryan,Governor,Chris Powell,LIB,70011,0,0,0,0,
Bryan,Governor,Rex Lawhorn,LIB,70011,0,0,0,0,
Bryan,Corporation Commissioner,Ashley Nicole Mccray,DEM,70011,0,0,5,5,
Bryan,Corporation Commissioner,Blake Cummings,DEM,70011,0,0,7,7,
Bryan,U.S. House,Jason Nichols,DEM,70011,0,0,8,8,02
Bryan,U.S. House,Clay Padgett,DEM,70011,0,0,4,4,02
Bryan,Governor,Mick Cornett,REP,70013,1,0,11,12,
Bryan,Governor,Kevin Stitt,REP,70013,2,0,43,45,
Bryan,Lieutenant Governor,Dana Murphy,REP,70013,0,0,18,18,
Bryan,Lieutenant Governor,Matt Pinnell,REP,70013,3,0,36,39,
Bryan,State Auditor,Cindy Byrd,REP,70013,2,0,27,29,
Bryan,State Auditor,Charlie Prater,REP,70013,1,0,25,26,
Bryan,Attorney General,Mike Hunter,REP,70013,3,0,16,19,
Bryan,Attorney General,Gentner Drummond,REP,70013,0,0,37,37,
Bryan,Superintendent of Public Instruction,Joy Hofmeister,REP,70013,0,0,21,21,
Bryan,Superintendent of Public Instruction,Linda Murphy,REP,70013,3,0,30,33,
Bryan,Commissioner of Labor,Cathy Costello,REP,70013,3,0,31,34,
Bryan,Commissioner of Labor,Leslie Osborn,REP,70013,0,0,16,16,
Bryan,Corporation Commissioner,Bob Anthony,REP,70013,0,0,27,27,
Bryan,Corporation Commissioner,Brian Bingman,REP,70013,3,0,23,26,
Bryan,Governor,Chris Powell,LIB,70013,0,0,0,0,
Bryan,Governor,Rex Lawhorn,LIB,70013,0,0,0,0,
Bryan,Corporation Commissioner,Ashley Nicole Mccray,DEM,70013,1,1,13,15,
Bryan,Corporation Commissioner,Blake Cummings,DEM,70013,0,0,19,19,
Bryan,U.S. House,Jason Nichols,DEM,70013,0,0,17,17,02
Bryan,U.S. House,Clay Padgett,DEM,70013,1,1,19,21,02
Bryan,Governor,Mick Cornett,REP,70014,0,0,8,8,
Bryan,Governor,Kevin Stitt,REP,70014,0,2,22,24,
Bryan,Lieutenant Governor,Dana Murphy,REP,70014,0,0,11,11,
Bryan,Lieutenant Governor,Matt Pinnell,REP,70014,0,2,19,21,
Bryan,State Auditor,Cindy Byrd,REP,70014,0,1,15,16,
Bryan,State Auditor,Charlie Prater,REP,70014,0,1,15,16,
Bryan,Attorney General,Mike Hunter,REP,70014,0,2,13,15,
Bryan,Attorney General,Gentner Drummond,REP,70014,0,0,17,17,
Bryan,Superintendent of Public Instruction,Joy Hofmeister,REP,70014,0,2,15,17,
Bryan,Superintendent of Public Instruction,Linda Murphy,REP,70014,0,0,15,15,
Bryan,Commissioner of Labor,Cathy Costello,REP,70014,0,2,22,24,
Bryan,Commissioner of Labor,Leslie Osborn,REP,70014,0,0,8,8,
Bryan,Corporation Commissioner,Bob Anthony,REP,70014,0,1,23,24,
Bryan,Corporation Commissioner,Brian Bingman,REP,70014,0,0,7,7,
Bryan,Governor,Chris Powell,LIB,70014,0,0,0,0,
Bryan,Governor,Rex Lawhorn,LIB,70014,0,0,0,0,
Bryan,Corporation Commissioner,Ashley Nicole Mccray,DEM,70014,0,0,10,10,
Bryan,Corporation Commissioner,Blake Cummings,DEM,70014,1,0,8,9,
Bryan,U.S. House,Jason Nichols,DEM,70014,0,0,11,11,02
Bryan,U.S. House,Clay Padgett,DEM,70014,1,0,7,8,02
Bryan,Governor,Mick Cornett,REP,70015,0,0,10,10,
Bryan,Governor,Kevin Stitt,REP,70015,1,3,31,35,
Bryan,Lieutenant Governor,Dana Murphy,REP,70015,0,0,17,17,
Bryan,Lieutenant Governor,Matt Pinnell,REP,70015,1,3,24,28,
Bryan,State Auditor,Cindy Byrd,REP,70015,0,3,23,26,
Bryan,State Auditor,Charlie Prater,REP,70015,1,0,17,18,
Bryan,Attorney General,Mike Hunter,REP,70015,0,0,16,16,
Bryan,Attorney General,Gentner Drummond,REP,70015,1,3,25,29,
Bryan,Superintendent of Public Instruction,Joy Hofmeister,REP,70015,0,0,10,10,
Bryan,Superintendent of Public Instruction,Linda Murphy,REP,70015,1,3,29,33,
Bryan,Commissioner of Labor,Cathy Costello,REP,70015,0,2,26,28,
Bryan,Commissioner of Labor,Leslie Osborn,REP,70015,1,1,13,15,
Bryan,Corporation Commissioner,Bob Anthony,REP,70015,1,3,13,17,
Bryan,Corporation Commissioner,Brian Bingman,REP,70015,0,0,26,26,
Bryan,Governor,Chris Powell,LIB,70015,0,0,0,0,
Bryan,Governor,Rex Lawhorn,LIB,70015,0,0,0,0,
Bryan,Corporation Commissioner,Ashley Nicole Mccray,DEM,70015,3,0,10,13,
Bryan,Corporation Commissioner,Blake Cummings,DEM,70015,1,1,18,20,
Bryan,U.S. House,Jason Nichols,DEM,70015,2,0,11,13,02
Bryan,U.S. House,Clay Padgett,DEM,70015,2,1,17,20,02
Bryan,Governor,Mick Cornett,REP,70017,0,0,7,7,
Bryan,Governor,Kevin Stitt,REP,70017,0,3,14,17,
Bryan,Lieutenant Governor,Dana Murphy,REP,70017,0,1,10,11,
Bryan,Lieutenant Governor,Matt Pinnell,REP,70017,0,2,11,13,
Bryan,State Auditor,Cindy Byrd,REP,70017,0,3,15,18,
Bryan,State Auditor,Charlie Prater,REP,70017,0,0,7,7,
Bryan,Attorney General,Mike Hunter,REP,70017,0,0,10,10,
Bryan,Attorney General,Gentner Drummond,REP,70017,0,3,13,16,
Bryan,Superintendent of Public Instruction,Joy Hofmeister,REP,70017,0,1,11,12,
Bryan,Superintendent of Public Instruction,Linda Murphy,REP,70017,0,2,10,12,
Bryan,Commissioner of Labor,Cathy Costello,REP,70017,0,1,13,14,
Bryan,Commissioner of Labor,Leslie Osborn,REP,70017,0,2,8,10,
Bryan,Corporation Commissioner,Bob Anthony,REP,70017,0,2,14,16,
Bryan,Corporation Commissioner,Brian Bingman,REP,70017,0,1,7,8,
Bryan,Governor,Chris Powell,LIB,70017,0,0,0,0,
Bryan,Governor,Rex Lawhorn,LIB,70017,0,0,0,0,
Bryan,Corporation Commissioner,Ashley Nicole Mccray,DEM,70017,0,0,20,20,
Bryan,Corporation Commissioner,Blake Cummings,DEM,70017,0,0,16,16,
Bryan,U.S. House,Jason Nichols,DEM,70017,0,0,23,23,02
Bryan,U.S. House,Clay Padgett,DEM,70017,0,0,13,13,02
Bryan,Governor,Mick Cornett,REP,70018,1,0,12,13,
Bryan,Governor,Kevin Stitt,REP,70018,1,1,37,39,
Bryan,Lieutenant Governor,Dana Murphy,REP,70018,1,1,15,17,
Bryan,Lieutenant Governor,Matt Pinnell,REP,70018,1,0,33,34,
Bryan,State Auditor,Cindy Byrd,REP,70018,1,1,31,33,
Bryan,State Auditor,Charlie Prater,REP,70018,1,0,17,18,
Bryan,Attorney General,Mike Hunter,REP,70018,1,0,23,24,
Bryan,Attorney General,Gentner Drummond,REP,70018,1,1,25,27,
Bryan,Superintendent of Public Instruction,Joy Hofmeister,REP,70018,0,0,21,21,
Bryan,Superintendent of Public Instruction,Linda Murphy,REP,70018,2,1,26,29,
Bryan,Commissioner of Labor,Cathy Costello,REP,70018,2,1,31,34,
Bryan,Commissioner of Labor,Leslie Osborn,REP,70018,0,0,17,17,
Bryan,Corporation Commissioner,Bob Anthony,REP,70018,1,1,25,27,
Bryan,Corporation Commissioner,Brian Bingman,REP,70018,1,0,23,24,
Bryan,Governor,Chris Powell,LIB,70018,0,0,0,0,
Bryan,Governor,Rex Lawhorn,LIB,70018,0,0,0,0,
Bryan,Corporation Commissioner,Ashley Nicole Mccray,DEM,70018,0,1,17,18,
Bryan,Corporation Commissioner,Blake Cummings,DEM,70018,4,0,19,23,
Bryan,U.S. House,Jason Nichols,DEM,70018,1,0,20,21,02
Bryan,U.S. House,Clay Padgett,DEM,70018,3,1,16,20,02
Bryan,Governor,Mick Cornett,REP,70019,1,1,13,15,
Bryan,Governor,Kevin Stitt,REP,70019,2,0,28,30,
Bryan,Lieutenant Governor,Dana Murphy,REP,70019,2,0,9,11,
Bryan,Lieutenant Governor,Matt Pinnell,REP,70019,1,1,33,35,
Bryan,State Auditor,Cindy Byrd,REP,70019,3,0,25,28,
Bryan,State Auditor,Charlie Prater,REP,70019,0,1,16,17,
Bryan,Attorney General,Mike Hunter,REP,70019,1,0,23,24,
Bryan,Attorney General,Gentner Drummond,REP,70019,2,1,19,22,
Bryan,Superintendent of Public Instruction,Joy Hofmeister,REP,70019,0,1,24,25,
Bryan,Superintendent of Public Instruction,Linda Murphy,REP,70019,3,0,18,21,
Bryan,Commissioner of Labor,Cathy Costello,REP,70019,3,0,26,29,
Bryan,Commissioner of Labor,Leslie Osborn,REP,70019,0,1,15,16,
Bryan,Corporation Commissioner,Bob Anthony,REP,70019,1,0,24,25,
Bryan,Corporation Commissioner,Brian Bingman,REP,70019,2,1,18,21,
Bryan,Governor,Chris Powell,LIB,70019,0,0,0,0,
Bryan,Governor,Rex Lawhorn,LIB,70019,0,0,0,0,
Bryan,Corporation Commissioner,Ashley Nicole Mccray,DEM,70019,0,1,11,12,
Bryan,Corporation Commissioner,Blake Cummings,DEM,70019,1,1,27,29,
Bryan,U.S. House,Jason Nichols,DEM,70019,1,2,15,18,02
Bryan,U.S. House,Clay Padgett,DEM,70019,0,0,23,23,02
Bryan,Governor,Mick Cornett,REP,70020,2,1,16,19,
Bryan,Governor,Kevin Stitt,REP,70020,2,0,29,31,
Bryan,Lieutenant Governor,Dana Murphy,REP,70020,1,0,18,19,
Bryan,Lieutenant Governor,Matt Pinnell,REP,70020,3,1,24,28,
Bryan,State Auditor,Cindy Byrd,REP,70020,1,0,28,29,
Bryan,State Auditor,Charlie Prater,REP,70020,3,1,16,20,
Bryan,Attorney General,Mike Hunter,REP,70020,3,1,18,22,
Bryan,Attorney General,Gentner Drummond,REP,70020,1,0,27,28,
Bryan,Superintendent of Public Instruction,Joy Hofmeister,REP,70020,1,1,25,27,
Bryan,Superintendent of Public Instruction,Linda Murphy,REP,70020,3,0,18,21,
Bryan,Commissioner of Labor,Cathy Costello,REP,70020,3,0,23,26,
Bryan,Commissioner of Labor,Leslie Osborn,REP,70020,1,1,22,24,
Bryan,Corporation Commissioner,Bob Anthony,REP,70020,1,0,28,29,
Bryan,Corporation Commissioner,Brian Bingman,REP,70020,3,1,15,19,
Bryan,Governor,Chris Powell,LIB,70020,0,0,0,0,
Bryan,Governor,Rex Lawhorn,LIB,70020,0,0,0,0,
Bryan,Corporation Commissioner,Ashley Nicole Mccray,DEM,70020,1,0,17,18,
Bryan,Corporation Commissioner,Blake Cummings,DEM,70020,0,0,18,18,
Bryan,U.S. House,Jason Nichols,DEM,70020,1,0,16,17,02
Bryan,U.S. House,Clay Padgett,DEM,70020,0,0,19,19,02
Bryan,Governor,Mick Cornett,REP,70021,1,2,25,28,
Bryan,Governor,Kevin Stitt,REP,70021,0,2,35,37,
Bryan,Lieutenant Governor,Dana Murphy,REP,70021,0,2,25,27,
Bryan,Lieutenant Governor,Matt Pinnell,REP,70021,1,2,35,38,
Bryan,State Auditor,Cindy Byrd,REP,70021,0,3,28,31,
Bryan,State Auditor,Charlie Prater,REP,70021,1,1,32,34,
Bryan,Attorney General,Mike Hunter,REP,70021,1,3,24,28,
Bryan,Attorney General,Gentner Drummond,REP,70021,0,1,37,38,
Bryan,Superintendent of Public Instruction,Joy Hofmeister,REP,70021,1,3,29,33,
Bryan,Superintendent of Public Instruction,Linda Murphy,REP,70021,0,1,31,32,
Bryan,Commissioner of Labor,Cathy Costello,REP,70021,1,1,34,36,
Bryan,Commissioner of Labor,Leslie Osborn,REP,70021,0,3,26,29,
Bryan,Corporation Commissioner,Bob Anthony,REP,70021,1,0,29,30,
Bryan,Corporation Commissioner,Brian Bingman,REP,70021,0,4,28,32,
Bryan,Governor,Chris Powell,LIB,70021,0,0,2,2,
Bryan,Governor,Rex Lawhorn,LIB,70021,0,0,0,0,
Bryan,Corporation Commissioner,Ashley Nicole Mccray,DEM,70021,1,1,27,29,
Bryan,Corporation Commissioner,Blake Cummings,DEM,70021,0,1,17,18,
Bryan,U.S. House,Jason Nichols,DEM,70021,1,0,11,12,02
Bryan,U.S. House,Clay Padgett,DEM,70021,0,2,32,34,02
Bryan,Governor,Mick Cornett,REP,70022,2,0,12,14,
Bryan,Governor,Kevin Stitt,REP,70022,1,0,40,41,
Bryan,Lieutenant Governor,Dana Murphy,REP,70022,2,0,15,17,
Bryan,Lieutenant Governor,Matt Pinnell,REP,70022,1,0,36,37,
Bryan,State Auditor,Cindy Byrd,REP,70022,1,0,26,27,
Bryan,State Auditor,Charlie Prater,REP,70022,2,0,19,21,
Bryan,Attorney General,Mike Hunter,REP,70022,1,0,23,24,
Bryan,Attorney General,Gentner Drummond,REP,70022,2,0,29,31,
Bryan,Superintendent of Public Instruction,Joy Hofmeister,REP,70022,2,0,25,27,
Bryan,Superintendent of Public Instruction,Linda Murphy,REP,70022,1,0,22,23,
Bryan,Commissioner of Labor,Cathy Costello,REP,70022,2,0,30,32,
Bryan,Commissioner of Labor,Leslie Osborn,REP,70022,1,0,17,18,
Bryan,Corporation Commissioner,Bob Anthony,REP,70022,2,0,28,30,
Bryan,Corporation Commissioner,Brian Bingman,REP,70022,1,0,19,20,
Bryan,Governor,Chris Powell,LIB,70022,0,0,0,0,
Bryan,Governor,Rex Lawhorn,LIB,70022,0,0,0,0,
Bryan,Corporation Commissioner,Ashley Nicole Mccray,DEM,70022,1,0,19,20,
Bryan,Corporation Commissioner,Blake Cummings,DEM,70022,2,0,22,24,
Bryan,U.S. House,Jason Nichols,DEM,70022,1,0,24,25,02
Bryan,U.S. House,Clay Padgett,DEM,70022,2,0,17,19,02
Bryan,Governor,Mick Cornett,REP,70023,0,0,7,7,
Bryan,Governor,Kevin Stitt,REP,70023,0,0,20,20,
Bryan,Lieutenant Governor,Dana Murphy,REP,70023,0,0,8,8,
Bryan,Lieutenant Governor,Matt Pinnell,REP,70023,0,0,18,18,
Bryan,State Auditor,Cindy Byrd,REP,70023,0,0,15,15,
Bryan,State Auditor,Charlie Prater,REP,70023,0,0,10,10,
Bryan,Attorney General,Mike Hunter,REP,70023,0,0,11,11,
Bryan,Attorney General,Gentner Drummond,REP,70023,0,0,15,15,
Bryan,Superintendent of Public Instruction,Joy Hofmeister,REP,70023,0,0,11,11,
Bryan,Superintendent of Public Instruction,Linda Murphy,REP,70023,0,0,14,14,
Bryan,Commissioner of Labor,Cathy Costello,REP,70023,0,0,14,14,
Bryan,Commissioner of Labor,Leslie Osborn,REP,70023,0,0,12,12,
Bryan,Corporation Commissioner,Bob Anthony,REP,70023,0,0,10,10,
Bryan,Corporation Commissioner,Brian Bingman,REP,70023,0,0,15,15,
Bryan,Governor,Chris Powell,LIB,70023,0,0,0,0,
Bryan,Governor,Rex Lawhorn,LIB,70023,0,0,0,0,
Bryan,Corporation Commissioner,Ashley Nicole Mccray,DEM,70023,0,0,12,12,
Bryan,Corporation Commissioner,Blake Cummings,DEM,70023,0,0,17,17,
Bryan,U.S. House,Jason Nichols,DEM,70023,0,0,19,19,02
Bryan,U.S. House,Clay Padgett,DEM,70023,0,0,11,11,02
Bryan,Governor,Mick Cornett,REP,70025,3,0,18,21,
Bryan,Governor,Kevin Stitt,REP,70025,1,8,41,50,
Bryan,Lieutenant Governor,Dana Murphy,REP,70025,0,0,24,24,
Bryan,Lieutenant Governor,Matt Pinnell,REP,70025,4,8,35,47,
Bryan,State Auditor,Cindy Byrd,REP,70025,1,4,31,36,
Bryan,State Auditor,Charlie Prater,REP,70025,3,3,23,29,
Bryan,Attorney General,Mike Hunter,REP,70025,1,5,17,23,
Bryan,Attorney General,Gentner Drummond,REP,70025,3,3,42,48,
Bryan,Superintendent of Public Instruction,Joy Hofmeister,REP,70025,1,3,34,38,
Bryan,Superintendent of Public Instruction,Linda Murphy,REP,70025,3,4,23,30,
Bryan,Commissioner of Labor,Cathy Costello,REP,70025,3,4,33,40,
Bryan,Commissioner of Labor,Leslie Osborn,REP,70025,1,4,23,28,
Bryan,Corporation Commissioner,Bob Anthony,REP,70025,4,5,26,35,
Bryan,Corporation Commissioner,Brian Bingman,REP,70025,0,2,30,32,
Bryan,Governor,Chris Powell,LIB,70025,0,0,0,0,
Bryan,Governor,Rex Lawhorn,LIB,70025,0,0,0,0,
Bryan,Corporation Commissioner,Ashley Nicole Mccray,DEM,70025,1,0,24,25,
Bryan,Corporation Commissioner,Blake Cummings,DEM,70025,3,0,21,24,
Bryan,U.S. House,Jason Nichols,DEM,70025,2,0,29,31,02
Bryan,U.S. House,Clay Padgett,DEM,70025,2,0,13,15,02
Bryan,Governor,Mick Cornett,REP,70026,1,0,11,12,
Bryan,Governor,Kevin Stitt,REP,70026,0,0,32,32,
Bryan,Lieutenant Governor,Dana Murphy,REP,70026,0,0,10,10,
Bryan,Lieutenant Governor,Matt Pinnell,REP,70026,1,0,31,32,
Bryan,State Auditor,Cindy Byrd,REP,70026,0,0,24,24,
Bryan,State Auditor,Charlie Prater,REP,70026,1,0,17,18,
Bryan,Attorney General,Mike Hunter,REP,70026,0,0,13,13,
Bryan,Attorney General,Gentner Drummond,REP,70026,1,0,26,27,
Bryan,Superintendent of Public Instruction,Joy Hofmeister,REP,70026,1,0,15,16,
Bryan,Superintendent of Public Instruction,Linda Murphy,REP,70026,0,0,26,26,
Bryan,Commissioner of Labor,Cathy Costello,REP,70026,1,0,24,25,
Bryan,Commissioner of Labor,Leslie Osborn,REP,70026,0,0,18,18,
Bryan,Corporation Commissioner,Bob Anthony,REP,70026,1,0,18,19,
Bryan,Corporation Commissioner,Brian Bingman,REP,70026,0,0,20,20,
Bryan,Governor,Chris Powell,LIB,70026,0,0,0,0,
Bryan,Governor,Rex Lawhorn,LIB,70026,0,0,0,0,
Bryan,Corporation Commissioner,Ashley Nicole Mccray,DEM,70026,0,0,19,19,
Bryan,Corporation Commissioner,Blake Cummings,DEM,70026,0,0,16,16,
Bryan,U.S. House,Jason Nichols,DEM,70026,0,0,14,14,02
Bryan,U.S. House,Clay Padgett,DEM,70026,0,0,22,22,02
Bryan,Governor,Mick Cornett,REP,70027,0,0,23,23,
Bryan,Governor,Kevin Stitt,REP,70027,0,1,43,44,
Bryan,Lieutenant Governor,Dana Murphy,REP,70027,0,1,13,14,
Bryan,Lieutenant Governor,Matt Pinnell,REP,70027,0,0,53,53,
Bryan,State Auditor,Cindy Byrd,REP,70027,0,0,37,37,
Bryan,State Auditor,Charlie Prater,REP,70027,0,1,29,30,
Bryan,Attorney General,Mike Hunter,REP,70027,0,0,28,28,
Bryan,Attorney General,Gentner Drummond,REP,70027,0,1,36,37,
Bryan,Superintendent of Public Instruction,Joy Hofmeister,REP,70027,0,1,40,41,
Bryan,Superintendent of Public Instruction,Linda Murphy,REP,70027,0,0,25,25,
Bryan,Commissioner of Labor,Cathy Costello,REP,70027,0,0,44,44,
Bryan,Commissioner of Labor,Leslie Osborn,REP,70027,0,1,21,22,
Bryan,Corporation Commissioner,Bob Anthony,REP,70027,0,1,38,39,
Bryan,Corporation Commissioner,Brian Bingman,REP,70027,0,0,27,27,
Bryan,Governor,Chris Powell,LIB,70027,0,0,0,0,
Bryan,Governor,Rex Lawhorn,LIB,70027,0,0,0,0,
Bryan,Corporation Commissioner,Ashley Nicole Mccray,DEM,70027,2,2,22,26,
Bryan,Corporation Commissioner,Blake Cummings,DEM,70027,3,0,18,21,
Bryan,U.S. House,Jason Nichols,DEM,70027,4,2,20,26,02
Bryan,U.S. House,Clay Padgett,DEM,70027,1,0,23,24,02
Bryan,Governor,Mick Cornett,REP,70028,0,0,17,17,
Bryan,Governor,Kevin Stitt,REP,70028,0,1,27,28,
Bryan,Lieutenant Governor,Dana Murphy,REP,70028,0,0,18,18,
Bryan,Lieutenant Governor,Matt Pinnell,REP,70028,0,1,26,27,
Bryan,State Auditor,Cindy Byrd,REP,70028,0,1,28,29,
Bryan,State Auditor,Charlie Prater,REP,70028,0,0,16,16,
Bryan,Attorney General,Mike Hunter,REP,70028,0,0,24,24,
Bryan,Attorney General,Gentner Drummond,REP,70028,0,1,21,22,
Bryan,Superintendent of Public Instruction,Joy Hofmeister,REP,70028,0,1,19,20,
Bryan,Superintendent of Public Instruction,Linda Murphy,REP,70028,0,0,25,25,
Bryan,Commissioner of Labor,Cathy Costello,REP,70028,0,0,28,28,
Bryan,Commissioner of Labor,Leslie Osborn,REP,70028,0,1,16,17,
Bryan,Corporation Commissioner,Bob Anthony,REP,70028,0,0,27,27,
Bryan,Corporation Commissioner,Brian Bingman,REP,70028,0,1,16,17,
Bryan,Governor,Chris Powell,LIB,70028,0,0,0,0,
Bryan,Governor,Rex Lawhorn,LIB,70028,0,0,0,0,
Bryan,Corporation Commissioner,Ashley Nicole Mccray,DEM,70028,1,0,23,24,
Bryan,Corporation Commissioner,Blake Cummings,DEM,70028,0,0,27,27,
Bryan,U.S. House,Jason Nichols,DEM,70028,0,0,28,28,02
Bryan,U.S. House,Clay Padgett,DEM,70028,1,0,22,23,02
Bryan,Governor,Mick Cornett,REP,70029,0,0,2,2,
Bryan,Governor,Kevin Stitt,REP,70029,0,0,1,1,
Bryan,Lieutenant Governor,Dana Murphy,REP,70029,0,0,1,1,
Bryan,Lieutenant Governor,Matt Pinnell,REP,70029,0,0,2,2,
Bryan,State Auditor,Cindy Byrd,REP,70029,0,0,3,3,
Bryan,State Auditor,Charlie Prater,REP,70029,0,0,0,0,
Bryan,Attorney General,Mike Hunter,REP,70029,0,0,2,2,
Bryan,Attorney General,Gentner Drummond,REP,70029,0,0,0,0,
Bryan,Superintendent of Public Instruction,Joy Hofmeister,REP,70029,0,0,3,3,
Bryan,Superintendent of Public Instruction,Linda Murphy,REP,70029,0,0,0,0,
Bryan,Commissioner of Labor,Cathy Costello,REP,70029,0,0,2,2,
Bryan,Commissioner of Labor,Leslie Osborn,REP,70029,0,0,0,0,
Bryan,Corporation Commissioner,Bob Anthony,REP,70029,0,0,2,2,
Bryan,Corporation Commissioner,Brian Bingman,REP,70029,0,0,0,0,
Bryan,Governor,Chris Powell,LIB,70029,0,0,0,0,
Bryan,Governor,Rex Lawhorn,LIB,70029,0,0,0,0,
Bryan,Corporation Commissioner,Ashley Nicole Mccray,DEM,70029,0,0,1,1,
Bryan,Corporation Commissioner,Blake Cummings,DEM,70029,0,0,15,15,
Bryan,U.S. House,Jason Nichols,DEM,70029,0,0,8,8,02
Bryan,U.S. House,Clay Padgett,DEM,70029,0,0,9,9,02
Bryan,Governor,Mick Cornett,REP,70033,5,1,48,54,
Bryan,Governor,Kevin Stitt,REP,70033,8,10,120,138,
Bryan,Lieutenant Governor,Dana Murphy,REP,70033,3,2,60,65,
Bryan,Lieutenant Governor,Matt Pinnell,REP,70033,8,9,103,120,
Bryan,State Auditor,Cindy Byrd,REP,70033,10,11,120,141,
Bryan,State Auditor,Charlie Prater,REP,70033,3,0,39,42,
Bryan,Attorney General,Mike Hunter,REP,70033,10,9,96,115,
Bryan,Attorney General,Gentner Drummond,REP,70033,3,2,69,74,
Bryan,Superintendent of Public Instruction,Joy Hofmeister,REP,70033,1,3,93,97,
Bryan,Superintendent of Public Instruction,Linda Murphy,REP,70033,10,8,70,88,
Bryan,Commissioner of Labor,Cathy Costello,REP,70033,6,11,116,133,
Bryan,Commissioner of Labor,Leslie Osborn,REP,70033,4,0,47,51,
Bryan,Corporation Commissioner,Bob Anthony,REP,70033,8,9,91,108,
Bryan,Corporation Commissioner,Brian Bingman,REP,70033,3,2,68,73,
Bryan,Governor,Chris Powell,LIB,70033,0,0,0,0,
Bryan,Governor,Rex Lawhorn,LIB,70033,0,0,0,0,
Bryan,Corporation Commissioner,Ashley Nicole Mccray,DEM,70033,0,1,61,62,
Bryan,Corporation Commissioner,Blake Cummings,DEM,70033,3,0,53,56,
Bryan,U.S. House,Jason Nichols,DEM,70033,0,0,37,37,02
Bryan,U.S. House,Clay Padgett,DEM,70033,3,2,77,82,02
Caddo,Governor,Mick Cornett,REP,80012,0,1,11,12,
Caddo,Governor,Kevin Stitt,REP,80012,0,0,6,6,
Caddo,Lieutenant Governor,Dana Murphy,REP,80012,0,0,10,10,
Caddo,Lieutenant Governor,Matt Pinnell,REP,80012,0,1,8,9,
Caddo,State Auditor,Cindy Byrd,REP,80012,0,0,7,7,
Caddo,State Auditor,Charlie Prater,REP,80012,0,1,11,12,
Caddo,Attorney General,Mike Hunter,REP,80012,0,0,13,13,
Caddo,Attorney General,Gentner Drummond,REP,80012,0,1,5,6,
Caddo,Superintendent of Public Instruction,Joy Hofmeister,REP,80012,0,1,8,9,
Caddo,Superintendent of Public Instruction,Linda Murphy,REP,80012,0,0,10,10,
Caddo,Commissioner of Labor,Cathy Costello,REP,80012,0,1,8,9,
Caddo,Commissioner of Labor,Leslie Osborn,REP,80012,0,0,10,10,
Caddo,Corporation Commissioner,Bob Anthony,REP,80012,0,0,10,10,
Caddo,Corporation Commissioner,Brian Bingman,REP,80012,0,1,8,9,
Caddo,Governor,Chris Powell,LIB,80012,0,0,0,0,
Caddo,Governor,Rex Lawhorn,LIB,80012,0,0,0,0,
Caddo,Corporation Commissioner,Ashley Nicole Mccray,DEM,80012,1,0,16,17,
Caddo,Corporation Commissioner,Blake Cummings,DEM,80012,0,1,4,5,
Caddo,Governor,Mick Cornett,REP,80022,0,0,14,14,
Caddo,Governor,Kevin Stitt,REP,80022,0,0,16,16,
Caddo,Lieutenant Governor,Dana Murphy,REP,80022,0,0,11,11,
Caddo,Lieutenant Governor,Matt Pinnell,REP,80022,0,0,19,19,
Caddo,State Auditor,Cindy Byrd,REP,80022,0,0,10,10,
Caddo,State Auditor,Charlie Prater,REP,80022,0,0,19,19,
Caddo,Attorney General,Mike Hunter,REP,80022,0,0,19,19,
Caddo,Attorney General,Gentner Drummond,REP,80022,0,0,11,11,
Caddo,Superintendent of Public Instruction,Joy Hofmeister,REP,80022,0,0,17,17,
Caddo,Superintendent of Public Instruction,Linda Murphy,REP,80022,0,0,13,13,
Caddo,Commissioner of Labor,Cathy Costello,REP,80022,0,0,13,13,
Caddo,Commissioner of Labor,Leslie Osborn,REP,80022,0,0,16,16,
Caddo,Corporation Commissioner,Bob Anthony,REP,80022,0,0,15,15,
Caddo,Corporation Commissioner,Brian Bingman,REP,80022,0,0,15,15,
Caddo,Governor,Chris Powell,LIB,80022,0,0,1,1,
Caddo,Governor,Rex Lawhorn,LIB,80022,0,0,0,0,
Caddo,Corporation Commissioner,Ashley Nicole Mccray,DEM,80022,0,6,24,30,
Caddo,Corporation Commissioner,Blake Cummings,DEM,80022,0,2,20,22,
Caddo,Governor,Mick Cornett,REP,80031,0,0,5,5,
Caddo,Governor,Kevin Stitt,REP,80031,0,0,10,10,
Caddo,Lieutenant Governor,Dana Murphy,REP,80031,0,0,7,7,
Caddo,Lieutenant Governor,Matt Pinnell,REP,80031,0,0,8,8,
Caddo,State Auditor,Cindy Byrd,REP,80031,0,0,8,8,
Caddo,State Auditor,Charlie Prater,REP,80031,0,0,7,7,
Caddo,Attorney General,Mike Hunter,REP,80031,0,0,6,6,
Caddo,Attorney General,Gentner Drummond,REP,80031,0,0,9,9,
Caddo,Superintendent of Public Instruction,Joy Hofmeister,REP,80031,0,0,8,8,
Caddo,Superintendent of Public Instruction,Linda Murphy,REP,80031,0,0,7,7,
Caddo,Commissioner of Labor,Cathy Costello,REP,80031,0,0,7,7,
Caddo,Commissioner of Labor,Leslie Osborn,REP,80031,0,0,8,8,
Caddo,Corporation Commissioner,Bob Anthony,REP,80031,0,0,3,3,
Caddo,Corporation Commissioner,Brian Bingman,REP,80031,0,0,12,12,
Caddo,Governor,Chris Powell,LIB,80031,0,0,0,0,
Caddo,Governor,Rex Lawhorn,LIB,80031,0,0,0,0,
Caddo,Corporation Commissioner,Ashley Nicole Mccray,DEM,80031,0,2,10,12,
Caddo,Corporation Commissioner,Blake Cummings,DEM,80031,0,3,9,12,
Caddo,Governor,Mick Cornett,REP,80041,0,6,37,43,
Caddo,Governor,Kevin Stitt,REP,80041,2,3,55,60,
Caddo,Lieutenant Governor,Dana Murphy,REP,80041,1,3,27,31,
Caddo,Lieutenant Governor,Matt Pinnell,REP,80041,1,6,65,72,
Caddo,State Auditor,Cindy Byrd,REP,80041,1,4,39,44,
Caddo,State Auditor,Charlie Prater,REP,80041,1,4,53,58,
Caddo,Attorney General,Mike Hunter,REP,80041,2,2,53,57,
Caddo,Attorney General,Gentner Drummond,REP,80041,0,6,39,45,
Caddo,Superintendent of Public Instruction,Joy Hofmeister,REP,80041,0,6,44,50,
Caddo,Superintendent of Public Instruction,Linda Murphy,REP,80041,2,2,48,52,
Caddo,Commissioner of Labor,Cathy Costello,REP,80041,0,2,44,46,
Caddo,Commissioner of Labor,Leslie Osborn,REP,80041,2,6,47,55,
Caddo,Corporation Commissioner,Bob Anthony,REP,80041,1,5,45,51,
Caddo,Corporation Commissioner,Brian Bingman,REP,80041,1,4,46,51,
Caddo,Governor,Chris Powell,LIB,80041,0,0,0,0,
Caddo,Governor,Rex Lawhorn,LIB,80041,0,0,0,0,
Caddo,Corporation Commissioner,Ashley Nicole Mccray,DEM,80041,2,2,32,36,
Caddo,Corporation Commissioner,Blake Cummings,DEM,80041,2,4,33,39,
Caddo,Governor,Mick Cornett,REP,80051,2,2,39,43,
Caddo,Governor,Kevin Stitt,REP,80051,0,4,41,45,
Caddo,Lieutenant Governor,Dana Murphy,REP,80051,0,2,30,32,
Caddo,Lieutenant Governor,Matt Pinnell,REP,80051,2,4,49,55,
Caddo,State Auditor,Cindy Byrd,REP,80051,2,1,35,38,
Caddo,State Auditor,Charlie Prater,REP,80051,0,5,44,49,
Caddo,Attorney General,Mike Hunter,REP,80051,0,0,37,37,
Caddo,Attorney General,Gentner Drummond,REP,80051,2,6,42,50,
Caddo,Superintendent of Public Instruction,Joy Hofmeister,REP,80051,2,5,44,51,
Caddo,Superintendent of Public Instruction,Linda Murphy,REP,80051,0,1,36,37,
Caddo,Commissioner of Labor,Cathy Costello,REP,80051,1,4,31,36,
Caddo,Commissioner of Labor,Leslie Osborn,REP,80051,1,2,49,52,
Caddo,Corporation Commissioner,Bob Anthony,REP,80051,2,4,33,39,
Caddo,Corporation Commissioner,Brian Bingman,REP,80051,0,2,46,48,
Caddo,Governor,Chris Powell,LIB,80051,0,0,0,0,
Caddo,Governor,Rex Lawhorn,LIB,80051,0,0,0,0,
Caddo,Corporation Commissioner,Ashley Nicole Mccray,DEM,80051,0,4,40,44,
Caddo,Corporation Commissioner,Blake Cummings,DEM,80051,1,3,23,27,
Caddo,Governor,Mick Cornett,REP,80102,2,0,43,45,
Caddo,Governor,Kevin Stitt,REP,80102,2,2,49,53,
Caddo,Lieutenant Governor,Dana Murphy,REP,80102,3,1,39,43,
Caddo,Lieutenant Governor,Matt Pinnell,REP,80102,1,1,53,55,
Caddo,State Auditor,Cindy Byrd,REP,80102,1,1,32,34,
Caddo,State Auditor,Charlie Prater,REP,80102,3,1,58,62,
Caddo,Attorney General,Mike Hunter,REP,80102,1,2,44,47,
Caddo,Attorney General,Gentner Drummond,REP,80102,3,0,47,50,
Caddo,Superintendent of Public Instruction,Joy Hofmeister,REP,80102,2,2,56,60,
Caddo,Superintendent of Public Instruction,Linda Murphy,REP,80102,2,0,35,37,
Caddo,Commissioner of Labor,Cathy Costello,REP,80102,2,0,42,44,
Caddo,Commissioner of Labor,Leslie Osborn,REP,80102,2,2,48,52,
Caddo,Corporation Commissioner,Bob Anthony,REP,80102,1,1,46,48,
Caddo,Corporation Commissioner,Brian Bingman,REP,80102,3,1,45,49,
Caddo,Governor,Chris Powell,LIB,80102,0,0,0,0,
Caddo,Governor,Rex Lawhorn,LIB,80102,0,0,0,0,
Caddo,Corporation Commissioner,Ashley Nicole Mccray,DEM,80102,3,2,26,31,
Caddo,Corporation Commissioner,Blake Cummings,DEM,80102,3,1,28,32,
Caddo,Governor,Mick Cornett,REP,80509,0,1,18,19,
Caddo,Governor,Kevin Stitt,REP,80509,1,0,25,26,
Caddo,Lieutenant Governor,Dana Murphy,REP,80509,0,0,20,20,
Caddo,Lieutenant Governor,Matt Pinnell,REP,80509,1,1,23,25,
Caddo,State Auditor,Cindy Byrd,REP,80509,1,1,16,18,
Caddo,State Auditor,Charlie Prater,REP,80509,0,0,26,26,
Caddo,Attorney General,Mike Hunter,REP,80509,1,0,21,22,
Caddo,Attorney General,Gentner Drummond,REP,80509,0,1,21,22,
Caddo,Superintendent of Public Instruction,Joy Hofmeister,REP,80509,0,0,26,26,
Caddo,Superintendent of Public Instruction,Linda Murphy,REP,80509,1,1,16,18,
Caddo,Commissioner of Labor,Cathy Costello,REP,80509,0,1,13,14,
Caddo,Commissioner of Labor,Leslie Osborn,REP,80509,1,0,30,31,
Caddo,Corporation Commissioner,Bob Anthony,REP,80509,1,1,17,19,
Caddo,Corporation Commissioner,Brian Bingman,REP,80509,0,0,25,25,
Caddo,Governor,Chris Powell,LIB,80509,0,0,0,0,
Caddo,Governor,Rex Lawhorn,LIB,80509,0,0,0,0,
Caddo,Corporation Commissioner,Ashley Nicole Mccray,DEM,80509,2,0,15,17,
Caddo,Corporation Commissioner,Blake Cummings,DEM,80509,1,0,12,13,
Caddo,Governor,Mick Cornett,REP,80510,0,0,36,36,
Caddo,Governor,Kevin Stitt,REP,80510,1,1,44,46,
Caddo,Lieutenant Governor,Dana Murphy,REP,80510,1,1,37,39,
Caddo,Lieutenant Governor,Matt Pinnell,REP,80510,0,0,42,42,
Caddo,State Auditor,Cindy Byrd,REP,80510,1,0,31,32,
Caddo,State Auditor,Charlie Prater,REP,80510,0,1,46,47,
Caddo,Attorney General,Mike Hunter,REP,80510,0,0,36,36,
Caddo,Attorney General,Gentner Drummond,REP,80510,1,1,42,44,
Caddo,Superintendent of Public Instruction,Joy Hofmeister,REP,80510,1,1,47,49,
Caddo,Superintendent of Public Instruction,Linda Murphy,REP,80510,0,0,33,33,
Caddo,Commissioner of Labor,Cathy Costello,REP,80510,1,0,25,26,
Caddo,Commissioner of Labor,Leslie Osborn,REP,80510,0,1,51,52,
Caddo,Corporation Commissioner,Bob Anthony,REP,80510,1,1,41,43,
Caddo,Corporation Commissioner,Brian Bingman,REP,80510,0,0,38,38,
Caddo,Governor,Chris Powell,LIB,80510,0,0,0,0,
Caddo,Governor,Rex Lawhorn,LIB,80510,0,0,0,0,
Caddo,Corporation Commissioner,Ashley Nicole Mccray,DEM,80510,0,0,28,28,
Caddo,Corporation Commissioner,Blake Cummings,DEM,80510,0,1,34,35,
Caddo,Governor,Mick Cornett,REP,80511,3,0,65,68,
Caddo,Governor,Kevin Stitt,REP,80511,0,0,54,54,
Caddo,Lieutenant Governor,Dana Murphy,REP,80511,0,0,45,45,
Caddo,Lieutenant Governor,Matt Pinnell,REP,80511,3,0,74,77,
Caddo,State Auditor,Cindy Byrd,REP,80511,0,0,49,49,
Caddo,State Auditor,Charlie Prater,REP,80511,3,0,66,69,
Caddo,Attorney General,Mike Hunter,REP,80511,0,0,46,46,
Caddo,Attorney General,Gentner Drummond,REP,80511,3,0,73,76,
Caddo,Superintendent of Public Instruction,Joy Hofmeister,REP,80511,1,0,73,74,
Caddo,Superintendent of Public Instruction,Linda Murphy,REP,80511,2,0,45,47,
Caddo,Commissioner of Labor,Cathy Costello,REP,80511,1,0,57,58,
Caddo,Commissioner of Labor,Leslie Osborn,REP,80511,2,0,62,64,
Caddo,Corporation Commissioner,Bob Anthony,REP,80511,2,0,59,61,
Caddo,Corporation Commissioner,Brian Bingman,REP,80511,1,0,56,57,
Caddo,Governor,Chris Powell,LIB,80511,0,0,0,0,
Caddo,Governor,Rex Lawhorn,LIB,80511,0,0,0,0,
Caddo,Corporation Commissioner,Ashley Nicole Mccray,DEM,80511,3,0,29,32,
Caddo,Corporation Commissioner,Blake Cummings,DEM,80511,0,0,20,20,
Caddo,Governor,Mick Cornett,REP,80712,1,0,34,35,
Caddo,Governor,Kevin Stitt,REP,80712,0,0,37,37,
Caddo,Lieutenant Governor,Dana Murphy,REP,80712,0,0,34,34,
Caddo,Lieutenant Governor,Matt Pinnell,REP,80712,1,0,37,38,
Caddo,State Auditor,Cindy Byrd,REP,80712,0,0,27,27,
Caddo,State Auditor,Charlie Prater,REP,80712,1,0,43,44,
Caddo,Attorney General,Mike Hunter,REP,80712,1,0,27,28,
Caddo,Attorney General,Gentner Drummond,REP,80712,0,0,44,44,
Caddo,Superintendent of Public Instruction,Joy Hofmeister,REP,80712,0,0,31,31,
Caddo,Superintendent of Public Instruction,Linda Murphy,REP,80712,1,0,39,40,
Caddo,Commissioner of Labor,Cathy Costello,REP,80712,0,0,33,33,
Caddo,Commissioner of Labor,Leslie Osborn,REP,80712,1,0,37,38,
Caddo,Corporation Commissioner,Bob Anthony,REP,80712,1,0,34,35,
Caddo,Corporation Commissioner,Brian Bingman,REP,80712,0,0,35,35,
Caddo,Governor,Chris Powell,LIB,80712,0,0,0,0,
Caddo,Governor,Rex Lawhorn,LIB,80712,0,0,0,0,
Caddo,Corporation Commissioner,Ashley Nicole Mccray,DEM,80712,1,1,25,27,
Caddo,Corporation Commissioner,Blake Cummings,DEM,80712,0,0,27,27,
Caddo,Governor,Mick Cornett,REP,80715,0,1,8,9,
Caddo,Governor,Kevin Stitt,REP,80715,0,0,12,12,
Caddo,Lieutenant Governor,Dana Murphy,REP,80715,0,1,11,12,
Caddo,Lieutenant Governor,Matt Pinnell,REP,80715,0,0,9,9,
Caddo,State Auditor,Cindy Byrd,REP,80715,0,0,9,9,
Caddo,State Auditor,Charlie Prater,REP,80715,0,0,11,11,
Caddo,Attorney General,Mike Hunter,REP,80715,0,0,10,10,
Caddo,Attorney General,Gentner Drummond,REP,80715,0,1,10,11,
Caddo,Superintendent of Public Instruction,Joy Hofmeister,REP,80715,0,1,10,11,
Caddo,Superintendent of Public Instruction,Linda Murphy,REP,80715,0,0,10,10,
Caddo,Commissioner of Labor,Cathy Costello,REP,80715,0,0,13,13,
Caddo,Commissioner of Labor,Leslie Osborn,REP,80715,0,1,7,8,
Caddo,Corporation Commissioner,Bob Anthony,REP,80715,0,0,11,11,
Caddo,Corporation Commissioner,Brian Bingman,REP,80715,0,1,9,10,
Caddo,Governor,Chris Powell,LIB,80715,0,0,0,0,
Caddo,Governor,Rex Lawhorn,LIB,80715,0,0,0,0,
Caddo,Corporation Commissioner,Ashley Nicole Mccray,DEM,80715,1,0,6,7,
Caddo,Corporation Commissioner,Blake Cummings,DEM,80715,0,1,12,13,
Caddo,Governor,Mick Cornett,REP,80810,0,2,18,20,
Caddo,Governor,Kevin Stitt,REP,80810,1,1,14,16,
Caddo,Lieutenant Governor,Dana Murphy,REP,80810,1,0,13,14,
Caddo,Lieutenant Governor,Matt Pinnell,REP,80810,0,3,18,21,
Caddo,State Auditor,Cindy Byrd,REP,80810,0,1,9,10,
Caddo,State Auditor,Charlie Prater,REP,80810,1,2,22,25,
Caddo,Attorney General,Mike Hunter,REP,80810,1,1,20,22,
Caddo,Attorney General,Gentner Drummond,REP,80810,0,2,10,12,
Caddo,Superintendent of Public Instruction,Joy Hofmeister,REP,80810,1,0,20,21,
Caddo,Superintendent of Public Instruction,Linda Murphy,REP,80810,0,3,12,15,
Caddo,Commissioner of Labor,Cathy Costello,REP,80810,0,2,12,14,
Caddo,Commissioner of Labor,Leslie Osborn,REP,80810,1,1,20,22,
Caddo,Corporation Commissioner,Bob Anthony,REP,80810,1,0,12,13,
Caddo,Corporation Commissioner,Brian Bingman,REP,80810,0,3,19,22,
Caddo,Governor,Chris Powell,LIB,80810,0,0,0,0,
Caddo,Governor,Rex Lawhorn,LIB,80810,0,0,0,0,
Caddo,Corporation Commissioner,Ashley Nicole Mccray,DEM,80810,2,0,9,11,
Caddo,Corporation Commissioner,Blake Cummings,DEM,80810,2,0,4,6,
Caddo,Governor,Mick Cornett,REP,80811,2,5,10,17,
Caddo,Governor,Kevin Stitt,REP,80811,0,0,22,22,
Caddo,Lieutenant Governor,Dana Murphy,REP,80811,1,3,11,15,
Caddo,Lieutenant Governor,Matt Pinnell,REP,80811,1,2,18,21,
Caddo,State Auditor,Cindy Byrd,REP,80811,1,3,12,16,
Caddo,State Auditor,Charlie Prater,REP,80811,1,2,18,21,
Caddo,Attorney General,Mike Hunter,REP,80811,1,0,17,18,
Caddo,Attorney General,Gentner Drummond,REP,80811,0,5,13,18,
Caddo,Superintendent of Public Instruction,Joy Hofmeister,REP,80811,2,3,14,19,
Caddo,Superintendent of Public Instruction,Linda Murphy,REP,80811,0,2,17,19,
Caddo,Commissioner of Labor,Cathy Costello,REP,80811,0,4,14,18,
Caddo,Commissioner of Labor,Leslie Osborn,REP,80811,2,1,17,20,
Caddo,Corporation Commissioner,Bob Anthony,REP,80811,0,1,14,15,
Caddo,Corporation Commissioner,Brian Bingman,REP,80811,2,4,17,23,
Caddo,Governor,Chris Powell,LIB,80811,0,0,0,0,
Caddo,Governor,Rex Lawhorn,LIB,80811,0,0,0,0,
Caddo,Corporation Commissioner,Ashley Nicole Mccray,DEM,80811,0,0,12,12,
Caddo,Corporation Commissioner,Blake Cummings,DEM,80811,1,2,10,13,
Caddo,Governor,Mick Cornett,REP,80812,0,1,9,10,
Caddo,Governor,Kevin Stitt,REP,80812,1,1,30,32,
Caddo,Lieutenant Governor,Dana Murphy,REP,80812,0,0,11,11,
Caddo,Lieutenant Governor,Matt Pinnell,REP,80812,1,2,28,31,
Caddo,State Auditor,Cindy Byrd,REP,80812,1,0,14,15,
Caddo,State Auditor,Charlie Prater,REP,80812,0,2,25,27,
Caddo,Attorney General,Mike Hunter,REP,80812,1,0,20,21,
Caddo,Attorney General,Gentner Drummond,REP,80812,0,2,18,20,
Caddo,Superintendent of Public Instruction,Joy Hofmeister,REP,80812,0,2,26,28,
Caddo,Superintendent of Public Instruction,Linda Murphy,REP,80812,1,0,13,14,
Caddo,Commissioner of Labor,Cathy Costello,REP,80812,0,0,18,18,
Caddo,Commissioner of Labor,Leslie Osborn,REP,80812,1,2,21,24,
Caddo,Corporation Commissioner,Bob Anthony,REP,80812,0,1,14,15,
Caddo,Corporation Commissioner,Brian Bingman,REP,80812,1,1,25,27,
Caddo,Governor,Chris Powell,LIB,80812,0,0,0,0,
Caddo,Governor,Rex Lawhorn,LIB,80812,0,0,0,0,
Caddo,Corporation Commissioner,Ashley Nicole Mccray,DEM,80812,0,0,10,10,
Caddo,Corporation Commissioner,Blake Cummings,DEM,80812,3,0,8,11,
Caddo,Governor,Mick Cornett,REP,81009,0,2,27,29,
Caddo,Governor,Kevin Stitt,REP,81009,1,0,30,31,
Caddo,Lieutenant Governor,Dana Murphy,REP,81009,1,2,18,21,
Caddo,Lieutenant Governor,Matt Pinnell,REP,81009,0,0,38,38,
Caddo,State Auditor,Cindy Byrd,REP,81009,1,0,22,23,
Caddo,State Auditor,Charlie Prater,REP,81009,0,2,30,32,
Caddo,Attorney General,Mike Hunter,REP,81009,1,2,23,26,
Caddo,Attorney General,Gentner Drummond,REP,81009,0,0,31,31,
Caddo,Superintendent of Public Instruction,Joy Hofmeister,REP,81009,0,2,33,35,
Caddo,Superintendent of Public Instruction,Linda Murphy,REP,81009,1,0,22,23,
Caddo,Commissioner of Labor,Cathy Costello,REP,81009,0,0,22,22,
Caddo,Commissioner of Labor,Leslie Osborn,REP,81009,1,2,35,38,
Caddo,Corporation Commissioner,Bob Anthony,REP,81009,1,2,18,21,
Caddo,Corporation Commissioner,Brian Bingman,REP,81009,0,0,38,38,
Caddo,Governor,Chris Powell,LIB,81009,0,0,0,0,
Caddo,Governor,Rex Lawhorn,LIB,81009,0,0,1,1,
Caddo,Corporation Commissioner,Ashley Nicole Mccray,DEM,81009,0,0,10,10,
Caddo,Corporation Commissioner,Blake Cummings,DEM,81009,0,1,15,16,
Caddo,Governor,Mick Cornett,REP,81010,1,3,18,22,
Caddo,Governor,Kevin Stitt,REP,81010,0,3,24,27,
Caddo,Lieutenant Governor,Dana Murphy,REP,81010,0,1,15,16,
Caddo,Lieutenant Governor,Matt Pinnell,REP,81010,1,5,25,31,
Caddo,State Auditor,Cindy Byrd,REP,81010,0,4,13,17,
Caddo,State Auditor,Charlie Prater,REP,81010,1,2,26,29,
Caddo,Attorney General,Mike Hunter,REP,81010,1,3,20,24,
Caddo,Attorney General,Gentner Drummond,REP,81010,0,3,20,23,
Caddo,Superintendent of Public Instruction,Joy Hofmeister,REP,81010,1,4,26,31,
Caddo,Superintendent of Public Instruction,Linda Murphy,REP,81010,0,2,15,17,
Caddo,Commissioner of Labor,Cathy Costello,REP,81010,0,1,18,19,
Caddo,Commissioner of Labor,Leslie Osborn,REP,81010,1,5,22,28,
Caddo,Corporation Commissioner,Bob Anthony,REP,81010,0,3,25,28,
Caddo,Corporation Commissioner,Brian Bingman,REP,81010,1,3,14,18,
Caddo,Governor,Chris Powell,LIB,81010,0,0,0,0,
Caddo,Governor,Rex Lawhorn,LIB,81010,0,0,0,0,
Caddo,Corporation Commissioner,Ashley Nicole Mccray,DEM,81010,1,1,16,18,
Caddo,Corporation Commissioner,Blake Cummings,DEM,81010,2,1,20,23,
Caddo,Governor,Mick Cornett,REP,81011,2,1,18,21,
Caddo,Governor,Kevin Stitt,REP,81011,0,1,33,34,
Caddo,Lieutenant Governor,Dana Murphy,REP,81011,1,0,18,19,
Caddo,Lieutenant Governor,Matt Pinnell,REP,81011,1,2,32,35,
Caddo,State Auditor,Cindy Byrd,REP,81011,1,1,22,24,
Caddo,State Auditor,Charlie Prater,REP,81011,1,1,28,30,
Caddo,Attorney General,Mike Hunter,REP,81011,2,0,21,23,
Caddo,Attorney General,Gentner Drummond,REP,81011,0,2,30,32,
Caddo,Superintendent of Public Instruction,Joy Hofmeister,REP,81011,1,1,25,27,
Caddo,Superintendent of Public Instruction,Linda Murphy,REP,81011,1,1,26,28,
Caddo,Commissioner of Labor,Cathy Costello,REP,81011,1,1,23,25,
Caddo,Commissioner of Labor,Leslie Osborn,REP,81011,1,1,26,28,
Caddo,Corporation Commissioner,Bob Anthony,REP,81011,2,2,24,28,
Caddo,Corporation Commissioner,Brian Bingman,REP,81011,0,0,27,27,
Caddo,Governor,Chris Powell,LIB,81011,0,0,0,0,
Caddo,Governor,Rex Lawhorn,LIB,81011,0,0,0,0,
Caddo,Corporation Commissioner,Ashley Nicole Mccray,DEM,81011,0,0,14,14,
Caddo,Corporation Commissioner,Blake Cummings,DEM,81011,0,0,15,15,
Caddo,Governor,Mick Cornett,REP,81013,6,0,13,19,
Caddo,Governor,Kevin Stitt,REP,81013,3,0,34,37,
Caddo,Lieutenant Governor,Dana Murphy,REP,81013,2,0,24,26,
Caddo,Lieutenant Governor,Matt Pinnell,REP,81013,7,0,23,30,
Caddo,State Auditor,Cindy Byrd,REP,81013,6,0,19,25,
Caddo,State Auditor,Charlie Prater,REP,81013,3,0,28,31,
Caddo,Attorney General,Mike Hunter,REP,81013,6,0,24,30,
Caddo,Attorney General,Gentner Drummond,REP,81013,3,0,23,26,
Caddo,Superintendent of Public Instruction,Joy Hofmeister,REP,81013,6,0,26,32,
Caddo,Superintendent of Public Instruction,Linda Murphy,REP,81013,3,0,20,23,
Caddo,Commissioner of Labor,Cathy Costello,REP,81013,1,0,17,18,
Caddo,Commissioner of Labor,Leslie Osborn,REP,81013,8,0,28,36,
Caddo,Corporation Commissioner,Bob Anthony,REP,81013,4,0,20,24,
Caddo,Corporation Commissioner,Brian Bingman,REP,81013,5,0,26,31,
Caddo,Governor,Chris Powell,LIB,81013,0,0,0,0,
Caddo,Governor,Rex Lawhorn,LIB,81013,0,0,0,0,
Caddo,Corporation Commissioner,Ashley Nicole Mccray,DEM,81013,5,0,4,9,
Caddo,Corporation Commissioner,Blake Cummings,DEM,81013,2,0,17,19,
Caddo,Governor,Mick Cornett,REP,81111,3,1,77,81,
Caddo,Governor,Kevin Stitt,REP,81111,4,4,101,109,
Caddo,Lieutenant Governor,Dana Murphy,REP,81111,4,2,76,82,
Caddo,Lieutenant Governor,Matt Pinnell,REP,81111,3,3,100,106,
Caddo,State Auditor,Cindy Byrd,REP,81111,4,2,68,74,
Caddo,State Auditor,Charlie Prater,REP,81111,3,3,102,108,
Caddo,Attorney General,Mike Hunter,REP,81111,4,2,89,95,
Caddo,Attorney General,Gentner Drummond,REP,81111,3,3,88,94,
Caddo,Superintendent of Public Instruction,Joy Hofmeister,REP,81111,5,3,84,92,
Caddo,Superintendent of Public Instruction,Linda Murphy,REP,81111,2,2,92,96,
Caddo,Commissioner of Labor,Cathy Costello,REP,81111,3,1,61,65,
Caddo,Commissioner of Labor,Leslie Osborn,REP,81111,4,4,112,120,
Caddo,Corporation Commissioner,Bob Anthony,REP,81111,4,3,86,93,
Caddo,Corporation Commissioner,Brian Bingman,REP,81111,3,2,89,94,
Caddo,Governor,Chris Powell,LIB,81111,0,0,0,0,
Caddo,Governor,Rex Lawhorn,LIB,81111,0,0,0,0,
Caddo,Corporation Commissioner,Ashley Nicole Mccray,DEM,81111,0,1,16,17,
Caddo,Corporation Commissioner,Blake Cummings,DEM,81111,2,0,19,21,
Caddo,Governor,Mick Cornett,REP,81213,2,0,24,26,
Caddo,Governor,Kevin Stitt,REP,81213,1,0,59,60,
Caddo,Lieutenant Governor,Dana Murphy,REP,81213,2,0,35,37,
Caddo,Lieutenant Governor,Matt Pinnell,REP,81213,1,0,45,46,
Caddo,State Auditor,Cindy Byrd,REP,81213,3,0,42,45,
Caddo,State Auditor,Charlie Prater,REP,81213,0,0,36,36,
Caddo,Attorney General,Mike Hunter,REP,81213,0,0,41,41,
Caddo,Attorney General,Gentner Drummond,REP,81213,3,0,42,45,
Caddo,Superintendent of Public Instruction,Joy Hofmeister,REP,81213,1,0,49,50,
Caddo,Superintendent of Public Instruction,Linda Murphy,REP,81213,2,0,33,35,
Caddo,Commissioner of Labor,Cathy Costello,REP,81213,1,0,41,42,
Caddo,Commissioner of Labor,Leslie Osborn,REP,81213,2,0,39,41,
Caddo,Corporation Commissioner,Bob Anthony,REP,81213,0,0,37,37,
Caddo,Corporation Commissioner,Brian Bingman,REP,81213,3,0,42,45,
Caddo,Governor,Chris Powell,LIB,81213,0,0,0,0,
Caddo,Governor,Rex Lawhorn,LIB,81213,0,0,0,0,
Caddo,Corporation Commissioner,Ashley Nicole Mccray,DEM,81213,0,0,10,10,
Caddo,Corporation Commissioner,Blake Cummings,DEM,81213,0,0,10,10,
Canadian,Governor,Mick Cornett,REP,90100,2,4,108,114,
Canadian,Governor,Kevin Stitt,REP,90100,2,7,104,113,
Canadian,Lieutenant Governor,Dana Murphy,REP,90100,0,1,94,95,
Canadian,Lieutenant Governor,Matt Pinnell,REP,90100,4,10,114,128,
Canadian,State Auditor,Cindy Byrd,REP,90100,2,3,89,94,
Canadian,State Auditor,Charlie Prater,REP,90100,2,8,117,127,
Canadian,Attorney General,Mike Hunter,REP,90100,2,4,112,118,
Canadian,Attorney General,Gentner Drummond,REP,90100,2,7,96,105,
Canadian,Superintendent of Public Instruction,Joy Hofmeister,REP,90100,4,5,110,119,
Canadian,Superintendent of Public Instruction,Linda Murphy,REP,90100,0,5,98,103,
Canadian,Commissioner of Labor,Cathy Costello,REP,90100,2,6,95,103,
Canadian,Commissioner of Labor,Leslie Osborn,REP,90100,2,5,112,119,
Canadian,Corporation Commissioner,Bob Anthony,REP,90100,4,8,107,119,
Canadian,Corporation Commissioner,Brian Bingman,REP,90100,0,2,101,103,
Canadian,Governor,Chris Powell,LIB,90100,0,0,0,0,
Canadian,Governor,Rex Lawhorn,LIB,90100,0,0,0,0,
Canadian,Corporation Commissioner,Ashley Nicole Mccray,DEM,90100,1,1,16,18,
Canadian,Corporation Commissioner,Blake Cummings,DEM,90100,0,0,20,20,
Canadian,Governor,Mick Cornett,REP,90102,1,2,34,37,
Canadian,Governor,Kevin Stitt,REP,90102,0,1,26,27,
Canadian,Lieutenant Governor,Dana Murphy,REP,90102,0,2,25,27,
Canadian,Lieutenant Governor,Matt Pinnell,REP,90102,1,1,35,37,
Canadian,State Auditor,Cindy Byrd,REP,90102,0,2,36,38,
Canadian,State Auditor,Charlie Prater,REP,90102,1,1,23,25,
Canadian,Attorney General,Mike Hunter,REP,90102,1,2,41,44,
Canadian,Attorney General,Gentner Drummond,REP,90102,0,1,18,19,
Canadian,Superintendent of Public Instruction,Joy Hofmeister,REP,90102,1,2,36,39,
Canadian,Superintendent of Public Instruction,Linda Murphy,REP,90102,0,1,24,25,
Canadian,Commissioner of Labor,Cathy Costello,REP,90102,0,1,24,25,
Canadian,Commissioner of Labor,Leslie Osborn,REP,90102,1,2,36,39,
Canadian,Corporation Commissioner,Bob Anthony,REP,90102,1,1,36,38,
Canadian,Corporation Commissioner,Brian Bingman,REP,90102,0,2,20,22,
Canadian,Governor,Chris Powell,LIB,90102,0,0,0,0,
Canadian,Governor,Rex Lawhorn,LIB,90102,0,0,0,0,
Canadian,Corporation Commissioner,Ashley Nicole Mccray,DEM,90102,0,0,7,7,
Canadian,Corporation Commissioner,Blake Cummings,DEM,90102,0,0,4,4,
Canadian,Governor,Mick Cornett,REP,90106,4,10,108,122,
Canadian,Governor,Kevin Stitt,REP,90106,3,6,66,75,
Canadian,Lieutenant Governor,Dana Murphy,REP,90106,3,8,70,81,
Canadian,Lieutenant Governor,Matt Pinnell,REP,90106,4,8,101,113,
Canadian,State Auditor,Cindy Byrd,REP,90106,4,11,88,103,
Canadian,State Auditor,Charlie Prater,REP,90106,3,4,85,92,
Canadian,Attorney General,Mike Hunter,REP,90106,4,11,95,110,
Canadian,Attorney General,Gentner Drummond,REP,90106,3,5,79,87,
Canadian,Superintendent of Public Instruction,Joy Hofmeister,REP,90106,4,12,117,133,
Canadian,Superintendent of Public Instruction,Linda Murphy,REP,90106,3,4,57,64,
Canadian,Commissioner of Labor,Cathy Costello,REP,90106,2,3,70,75,
Canadian,Commissioner of Labor,Leslie Osborn,REP,90106,5,13,102,120,
Canadian,Corporation Commissioner,Bob Anthony,REP,90106,4,10,104,118,
Canadian,Corporation Commissioner,Brian Bingman,REP,90106,3,5,69,77,
Canadian,Governor,Chris Powell,LIB,90106,0,0,1,1,
Canadian,Governor,Rex Lawhorn,LIB,90106,0,0,0,0,
Canadian,Corporation Commissioner,Ashley Nicole Mccray,DEM,90106,3,1,27,31,
Canadian,Corporation Commissioner,Blake Cummings,DEM,90106,0,1,25,26,
Canadian,Governor,Mick Cornett,REP,90107,1,5,47,53,
Canadian,Governor,Kevin Stitt,REP,90107,0,6,51,57,
Canadian,Lieutenant Governor,Dana Murphy,REP,90107,0,6,38,44,
Canadian,Lieutenant Governor,Matt Pinnell,REP,90107,1,5,59,65,
Canadian,State Auditor,Cindy Byrd,REP,90107,1,6,52,59,
Canadian,State Auditor,Charlie Prater,REP,90107,0,5,45,50,
Canadian,Attorney General,Mike Hunter,REP,90107,0,9,60,69,
Canadian,Attorney General,Gentner Drummond,REP,90107,1,2,38,41,
Canadian,Superintendent of Public Instruction,Joy Hofmeister,REP,90107,1,3,65,69,
Canadian,Superintendent of Public Instruction,Linda Murphy,REP,90107,0,8,33,41,
Canadian,Commissioner of Labor,Cathy Costello,REP,90107,1,7,49,57,
Canadian,Commissioner of Labor,Leslie Osborn,REP,90107,0,4,49,53,
Canadian,Corporation Commissioner,Bob Anthony,REP,90107,1,8,53,62,
Canadian,Corporation Commissioner,Brian Bingman,REP,90107,0,3,43,46,
Canadian,Governor,Chris Powell,LIB,90107,0,0,0,0,
Canadian,Governor,Rex Lawhorn,LIB,90107,0,0,0,0,
Canadian,Corporation Commissioner,Ashley Nicole Mccray,DEM,90107,0,0,10,10,
Canadian,Corporation Commissioner,Blake Cummings,DEM,90107,0,0,12,12,
Canadian,Governor,Mick Cornett,REP,90109,1,1,8,10,
Canadian,Governor,Kevin Stitt,REP,90109,0,1,17,18,
Canadian,Lieutenant Governor,Dana Murphy,REP,90109,0,1,8,9,
Canadian,Lieutenant Governor,Matt Pinnell,REP,90109,1,1,18,20,
Canadian,State Auditor,Cindy Byrd,REP,90109,1,2,8,11,
Canadian,State Auditor,Charlie Prater,REP,90109,0,0,17,17,
Canadian,Attorney General,Mike Hunter,REP,90109,1,1,10,12,
Canadian,Attorney General,Gentner Drummond,REP,90109,0,1,16,17,
Canadian,Superintendent of Public Instruction,Joy Hofmeister,REP,90109,1,1,23,25,
Canadian,Superintendent of Public Instruction,Linda Murphy,REP,90109,0,1,3,4,
Canadian,Commissioner of Labor,Cathy Costello,REP,90109,1,0,11,12,
Canadian,Commissioner of Labor,Leslie Osborn,REP,90109,0,2,15,17,
Canadian,Corporation Commissioner,Bob Anthony,REP,90109,0,1,14,15,
Canadian,Corporation Commissioner,Brian Bingman,REP,90109,1,1,12,14,
Canadian,Governor,Chris Powell,LIB,90109,0,0,0,0,
Canadian,Governor,Rex Lawhorn,LIB,90109,0,0,0,0,
Canadian,Corporation Commissioner,Ashley Nicole Mccray,DEM,90109,0,0,4,4,
Canadian,Corporation Commissioner,Blake Cummings,DEM,90109,0,0,4,4,
Canadian,Governor,Mick Cornett,REP,90114,4,4,99,107,
Canadian,Governor,Kevin Stitt,REP,90114,3,5,61,69,
Canadian,Lieutenant Governor,Dana Murphy,REP,90114,4,1,58,63,
Canadian,Lieutenant Governor,Matt Pinnell,REP,90114,3,8,100,111,
Canadian,State Auditor,Cindy Byrd,REP,90114,3,2,64,69,
Canadian,State Auditor,Charlie Prater,REP,90114,4,6,90,100,
Canadian,Attorney General,Mike Hunter,REP,90114,1,3,71,75,
Canadian,Attorney General,Gentner Drummond,REP,90114,6,6,88,100,
Canadian,Superintendent of Public Instruction,Joy Hofmeister,REP,90114,3,5,99,107,
Canadian,Superintendent of Public Instruction,Linda Murphy,REP,90114,4,4,59,67,
Canadian,Commissioner of Labor,Cathy Costello,REP,90114,2,1,64,67,
Canadian,Commissioner of Labor,Leslie Osborn,REP,90114,5,7,92,104,
Canadian,Corporation Commissioner,Bob Anthony,REP,90114,4,4,82,90,
Canadian,Corporation Commissioner,Brian Bingman,REP,90114,3,4,75,82,
Canadian,Governor,Chris Powell,LIB,90114,0,0,0,0,
Canadian,Governor,Rex Lawhorn,LIB,90114,0,0,0,0,
Canadian,Corporation Commissioner,Ashley Nicole Mccray,DEM,90114,3,4,16,23,
Canadian,Corporation Commissioner,Blake Cummings,DEM,90114,0,0,15,15,
Canadian,Governor,Mick Cornett,REP,90116,3,10,84,97,
Canadian,Governor,Kevin Stitt,REP,90116,7,9,65,81,
Canadian,Lieutenant Governor,Dana Murphy,REP,90116,4,9,66,79,
Canadian,Lieutenant Governor,Matt Pinnell,REP,90116,6,9,80,95,
Canadian,State Auditor,Cindy Byrd,REP,90116,4,6,50,60,
Canadian,State Auditor,Charlie Prater,REP,90116,6,12,91,109,
Canadian,Attorney General,Mike Hunter,REP,90116,5,13,83,101,
Canadian,Attorney General,Gentner Drummond,REP,90116,5,5,62,72,
Canadian,Superintendent of Public Instruction,Joy Hofmeister,REP,90116,5,10,92,107,
Canadian,Superintendent of Public Instruction,Linda Murphy,REP,90116,5,8,51,64,
Canadian,Commissioner of Labor,Cathy Costello,REP,90116,3,8,57,68,
Canadian,Commissioner of Labor,Leslie Osborn,REP,90116,7,9,86,102,
Canadian,Corporation Commissioner,Bob Anthony,REP,90116,6,15,88,109,
Canadian,Corporation Commissioner,Brian Bingman,REP,90116,4,4,58,66,
Canadian,Governor,Chris Powell,LIB,90116,0,0,5,5,
Canadian,Governor,Rex Lawhorn,LIB,90116,0,0,0,0,
Canadian,Corporation Commissioner,Ashley Nicole Mccray,DEM,90116,2,1,47,50,
Canadian,Corporation Commissioner,Blake Cummings,DEM,90116,0,1,18,19,
Canadian,Governor,Mick Cornett,REP,90124,1,9,143,153,
Canadian,Governor,Kevin Stitt,REP,90124,1,6,111,118,
Canadian,Lieutenant Governor,Dana Murphy,REP,90124,0,8,116,124,
Canadian,Lieutenant Governor,Matt Pinnell,REP,90124,2,7,137,146,
Canadian,State Auditor,Cindy Byrd,REP,90124,0,8,129,137,
Canadian,State Auditor,Charlie Prater,REP,90124,2,5,121,128,
Canadian,Attorney General,Mike Hunter,REP,90124,0,6,140,146,
Canadian,Attorney General,Gentner Drummond,REP,90124,2,9,109,120,
Canadian,Superintendent of Public Instruction,Joy Hofmeister,REP,90124,0,8,162,170,
Canadian,Superintendent of Public Instruction,Linda Murphy,REP,90124,2,7,88,97,
Canadian,Commissioner of Labor,Cathy Costello,REP,90124,1,7,112,120,
Canadian,Commissioner of Labor,Leslie Osborn,REP,90124,1,8,134,143,
Canadian,Corporation Commissioner,Bob Anthony,REP,90124,1,9,148,158,
Canadian,Corporation Commissioner,Brian Bingman,REP,90124,1,6,103,110,
Canadian,Governor,Chris Powell,LIB,90124,0,2,0,2,
Canadian,Governor,Rex Lawhorn,LIB,90124,0,0,0,0,
Canadian,Corporation Commissioner,Ashley Nicole Mccray,DEM,90124,2,3,37,42,
Canadian,Corporation Commissioner,Blake Cummings,DEM,90124,3,1,25,29,
Canadian,Governor,Mick Cornett,REP,90200,48,6,529,583,
Canadian,Governor,Kevin Stitt,REP,90200,27,5,489,521,
Canadian,Lieutenant Governor,Dana Murphy,REP,90200,31,5,435,471,
Canadian,Lieutenant Governor,Matt Pinnell,REP,90200,43,6,549,598,
Canadian,State Auditor,Cindy Byrd,REP,90200,41,7,458,506,
Canadian,State Auditor,Charlie Prater,REP,90200,29,4,486,519,
Canadian,Attorney General,Mike Hunter,REP,90200,45,5,502,552,
Canadian,Attorney General,Gentner Drummond,REP,90200,28,6,491,525,
Canadian,Superintendent of Public Instruction,Joy Hofmeister,REP,90200,42,9,596,647,
Canadian,Superintendent of Public Instruction,Linda Murphy,REP,90200,30,2,393,425,
Canadian,Commissioner of Labor,Cathy Costello,REP,90200,32,7,425,464,
Canadian,Commissioner of Labor,Leslie Osborn,REP,90200,39,4,541,584,
Canadian,Corporation Commissioner,Bob Anthony,REP,90200,34,9,512,555,
Canadian,Corporation Commissioner,Brian Bingman,REP,90200,40,2,469,511,
Canadian,State House,Roxanne Pollard,REP,90200,23,4,298,325,41
Canadian,State House,Denise Crosswhite Hader,REP,90200,51,7,683,741,41
Canadian,Governor,Chris Powell,LIB,90200,0,0,1,1,
Canadian,Governor,Rex Lawhorn,LIB,90200,0,0,1,1,
Canadian,Corporation Commissioner,Ashley Nicole Mccray,DEM,90200,12,0,158,170,
Canadian,Corporation Commissioner,Blake Cummings,DEM,90200,7,0,61,68,
Canadian,State House,Sara Peterson,DEM,90200,11,0,136,147,41
Canadian,State House,Jennie Scott,DEM,90200,8,0,85,93,41
Canadian,Governor,Mick Cornett,REP,90201,9,2,154,165,
Canadian,Governor,Kevin Stitt,REP,90201,5,3,173,181,
Canadian,Lieutenant Governor,Dana Murphy,REP,90201,8,1,132,141,
Canadian,Lieutenant Governor,Matt Pinnell,REP,90201,6,4,192,202,
Canadian,State Auditor,Cindy Byrd,REP,90201,14,4,145,163,
Canadian,State Auditor,Charlie Prater,REP,90201,0,1,173,174,
Canadian,Attorney General,Mike Hunter,REP,90201,5,2,162,169,
Canadian,Attorney General,Gentner Drummond,REP,90201,8,3,163,174,
Canadian,Superintendent of Public Instruction,Joy Hofmeister,REP,90201,10,2,163,175,
Canadian,Superintendent of Public Instruction,Linda Murphy,REP,90201,4,3,160,167,
Canadian,Commissioner of Labor,Cathy Costello,REP,90201,7,5,154,166,
Canadian,Commissioner of Labor,Leslie Osborn,REP,90201,7,0,167,174,
Canadian,Corporation Commissioner,Bob Anthony,REP,90201,11,5,171,187,
Canadian,Corporation Commissioner,Brian Bingman,REP,90201,3,0,153,156,
Canadian,Governor,Chris Powell,LIB,90201,0,0,0,0,
Canadian,Governor,Rex Lawhorn,LIB,90201,0,0,0,0,
Canadian,Corporation Commissioner,Ashley Nicole Mccray,DEM,90201,4,2,20,26,
Canadian,Corporation Commissioner,Blake Cummings,DEM,90201,3,0,10,13,
Canadian,Governor,Mick Cornett,REP,90202,2,1,70,73,
Canadian,Governor,Kevin Stitt,REP,90202,7,2,73,82,
Canadian,Lieutenant Governor,Dana Murphy,REP,90202,5,3,62,70,
Canadian,Lieutenant Governor,Matt Pinnell,REP,90202,4,0,78,82,
Canadian,State Auditor,Cindy Byrd,REP,90202,5,2,54,61,
Canadian,State Auditor,Charlie Prater,REP,90202,4,0,86,90,
Canadian,Attorney General,Mike Hunter,REP,90202,5,0,73,78,
Canadian,Attorney General,Gentner Drummond,REP,90202,4,3,66,73,
Canadian,Superintendent of Public Instruction,Joy Hofmeister,REP,90202,7,3,90,100,
Canadian,Superintendent of Public Instruction,Linda Murphy,REP,90202,2,0,50,52,
Canadian,Commissioner of Labor,Cathy Costello,REP,90202,7,1,60,68,
Canadian,Commissioner of Labor,Leslie Osborn,REP,90202,2,1,79,82,
Canadian,Corporation Commissioner,Bob Anthony,REP,90202,2,2,73,77,
Canadian,Corporation Commissioner,Brian Bingman,REP,90202,7,1,66,74,
Canadian,Governor,Chris Powell,LIB,90202,0,0,0,0,
Canadian,Governor,Rex Lawhorn,LIB,90202,0,0,0,0,
Canadian,Corporation Commissioner,Ashley Nicole Mccray,DEM,90202,0,0,7,7,
Canadian,Corporation Commissioner,Blake Cummings,DEM,90202,1,0,6,7,
Canadian,Governor,Mick Cornett,REP,90204,11,5,134,150,
Canadian,Governor,Kevin Stitt,REP,90204,7,2,132,141,
Canadian,Lieutenant Governor,Dana Murphy,REP,90204,8,2,123,133,
Canadian,Lieutenant Governor,Matt Pinnell,REP,90204,10,5,139,154,
Canadian,State Auditor,Cindy Byrd,REP,90204,7,1,134,142,
Canadian,State Auditor,Charlie Prater,REP,90204,10,6,121,137,
Canadian,Attorney General,Mike Hunter,REP,90204,12,6,149,167,
Canadian,Attorney General,Gentner Drummond,REP,90204,6,1,115,122,
Canadian,Superintendent of Public Instruction,Joy Hofmeister,REP,90204,11,3,159,173,
Canadian,Superintendent of Public Instruction,Linda Murphy,REP,90204,7,4,103,114,
Canadian,Commissioner of Labor,Cathy Costello,REP,90204,13,3,117,133,
Canadian,Commissioner of Labor,Leslie Osborn,REP,90204,4,3,141,148,
Canadian,Corporation Commissioner,Bob Anthony,REP,90204,14,4,146,164,
Canadian,Corporation Commissioner,Brian Bingman,REP,90204,4,3,112,119,
Canadian,Governor,Chris Powell,LIB,90204,0,0,1,1,
Canadian,Governor,Rex Lawhorn,LIB,90204,0,0,0,0,
Canadian,Corporation Commissioner,Ashley Nicole Mccray,DEM,90204,2,1,18,21,
Canadian,Corporation Commissioner,Blake Cummings,DEM,90204,0,1,7,8,
Canadian,Governor,Mick Cornett,REP,90206,5,4,202,211,
Canadian,Governor,Kevin Stitt,REP,90206,10,2,220,232,
Canadian,Lieutenant Governor,Dana Murphy,REP,90206,7,2,166,175,
Canadian,Lieutenant Governor,Matt Pinnell,REP,90206,8,3,248,259,
Canadian,State Auditor,Cindy Byrd,REP,90206,11,5,202,218,
Canadian,State Auditor,Charlie Prater,REP,90206,3,1,203,207,
Canadian,Attorney General,Mike Hunter,REP,90206,11,4,216,231,
Canadian,Attorney General,Gentner Drummond,REP,90206,4,1,197,202,
Canadian,Superintendent of Public Instruction,Joy Hofmeister,REP,90206,9,4,249,262,
Canadian,Superintendent of Public Instruction,Linda Murphy,REP,90206,6,1,166,173,
Canadian,Commissioner of Labor,Cathy Costello,REP,90206,6,1,174,181,
Canadian,Commissioner of Labor,Leslie Osborn,REP,90206,9,4,238,251,
Canadian,Corporation Commissioner,Bob Anthony,REP,90206,5,4,215,224,
Canadian,Corporation Commissioner,Brian Bingman,REP,90206,9,1,199,209,
Canadian,Governor,Chris Powell,LIB,90206,0,0,0,0,
Canadian,Governor,Rex Lawhorn,LIB,90206,0,0,0,0,
Canadian,Corporation Commissioner,Ashley Nicole Mccray,DEM,90206,6,0,30,36,
Canadian,Corporation Commissioner,Blake Cummings,DEM,90206,1,0,20,21,
Canadian,Governor,Mick Cornett,REP,90208,6,6,152,164,
Canadian,Governor,Kevin Stitt,REP,90208,5,4,162,171,
Canadian,Lieutenant Governor,Dana Murphy,REP,90208,7,5,129,141,
Canadian,Lieutenant Governor,Matt Pinnell,REP,90208,4,5,185,194,
Canadian,State Auditor,Cindy Byrd,REP,90208,4,2,158,164,
Canadian,State Auditor,Charlie Prater,REP,90208,6,8,149,163,
Canadian,Attorney General,Mike Hunter,REP,90208,8,6,172,186,
Canadian,Attorney General,Gentner Drummond,REP,90208,3,4,138,145,
Canadian,Superintendent of Public Instruction,Joy Hofmeister,REP,90208,6,6,163,175,
Canadian,Superintendent of Public Instruction,Linda Murphy,REP,90208,5,3,147,155,
Canadian,Commissioner of Labor,Cathy Costello,REP,90208,5,3,144,152,
Canadian,Commissioner of Labor,Leslie Osborn,REP,90208,6,6,164,176,
Canadian,Corporation Commissioner,Bob Anthony,REP,90208,10,8,178,196,
Canadian,Corporation Commissioner,Brian Bingman,REP,90208,1,2,128,131,
Canadian,State House,Jay Steagall,REP,90208,7,7,207,221,43
Canadian,State House,Crystal Duncan,REP,90208,3,3,100,106,43
Canadian,Governor,Chris Powell,LIB,90208,0,0,0,0,
Canadian,Governor,Rex Lawhorn,LIB,90208,0,0,0,0,
Canadian,Corporation Commissioner,Ashley Nicole Mccray,DEM,90208,11,0,53,64,
Canadian,Corporation Commissioner,Blake Cummings,DEM,90208,6,1,22,29,
Canadian,Governor,Mick Cornett,REP,90209,0,0,4,4,
Canadian,Governor,Kevin Stitt,REP,90209,0,0,4,4,
Canadian,Lieutenant Governor,Dana Murphy,REP,90209,0,0,6,6,
Canadian,Lieutenant Governor,Matt Pinnell,REP,90209,0,0,2,2,
Canadian,State Auditor,Cindy Byrd,REP,90209,0,0,6,6,
Canadian,State Auditor,Charlie Prater,REP,90209,0,0,2,2,
Canadian,Attorney General,Mike Hunter,REP,90209,0,0,5,5,
Canadian,Attorney General,Gentner Drummond,REP,90209,0,0,3,3,
Canadian,Superintendent of Public Instruction,Joy Hofmeister,REP,90209,0,0,4,4,
Canadian,Superintendent of Public Instruction,Linda Murphy,REP,90209,0,0,4,4,
Canadian,Commissioner of Labor,Cathy Costello,REP,90209,0,0,3,3,
Canadian,Commissioner of Labor,Leslie Osborn,REP,90209,0,0,5,5,
Canadian,Corporation Commissioner,Bob Anthony,REP,90209,0,0,4,4,
Canadian,Corporation Commissioner,Brian Bingman,REP,90209,0,0,4,4,
Canadian,Governor,Chris Powell,LIB,90209,0,0,0,0,
Canadian,Governor,Rex Lawhorn,LIB,90209,0,0,0,0,
Canadian,Corporation Commissioner,Ashley Nicole Mccray,DEM,90209,0,0,2,2,
Canadian,Corporation Commissioner,Blake Cummings,DEM,90209,0,0,1,1,
Canadian,Governor,Mick Cornett,REP,90210,12,5,138,155,
Canadian,Governor,Kevin Stitt,REP,90210,4,5,95,104,
Canadian,Lieutenant Governor,Dana Murphy,REP,90210,8,1,99,108,
Canadian,Lieutenant Governor,Matt Pinnell,REP,90210,8,9,129,146,
Canadian,State Auditor,Cindy Byrd,REP,90210,9,5,122,136,
Canadian,State Auditor,Charlie Prater,REP,90210,7,5,99,111,
Canadian,Attorney General,Mike Hunter,REP,90210,8,8,133,149,
Canadian,Attorney General,Gentner Drummond,REP,90210,9,2,91,102,
Canadian,Superintendent of Public Instruction,Joy Hofmeister,REP,90210,6,8,138,152,
Canadian,Superintendent of Public Instruction,Linda Murphy,REP,90210,11,2,86,99,
Canadian,Commissioner of Labor,Cathy Costello,REP,90210,5,3,93,101,
Canadian,Commissioner of Labor,Leslie Osborn,REP,90210,12,6,134,152,
Canadian,Corporation Commissioner,Bob Anthony,REP,90210,9,3,143,155,
Canadian,Corporation Commissioner,Brian Bingman,REP,90210,7,7,82,96,
Canadian,State House,Jay Steagall,REP,90210,9,7,167,183,43
Canadian,State House,Crystal Duncan,REP,90210,8,3,60,71,43
Canadian,Governor,Chris Powell,LIB,90210,0,0,0,0,
Canadian,Governor,Rex Lawhorn,LIB,90210,0,0,0,0,
Canadian,Corporation Commissioner,Ashley Nicole Mccray,DEM,90210,0,1,12,13,
Canadian,Corporation Commissioner,Blake Cummings,DEM,90210,1,0,14,15,
Canadian,Governor,Mick Cornett,REP,90211,12,2,90,104,
Canadian,Governor,Kevin Stitt,REP,90211,6,0,91,97,
Canadian,Lieutenant Governor,Dana Murphy,REP,90211,3,1,90,94,
Canadian,Lieutenant Governor,Matt Pinnell,REP,90211,16,1,88,105,
Canadian,State Auditor,Cindy Byrd,REP,90211,6,0,94,100,
Canadian,State Auditor,Charlie Prater,REP,90211,10,2,84,96,
Canadian,Attorney General,Mike Hunter,REP,90211,8,2,92,102,
Canadian,Attorney General,Gentner Drummond,REP,90211,11,0,89,100,
Canadian,Superintendent of Public Instruction,Joy Hofmeister,REP,90211,8,1,107,116,
Canadian,Superintendent of Public Instruction,Linda Murphy,REP,90211,10,1,74,85,
Canadian,Commissioner of Labor,Cathy Costello,REP,90211,6,2,77,85,
Canadian,Commissioner of Labor,Leslie Osborn,REP,90211,13,0,100,113,
Canadian,Corporation Commissioner,Bob Anthony,REP,90211,14,1,101,116,
Canadian,Corporation Commissioner,Brian Bingman,REP,90211,5,1,75,81,
Canadian,Governor,Chris Powell,LIB,90211,0,0,0,0,
Canadian,Governor,Rex Lawhorn,LIB,90211,0,0,0,0,
Canadian,Corporation Commissioner,Ashley Nicole Mccray,DEM,90211,4,0,19,23,
Canadian,Corporation Commissioner,Blake Cummings,DEM,90211,1,0,5,6,
Canadian,Governor,Mick Cornett,REP,90214,7,3,185,195,
Canadian,Governor,Kevin Stitt,REP,90214,11,0,155,166,
Canadian,Lieutenant Governor,Dana Murphy,REP,90214,11,0,158,169,
Canadian,Lieutenant Governor,Matt Pinnell,REP,90214,7,3,173,183,
Canadian,State Auditor,Cindy Byrd,REP,90214,10,2,182,194,
Canadian,State Auditor,Charlie Prater,REP,90214,8,1,146,155,
Canadian,Attorney General,Mike Hunter,REP,90214,10,3,186,199,
Canadian,Attorney General,Gentner Drummond,REP,90214,8,0,147,155,
Canadian,Superintendent of Public Instruction,Joy Hofmeister,REP,90214,11,3,185,199,
Canadian,Superintendent of Public Instruction,Linda Murphy,REP,90214,7,0,148,155,
Canadian,Commissioner of Labor,Cathy Costello,REP,90214,9,0,148,157,
Canadian,Commissioner of Labor,Leslie Osborn,REP,90214,9,3,180,192,
Canadian,Corporation Commissioner,Bob Anthony,REP,90214,14,1,185,200,
Canadian,Corporation Commissioner,Brian Bingman,REP,90214,4,2,151,157,
Canadian,State House,Jay Steagall,REP,90214,16,3,218,237,43
Canadian,State House,Crystal Duncan,REP,90214,2,0,111,113,43
Canadian,Governor,Chris Powell,LIB,90214,0,0,0,0,
Canadian,Governor,Rex Lawhorn,LIB,90214,0,0,1,1,
Canadian,Corporation Commissioner,Ashley Nicole Mccray,DEM,90214,6,0,35,41,
Canadian,Corporation Commissioner,Blake Cummings,DEM,90214,1,0,18,19,
Canadian,Governor,Mick Cornett,REP,90215,13,11,170,194,
Canadian,Governor,Kevin Stitt,REP,90215,21,8,219,248,
Canadian,Lieutenant Governor,Dana Murphy,REP,90215,17,7,164,188,
Canadian,Lieutenant Governor,Matt Pinnell,REP,90215,17,14,216,247,
Canadian,State Auditor,Cindy Byrd,REP,90215,19,5,191,215,
Canadian,State Auditor,Charlie Prater,REP,90215,12,15,186,213,
Canadian,Attorney General,Mike Hunter,REP,90215,13,9,202,224,
Canadian,Attorney General,Gentner Drummond,REP,90215,21,11,186,218,
Canadian,Superintendent of Public Instruction,Joy Hofmeister,REP,90215,18,9,206,233,
Canadian,Superintendent of Public Instruction,Linda Murphy,REP,90215,15,10,177,202,
Canadian,Commissioner of Labor,Cathy Costello,REP,90215,15,7,179,201,
Canadian,Commissioner of Labor,Leslie Osborn,REP,90215,16,12,194,222,
Canadian,Corporation Commissioner,Bob Anthony,REP,90215,20,12,195,227,
Canadian,Corporation Commissioner,Brian Bingman,REP,90215,12,8,179,199,
Canadian,State House,Jay Steagall,REP,90215,18,17,265,300,43
Canadian,State House,Crystal Duncan,REP,90215,15,3,115,133,43
Canadian,Governor,Chris Powell,LIB,90215,0,0,2,2,
Canadian,Governor,Rex Lawhorn,LIB,90215,0,0,1,1,
Canadian,Corporation Commissioner,Ashley Nicole Mccray,DEM,90215,4,0,46,50,
Canadian,Corporation Commissioner,Blake Cummings,DEM,90215,2,0,20,22,
Canadian,Governor,Mick Cornett,REP,90216,23,7,268,298,
Canadian,Governor,Kevin Stitt,REP,90216,21,6,255,282,
Canadian,Lieutenant Governor,Dana Murphy,REP,90216,21,6,216,243,
Canadian,Lieutenant Governor,Matt Pinnell,REP,90216,16,7,298,321,
Canadian,State Auditor,Cindy Byrd,REP,90216,21,5,262,288,
Canadian,State Auditor,Charlie Prater,REP,90216,20,7,232,259,
Canadian,Attorney General,Mike Hunter,REP,90216,24,6,296,326,
Canadian,Attorney General,Gentner Drummond,REP,90216,19,7,212,238,
Canadian,Superintendent of Public Instruction,Joy Hofmeister,REP,90216,21,9,315,345,
Canadian,Superintendent of Public Instruction,Linda Murphy,REP,90216,21,4,196,221,
Canadian,Commissioner of Labor,Cathy Costello,REP,90216,22,7,221,250,
Canadian,Commissioner of Labor,Leslie Osborn,REP,90216,18,5,283,306,
Canadian,Corporation Commissioner,Bob Anthony,REP,90216,27,5,315,347,
Canadian,Corporation Commissioner,Brian Bingman,REP,90216,12,7,194,213,
Canadian,State House,Jay Steagall,REP,90216,27,10,345,382,43
Canadian,State House,Crystal Duncan,REP,90216,16,3,156,175,43
Canadian,Governor,Chris Powell,LIB,90216,0,0,2,2,
Canadian,Governor,Rex Lawhorn,LIB,90216,0,0,0,0,
Canadian,Corporation Commissioner,Ashley Nicole Mccray,DEM,90216,6,0,55,61,
Canadian,Corporation Commissioner,Blake Cummings,DEM,90216,3,0,34,37,
Canadian,Governor,Mick Cornett,REP,90217,22,3,202,227,
Canadian,Governor,Kevin Stitt,REP,90217,12,2,196,210,
Canadian,Lieutenant Governor,Dana Murphy,REP,90217,21,1,170,192,
Canadian,Lieutenant Governor,Matt Pinnell,REP,90217,13,4,216,233,
Canadian,State Auditor,Cindy Byrd,REP,90217,22,1,210,233,
Canadian,State Auditor,Charlie Prater,REP,90217,10,4,162,176,
Canadian,Attorney General,Mike Hunter,REP,90217,21,4,198,223,
Canadian,Attorney General,Gentner Drummond,REP,90217,12,1,185,198,
Canadian,Superintendent of Public Instruction,Joy Hofmeister,REP,90217,27,4,243,274,
Canadian,Superintendent of Public Instruction,Linda Murphy,REP,90217,6,1,144,151,
Canadian,Commissioner of Labor,Cathy Costello,REP,90217,18,2,174,194,
Canadian,Commissioner of Labor,Leslie Osborn,REP,90217,15,3,209,227,
Canadian,Corporation Commissioner,Bob Anthony,REP,90217,21,2,228,251,
Canadian,Corporation Commissioner,Brian Bingman,REP,90217,13,3,155,171,
Canadian,State House,Jay Steagall,REP,90217,19,4,240,263,43
Canadian,State House,Crystal Duncan,REP,90217,14,1,137,152,43
Canadian,Governor,Chris Powell,LIB,90217,0,0,2,2,
Canadian,Governor,Rex Lawhorn,LIB,90217,0,0,1,1,
Canadian,Corporation Commissioner,Ashley Nicole Mccray,DEM,90217,6,2,33,41,
Canadian,Corporation Commissioner,Blake Cummings,DEM,90217,0,0,16,16,
Canadian,Governor,Mick Cornett,REP,90218,16,5,146,167,
Canadian,Governor,Kevin Stitt,REP,90218,5,2,127,134,
Canadian,Lieutenant Governor,Dana Murphy,REP,90218,11,2,114,127,
Canadian,Lieutenant Governor,Matt Pinnell,REP,90218,10,5,157,172,
Canadian,State Auditor,Cindy Byrd,REP,90218,15,6,125,146,
Canadian,State Auditor,Charlie Prater,REP,90218,5,1,141,147,
Canadian,Attorney General,Mike Hunter,REP,90218,13,4,145,162,
Canadian,Attorney General,Gentner Drummond,REP,90218,7,3,123,133,
Canadian,Superintendent of Public Instruction,Joy Hofmeister,REP,90218,13,4,142,159,
Canadian,Superintendent of Public Instruction,Linda Murphy,REP,90218,8,3,128,139,
Canadian,Commissioner of Labor,Cathy Costello,REP,90218,8,2,127,137,
Canadian,Commissioner of Labor,Leslie Osborn,REP,90218,13,5,142,160,
Canadian,Corporation Commissioner,Bob Anthony,REP,90218,12,0,153,165,
Canadian,Corporation Commissioner,Brian Bingman,REP,90218,9,7,117,133,
Canadian,State House,Jay Steagall,REP,90218,10,2,175,187,43
Canadian,State House,Crystal Duncan,REP,90218,11,5,96,112,43
Canadian,Governor,Chris Powell,LIB,90218,0,0,0,0,
Canadian,Governor,Rex Lawhorn,LIB,90218,0,0,1,1,
Canadian,Corporation Commissioner,Ashley Nicole Mccray,DEM,90218,2,0,28,30,
Canadian,Corporation Commissioner,Blake Cummings,DEM,90218,2,0,9,11,
Canadian,Governor,Mick Cornett,REP,90220,21,4,334,359,
Canadian,Governor,Kevin Stitt,REP,90220,19,7,201,227,
Canadian,Lieutenant Governor,Dana Murphy,REP,90220,21,4,234,259,
Canadian,Lieutenant Governor,Matt Pinnell,REP,90220,19,7,289,315,
Canadian,State Auditor,Cindy Byrd,REP,90220,27,5,259,291,
Canadian,State Auditor,Charlie Prater,REP,90220,13,6,241,260,
Canadian,Attorney General,Mike Hunter,REP,90220,30,5,316,351,
Canadian,Attorney General,Gentner Drummond,REP,90220,10,6,212,228,
Canadian,Superintendent of Public Instruction,Joy Hofmeister,REP,90220,23,6,317,346,
Canadian,Superintendent of Public Instruction,Linda Murphy,REP,90220,18,5,207,230,
Canadian,Commissioner of Labor,Cathy Costello,REP,90220,23,5,228,256,
Canadian,Commissioner of Labor,Leslie Osborn,REP,90220,16,5,284,305,
Canadian,Corporation Commissioner,Bob Anthony,REP,90220,31,6,277,314,
Canadian,Corporation Commissioner,Brian Bingman,REP,90220,10,5,235,250,
Canadian,State House,Jay Steagall,REP,90220,22,7,320,349,43
Canadian,State House,Crystal Duncan,REP,90220,19,4,191,214,43
Canadian,Governor,Chris Powell,LIB,90220,0,0,0,0,
Canadian,Governor,Rex Lawhorn,LIB,90220,0,0,0,0,
Canadian,Corporation Commissioner,Ashley Nicole Mccray,DEM,90220,6,2,37,45,
Canadian,Corporation Commissioner,Blake Cummings,DEM,90220,1,2,18,21,
Canadian,Governor,Mick Cornett,REP,90221,7,0,151,158,
Canadian,Governor,Kevin Stitt,REP,90221,8,1,146,155,
Canadian,Lieutenant Governor,Dana Murphy,REP,90221,3,0,123,126,
Canadian,Lieutenant Governor,Matt Pinnell,REP,90221,12,1,169,182,
Canadian,State Auditor,Cindy Byrd,REP,90221,7,0,152,159,
Canadian,State Auditor,Charlie Prater,REP,90221,7,1,131,139,
Canadian,Attorney General,Mike Hunter,REP,90221,10,1,145,156,
Canadian,Attorney General,Gentner Drummond,REP,90221,5,0,147,152,
Canadian,Superintendent of Public Instruction,Joy Hofmeister,REP,90221,5,1,163,169,
Canadian,Superintendent of Public Instruction,Linda Murphy,REP,90221,10,0,131,141,
Canadian,Commissioner of Labor,Cathy Costello,REP,90221,5,0,132,137,
Canadian,Commissioner of Labor,Leslie Osborn,REP,90221,9,1,159,169,
Canadian,Corporation Commissioner,Bob Anthony,REP,90221,8,0,150,158,
Canadian,Corporation Commissioner,Brian Bingman,REP,90221,7,1,137,145,
Canadian,State House,Jay Steagall,REP,90221,11,1,182,194,43
Canadian,State House,Crystal Duncan,REP,90221,3,0,109,112,43
Canadian,Governor,Chris Powell,LIB,90221,0,0,2,2,
Canadian,Governor,Rex Lawhorn,LIB,90221,0,0,1,1,
Canadian,Corporation Commissioner,Ashley Nicole Mccray,DEM,90221,2,0,33,35,
Canadian,Corporation Commissioner,Blake Cummings,DEM,90221,0,0,8,8,
Canadian,Governor,Mick Cornett,REP,90223,13,6,175,194,
Canadian,Governor,Kevin Stitt,REP,90223,11,4,213,228,
Canadian,Lieutenant Governor,Dana Murphy,REP,90223,11,7,177,195,
Canadian,Lieutenant Governor,Matt Pinnell,REP,90223,13,4,208,225,
Canadian,State Auditor,Cindy Byrd,REP,90223,14,6,197,217,
Canadian,State Auditor,Charlie Prater,REP,90223,9,5,177,191,
Canadian,Attorney General,Mike Hunter,REP,90223,17,6,204,227,
Canadian,Attorney General,Gentner Drummond,REP,90223,6,4,179,189,
Canadian,Superintendent of Public Instruction,Joy Hofmeister,REP,90223,11,4,199,214,
Canadian,Superintendent of Public Instruction,Linda Murphy,REP,90223,13,7,183,203,
Canadian,Commissioner of Labor,Cathy Costello,REP,90223,12,5,163,180,
Canadian,Commissioner of Labor,Leslie Osborn,REP,90223,11,6,213,230,
Canadian,Corporation Commissioner,Bob Anthony,REP,90223,17,10,193,220,
Canadian,Corporation Commissioner,Brian Bingman,REP,90223,6,1,192,199,
Canadian,State House,Jay Steagall,REP,90223,13,7,212,232,43
Canadian,State House,Crystal Duncan,REP,90223,11,4,168,183,43
Canadian,Governor,Chris Powell,LIB,90223,0,0,3,3,
Canadian,Governor,Rex Lawhorn,LIB,90223,0,0,0,0,
Canadian,Corporation Commissioner,Ashley Nicole Mccray,DEM,90223,6,2,43,51,
Canadian,Corporation Commissioner,Blake Cummings,DEM,90223,0,0,17,17,
Canadian,Governor,Mick Cornett,REP,90224,7,2,122,131,
Canadian,Governor,Kevin Stitt,REP,90224,3,2,114,119,
Canadian,Lieutenant Governor,Dana Murphy,REP,90224,3,2,104,109,
Canadian,Lieutenant Governor,Matt Pinnell,REP,90224,7,2,127,136,
Canadian,State Auditor,Cindy Byrd,REP,90224,3,3,119,125,
Canadian,State Auditor,Charlie Prater,REP,90224,5,1,106,112,
Canadian,Attorney General,Mike Hunter,REP,90224,3,1,116,120,
Canadian,Attorney General,Gentner Drummond,REP,90224,6,3,114,123,
Canadian,Superintendent of Public Instruction,Joy Hofmeister,REP,90224,6,4,136,146,
Canadian,Superintendent of Public Instruction,Linda Murphy,REP,90224,4,0,95,99,
Canadian,Commissioner of Labor,Cathy Costello,REP,90224,6,0,86,92,
Canadian,Commissioner of Labor,Leslie Osborn,REP,90224,3,4,143,150,
Canadian,Corporation Commissioner,Bob Anthony,REP,90224,6,2,106,114,
Canadian,Corporation Commissioner,Brian Bingman,REP,90224,2,2,117,121,
Canadian,State House,Jay Steagall,REP,90224,7,4,110,121,43
Canadian,State House,Crystal Duncan,REP,90224,2,0,117,119,43
Canadian,Governor,Chris Powell,LIB,90224,0,0,0,0,
Canadian,Governor,Rex Lawhorn,LIB,90224,0,0,0,0,
Canadian,Corporation Commissioner,Ashley Nicole Mccray,DEM,90224,2,0,31,33,
Canadian,Corporation Commissioner,Blake Cummings,DEM,90224,0,0,13,13,
Canadian,Governor,Mick Cornett,REP,90225,11,0,139,150,
Canadian,Governor,Kevin Stitt,REP,90225,7,1,95,103,
Canadian,Lieutenant Governor,Dana Murphy,REP,90225,10,0,106,116,
Canadian,Lieutenant Governor,Matt Pinnell,REP,90225,7,1,126,134,
Canadian,State Auditor,Cindy Byrd,REP,90225,7,0,130,137,
Canadian,State Auditor,Charlie Prater,REP,90225,9,1,97,107,
Canadian,Attorney General,Mike Hunter,REP,90225,15,0,126,141,
Canadian,Attorney General,Gentner Drummond,REP,90225,2,1,106,109,
Canadian,Superintendent of Public Instruction,Joy Hofmeister,REP,90225,7,0,119,126,
Canadian,Superintendent of Public Instruction,Linda Murphy,REP,90225,11,1,113,125,
Canadian,Commissioner of Labor,Cathy Costello,REP,90225,7,0,106,113,
Canadian,Commissioner of Labor,Leslie Osborn,REP,90225,11,1,129,141,
Canadian,Corporation Commissioner,Bob Anthony,REP,90225,8,1,109,118,
Canadian,Corporation Commissioner,Brian Bingman,REP,90225,9,0,120,129,
Canadian,State House,Brian Hill,REP,90225,7,1,98,106,47
Canadian,State House,Beverly Adams,REP,90225,11,0,130,141,47
Canadian,Governor,Chris Powell,LIB,90225,0,0,0,0,
Canadian,Governor,Rex Lawhorn,LIB,90225,0,0,0,0,
Canadian,Corporation Commissioner,Ashley Nicole Mccray,DEM,90225,4,3,26,33,
Canadian,Corporation Commissioner,Blake Cummings,DEM,90225,2,0,8,10,
Canadian,Governor,Mick Cornett,REP,90226,4,1,62,67,
Canadian,Governor,Kevin Stitt,REP,90226,6,4,56,66,
Canadian,Lieutenant Governor,Dana Murphy,REP,90226,2,2,47,51,
Canadian,Lieutenant Governor,Matt Pinnell,REP,90226,8,3,69,80,
Canadian,State Auditor,Cindy Byrd,REP,90226,6,4,43,53,
Canadian,State Auditor,Charlie Prater,REP,90226,4,1,74,79,
Canadian,Attorney General,Mike Hunter,REP,90226,7,3,51,61,
Canadian,Attorney General,Gentner Drummond,REP,90226,3,2,65,70,
Canadian,Superintendent of Public Instruction,Joy Hofmeister,REP,90226,4,4,65,73,
Canadian,Superintendent of Public Instruction,Linda Murphy,REP,90226,6,1,52,59,
Canadian,Commissioner of Labor,Cathy Costello,REP,90226,6,4,51,61,
Canadian,Commissioner of Labor,Leslie Osborn,REP,90226,4,1,67,72,
Canadian,Corporation Commissioner,Bob Anthony,REP,90226,5,2,51,58,
Canadian,Corporation Commissioner,Brian Bingman,REP,90226,5,3,66,74,
Canadian,Governor,Chris Powell,LIB,90226,0,0,0,0,
Canadian,Governor,Rex Lawhorn,LIB,90226,0,0,0,0,
Canadian,Corporation Commissioner,Ashley Nicole Mccray,DEM,90226,1,0,11,12,
Canadian,Corporation Commissioner,Blake Cummings,DEM,90226,0,0,5,5,
Canadian,Governor,Mick Cornett,REP,90227,29,10,232,271,
Canadian,Governor,Kevin Stitt,REP,90227,30,7,227,264,
Canadian,Lieutenant Governor,Dana Murphy,REP,90227,26,5,215,246,
Canadian,Lieutenant Governor,Matt Pinnell,REP,90227,32,9,234,275,
Canadian,State Auditor,Cindy Byrd,REP,90227,38,8,214,260,
Canadian,State Auditor,Charlie Prater,REP,90227,20,6,227,253,
Canadian,Attorney General,Mike Hunter,REP,90227,30,8,228,266,
Canadian,Attorney General,Gentner Drummond,REP,90227,29,9,214,252,
Canadian,Superintendent of Public Instruction,Joy Hofmeister,REP,90227,32,9,257,298,
Canadian,Superintendent of Public Instruction,Linda Murphy,REP,90227,26,7,186,219,
Canadian,Commissioner of Labor,Cathy Costello,REP,90227,28,4,199,231,
Canadian,Commissioner of Labor,Leslie Osborn,REP,90227,30,9,246,285,
Canadian,Corporation Commissioner,Bob Anthony,REP,90227,38,8,225,271,
Canadian,Corporation Commissioner,Brian Bingman,REP,90227,20,6,220,246,
Canadian,State House,Brian Hill,REP,90227,30,11,226,267,47
Canadian,State House,Beverly Adams,REP,90227,27,4,211,242,47
Canadian,Governor,Chris Powell,LIB,90227,0,0,2,2,
Canadian,Governor,Rex Lawhorn,LIB,90227,0,0,1,1,
Canadian,Corporation Commissioner,Ashley Nicole Mccray,DEM,90227,6,1,49,56,
Canadian,Corporation Commissioner,Blake Cummings,DEM,90227,4,0,18,22,
Canadian,Governor,Mick Cornett,REP,90228,4,0,52,56,
Canadian,Governor,Kevin Stitt,REP,90228,3,0,46,49,
Canadian,Lieutenant Governor,Dana Murphy,REP,90228,1,0,42,43,
Canadian,Lieutenant Governor,Matt Pinnell,REP,90228,6,0,50,56,
Canadian,State Auditor,Cindy Byrd,REP,90228,4,0,38,42,
Canadian,State Auditor,Charlie Prater,REP,90228,3,0,51,54,
Canadian,Attorney General,Mike Hunter,REP,90228,4,0,44,48,
Canadian,Attorney General,Gentner Drummond,REP,90228,3,0,50,53,
Canadian,Superintendent of Public Instruction,Joy Hofmeister,REP,90228,4,0,56,60,
Canadian,Superintendent of Public Instruction,Linda Murphy,REP,90228,3,0,36,39,
Canadian,Commissioner of Labor,Cathy Costello,REP,90228,4,0,39,43,
Canadian,Commissioner of Labor,Leslie Osborn,REP,90228,3,0,52,55,
Canadian,Corporation Commissioner,Bob Anthony,REP,90228,5,0,49,54,
Canadian,Corporation Commissioner,Brian Bingman,REP,90228,2,0,43,45,
Canadian,State House,Jay Steagall,REP,90228,2,0,58,60,43
Canadian,State House,Crystal Duncan,REP,90228,5,0,35,40,43
Canadian,Governor,Chris Powell,LIB,90228,0,0,0,0,
Canadian,Governor,Rex Lawhorn,LIB,90228,0,0,1,1,
Canadian,Corporation Commissioner,Ashley Nicole Mccray,DEM,90228,0,0,5,5,
Canadian,Corporation Commissioner,Blake Cummings,DEM,90228,0,0,3,3,
Canadian,Governor,Mick Cornett,REP,90300,6,0,183,189,
Canadian,Governor,Kevin Stitt,REP,90300,13,0,190,203,
Canadian,Lieutenant Governor,Dana Murphy,REP,90300,7,0,143,150,
Canadian,Lieutenant Governor,Matt Pinnell,REP,90300,11,0,214,225,
Canadian,State Auditor,Cindy Byrd,REP,90300,7,0,177,184,
Canadian,State Auditor,Charlie Prater,REP,90300,8,0,170,178,
Canadian,Attorney General,Mike Hunter,REP,90300,10,0,192,202,
Canadian,Attorney General,Gentner Drummond,REP,90300,8,0,169,177,
Canadian,Superintendent of Public Instruction,Joy Hofmeister,REP,90300,6,0,205,211,
Canadian,Superintendent of Public Instruction,Linda Murphy,REP,90300,13,0,159,172,
Canadian,Commissioner of Labor,Cathy Costello,REP,90300,3,0,142,145,
Canadian,Commissioner of Labor,Leslie Osborn,REP,90300,15,0,227,242,
Canadian,Corporation Commissioner,Bob Anthony,REP,90300,11,0,198,209,
Canadian,Corporation Commissioner,Brian Bingman,REP,90300,6,0,158,164,
Canadian,State House,Brian Hill,REP,90300,12,0,174,186,47
Canadian,State House,Beverly Adams,REP,90300,5,0,187,192,47
Canadian,Governor,Chris Powell,LIB,90300,1,0,3,4,
Canadian,Governor,Rex Lawhorn,LIB,90300,0,0,0,0,
Canadian,Corporation Commissioner,Ashley Nicole Mccray,DEM,90300,6,0,28,34,
Canadian,Corporation Commissioner,Blake Cummings,DEM,90300,1,0,9,10,
Canadian,U.S. House,Mary Brannon,DEM,90300,5,0,30,35,04
Canadian,U.S. House,Fred Gipson,DEM,90300,2,0,7,9,04
Canadian,Governor,Mick Cornett,REP,90301,15,4,259,278,
Canadian,Governor,Kevin Stitt,REP,90301,14,2,261,277,
Canadian,Lieutenant Governor,Dana Murphy,REP,90301,14,4,226,244,
Canadian,Lieutenant Governor,Matt Pinnell,REP,90301,14,1,287,302,
Canadian,State Auditor,Cindy Byrd,REP,90301,18,3,253,274,
Canadian,State Auditor,Charlie Prater,REP,90301,9,3,246,258,
Canadian,Attorney General,Mike Hunter,REP,90301,13,5,285,303,
Canadian,Attorney General,Gentner Drummond,REP,90301,16,1,225,242,
Canadian,Superintendent of Public Instruction,Joy Hofmeister,REP,90301,15,4,299,318,
Canadian,Superintendent of Public Instruction,Linda Murphy,REP,90301,14,2,213,229,
Canadian,Commissioner of Labor,Cathy Costello,REP,90301,10,1,170,181,
Canadian,Commissioner of Labor,Leslie Osborn,REP,90301,19,5,343,367,
Canadian,Corporation Commissioner,Bob Anthony,REP,90301,19,3,271,293,
Canadian,Corporation Commissioner,Brian Bingman,REP,90301,10,3,229,242,
Canadian,State House,Brian Hill,REP,90301,21,4,258,283,47
Canadian,State House,Beverly Adams,REP,90301,7,2,252,261,47
Canadian,Governor,Chris Powell,LIB,90301,0,0,0,0,
Canadian,Governor,Rex Lawhorn,LIB,90301,0,0,1,1,
Canadian,Corporation Commissioner,Ashley Nicole Mccray,DEM,90301,14,0,54,68,
Canadian,Corporation Commissioner,Blake Cummings,DEM,90301,2,0,20,22,
Canadian,U.S. House,Mary Brannon,DEM,90301,15,0,49,64,04
Canadian,U.S. House,Fred Gipson,DEM,90301,1,0,25,26,04
Canadian,Governor,Mick Cornett,REP,90302,6,0,151,157,
Canadian,Governor,Kevin Stitt,REP,90302,13,0,225,238,
Canadian,Lieutenant Governor,Dana Murphy,REP,90302,7,0,152,159,
Canadian,Lieutenant Governor,Matt Pinnell,REP,90302,10,0,214,224,
Canadian,State Auditor,Cindy Byrd,REP,90302,8,0,185,193,
Canadian,State Auditor,Charlie Prater,REP,90302,10,0,177,187,
Canadian,Attorney General,Mike Hunter,REP,90302,13,0,170,183,
Canadian,Attorney General,Gentner Drummond,REP,90302,7,0,201,208,
Canadian,Superintendent of Public Instruction,Joy Hofmeister,REP,90302,6,0,191,197,
Canadian,Superintendent of Public Instruction,Linda Murphy,REP,90302,12,0,177,189,
Canadian,Commissioner of Labor,Cathy Costello,REP,90302,8,0,138,146,
Canadian,Commissioner of Labor,Leslie Osborn,REP,90302,12,0,230,242,
Canadian,Corporation Commissioner,Bob Anthony,REP,90302,14,0,196,210,
Canadian,Corporation Commissioner,Brian Bingman,REP,90302,4,0,170,174,
Canadian,State House,Brian Hill,REP,90302,14,0,174,188,47
Canadian,State House,Beverly Adams,REP,90302,5,0,190,195,47
Canadian,Governor,Chris Powell,LIB,90302,0,0,0,0,
Canadian,Governor,Rex Lawhorn,LIB,90302,0,0,0,0,
Canadian,Corporation Commissioner,Ashley Nicole Mccray,DEM,90302,4,0,34,38,
Canadian,Corporation Commissioner,Blake Cummings,DEM,90302,0,0,14,14,
Canadian,U.S. House,Mary Brannon,DEM,90302,2,0,38,40,04
Canadian,U.S. House,Fred Gipson,DEM,90302,2,0,10,12,04
Canadian,Governor,Mick Cornett,REP,90303,27,10,265,302,
Canadian,Governor,Kevin Stitt,REP,90303,24,3,308,335,
Canadian,Lieutenant Governor,Dana Murphy,REP,90303,28,8,233,269,
Canadian,Lieutenant Governor,Matt Pinnell,REP,90303,21,5,322,348,
Canadian,State Auditor,Cindy Byrd,REP,90303,30,10,263,303,
Canadian,State Auditor,Charlie Prater,REP,90303,19,3,282,304,
Canadian,Attorney General,Mike Hunter,REP,90303,30,7,277,314,
Canadian,Attorney General,Gentner Drummond,REP,90303,20,6,279,305,
Canadian,Superintendent of Public Instruction,Joy Hofmeister,REP,90303,29,8,327,364,
Canadian,Superintendent of Public Instruction,Linda Murphy,REP,90303,21,5,229,255,
Canadian,Commissioner of Labor,Cathy Costello,REP,90303,24,2,207,233,
Canadian,Commissioner of Labor,Leslie Osborn,REP,90303,26,11,357,394,
Canadian,Corporation Commissioner,Bob Anthony,REP,90303,30,7,270,307,
Canadian,Corporation Commissioner,Brian Bingman,REP,90303,19,6,275,300,
Canadian,State House,Brian Hill,REP,90303,28,5,314,347,47
Canadian,State House,Beverly Adams,REP,90303,22,8,248,278,47
Canadian,Governor,Chris Powell,LIB,90303,0,0,1,1,
Canadian,Governor,Rex Lawhorn,LIB,90303,0,0,1,1,
Canadian,Corporation Commissioner,Ashley Nicole Mccray,DEM,90303,7,1,45,53,
Canadian,Corporation Commissioner,Blake Cummings,DEM,90303,3,0,21,24,
Canadian,Governor,Mick Cornett,REP,90304,2,1,158,161,
Canadian,Governor,Kevin Stitt,REP,90304,6,4,157,167,
Canadian,Lieutenant Governor,Dana Murphy,REP,90304,2,2,126,130,
Canadian,Lieutenant Governor,Matt Pinnell,REP,90304,6,3,186,195,
Canadian,State Auditor,Cindy Byrd,REP,90304,5,1,143,149,
Canadian,State Auditor,Charlie Prater,REP,90304,3,4,160,167,
Canadian,Attorney General,Mike Hunter,REP,90304,2,1,169,172,
Canadian,Attorney General,Gentner Drummond,REP,90304,6,4,142,152,
Canadian,Superintendent of Public Instruction,Joy Hofmeister,REP,90304,2,5,168,175,
Canadian,Superintendent of Public Instruction,Linda Murphy,REP,90304,6,0,145,151,
Canadian,Commissioner of Labor,Cathy Costello,REP,90304,2,0,125,127,
Canadian,Commissioner of Labor,Leslie Osborn,REP,90304,6,5,186,197,
Canadian,Corporation Commissioner,Bob Anthony,REP,90304,5,5,149,159,
Canadian,Corporation Commissioner,Brian Bingman,REP,90304,3,0,161,164,
Canadian,State House,Brian Hill,REP,90304,4,4,140,148,47
Canadian,State House,Beverly Adams,REP,90304,4,1,170,175,47
Canadian,Governor,Chris Powell,LIB,90304,0,0,0,0,
Canadian,Governor,Rex Lawhorn,LIB,90304,0,0,1,1,
Canadian,Corporation Commissioner,Ashley Nicole Mccray,DEM,90304,2,1,21,24,
Canadian,Corporation Commissioner,Blake Cummings,DEM,90304,1,0,18,19,
Canadian,U.S. House,Mary Brannon,DEM,90304,3,1,27,31,04
Canadian,U.S. House,Fred Gipson,DEM,90304,0,0,12,12,04
Canadian,Governor,Mick Cornett,REP,90306,21,7,276,304,
Canadian,Governor,Kevin Stitt,REP,90306,26,6,313,345,
Canadian,Lieutenant Governor,Dana Murphy,REP,90306,17,4,240,261,
Canadian,Lieutenant Governor,Matt Pinnell,REP,90306,29,9,335,373,
Canadian,State Auditor,Cindy Byrd,REP,90306,30,7,303,340,
Canadian,State Auditor,Charlie Prater,REP,90306,12,6,259,277,
Canadian,Attorney General,Mike Hunter,REP,90306,27,6,306,339,
Canadian,Attorney General,Gentner Drummond,REP,90306,19,7,270,296,
Canadian,Superintendent of Public Instruction,Joy Hofmeister,REP,90306,24,9,303,336,
Canadian,Superintendent of Public Instruction,Linda Murphy,REP,90306,22,4,280,306,
Canadian,Commissioner of Labor,Cathy Costello,REP,90306,20,8,195,223,
Canadian,Commissioner of Labor,Leslie Osborn,REP,90306,26,5,387,418,
Canadian,Corporation Commissioner,Bob Anthony,REP,90306,35,9,294,338,
Canadian,Corporation Commissioner,Brian Bingman,REP,90306,10,4,278,292,
Canadian,State House,Brian Hill,REP,90306,32,5,308,345,47
Canadian,State House,Beverly Adams,REP,90306,13,8,274,295,47
Canadian,Governor,Chris Powell,LIB,90306,0,0,2,2,
Canadian,Governor,Rex Lawhorn,LIB,90306,0,0,0,0,
Canadian,Corporation Commissioner,Ashley Nicole Mccray,DEM,90306,10,2,51,63,
Canadian,Corporation Commissioner,Blake Cummings,DEM,90306,5,1,24,30,
Canadian,U.S. House,Mary Brannon,DEM,90306,11,3,49,63,04
Canadian,U.S. House,Fred Gipson,DEM,90306,4,0,26,30,04
Canadian,Governor,Mick Cornett,REP,90308,8,1,66,75,
Canadian,Governor,Kevin Stitt,REP,90308,4,1,95,100,
Canadian,Lieutenant Governor,Dana Murphy,REP,90308,9,2,65,76,
Canadian,Lieutenant Governor,Matt Pinnell,REP,90308,3,0,91,94,
Canadian,State Auditor,Cindy Byrd,REP,90308,6,0,73,79,
Canadian,State Auditor,Charlie Prater,REP,90308,4,1,79,84,
Canadian,Attorney General,Mike Hunter,REP,90308,4,0,74,78,
Canadian,Attorney General,Gentner Drummond,REP,90308,7,2,82,91,
Canadian,Superintendent of Public Instruction,Joy Hofmeister,REP,90308,5,2,67,74,
Canadian,Superintendent of Public Instruction,Linda Murphy,REP,90308,7,0,90,97,
Canadian,Commissioner of Labor,Cathy Costello,REP,90308,3,0,55,58,
Canadian,Commissioner of Labor,Leslie Osborn,REP,90308,9,1,103,113,
Canadian,Corporation Commissioner,Bob Anthony,REP,90308,10,1,88,99,
Canadian,Corporation Commissioner,Brian Bingman,REP,90308,2,1,69,72,
Canadian,State House,Brian Hill,REP,90308,8,0,83,91,47
Canadian,State House,Beverly Adams,REP,90308,4,1,73,78,47
Canadian,Governor,Chris Powell,LIB,90308,2,0,0,2,
Canadian,Governor,Rex Lawhorn,LIB,90308,1,0,0,1,
Canadian,Corporation Commissioner,Ashley Nicole Mccray,DEM,90308,0,0,9,9,
Canadian,Corporation Commissioner,Blake Cummings,DEM,90308,0,0,4,4,
Canadian,Governor,Mick Cornett,REP,90309,3,0,17,20,
Canadian,Governor,Kevin Stitt,REP,90309,1,0,25,26,
Canadian,Lieutenant Governor,Dana Murphy,REP,90309,2,0,16,18,
Canadian,Lieutenant Governor,Matt Pinnell,REP,90309,2,0,26,28,
Canadian,State Auditor,Cindy Byrd,REP,90309,2,0,20,22,
Canadian,State Auditor,Charlie Prater,REP,90309,1,0,21,22,
Canadian,Attorney General,Mike Hunter,REP,90309,1,0,25,26,
Canadian,Attorney General,Gentner Drummond,REP,90309,2,0,17,19,
Canadian,Superintendent of Public Instruction,Joy Hofmeister,REP,90309,2,0,18,20,
Canadian,Superintendent of Public Instruction,Linda Murphy,REP,90309,2,0,24,26,
Canadian,Commissioner of Labor,Cathy Costello,REP,90309,2,0,17,19,
Canadian,Commissioner of Labor,Leslie Osborn,REP,90309,2,0,23,25,
Canadian,Corporation Commissioner,Bob Anthony,REP,90309,3,0,18,21,
Canadian,Corporation Commissioner,Brian Bingman,REP,90309,1,0,24,25,
Canadian,State House,Brian Hill,REP,90309,1,0,20,21,47
Canadian,State House,Beverly Adams,REP,90309,3,0,22,25,47
Canadian,Governor,Chris Powell,LIB,90309,0,0,0,0,
Canadian,Governor,Rex Lawhorn,LIB,90309,0,0,0,0,
Canadian,Corporation Commissioner,Ashley Nicole Mccray,DEM,90309,0,0,2,2,
Canadian,Corporation Commissioner,Blake Cummings,DEM,90309,0,0,2,2,
Canadian,U.S. House,Mary Brannon,DEM,90309,0,0,2,2,04
Canadian,U.S. House,Fred Gipson,DEM,90309,0,0,2,2,04
Canadian,Governor,Mick Cornett,REP,90398,0,0,0,0,
Canadian,Governor,Kevin Stitt,REP,90398,0,0,0,0,
Canadian,Lieutenant Governor,Dana Murphy,REP,90398,0,0,0,0,
Canadian,Lieutenant Governor,Matt Pinnell,REP,90398,0,0,0,0,
Canadian,State Auditor,Cindy Byrd,REP,90398,0,0,0,0,
Canadian,State Auditor,Charlie Prater,REP,90398,0,0,0,0,
Canadian,Attorney General,Mike Hunter,REP,90398,0,0,0,0,
Canadian,Attorney General,Gentner Drummond,REP,90398,0,0,0,0,
Canadian,Superintendent of Public Instruction,Joy Hofmeister,REP,90398,0,0,0,0,
Canadian,Superintendent of Public Instruction,Linda Murphy,REP,90398,0,0,0,0,
Canadian,Commissioner of Labor,Cathy Costello,REP,90398,0,0,0,0,
Canadian,Commissioner of Labor,Leslie Osborn,REP,90398,0,0,0,0,
Canadian,Corporation Commissioner,Bob Anthony,REP,90398,0,0,0,0,
Canadian,Corporation Commissioner,Brian Bingman,REP,90398,0,0,0,0,
Canadian,State House,Brian Hill,REP,90398,0,0,0,0,47
Canadian,State House,Beverly Adams,REP,90398,0,0,0,0,47
Canadian,Governor,Chris Powell,LIB,90398,0,0,0,0,
Canadian,Governor,Rex Lawhorn,LIB,90398,0,0,0,0,
Canadian,Corporation Commissioner,Ashley Nicole Mccray,DEM,90398,0,0,0,0,
Canadian,Corporation Commissioner,Blake Cummings,DEM,90398,0,0,0,0,
Canadian,U.S. House,Mary Brannon,DEM,90398,0,0,0,0,04
Canadian,U.S. House,Fred Gipson,DEM,90398,0,0,0,0,04
Canadian,Governor,Mick Cornett,REP,90399,0,0,0,0,
Canadian,Governor,Kevin Stitt,REP,90399,0,0,0,0,
Canadian,Lieutenant Governor,Dana Murphy,REP,90399,0,0,0,0,
Canadian,Lieutenant Governor,Matt Pinnell,REP,90399,0,0,0,0,
Canadian,State Auditor,Cindy Byrd,REP,90399,0,0,0,0,
Canadian,State Auditor,Charlie Prater,REP,90399,0,0,0,0,
Canadian,Attorney General,Mike Hunter,REP,90399,0,0,0,0,
Canadian,Attorney General,Gentner Drummond,REP,90399,0,0,0,0,
Canadian,Superintendent of Public Instruction,Joy Hofmeister,REP,90399,0,0,0,0,
Canadian,Superintendent of Public Instruction,Linda Murphy,REP,90399,0,0,0,0,
Canadian,Commissioner of Labor,Cathy Costello,REP,90399,0,0,0,0,
Canadian,Commissioner of Labor,Leslie Osborn,REP,90399,0,0,0,0,
Canadian,Corporation Commissioner,Bob Anthony,REP,90399,0,0,0,0,
Canadian,Corporation Commissioner,Brian Bingman,REP,90399,0,0,0,0,
Canadian,State House,Brian Hill,REP,90399,0,0,0,0,47
Canadian,State House,Beverly Adams,REP,90399,0,0,0,0,47
Canadian,Governor,Chris Powell,LIB,90399,0,0,0,0,
Canadian,Governor,Rex Lawhorn,LIB,90399,0,0,0,0,
Canadian,Corporation Commissioner,Ashley Nicole Mccray,DEM,90399,0,0,0,0,
Canadian,Corporation Commissioner,Blake Cummings,DEM,90399,0,0,0,0,
Canadian,U.S. House,Mary Brannon,DEM,90399,0,0,0,0,04
Canadian,U.S. House,Fred Gipson,DEM,90399,0,0,0,0,04
Canadian,Governor,Mick Cornett,REP,90400,5,1,97,103,
Canadian,Governor,Kevin Stitt,REP,90400,6,2,110,118,
Canadian,Lieutenant Governor,Dana Murphy,REP,90400,6,2,96,104,
Canadian,Lieutenant Governor,Matt Pinnell,REP,90400,5,1,112,118,
Canadian,State Auditor,Cindy Byrd,REP,90400,5,3,103,111,
Canadian,State Auditor,Charlie Prater,REP,90400,6,0,98,104,
Canadian,Attorney General,Mike Hunter,REP,90400,5,3,107,115,
Canadian,Attorney General,Gentner Drummond,REP,90400,6,0,100,106,
Canadian,Superintendent of Public Instruction,Joy Hofmeister,REP,90400,5,2,108,115,
Canadian,Superintendent of Public Instruction,Linda Murphy,REP,90400,6,1,97,104,
Canadian,Commissioner of Labor,Cathy Costello,REP,90400,2,2,79,83,
Canadian,Commissioner of Labor,Leslie Osborn,REP,90400,9,1,125,135,
Canadian,Corporation Commissioner,Bob Anthony,REP,90400,6,3,107,116,
Canadian,Corporation Commissioner,Brian Bingman,REP,90400,5,0,98,103,
Canadian,Governor,Chris Powell,LIB,90400,0,0,0,0,
Canadian,Governor,Rex Lawhorn,LIB,90400,0,0,0,0,
Canadian,Corporation Commissioner,Ashley Nicole Mccray,DEM,90400,1,0,17,18,
Canadian,Corporation Commissioner,Blake Cummings,DEM,90400,1,0,16,17,
Canadian,Governor,Mick Cornett,REP,90403,4,0,29,33,
Canadian,Governor,Kevin Stitt,REP,90403,4,2,45,51,
Canadian,Lieutenant Governor,Dana Murphy,REP,90403,5,0,28,33,
Canadian,Lieutenant Governor,Matt Pinnell,REP,90403,3,2,45,50,
Canadian,State Auditor,Cindy Byrd,REP,90403,5,2,29,36,
Canadian,State Auditor,Charlie Prater,REP,90403,3,0,44,47,
Canadian,Attorney General,Mike Hunter,REP,90403,6,2,30,38,
Canadian,Attorney General,Gentner Drummond,REP,90403,2,0,43,45,
Canadian,Superintendent of Public Instruction,Joy Hofmeister,REP,90403,4,1,37,42,
Canadian,Superintendent of Public Instruction,Linda Murphy,REP,90403,4,1,37,42,
Canadian,Commissioner of Labor,Cathy Costello,REP,90403,1,1,30,32,
Canadian,Commissioner of Labor,Leslie Osborn,REP,90403,7,1,44,52,
Canadian,Corporation Commissioner,Bob Anthony,REP,90403,4,0,27,31,
Canadian,Corporation Commissioner,Brian Bingman,REP,90403,4,2,47,53,
Canadian,Governor,Chris Powell,LIB,90403,0,0,0,0,
Canadian,Governor,Rex Lawhorn,LIB,90403,0,0,0,0,
Canadian,Corporation Commissioner,Ashley Nicole Mccray,DEM,90403,2,0,6,8,
Canadian,Corporation Commissioner,Blake Cummings,DEM,90403,0,0,7,7,
Canadian,Governor,Mick Cornett,REP,90404,1,4,31,36,
Canadian,Governor,Kevin Stitt,REP,90404,0,1,26,27,
Canadian,Lieutenant Governor,Dana Murphy,REP,90404,1,4,26,31,
Canadian,Lieutenant Governor,Matt Pinnell,REP,90404,0,1,30,31,
Canadian,State Auditor,Cindy Byrd,REP,90404,0,3,25,28,
Canadian,State Auditor,Charlie Prater,REP,90404,1,2,32,35,
Canadian,Attorney General,Mike Hunter,REP,90404,0,3,36,39,
Canadian,Attorney General,Gentner Drummond,REP,90404,1,2,21,24,
Canadian,Superintendent of Public Instruction,Joy Hofmeister,REP,90404,0,4,35,39,
Canadian,Superintendent of Public Instruction,Linda Murphy,REP,90404,1,1,22,24,
Canadian,Commissioner of Labor,Cathy Costello,REP,90404,0,1,16,17,
Canadian,Commissioner of Labor,Leslie Osborn,REP,90404,1,4,40,45,
Canadian,Corporation Commissioner,Bob Anthony,REP,90404,1,3,36,40,
Canadian,Corporation Commissioner,Brian Bingman,REP,90404,0,2,21,23,
Canadian,Governor,Chris Powell,LIB,90404,0,0,0,0,
Canadian,Governor,Rex Lawhorn,LIB,90404,0,0,0,0,
Canadian,Corporation Commissioner,Ashley Nicole Mccray,DEM,90404,0,0,9,9,
Canadian,Corporation Commissioner,Blake Cummings,DEM,90404,0,0,2,2,
Canadian,Governor,Mick Cornett,REP,90406,0,0,29,29,
Canadian,Governor,Kevin Stitt,REP,90406,0,0,24,24,
Canadian,Lieutenant Governor,Dana Murphy,REP,90406,0,0,23,23,
Canadian,Lieutenant Governor,Matt Pinnell,REP,90406,0,0,29,29,
Canadian,State Auditor,Cindy Byrd,REP,90406,0,0,24,24,
Canadian,State Auditor,Charlie Prater,REP,90406,0,0,28,28,
Canadian,Attorney General,Mike Hunter,REP,90406,0,0,21,21,
Canadian,Attorney General,Gentner Drummond,REP,90406,0,0,30,30,
Canadian,Superintendent of Public Instruction,Joy Hofmeister,REP,90406,0,0,34,34,
Canadian,Superintendent of Public Instruction,Linda Murphy,REP,90406,0,0,19,19,
Canadian,Commissioner of Labor,Cathy Costello,REP,90406,0,0,24,24,
Canadian,Commissioner of Labor,Leslie Osborn,REP,90406,0,0,27,27,
Canadian,Corporation Commissioner,Bob Anthony,REP,90406,0,0,22,22,
Canadian,Corporation Commissioner,Brian Bingman,REP,90406,0,0,31,31,
Canadian,Governor,Chris Powell,LIB,90406,0,0,0,0,
Canadian,Governor,Rex Lawhorn,LIB,90406,0,0,0,0,
Canadian,Corporation Commissioner,Ashley Nicole Mccray,DEM,90406,0,0,9,9,
Canadian,Corporation Commissioner,Blake Cummings,DEM,90406,0,0,3,3,
Canadian,Governor,Mick Cornett,REP,90408,1,1,21,23,
Canadian,Governor,Kevin Stitt,REP,90408,0,1,34,35,
Canadian,Lieutenant Governor,Dana Murphy,REP,90408,0,1,23,24,
Canadian,Lieutenant Governor,Matt Pinnell,REP,90408,1,1,30,32,
Canadian,State Auditor,Cindy Byrd,REP,90408,0,1,24,25,
Canadian,State Auditor,Charlie Prater,REP,90408,1,1,31,33,
Canadian,Attorney General,Mike Hunter,REP,90408,0,1,23,24,
Canadian,Attorney General,Gentner Drummond,REP,90408,1,1,31,33,
Canadian,Superintendent of Public Instruction,Joy Hofmeister,REP,90408,1,0,31,32,
Canadian,Superintendent of Public Instruction,Linda Murphy,REP,90408,0,2,23,25,
Canadian,Commissioner of Labor,Cathy Costello,REP,90408,0,0,17,17,
Canadian,Commissioner of Labor,Leslie Osborn,REP,90408,1,2,36,39,
Canadian,Corporation Commissioner,Bob Anthony,REP,90408,1,1,26,28,
Canadian,Corporation Commissioner,Brian Bingman,REP,90408,0,1,29,30,
Canadian,Governor,Chris Powell,LIB,90408,0,0,0,0,
Canadian,Governor,Rex Lawhorn,LIB,90408,0,0,0,0,
Canadian,Corporation Commissioner,Ashley Nicole Mccray,DEM,90408,0,0,13,13,
Canadian,Corporation Commissioner,Blake Cummings,DEM,90408,1,0,12,13,
Canadian,Governor,Mick Cornett,REP,90409,1,1,9,11,
Canadian,Governor,Kevin Stitt,REP,90409,0,0,9,9,
Canadian,Lieutenant Governor,Dana Murphy,REP,90409,1,0,14,15,
Canadian,Lieutenant Governor,Matt Pinnell,REP,90409,0,1,4,5,
Canadian,State Auditor,Cindy Byrd,REP,90409,1,0,8,9,
Canadian,State Auditor,Charlie Prater,REP,90409,0,0,10,10,
Canadian,Attorney General,Mike Hunter,REP,90409,1,0,10,11,
Canadian,Attorney General,Gentner Drummond,REP,90409,0,1,8,9,
Canadian,Superintendent of Public Instruction,Joy Hofmeister,REP,90409,1,1,9,11,
Canadian,Superintendent of Public Instruction,Linda Murphy,REP,90409,0,0,9,9,
Canadian,Commissioner of Labor,Cathy Costello,REP,90409,1,1,9,11,
Canadian,Commissioner of Labor,Leslie Osborn,REP,90409,0,0,9,9,
Canadian,Corporation Commissioner,Bob Anthony,REP,90409,0,1,9,10,
Canadian,Corporation Commissioner,Brian Bingman,REP,90409,1,0,9,10,
Canadian,Governor,Chris Powell,LIB,90409,0,0,0,0,
Canadian,Governor,Rex Lawhorn,LIB,90409,0,0,0,0,
Canadian,Corporation Commissioner,Ashley Nicole Mccray,DEM,90409,0,0,0,0,
Canadian,Corporation Commissioner,Blake Cummings,DEM,90409,0,0,0,0,
Canadian,Governor,Mick Cornett,REP,90502,1,2,37,40,
Canadian,Governor,Kevin Stitt,REP,90502,0,2,32,34,
Canadian,Lieutenant Governor,Dana Murphy,REP,90502,1,1,23,25,
Canadian,Lieutenant Governor,Matt Pinnell,REP,90502,0,3,46,49,
Canadian,State Auditor,Cindy Byrd,REP,90502,1,1,31,33,
Canadian,State Auditor,Charlie Prater,REP,90502,0,3,38,41,
Canadian,Attorney General,Mike Hunter,REP,90502,0,2,38,40,
Canadian,Attorney General,Gentner Drummond,REP,90502,1,2,31,34,
Canadian,Superintendent of Public Instruction,Joy Hofmeister,REP,90502,1,2,34,37,
Canadian,Superintendent of Public Instruction,Linda Murphy,REP,90502,0,2,35,37,
Canadian,Commissioner of Labor,Cathy Costello,REP,90502,1,1,33,35,
Canadian,Commissioner of Labor,Leslie Osborn,REP,90502,0,3,36,39,
Canadian,Corporation Commissioner,Bob Anthony,REP,90502,1,2,28,31,
Canadian,Corporation Commissioner,Brian Bingman,REP,90502,0,2,40,42,
Canadian,Governor,Chris Powell,LIB,90502,0,0,0,0,
Canadian,Governor,Rex Lawhorn,LIB,90502,0,0,0,0,
Canadian,Corporation Commissioner,Ashley Nicole Mccray,DEM,90502,0,1,3,4,
Canadian,Corporation Commissioner,Blake Cummings,DEM,90502,0,0,2,2,
Canadian,Governor,Mick Cornett,REP,90503,6,1,46,53,
Canadian,Governor,Kevin Stitt,REP,90503,5,0,57,62,
Canadian,Lieutenant Governor,Dana Murphy,REP,90503,2,0,52,54,
Canadian,Lieutenant Governor,Matt Pinnell,REP,90503,7,1,48,56,
Canadian,State Auditor,Cindy Byrd,REP,90503,2,0,53,55,
Canadian,State Auditor,Charlie Prater,REP,90503,6,1,42,49,
Canadian,Attorney General,Mike Hunter,REP,90503,0,0,52,52,
Canadian,Attorney General,Gentner Drummond,REP,90503,10,1,48,59,
Canadian,Superintendent of Public Instruction,Joy Hofmeister,REP,90503,6,0,49,55,
Canadian,Superintendent of Public Instruction,Linda Murphy,REP,90503,5,1,48,54,
Canadian,Commissioner of Labor,Cathy Costello,REP,90503,1,0,40,41,
Canadian,Commissioner of Labor,Leslie Osborn,REP,90503,9,1,54,64,
Canadian,Corporation Commissioner,Bob Anthony,REP,90503,5,0,50,55,
Canadian,Corporation Commissioner,Brian Bingman,REP,90503,5,1,48,54,
Canadian,Governor,Chris Powell,LIB,90503,0,0,0,0,
Canadian,Governor,Rex Lawhorn,LIB,90503,0,0,0,0,
Canadian,Corporation Commissioner,Ashley Nicole Mccray,DEM,90503,0,0,2,2,
Canadian,Corporation Commissioner,Blake Cummings,DEM,90503,0,0,4,4,
Canadian,Governor,Mick Cornett,REP,90504,9,3,348,360,
Canadian,Governor,Kevin Stitt,REP,90504,11,5,263,279,
Canadian,Lieutenant Governor,Dana Murphy,REP,90504,10,2,256,268,
Canadian,Lieutenant Governor,Matt Pinnell,REP,90504,7,6,329,342,
Canadian,State Auditor,Cindy Byrd,REP,90504,11,6,296,313,
Canadian,State Auditor,Charlie Prater,REP,90504,7,1,283,291,
Canadian,Attorney General,Mike Hunter,REP,90504,7,4,309,320,
Canadian,Attorney General,Gentner Drummond,REP,90504,11,4,287,302,
Canadian,Superintendent of Public Instruction,Joy Hofmeister,REP,90504,12,2,331,345,
Canadian,Superintendent of Public Instruction,Linda Murphy,REP,90504,6,6,266,278,
Canadian,Commissioner of Labor,Cathy Costello,REP,90504,11,6,275,292,
Canadian,Commissioner of Labor,Leslie Osborn,REP,90504,7,2,309,318,
Canadian,Corporation Commissioner,Bob Anthony,REP,90504,7,5,303,315,
Canadian,Corporation Commissioner,Brian Bingman,REP,90504,13,2,287,302,
Canadian,State House,Roxanne Pollard,REP,90504,5,4,192,201,41
Canadian,State House,Denise Crosswhite Hader,REP,90504,13,4,409,426,41
Canadian,Governor,Chris Powell,LIB,90504,0,0,1,1,
Canadian,Governor,Rex Lawhorn,LIB,90504,0,0,0,0,
Canadian,Corporation Commissioner,Ashley Nicole Mccray,DEM,90504,7,0,39,46,
Canadian,Corporation Commissioner,Blake Cummings,DEM,90504,3,0,28,31,
Canadian,State House,Sara Peterson,DEM,90504,5,0,35,40,41
Canadian,State House,Jennie Scott,DEM,90504,5,0,32,37,41
Canadian,Governor,Mick Cornett,REP,90506,34,5,409,448,
Canadian,Governor,Kevin Stitt,REP,90506,38,5,310,353,
Canadian,Lieutenant Governor,Dana Murphy,REP,90506,38,5,303,346,
Canadian,Lieutenant Governor,Matt Pinnell,REP,90506,33,4,386,423,
Canadian,State Auditor,Cindy Byrd,REP,90506,41,5,314,360,
Canadian,State Auditor,Charlie Prater,REP,90506,28,5,353,386,
Canadian,Attorney General,Mike Hunter,REP,90506,41,5,362,408,
Canadian,Attorney General,Gentner Drummond,REP,90506,28,5,339,372,
Canadian,Superintendent of Public Instruction,Joy Hofmeister,REP,90506,40,7,356,403,
Canadian,Superintendent of Public Instruction,Linda Murphy,REP,90506,30,3,342,375,
Canadian,Commissioner of Labor,Cathy Costello,REP,90506,36,5,298,339,
Canadian,Commissioner of Labor,Leslie Osborn,REP,90506,34,5,392,431,
Canadian,Corporation Commissioner,Bob Anthony,REP,90506,48,4,345,397,
Canadian,Corporation Commissioner,Brian Bingman,REP,90506,23,6,340,369,
Canadian,State House,Roxanne Pollard,REP,90506,28,6,233,267,41
Canadian,State House,Denise Crosswhite Hader,REP,90506,43,4,467,514,41
Canadian,Governor,Chris Powell,LIB,90506,0,0,1,1,
Canadian,Governor,Rex Lawhorn,LIB,90506,0,0,1,1,
Canadian,Corporation Commissioner,Ashley Nicole Mccray,DEM,90506,14,0,55,69,
Canadian,Corporation Commissioner,Blake Cummings,DEM,90506,3,1,20,24,
Canadian,State House,Sara Peterson,DEM,90506,7,1,40,48,41
Canadian,State House,Jennie Scott,DEM,90506,11,0,36,47,41
Carter,Governor,Mick Cornett,REP,100001,0,1,23,24,
Carter,Governor,Kevin Stitt,REP,100001,0,1,23,24,
Carter,Lieutenant Governor,Dana Murphy,REP,100001,0,0,18,18,
Carter,Lieutenant Governor,Matt Pinnell,REP,100001,0,2,28,30,
Carter,State Auditor,Cindy Byrd,REP,100001,0,0,23,23,
Carter,State Auditor,Charlie Prater,REP,100001,0,2,22,24,
Carter,Attorney General,Mike Hunter,REP,100001,0,2,22,24,
Carter,Attorney General,Gentner Drummond,REP,100001,0,0,24,24,
Carter,Superintendent of Public Instruction,Joy Hofmeister,REP,100001,0,1,23,24,
Carter,Superintendent of Public Instruction,Linda Murphy,REP,100001,0,1,20,21,
Carter,Commissioner of Labor,Cathy Costello,REP,100001,0,0,23,23,
Carter,Commissioner of Labor,Leslie Osborn,REP,100001,0,2,22,24,
Carter,Corporation Commissioner,Bob Anthony,REP,100001,0,0,21,21,
Carter,Corporation Commissioner,Brian Bingman,REP,100001,0,2,23,25,
Carter,Governor,Chris Powell,LIB,100001,0,0,0,0,
Carter,Governor,Rex Lawhorn,LIB,100001,0,0,0,0,
Carter,Corporation Commissioner,Ashley Nicole Mccray,DEM,100001,1,2,29,32,
Carter,Corporation Commissioner,Blake Cummings,DEM,100001,0,0,11,11,
Carter,U.S. House,Mary Brannon,DEM,100001,0,2,20,22,04
Carter,U.S. House,Fred Gipson,DEM,100001,1,0,20,21,04
Carter,Governor,Mick Cornett,REP,100002,3,4,38,45,
Carter,Governor,Kevin Stitt,REP,100002,3,3,57,63,
Carter,Lieutenant Governor,Dana Murphy,REP,100002,4,3,27,34,
Carter,Lieutenant Governor,Matt Pinnell,REP,100002,2,4,64,70,
Carter,State Auditor,Cindy Byrd,REP,100002,4,4,44,52,
Carter,State Auditor,Charlie Prater,REP,100002,2,2,46,50,
Carter,Attorney General,Mike Hunter,REP,100002,5,4,49,58,
Carter,Attorney General,Gentner Drummond,REP,100002,1,3,44,48,
Carter,Superintendent of Public Instruction,Joy Hofmeister,REP,100002,3,3,36,42,
Carter,Superintendent of Public Instruction,Linda Murphy,REP,100002,3,4,55,62,
Carter,Commissioner of Labor,Cathy Costello,REP,100002,1,5,47,53,
Carter,Commissioner of Labor,Leslie Osborn,REP,100002,5,1,43,49,
Carter,Corporation Commissioner,Bob Anthony,REP,100002,4,4,47,55,
Carter,Corporation Commissioner,Brian Bingman,REP,100002,2,2,45,49,
Carter,Governor,Chris Powell,LIB,100002,0,0,0,0,
Carter,Governor,Rex Lawhorn,LIB,100002,0,0,0,0,
Carter,Corporation Commissioner,Ashley Nicole Mccray,DEM,100002,7,0,38,45,
Carter,Corporation Commissioner,Blake Cummings,DEM,100002,9,1,24,34,
Carter,U.S. House,Mary Brannon,DEM,100002,11,1,37,49,04
Carter,U.S. House,Fred Gipson,DEM,100002,5,0,26,31,04
Carter,Governor,Mick Cornett,REP,100007,0,1,2,3,
Carter,Governor,Kevin Stitt,REP,100007,0,1,2,3,
Carter,Lieutenant Governor,Dana Murphy,REP,100007,0,0,2,2,
Carter,Lieutenant Governor,Matt Pinnell,REP,100007,0,2,2,4,
Carter,State Auditor,Cindy Byrd,REP,100007,0,0,3,3,
Carter,State Auditor,Charlie Prater,REP,100007,0,2,1,3,
Carter,Attorney General,Mike Hunter,REP,100007,0,0,1,1,
Carter,Attorney General,Gentner Drummond,REP,100007,0,2,3,5,
Carter,Superintendent of Public Instruction,Joy Hofmeister,REP,100007,0,0,1,1,
Carter,Superintendent of Public Instruction,Linda Murphy,REP,100007,0,2,3,5,
Carter,Commissioner of Labor,Cathy Costello,REP,100007,0,2,2,4,
Carter,Commissioner of Labor,Leslie Osborn,REP,100007,0,0,2,2,
Carter,Corporation Commissioner,Bob Anthony,REP,100007,0,1,2,3,
Carter,Corporation Commissioner,Brian Bingman,REP,100007,0,1,2,3,
Carter,Governor,Chris Powell,LIB,100007,0,0,0,0,
Carter,Governor,Rex Lawhorn,LIB,100007,0,0,1,1,
Carter,Corporation Commissioner,Ashley Nicole Mccray,DEM,100007,2,0,18,20,
Carter,Corporation Commissioner,Blake Cummings,DEM,100007,1,1,6,8,
Carter,U.S. House,Mary Brannon,DEM,100007,1,1,10,12,04
Carter,U.S. House,Fred Gipson,DEM,100007,2,0,14,16,04
Carter,Governor,Mick Cornett,REP,100011,0,0,17,17,
Carter,Governor,Kevin Stitt,REP,100011,2,2,33,37,
Carter,Lieutenant Governor,Dana Murphy,REP,100011,0,0,26,26,
Carter,Lieutenant Governor,Matt Pinnell,REP,100011,2,2,24,28,
Carter,State Auditor,Cindy Byrd,REP,100011,2,0,27,29,
Carter,State Auditor,Charlie Prater,REP,100011,0,2,22,24,
Carter,Attorney General,Mike Hunter,REP,100011,0,1,22,23,
Carter,Attorney General,Gentner Drummond,REP,100011,2,1,28,31,
Carter,Superintendent of Public Instruction,Joy Hofmeister,REP,100011,0,0,27,27,
Carter,Superintendent of Public Instruction,Linda Murphy,REP,100011,2,2,23,27,
Carter,Commissioner of Labor,Cathy Costello,REP,100011,2,1,28,31,
Carter,Commissioner of Labor,Leslie Osborn,REP,100011,0,1,21,22,
Carter,Corporation Commissioner,Bob Anthony,REP,100011,0,1,31,32,
Carter,Corporation Commissioner,Brian Bingman,REP,100011,2,1,17,20,
Carter,Governor,Chris Powell,LIB,100011,0,0,0,0,
Carter,Governor,Rex Lawhorn,LIB,100011,0,0,0,0,
Carter,Corporation Commissioner,Ashley Nicole Mccray,DEM,100011,0,2,16,18,
Carter,Corporation Commissioner,Blake Cummings,DEM,100011,0,0,15,15,
Carter,U.S. House,Mary Brannon,DEM,100011,0,1,14,15,04
Carter,U.S. House,Fred Gipson,DEM,100011,0,1,17,18,04
Carter,Governor,Mick Cornett,REP,100014,4,3,22,29,
Carter,Governor,Kevin Stitt,REP,100014,1,1,23,25,
Carter,Lieutenant Governor,Dana Murphy,REP,100014,2,1,10,13,
Carter,Lieutenant Governor,Matt Pinnell,REP,100014,3,3,35,41,
Carter,State Auditor,Cindy Byrd,REP,100014,4,2,21,27,
Carter,State Auditor,Charlie Prater,REP,100014,1,2,23,26,
Carter,Attorney General,Mike Hunter,REP,100014,0,3,20,23,
Carter,Attorney General,Gentner Drummond,REP,100014,5,1,24,30,
Carter,Superintendent of Public Instruction,Joy Hofmeister,REP,100014,4,4,24,32,
Carter,Superintendent of Public Instruction,Linda Murphy,REP,100014,1,0,21,22,
Carter,Commissioner of Labor,Cathy Costello,REP,100014,3,1,16,20,
Carter,Commissioner of Labor,Leslie Osborn,REP,100014,2,3,28,33,
Carter,Corporation Commissioner,Bob Anthony,REP,100014,4,4,20,28,
Carter,Corporation Commissioner,Brian Bingman,REP,100014,1,0,25,26,
Carter,Governor,Chris Powell,LIB,100014,0,0,0,0,
Carter,Governor,Rex Lawhorn,LIB,100014,0,0,0,0,
Carter,Corporation Commissioner,Ashley Nicole Mccray,DEM,100014,2,2,17,21,
Carter,Corporation Commissioner,Blake Cummings,DEM,100014,0,1,9,10,
Carter,U.S. House,Mary Brannon,DEM,100014,0,0,12,12,04
Carter,U.S. House,Fred Gipson,DEM,100014,2,3,14,19,04
Carter,Governor,Mick Cornett,REP,100015,1,0,28,29,
Carter,Governor,Kevin Stitt,REP,100015,2,0,47,49,
Carter,Lieutenant Governor,Dana Murphy,REP,100015,0,0,30,30,
Carter,Lieutenant Governor,Matt Pinnell,REP,100015,3,0,45,48,
Carter,State Auditor,Cindy Byrd,REP,100015,1,0,33,34,
Carter,State Auditor,Charlie Prater,REP,100015,2,0,41,43,
Carter,Attorney General,Mike Hunter,REP,100015,1,0,39,40,
Carter,Attorney General,Gentner Drummond,REP,100015,2,0,36,38,
Carter,Superintendent of Public Instruction,Joy Hofmeister,REP,100015,3,0,34,37,
Carter,Superintendent of Public Instruction,Linda Murphy,REP,100015,0,0,38,38,
Carter,Commissioner of Labor,Cathy Costello,REP,100015,1,0,32,33,
Carter,Commissioner of Labor,Leslie Osborn,REP,100015,2,0,40,42,
Carter,Corporation Commissioner,Bob Anthony,REP,100015,1,0,39,40,
Carter,Corporation Commissioner,Brian Bingman,REP,100015,2,0,36,38,
Carter,Governor,Chris Powell,LIB,100015,0,0,0,0,
Carter,Governor,Rex Lawhorn,LIB,100015,0,0,0,0,
Carter,Corporation Commissioner,Ashley Nicole Mccray,DEM,100015,4,2,25,31,
Carter,Corporation Commissioner,Blake Cummings,DEM,100015,5,1,19,25,
Carter,U.S. House,Mary Brannon,DEM,100015,5,2,21,28,04
Carter,U.S. House,Fred Gipson,DEM,100015,3,1,23,27,04
Carter,Governor,Mick Cornett,REP,100017,1,0,26,27,
Carter,Governor,Kevin Stitt,REP,100017,2,1,69,72,
Carter,Lieutenant Governor,Dana Murphy,REP,100017,2,0,25,27,
Carter,Lieutenant Governor,Matt Pinnell,REP,100017,1,1,70,72,
Carter,State Auditor,Cindy Byrd,REP,100017,3,0,50,53,
Carter,State Auditor,Charlie Prater,REP,100017,0,0,37,37,
Carter,Attorney General,Mike Hunter,REP,100017,2,1,49,52,
Carter,Attorney General,Gentner Drummond,REP,100017,1,0,46,47,
Carter,Superintendent of Public Instruction,Joy Hofmeister,REP,100017,1,1,43,45,
Carter,Superintendent of Public Instruction,Linda Murphy,REP,100017,2,0,50,52,
Carter,Commissioner of Labor,Cathy Costello,REP,100017,2,1,55,58,
Carter,Commissioner of Labor,Leslie Osborn,REP,100017,1,0,33,34,
Carter,Corporation Commissioner,Bob Anthony,REP,100017,3,0,54,57,
Carter,Corporation Commissioner,Brian Bingman,REP,100017,0,1,35,36,
Carter,Governor,Chris Powell,LIB,100017,0,0,0,0,
Carter,Governor,Rex Lawhorn,LIB,100017,0,0,0,0,
Carter,Corporation Commissioner,Ashley Nicole Mccray,DEM,100017,0,0,19,19,
Carter,Corporation Commissioner,Blake Cummings,DEM,100017,1,1,14,16,
Carter,U.S. House,Mary Brannon,DEM,100017,0,0,20,20,04
Carter,U.S. House,Fred Gipson,DEM,100017,1,1,13,15,04
Carter,Governor,Mick Cornett,REP,100019,5,9,109,123,
Carter,Governor,Kevin Stitt,REP,100019,11,13,234,258,
Carter,Lieutenant Governor,Dana Murphy,REP,100019,7,5,124,136,
Carter,Lieutenant Governor,Matt Pinnell,REP,100019,9,17,216,242,
Carter,State Auditor,Cindy Byrd,REP,100019,8,17,188,213,
Carter,State Auditor,Charlie Prater,REP,100019,8,4,144,156,
Carter,Attorney General,Mike Hunter,REP,100019,10,14,183,207,
Carter,Attorney General,Gentner Drummond,REP,100019,6,8,155,169,
Carter,Superintendent of Public Instruction,Joy Hofmeister,REP,100019,8,14,183,205,
Carter,Superintendent of Public Instruction,Linda Murphy,REP,100019,8,8,150,166,
Carter,Commissioner of Labor,Cathy Costello,REP,100019,7,10,179,196,
Carter,Commissioner of Labor,Leslie Osborn,REP,100019,8,11,145,164,
Carter,Corporation Commissioner,Bob Anthony,REP,100019,9,15,223,247,
Carter,Corporation Commissioner,Brian Bingman,REP,100019,7,7,113,127,
Carter,Governor,Chris Powell,LIB,100019,0,0,0,0,
Carter,Governor,Rex Lawhorn,LIB,100019,0,0,0,0,
Carter,Corporation Commissioner,Ashley Nicole Mccray,DEM,100019,6,7,66,79,
Carter,Corporation Commissioner,Blake Cummings,DEM,100019,3,3,35,41,
Carter,U.S. House,Mary Brannon,DEM,100019,4,6,52,62,04
Carter,U.S. House,Fred Gipson,DEM,100019,6,4,49,59,04
Carter,Governor,Mick Cornett,REP,100020,0,0,27,27,
Carter,Governor,Kevin Stitt,REP,100020,0,2,55,57,
Carter,Lieutenant Governor,Dana Murphy,REP,100020,0,1,28,29,
Carter,Lieutenant Governor,Matt Pinnell,REP,100020,0,1,53,54,
Carter,State Auditor,Cindy Byrd,REP,100020,0,1,43,44,
Carter,State Auditor,Charlie Prater,REP,100020,0,1,35,36,
Carter,Attorney General,Mike Hunter,REP,100020,0,0,36,36,
Carter,Attorney General,Gentner Drummond,REP,100020,0,2,46,48,
Carter,Superintendent of Public Instruction,Joy Hofmeister,REP,100020,0,1,42,43,
Carter,Superintendent of Public Instruction,Linda Murphy,REP,100020,0,1,38,39,
Carter,Commissioner of Labor,Cathy Costello,REP,100020,0,2,43,45,
Carter,Commissioner of Labor,Leslie Osborn,REP,100020,0,0,34,34,
Carter,Corporation Commissioner,Bob Anthony,REP,100020,0,2,39,41,
Carter,Corporation Commissioner,Brian Bingman,REP,100020,0,0,39,39,
Carter,Governor,Chris Powell,LIB,100020,0,0,0,0,
Carter,Governor,Rex Lawhorn,LIB,100020,0,0,0,0,
Carter,Corporation Commissioner,Ashley Nicole Mccray,DEM,100020,3,0,38,41,
Carter,Corporation Commissioner,Blake Cummings,DEM,100020,0,0,22,22,
Carter,U.S. House,Mary Brannon,DEM,100020,0,0,34,34,04
Carter,U.S. House,Fred Gipson,DEM,100020,3,0,27,30,04
Carter,Governor,Mick Cornett,REP,100024,0,2,72,74,
Carter,Governor,Kevin Stitt,REP,100024,1,4,100,105,
Carter,Lieutenant Governor,Dana Murphy,REP,100024,0,2,59,61,
Carter,Lieutenant Governor,Matt Pinnell,REP,100024,1,4,112,117,
Carter,State Auditor,Cindy Byrd,REP,100024,0,3,98,101,
Carter,State Auditor,Charlie Prater,REP,100024,1,2,67,70,
Carter,Attorney General,Mike Hunter,REP,100024,0,2,88,90,
Carter,Attorney General,Gentner Drummond,REP,100024,1,3,81,85,
Carter,Superintendent of Public Instruction,Joy Hofmeister,REP,100024,0,3,88,91,
Carter,Superintendent of Public Instruction,Linda Murphy,REP,100024,1,3,82,86,
Carter,Commissioner of Labor,Cathy Costello,REP,100024,1,3,91,95,
Carter,Commissioner of Labor,Leslie Osborn,REP,100024,0,3,75,78,
Carter,Corporation Commissioner,Bob Anthony,REP,100024,0,4,97,101,
Carter,Corporation Commissioner,Brian Bingman,REP,100024,1,2,71,74,
Carter,Governor,Chris Powell,LIB,100024,0,0,0,0,
Carter,Governor,Rex Lawhorn,LIB,100024,0,0,0,0,
Carter,Corporation Commissioner,Ashley Nicole Mccray,DEM,100024,4,0,41,45,
Carter,Corporation Commissioner,Blake Cummings,DEM,100024,2,0,19,21,
Carter,U.S. House,Mary Brannon,DEM,100024,3,0,34,37,04
Carter,U.S. House,Fred Gipson,DEM,100024,3,0,26,29,04
Carter,Governor,Mick Cornett,REP,100025,0,0,7,7,
Carter,Governor,Kevin Stitt,REP,100025,2,0,24,26,
Carter,Lieutenant Governor,Dana Murphy,REP,100025,0,0,7,7,
Carter,Lieutenant Governor,Matt Pinnell,REP,100025,2,0,24,26,
Carter,State Auditor,Cindy Byrd,REP,100025,2,0,10,12,
Carter,State Auditor,Charlie Prater,REP,100025,0,0,21,21,
Carter,Attorney General,Mike Hunter,REP,100025,0,0,16,16,
Carter,Attorney General,Gentner Drummond,REP,100025,2,0,15,17,
Carter,Superintendent of Public Instruction,Joy Hofmeister,REP,100025,0,0,15,15,
Carter,Superintendent of Public Instruction,Linda Murphy,REP,100025,2,0,16,18,
Carter,Commissioner of Labor,Cathy Costello,REP,100025,2,0,15,17,
Carter,Commissioner of Labor,Leslie Osborn,REP,100025,0,0,16,16,
Carter,Corporation Commissioner,Bob Anthony,REP,100025,0,0,19,19,
Carter,Corporation Commissioner,Brian Bingman,REP,100025,2,0,12,14,
Carter,Governor,Chris Powell,LIB,100025,0,0,1,1,
Carter,Governor,Rex Lawhorn,LIB,100025,0,0,0,0,
Carter,Corporation Commissioner,Ashley Nicole Mccray,DEM,100025,0,0,5,5,
Carter,Corporation Commissioner,Blake Cummings,DEM,100025,0,0,2,2,
Carter,U.S. House,Mary Brannon,DEM,100025,0,0,4,4,04
Carter,U.S. House,Fred Gipson,DEM,100025,0,0,3,3,04
Carter,Governor,Mick Cornett,REP,100026,3,0,11,14,
Carter,Governor,Kevin Stitt,REP,100026,0,0,24,24,
Carter,Lieutenant Governor,Dana Murphy,REP,100026,1,0,10,11,
Carter,Lieutenant Governor,Matt Pinnell,REP,100026,2,0,24,26,
Carter,State Auditor,Cindy Byrd,REP,100026,2,0,16,18,
Carter,State Auditor,Charlie Prater,REP,100026,0,0,17,17,
Carter,Attorney General,Mike Hunter,REP,100026,3,0,19,22,
Carter,Attorney General,Gentner Drummond,REP,100026,0,0,15,15,
Carter,Superintendent of Public Instruction,Joy Hofmeister,REP,100026,3,0,16,19,
Carter,Superintendent of Public Instruction,Linda Murphy,REP,100026,0,0,19,19,
Carter,Commissioner of Labor,Cathy Costello,REP,100026,1,0,19,20,
Carter,Commissioner of Labor,Leslie Osborn,REP,100026,0,0,14,14,
Carter,Corporation Commissioner,Bob Anthony,REP,100026,2,0,21,23,
Carter,Corporation Commissioner,Brian Bingman,REP,100026,1,0,12,13,
Carter,Governor,Chris Powell,LIB,100026,0,0,0,0,
Carter,Governor,Rex Lawhorn,LIB,100026,0,0,0,0,
Carter,Corporation Commissioner,Ashley Nicole Mccray,DEM,100026,2,0,11,13,
Carter,Corporation Commissioner,Blake Cummings,DEM,100026,0,1,5,6,
Carter,U.S. House,Mary Brannon,DEM,100026,2,1,12,15,04
Carter,U.S. House,Fred Gipson,DEM,100026,0,0,4,4,04
Carter,Governor,Mick Cornett,REP,100030,0,0,3,3,
Carter,Governor,Kevin Stitt,REP,100030,1,0,17,18,
Carter,Lieutenant Governor,Dana Murphy,REP,100030,0,0,2,2,
Carter,Lieutenant Governor,Matt Pinnell,REP,100030,1,0,18,19,
Carter,State Auditor,Cindy Byrd,REP,100030,0,0,9,9,
Carter,State Auditor,Charlie Prater,REP,100030,1,0,10,11,
Carter,Attorney General,Mike Hunter,REP,100030,0,0,8,8,
Carter,Attorney General,Gentner Drummond,REP,100030,1,0,12,13,
Carter,Superintendent of Public Instruction,Joy Hofmeister,REP,100030,0,0,12,12,
Carter,Superintendent of Public Instruction,Linda Murphy,REP,100030,1,0,8,9,
Carter,Commissioner of Labor,Cathy Costello,REP,100030,0,0,5,5,
Carter,Commissioner of Labor,Leslie Osborn,REP,100030,1,0,15,16,
Carter,Corporation Commissioner,Bob Anthony,REP,100030,1,0,7,8,
Carter,Corporation Commissioner,Brian Bingman,REP,100030,0,0,12,12,
Carter,Governor,Chris Powell,LIB,100030,0,0,0,0,
Carter,Governor,Rex Lawhorn,LIB,100030,0,0,0,0,
Carter,Corporation Commissioner,Ashley Nicole Mccray,DEM,100030,0,0,1,1,
Carter,Corporation Commissioner,Blake Cummings,DEM,100030,0,0,4,4,
Carter,U.S. House,Mary Brannon,DEM,100030,0,0,3,3,04
Carter,U.S. House,Fred Gipson,DEM,100030,0,0,2,2,04
Carter,Governor,Mick Cornett,REP,100031,1,1,48,50,
Carter,Governor,Kevin Stitt,REP,100031,1,1,76,78,
Carter,Lieutenant Governor,Dana Murphy,REP,100031,1,0,48,49,
Carter,Lieutenant Governor,Matt Pinnell,REP,100031,1,2,75,78,
Carter,State Auditor,Cindy Byrd,REP,100031,1,0,68,69,
Carter,State Auditor,Charlie Prater,REP,100031,1,2,53,56,
Carter,Attorney General,Mike Hunter,REP,100031,0,1,39,40,
Carter,Attorney General,Gentner Drummond,REP,100031,2,1,84,87,
Carter,Superintendent of Public Instruction,Joy Hofmeister,REP,100031,0,1,64,65,
Carter,Superintendent of Public Instruction,Linda Murphy,REP,100031,2,1,56,59,
Carter,Commissioner of Labor,Cathy Costello,REP,100031,1,1,60,62,
Carter,Commissioner of Labor,Leslie Osborn,REP,100031,1,1,57,59,
Carter,Corporation Commissioner,Bob Anthony,REP,100031,1,1,69,71,
Carter,Corporation Commissioner,Brian Bingman,REP,100031,1,1,49,51,
Carter,Governor,Chris Powell,LIB,100031,0,0,0,0,
Carter,Governor,Rex Lawhorn,LIB,100031,0,0,0,0,
Carter,Corporation Commissioner,Ashley Nicole Mccray,DEM,100031,3,0,30,33,
Carter,Corporation Commissioner,Blake Cummings,DEM,100031,0,1,26,27,
Carter,U.S. House,Mary Brannon,DEM,100031,1,0,29,30,04
Carter,U.S. House,Fred Gipson,DEM,100031,2,1,27,30,04
Carter,Governor,Mick Cornett,REP,100032,0,0,6,6,
Carter,Governor,Kevin Stitt,REP,100032,1,0,9,10,
Carter,Lieutenant Governor,Dana Murphy,REP,100032,0,0,8,8,
Carter,Lieutenant Governor,Matt Pinnell,REP,100032,1,0,8,9,
Carter,State Auditor,Cindy Byrd,REP,100032,1,0,6,7,
Carter,State Auditor,Charlie Prater,REP,100032,0,0,9,9,
Carter,Attorney General,Mike Hunter,REP,100032,0,0,6,6,
Carter,Attorney General,Gentner Drummond,REP,100032,1,0,10,11,
Carter,Superintendent of Public Instruction,Joy Hofmeister,REP,100032,0,0,2,2,
Carter,Superintendent of Public Instruction,Linda Murphy,REP,100032,1,0,13,14,
Carter,Commissioner of Labor,Cathy Costello,REP,100032,1,0,6,7,
Carter,Commissioner of Labor,Leslie Osborn,REP,100032,0,0,10,10,
Carter,Corporation Commissioner,Bob Anthony,REP,100032,1,0,6,7,
Carter,Corporation Commissioner,Brian Bingman,REP,100032,0,0,10,10,
Carter,Governor,Chris Powell,LIB,100032,0,0,0,0,
Carter,Governor,Rex Lawhorn,LIB,100032,0,0,0,0,
Carter,Corporation Commissioner,Ashley Nicole Mccray,DEM,100032,0,0,12,12,
Carter,Corporation Commissioner,Blake Cummings,DEM,100032,0,0,11,11,
Carter,U.S. House,Mary Brannon,DEM,100032,0,0,12,12,04
Carter,U.S. House,Fred Gipson,DEM,100032,0,0,11,11,04
Carter,Governor,Mick Cornett,REP,100033,1,1,17,19,
Carter,Governor,Kevin Stitt,REP,100033,1,6,51,58,
Carter,Lieutenant Governor,Dana Murphy,REP,100033,2,3,9,14,
Carter,Lieutenant Governor,Matt Pinnell,REP,100033,0,4,58,62,
Carter,State Auditor,Cindy Byrd,REP,100033,2,4,29,35,
Carter,State Auditor,Charlie Prater,REP,100033,0,3,36,39,
Carter,Attorney General,Mike Hunter,REP,100033,2,3,35,40,
Carter,Attorney General,Gentner Drummond,REP,100033,0,4,31,35,
Carter,Superintendent of Public Instruction,Joy Hofmeister,REP,100033,1,2,32,35,
Carter,Superintendent of Public Instruction,Linda Murphy,REP,100033,1,5,33,39,
Carter,Commissioner of Labor,Cathy Costello,REP,100033,1,4,33,38,
Carter,Commissioner of Labor,Leslie Osborn,REP,100033,0,3,33,36,
Carter,Corporation Commissioner,Bob Anthony,REP,100033,1,3,33,37,
Carter,Corporation Commissioner,Brian Bingman,REP,100033,1,4,33,38,
Carter,Governor,Chris Powell,LIB,100033,0,0,0,0,
Carter,Governor,Rex Lawhorn,LIB,100033,0,0,0,0,
Carter,Corporation Commissioner,Ashley Nicole Mccray,DEM,100033,3,1,19,23,
Carter,Corporation Commissioner,Blake Cummings,DEM,100033,0,0,19,19,
Carter,U.S. House,Mary Brannon,DEM,100033,1,0,20,21,04
Carter,U.S. House,Fred Gipson,DEM,100033,2,1,18,21,04
Carter,Governor,Mick Cornett,REP,100034,0,0,14,14,
Carter,Governor,Kevin Stitt,REP,100034,1,0,32,33,
Carter,Lieutenant Governor,Dana Murphy,REP,100034,0,0,15,15,
Carter,Lieutenant Governor,Matt Pinnell,REP,100034,1,0,31,32,
Carter,State Auditor,Cindy Byrd,REP,100034,1,0,16,17,
Carter,State Auditor,Charlie Prater,REP,100034,0,0,30,30,
Carter,Attorney General,Mike Hunter,REP,100034,1,0,20,21,
Carter,Attorney General,Gentner Drummond,REP,100034,0,0,26,26,
Carter,Superintendent of Public Instruction,Joy Hofmeister,REP,100034,1,0,25,26,
Carter,Superintendent of Public Instruction,Linda Murphy,REP,100034,0,0,20,20,
Carter,Commissioner of Labor,Cathy Costello,REP,100034,1,0,24,25,
Carter,Commissioner of Labor,Leslie Osborn,REP,100034,0,0,22,22,
Carter,Corporation Commissioner,Bob Anthony,REP,100034,0,0,23,23,
Carter,Corporation Commissioner,Brian Bingman,REP,100034,1,0,21,22,
Carter,Governor,Chris Powell,LIB,100034,0,0,1,1,
Carter,Governor,Rex Lawhorn,LIB,100034,0,0,0,0,
Carter,Corporation Commissioner,Ashley Nicole Mccray,DEM,100034,1,2,33,36,
Carter,Corporation Commissioner,Blake Cummings,DEM,100034,2,0,18,20,
Carter,U.S. House,Mary Brannon,DEM,100034,0,0,27,27,04
Carter,U.S. House,Fred Gipson,DEM,100034,3,2,24,29,04
Carter,Governor,Mick Cornett,REP,100039,0,0,4,4,
Carter,Governor,Kevin Stitt,REP,100039,0,0,17,17,
Carter,Lieutenant Governor,Dana Murphy,REP,100039,0,0,6,6,
Carter,Lieutenant Governor,Matt Pinnell,REP,100039,0,0,15,15,
Carter,State Auditor,Cindy Byrd,REP,100039,0,0,8,8,
Carter,State Auditor,Charlie Prater,REP,100039,0,0,13,13,
Carter,Attorney General,Mike Hunter,REP,100039,0,0,6,6,
Carter,Attorney General,Gentner Drummond,REP,100039,0,0,15,15,
Carter,Superintendent of Public Instruction,Joy Hofmeister,REP,100039,0,0,12,12,
Carter,Superintendent of Public Instruction,Linda Murphy,REP,100039,0,0,9,9,
Carter,Commissioner of Labor,Cathy Costello,REP,100039,0,0,12,12,
Carter,Commissioner of Labor,Leslie Osborn,REP,100039,0,0,9,9,
Carter,Corporation Commissioner,Bob Anthony,REP,100039,0,0,2,2,
Carter,Corporation Commissioner,Brian Bingman,REP,100039,0,0,19,19,
Carter,Governor,Chris Powell,LIB,100039,0,0,0,0,
Carter,Governor,Rex Lawhorn,LIB,100039,0,0,0,0,
Carter,Corporation Commissioner,Ashley Nicole Mccray,DEM,100039,0,0,7,7,
Carter,Corporation Commissioner,Blake Cummings,DEM,100039,0,0,7,7,
Carter,U.S. House,Mary Brannon,DEM,100039,0,0,7,7,04
Carter,U.S. House,Fred Gipson,DEM,100039,0,0,7,7,04
Carter,Governor,Mick Cornett,REP,100041,0,0,42,42,
Carter,Governor,Kevin Stitt,REP,100041,3,0,68,71,
Carter,Lieutenant Governor,Dana Murphy,REP,100041,1,0,45,46,
Carter,Lieutenant Governor,Matt Pinnell,REP,100041,2,0,62,64,
Carter,State Auditor,Cindy Byrd,REP,100041,1,0,58,59,
Carter,State Auditor,Charlie Prater,REP,100041,2,0,46,48,
Carter,Attorney General,Mike Hunter,REP,100041,2,0,56,58,
Carter,Attorney General,Gentner Drummond,REP,100041,1,0,54,55,
Carter,Superintendent of Public Instruction,Joy Hofmeister,REP,100041,1,0,62,63,
Carter,Superintendent of Public Instruction,Linda Murphy,REP,100041,2,0,46,48,
Carter,Commissioner of Labor,Cathy Costello,REP,100041,3,0,52,55,
Carter,Commissioner of Labor,Leslie Osborn,REP,100041,0,0,53,53,
Carter,Corporation Commissioner,Bob Anthony,REP,100041,2,0,58,60,
Carter,Corporation Commissioner,Brian Bingman,REP,100041,1,0,48,49,
Carter,Governor,Chris Powell,LIB,100041,0,0,0,0,
Carter,Governor,Rex Lawhorn,LIB,100041,0,0,0,0,
Carter,Corporation Commissioner,Ashley Nicole Mccray,DEM,100041,1,1,26,28,
Carter,Corporation Commissioner,Blake Cummings,DEM,100041,0,0,33,33,
Carter,U.S. House,Mary Brannon,DEM,100041,0,1,26,27,04
Carter,U.S. House,Fred Gipson,DEM,100041,1,0,34,35,04
Carter,Governor,Mick Cornett,REP,100051,0,0,4,4,
Carter,Governor,Kevin Stitt,REP,100051,0,0,30,30,
Carter,Lieutenant Governor,Dana Murphy,REP,100051,0,0,10,10,
Carter,Lieutenant Governor,Matt Pinnell,REP,100051,0,0,24,24,
Carter,State Auditor,Cindy Byrd,REP,100051,0,0,18,18,
Carter,State Auditor,Charlie Prater,REP,100051,0,0,15,15,
Carter,Attorney General,Mike Hunter,REP,100051,0,0,11,11,
Carter,Attorney General,Gentner Drummond,REP,100051,0,0,22,22,
Carter,Superintendent of Public Instruction,Joy Hofmeister,REP,100051,0,0,12,12,
Carter,Superintendent of Public Instruction,Linda Murphy,REP,100051,0,0,21,21,
Carter,Commissioner of Labor,Cathy Costello,REP,100051,0,0,18,18,
Carter,Commissioner of Labor,Leslie Osborn,REP,100051,0,0,15,15,
Carter,Corporation Commissioner,Bob Anthony,REP,100051,0,0,18,18,
Carter,Corporation Commissioner,Brian Bingman,REP,100051,0,0,16,16,
Carter,Governor,Chris Powell,LIB,100051,0,0,0,0,
Carter,Governor,Rex Lawhorn,LIB,100051,0,0,0,0,
Carter,Corporation Commissioner,Ashley Nicole Mccray,DEM,100051,0,0,10,10,
Carter,Corporation Commissioner,Blake Cummings,DEM,100051,0,0,10,10,
Carter,U.S. House,Mary Brannon,DEM,100051,0,0,10,10,04
Carter,U.S. House,Fred Gipson,DEM,100051,0,0,10,10,04
Carter,Governor,Mick Cornett,REP,100052,0,0,14,14,
Carter,Governor,Kevin Stitt,REP,100052,0,0,42,42,
Carter,Lieutenant Governor,Dana Murphy,REP,100052,0,0,21,21,
Carter,Lieutenant Governor,Matt Pinnell,REP,100052,0,0,36,36,
Carter,State Auditor,Cindy Byrd,REP,100052,0,0,24,24,
Carter,State Auditor,Charlie Prater,REP,100052,0,0,30,30,
Carter,Attorney General,Mike Hunter,REP,100052,0,0,20,20,
Carter,Attorney General,Gentner Drummond,REP,100052,0,0,37,37,
Carter,Superintendent of Public Instruction,Joy Hofmeister,REP,100052,0,0,23,23,
Carter,Superintendent of Public Instruction,Linda Murphy,REP,100052,0,0,31,31,
Carter,Commissioner of Labor,Cathy Costello,REP,100052,0,0,33,33,
Carter,Commissioner of Labor,Leslie Osborn,REP,100052,0,0,22,22,
Carter,Corporation Commissioner,Bob Anthony,REP,100052,0,0,20,20,
Carter,Corporation Commissioner,Brian Bingman,REP,100052,0,0,36,36,
Carter,Governor,Chris Powell,LIB,100052,0,0,0,0,
Carter,Governor,Rex Lawhorn,LIB,100052,0,0,0,0,
Carter,Corporation Commissioner,Ashley Nicole Mccray,DEM,100052,0,0,15,15,
Carter,Corporation Commissioner,Blake Cummings,DEM,100052,0,0,14,14,
Carter,U.S. House,Mary Brannon,DEM,100052,0,0,14,14,04
Carter,U.S. House,Fred Gipson,DEM,100052,0,0,15,15,04
Carter,Governor,Mick Cornett,REP,100061,0,0,20,20,
Carter,Governor,Kevin Stitt,REP,100061,2,2,26,30,
Carter,Lieutenant Governor,Dana Murphy,REP,100061,1,0,19,20,
Carter,Lieutenant Governor,Matt Pinnell,REP,100061,1,2,27,30,
Carter,State Auditor,Cindy Byrd,REP,100061,2,0,22,24,
Carter,State Auditor,Charlie Prater,REP,100061,0,2,24,26,
Carter,Attorney General,Mike Hunter,REP,100061,1,0,16,17,
Carter,Attorney General,Gentner Drummond,REP,100061,0,2,30,32,
Carter,Superintendent of Public Instruction,Joy Hofmeister,REP,100061,0,1,25,26,
Carter,Superintendent of Public Instruction,Linda Murphy,REP,100061,2,1,20,23,
Carter,Commissioner of Labor,Cathy Costello,REP,100061,2,1,29,32,
Carter,Commissioner of Labor,Leslie Osborn,REP,100061,0,1,16,17,
Carter,Corporation Commissioner,Bob Anthony,REP,100061,2,0,27,29,
Carter,Corporation Commissioner,Brian Bingman,REP,100061,0,2,19,21,
Carter,Governor,Chris Powell,LIB,100061,0,0,0,0,
Carter,Governor,Rex Lawhorn,LIB,100061,0,0,0,0,
Carter,Corporation Commissioner,Ashley Nicole Mccray,DEM,100061,0,0,7,7,
Carter,Corporation Commissioner,Blake Cummings,DEM,100061,0,0,9,9,
Carter,U.S. House,Mary Brannon,DEM,100061,0,0,6,6,04
Carter,U.S. House,Fred Gipson,DEM,100061,0,0,10,10,04
Carter,Governor,Mick Cornett,REP,100062,0,2,30,32,
Carter,Governor,Kevin Stitt,REP,100062,0,0,49,49,
Carter,Lieutenant Governor,Dana Murphy,REP,100062,0,0,25,25,
Carter,Lieutenant Governor,Matt Pinnell,REP,100062,0,2,52,54,
Carter,State Auditor,Cindy Byrd,REP,100062,0,0,35,35,
Carter,State Auditor,Charlie Prater,REP,100062,0,1,40,41,
Carter,Attorney General,Mike Hunter,REP,100062,0,1,24,25,
Carter,Attorney General,Gentner Drummond,REP,100062,0,0,54,54,
Carter,Superintendent of Public Instruction,Joy Hofmeister,REP,100062,0,2,39,41,
Carter,Superintendent of Public Instruction,Linda Murphy,REP,100062,0,0,37,37,
Carter,Commissioner of Labor,Cathy Costello,REP,100062,0,0,35,35,
Carter,Commissioner of Labor,Leslie Osborn,REP,100062,0,1,41,42,
Carter,Corporation Commissioner,Bob Anthony,REP,100062,0,0,29,29,
Carter,Corporation Commissioner,Brian Bingman,REP,100062,0,2,46,48,
Carter,Governor,Chris Powell,LIB,100062,0,0,0,0,
Carter,Governor,Rex Lawhorn,LIB,100062,0,0,0,0,
Carter,Corporation Commissioner,Ashley Nicole Mccray,DEM,100062,2,3,18,23,
Carter,Corporation Commissioner,Blake Cummings,DEM,100062,1,2,31,34,
Carter,U.S. House,Mary Brannon,DEM,100062,2,2,28,32,04
Carter,U.S. House,Fred Gipson,DEM,100062,1,3,21,25,04
Carter,Governor,Mick Cornett,REP,100063,1,6,35,42,
Carter,Governor,Kevin Stitt,REP,100063,1,1,79,81,
Carter,Lieutenant Governor,Dana Murphy,REP,100063,1,2,29,32,
Carter,Lieutenant Governor,Matt Pinnell,REP,100063,1,5,85,91,
Carter,State Auditor,Cindy Byrd,REP,100063,2,5,53,60,
Carter,State Auditor,Charlie Prater,REP,100063,0,2,59,61,
Carter,Attorney General,Mike Hunter,REP,100063,1,2,53,56,
Carter,Attorney General,Gentner Drummond,REP,100063,1,4,61,66,
Carter,Superintendent of Public Instruction,Joy Hofmeister,REP,100063,0,4,70,74,
Carter,Superintendent of Public Instruction,Linda Murphy,REP,100063,2,3,42,47,
Carter,Commissioner of Labor,Cathy Costello,REP,100063,1,1,47,49,
Carter,Commissioner of Labor,Leslie Osborn,REP,100063,1,6,65,72,
Carter,Corporation Commissioner,Bob Anthony,REP,100063,1,5,63,69,
Carter,Corporation Commissioner,Brian Bingman,REP,100063,1,2,50,53,
Carter,Governor,Chris Powell,LIB,100063,0,0,3,3,
Carter,Governor,Rex Lawhorn,LIB,100063,0,0,0,0,
Carter,Corporation Commissioner,Ashley Nicole Mccray,DEM,100063,0,1,20,21,
Carter,Corporation Commissioner,Blake Cummings,DEM,100063,0,0,16,16,
Carter,U.S. House,Mary Brannon,DEM,100063,0,1,19,20,04
Carter,U.S. House,Fred Gipson,DEM,100063,0,0,17,17,04
Carter,Governor,Mick Cornett,REP,100071,1,0,16,17,
Carter,Governor,Kevin Stitt,REP,100071,0,0,44,44,
Carter,Lieutenant Governor,Dana Murphy,REP,100071,1,0,22,23,
Carter,Lieutenant Governor,Matt Pinnell,REP,100071,0,0,38,38,
Carter,State Auditor,Cindy Byrd,REP,100071,1,0,28,29,
Carter,State Auditor,Charlie Prater,REP,100071,0,0,31,31,
Carter,Attorney General,Mike Hunter,REP,100071,0,0,21,21,
Carter,Attorney General,Gentner Drummond,REP,100071,1,0,37,38,
Carter,Superintendent of Public Instruction,Joy Hofmeister,REP,100071,1,0,17,18,
Carter,Superintendent of Public Instruction,Linda Murphy,REP,100071,0,0,41,41,
Carter,Commissioner of Labor,Cathy Costello,REP,100071,1,0,23,24,
Carter,Commissioner of Labor,Leslie Osborn,REP,100071,0,0,34,34,
Carter,Corporation Commissioner,Bob Anthony,REP,100071,0,0,24,24,
Carter,Corporation Commissioner,Brian Bingman,REP,100071,1,0,35,36,
Carter,Governor,Chris Powell,LIB,100071,0,0,0,0,
Carter,Governor,Rex Lawhorn,LIB,100071,0,0,0,0,
Carter,Corporation Commissioner,Ashley Nicole Mccray,DEM,100071,2,0,24,26,
Carter,Corporation Commissioner,Blake Cummings,DEM,100071,1,0,19,20,
Carter,U.S. House,Mary Brannon,DEM,100071,2,0,23,25,04
Carter,U.S. House,Fred Gipson,DEM,100071,1,0,19,20,04
Cherokee,Governor,Mick Cornett,REP,110001,0,3,39,42,
Cherokee,Governor,Kevin Stitt,REP,110001,6,9,47,62,
Cherokee,Lieutenant Governor,Dana Murphy,REP,110001,2,1,30,33,
Cherokee,Lieutenant Governor,Matt Pinnell,REP,110001,4,11,52,67,
Cherokee,State Auditor,Cindy Byrd,REP,110001,4,5,39,48,
Cherokee,State Auditor,Charlie Prater,REP,110001,1,5,44,50,
Cherokee,Attorney General,Mike Hunter,REP,110001,4,3,40,47,
Cherokee,Attorney General,Gentner Drummond,REP,110001,1,7,43,51,
Cherokee,Superintendent of Public Instruction,Joy Hofmeister,REP,110001,2,6,48,56,
Cherokee,Superintendent of Public Instruction,Linda Murphy,REP,110001,3,6,35,44,
Cherokee,Commissioner of Labor,Cathy Costello,REP,110001,3,6,29,38,
Cherokee,Commissioner of Labor,Leslie Osborn,REP,110001,2,4,54,60,
Cherokee,Corporation Commissioner,Bob Anthony,REP,110001,6,4,28,38,
Cherokee,Corporation Commissioner,Brian Bingman,REP,110001,0,6,56,62,
Cherokee,Governor,Chris Powell,LIB,110001,0,0,1,1,
Cherokee,Governor,Rex Lawhorn,LIB,110001,0,0,1,1,
Cherokee,Corporation Commissioner,Ashley Nicole Mccray,DEM,110001,3,21,140,164,
Cherokee,Corporation Commissioner,Blake Cummings,DEM,110001,2,19,59,80,
Cherokee,U.S. House,Jason Nichols,DEM,110001,3,18,140,161,02
Cherokee,U.S. House,Clay Padgett,DEM,110001,3,24,69,96,02
Cherokee,Governor,Mick Cornett,REP,110002,2,19,83,104,
Cherokee,Governor,Kevin Stitt,REP,110002,5,27,110,142,
Cherokee,Lieutenant Governor,Dana Murphy,REP,110002,2,16,57,75,
Cherokee,Lieutenant Governor,Matt Pinnell,REP,110002,5,30,133,168,
Cherokee,State Auditor,Cindy Byrd,REP,110002,2,20,93,115,
Cherokee,State Auditor,Charlie Prater,REP,110002,5,25,90,120,
Cherokee,Attorney General,Mike Hunter,REP,110002,0,29,92,121,
Cherokee,Attorney General,Gentner Drummond,REP,110002,7,17,98,122,
Cherokee,Superintendent of Public Instruction,Joy Hofmeister,REP,110002,5,31,121,157,
Cherokee,Superintendent of Public Instruction,Linda Murphy,REP,110002,2,15,71,88,
Cherokee,Commissioner of Labor,Cathy Costello,REP,110002,2,12,79,93,
Cherokee,Commissioner of Labor,Leslie Osborn,REP,110002,5,34,108,147,
Cherokee,Corporation Commissioner,Bob Anthony,REP,110002,2,20,86,108,
Cherokee,Corporation Commissioner,Brian Bingman,REP,110002,5,26,102,133,
Cherokee,Governor,Chris Powell,LIB,110002,0,1,0,1,
Cherokee,Governor,Rex Lawhorn,LIB,110002,0,0,1,1,
Cherokee,Corporation Commissioner,Ashley Nicole Mccray,DEM,110002,57,73,181,311,
Cherokee,Corporation Commissioner,Blake Cummings,DEM,110002,28,31,111,170,
Cherokee,U.S. House,Jason Nichols,DEM,110002,59,59,212,330,02
Cherokee,U.S. House,Clay Padgett,DEM,110002,26,48,97,171,02
Cherokee,Governor,Mick Cornett,REP,110003,4,18,68,90,
Cherokee,Governor,Kevin Stitt,REP,110003,6,22,136,164,
Cherokee,Lieutenant Governor,Dana Murphy,REP,110003,2,17,64,83,
Cherokee,Lieutenant Governor,Matt Pinnell,REP,110003,8,22,135,165,
Cherokee,State Auditor,Cindy Byrd,REP,110003,5,14,90,109,
Cherokee,State Auditor,Charlie Prater,REP,110003,5,23,100,128,
Cherokee,Attorney General,Mike Hunter,REP,110003,5,17,100,122,
Cherokee,Attorney General,Gentner Drummond,REP,110003,5,22,98,125,
Cherokee,Superintendent of Public Instruction,Joy Hofmeister,REP,110003,3,16,111,130,
Cherokee,Superintendent of Public Instruction,Linda Murphy,REP,110003,7,23,80,110,
Cherokee,Commissioner of Labor,Cathy Costello,REP,110003,9,9,97,115,
Cherokee,Commissioner of Labor,Leslie Osborn,REP,110003,1,28,90,119,
Cherokee,Corporation Commissioner,Bob Anthony,REP,110003,1,21,115,137,
Cherokee,Corporation Commissioner,Brian Bingman,REP,110003,9,19,80,108,
Cherokee,Governor,Chris Powell,LIB,110003,0,0,1,1,
Cherokee,Governor,Rex Lawhorn,LIB,110003,0,0,0,0,
Cherokee,Corporation Commissioner,Ashley Nicole Mccray,DEM,110003,11,78,117,206,
Cherokee,Corporation Commissioner,Blake Cummings,DEM,110003,5,22,64,91,
Cherokee,U.S. House,Jason Nichols,DEM,110003,13,72,113,198,02
Cherokee,U.S. House,Clay Padgett,DEM,110003,3,30,72,105,02
Cherokee,Governor,Mick Cornett,REP,110004,1,10,52,63,
Cherokee,Governor,Kevin Stitt,REP,110004,7,27,58,92,
Cherokee,Lieutenant Governor,Dana Murphy,REP,110004,3,14,43,60,
Cherokee,Lieutenant Governor,Matt Pinnell,REP,110004,5,23,65,93,
Cherokee,State Auditor,Cindy Byrd,REP,110004,3,16,44,63,
Cherokee,State Auditor,Charlie Prater,REP,110004,5,20,63,88,
Cherokee,Attorney General,Mike Hunter,REP,110004,2,21,43,66,
Cherokee,Attorney General,Gentner Drummond,REP,110004,6,16,67,89,
Cherokee,Superintendent of Public Instruction,Joy Hofmeister,REP,110004,3,22,65,90,
Cherokee,Superintendent of Public Instruction,Linda Murphy,REP,110004,5,15,44,64,
Cherokee,Commissioner of Labor,Cathy Costello,REP,110004,7,21,47,75,
Cherokee,Commissioner of Labor,Leslie Osborn,REP,110004,1,16,62,79,
Cherokee,Corporation Commissioner,Bob Anthony,REP,110004,7,18,56,81,
Cherokee,Corporation Commissioner,Brian Bingman,REP,110004,1,19,52,72,
Cherokee,Governor,Chris Powell,LIB,110004,0,1,0,1,
Cherokee,Governor,Rex Lawhorn,LIB,110004,0,1,0,1,
Cherokee,Corporation Commissioner,Ashley Nicole Mccray,DEM,110004,7,63,140,210,
Cherokee,Corporation Commissioner,Blake Cummings,DEM,110004,1,26,86,113,
Cherokee,U.S. House,Jason Nichols,DEM,110004,8,58,155,221,02
Cherokee,U.S. House,Clay Padgett,DEM,110004,0,33,77,110,02
Cherokee,Governor,Mick Cornett,REP,110005,1,0,5,6,
Cherokee,Governor,Kevin Stitt,REP,110005,2,6,11,19,
Cherokee,Lieutenant Governor,Dana Murphy,REP,110005,2,1,4,7,
Cherokee,Lieutenant Governor,Matt Pinnell,REP,110005,1,5,12,18,
Cherokee,State Auditor,Cindy Byrd,REP,110005,3,5,4,12,
Cherokee,State Auditor,Charlie Prater,REP,110005,0,1,11,12,
Cherokee,Attorney General,Mike Hunter,REP,110005,3,4,3,10,
Cherokee,Attorney General,Gentner Drummond,REP,110005,0,2,13,15,
Cherokee,Superintendent of Public Instruction,Joy Hofmeister,REP,110005,3,2,9,14,
Cherokee,Superintendent of Public Instruction,Linda Murphy,REP,110005,0,4,7,11,
Cherokee,Commissioner of Labor,Cathy Costello,REP,110005,2,2,6,10,
Cherokee,Commissioner of Labor,Leslie Osborn,REP,110005,1,4,10,15,
Cherokee,Corporation Commissioner,Bob Anthony,REP,110005,2,2,5,9,
Cherokee,Corporation Commissioner,Brian Bingman,REP,110005,1,4,10,15,
Cherokee,Governor,Chris Powell,LIB,110005,0,0,0,0,
Cherokee,Governor,Rex Lawhorn,LIB,110005,0,0,0,0,
Cherokee,Corporation Commissioner,Ashley Nicole Mccray,DEM,110005,1,6,32,39,
Cherokee,Corporation Commissioner,Blake Cummings,DEM,110005,2,4,21,27,
Cherokee,U.S. House,Jason Nichols,DEM,110005,2,7,41,50,02
Cherokee,U.S. House,Clay Padgett,DEM,110005,1,3,13,17,02
Cherokee,Governor,Mick Cornett,REP,110006,1,2,19,22,
Cherokee,Governor,Kevin Stitt,REP,110006,0,4,30,34,
Cherokee,Lieutenant Governor,Dana Murphy,REP,110006,0,1,16,17,
Cherokee,Lieutenant Governor,Matt Pinnell,REP,110006,1,5,32,38,
Cherokee,State Auditor,Cindy Byrd,REP,110006,1,2,19,22,
Cherokee,State Auditor,Charlie Prater,REP,110006,0,4,30,34,
Cherokee,Attorney General,Mike Hunter,REP,110006,1,3,23,27,
Cherokee,Attorney General,Gentner Drummond,REP,110006,0,3,26,29,
Cherokee,Superintendent of Public Instruction,Joy Hofmeister,REP,110006,1,2,24,27,
Cherokee,Superintendent of Public Instruction,Linda Murphy,REP,110006,0,4,24,28,
Cherokee,Commissioner of Labor,Cathy Costello,REP,110006,0,2,21,23,
Cherokee,Commissioner of Labor,Leslie Osborn,REP,110006,1,4,27,32,
Cherokee,Corporation Commissioner,Bob Anthony,REP,110006,1,1,21,23,
Cherokee,Corporation Commissioner,Brian Bingman,REP,110006,0,5,28,33,
Cherokee,Governor,Chris Powell,LIB,110006,0,0,0,0,
Cherokee,Governor,Rex Lawhorn,LIB,110006,0,0,0,0,
Cherokee,Corporation Commissioner,Ashley Nicole Mccray,DEM,110006,15,20,65,100,
Cherokee,Corporation Commissioner,Blake Cummings,DEM,110006,13,15,71,99,
Cherokee,U.S. House,Jason Nichols,DEM,110006,16,19,79,114,02
Cherokee,U.S. House,Clay Padgett,DEM,110006,13,16,62,91,02
Cherokee,Governor,Mick Cornett,REP,110007,0,2,6,8,
Cherokee,Governor,Kevin Stitt,REP,110007,0,3,5,8,
Cherokee,Lieutenant Governor,Dana Murphy,REP,110007,0,1,3,4,
Cherokee,Lieutenant Governor,Matt Pinnell,REP,110007,0,4,8,12,
Cherokee,State Auditor,Cindy Byrd,REP,110007,0,1,3,4,
Cherokee,State Auditor,Charlie Prater,REP,110007,0,4,7,11,
Cherokee,Attorney General,Mike Hunter,REP,110007,0,2,5,7,
Cherokee,Attorney General,Gentner Drummond,REP,110007,0,3,5,8,
Cherokee,Superintendent of Public Instruction,Joy Hofmeister,REP,110007,0,5,5,10,
Cherokee,Superintendent of Public Instruction,Linda Murphy,REP,110007,0,0,6,6,
Cherokee,Commissioner of Labor,Cathy Costello,REP,110007,0,1,4,5,
Cherokee,Commissioner of Labor,Leslie Osborn,REP,110007,0,4,7,11,
Cherokee,Corporation Commissioner,Bob Anthony,REP,110007,0,5,3,8,
Cherokee,Corporation Commissioner,Brian Bingman,REP,110007,0,0,7,7,
Cherokee,Governor,Chris Powell,LIB,110007,0,0,0,0,
Cherokee,Governor,Rex Lawhorn,LIB,110007,0,0,0,0,
Cherokee,Corporation Commissioner,Ashley Nicole Mccray,DEM,110007,0,1,6,7,
Cherokee,Corporation Commissioner,Blake Cummings,DEM,110007,0,0,5,5,
Cherokee,U.S. House,Jason Nichols,DEM,110007,0,1,8,9,02
Cherokee,U.S. House,Clay Padgett,DEM,110007,0,0,4,4,02
Cherokee,Governor,Mick Cornett,REP,110008,0,0,12,12,
Cherokee,Governor,Kevin Stitt,REP,110008,0,4,29,33,
Cherokee,Lieutenant Governor,Dana Murphy,REP,110008,0,1,16,17,
Cherokee,Lieutenant Governor,Matt Pinnell,REP,110008,0,3,25,28,
Cherokee,State Auditor,Cindy Byrd,REP,110008,0,1,21,22,
Cherokee,State Auditor,Charlie Prater,REP,110008,0,3,19,22,
Cherokee,Attorney General,Mike Hunter,REP,110008,0,1,12,13,
Cherokee,Attorney General,Gentner Drummond,REP,110008,0,3,29,32,
Cherokee,Superintendent of Public Instruction,Joy Hofmeister,REP,110008,0,3,18,21,
Cherokee,Superintendent of Public Instruction,Linda Murphy,REP,110008,0,1,23,24,
Cherokee,Commissioner of Labor,Cathy Costello,REP,110008,0,1,25,26,
Cherokee,Commissioner of Labor,Leslie Osborn,REP,110008,0,3,15,18,
Cherokee,Corporation Commissioner,Bob Anthony,REP,110008,0,2,26,28,
Cherokee,Corporation Commissioner,Brian Bingman,REP,110008,0,2,14,16,
Cherokee,Governor,Chris Powell,LIB,110008,0,0,0,0,
Cherokee,Governor,Rex Lawhorn,LIB,110008,0,0,0,0,
Cherokee,Corporation Commissioner,Ashley Nicole Mccray,DEM,110008,2,12,46,60,
Cherokee,Corporation Commissioner,Blake Cummings,DEM,110008,1,5,17,23,
Cherokee,U.S. House,Jason Nichols,DEM,110008,3,9,53,65,02
Cherokee,U.S. House,Clay Padgett,DEM,110008,0,8,11,19,02
Cherokee,Governor,Mick Cornett,REP,110009,2,2,70,74,
Cherokee,Governor,Kevin Stitt,REP,110009,1,4,70,75,
Cherokee,Lieutenant Governor,Dana Murphy,REP,110009,3,5,60,68,
Cherokee,Lieutenant Governor,Matt Pinnell,REP,110009,0,1,79,80,
Cherokee,State Auditor,Cindy Byrd,REP,110009,3,2,48,53,
Cherokee,State Auditor,Charlie Prater,REP,110009,0,3,86,89,
Cherokee,Attorney General,Mike Hunter,REP,110009,2,3,59,64,
Cherokee,Attorney General,Gentner Drummond,REP,110009,1,3,80,84,
Cherokee,Superintendent of Public Instruction,Joy Hofmeister,REP,110009,2,2,84,88,
Cherokee,Superintendent of Public Instruction,Linda Murphy,REP,110009,1,4,55,60,
Cherokee,Commissioner of Labor,Cathy Costello,REP,110009,3,4,50,57,
Cherokee,Commissioner of Labor,Leslie Osborn,REP,110009,0,1,82,83,
Cherokee,Corporation Commissioner,Bob Anthony,REP,110009,2,4,64,70,
Cherokee,Corporation Commissioner,Brian Bingman,REP,110009,1,1,71,73,
Cherokee,Governor,Chris Powell,LIB,110009,0,0,0,0,
Cherokee,Governor,Rex Lawhorn,LIB,110009,0,0,2,2,
Cherokee,Corporation Commissioner,Ashley Nicole Mccray,DEM,110009,12,2,75,89,
Cherokee,Corporation Commissioner,Blake Cummings,DEM,110009,1,2,70,73,
Cherokee,U.S. House,Jason Nichols,DEM,110009,4,3,99,106,02
Cherokee,U.S. House,Clay Padgett,DEM,110009,9,1,47,57,02
Cherokee,Governor,Mick Cornett,REP,110010,0,8,49,57,
Cherokee,Governor,Kevin Stitt,REP,110010,0,6,94,100,
Cherokee,Lieutenant Governor,Dana Murphy,REP,110010,0,4,46,50,
Cherokee,Lieutenant Governor,Matt Pinnell,REP,110010,0,10,93,103,
Cherokee,State Auditor,Cindy Byrd,REP,110010,0,4,61,65,
Cherokee,State Auditor,Charlie Prater,REP,110010,0,10,78,88,
Cherokee,Attorney General,Mike Hunter,REP,110010,0,3,52,55,
Cherokee,Attorney General,Gentner Drummond,REP,110010,0,11,89,100,
Cherokee,Superintendent of Public Instruction,Joy Hofmeister,REP,110010,0,8,83,91,
Cherokee,Superintendent of Public Instruction,Linda Murphy,REP,110010,0,6,57,63,
Cherokee,Commissioner of Labor,Cathy Costello,REP,110010,0,3,65,68,
Cherokee,Commissioner of Labor,Leslie Osborn,REP,110010,0,11,77,88,
Cherokee,Corporation Commissioner,Bob Anthony,REP,110010,0,7,73,80,
Cherokee,Corporation Commissioner,Brian Bingman,REP,110010,0,7,66,73,
Cherokee,Governor,Chris Powell,LIB,110010,0,0,0,0,
Cherokee,Governor,Rex Lawhorn,LIB,110010,0,0,1,1,
Cherokee,Corporation Commissioner,Ashley Nicole Mccray,DEM,110010,52,29,228,309,
Cherokee,Corporation Commissioner,Blake Cummings,DEM,110010,28,23,218,269,
Cherokee,U.S. House,Jason Nichols,DEM,110010,42,35,261,338,02
Cherokee,U.S. House,Clay Padgett,DEM,110010,38,18,191,247,02
Cherokee,Governor,Mick Cornett,REP,110011,0,2,2,4,
Cherokee,Governor,Kevin Stitt,REP,110011,0,2,22,24,
Cherokee,Lieutenant Governor,Dana Murphy,REP,110011,0,1,8,9,
Cherokee,Lieutenant Governor,Matt Pinnell,REP,110011,0,3,16,19,
Cherokee,State Auditor,Cindy Byrd,REP,110011,0,3,9,12,
Cherokee,State Auditor,Charlie Prater,REP,110011,0,1,15,16,
Cherokee,Attorney General,Mike Hunter,REP,110011,0,1,10,11,
Cherokee,Attorney General,Gentner Drummond,REP,110011,0,3,14,17,
Cherokee,Superintendent of Public Instruction,Joy Hofmeister,REP,110011,0,2,5,7,
Cherokee,Superintendent of Public Instruction,Linda Murphy,REP,110011,0,2,18,20,
Cherokee,Commissioner of Labor,Cathy Costello,REP,110011,0,3,13,16,
Cherokee,Commissioner of Labor,Leslie Osborn,REP,110011,0,1,10,11,
Cherokee,Corporation Commissioner,Bob Anthony,REP,110011,0,3,11,14,
Cherokee,Corporation Commissioner,Brian Bingman,REP,110011,0,1,12,13,
Cherokee,Governor,Chris Powell,LIB,110011,0,0,1,1,
Cherokee,Governor,Rex Lawhorn,LIB,110011,0,0,0,0,
Cherokee,Corporation Commissioner,Ashley Nicole Mccray,DEM,110011,7,1,17,25,
Cherokee,Corporation Commissioner,Blake Cummings,DEM,110011,0,3,32,35,
Cherokee,U.S. House,Jason Nichols,DEM,110011,7,2,30,39,02
Cherokee,U.S. House,Clay Padgett,DEM,110011,0,2,19,21,02
Cherokee,Governor,Mick Cornett,REP,110012,0,5,42,47,
Cherokee,Governor,Kevin Stitt,REP,110012,1,7,59,67,
Cherokee,Lieutenant Governor,Dana Murphy,REP,110012,2,3,51,56,
Cherokee,Lieutenant Governor,Matt Pinnell,REP,110012,0,12,51,63,
Cherokee,State Auditor,Cindy Byrd,REP,110012,0,8,53,61,
Cherokee,State Auditor,Charlie Prater,REP,110012,2,4,46,52,
Cherokee,Attorney General,Mike Hunter,REP,110012,2,2,38,42,
Cherokee,Attorney General,Gentner Drummond,REP,110012,0,10,65,75,
Cherokee,Superintendent of Public Instruction,Joy Hofmeister,REP,110012,2,6,39,47,
Cherokee,Superintendent of Public Instruction,Linda Murphy,REP,110012,0,9,61,70,
Cherokee,Commissioner of Labor,Cathy Costello,REP,110012,2,4,40,46,
Cherokee,Commissioner of Labor,Leslie Osborn,REP,110012,0,8,58,66,
Cherokee,Corporation Commissioner,Bob Anthony,REP,110012,0,5,49,54,
Cherokee,Corporation Commissioner,Brian Bingman,REP,110012,2,7,52,61,
Cherokee,Governor,Chris Powell,LIB,110012,0,0,0,0,
Cherokee,Governor,Rex Lawhorn,LIB,110012,0,0,0,0,
Cherokee,Corporation Commissioner,Ashley Nicole Mccray,DEM,110012,3,29,76,108,
Cherokee,Corporation Commissioner,Blake Cummings,DEM,110012,0,10,67,77,
Cherokee,U.S. House,Jason Nichols,DEM,110012,4,26,98,128,02
Cherokee,U.S. House,Clay Padgett,DEM,110012,0,13,45,58,02
Cherokee,Governor,Mick Cornett,REP,110013,2,3,18,23,
Cherokee,Governor,Kevin Stitt,REP,110013,0,7,27,34,
Cherokee,Lieutenant Governor,Dana Murphy,REP,110013,2,2,13,17,
Cherokee,Lieutenant Governor,Matt Pinnell,REP,110013,0,8,32,40,
Cherokee,State Auditor,Cindy Byrd,REP,110013,2,4,29,35,
Cherokee,State Auditor,Charlie Prater,REP,110013,0,6,16,22,
Cherokee,Attorney General,Mike Hunter,REP,110013,2,3,27,32,
Cherokee,Attorney General,Gentner Drummond,REP,110013,0,7,17,24,
Cherokee,Superintendent of Public Instruction,Joy Hofmeister,REP,110013,2,5,20,27,
Cherokee,Superintendent of Public Instruction,Linda Murphy,REP,110013,0,4,25,29,
Cherokee,Commissioner of Labor,Cathy Costello,REP,110013,0,3,22,25,
Cherokee,Commissioner of Labor,Leslie Osborn,REP,110013,2,7,23,32,
Cherokee,Corporation Commissioner,Bob Anthony,REP,110013,2,6,16,24,
Cherokee,Corporation Commissioner,Brian Bingman,REP,110013,0,4,29,33,
Cherokee,Governor,Chris Powell,LIB,110013,0,0,0,0,
Cherokee,Governor,Rex Lawhorn,LIB,110013,0,0,0,0,
Cherokee,Corporation Commissioner,Ashley Nicole Mccray,DEM,110013,2,13,52,67,
Cherokee,Corporation Commissioner,Blake Cummings,DEM,110013,1,9,49,59,
Cherokee,U.S. House,Jason Nichols,DEM,110013,1,13,63,77,02
Cherokee,U.S. House,Clay Padgett,DEM,110013,2,9,38,49,02
Cherokee,Governor,Mick Cornett,REP,110014,2,2,34,38,
Cherokee,Governor,Kevin Stitt,REP,110014,3,1,79,83,
Cherokee,Lieutenant Governor,Dana Murphy,REP,110014,3,3,48,54,
Cherokee,Lieutenant Governor,Matt Pinnell,REP,110014,2,0,63,65,
Cherokee,State Auditor,Cindy Byrd,REP,110014,2,3,49,54,
Cherokee,State Auditor,Charlie Prater,REP,110014,2,0,59,61,
Cherokee,Attorney General,Mike Hunter,REP,110014,3,2,55,60,
Cherokee,Attorney General,Gentner Drummond,REP,110014,2,1,57,60,
Cherokee,Superintendent of Public Instruction,Joy Hofmeister,REP,110014,1,3,49,53,
Cherokee,Superintendent of Public Instruction,Linda Murphy,REP,110014,3,0,63,66,
Cherokee,Commissioner of Labor,Cathy Costello,REP,110014,5,3,61,69,
Cherokee,Commissioner of Labor,Leslie Osborn,REP,110014,1,0,51,52,
Cherokee,Corporation Commissioner,Bob Anthony,REP,110014,2,2,58,62,
Cherokee,Corporation Commissioner,Brian Bingman,REP,110014,3,1,53,57,
Cherokee,State House,George Faught,REP,110014,5,1,66,72,14
Cherokee,State House,Chris Sneed,REP,110014,1,2,47,50,14
Cherokee,Governor,Chris Powell,LIB,110014,0,0,0,0,
Cherokee,Governor,Rex Lawhorn,LIB,110014,0,0,0,0,
Cherokee,Corporation Commissioner,Ashley Nicole Mccray,DEM,110014,4,9,52,65,
Cherokee,Corporation Commissioner,Blake Cummings,DEM,110014,0,2,36,38,
Cherokee,U.S. House,Jason Nichols,DEM,110014,2,10,65,77,02
Cherokee,U.S. House,Clay Padgett,DEM,110014,2,1,23,26,02
Cherokee,Governor,Mick Cornett,REP,110015,1,4,55,60,
Cherokee,Governor,Kevin Stitt,REP,110015,5,5,109,119,
Cherokee,Lieutenant Governor,Dana Murphy,REP,110015,1,4,41,46,
Cherokee,Lieutenant Governor,Matt Pinnell,REP,110015,5,5,120,130,
Cherokee,State Auditor,Cindy Byrd,REP,110015,1,5,61,67,
Cherokee,State Auditor,Charlie Prater,REP,110015,5,4,94,103,
Cherokee,Attorney General,Mike Hunter,REP,110015,0,3,79,82,
Cherokee,Attorney General,Gentner Drummond,REP,110015,6,6,83,95,
Cherokee,Superintendent of Public Instruction,Joy Hofmeister,REP,110015,4,4,80,88,
Cherokee,Superintendent of Public Instruction,Linda Murphy,REP,110015,2,5,80,87,
Cherokee,Commissioner of Labor,Cathy Costello,REP,110015,1,5,84,90,
Cherokee,Commissioner of Labor,Leslie Osborn,REP,110015,5,4,73,82,
Cherokee,Corporation Commissioner,Bob Anthony,REP,110015,4,5,81,90,
Cherokee,Corporation Commissioner,Brian Bingman,REP,110015,2,4,79,85,
Cherokee,State House,George Faught,REP,110015,1,6,78,85,14
Cherokee,State House,Chris Sneed,REP,110015,5,3,88,96,14
Cherokee,Governor,Chris Powell,LIB,110015,0,0,0,0,
Cherokee,Governor,Rex Lawhorn,LIB,110015,0,0,1,1,
Cherokee,Corporation Commissioner,Ashley Nicole Mccray,DEM,110015,2,1,49,52,
Cherokee,Corporation Commissioner,Blake Cummings,DEM,110015,0,3,38,41,
Cherokee,U.S. House,Jason Nichols,DEM,110015,2,2,54,58,02
Cherokee,U.S. House,Clay Padgett,DEM,110015,0,2,33,35,02
Cherokee,Governor,Mick Cornett,REP,110016,0,1,9,10,
Cherokee,Governor,Kevin Stitt,REP,110016,3,0,23,26,
Cherokee,Lieutenant Governor,Dana Murphy,REP,110016,2,0,8,10,
Cherokee,Lieutenant Governor,Matt Pinnell,REP,110016,1,1,24,26,
Cherokee,State Auditor,Cindy Byrd,REP,110016,2,1,11,14,
Cherokee,State Auditor,Charlie Prater,REP,110016,1,0,21,22,
Cherokee,Attorney General,Mike Hunter,REP,110016,0,1,11,12,
Cherokee,Attorney General,Gentner Drummond,REP,110016,3,0,21,24,
Cherokee,Superintendent of Public Instruction,Joy Hofmeister,REP,110016,2,1,9,12,
Cherokee,Superintendent of Public Instruction,Linda Murphy,REP,110016,1,0,23,24,
Cherokee,Commissioner of Labor,Cathy Costello,REP,110016,3,1,16,20,
Cherokee,Commissioner of Labor,Leslie Osborn,REP,110016,0,0,16,16,
Cherokee,Corporation Commissioner,Bob Anthony,REP,110016,3,0,20,23,
Cherokee,Corporation Commissioner,Brian Bingman,REP,110016,0,1,12,13,
Cherokee,Governor,Chris Powell,LIB,110016,0,0,1,1,
Cherokee,Governor,Rex Lawhorn,LIB,110016,0,0,0,0,
Cherokee,Corporation Commissioner,Ashley Nicole Mccray,DEM,110016,1,1,28,30,
Cherokee,Corporation Commissioner,Blake Cummings,DEM,110016,0,1,26,27,
Cherokee,U.S. House,Jason Nichols,DEM,110016,0,1,31,32,02
Cherokee,U.S. House,Clay Padgett,DEM,110016,1,1,23,25,02
Cherokee,Governor,Mick Cornett,REP,110017,0,0,11,11,
Cherokee,Governor,Kevin Stitt,REP,110017,0,2,22,24,
Cherokee,Lieutenant Governor,Dana Murphy,REP,110017,0,0,9,9,
Cherokee,Lieutenant Governor,Matt Pinnell,REP,110017,0,2,24,26,
Cherokee,State Auditor,Cindy Byrd,REP,110017,0,0,17,17,
Cherokee,State Auditor,Charlie Prater,REP,110017,0,2,16,18,
Cherokee,Attorney General,Mike Hunter,REP,110017,0,0,15,15,
Cherokee,Attorney General,Gentner Drummond,REP,110017,0,2,19,21,
Cherokee,Superintendent of Public Instruction,Joy Hofmeister,REP,110017,0,0,20,20,
Cherokee,Superintendent of Public Instruction,Linda Murphy,REP,110017,0,2,14,16,
Cherokee,Commissioner of Labor,Cathy Costello,REP,110017,0,0,14,14,
Cherokee,Commissioner of Labor,Leslie Osborn,REP,110017,0,2,19,21,
Cherokee,Corporation Commissioner,Bob Anthony,REP,110017,0,0,13,13,
Cherokee,Corporation Commissioner,Brian Bingman,REP,110017,0,2,20,22,
Cherokee,Governor,Chris Powell,LIB,110017,0,0,0,0,
Cherokee,Governor,Rex Lawhorn,LIB,110017,0,0,0,0,
Cherokee,Corporation Commissioner,Ashley Nicole Mccray,DEM,110017,1,4,28,33,
Cherokee,Corporation Commissioner,Blake Cummings,DEM,110017,0,3,14,17,
Cherokee,U.S. House,Jason Nichols,DEM,110017,0,5,28,33,02
Cherokee,U.S. House,Clay Padgett,DEM,110017,1,2,14,17,02
Cherokee,Governor,Mick Cornett,REP,110018,0,0,6,6,
Cherokee,Governor,Kevin Stitt,REP,110018,0,1,23,24,
Cherokee,Lieutenant Governor,Dana Murphy,REP,110018,0,0,6,6,
Cherokee,Lieutenant Governor,Matt Pinnell,REP,110018,0,1,23,24,
Cherokee,State Auditor,Cindy Byrd,REP,110018,0,1,12,13,
Cherokee,State Auditor,Charlie Prater,REP,110018,0,0,17,17,
Cherokee,Attorney General,Mike Hunter,REP,110018,0,1,11,12,
Cherokee,Attorney General,Gentner Drummond,REP,110018,0,0,18,18,
Cherokee,Superintendent of Public Instruction,Joy Hofmeister,REP,110018,0,0,11,11,
Cherokee,Superintendent of Public Instruction,Linda Murphy,REP,110018,0,1,18,19,
Cherokee,Commissioner of Labor,Cathy Costello,REP,110018,0,1,13,14,
Cherokee,Commissioner of Labor,Leslie Osborn,REP,110018,0,0,16,16,
Cherokee,Corporation Commissioner,Bob Anthony,REP,110018,0,1,9,10,
Cherokee,Corporation Commissioner,Brian Bingman,REP,110018,0,0,20,20,
Cherokee,Governor,Chris Powell,LIB,110018,0,0,0,0,
Cherokee,Governor,Rex Lawhorn,LIB,110018,0,0,0,0,
Cherokee,Corporation Commissioner,Ashley Nicole Mccray,DEM,110018,0,0,6,6,
Cherokee,Corporation Commissioner,Blake Cummings,DEM,110018,2,3,14,19,
Cherokee,U.S. House,Jason Nichols,DEM,110018,2,2,11,15,02
Cherokee,U.S. House,Clay Padgett,DEM,110018,0,1,10,11,02
Cherokee,Governor,Mick Cornett,REP,110019,1,2,17,20,
Cherokee,Governor,Kevin Stitt,REP,110019,2,3,39,44,
Cherokee,Lieutenant Governor,Dana Murphy,REP,110019,2,1,20,23,
Cherokee,Lieutenant Governor,Matt Pinnell,REP,110019,1,4,35,40,
Cherokee,State Auditor,Cindy Byrd,REP,110019,2,2,19,23,
Cherokee,State Auditor,Charlie Prater,REP,110019,1,3,35,39,
Cherokee,Attorney General,Mike Hunter,REP,110019,2,1,18,21,
Cherokee,Attorney General,Gentner Drummond,REP,110019,1,4,38,43,
Cherokee,Superintendent of Public Instruction,Joy Hofmeister,REP,110019,0,3,36,39,
Cherokee,Superintendent of Public Instruction,Linda Murphy,REP,110019,3,2,18,23,
Cherokee,Commissioner of Labor,Cathy Costello,REP,110019,2,1,18,21,
Cherokee,Commissioner of Labor,Leslie Osborn,REP,110019,1,4,36,41,
Cherokee,Corporation Commissioner,Bob Anthony,REP,110019,0,2,22,24,
Cherokee,Corporation Commissioner,Brian Bingman,REP,110019,3,3,33,39,
Cherokee,Governor,Chris Powell,LIB,110019,0,0,0,0,
Cherokee,Governor,Rex Lawhorn,LIB,110019,0,0,0,0,
Cherokee,Corporation Commissioner,Ashley Nicole Mccray,DEM,110019,1,7,43,51,
Cherokee,Corporation Commissioner,Blake Cummings,DEM,110019,2,3,34,39,
Cherokee,U.S. House,Jason Nichols,DEM,110019,0,7,54,61,02
Cherokee,U.S. House,Clay Padgett,DEM,110019,3,3,23,29,02
Cherokee,Governor,Mick Cornett,REP,110020,5,8,34,47,
Cherokee,Governor,Kevin Stitt,REP,110020,3,11,55,69,
Cherokee,Lieutenant Governor,Dana Murphy,REP,110020,1,12,28,41,
Cherokee,Lieutenant Governor,Matt Pinnell,REP,110020,7,7,61,75,
Cherokee,State Auditor,Cindy Byrd,REP,110020,3,12,52,67,
Cherokee,State Auditor,Charlie Prater,REP,110020,5,7,33,45,
Cherokee,Attorney General,Mike Hunter,REP,110020,3,8,44,55,
Cherokee,Attorney General,Gentner Drummond,REP,110020,5,10,43,58,
Cherokee,Superintendent of Public Instruction,Joy Hofmeister,REP,110020,6,13,48,67,
Cherokee,Superintendent of Public Instruction,Linda Murphy,REP,110020,2,6,43,51,
Cherokee,Commissioner of Labor,Cathy Costello,REP,110020,6,13,40,59,
Cherokee,Commissioner of Labor,Leslie Osborn,REP,110020,2,6,43,51,
Cherokee,Corporation Commissioner,Bob Anthony,REP,110020,6,11,33,50,
Cherokee,Corporation Commissioner,Brian Bingman,REP,110020,2,8,47,57,
Cherokee,Governor,Chris Powell,LIB,110020,0,0,0,0,
Cherokee,Governor,Rex Lawhorn,LIB,110020,0,0,0,0,
Cherokee,Corporation Commissioner,Ashley Nicole Mccray,DEM,110020,19,34,103,156,
Cherokee,Corporation Commissioner,Blake Cummings,DEM,110020,5,26,69,100,
Cherokee,U.S. House,Jason Nichols,DEM,110020,14,43,127,184,02
Cherokee,U.S. House,Clay Padgett,DEM,110020,9,19,57,85,02
Cherokee,Governor,Mick Cornett,REP,110021,0,3,11,14,
Cherokee,Governor,Kevin Stitt,REP,110021,0,1,34,35,
Cherokee,Lieutenant Governor,Dana Murphy,REP,110021,0,0,15,15,
Cherokee,Lieutenant Governor,Matt Pinnell,REP,110021,0,4,29,33,
Cherokee,State Auditor,Cindy Byrd,REP,110021,0,2,17,19,
Cherokee,State Auditor,Charlie Prater,REP,110021,0,2,25,27,
Cherokee,Attorney General,Mike Hunter,REP,110021,0,2,21,23,
Cherokee,Attorney General,Gentner Drummond,REP,110021,0,2,24,26,
Cherokee,Superintendent of Public Instruction,Joy Hofmeister,REP,110021,0,3,26,29,
Cherokee,Superintendent of Public Instruction,Linda Murphy,REP,110021,0,1,19,20,
Cherokee,Commissioner of Labor,Cathy Costello,REP,110021,0,1,21,22,
Cherokee,Commissioner of Labor,Leslie Osborn,REP,110021,0,3,22,25,
Cherokee,Corporation Commissioner,Bob Anthony,REP,110021,0,2,21,23,
Cherokee,Corporation Commissioner,Brian Bingman,REP,110021,0,2,21,23,
Cherokee,Governor,Chris Powell,LIB,110021,0,0,0,0,
Cherokee,Governor,Rex Lawhorn,LIB,110021,0,0,0,0,
Cherokee,Corporation Commissioner,Ashley Nicole Mccray,DEM,110021,5,2,66,73,
Cherokee,Corporation Commissioner,Blake Cummings,DEM,110021,3,3,53,59,
Cherokee,U.S. House,Jason Nichols,DEM,110021,3,4,76,83,02
Cherokee,U.S. House,Clay Padgett,DEM,110021,5,2,47,54,02
Cherokee,Governor,Mick Cornett,REP,110022,0,1,11,12,
Cherokee,Governor,Kevin Stitt,REP,110022,0,0,17,17,
Cherokee,Lieutenant Governor,Dana Murphy,REP,110022,0,1,7,8,
Cherokee,Lieutenant Governor,Matt Pinnell,REP,110022,0,0,21,21,
Cherokee,State Auditor,Cindy Byrd,REP,110022,0,1,13,14,
Cherokee,State Auditor,Charlie Prater,REP,110022,0,0,15,15,
Cherokee,Attorney General,Mike Hunter,REP,110022,0,1,16,17,
Cherokee,Attorney General,Gentner Drummond,REP,110022,0,0,12,12,
Cherokee,Superintendent of Public Instruction,Joy Hofmeister,REP,110022,0,0,9,9,
Cherokee,Superintendent of Public Instruction,Linda Murphy,REP,110022,0,1,19,20,
Cherokee,Commissioner of Labor,Cathy Costello,REP,110022,0,0,11,11,
Cherokee,Commissioner of Labor,Leslie Osborn,REP,110022,0,1,17,18,
Cherokee,Corporation Commissioner,Bob Anthony,REP,110022,0,1,10,11,
Cherokee,Corporation Commissioner,Brian Bingman,REP,110022,0,0,18,18,
Cherokee,Governor,Chris Powell,LIB,110022,0,0,0,0,
Cherokee,Governor,Rex Lawhorn,LIB,110022,0,0,0,0,
Cherokee,Corporation Commissioner,Ashley Nicole Mccray,DEM,110022,19,9,38,66,
Cherokee,Corporation Commissioner,Blake Cummings,DEM,110022,6,1,42,49,
Cherokee,U.S. House,Jason Nichols,DEM,110022,17,5,56,78,02
Cherokee,U.S. House,Clay Padgett,DEM,110022,8,5,31,44,02
Cherokee,Governor,Mick Cornett,REP,110023,0,1,4,5,
Cherokee,Governor,Kevin Stitt,REP,110023,0,4,21,25,
Cherokee,Lieutenant Governor,Dana Murphy,REP,110023,0,3,6,9,
Cherokee,Lieutenant Governor,Matt Pinnell,REP,110023,0,2,19,21,
Cherokee,State Auditor,Cindy Byrd,REP,110023,0,3,11,14,
Cherokee,State Auditor,Charlie Prater,REP,110023,0,2,13,15,
Cherokee,Attorney General,Mike Hunter,REP,110023,0,4,6,10,
Cherokee,Attorney General,Gentner Drummond,REP,110023,0,1,17,18,
Cherokee,Superintendent of Public Instruction,Joy Hofmeister,REP,110023,0,3,10,13,
Cherokee,Superintendent of Public Instruction,Linda Murphy,REP,110023,0,2,15,17,
Cherokee,Commissioner of Labor,Cathy Costello,REP,110023,0,2,14,16,
Cherokee,Commissioner of Labor,Leslie Osborn,REP,110023,0,3,11,14,
Cherokee,Corporation Commissioner,Bob Anthony,REP,110023,0,1,7,8,
Cherokee,Corporation Commissioner,Brian Bingman,REP,110023,0,4,18,22,
Cherokee,Governor,Chris Powell,LIB,110023,0,0,0,0,
Cherokee,Governor,Rex Lawhorn,LIB,110023,0,0,0,0,
Cherokee,Corporation Commissioner,Ashley Nicole Mccray,DEM,110023,0,5,27,32,
Cherokee,Corporation Commissioner,Blake Cummings,DEM,110023,0,3,9,12,
Cherokee,U.S. House,Jason Nichols,DEM,110023,0,7,25,32,02
Cherokee,U.S. House,Clay Padgett,DEM,110023,0,2,11,13,02
Cherokee,Governor,Mick Cornett,REP,110025,0,4,7,11,
Cherokee,Governor,Kevin Stitt,REP,110025,0,6,31,37,
Cherokee,Lieutenant Governor,Dana Murphy,REP,110025,0,1,10,11,
Cherokee,Lieutenant Governor,Matt Pinnell,REP,110025,0,9,28,37,
Cherokee,State Auditor,Cindy Byrd,REP,110025,0,3,16,19,
Cherokee,State Auditor,Charlie Prater,REP,110025,0,7,22,29,
Cherokee,Attorney General,Mike Hunter,REP,110025,0,1,15,16,
Cherokee,Attorney General,Gentner Drummond,REP,110025,0,9,21,30,
Cherokee,Superintendent of Public Instruction,Joy Hofmeister,REP,110025,0,5,25,30,
Cherokee,Superintendent of Public Instruction,Linda Murphy,REP,110025,0,5,13,18,
Cherokee,Commissioner of Labor,Cathy Costello,REP,110025,0,5,13,18,
Cherokee,Commissioner of Labor,Leslie Osborn,REP,110025,0,5,24,29,
Cherokee,Corporation Commissioner,Bob Anthony,REP,110025,0,3,16,19,
Cherokee,Corporation Commissioner,Brian Bingman,REP,110025,0,6,22,28,
Cherokee,Governor,Chris Powell,LIB,110025,0,0,0,0,
Cherokee,Governor,Rex Lawhorn,LIB,110025,0,0,0,0,
Cherokee,Corporation Commissioner,Ashley Nicole Mccray,DEM,110025,4,21,50,75,
Cherokee,Corporation Commissioner,Blake Cummings,DEM,110025,0,8,39,47,
Cherokee,U.S. House,Jason Nichols,DEM,110025,3,15,59,77,02
Cherokee,U.S. House,Clay Padgett,DEM,110025,1,14,32,47,02
Choctaw,Governor,Mick Cornett,REP,120101,0,0,10,10,
Choctaw,Governor,Kevin Stitt,REP,120101,1,4,36,41,
Choctaw,Lieutenant Governor,Dana Murphy,REP,120101,0,0,17,17,
Choctaw,Lieutenant Governor,Matt Pinnell,REP,120101,1,4,28,33,
Choctaw,State Auditor,Cindy Byrd,REP,120101,1,4,29,34,
Choctaw,State Auditor,Charlie Prater,REP,120101,0,0,14,14,
Choctaw,Attorney General,Mike Hunter,REP,120101,0,2,29,31,
Choctaw,Attorney General,Gentner Drummond,REP,120101,1,2,18,21,
Choctaw,Superintendent of Public Instruction,Joy Hofmeister,REP,120101,0,0,26,26,
Choctaw,Superintendent of Public Instruction,Linda Murphy,REP,120101,1,4,20,25,
Choctaw,Commissioner of Labor,Cathy Costello,REP,120101,1,4,31,36,
Choctaw,Commissioner of Labor,Leslie Osborn,REP,120101,0,0,15,15,
Choctaw,Corporation Commissioner,Bob Anthony,REP,120101,1,4,32,37,
Choctaw,Corporation Commissioner,Brian Bingman,REP,120101,0,0,14,14,
Choctaw,Governor,Chris Powell,LIB,120101,0,0,0,0,
Choctaw,Governor,Rex Lawhorn,LIB,120101,0,0,0,0,
Choctaw,Corporation Commissioner,Ashley Nicole Mccray,DEM,120101,1,3,16,20,
Choctaw,Corporation Commissioner,Blake Cummings,DEM,120101,0,2,30,32,
Choctaw,U.S. House,Jason Nichols,DEM,120101,0,2,12,14,02
Choctaw,U.S. House,Clay Padgett,DEM,120101,1,3,35,39,02
Choctaw,Governor,Mick Cornett,REP,120104,0,1,10,11,
Choctaw,Governor,Kevin Stitt,REP,120104,0,3,13,16,
Choctaw,Lieutenant Governor,Dana Murphy,REP,120104,0,1,5,6,
Choctaw,Lieutenant Governor,Matt Pinnell,REP,120104,0,3,18,21,
Choctaw,State Auditor,Cindy Byrd,REP,120104,0,3,13,16,
Choctaw,State Auditor,Charlie Prater,REP,120104,0,1,10,11,
Choctaw,Attorney General,Mike Hunter,REP,120104,0,2,8,10,
Choctaw,Attorney General,Gentner Drummond,REP,120104,0,2,15,17,
Choctaw,Superintendent of Public Instruction,Joy Hofmeister,REP,120104,0,1,4,5,
Choctaw,Superintendent of Public Instruction,Linda Murphy,REP,120104,0,3,17,20,
Choctaw,Commissioner of Labor,Cathy Costello,REP,120104,0,2,12,14,
Choctaw,Commissioner of Labor,Leslie Osborn,REP,120104,0,2,11,13,
Choctaw,Corporation Commissioner,Bob Anthony,REP,120104,0,3,10,13,
Choctaw,Corporation Commissioner,Brian Bingman,REP,120104,0,1,11,12,
Choctaw,Governor,Chris Powell,LIB,120104,0,0,0,0,
Choctaw,Governor,Rex Lawhorn,LIB,120104,0,0,0,0,
Choctaw,Corporation Commissioner,Ashley Nicole Mccray,DEM,120104,0,1,36,37,
Choctaw,Corporation Commissioner,Blake Cummings,DEM,120104,3,4,47,54,
Choctaw,U.S. House,Jason Nichols,DEM,120104,0,2,8,10,02
Choctaw,U.S. House,Clay Padgett,DEM,120104,3,5,85,93,02
Choctaw,Governor,Mick Cornett,REP,120105,0,0,1,1,
Choctaw,Governor,Kevin Stitt,REP,120105,0,0,2,2,
Choctaw,Lieutenant Governor,Dana Murphy,REP,120105,0,0,1,1,
Choctaw,Lieutenant Governor,Matt Pinnell,REP,120105,0,0,2,2,
Choctaw,State Auditor,Cindy Byrd,REP,120105,0,0,2,2,
Choctaw,State Auditor,Charlie Prater,REP,120105,0,0,1,1,
Choctaw,Attorney General,Mike Hunter,REP,120105,0,0,2,2,
Choctaw,Attorney General,Gentner Drummond,REP,120105,0,0,1,1,
Choctaw,Superintendent of Public Instruction,Joy Hofmeister,REP,120105,0,0,1,1,
Choctaw,Superintendent of Public Instruction,Linda Murphy,REP,120105,0,0,2,2,
Choctaw,Commissioner of Labor,Cathy Costello,REP,120105,0,0,1,1,
Choctaw,Commissioner of Labor,Leslie Osborn,REP,120105,0,0,2,2,
Choctaw,Corporation Commissioner,Bob Anthony,REP,120105,0,0,1,1,
Choctaw,Corporation Commissioner,Brian Bingman,REP,120105,0,0,2,2,
Choctaw,Governor,Chris Powell,LIB,120105,0,0,0,0,
Choctaw,Governor,Rex Lawhorn,LIB,120105,0,0,0,0,
Choctaw,Corporation Commissioner,Ashley Nicole Mccray,DEM,120105,0,2,9,11,
Choctaw,Corporation Commissioner,Blake Cummings,DEM,120105,0,0,5,5,
Choctaw,U.S. House,Jason Nichols,DEM,120105,0,0,9,9,02
Choctaw,U.S. House,Clay Padgett,DEM,120105,0,2,5,7,02
Choctaw,Governor,Mick Cornett,REP,120106,0,0,2,2,
Choctaw,Governor,Kevin Stitt,REP,120106,1,0,11,12,
Choctaw,Lieutenant Governor,Dana Murphy,REP,120106,1,0,4,5,
Choctaw,Lieutenant Governor,Matt Pinnell,REP,120106,0,0,9,9,
Choctaw,State Auditor,Cindy Byrd,REP,120106,0,0,5,5,
Choctaw,State Auditor,Charlie Prater,REP,120106,1,0,8,9,
Choctaw,Attorney General,Mike Hunter,REP,120106,0,0,5,5,
Choctaw,Attorney General,Gentner Drummond,REP,120106,1,0,8,9,
Choctaw,Superintendent of Public Instruction,Joy Hofmeister,REP,120106,1,0,7,8,
Choctaw,Superintendent of Public Instruction,Linda Murphy,REP,120106,0,0,6,6,
Choctaw,Commissioner of Labor,Cathy Costello,REP,120106,1,0,9,10,
Choctaw,Commissioner of Labor,Leslie Osborn,REP,120106,0,0,4,4,
Choctaw,Corporation Commissioner,Bob Anthony,REP,120106,1,0,7,8,
Choctaw,Corporation Commissioner,Brian Bingman,REP,120106,0,0,6,6,
Choctaw,Governor,Chris Powell,LIB,120106,0,0,0,0,
Choctaw,Governor,Rex Lawhorn,LIB,120106,0,0,0,0,
Choctaw,Corporation Commissioner,Ashley Nicole Mccray,DEM,120106,2,0,7,9,
Choctaw,Corporation Commissioner,Blake Cummings,DEM,120106,2,0,7,9,
Choctaw,U.S. House,Jason Nichols,DEM,120106,0,0,4,4,02
Choctaw,U.S. House,Clay Padgett,DEM,120106,4,0,10,14,02
Choctaw,Governor,Mick Cornett,REP,120207,0,0,2,2,
Choctaw,Governor,Kevin Stitt,REP,120207,0,0,1,1,
Choctaw,Lieutenant Governor,Dana Murphy,REP,120207,0,0,1,1,
Choctaw,Lieutenant Governor,Matt Pinnell,REP,120207,0,0,2,2,
Choctaw,State Auditor,Cindy Byrd,REP,120207,0,0,2,2,
Choctaw,State Auditor,Charlie Prater,REP,120207,0,0,1,1,
Choctaw,Attorney General,Mike Hunter,REP,120207,0,0,2,2,
Choctaw,Attorney General,Gentner Drummond,REP,120207,0,0,1,1,
Choctaw,Superintendent of Public Instruction,Joy Hofmeister,REP,120207,0,0,2,2,
Choctaw,Superintendent of Public Instruction,Linda Murphy,REP,120207,0,0,1,1,
Choctaw,Commissioner of Labor,Cathy Costello,REP,120207,0,0,2,2,
Choctaw,Commissioner of Labor,Leslie Osborn,REP,120207,0,0,1,1,
Choctaw,Corporation Commissioner,Bob Anthony,REP,120207,0,0,2,2,
Choctaw,Corporation Commissioner,Brian Bingman,REP,120207,0,0,1,1,
Choctaw,Governor,Chris Powell,LIB,120207,0,0,0,0,
Choctaw,Governor,Rex Lawhorn,LIB,120207,0,0,0,0,
Choctaw,Corporation Commissioner,Ashley Nicole Mccray,DEM,120207,0,0,4,4,
Choctaw,Corporation Commissioner,Blake Cummings,DEM,120207,0,0,2,2,
Choctaw,U.S. House,Jason Nichols,DEM,120207,0,0,3,3,02
Choctaw,U.S. House,Clay Padgett,DEM,120207,0,0,3,3,02
Choctaw,Governor,Mick Cornett,REP,120208,0,1,6,7,
Choctaw,Governor,Kevin Stitt,REP,120208,1,4,21,26,
Choctaw,Lieutenant Governor,Dana Murphy,REP,120208,1,2,12,15,
Choctaw,Lieutenant Governor,Matt Pinnell,REP,120208,0,3,14,17,
Choctaw,State Auditor,Cindy Byrd,REP,120208,1,2,13,16,
Choctaw,State Auditor,Charlie Prater,REP,120208,0,3,11,14,
Choctaw,Attorney General,Mike Hunter,REP,120208,1,0,7,8,
Choctaw,Attorney General,Gentner Drummond,REP,120208,0,5,18,23,
Choctaw,Superintendent of Public Instruction,Joy Hofmeister,REP,120208,0,1,11,12,
Choctaw,Superintendent of Public Instruction,Linda Murphy,REP,120208,1,4,13,18,
Choctaw,Commissioner of Labor,Cathy Costello,REP,120208,0,4,14,18,
Choctaw,Commissioner of Labor,Leslie Osborn,REP,120208,1,1,10,12,
Choctaw,Corporation Commissioner,Bob Anthony,REP,120208,1,4,9,14,
Choctaw,Corporation Commissioner,Brian Bingman,REP,120208,0,1,15,16,
Choctaw,Governor,Chris Powell,LIB,120208,0,0,0,0,
Choctaw,Governor,Rex Lawhorn,LIB,120208,0,0,0,0,
Choctaw,Corporation Commissioner,Ashley Nicole Mccray,DEM,120208,0,5,10,15,
Choctaw,Corporation Commissioner,Blake Cummings,DEM,120208,0,7,10,17,
Choctaw,U.S. House,Jason Nichols,DEM,120208,0,6,7,13,02
Choctaw,U.S. House,Clay Padgett,DEM,120208,0,6,15,21,02
Choctaw,Governor,Mick Cornett,REP,120209,0,0,1,1,
Choctaw,Governor,Kevin Stitt,REP,120209,0,0,10,10,
Choctaw,Lieutenant Governor,Dana Murphy,REP,120209,0,0,3,3,
Choctaw,Lieutenant Governor,Matt Pinnell,REP,120209,0,0,8,8,
Choctaw,State Auditor,Cindy Byrd,REP,120209,0,0,4,4,
Choctaw,State Auditor,Charlie Prater,REP,120209,0,0,7,7,
Choctaw,Attorney General,Mike Hunter,REP,120209,0,0,3,3,
Choctaw,Attorney General,Gentner Drummond,REP,120209,0,0,8,8,
Choctaw,Superintendent of Public Instruction,Joy Hofmeister,REP,120209,0,0,2,2,
Choctaw,Superintendent of Public Instruction,Linda Murphy,REP,120209,0,0,8,8,
Choctaw,Commissioner of Labor,Cathy Costello,REP,120209,0,0,6,6,
Choctaw,Commissioner of Labor,Leslie Osborn,REP,120209,0,0,5,5,
Choctaw,Corporation Commissioner,Bob Anthony,REP,120209,0,0,7,7,
Choctaw,Corporation Commissioner,Brian Bingman,REP,120209,0,0,2,2,
Choctaw,Governor,Chris Powell,LIB,120209,0,0,0,0,
Choctaw,Governor,Rex Lawhorn,LIB,120209,0,0,0,0,
Choctaw,Corporation Commissioner,Ashley Nicole Mccray,DEM,120209,0,0,1,1,
Choctaw,Corporation Commissioner,Blake Cummings,DEM,120209,0,1,1,2,
Choctaw,U.S. House,Jason Nichols,DEM,120209,0,0,2,2,02
Choctaw,U.S. House,Clay Padgett,DEM,120209,0,1,0,1,02
Choctaw,Governor,Mick Cornett,REP,120210,1,2,7,10,
Choctaw,Governor,Kevin Stitt,REP,120210,1,5,32,38,
Choctaw,Lieutenant Governor,Dana Murphy,REP,120210,1,1,10,12,
Choctaw,Lieutenant Governor,Matt Pinnell,REP,120210,1,6,28,35,
Choctaw,State Auditor,Cindy Byrd,REP,120210,1,5,23,29,
Choctaw,State Auditor,Charlie Prater,REP,120210,1,2,14,17,
Choctaw,Attorney General,Mike Hunter,REP,120210,1,5,17,23,
Choctaw,Attorney General,Gentner Drummond,REP,120210,1,2,22,25,
Choctaw,Superintendent of Public Instruction,Joy Hofmeister,REP,120210,1,1,12,14,
Choctaw,Superintendent of Public Instruction,Linda Murphy,REP,120210,1,6,25,32,
Choctaw,Commissioner of Labor,Cathy Costello,REP,120210,1,4,21,26,
Choctaw,Commissioner of Labor,Leslie Osborn,REP,120210,1,3,16,20,
Choctaw,Corporation Commissioner,Bob Anthony,REP,120210,2,3,25,30,
Choctaw,Corporation Commissioner,Brian Bingman,REP,120210,0,4,10,14,
Choctaw,Governor,Chris Powell,LIB,120210,0,0,0,0,
Choctaw,Governor,Rex Lawhorn,LIB,120210,0,0,0,0,
Choctaw,Corporation Commissioner,Ashley Nicole Mccray,DEM,120210,3,4,13,20,
Choctaw,Corporation Commissioner,Blake Cummings,DEM,120210,0,2,10,12,
Choctaw,U.S. House,Jason Nichols,DEM,120210,3,1,9,13,02
Choctaw,U.S. House,Clay Padgett,DEM,120210,0,5,15,20,02
Choctaw,Governor,Mick Cornett,REP,120211,0,0,1,1,
Choctaw,Governor,Kevin Stitt,REP,120211,1,0,0,1,
Choctaw,Lieutenant Governor,Dana Murphy,REP,120211,0,0,1,1,
Choctaw,Lieutenant Governor,Matt Pinnell,REP,120211,1,0,0,1,
Choctaw,State Auditor,Cindy Byrd,REP,120211,1,0,1,2,
Choctaw,State Auditor,Charlie Prater,REP,120211,0,0,0,0,
Choctaw,Attorney General,Mike Hunter,REP,120211,1,0,0,1,
Choctaw,Attorney General,Gentner Drummond,REP,120211,0,0,1,1,
Choctaw,Superintendent of Public Instruction,Joy Hofmeister,REP,120211,0,0,1,1,
Choctaw,Superintendent of Public Instruction,Linda Murphy,REP,120211,1,0,0,1,
Choctaw,Commissioner of Labor,Cathy Costello,REP,120211,0,0,0,0,
Choctaw,Commissioner of Labor,Leslie Osborn,REP,120211,1,0,1,2,
Choctaw,Corporation Commissioner,Bob Anthony,REP,120211,1,0,1,2,
Choctaw,Corporation Commissioner,Brian Bingman,REP,120211,0,0,0,0,
Choctaw,Governor,Chris Powell,LIB,120211,0,0,0,0,
Choctaw,Governor,Rex Lawhorn,LIB,120211,0,0,0,0,
Choctaw,Corporation Commissioner,Ashley Nicole Mccray,DEM,120211,0,0,6,6,
Choctaw,Corporation Commissioner,Blake Cummings,DEM,120211,0,1,2,3,
Choctaw,U.S. House,Jason Nichols,DEM,120211,0,1,3,4,02
Choctaw,U.S. House,Clay Padgett,DEM,120211,0,0,5,5,02
Choctaw,Governor,Mick Cornett,REP,120214,0,0,3,3,
Choctaw,Governor,Kevin Stitt,REP,120214,0,0,9,9,
Choctaw,Lieutenant Governor,Dana Murphy,REP,120214,0,0,4,4,
Choctaw,Lieutenant Governor,Matt Pinnell,REP,120214,0,0,8,8,
Choctaw,State Auditor,Cindy Byrd,REP,120214,0,0,6,6,
Choctaw,State Auditor,Charlie Prater,REP,120214,0,0,6,6,
Choctaw,Attorney General,Mike Hunter,REP,120214,0,0,7,7,
Choctaw,Attorney General,Gentner Drummond,REP,120214,0,0,5,5,
Choctaw,Superintendent of Public Instruction,Joy Hofmeister,REP,120214,0,0,4,4,
Choctaw,Superintendent of Public Instruction,Linda Murphy,REP,120214,0,0,8,8,
Choctaw,Commissioner of Labor,Cathy Costello,REP,120214,0,0,6,6,
Choctaw,Commissioner of Labor,Leslie Osborn,REP,120214,0,0,6,6,
Choctaw,Corporation Commissioner,Bob Anthony,REP,120214,0,0,3,3,
Choctaw,Corporation Commissioner,Brian Bingman,REP,120214,0,0,9,9,
Choctaw,Governor,Chris Powell,LIB,120214,0,0,0,0,
Choctaw,Governor,Rex Lawhorn,LIB,120214,0,0,0,0,
Choctaw,Corporation Commissioner,Ashley Nicole Mccray,DEM,120214,0,2,13,15,
Choctaw,Corporation Commissioner,Blake Cummings,DEM,120214,1,2,9,12,
Choctaw,U.S. House,Jason Nichols,DEM,120214,0,3,9,12,02
Choctaw,U.S. House,Clay Padgett,DEM,120214,1,1,13,15,02
Choctaw,Governor,Mick Cornett,REP,120215,0,0,3,3,
Choctaw,Governor,Kevin Stitt,REP,120215,2,3,6,11,
Choctaw,Lieutenant Governor,Dana Murphy,REP,120215,2,2,3,7,
Choctaw,Lieutenant Governor,Matt Pinnell,REP,120215,0,1,6,7,
Choctaw,State Auditor,Cindy Byrd,REP,120215,2,2,3,7,
Choctaw,State Auditor,Charlie Prater,REP,120215,0,1,6,7,
Choctaw,Attorney General,Mike Hunter,REP,120215,2,0,6,8,
Choctaw,Attorney General,Gentner Drummond,REP,120215,0,3,4,7,
Choctaw,Superintendent of Public Instruction,Joy Hofmeister,REP,120215,0,2,5,7,
Choctaw,Superintendent of Public Instruction,Linda Murphy,REP,120215,2,1,4,7,
Choctaw,Commissioner of Labor,Cathy Costello,REP,120215,2,3,4,9,
Choctaw,Commissioner of Labor,Leslie Osborn,REP,120215,0,0,4,4,
Choctaw,Corporation Commissioner,Bob Anthony,REP,120215,1,1,2,4,
Choctaw,Corporation Commissioner,Brian Bingman,REP,120215,1,1,5,7,
Choctaw,Governor,Chris Powell,LIB,120215,0,0,0,0,
Choctaw,Governor,Rex Lawhorn,LIB,120215,0,0,0,0,
Choctaw,Corporation Commissioner,Ashley Nicole Mccray,DEM,120215,0,3,10,13,
Choctaw,Corporation Commissioner,Blake Cummings,DEM,120215,0,3,4,7,
Choctaw,U.S. House,Jason Nichols,DEM,120215,0,5,7,12,02
Choctaw,U.S. House,Clay Padgett,DEM,120215,0,1,7,8,02
Choctaw,Governor,Mick Cornett,REP,120316,0,1,6,7,
Choctaw,Governor,Kevin Stitt,REP,120316,2,13,20,35,
Choctaw,Lieutenant Governor,Dana Murphy,REP,120316,0,2,12,14,
Choctaw,Lieutenant Governor,Matt Pinnell,REP,120316,2,12,13,27,
Choctaw,State Auditor,Cindy Byrd,REP,120316,0,5,11,16,
Choctaw,State Auditor,Charlie Prater,REP,120316,2,9,14,25,
Choctaw,Attorney General,Mike Hunter,REP,120316,0,4,14,18,
Choctaw,Attorney General,Gentner Drummond,REP,120316,2,10,11,23,
Choctaw,Superintendent of Public Instruction,Joy Hofmeister,REP,120316,1,4,9,14,
Choctaw,Superintendent of Public Instruction,Linda Murphy,REP,120316,1,9,16,26,
Choctaw,Commissioner of Labor,Cathy Costello,REP,120316,0,6,16,22,
Choctaw,Commissioner of Labor,Leslie Osborn,REP,120316,2,7,9,18,
Choctaw,Corporation Commissioner,Bob Anthony,REP,120316,0,6,10,16,
Choctaw,Corporation Commissioner,Brian Bingman,REP,120316,2,8,14,24,
Choctaw,Governor,Chris Powell,LIB,120316,0,0,0,0,
Choctaw,Governor,Rex Lawhorn,LIB,120316,0,0,0,0,
Choctaw,Corporation Commissioner,Ashley Nicole Mccray,DEM,120316,5,8,24,37,
Choctaw,Corporation Commissioner,Blake Cummings,DEM,120316,2,3,25,30,
Choctaw,U.S. House,Jason Nichols,DEM,120316,4,4,19,27,02
Choctaw,U.S. House,Clay Padgett,DEM,120316,3,7,29,39,02
Choctaw,Governor,Mick Cornett,REP,120318,0,0,6,6,
Choctaw,Governor,Kevin Stitt,REP,120318,0,2,10,12,
Choctaw,Lieutenant Governor,Dana Murphy,REP,120318,0,0,3,3,
Choctaw,Lieutenant Governor,Matt Pinnell,REP,120318,0,2,11,13,
Choctaw,State Auditor,Cindy Byrd,REP,120318,0,2,9,11,
Choctaw,State Auditor,Charlie Prater,REP,120318,0,0,5,5,
Choctaw,Attorney General,Mike Hunter,REP,120318,0,1,7,8,
Choctaw,Attorney General,Gentner Drummond,REP,120318,0,1,9,10,
Choctaw,Superintendent of Public Instruction,Joy Hofmeister,REP,120318,0,2,5,7,
Choctaw,Superintendent of Public Instruction,Linda Murphy,REP,120318,0,0,9,9,
Choctaw,Commissioner of Labor,Cathy Costello,REP,120318,0,1,4,5,
Choctaw,Commissioner of Labor,Leslie Osborn,REP,120318,0,1,10,11,
Choctaw,Corporation Commissioner,Bob Anthony,REP,120318,0,2,4,6,
Choctaw,Corporation Commissioner,Brian Bingman,REP,120318,0,0,10,10,
Choctaw,Governor,Chris Powell,LIB,120318,0,0,0,0,
Choctaw,Governor,Rex Lawhorn,LIB,120318,0,0,0,0,
Choctaw,Corporation Commissioner,Ashley Nicole Mccray,DEM,120318,0,2,13,15,
Choctaw,Corporation Commissioner,Blake Cummings,DEM,120318,0,3,23,26,
Choctaw,U.S. House,Jason Nichols,DEM,120318,0,4,17,21,02
Choctaw,U.S. House,Clay Padgett,DEM,120318,0,1,19,20,02
Choctaw,Governor,Mick Cornett,REP,120319,3,0,3,6,
Choctaw,Governor,Kevin Stitt,REP,120319,1,1,6,8,
Choctaw,Lieutenant Governor,Dana Murphy,REP,120319,3,0,5,8,
Choctaw,Lieutenant Governor,Matt Pinnell,REP,120319,1,1,4,6,
Choctaw,State Auditor,Cindy Byrd,REP,120319,1,1,4,6,
Choctaw,State Auditor,Charlie Prater,REP,120319,3,0,5,8,
Choctaw,Attorney General,Mike Hunter,REP,120319,3,0,5,8,
Choctaw,Attorney General,Gentner Drummond,REP,120319,1,1,4,6,
Choctaw,Superintendent of Public Instruction,Joy Hofmeister,REP,120319,0,1,5,6,
Choctaw,Superintendent of Public Instruction,Linda Murphy,REP,120319,3,0,4,7,
Choctaw,Commissioner of Labor,Cathy Costello,REP,120319,1,1,6,8,
Choctaw,Commissioner of Labor,Leslie Osborn,REP,120319,3,0,2,5,
Choctaw,Corporation Commissioner,Bob Anthony,REP,120319,1,0,3,4,
Choctaw,Corporation Commissioner,Brian Bingman,REP,120319,2,1,6,9,
Choctaw,Governor,Chris Powell,LIB,120319,0,0,0,0,
Choctaw,Governor,Rex Lawhorn,LIB,120319,0,0,0,0,
Choctaw,Corporation Commissioner,Ashley Nicole Mccray,DEM,120319,2,3,18,23,
Choctaw,Corporation Commissioner,Blake Cummings,DEM,120319,0,1,17,18,
Choctaw,U.S. House,Jason Nichols,DEM,120319,1,2,13,16,02
Choctaw,U.S. House,Clay Padgett,DEM,120319,1,2,22,25,02
Choctaw,Governor,Mick Cornett,REP,120320,0,0,7,7,
Choctaw,Governor,Kevin Stitt,REP,120320,0,0,7,7,
Choctaw,Lieutenant Governor,Dana Murphy,REP,120320,0,0,7,7,
Choctaw,Lieutenant Governor,Matt Pinnell,REP,120320,0,0,7,7,
Choctaw,State Auditor,Cindy Byrd,REP,120320,0,0,9,9,
Choctaw,State Auditor,Charlie Prater,REP,120320,0,0,5,5,
Choctaw,Attorney General,Mike Hunter,REP,120320,0,0,7,7,
Choctaw,Attorney General,Gentner Drummond,REP,120320,0,0,7,7,
Choctaw,Superintendent of Public Instruction,Joy Hofmeister,REP,120320,0,0,8,8,
Choctaw,Superintendent of Public Instruction,Linda Murphy,REP,120320,0,0,6,6,
Choctaw,Commissioner of Labor,Cathy Costello,REP,120320,0,0,5,5,
Choctaw,Commissioner of Labor,Leslie Osborn,REP,120320,0,0,8,8,
Choctaw,Corporation Commissioner,Bob Anthony,REP,120320,0,0,5,5,
Choctaw,Corporation Commissioner,Brian Bingman,REP,120320,0,0,8,8,
Choctaw,Governor,Chris Powell,LIB,120320,0,0,0,0,
Choctaw,Governor,Rex Lawhorn,LIB,120320,0,0,0,0,
Choctaw,Corporation Commissioner,Ashley Nicole Mccray,DEM,120320,1,0,6,7,
Choctaw,Corporation Commissioner,Blake Cummings,DEM,120320,0,0,10,10,
Choctaw,U.S. House,Jason Nichols,DEM,120320,1,0,7,8,02
Choctaw,U.S. House,Clay Padgett,DEM,120320,0,0,10,10,02
Choctaw,Governor,Mick Cornett,REP,120321,0,1,8,9,
Choctaw,Governor,Kevin Stitt,REP,120321,0,1,24,25,
Choctaw,Lieutenant Governor,Dana Murphy,REP,120321,0,1,13,14,
Choctaw,Lieutenant Governor,Matt Pinnell,REP,120321,0,1,19,20,
Choctaw,State Auditor,Cindy Byrd,REP,120321,0,1,17,18,
Choctaw,State Auditor,Charlie Prater,REP,120321,0,1,12,13,
Choctaw,Attorney General,Mike Hunter,REP,120321,0,1,9,10,
Choctaw,Attorney General,Gentner Drummond,REP,120321,0,1,22,23,
Choctaw,Superintendent of Public Instruction,Joy Hofmeister,REP,120321,0,1,8,9,
Choctaw,Superintendent of Public Instruction,Linda Murphy,REP,120321,0,1,24,25,
Choctaw,Commissioner of Labor,Cathy Costello,REP,120321,0,0,19,19,
Choctaw,Commissioner of Labor,Leslie Osborn,REP,120321,0,2,12,14,
Choctaw,Corporation Commissioner,Bob Anthony,REP,120321,0,1,11,12,
Choctaw,Corporation Commissioner,Brian Bingman,REP,120321,0,1,20,21,
Choctaw,Governor,Chris Powell,LIB,120321,0,0,0,0,
Choctaw,Governor,Rex Lawhorn,LIB,120321,0,0,0,0,
Choctaw,Corporation Commissioner,Ashley Nicole Mccray,DEM,120321,1,0,18,19,
Choctaw,Corporation Commissioner,Blake Cummings,DEM,120321,0,3,23,26,
Choctaw,U.S. House,Jason Nichols,DEM,120321,1,2,16,19,02
Choctaw,U.S. House,Clay Padgett,DEM,120321,0,1,27,28,02
Choctaw,Governor,Mick Cornett,REP,120322,0,0,1,1,
Choctaw,Governor,Kevin Stitt,REP,120322,0,1,7,8,
Choctaw,Lieutenant Governor,Dana Murphy,REP,120322,0,1,5,6,
Choctaw,Lieutenant Governor,Matt Pinnell,REP,120322,0,0,3,3,
Choctaw,State Auditor,Cindy Byrd,REP,120322,0,1,7,8,
Choctaw,State Auditor,Charlie Prater,REP,120322,0,0,1,1,
Choctaw,Attorney General,Mike Hunter,REP,120322,0,0,2,2,
Choctaw,Attorney General,Gentner Drummond,REP,120322,0,1,7,8,
Choctaw,Superintendent of Public Instruction,Joy Hofmeister,REP,120322,0,0,4,4,
Choctaw,Superintendent of Public Instruction,Linda Murphy,REP,120322,0,1,3,4,
Choctaw,Commissioner of Labor,Cathy Costello,REP,120322,0,1,7,8,
Choctaw,Commissioner of Labor,Leslie Osborn,REP,120322,0,0,1,1,
Choctaw,Corporation Commissioner,Bob Anthony,REP,120322,0,1,4,5,
Choctaw,Corporation Commissioner,Brian Bingman,REP,120322,0,0,4,4,
Choctaw,Governor,Chris Powell,LIB,120322,0,0,0,0,
Choctaw,Governor,Rex Lawhorn,LIB,120322,0,0,0,0,
Choctaw,Corporation Commissioner,Ashley Nicole Mccray,DEM,120322,0,1,4,5,
Choctaw,Corporation Commissioner,Blake Cummings,DEM,120322,0,1,9,10,
Choctaw,U.S. House,Jason Nichols,DEM,120322,0,1,6,7,02
Choctaw,U.S. House,Clay Padgett,DEM,120322,0,1,7,8,02
Cimarron,Governor,Mick Cornett,REP,130002,0,0,16,16,
Cimarron,Governor,Kevin Stitt,REP,130002,7,6,37,50,
Cimarron,Lieutenant Governor,Dana Murphy,REP,130002,1,0,25,26,
Cimarron,Lieutenant Governor,Matt Pinnell,REP,130002,6,5,28,39,
Cimarron,State Auditor,Cindy Byrd,REP,130002,5,2,25,32,
Cimarron,State Auditor,Charlie Prater,REP,130002,2,3,29,34,
Cimarron,Attorney General,Mike Hunter,REP,130002,4,0,21,25,
Cimarron,Attorney General,Gentner Drummond,REP,130002,3,6,33,42,
Cimarron,Superintendent of Public Instruction,Joy Hofmeister,REP,130002,3,2,20,25,
Cimarron,Superintendent of Public Instruction,Linda Murphy,REP,130002,4,3,36,43,
Cimarron,Commissioner of Labor,Cathy Costello,REP,130002,5,2,34,41,
Cimarron,Commissioner of Labor,Leslie Osborn,REP,130002,2,3,20,25,
Cimarron,Corporation Commissioner,Bob Anthony,REP,130002,1,3,30,34,
Cimarron,Corporation Commissioner,Brian Bingman,REP,130002,6,3,23,32,
Cimarron,State House,Kenton Patzkowsky,REP,130002,5,3,34,42,61
Cimarron,State House,Brad Raven,REP,130002,2,3,21,26,61
Cimarron,Governor,Chris Powell,LIB,130002,0,0,0,0,
Cimarron,Governor,Rex Lawhorn,LIB,130002,0,0,0,0,
Cimarron,Corporation Commissioner,Ashley Nicole Mccray,DEM,130002,0,0,3,3,
Cimarron,Corporation Commissioner,Blake Cummings,DEM,130002,0,0,5,5,
Cimarron,Governor,Mick Cornett,REP,130003,3,1,9,13,
Cimarron,Governor,Kevin Stitt,REP,130003,0,3,42,45,
Cimarron,Lieutenant Governor,Dana Murphy,REP,130003,2,1,24,27,
Cimarron,Lieutenant Governor,Matt Pinnell,REP,130003,0,3,26,29,
Cimarron,State Auditor,Cindy Byrd,REP,130003,2,2,32,36,
Cimarron,State Auditor,Charlie Prater,REP,130003,0,2,23,25,
Cimarron,Attorney General,Mike Hunter,REP,130003,0,3,11,14,
Cimarron,Attorney General,Gentner Drummond,REP,130003,3,1,40,44,
Cimarron,Superintendent of Public Instruction,Joy Hofmeister,REP,130003,2,2,16,20,
Cimarron,Superintendent of Public Instruction,Linda Murphy,REP,130003,0,2,40,42,
Cimarron,Commissioner of Labor,Cathy Costello,REP,130003,2,2,43,47,
Cimarron,Commissioner of Labor,Leslie Osborn,REP,130003,0,2,12,14,
Cimarron,Corporation Commissioner,Bob Anthony,REP,130003,0,2,37,39,
Cimarron,Corporation Commissioner,Brian Bingman,REP,130003,2,1,14,17,
Cimarron,State House,Kenton Patzkowsky,REP,130003,2,4,25,31,61
Cimarron,State House,Brad Raven,REP,130003,1,0,27,28,61
Cimarron,Governor,Chris Powell,LIB,130003,0,0,0,0,
Cimarron,Governor,Rex Lawhorn,LIB,130003,0,0,0,0,
Cimarron,Corporation Commissioner,Ashley Nicole Mccray,DEM,130003,0,0,4,4,
Cimarron,Corporation Commissioner,Blake Cummings,DEM,130003,1,2,3,6,
Cimarron,Governor,Mick Cornett,REP,130004,1,4,16,21,
Cimarron,Governor,Kevin Stitt,REP,130004,1,8,35,44,
Cimarron,Lieutenant Governor,Dana Murphy,REP,130004,1,8,22,31,
Cimarron,Lieutenant Governor,Matt Pinnell,REP,130004,1,5,25,31,
Cimarron,State Auditor,Cindy Byrd,REP,130004,2,5,19,26,
Cimarron,State Auditor,Charlie Prater,REP,130004,0,8,32,40,
Cimarron,Attorney General,Mike Hunter,REP,130004,0,4,27,31,
Cimarron,Attorney General,Gentner Drummond,REP,130004,2,9,21,32,
Cimarron,Superintendent of Public Instruction,Joy Hofmeister,REP,130004,1,8,21,30,
Cimarron,Superintendent of Public Instruction,Linda Murphy,REP,130004,1,5,31,37,
Cimarron,Commissioner of Labor,Cathy Costello,REP,130004,1,10,31,42,
Cimarron,Commissioner of Labor,Leslie Osborn,REP,130004,1,3,18,22,
Cimarron,Corporation Commissioner,Bob Anthony,REP,130004,1,10,20,31,
Cimarron,Corporation Commissioner,Brian Bingman,REP,130004,1,3,27,31,
Cimarron,State House,Kenton Patzkowsky,REP,130004,0,10,18,28,61
Cimarron,State House,Brad Raven,REP,130004,2,3,32,37,61
Cimarron,Governor,Chris Powell,LIB,130004,0,0,0,0,
Cimarron,Governor,Rex Lawhorn,LIB,130004,0,0,0,0,
Cimarron,Corporation Commissioner,Ashley Nicole Mccray,DEM,130004,0,0,1,1,
Cimarron,Corporation Commissioner,Blake Cummings,DEM,130004,0,0,2,2,
Cimarron,Governor,Mick Cornett,REP,130005,0,3,10,13,
Cimarron,Governor,Kevin Stitt,REP,130005,0,4,19,23,
Cimarron,Lieutenant Governor,Dana Murphy,REP,130005,0,2,13,15,
Cimarron,Lieutenant Governor,Matt Pinnell,REP,130005,0,5,15,20,
Cimarron,State Auditor,Cindy Byrd,REP,130005,0,0,12,12,
Cimarron,State Auditor,Charlie Prater,REP,130005,0,7,15,22,
Cimarron,Attorney General,Mike Hunter,REP,130005,0,0,9,9,
Cimarron,Attorney General,Gentner Drummond,REP,130005,0,7,20,27,
Cimarron,Superintendent of Public Instruction,Joy Hofmeister,REP,130005,0,4,9,13,
Cimarron,Superintendent of Public Instruction,Linda Murphy,REP,130005,0,3,19,22,
Cimarron,Commissioner of Labor,Cathy Costello,REP,130005,0,5,19,24,
Cimarron,Commissioner of Labor,Leslie Osborn,REP,130005,0,2,8,10,
Cimarron,Corporation Commissioner,Bob Anthony,REP,130005,0,4,15,19,
Cimarron,Corporation Commissioner,Brian Bingman,REP,130005,0,3,12,15,
Cimarron,State House,Kenton Patzkowsky,REP,130005,0,4,14,18,61
Cimarron,State House,Brad Raven,REP,130005,0,3,16,19,61
Cimarron,Governor,Chris Powell,LIB,130005,0,0,0,0,
Cimarron,Governor,Rex Lawhorn,LIB,130005,0,0,0,0,
Cimarron,Corporation Commissioner,Ashley Nicole Mccray,DEM,130005,0,2,2,4,
Cimarron,Corporation Commissioner,Blake Cummings,DEM,130005,0,0,1,1,
Cimarron,Governor,Mick Cornett,REP,130006,2,5,18,25,
Cimarron,Governor,Kevin Stitt,REP,130006,3,14,51,68,
Cimarron,Lieutenant Governor,Dana Murphy,REP,130006,1,9,16,26,
Cimarron,Lieutenant Governor,Matt Pinnell,REP,130006,4,11,50,65,
Cimarron,State Auditor,Cindy Byrd,REP,130006,0,4,28,32,
Cimarron,State Auditor,Charlie Prater,REP,130006,4,14,35,53,
Cimarron,Attorney General,Mike Hunter,REP,130006,4,9,35,48,
Cimarron,Attorney General,Gentner Drummond,REP,130006,1,11,32,44,
Cimarron,Superintendent of Public Instruction,Joy Hofmeister,REP,130006,0,11,22,33,
Cimarron,Superintendent of Public Instruction,Linda Murphy,REP,130006,4,8,41,53,
Cimarron,Commissioner of Labor,Cathy Costello,REP,130006,3,9,34,46,
Cimarron,Commissioner of Labor,Leslie Osborn,REP,130006,1,10,29,40,
Cimarron,Corporation Commissioner,Bob Anthony,REP,130006,0,10,35,45,
Cimarron,Corporation Commissioner,Brian Bingman,REP,130006,4,8,27,39,
Cimarron,State House,Kenton Patzkowsky,REP,130006,5,12,42,59,61
Cimarron,State House,Brad Raven,REP,130006,1,7,25,33,61
Cimarron,Governor,Chris Powell,LIB,130006,0,0,0,0,
Cimarron,Governor,Rex Lawhorn,LIB,130006,0,0,0,0,
Cimarron,Corporation Commissioner,Ashley Nicole Mccray,DEM,130006,0,1,9,10,
Cimarron,Corporation Commissioner,Blake Cummings,DEM,130006,0,0,3,3,
Cimarron,Governor,Mick Cornett,REP,130007,0,1,1,2,
Cimarron,Governor,Kevin Stitt,REP,130007,2,3,5,10,
Cimarron,Lieutenant Governor,Dana Murphy,REP,130007,0,3,0,3,
Cimarron,Lieutenant Governor,Matt Pinnell,REP,130007,2,1,6,9,
Cimarron,State Auditor,Cindy Byrd,REP,130007,0,3,4,7,
Cimarron,State Auditor,Charlie Prater,REP,130007,2,1,2,5,
Cimarron,Attorney General,Mike Hunter,REP,130007,2,1,2,5,
Cimarron,Attorney General,Gentner Drummond,REP,130007,0,2,4,6,
Cimarron,Superintendent of Public Instruction,Joy Hofmeister,REP,130007,2,3,3,8,
Cimarron,Superintendent of Public Instruction,Linda Murphy,REP,130007,0,1,3,4,
Cimarron,Commissioner of Labor,Cathy Costello,REP,130007,0,2,3,5,
Cimarron,Commissioner of Labor,Leslie Osborn,REP,130007,2,2,3,7,
Cimarron,Corporation Commissioner,Bob Anthony,REP,130007,0,1,3,4,
Cimarron,Corporation Commissioner,Brian Bingman,REP,130007,2,2,3,7,
Cimarron,State House,Kenton Patzkowsky,REP,130007,2,3,2,7,61
Cimarron,State House,Brad Raven,REP,130007,0,1,4,5,61
Cimarron,Governor,Chris Powell,LIB,130007,0,0,0,0,
Cimarron,Governor,Rex Lawhorn,LIB,130007,0,0,0,0,
Cimarron,Corporation Commissioner,Ashley Nicole Mccray,DEM,130007,0,2,4,6,
Cimarron,Corporation Commissioner,Blake Cummings,DEM,130007,0,0,2,2,
Cleveland,Governor,Mick Cornett,REP,140001,19,24,172,215,
Cleveland,Governor,Kevin Stitt,REP,140001,17,17,132,166,
Cleveland,Lieutenant Governor,Dana Murphy,REP,140001,16,21,144,181,
Cleveland,Lieutenant Governor,Matt Pinnell,REP,140001,20,19,146,185,
Cleveland,State Auditor,Cindy Byrd,REP,140001,21,20,161,202,
Cleveland,State Auditor,Charlie Prater,REP,140001,14,19,121,154,
Cleveland,Attorney General,Mike Hunter,REP,140001,27,16,167,210,
Cleveland,Attorney General,Gentner Drummond,REP,140001,8,25,130,163,
Cleveland,Superintendent of Public Instruction,Joy Hofmeister,REP,140001,18,31,182,231,
Cleveland,Superintendent of Public Instruction,Linda Murphy,REP,140001,17,8,112,137,
Cleveland,Commissioner of Labor,Cathy Costello,REP,140001,10,17,150,177,
Cleveland,Commissioner of Labor,Leslie Osborn,REP,140001,25,23,138,186,
Cleveland,Corporation Commissioner,Bob Anthony,REP,140001,24,25,150,199,
Cleveland,Corporation Commissioner,Brian Bingman,REP,140001,11,14,137,162,
Cleveland,Governor,Chris Powell,LIB,140001,0,0,1,1,
Cleveland,Governor,Rex Lawhorn,LIB,140001,0,0,0,0,
Cleveland,Corporation Commissioner,Ashley Nicole Mccray,DEM,140001,8,11,113,132,
Cleveland,Corporation Commissioner,Blake Cummings,DEM,140001,0,7,12,19,
Cleveland,U.S. House,Mary Brannon,DEM,140001,6,6,78,90,04
Cleveland,U.S. House,Fred Gipson,DEM,140001,3,12,47,62,04
Cleveland,Governor,Mick Cornett,REP,140002,1,2,26,29,
Cleveland,Governor,Kevin Stitt,REP,140002,1,4,21,26,
Cleveland,Lieutenant Governor,Dana Murphy,REP,140002,1,1,21,23,
Cleveland,Lieutenant Governor,Matt Pinnell,REP,140002,0,5,24,29,
Cleveland,State Auditor,Cindy Byrd,REP,140002,2,4,21,27,
Cleveland,State Auditor,Charlie Prater,REP,140002,0,2,23,25,
Cleveland,Attorney General,Mike Hunter,REP,140002,0,4,30,34,
Cleveland,Attorney General,Gentner Drummond,REP,140002,1,2,16,19,
Cleveland,Superintendent of Public Instruction,Joy Hofmeister,REP,140002,1,4,29,34,
Cleveland,Superintendent of Public Instruction,Linda Murphy,REP,140002,0,2,17,19,
Cleveland,Commissioner of Labor,Cathy Costello,REP,140002,2,2,23,27,
Cleveland,Commissioner of Labor,Leslie Osborn,REP,140002,0,4,20,24,
Cleveland,Corporation Commissioner,Bob Anthony,REP,140002,0,3,25,28,
Cleveland,Corporation Commissioner,Brian Bingman,REP,140002,1,3,17,21,
Cleveland,Governor,Chris Powell,LIB,140002,0,1,2,3,
Cleveland,Governor,Rex Lawhorn,LIB,140002,0,0,0,0,
Cleveland,Corporation Commissioner,Ashley Nicole Mccray,DEM,140002,2,3,71,76,
Cleveland,Corporation Commissioner,Blake Cummings,DEM,140002,0,0,17,17,
Cleveland,U.S. House,Mary Brannon,DEM,140002,1,2,55,58,04
Cleveland,U.S. House,Fred Gipson,DEM,140002,1,2,32,35,04
Cleveland,State Senate,Mary Boren,DEM,140002,2,2,68,72,16
Cleveland,State Senate,Claudia Griffith,DEM,140002,0,1,20,21,16
Cleveland,Governor,Mick Cornett,REP,140003,5,2,80,87,
Cleveland,Governor,Kevin Stitt,REP,140003,0,0,48,48,
Cleveland,Lieutenant Governor,Dana Murphy,REP,140003,3,2,58,63,
Cleveland,Lieutenant Governor,Matt Pinnell,REP,140003,2,0,63,65,
Cleveland,State Auditor,Cindy Byrd,REP,140003,4,1,63,68,
Cleveland,State Auditor,Charlie Prater,REP,140003,1,1,54,56,
Cleveland,Attorney General,Mike Hunter,REP,140003,4,2,58,64,
Cleveland,Attorney General,Gentner Drummond,REP,140003,1,0,63,64,
Cleveland,Superintendent of Public Instruction,Joy Hofmeister,REP,140003,5,2,80,87,
Cleveland,Superintendent of Public Instruction,Linda Murphy,REP,140003,0,0,44,44,
Cleveland,Commissioner of Labor,Cathy Costello,REP,140003,1,0,47,48,
Cleveland,Commissioner of Labor,Leslie Osborn,REP,140003,4,2,75,81,
Cleveland,Corporation Commissioner,Bob Anthony,REP,140003,3,1,70,74,
Cleveland,Corporation Commissioner,Brian Bingman,REP,140003,2,1,50,53,
Cleveland,Governor,Chris Powell,LIB,140003,0,0,0,0,
Cleveland,Governor,Rex Lawhorn,LIB,140003,0,0,0,0,
Cleveland,Corporation Commissioner,Ashley Nicole Mccray,DEM,140003,2,4,73,79,
Cleveland,Corporation Commissioner,Blake Cummings,DEM,140003,2,0,28,30,
Cleveland,U.S. House,Mary Brannon,DEM,140003,2,3,68,73,04
Cleveland,U.S. House,Fred Gipson,DEM,140003,2,1,33,36,04
Cleveland,Governor,Mick Cornett,REP,140004,24,14,273,311,
Cleveland,Governor,Kevin Stitt,REP,140004,21,10,259,290,
Cleveland,Lieutenant Governor,Dana Murphy,REP,140004,19,6,216,241,
Cleveland,Lieutenant Governor,Matt Pinnell,REP,140004,25,18,303,346,
Cleveland,State Auditor,Cindy Byrd,REP,140004,21,12,243,276,
Cleveland,State Auditor,Charlie Prater,REP,140004,23,12,262,297,
Cleveland,Attorney General,Mike Hunter,REP,140004,27,15,328,370,
Cleveland,Attorney General,Gentner Drummond,REP,140004,18,9,195,222,
Cleveland,Superintendent of Public Instruction,Joy Hofmeister,REP,140004,27,18,306,351,
Cleveland,Superintendent of Public Instruction,Linda Murphy,REP,140004,17,6,215,238,
Cleveland,Commissioner of Labor,Cathy Costello,REP,140004,20,12,244,276,
Cleveland,Commissioner of Labor,Leslie Osborn,REP,140004,25,12,271,308,
Cleveland,Corporation Commissioner,Bob Anthony,REP,140004,32,18,323,373,
Cleveland,Corporation Commissioner,Brian Bingman,REP,140004,13,6,197,216,
Cleveland,Governor,Chris Powell,LIB,140004,0,0,0,0,
Cleveland,Governor,Rex Lawhorn,LIB,140004,0,0,0,0,
Cleveland,Corporation Commissioner,Ashley Nicole Mccray,DEM,140004,9,5,56,70,
Cleveland,Corporation Commissioner,Blake Cummings,DEM,140004,2,3,20,25,
Cleveland,U.S. House,Mary Brannon,DEM,140004,6,5,38,49,04
Cleveland,U.S. House,Fred Gipson,DEM,140004,5,3,39,47,04
Cleveland,Governor,Mick Cornett,REP,140005,44,13,245,302,
Cleveland,Governor,Kevin Stitt,REP,140005,21,5,233,259,
Cleveland,Lieutenant Governor,Dana Murphy,REP,140005,38,11,203,252,
Cleveland,Lieutenant Governor,Matt Pinnell,REP,140005,27,6,264,297,
Cleveland,State Auditor,Cindy Byrd,REP,140005,40,6,219,265,
Cleveland,State Auditor,Charlie Prater,REP,140005,23,10,242,275,
Cleveland,Attorney General,Mike Hunter,REP,140005,48,10,261,319,
Cleveland,Attorney General,Gentner Drummond,REP,140005,16,8,210,234,
Cleveland,Superintendent of Public Instruction,Joy Hofmeister,REP,140005,41,12,262,315,
Cleveland,Superintendent of Public Instruction,Linda Murphy,REP,140005,22,5,209,236,
Cleveland,Commissioner of Labor,Cathy Costello,REP,140005,33,6,204,243,
Cleveland,Commissioner of Labor,Leslie Osborn,REP,140005,31,12,262,305,
Cleveland,Corporation Commissioner,Bob Anthony,REP,140005,37,14,269,320,
Cleveland,Corporation Commissioner,Brian Bingman,REP,140005,27,4,197,228,
Cleveland,Governor,Chris Powell,LIB,140005,0,0,0,0,
Cleveland,Governor,Rex Lawhorn,LIB,140005,0,1,0,1,
Cleveland,Corporation Commissioner,Ashley Nicole Mccray,DEM,140005,18,4,60,82,
Cleveland,Corporation Commissioner,Blake Cummings,DEM,140005,3,3,22,28,
Cleveland,U.S. House,Mary Brannon,DEM,140005,12,4,59,75,04
Cleveland,U.S. House,Fred Gipson,DEM,140005,8,3,24,35,04
Cleveland,Governor,Mick Cornett,REP,140006,2,3,43,48,
Cleveland,Governor,Kevin Stitt,REP,140006,3,4,19,26,
Cleveland,Lieutenant Governor,Dana Murphy,REP,140006,2,6,42,50,
Cleveland,Lieutenant Governor,Matt Pinnell,REP,140006,3,2,18,23,
Cleveland,State Auditor,Cindy Byrd,REP,140006,3,4,28,35,
Cleveland,State Auditor,Charlie Prater,REP,140006,2,4,28,34,
Cleveland,Attorney General,Mike Hunter,REP,140006,3,6,39,48,
Cleveland,Attorney General,Gentner Drummond,REP,140006,2,1,21,24,
Cleveland,Superintendent of Public Instruction,Joy Hofmeister,REP,140006,3,4,40,47,
Cleveland,Superintendent of Public Instruction,Linda Murphy,REP,140006,2,3,19,24,
Cleveland,Commissioner of Labor,Cathy Costello,REP,140006,2,6,30,38,
Cleveland,Commissioner of Labor,Leslie Osborn,REP,140006,3,2,26,31,
Cleveland,Corporation Commissioner,Bob Anthony,REP,140006,4,5,36,45,
Cleveland,Corporation Commissioner,Brian Bingman,REP,140006,1,3,24,28,
Cleveland,Governor,Chris Powell,LIB,140006,0,0,0,0,
Cleveland,Governor,Rex Lawhorn,LIB,140006,0,0,0,0,
Cleveland,Corporation Commissioner,Ashley Nicole Mccray,DEM,140006,9,14,156,179,
Cleveland,Corporation Commissioner,Blake Cummings,DEM,140006,4,2,22,28,
Cleveland,U.S. House,Mary Brannon,DEM,140006,2,6,81,89,04
Cleveland,U.S. House,Fred Gipson,DEM,140006,11,10,100,121,04
Cleveland,State Senate,Mary Boren,DEM,140006,10,14,155,179,16
Cleveland,State Senate,Claudia Griffith,DEM,140006,3,2,29,34,16
Cleveland,Governor,Mick Cornett,REP,140007,10,9,201,220,
Cleveland,Governor,Kevin Stitt,REP,140007,12,11,203,226,
Cleveland,Lieutenant Governor,Dana Murphy,REP,140007,8,8,182,198,
Cleveland,Lieutenant Governor,Matt Pinnell,REP,140007,14,10,202,226,
Cleveland,State Auditor,Cindy Byrd,REP,140007,6,14,207,227,
Cleveland,State Auditor,Charlie Prater,REP,140007,10,4,173,187,
Cleveland,Attorney General,Mike Hunter,REP,140007,11,14,199,224,
Cleveland,Attorney General,Gentner Drummond,REP,140007,11,6,187,204,
Cleveland,Superintendent of Public Instruction,Joy Hofmeister,REP,140007,14,13,236,263,
Cleveland,Superintendent of Public Instruction,Linda Murphy,REP,140007,6,5,152,163,
Cleveland,Commissioner of Labor,Cathy Costello,REP,140007,11,7,168,186,
Cleveland,Commissioner of Labor,Leslie Osborn,REP,140007,8,10,216,234,
Cleveland,Corporation Commissioner,Bob Anthony,REP,140007,8,8,207,223,
Cleveland,Corporation Commissioner,Brian Bingman,REP,140007,12,9,169,190,
Cleveland,Governor,Chris Powell,LIB,140007,0,1,0,1,
Cleveland,Governor,Rex Lawhorn,LIB,140007,0,0,0,0,
Cleveland,Corporation Commissioner,Ashley Nicole Mccray,DEM,140007,9,0,31,40,
Cleveland,Corporation Commissioner,Blake Cummings,DEM,140007,2,0,14,16,
Cleveland,U.S. House,Mary Brannon,DEM,140007,8,0,32,40,04
Cleveland,U.S. House,Fred Gipson,DEM,140007,3,0,13,16,04
Cleveland,Governor,Mick Cornett,REP,140008,2,1,31,34,
Cleveland,Governor,Kevin Stitt,REP,140008,1,4,15,20,
Cleveland,Lieutenant Governor,Dana Murphy,REP,140008,2,2,22,26,
Cleveland,Lieutenant Governor,Matt Pinnell,REP,140008,0,3,23,26,
Cleveland,State Auditor,Cindy Byrd,REP,140008,1,0,31,32,
Cleveland,State Auditor,Charlie Prater,REP,140008,2,5,13,20,
Cleveland,Attorney General,Mike Hunter,REP,140008,3,2,25,30,
Cleveland,Attorney General,Gentner Drummond,REP,140008,0,3,18,21,
Cleveland,Superintendent of Public Instruction,Joy Hofmeister,REP,140008,2,2,34,38,
Cleveland,Superintendent of Public Instruction,Linda Murphy,REP,140008,1,3,12,16,
Cleveland,Commissioner of Labor,Cathy Costello,REP,140008,2,4,18,24,
Cleveland,Commissioner of Labor,Leslie Osborn,REP,140008,1,1,27,29,
Cleveland,Corporation Commissioner,Bob Anthony,REP,140008,3,2,18,23,
Cleveland,Corporation Commissioner,Brian Bingman,REP,140008,0,3,26,29,
Cleveland,Governor,Chris Powell,LIB,140008,0,0,0,0,
Cleveland,Governor,Rex Lawhorn,LIB,140008,0,0,0,0,
Cleveland,Corporation Commissioner,Ashley Nicole Mccray,DEM,140008,8,11,135,154,
Cleveland,Corporation Commissioner,Blake Cummings,DEM,140008,1,1,22,24,
Cleveland,U.S. House,Mary Brannon,DEM,140008,5,6,79,90,04
Cleveland,U.S. House,Fred Gipson,DEM,140008,4,6,80,90,04
Cleveland,State Senate,Mary Boren,DEM,140008,7,11,125,143,16
Cleveland,State Senate,Claudia Griffith,DEM,140008,2,1,34,37,16
Cleveland,Governor,Mick Cornett,REP,140009,18,11,186,215,
Cleveland,Governor,Kevin Stitt,REP,140009,15,14,188,217,
Cleveland,Lieutenant Governor,Dana Murphy,REP,140009,16,10,170,196,
Cleveland,Lieutenant Governor,Matt Pinnell,REP,140009,15,15,188,218,
Cleveland,State Auditor,Cindy Byrd,REP,140009,22,9,181,212,
Cleveland,State Auditor,Charlie Prater,REP,140009,7,15,165,187,
Cleveland,Attorney General,Mike Hunter,REP,140009,22,11,193,226,
Cleveland,Attorney General,Gentner Drummond,REP,140009,10,14,171,195,
Cleveland,Superintendent of Public Instruction,Joy Hofmeister,REP,140009,20,15,218,253,
Cleveland,Superintendent of Public Instruction,Linda Murphy,REP,140009,13,10,141,164,
Cleveland,Commissioner of Labor,Cathy Costello,REP,140009,9,15,170,194,
Cleveland,Commissioner of Labor,Leslie Osborn,REP,140009,23,10,182,215,
Cleveland,Corporation Commissioner,Bob Anthony,REP,140009,17,12,179,208,
Cleveland,Corporation Commissioner,Brian Bingman,REP,140009,16,13,177,206,
Cleveland,Governor,Chris Powell,LIB,140009,0,0,0,0,
Cleveland,Governor,Rex Lawhorn,LIB,140009,0,0,1,1,
Cleveland,Corporation Commissioner,Ashley Nicole Mccray,DEM,140009,3,3,60,66,
Cleveland,Corporation Commissioner,Blake Cummings,DEM,140009,2,0,16,18,
Cleveland,U.S. House,Mary Brannon,DEM,140009,3,2,52,57,04
Cleveland,U.S. House,Fred Gipson,DEM,140009,2,1,24,27,04
Cleveland,Governor,Mick Cornett,REP,140010,8,5,98,111,
Cleveland,Governor,Kevin Stitt,REP,140010,6,5,107,118,
Cleveland,Lieutenant Governor,Dana Murphy,REP,140010,7,6,77,90,
Cleveland,Lieutenant Governor,Matt Pinnell,REP,140010,7,4,124,135,
Cleveland,State Auditor,Cindy Byrd,REP,140010,5,5,97,107,
Cleveland,State Auditor,Charlie Prater,REP,140010,8,3,98,109,
Cleveland,Attorney General,Mike Hunter,REP,140010,10,7,107,124,
Cleveland,Attorney General,Gentner Drummond,REP,140010,4,3,91,98,
Cleveland,Superintendent of Public Instruction,Joy Hofmeister,REP,140010,9,5,97,111,
Cleveland,Superintendent of Public Instruction,Linda Murphy,REP,140010,5,5,103,113,
Cleveland,Commissioner of Labor,Cathy Costello,REP,140010,5,7,78,90,
Cleveland,Commissioner of Labor,Leslie Osborn,REP,140010,8,3,120,131,
Cleveland,Corporation Commissioner,Bob Anthony,REP,140010,9,6,115,130,
Cleveland,Corporation Commissioner,Brian Bingman,REP,140010,5,4,83,92,
Cleveland,Governor,Chris Powell,LIB,140010,0,0,0,0,
Cleveland,Governor,Rex Lawhorn,LIB,140010,0,0,0,0,
Cleveland,Corporation Commissioner,Ashley Nicole Mccray,DEM,140010,5,1,42,48,
Cleveland,Corporation Commissioner,Blake Cummings,DEM,140010,1,0,17,18,
Cleveland,U.S. House,Mary Brannon,DEM,140010,5,1,36,42,04
Cleveland,U.S. House,Fred Gipson,DEM,140010,1,0,23,24,04
Cleveland,Governor,Mick Cornett,REP,140011,3,3,60,66,
Cleveland,Governor,Kevin Stitt,REP,140011,0,1,50,51,
Cleveland,Lieutenant Governor,Dana Murphy,REP,140011,3,3,50,56,
Cleveland,Lieutenant Governor,Matt Pinnell,REP,140011,0,1,56,57,
Cleveland,State Auditor,Cindy Byrd,REP,140011,3,3,44,50,
Cleveland,State Auditor,Charlie Prater,REP,140011,0,1,60,61,
Cleveland,Attorney General,Mike Hunter,REP,140011,1,3,60,64,
Cleveland,Attorney General,Gentner Drummond,REP,140011,2,1,46,49,
Cleveland,Superintendent of Public Instruction,Joy Hofmeister,REP,140011,3,2,60,65,
Cleveland,Superintendent of Public Instruction,Linda Murphy,REP,140011,0,2,48,50,
Cleveland,Commissioner of Labor,Cathy Costello,REP,140011,2,1,52,55,
Cleveland,Commissioner of Labor,Leslie Osborn,REP,140011,1,3,53,57,
Cleveland,Corporation Commissioner,Bob Anthony,REP,140011,2,3,62,67,
Cleveland,Corporation Commissioner,Brian Bingman,REP,140011,1,1,44,46,
Cleveland,Governor,Chris Powell,LIB,140011,0,0,0,0,
Cleveland,Governor,Rex Lawhorn,LIB,140011,0,0,0,0,
Cleveland,Corporation Commissioner,Ashley Nicole Mccray,DEM,140011,12,9,181,202,
Cleveland,Corporation Commissioner,Blake Cummings,DEM,140011,0,2,40,42,
Cleveland,U.S. House,Mary Brannon,DEM,140011,6,2,90,98,04
Cleveland,U.S. House,Fred Gipson,DEM,140011,6,9,132,147,04
Cleveland,State Senate,Mary Boren,DEM,140011,8,10,194,212,16
Cleveland,State Senate,Claudia Griffith,DEM,140011,4,1,30,35,16
Cleveland,Governor,Mick Cornett,REP,140012,8,23,164,195,
Cleveland,Governor,Kevin Stitt,REP,140012,8,10,119,137,
Cleveland,Lieutenant Governor,Dana Murphy,REP,140012,10,13,128,151,
Cleveland,Lieutenant Governor,Matt Pinnell,REP,140012,6,20,145,171,
Cleveland,State Auditor,Cindy Byrd,REP,140012,10,23,138,171,
Cleveland,State Auditor,Charlie Prater,REP,140012,6,10,125,141,
Cleveland,Attorney General,Mike Hunter,REP,140012,8,15,147,170,
Cleveland,Attorney General,Gentner Drummond,REP,140012,8,18,130,156,
Cleveland,Superintendent of Public Instruction,Joy Hofmeister,REP,140012,8,15,151,174,
Cleveland,Superintendent of Public Instruction,Linda Murphy,REP,140012,8,18,119,145,
Cleveland,Commissioner of Labor,Cathy Costello,REP,140012,10,18,129,157,
Cleveland,Commissioner of Labor,Leslie Osborn,REP,140012,6,15,140,161,
Cleveland,Corporation Commissioner,Bob Anthony,REP,140012,12,14,143,169,
Cleveland,Corporation Commissioner,Brian Bingman,REP,140012,4,18,124,146,
Cleveland,Governor,Chris Powell,LIB,140012,0,0,1,1,
Cleveland,Governor,Rex Lawhorn,LIB,140012,0,0,5,5,
Cleveland,Corporation Commissioner,Ashley Nicole Mccray,DEM,140012,8,9,87,104,
Cleveland,Corporation Commissioner,Blake Cummings,DEM,140012,2,4,29,35,
Cleveland,U.S. House,Mary Brannon,DEM,140012,7,7,67,81,04
Cleveland,U.S. House,Fred Gipson,DEM,140012,3,6,49,58,04
Cleveland,Governor,Mick Cornett,REP,140013,0,0,14,14,
Cleveland,Governor,Kevin Stitt,REP,140013,1,0,4,5,
Cleveland,Lieutenant Governor,Dana Murphy,REP,140013,1,0,7,8,
Cleveland,Lieutenant Governor,Matt Pinnell,REP,140013,0,0,11,11,
Cleveland,State Auditor,Cindy Byrd,REP,140013,0,0,9,9,
Cleveland,State Auditor,Charlie Prater,REP,140013,1,0,8,9,
Cleveland,Attorney General,Mike Hunter,REP,140013,0,0,8,8,
Cleveland,Attorney General,Gentner Drummond,REP,140013,1,0,10,11,
Cleveland,Superintendent of Public Instruction,Joy Hofmeister,REP,140013,0,0,10,10,
Cleveland,Superintendent of Public Instruction,Linda Murphy,REP,140013,1,0,8,9,
Cleveland,Commissioner of Labor,Cathy Costello,REP,140013,0,0,6,6,
Cleveland,Commissioner of Labor,Leslie Osborn,REP,140013,1,0,12,13,
Cleveland,Corporation Commissioner,Bob Anthony,REP,140013,1,0,6,7,
Cleveland,Corporation Commissioner,Brian Bingman,REP,140013,0,0,11,11,
Cleveland,Governor,Chris Powell,LIB,140013,0,0,0,0,
Cleveland,Governor,Rex Lawhorn,LIB,140013,0,0,0,0,
Cleveland,Corporation Commissioner,Ashley Nicole Mccray,DEM,140013,2,0,15,17,
Cleveland,Corporation Commissioner,Blake Cummings,DEM,140013,1,0,3,4,
Cleveland,U.S. House,Mary Brannon,DEM,140013,3,0,11,14,04
Cleveland,U.S. House,Fred Gipson,DEM,140013,0,0,7,7,04
Cleveland,Governor,Mick Cornett,REP,140014,4,1,35,40,
Cleveland,Governor,Kevin Stitt,REP,140014,1,1,19,21,
Cleveland,Lieutenant Governor,Dana Murphy,REP,140014,2,1,23,26,
Cleveland,Lieutenant Governor,Matt Pinnell,REP,140014,3,1,31,35,
Cleveland,State Auditor,Cindy Byrd,REP,140014,5,1,33,39,
Cleveland,State Auditor,Charlie Prater,REP,140014,0,1,21,22,
Cleveland,Attorney General,Mike Hunter,REP,140014,2,1,30,33,
Cleveland,Attorney General,Gentner Drummond,REP,140014,3,0,24,27,
Cleveland,Superintendent of Public Instruction,Joy Hofmeister,REP,140014,4,1,23,28,
Cleveland,Superintendent of Public Instruction,Linda Murphy,REP,140014,1,1,29,31,
Cleveland,Commissioner of Labor,Cathy Costello,REP,140014,1,1,33,35,
Cleveland,Commissioner of Labor,Leslie Osborn,REP,140014,4,1,21,26,
Cleveland,Corporation Commissioner,Bob Anthony,REP,140014,3,2,23,28,
Cleveland,Corporation Commissioner,Brian Bingman,REP,140014,2,0,31,33,
Cleveland,Governor,Chris Powell,LIB,140014,0,0,2,2,
Cleveland,Governor,Rex Lawhorn,LIB,140014,0,0,1,1,
Cleveland,Corporation Commissioner,Ashley Nicole Mccray,DEM,140014,6,1,74,81,
Cleveland,Corporation Commissioner,Blake Cummings,DEM,140014,2,0,12,14,
Cleveland,U.S. House,Mary Brannon,DEM,140014,5,0,49,54,04
Cleveland,U.S. House,Fred Gipson,DEM,140014,4,2,39,45,04
Cleveland,State Senate,Mary Boren,DEM,140014,8,2,61,71,16
Cleveland,State Senate,Claudia Griffith,DEM,140014,1,0,24,25,16
Cleveland,Governor,Mick Cornett,REP,140015,4,4,78,86,
Cleveland,Governor,Kevin Stitt,REP,140015,2,2,52,56,
Cleveland,Lieutenant Governor,Dana Murphy,REP,140015,4,6,70,80,
Cleveland,Lieutenant Governor,Matt Pinnell,REP,140015,1,0,57,58,
Cleveland,State Auditor,Cindy Byrd,REP,140015,4,3,53,60,
Cleveland,State Auditor,Charlie Prater,REP,140015,1,3,66,70,
Cleveland,Attorney General,Mike Hunter,REP,140015,3,5,71,79,
Cleveland,Attorney General,Gentner Drummond,REP,140015,2,1,57,60,
Cleveland,Superintendent of Public Instruction,Joy Hofmeister,REP,140015,2,5,76,83,
Cleveland,Superintendent of Public Instruction,Linda Murphy,REP,140015,3,1,54,58,
Cleveland,Commissioner of Labor,Cathy Costello,REP,140015,3,2,60,65,
Cleveland,Commissioner of Labor,Leslie Osborn,REP,140015,2,4,65,71,
Cleveland,Corporation Commissioner,Bob Anthony,REP,140015,4,6,82,92,
Cleveland,Corporation Commissioner,Brian Bingman,REP,140015,1,0,43,44,
Cleveland,Governor,Chris Powell,LIB,140015,0,0,0,0,
Cleveland,Governor,Rex Lawhorn,LIB,140015,0,0,0,0,
Cleveland,Corporation Commissioner,Ashley Nicole Mccray,DEM,140015,6,8,168,182,
Cleveland,Corporation Commissioner,Blake Cummings,DEM,140015,2,3,29,34,
Cleveland,U.S. House,Mary Brannon,DEM,140015,3,7,77,87,04
Cleveland,U.S. House,Fred Gipson,DEM,140015,5,5,124,134,04
Cleveland,State Senate,Mary Boren,DEM,140015,8,12,174,194,16
Cleveland,State Senate,Claudia Griffith,DEM,140015,0,0,26,26,16
Cleveland,Governor,Mick Cornett,REP,140016,12,3,129,144,
Cleveland,Governor,Kevin Stitt,REP,140016,7,2,127,136,
Cleveland,Lieutenant Governor,Dana Murphy,REP,140016,6,1,111,118,
Cleveland,Lieutenant Governor,Matt Pinnell,REP,140016,13,3,142,158,
Cleveland,State Auditor,Cindy Byrd,REP,140016,13,3,99,115,
Cleveland,State Auditor,Charlie Prater,REP,140016,6,2,148,156,
Cleveland,Attorney General,Mike Hunter,REP,140016,12,5,136,153,
Cleveland,Attorney General,Gentner Drummond,REP,140016,7,0,114,121,
Cleveland,Superintendent of Public Instruction,Joy Hofmeister,REP,140016,5,4,129,138,
Cleveland,Superintendent of Public Instruction,Linda Murphy,REP,140016,14,0,120,134,
Cleveland,Commissioner of Labor,Cathy Costello,REP,140016,9,1,99,109,
Cleveland,Commissioner of Labor,Leslie Osborn,REP,140016,10,4,139,153,
Cleveland,Corporation Commissioner,Bob Anthony,REP,140016,16,3,153,172,
Cleveland,Corporation Commissioner,Brian Bingman,REP,140016,3,2,96,101,
Cleveland,Governor,Chris Powell,LIB,140016,0,0,1,1,
Cleveland,Governor,Rex Lawhorn,LIB,140016,0,0,0,0,
Cleveland,Corporation Commissioner,Ashley Nicole Mccray,DEM,140016,8,0,54,62,
Cleveland,Corporation Commissioner,Blake Cummings,DEM,140016,3,0,22,25,
Cleveland,U.S. House,Mary Brannon,DEM,140016,6,0,51,57,04
Cleveland,U.S. House,Fred Gipson,DEM,140016,5,0,25,30,04
Cleveland,Governor,Mick Cornett,REP,140017,1,1,54,56,
Cleveland,Governor,Kevin Stitt,REP,140017,4,4,74,82,
Cleveland,Lieutenant Governor,Dana Murphy,REP,140017,1,2,60,63,
Cleveland,Lieutenant Governor,Matt Pinnell,REP,140017,4,3,64,71,
Cleveland,State Auditor,Cindy Byrd,REP,140017,3,0,61,64,
Cleveland,State Auditor,Charlie Prater,REP,140017,2,5,62,69,
Cleveland,Attorney General,Mike Hunter,REP,140017,3,2,68,73,
Cleveland,Attorney General,Gentner Drummond,REP,140017,2,3,60,65,
Cleveland,Superintendent of Public Instruction,Joy Hofmeister,REP,140017,2,3,62,67,
Cleveland,Superintendent of Public Instruction,Linda Murphy,REP,140017,3,1,62,66,
Cleveland,Commissioner of Labor,Cathy Costello,REP,140017,4,0,59,63,
Cleveland,Commissioner of Labor,Leslie Osborn,REP,140017,1,4,64,69,
Cleveland,Corporation Commissioner,Bob Anthony,REP,140017,3,4,77,84,
Cleveland,Corporation Commissioner,Brian Bingman,REP,140017,2,1,46,49,
Cleveland,State House,Danny Sterling,REP,140017,2,0,49,51,27
Cleveland,State House,Dave Spaulding,REP,140017,3,5,73,81,27
Cleveland,Governor,Chris Powell,LIB,140017,0,0,0,0,
Cleveland,Governor,Rex Lawhorn,LIB,140017,0,0,0,0,
Cleveland,Corporation Commissioner,Ashley Nicole Mccray,DEM,140017,1,0,13,14,
Cleveland,Corporation Commissioner,Blake Cummings,DEM,140017,0,0,7,7,
Cleveland,U.S. House,Mary Brannon,DEM,140017,1,0,13,14,04
Cleveland,U.S. House,Fred Gipson,DEM,140017,0,0,7,7,04
Cleveland,Governor,Mick Cornett,REP,140018,0,3,65,68,
Cleveland,Governor,Kevin Stitt,REP,140018,3,0,35,38,
Cleveland,Lieutenant Governor,Dana Murphy,REP,140018,0,1,45,46,
Cleveland,Lieutenant Governor,Matt Pinnell,REP,140018,3,2,54,59,
Cleveland,State Auditor,Cindy Byrd,REP,140018,1,3,50,54,
Cleveland,State Auditor,Charlie Prater,REP,140018,2,0,47,49,
Cleveland,Attorney General,Mike Hunter,REP,140018,3,0,54,57,
Cleveland,Attorney General,Gentner Drummond,REP,140018,0,3,45,48,
Cleveland,Superintendent of Public Instruction,Joy Hofmeister,REP,140018,1,1,47,49,
Cleveland,Superintendent of Public Instruction,Linda Murphy,REP,140018,2,2,51,55,
Cleveland,Commissioner of Labor,Cathy Costello,REP,140018,2,0,47,49,
Cleveland,Commissioner of Labor,Leslie Osborn,REP,140018,1,3,50,54,
Cleveland,Corporation Commissioner,Bob Anthony,REP,140018,2,0,58,60,
Cleveland,Corporation Commissioner,Brian Bingman,REP,140018,1,3,41,45,
Cleveland,Governor,Chris Powell,LIB,140018,0,0,0,0,
Cleveland,Governor,Rex Lawhorn,LIB,140018,0,0,0,0,
Cleveland,Corporation Commissioner,Ashley Nicole Mccray,DEM,140018,7,6,134,147,
Cleveland,Corporation Commissioner,Blake Cummings,DEM,140018,0,3,24,27,
Cleveland,U.S. House,Mary Brannon,DEM,140018,5,5,85,95,04
Cleveland,U.S. House,Fred Gipson,DEM,140018,2,4,73,79,04
Cleveland,State Senate,Mary Boren,DEM,140018,5,5,140,150,16
Cleveland,State Senate,Claudia Griffith,DEM,140018,2,4,20,26,16
Cleveland,Governor,Mick Cornett,REP,140019,11,12,167,190,
Cleveland,Governor,Kevin Stitt,REP,140019,4,9,91,104,
Cleveland,Lieutenant Governor,Dana Murphy,REP,140019,12,14,115,141,
Cleveland,Lieutenant Governor,Matt Pinnell,REP,140019,3,7,138,148,
Cleveland,State Auditor,Cindy Byrd,REP,140019,9,14,121,144,
Cleveland,State Auditor,Charlie Prater,REP,140019,5,7,119,131,
Cleveland,Attorney General,Mike Hunter,REP,140019,9,11,134,154,
Cleveland,Attorney General,Gentner Drummond,REP,140019,5,10,116,131,
Cleveland,Superintendent of Public Instruction,Joy Hofmeister,REP,140019,10,15,158,183,
Cleveland,Superintendent of Public Instruction,Linda Murphy,REP,140019,5,6,95,106,
Cleveland,Commissioner of Labor,Cathy Costello,REP,140019,10,8,124,142,
Cleveland,Commissioner of Labor,Leslie Osborn,REP,140019,5,13,119,137,
Cleveland,Corporation Commissioner,Bob Anthony,REP,140019,10,17,140,167,
Cleveland,Corporation Commissioner,Brian Bingman,REP,140019,5,4,109,118,
Cleveland,Governor,Chris Powell,LIB,140019,0,0,0,0,
Cleveland,Governor,Rex Lawhorn,LIB,140019,0,0,2,2,
Cleveland,Corporation Commissioner,Ashley Nicole Mccray,DEM,140019,15,13,235,263,
Cleveland,Corporation Commissioner,Blake Cummings,DEM,140019,2,3,57,62,
Cleveland,U.S. House,Mary Brannon,DEM,140019,9,9,153,171,04
Cleveland,U.S. House,Fred Gipson,DEM,140019,8,7,141,156,04
Cleveland,State Senate,Mary Boren,DEM,140019,13,12,248,273,16
Cleveland,State Senate,Claudia Griffith,DEM,140019,4,4,46,54,16
Cleveland,Governor,Mick Cornett,REP,140020,21,46,233,300,
Cleveland,Governor,Kevin Stitt,REP,140020,22,37,245,304,
Cleveland,Lieutenant Governor,Dana Murphy,REP,140020,29,29,209,267,
Cleveland,Lieutenant Governor,Matt Pinnell,REP,140020,13,50,255,318,
Cleveland,State Auditor,Cindy Byrd,REP,140020,33,33,226,292,
Cleveland,State Auditor,Charlie Prater,REP,140020,8,45,220,273,
Cleveland,Attorney General,Mike Hunter,REP,140020,26,51,263,340,
Cleveland,Attorney General,Gentner Drummond,REP,140020,14,29,206,249,
Cleveland,Superintendent of Public Instruction,Joy Hofmeister,REP,140020,25,44,282,351,
Cleveland,Superintendent of Public Instruction,Linda Murphy,REP,140020,17,35,184,236,
Cleveland,Commissioner of Labor,Cathy Costello,REP,140020,23,29,219,271,
Cleveland,Commissioner of Labor,Leslie Osborn,REP,140020,18,50,239,307,
Cleveland,Corporation Commissioner,Bob Anthony,REP,140020,29,40,284,353,
Cleveland,Corporation Commissioner,Brian Bingman,REP,140020,13,39,174,226,
Cleveland,Governor,Chris Powell,LIB,140020,1,0,0,1,
Cleveland,Governor,Rex Lawhorn,LIB,140020,0,0,0,0,
Cleveland,Corporation Commissioner,Ashley Nicole Mccray,DEM,140020,12,6,57,75,
Cleveland,Corporation Commissioner,Blake Cummings,DEM,140020,4,3,14,21,
Cleveland,U.S. House,Mary Brannon,DEM,140020,9,5,50,64,04
Cleveland,U.S. House,Fred Gipson,DEM,140020,8,4,21,33,04
Cleveland,Governor,Mick Cornett,REP,140021,2,3,49,54,
Cleveland,Governor,Kevin Stitt,REP,140021,4,2,86,92,
Cleveland,Lieutenant Governor,Dana Murphy,REP,140021,2,1,42,45,
Cleveland,Lieutenant Governor,Matt Pinnell,REP,140021,4,4,93,101,
Cleveland,State Auditor,Cindy Byrd,REP,140021,3,1,42,46,
Cleveland,State Auditor,Charlie Prater,REP,140021,3,4,94,101,
Cleveland,Attorney General,Mike Hunter,REP,140021,4,2,61,67,
Cleveland,Attorney General,Gentner Drummond,REP,140021,2,3,74,79,
Cleveland,Superintendent of Public Instruction,Joy Hofmeister,REP,140021,1,1,72,74,
Cleveland,Superintendent of Public Instruction,Linda Murphy,REP,140021,5,4,62,71,
Cleveland,Commissioner of Labor,Cathy Costello,REP,140021,1,1,69,71,
Cleveland,Commissioner of Labor,Leslie Osborn,REP,140021,5,4,66,75,
Cleveland,Corporation Commissioner,Bob Anthony,REP,140021,2,4,64,70,
Cleveland,Corporation Commissioner,Brian Bingman,REP,140021,4,1,72,77,
Cleveland,Governor,Chris Powell,LIB,140021,0,0,1,1,
Cleveland,Governor,Rex Lawhorn,LIB,140021,0,0,0,0,
Cleveland,Corporation Commissioner,Ashley Nicole Mccray,DEM,140021,4,0,42,46,
Cleveland,Corporation Commissioner,Blake Cummings,DEM,140021,4,0,18,22,
Cleveland,U.S. House,Mary Brannon,DEM,140021,6,0,33,39,04
Cleveland,U.S. House,Fred Gipson,DEM,140021,2,0,28,30,04
Cleveland,State House,Leslie Bonebreak,DEM,140021,4,0,40,44,53
Cleveland,State House,Cyndy Southerland,DEM,140021,4,0,23,27,53
Cleveland,Governor,Mick Cornett,REP,140022,28,12,203,243,
Cleveland,Governor,Kevin Stitt,REP,140022,20,11,201,232,
Cleveland,Lieutenant Governor,Dana Murphy,REP,140022,21,11,169,201,
Cleveland,Lieutenant Governor,Matt Pinnell,REP,140022,24,10,232,266,
Cleveland,State Auditor,Cindy Byrd,REP,140022,29,9,191,229,
Cleveland,State Auditor,Charlie Prater,REP,140022,16,11,201,228,
Cleveland,Attorney General,Mike Hunter,REP,140022,23,7,203,233,
Cleveland,Attorney General,Gentner Drummond,REP,140022,24,13,197,234,
Cleveland,Superintendent of Public Instruction,Joy Hofmeister,REP,140022,27,14,209,250,
Cleveland,Superintendent of Public Instruction,Linda Murphy,REP,140022,18,7,186,211,
Cleveland,Commissioner of Labor,Cathy Costello,REP,140022,29,8,181,218,
Cleveland,Commissioner of Labor,Leslie Osborn,REP,140022,16,11,211,238,
Cleveland,Corporation Commissioner,Bob Anthony,REP,140022,32,13,226,271,
Cleveland,Corporation Commissioner,Brian Bingman,REP,140022,16,8,167,191,
Cleveland,Governor,Chris Powell,LIB,140022,0,0,0,0,
Cleveland,Governor,Rex Lawhorn,LIB,140022,0,0,1,1,
Cleveland,Corporation Commissioner,Ashley Nicole Mccray,DEM,140022,12,10,97,119,
Cleveland,Corporation Commissioner,Blake Cummings,DEM,140022,7,2,23,32,
Cleveland,U.S. House,Mary Brannon,DEM,140022,15,6,87,108,04
Cleveland,U.S. House,Fred Gipson,DEM,140022,4,5,34,43,04
Cleveland,State House,Leslie Bonebreak,DEM,140022,13,6,77,96,53
Cleveland,State House,Cyndy Southerland,DEM,140022,6,6,44,56,53
Cleveland,Governor,Mick Cornett,REP,140024,31,28,224,283,
Cleveland,Governor,Kevin Stitt,REP,140024,34,10,251,295,
Cleveland,Lieutenant Governor,Dana Murphy,REP,140024,38,18,216,272,
Cleveland,Lieutenant Governor,Matt Pinnell,REP,140024,27,19,248,294,
Cleveland,State Auditor,Cindy Byrd,REP,140024,44,23,255,322,
Cleveland,State Auditor,Charlie Prater,REP,140024,20,15,202,237,
Cleveland,Attorney General,Mike Hunter,REP,140024,42,23,224,289,
Cleveland,Attorney General,Gentner Drummond,REP,140024,23,15,243,281,
Cleveland,Superintendent of Public Instruction,Joy Hofmeister,REP,140024,40,23,266,329,
Cleveland,Superintendent of Public Instruction,Linda Murphy,REP,140024,26,15,200,241,
Cleveland,Commissioner of Labor,Cathy Costello,REP,140024,24,15,200,239,
Cleveland,Commissioner of Labor,Leslie Osborn,REP,140024,42,23,263,328,
Cleveland,Corporation Commissioner,Bob Anthony,REP,140024,36,26,270,332,
Cleveland,Corporation Commissioner,Brian Bingman,REP,140024,30,11,195,236,
Cleveland,Governor,Chris Powell,LIB,140024,0,0,1,1,
Cleveland,Governor,Rex Lawhorn,LIB,140024,0,0,1,1,
Cleveland,Corporation Commissioner,Ashley Nicole Mccray,DEM,140024,20,4,143,167,
Cleveland,Corporation Commissioner,Blake Cummings,DEM,140024,17,5,45,67,
Cleveland,U.S. House,Mary Brannon,DEM,140024,24,2,122,148,04
Cleveland,U.S. House,Fred Gipson,DEM,140024,13,7,64,84,04
Cleveland,State House,Leslie Bonebreak,DEM,140024,20,3,116,139,53
Cleveland,State House,Cyndy Southerland,DEM,140024,17,6,74,97,53
Cleveland,Governor,Mick Cornett,REP,140025,5,6,68,79,
Cleveland,Governor,Kevin Stitt,REP,140025,5,4,129,138,
Cleveland,Lieutenant Governor,Dana Murphy,REP,140025,5,3,72,80,
Cleveland,Lieutenant Governor,Matt Pinnell,REP,140025,5,7,123,135,
Cleveland,State Auditor,Cindy Byrd,REP,140025,8,3,95,106,
Cleveland,State Auditor,Charlie Prater,REP,140025,2,7,98,107,
Cleveland,Attorney General,Mike Hunter,REP,140025,5,4,93,102,
Cleveland,Attorney General,Gentner Drummond,REP,140025,5,6,103,114,
Cleveland,Superintendent of Public Instruction,Joy Hofmeister,REP,140025,4,7,104,115,
Cleveland,Superintendent of Public Instruction,Linda Murphy,REP,140025,6,3,89,98,
Cleveland,Commissioner of Labor,Cathy Costello,REP,140025,4,3,91,98,
Cleveland,Commissioner of Labor,Leslie Osborn,REP,140025,6,7,103,116,
Cleveland,Corporation Commissioner,Bob Anthony,REP,140025,8,8,97,113,
Cleveland,Corporation Commissioner,Brian Bingman,REP,140025,2,2,98,102,
Cleveland,Governor,Chris Powell,LIB,140025,0,0,0,0,
Cleveland,Governor,Rex Lawhorn,LIB,140025,0,0,0,0,
Cleveland,Corporation Commissioner,Ashley Nicole Mccray,DEM,140025,1,1,42,44,
Cleveland,Corporation Commissioner,Blake Cummings,DEM,140025,1,0,22,23,
Cleveland,U.S. House,Mary Brannon,DEM,140025,0,1,33,34,04
Cleveland,U.S. House,Fred Gipson,DEM,140025,2,0,31,33,04
Cleveland,Governor,Mick Cornett,REP,140026,8,18,151,177,
Cleveland,Governor,Kevin Stitt,REP,140026,5,18,80,103,
Cleveland,Lieutenant Governor,Dana Murphy,REP,140026,6,10,101,117,
Cleveland,Lieutenant Governor,Matt Pinnell,REP,140026,7,25,117,149,
Cleveland,State Auditor,Cindy Byrd,REP,140026,10,17,114,141,
Cleveland,State Auditor,Charlie Prater,REP,140026,3,18,97,118,
Cleveland,Attorney General,Mike Hunter,REP,140026,8,17,127,152,
Cleveland,Attorney General,Gentner Drummond,REP,140026,5,19,97,121,
Cleveland,Superintendent of Public Instruction,Joy Hofmeister,REP,140026,8,21,125,154,
Cleveland,Superintendent of Public Instruction,Linda Murphy,REP,140026,5,14,94,113,
Cleveland,Commissioner of Labor,Cathy Costello,REP,140026,3,12,103,118,
Cleveland,Commissioner of Labor,Leslie Osborn,REP,140026,10,23,113,146,
Cleveland,Corporation Commissioner,Bob Anthony,REP,140026,9,28,138,175,
Cleveland,Corporation Commissioner,Brian Bingman,REP,140026,4,8,79,91,
Cleveland,Governor,Chris Powell,LIB,140026,0,2,2,4,
Cleveland,Governor,Rex Lawhorn,LIB,140026,0,1,0,1,
Cleveland,Corporation Commissioner,Ashley Nicole Mccray,DEM,140026,10,17,126,153,
Cleveland,Corporation Commissioner,Blake Cummings,DEM,140026,1,2,28,31,
Cleveland,U.S. House,Mary Brannon,DEM,140026,4,8,84,96,04
Cleveland,U.S. House,Fred Gipson,DEM,140026,8,11,72,91,04
Cleveland,Governor,Mick Cornett,REP,140027,27,22,351,400,
Cleveland,Governor,Kevin Stitt,REP,140027,27,27,182,236,
Cleveland,Lieutenant Governor,Dana Murphy,REP,140027,29,20,247,296,
Cleveland,Lieutenant Governor,Matt Pinnell,REP,140027,24,27,266,317,
Cleveland,State Auditor,Cindy Byrd,REP,140027,23,20,278,321,
Cleveland,State Auditor,Charlie Prater,REP,140027,27,23,213,263,
Cleveland,Attorney General,Mike Hunter,REP,140027,34,35,323,392,
Cleveland,Attorney General,Gentner Drummond,REP,140027,18,13,197,228,
Cleveland,Superintendent of Public Instruction,Joy Hofmeister,REP,140027,35,37,334,406,
Cleveland,Superintendent of Public Instruction,Linda Murphy,REP,140027,16,9,181,206,
Cleveland,Commissioner of Labor,Cathy Costello,REP,140027,26,23,249,298,
Cleveland,Commissioner of Labor,Leslie Osborn,REP,140027,24,21,254,299,
Cleveland,Corporation Commissioner,Bob Anthony,REP,140027,40,30,321,391,
Cleveland,Corporation Commissioner,Brian Bingman,REP,140027,12,16,187,215,
Cleveland,Governor,Chris Powell,LIB,140027,0,0,1,1,
Cleveland,Governor,Rex Lawhorn,LIB,140027,0,0,0,0,
Cleveland,Corporation Commissioner,Ashley Nicole Mccray,DEM,140027,27,7,101,135,
Cleveland,Corporation Commissioner,Blake Cummings,DEM,140027,6,5,43,54,
Cleveland,U.S. House,Mary Brannon,DEM,140027,12,1,49,62,04
Cleveland,U.S. House,Fred Gipson,DEM,140027,20,14,99,133,04
Cleveland,Governor,Mick Cornett,REP,140028,3,11,94,108,
Cleveland,Governor,Kevin Stitt,REP,140028,2,3,71,76,
Cleveland,Lieutenant Governor,Dana Murphy,REP,140028,2,12,67,81,
Cleveland,Lieutenant Governor,Matt Pinnell,REP,140028,3,2,93,98,
Cleveland,State Auditor,Cindy Byrd,REP,140028,2,7,83,92,
Cleveland,State Auditor,Charlie Prater,REP,140028,3,6,73,82,
Cleveland,Attorney General,Mike Hunter,REP,140028,1,6,85,92,
Cleveland,Attorney General,Gentner Drummond,REP,140028,4,8,77,89,
Cleveland,Superintendent of Public Instruction,Joy Hofmeister,REP,140028,2,7,82,91,
Cleveland,Superintendent of Public Instruction,Linda Murphy,REP,140028,3,7,76,86,
Cleveland,Commissioner of Labor,Cathy Costello,REP,140028,4,6,73,83,
Cleveland,Commissioner of Labor,Leslie Osborn,REP,140028,1,8,85,94,
Cleveland,Corporation Commissioner,Bob Anthony,REP,140028,4,6,102,112,
Cleveland,Corporation Commissioner,Brian Bingman,REP,140028,1,8,58,67,
Cleveland,Governor,Chris Powell,LIB,140028,0,0,2,2,
Cleveland,Governor,Rex Lawhorn,LIB,140028,0,0,0,0,
Cleveland,Corporation Commissioner,Ashley Nicole Mccray,DEM,140028,15,7,138,160,
Cleveland,Corporation Commissioner,Blake Cummings,DEM,140028,1,4,30,35,
Cleveland,U.S. House,Mary Brannon,DEM,140028,10,6,103,119,04
Cleveland,U.S. House,Fred Gipson,DEM,140028,6,5,67,78,04
Cleveland,State Senate,Mary Boren,DEM,140028,15,6,131,152,16
Cleveland,State Senate,Claudia Griffith,DEM,140028,1,5,40,46,16
Cleveland,Governor,Mick Cornett,REP,140029,9,12,188,209,
Cleveland,Governor,Kevin Stitt,REP,140029,12,0,192,204,
Cleveland,Lieutenant Governor,Dana Murphy,REP,140029,10,3,154,167,
Cleveland,Lieutenant Governor,Matt Pinnell,REP,140029,11,8,212,231,
Cleveland,State Auditor,Cindy Byrd,REP,140029,15,6,177,198,
Cleveland,State Auditor,Charlie Prater,REP,140029,6,6,185,197,
Cleveland,Attorney General,Mike Hunter,REP,140029,7,4,165,176,
Cleveland,Attorney General,Gentner Drummond,REP,140029,14,8,207,229,
Cleveland,Superintendent of Public Instruction,Joy Hofmeister,REP,140029,6,9,209,224,
Cleveland,Superintendent of Public Instruction,Linda Murphy,REP,140029,15,3,165,183,
Cleveland,Commissioner of Labor,Cathy Costello,REP,140029,12,6,146,164,
Cleveland,Commissioner of Labor,Leslie Osborn,REP,140029,8,6,214,228,
Cleveland,Corporation Commissioner,Bob Anthony,REP,140029,11,9,191,211,
Cleveland,Corporation Commissioner,Brian Bingman,REP,140029,10,3,171,184,
Cleveland,State House,Bobby Cleveland,REP,140029,8,7,151,166,20
Cleveland,State House,Sherrie Conley,REP,140029,13,4,228,245,20
Cleveland,Governor,Chris Powell,LIB,140029,0,0,0,0,
Cleveland,Governor,Rex Lawhorn,LIB,140029,0,0,0,0,
Cleveland,Corporation Commissioner,Ashley Nicole Mccray,DEM,140029,3,5,63,71,
Cleveland,Corporation Commissioner,Blake Cummings,DEM,140029,6,2,53,61,
Cleveland,U.S. House,Mary Brannon,DEM,140029,6,4,58,68,04
Cleveland,U.S. House,Fred Gipson,DEM,140029,4,3,58,65,04
Cleveland,State Senate,Mary Boren,DEM,140029,8,6,79,93,16
Cleveland,State Senate,Claudia Griffith,DEM,140029,1,1,40,42,16
Cleveland,Governor,Mick Cornett,REP,140030,4,7,88,99,
Cleveland,Governor,Kevin Stitt,REP,140030,1,4,95,100,
Cleveland,Lieutenant Governor,Dana Murphy,REP,140030,5,3,81,89,
Cleveland,Lieutenant Governor,Matt Pinnell,REP,140030,0,8,97,105,
Cleveland,State Auditor,Cindy Byrd,REP,140030,4,4,98,106,
Cleveland,State Auditor,Charlie Prater,REP,140030,1,7,77,85,
Cleveland,Attorney General,Mike Hunter,REP,140030,3,7,87,97,
Cleveland,Attorney General,Gentner Drummond,REP,140030,2,4,91,97,
Cleveland,Superintendent of Public Instruction,Joy Hofmeister,REP,140030,5,8,98,111,
Cleveland,Superintendent of Public Instruction,Linda Murphy,REP,140030,0,2,81,83,
Cleveland,Commissioner of Labor,Cathy Costello,REP,140030,3,1,84,88,
Cleveland,Commissioner of Labor,Leslie Osborn,REP,140030,2,9,91,102,
Cleveland,Corporation Commissioner,Bob Anthony,REP,140030,1,9,75,85,
Cleveland,Corporation Commissioner,Brian Bingman,REP,140030,4,2,98,104,
Cleveland,Governor,Chris Powell,LIB,140030,0,0,0,0,
Cleveland,Governor,Rex Lawhorn,LIB,140030,0,0,1,1,
Cleveland,Corporation Commissioner,Ashley Nicole Mccray,DEM,140030,8,12,67,87,
Cleveland,Corporation Commissioner,Blake Cummings,DEM,140030,0,3,28,31,
Cleveland,U.S. House,Mary Brannon,DEM,140030,6,3,42,51,04
Cleveland,U.S. House,Fred Gipson,DEM,140030,2,12,56,70,04
Cleveland,State Senate,Mary Boren,DEM,140030,6,13,74,93,16
Cleveland,State Senate,Claudia Griffith,DEM,140030,1,2,21,24,16
Cleveland,Governor,Mick Cornett,REP,140032,6,2,82,90,
Cleveland,Governor,Kevin Stitt,REP,140032,4,0,56,60,
Cleveland,Lieutenant Governor,Dana Murphy,REP,140032,3,1,64,68,
Cleveland,Lieutenant Governor,Matt Pinnell,REP,140032,7,1,72,80,
Cleveland,State Auditor,Cindy Byrd,REP,140032,7,1,65,73,
Cleveland,State Auditor,Charlie Prater,REP,140032,3,1,65,69,
Cleveland,Attorney General,Mike Hunter,REP,140032,4,2,66,72,
Cleveland,Attorney General,Gentner Drummond,REP,140032,5,0,68,73,
Cleveland,Superintendent of Public Instruction,Joy Hofmeister,REP,140032,3,2,68,73,
Cleveland,Superintendent of Public Instruction,Linda Murphy,REP,140032,7,0,68,75,
Cleveland,Commissioner of Labor,Cathy Costello,REP,140032,4,0,80,84,
Cleveland,Commissioner of Labor,Leslie Osborn,REP,140032,6,2,52,60,
Cleveland,Corporation Commissioner,Bob Anthony,REP,140032,4,1,73,78,
Cleveland,Corporation Commissioner,Brian Bingman,REP,140032,6,1,60,67,
Cleveland,Governor,Chris Powell,LIB,140032,0,0,1,1,
Cleveland,Governor,Rex Lawhorn,LIB,140032,0,0,0,0,
Cleveland,Corporation Commissioner,Ashley Nicole Mccray,DEM,140032,9,9,127,145,
Cleveland,Corporation Commissioner,Blake Cummings,DEM,140032,1,4,17,22,
Cleveland,U.S. House,Mary Brannon,DEM,140032,5,8,95,108,04
Cleveland,U.S. House,Fred Gipson,DEM,140032,5,5,49,59,04
Cleveland,State Senate,Mary Boren,DEM,140032,6,7,112,125,16
Cleveland,State Senate,Claudia Griffith,DEM,140032,4,6,29,39,16
Cleveland,Governor,Mick Cornett,REP,140034,7,3,173,183,
Cleveland,Governor,Kevin Stitt,REP,140034,9,3,244,256,
Cleveland,Lieutenant Governor,Dana Murphy,REP,140034,7,5,180,192,
Cleveland,Lieutenant Governor,Matt Pinnell,REP,140034,8,0,233,241,
Cleveland,State Auditor,Cindy Byrd,REP,140034,11,3,193,207,
Cleveland,State Auditor,Charlie Prater,REP,140034,4,2,218,224,
Cleveland,Attorney General,Mike Hunter,REP,140034,5,4,204,213,
Cleveland,Attorney General,Gentner Drummond,REP,140034,11,2,204,217,
Cleveland,Superintendent of Public Instruction,Joy Hofmeister,REP,140034,6,5,234,245,
Cleveland,Superintendent of Public Instruction,Linda Murphy,REP,140034,9,1,177,187,
Cleveland,Commissioner of Labor,Cathy Costello,REP,140034,5,3,199,207,
Cleveland,Commissioner of Labor,Leslie Osborn,REP,140034,10,2,207,219,
Cleveland,Corporation Commissioner,Bob Anthony,REP,140034,7,2,211,220,
Cleveland,Corporation Commissioner,Brian Bingman,REP,140034,8,4,198,210,
Cleveland,State House,Bobby Cleveland,REP,140034,3,3,201,207,20
Cleveland,State House,Sherrie Conley,REP,140034,13,3,217,233,20
Cleveland,Governor,Chris Powell,LIB,140034,0,0,0,0,
Cleveland,Governor,Rex Lawhorn,LIB,140034,0,0,0,0,
Cleveland,Corporation Commissioner,Ashley Nicole Mccray,DEM,140034,4,1,70,75,
Cleveland,Corporation Commissioner,Blake Cummings,DEM,140034,4,0,57,61,
Cleveland,U.S. House,Mary Brannon,DEM,140034,5,0,76,81,04
Cleveland,U.S. House,Fred Gipson,DEM,140034,3,1,51,55,04
Cleveland,State Senate,Mary Boren,DEM,140034,8,0,82,90,16
Cleveland,State Senate,Claudia Griffith,DEM,140034,0,1,45,46,16
Cleveland,Governor,Mick Cornett,REP,140035,7,5,155,167,
Cleveland,Governor,Kevin Stitt,REP,140035,4,4,101,109,
Cleveland,Lieutenant Governor,Dana Murphy,REP,140035,7,2,118,127,
Cleveland,Lieutenant Governor,Matt Pinnell,REP,140035,4,7,126,137,
Cleveland,State Auditor,Cindy Byrd,REP,140035,6,6,125,137,
Cleveland,State Auditor,Charlie Prater,REP,140035,3,3,114,120,
Cleveland,Attorney General,Mike Hunter,REP,140035,7,6,143,156,
Cleveland,Attorney General,Gentner Drummond,REP,140035,4,2,101,107,
Cleveland,Superintendent of Public Instruction,Joy Hofmeister,REP,140035,5,4,156,165,
Cleveland,Superintendent of Public Instruction,Linda Murphy,REP,140035,5,4,84,93,
Cleveland,Commissioner of Labor,Cathy Costello,REP,140035,3,6,99,108,
Cleveland,Commissioner of Labor,Leslie Osborn,REP,140035,3,3,138,144,
Cleveland,Corporation Commissioner,Bob Anthony,REP,140035,6,7,147,160,
Cleveland,Corporation Commissioner,Brian Bingman,REP,140035,2,2,96,100,
Cleveland,Governor,Chris Powell,LIB,140035,0,0,0,0,
Cleveland,Governor,Rex Lawhorn,LIB,140035,0,0,1,1,
Cleveland,Corporation Commissioner,Ashley Nicole Mccray,DEM,140035,11,3,92,106,
Cleveland,Corporation Commissioner,Blake Cummings,DEM,140035,1,1,24,26,
Cleveland,U.S. House,Mary Brannon,DEM,140035,4,0,44,48,04
Cleveland,U.S. House,Fred Gipson,DEM,140035,8,4,74,86,04
Cleveland,Governor,Mick Cornett,REP,140036,6,11,101,118,
Cleveland,Governor,Kevin Stitt,REP,140036,5,10,161,176,
Cleveland,Lieutenant Governor,Dana Murphy,REP,140036,5,6,109,120,
Cleveland,Lieutenant Governor,Matt Pinnell,REP,140036,6,15,145,166,
Cleveland,State Auditor,Cindy Byrd,REP,140036,5,11,132,148,
Cleveland,State Auditor,Charlie Prater,REP,140036,5,10,116,131,
Cleveland,Attorney General,Mike Hunter,REP,140036,9,11,110,130,
Cleveland,Attorney General,Gentner Drummond,REP,140036,2,10,142,154,
Cleveland,Superintendent of Public Instruction,Joy Hofmeister,REP,140036,6,14,130,150,
Cleveland,Superintendent of Public Instruction,Linda Murphy,REP,140036,4,7,124,135,
Cleveland,Commissioner of Labor,Cathy Costello,REP,140036,3,10,123,136,
Cleveland,Commissioner of Labor,Leslie Osborn,REP,140036,7,11,129,147,
Cleveland,Corporation Commissioner,Bob Anthony,REP,140036,9,15,134,158,
Cleveland,Corporation Commissioner,Brian Bingman,REP,140036,2,6,113,121,
Cleveland,State House,Danny Sterling,REP,140036,2,5,89,96,27
Cleveland,State House,Dave Spaulding,REP,140036,9,16,167,192,27
Cleveland,Governor,Chris Powell,LIB,140036,0,0,0,0,
Cleveland,Governor,Rex Lawhorn,LIB,140036,0,0,0,0,
Cleveland,Corporation Commissioner,Ashley Nicole Mccray,DEM,140036,9,3,26,38,
Cleveland,Corporation Commissioner,Blake Cummings,DEM,140036,2,1,13,16,
Cleveland,U.S. House,Mary Brannon,DEM,140036,7,2,22,31,04
Cleveland,U.S. House,Fred Gipson,DEM,140036,4,2,16,22,04
Cleveland,Governor,Mick Cornett,REP,140037,9,2,72,83,
Cleveland,Governor,Kevin Stitt,REP,140037,3,0,94,97,
Cleveland,Lieutenant Governor,Dana Murphy,REP,140037,8,0,61,69,
Cleveland,Lieutenant Governor,Matt Pinnell,REP,140037,4,2,100,106,
Cleveland,State Auditor,Cindy Byrd,REP,140037,9,1,94,104,
Cleveland,State Auditor,Charlie Prater,REP,140037,3,1,65,69,
Cleveland,Attorney General,Mike Hunter,REP,140037,4,2,72,78,
Cleveland,Attorney General,Gentner Drummond,REP,140037,8,0,89,97,
Cleveland,Superintendent of Public Instruction,Joy Hofmeister,REP,140037,8,2,93,103,
Cleveland,Superintendent of Public Instruction,Linda Murphy,REP,140037,4,0,70,74,
Cleveland,Commissioner of Labor,Cathy Costello,REP,140037,8,0,82,90,
Cleveland,Commissioner of Labor,Leslie Osborn,REP,140037,4,2,75,81,
Cleveland,Corporation Commissioner,Bob Anthony,REP,140037,7,2,91,100,
Cleveland,Corporation Commissioner,Brian Bingman,REP,140037,5,0,64,69,
Cleveland,Governor,Chris Powell,LIB,140037,0,0,1,1,
Cleveland,Governor,Rex Lawhorn,LIB,140037,0,0,3,3,
Cleveland,Corporation Commissioner,Ashley Nicole Mccray,DEM,140037,1,1,30,32,
Cleveland,Corporation Commissioner,Blake Cummings,DEM,140037,1,0,8,9,
Cleveland,U.S. House,Mary Brannon,DEM,140037,2,1,30,33,04
Cleveland,U.S. House,Fred Gipson,DEM,140037,0,0,8,8,04
Cleveland,Governor,Mick Cornett,REP,140038,0,3,119,122,
Cleveland,Governor,Kevin Stitt,REP,140038,6,3,150,159,
Cleveland,Lieutenant Governor,Dana Murphy,REP,140038,1,2,112,115,
Cleveland,Lieutenant Governor,Matt Pinnell,REP,140038,5,4,156,165,
Cleveland,State Auditor,Cindy Byrd,REP,140038,2,1,135,138,
Cleveland,State Auditor,Charlie Prater,REP,140038,4,5,130,139,
Cleveland,Attorney General,Mike Hunter,REP,140038,3,6,118,127,
Cleveland,Attorney General,Gentner Drummond,REP,140038,3,0,148,151,
Cleveland,Superintendent of Public Instruction,Joy Hofmeister,REP,140038,2,3,127,132,
Cleveland,Superintendent of Public Instruction,Linda Murphy,REP,140038,4,3,140,147,
Cleveland,Commissioner of Labor,Cathy Costello,REP,140038,4,3,109,116,
Cleveland,Commissioner of Labor,Leslie Osborn,REP,140038,2,3,153,158,
Cleveland,Corporation Commissioner,Bob Anthony,REP,140038,5,2,127,134,
Cleveland,Corporation Commissioner,Brian Bingman,REP,140038,1,4,137,142,
Cleveland,State House,Bobby Cleveland,REP,140038,6,5,123,134,20
Cleveland,State House,Sherrie Conley,REP,140038,0,1,141,142,20
Cleveland,Governor,Chris Powell,LIB,140038,0,0,2,2,
Cleveland,Governor,Rex Lawhorn,LIB,140038,0,0,2,2,
Cleveland,Corporation Commissioner,Ashley Nicole Mccray,DEM,140038,3,2,55,60,
Cleveland,Corporation Commissioner,Blake Cummings,DEM,140038,3,0,21,24,
Cleveland,U.S. House,Mary Brannon,DEM,140038,3,1,45,49,04
Cleveland,U.S. House,Fred Gipson,DEM,140038,3,1,30,34,04
Cleveland,Governor,Mick Cornett,REP,140039,8,6,136,150,
Cleveland,Governor,Kevin Stitt,REP,140039,8,6,78,92,
Cleveland,Lieutenant Governor,Dana Murphy,REP,140039,8,3,103,114,
Cleveland,Lieutenant Governor,Matt Pinnell,REP,140039,6,9,105,120,
Cleveland,State Auditor,Cindy Byrd,REP,140039,6,5,101,112,
Cleveland,State Auditor,Charlie Prater,REP,140039,9,7,103,119,
Cleveland,Attorney General,Mike Hunter,REP,140039,12,6,111,129,
Cleveland,Attorney General,Gentner Drummond,REP,140039,4,6,98,108,
Cleveland,Superintendent of Public Instruction,Joy Hofmeister,REP,140039,8,6,114,128,
Cleveland,Superintendent of Public Instruction,Linda Murphy,REP,140039,8,6,94,108,
Cleveland,Commissioner of Labor,Cathy Costello,REP,140039,7,9,96,112,
Cleveland,Commissioner of Labor,Leslie Osborn,REP,140039,7,3,107,117,
Cleveland,Corporation Commissioner,Bob Anthony,REP,140039,9,9,121,139,
Cleveland,Corporation Commissioner,Brian Bingman,REP,140039,7,3,89,99,
Cleveland,Governor,Chris Powell,LIB,140039,0,0,1,1,
Cleveland,Governor,Rex Lawhorn,LIB,140039,0,0,0,0,
Cleveland,Corporation Commissioner,Ashley Nicole Mccray,DEM,140039,25,3,111,139,
Cleveland,Corporation Commissioner,Blake Cummings,DEM,140039,5,0,24,29,
Cleveland,U.S. House,Mary Brannon,DEM,140039,15,0,64,79,04
Cleveland,U.S. House,Fred Gipson,DEM,140039,15,3,70,88,04
Cleveland,Governor,Mick Cornett,REP,140040,11,11,145,167,
Cleveland,Governor,Kevin Stitt,REP,140040,8,2,161,171,
Cleveland,Lieutenant Governor,Dana Murphy,REP,140040,11,3,142,156,
Cleveland,Lieutenant Governor,Matt Pinnell,REP,140040,8,9,160,177,
Cleveland,State Auditor,Cindy Byrd,REP,140040,12,8,153,173,
Cleveland,State Auditor,Charlie Prater,REP,140040,7,6,136,149,
Cleveland,Attorney General,Mike Hunter,REP,140040,7,6,162,175,
Cleveland,Attorney General,Gentner Drummond,REP,140040,12,8,140,160,
Cleveland,Superintendent of Public Instruction,Joy Hofmeister,REP,140040,7,9,180,196,
Cleveland,Superintendent of Public Instruction,Linda Murphy,REP,140040,11,2,124,137,
Cleveland,Commissioner of Labor,Cathy Costello,REP,140040,7,0,142,149,
Cleveland,Commissioner of Labor,Leslie Osborn,REP,140040,12,10,156,178,
Cleveland,Corporation Commissioner,Bob Anthony,REP,140040,10,9,169,188,
Cleveland,Corporation Commissioner,Brian Bingman,REP,140040,9,4,133,146,
Cleveland,Governor,Chris Powell,LIB,140040,0,0,0,0,
Cleveland,Governor,Rex Lawhorn,LIB,140040,0,0,0,0,
Cleveland,Corporation Commissioner,Ashley Nicole Mccray,DEM,140040,3,2,59,64,
Cleveland,Corporation Commissioner,Blake Cummings,DEM,140040,0,1,9,10,
Cleveland,U.S. House,Mary Brannon,DEM,140040,2,2,49,53,04
Cleveland,U.S. House,Fred Gipson,DEM,140040,1,1,17,19,04
Cleveland,Governor,Mick Cornett,REP,140041,1,0,56,57,
Cleveland,Governor,Kevin Stitt,REP,140041,0,0,56,56,
Cleveland,Lieutenant Governor,Dana Murphy,REP,140041,1,0,54,55,
Cleveland,Lieutenant Governor,Matt Pinnell,REP,140041,0,0,58,58,
Cleveland,State Auditor,Cindy Byrd,REP,140041,1,0,53,54,
Cleveland,State Auditor,Charlie Prater,REP,140041,0,0,54,54,
Cleveland,Attorney General,Mike Hunter,REP,140041,1,0,66,67,
Cleveland,Attorney General,Gentner Drummond,REP,140041,0,0,47,47,
Cleveland,Superintendent of Public Instruction,Joy Hofmeister,REP,140041,1,0,72,73,
Cleveland,Superintendent of Public Instruction,Linda Murphy,REP,140041,0,0,41,41,
Cleveland,Commissioner of Labor,Cathy Costello,REP,140041,1,0,59,60,
Cleveland,Commissioner of Labor,Leslie Osborn,REP,140041,0,0,51,51,
Cleveland,Corporation Commissioner,Bob Anthony,REP,140041,1,0,64,65,
Cleveland,Corporation Commissioner,Brian Bingman,REP,140041,0,0,44,44,
Cleveland,Governor,Chris Powell,LIB,140041,0,0,0,0,
Cleveland,Governor,Rex Lawhorn,LIB,140041,0,0,0,0,
Cleveland,Corporation Commissioner,Ashley Nicole Mccray,DEM,140041,0,0,18,18,
Cleveland,Corporation Commissioner,Blake Cummings,DEM,140041,0,0,12,12,
Cleveland,U.S. House,Mary Brannon,DEM,140041,0,0,21,21,04
Cleveland,U.S. House,Fred Gipson,DEM,140041,0,0,9,9,04
Cleveland,Governor,Mick Cornett,REP,140042,3,3,76,82,
Cleveland,Governor,Kevin Stitt,REP,140042,3,4,42,49,
Cleveland,Lieutenant Governor,Dana Murphy,REP,140042,1,2,53,56,
Cleveland,Lieutenant Governor,Matt Pinnell,REP,140042,5,5,63,73,
Cleveland,State Auditor,Cindy Byrd,REP,140042,2,3,47,52,
Cleveland,State Auditor,Charlie Prater,REP,140042,4,4,60,68,
Cleveland,Attorney General,Mike Hunter,REP,140042,4,1,78,83,
Cleveland,Attorney General,Gentner Drummond,REP,140042,2,6,34,42,
Cleveland,Superintendent of Public Instruction,Joy Hofmeister,REP,140042,4,5,69,78,
Cleveland,Superintendent of Public Instruction,Linda Murphy,REP,140042,2,2,44,48,
Cleveland,Commissioner of Labor,Cathy Costello,REP,140042,1,5,43,49,
Cleveland,Commissioner of Labor,Leslie Osborn,REP,140042,4,2,67,73,
Cleveland,Corporation Commissioner,Bob Anthony,REP,140042,2,3,71,76,
Cleveland,Corporation Commissioner,Brian Bingman,REP,140042,4,4,39,47,
Cleveland,Governor,Chris Powell,LIB,140042,0,0,0,0,
Cleveland,Governor,Rex Lawhorn,LIB,140042,0,0,0,0,
Cleveland,Corporation Commissioner,Ashley Nicole Mccray,DEM,140042,9,5,121,135,
Cleveland,Corporation Commissioner,Blake Cummings,DEM,140042,0,3,38,41,
Cleveland,U.S. House,Mary Brannon,DEM,140042,0,1,42,43,04
Cleveland,U.S. House,Fred Gipson,DEM,140042,9,8,125,142,04
Cleveland,State Senate,Mary Boren,DEM,140042,9,9,143,161,16
Cleveland,State Senate,Claudia Griffith,DEM,140042,0,0,26,26,16
Cleveland,Governor,Mick Cornett,REP,140043,14,6,177,197,
Cleveland,Governor,Kevin Stitt,REP,140043,11,13,186,210,
Cleveland,Lieutenant Governor,Dana Murphy,REP,140043,9,10,155,174,
Cleveland,Lieutenant Governor,Matt Pinnell,REP,140043,16,9,203,228,
Cleveland,State Auditor,Cindy Byrd,REP,140043,17,10,185,212,
Cleveland,State Auditor,Charlie Prater,REP,140043,8,9,167,184,
Cleveland,Attorney General,Mike Hunter,REP,140043,21,9,175,205,
Cleveland,Attorney General,Gentner Drummond,REP,140043,3,10,187,200,
Cleveland,Superintendent of Public Instruction,Joy Hofmeister,REP,140043,10,15,201,226,
Cleveland,Superintendent of Public Instruction,Linda Murphy,REP,140043,15,4,158,177,
Cleveland,Commissioner of Labor,Cathy Costello,REP,140043,13,10,157,180,
Cleveland,Commissioner of Labor,Leslie Osborn,REP,140043,12,9,197,218,
Cleveland,Corporation Commissioner,Bob Anthony,REP,140043,16,10,159,185,
Cleveland,Corporation Commissioner,Brian Bingman,REP,140043,9,9,191,209,
Cleveland,Governor,Chris Powell,LIB,140043,2,1,3,6,
Cleveland,Governor,Rex Lawhorn,LIB,140043,1,0,0,1,
Cleveland,Corporation Commissioner,Ashley Nicole Mccray,DEM,140043,12,4,81,97,
Cleveland,Corporation Commissioner,Blake Cummings,DEM,140043,0,1,37,38,
Cleveland,U.S. House,Mary Brannon,DEM,140043,7,0,68,75,04
Cleveland,U.S. House,Fred Gipson,DEM,140043,5,5,51,61,04
Cleveland,State House,Leslie Bonebreak,DEM,140043,10,4,86,100,53
Cleveland,State House,Cyndy Southerland,DEM,140043,2,1,34,37,53
Cleveland,Governor,Mick Cornett,REP,140044,13,8,163,184,
Cleveland,Governor,Kevin Stitt,REP,140044,9,4,140,153,
Cleveland,Lieutenant Governor,Dana Murphy,REP,140044,9,6,149,164,
Cleveland,Lieutenant Governor,Matt Pinnell,REP,140044,11,6,148,165,
Cleveland,State Auditor,Cindy Byrd,REP,140044,13,5,146,164,
Cleveland,State Auditor,Charlie Prater,REP,140044,7,7,147,161,
Cleveland,Attorney General,Mike Hunter,REP,140044,14,8,143,165,
Cleveland,Attorney General,Gentner Drummond,REP,140044,8,4,156,168,
Cleveland,Superintendent of Public Instruction,Joy Hofmeister,REP,140044,13,8,180,201,
Cleveland,Superintendent of Public Instruction,Linda Murphy,REP,140044,9,4,119,132,
Cleveland,Commissioner of Labor,Cathy Costello,REP,140044,14,1,134,149,
Cleveland,Commissioner of Labor,Leslie Osborn,REP,140044,6,10,157,173,
Cleveland,Corporation Commissioner,Bob Anthony,REP,140044,7,12,163,182,
Cleveland,Corporation Commissioner,Brian Bingman,REP,140044,15,0,136,151,
Cleveland,Governor,Chris Powell,LIB,140044,0,0,0,0,
Cleveland,Governor,Rex Lawhorn,LIB,140044,0,0,0,0,
Cleveland,Corporation Commissioner,Ashley Nicole Mccray,DEM,140044,8,6,91,105,
Cleveland,Corporation Commissioner,Blake Cummings,DEM,140044,4,0,30,34,
Cleveland,U.S. House,Mary Brannon,DEM,140044,7,4,89,100,04
Cleveland,U.S. House,Fred Gipson,DEM,140044,5,2,32,39,04
Cleveland,State House,Leslie Bonebreak,DEM,140044,11,5,83,99,53
Cleveland,State House,Cyndy Southerland,DEM,140044,1,1,41,43,53
Cleveland,Governor,Mick Cornett,REP,140045,3,0,56,59,
Cleveland,Governor,Kevin Stitt,REP,140045,1,1,86,88,
Cleveland,Lieutenant Governor,Dana Murphy,REP,140045,2,0,55,57,
Cleveland,Lieutenant Governor,Matt Pinnell,REP,140045,2,1,86,89,
Cleveland,State Auditor,Cindy Byrd,REP,140045,3,1,63,67,
Cleveland,State Auditor,Charlie Prater,REP,140045,0,0,76,76,
Cleveland,Attorney General,Mike Hunter,REP,140045,1,1,72,74,
Cleveland,Attorney General,Gentner Drummond,REP,140045,3,0,70,73,
Cleveland,Superintendent of Public Instruction,Joy Hofmeister,REP,140045,3,0,80,83,
Cleveland,Superintendent of Public Instruction,Linda Murphy,REP,140045,1,1,59,61,
Cleveland,Commissioner of Labor,Cathy Costello,REP,140045,4,1,67,72,
Cleveland,Commissioner of Labor,Leslie Osborn,REP,140045,0,0,74,74,
Cleveland,Corporation Commissioner,Bob Anthony,REP,140045,1,0,59,60,
Cleveland,Corporation Commissioner,Brian Bingman,REP,140045,3,1,82,86,
Cleveland,State House,Bobby Cleveland,REP,140045,4,1,76,81,20
Cleveland,State House,Sherrie Conley,REP,140045,0,0,64,64,20
Cleveland,Governor,Chris Powell,LIB,140045,0,0,0,0,
Cleveland,Governor,Rex Lawhorn,LIB,140045,0,0,1,1,
Cleveland,Corporation Commissioner,Ashley Nicole Mccray,DEM,140045,2,0,47,49,
Cleveland,Corporation Commissioner,Blake Cummings,DEM,140045,1,0,7,8,
Cleveland,U.S. House,Mary Brannon,DEM,140045,1,0,26,27,04
Cleveland,U.S. House,Fred Gipson,DEM,140045,2,0,28,30,04
Cleveland,Governor,Mick Cornett,REP,140047,4,0,106,110,
Cleveland,Governor,Kevin Stitt,REP,140047,0,2,93,95,
Cleveland,Lieutenant Governor,Dana Murphy,REP,140047,4,1,97,102,
Cleveland,Lieutenant Governor,Matt Pinnell,REP,140047,0,1,101,102,
Cleveland,State Auditor,Cindy Byrd,REP,140047,3,1,94,98,
Cleveland,State Auditor,Charlie Prater,REP,140047,1,1,96,98,
Cleveland,Attorney General,Mike Hunter,REP,140047,3,1,104,108,
Cleveland,Attorney General,Gentner Drummond,REP,140047,1,1,91,93,
Cleveland,Superintendent of Public Instruction,Joy Hofmeister,REP,140047,0,0,100,100,
Cleveland,Superintendent of Public Instruction,Linda Murphy,REP,140047,4,2,93,99,
Cleveland,Commissioner of Labor,Cathy Costello,REP,140047,4,0,87,91,
Cleveland,Commissioner of Labor,Leslie Osborn,REP,140047,0,2,104,106,
Cleveland,Corporation Commissioner,Bob Anthony,REP,140047,4,1,105,110,
Cleveland,Corporation Commissioner,Brian Bingman,REP,140047,0,1,88,89,
Cleveland,Governor,Chris Powell,LIB,140047,0,0,1,1,
Cleveland,Governor,Rex Lawhorn,LIB,140047,0,0,0,0,
Cleveland,Corporation Commissioner,Ashley Nicole Mccray,DEM,140047,3,0,51,54,
Cleveland,Corporation Commissioner,Blake Cummings,DEM,140047,1,1,22,24,
Cleveland,U.S. House,Mary Brannon,DEM,140047,1,0,51,52,04
Cleveland,U.S. House,Fred Gipson,DEM,140047,3,1,22,26,04
Cleveland,Governor,Mick Cornett,REP,140048,3,3,67,73,
Cleveland,Governor,Kevin Stitt,REP,140048,0,3,81,84,
Cleveland,Lieutenant Governor,Dana Murphy,REP,140048,2,4,60,66,
Cleveland,Lieutenant Governor,Matt Pinnell,REP,140048,1,2,85,88,
Cleveland,State Auditor,Cindy Byrd,REP,140048,3,4,67,74,
Cleveland,State Auditor,Charlie Prater,REP,140048,0,2,74,76,
Cleveland,Attorney General,Mike Hunter,REP,140048,2,3,66,71,
Cleveland,Attorney General,Gentner Drummond,REP,140048,1,3,80,84,
Cleveland,Superintendent of Public Instruction,Joy Hofmeister,REP,140048,1,4,83,88,
Cleveland,Superintendent of Public Instruction,Linda Murphy,REP,140048,2,2,64,68,
Cleveland,Commissioner of Labor,Cathy Costello,REP,140048,3,2,71,76,
Cleveland,Commissioner of Labor,Leslie Osborn,REP,140048,0,4,74,78,
Cleveland,Corporation Commissioner,Bob Anthony,REP,140048,2,4,72,78,
Cleveland,Corporation Commissioner,Brian Bingman,REP,140048,1,2,71,74,
Cleveland,Governor,Chris Powell,LIB,140048,0,0,0,0,
Cleveland,Governor,Rex Lawhorn,LIB,140048,0,0,2,2,
Cleveland,Corporation Commissioner,Ashley Nicole Mccray,DEM,140048,0,0,50,50,
Cleveland,Corporation Commissioner,Blake Cummings,DEM,140048,4,2,20,26,
Cleveland,U.S. House,Mary Brannon,DEM,140048,3,0,49,52,04
Cleveland,U.S. House,Fred Gipson,DEM,140048,1,2,21,24,04
Cleveland,State House,Leslie Bonebreak,DEM,140048,2,1,43,46,53
Cleveland,State House,Cyndy Southerland,DEM,140048,2,1,26,29,53
Cleveland,Governor,Mick Cornett,REP,140049,2,0,65,67,
Cleveland,Governor,Kevin Stitt,REP,140049,5,4,93,102,
Cleveland,Lieutenant Governor,Dana Murphy,REP,140049,3,0,60,63,
Cleveland,Lieutenant Governor,Matt Pinnell,REP,140049,4,4,96,104,
Cleveland,State Auditor,Cindy Byrd,REP,140049,2,3,69,74,
Cleveland,State Auditor,Charlie Prater,REP,140049,5,1,84,90,
Cleveland,Attorney General,Mike Hunter,REP,140049,5,0,71,76,
Cleveland,Attorney General,Gentner Drummond,REP,140049,2,4,83,89,
Cleveland,Superintendent of Public Instruction,Joy Hofmeister,REP,140049,2,2,67,71,
Cleveland,Superintendent of Public Instruction,Linda Murphy,REP,140049,5,2,93,100,
Cleveland,Commissioner of Labor,Cathy Costello,REP,140049,2,2,59,63,
Cleveland,Commissioner of Labor,Leslie Osborn,REP,140049,5,2,94,101,
Cleveland,Corporation Commissioner,Bob Anthony,REP,140049,3,2,73,78,
Cleveland,Corporation Commissioner,Brian Bingman,REP,140049,4,2,83,89,
Cleveland,State House,Danny Sterling,REP,140049,3,0,74,77,27
Cleveland,State House,Dave Spaulding,REP,140049,4,4,83,91,27
Cleveland,Governor,Chris Powell,LIB,140049,0,0,0,0,
Cleveland,Governor,Rex Lawhorn,LIB,140049,0,0,0,0,
Cleveland,Corporation Commissioner,Ashley Nicole Mccray,DEM,140049,2,0,37,39,
Cleveland,Corporation Commissioner,Blake Cummings,DEM,140049,0,0,20,20,
Cleveland,U.S. House,Mary Brannon,DEM,140049,2,0,38,40,04
Cleveland,U.S. House,Fred Gipson,DEM,140049,0,0,19,19,04
Cleveland,Governor,Mick Cornett,REP,140050,9,7,195,211,
Cleveland,Governor,Kevin Stitt,REP,140050,11,6,161,178,
Cleveland,Lieutenant Governor,Dana Murphy,REP,140050,5,8,148,161,
Cleveland,Lieutenant Governor,Matt Pinnell,REP,140050,17,5,195,217,
Cleveland,State Auditor,Cindy Byrd,REP,140050,10,8,172,190,
Cleveland,State Auditor,Charlie Prater,REP,140050,10,5,166,181,
Cleveland,Attorney General,Mike Hunter,REP,140050,15,8,184,207,
Cleveland,Attorney General,Gentner Drummond,REP,140050,7,5,166,178,
Cleveland,Superintendent of Public Instruction,Joy Hofmeister,REP,140050,10,7,196,213,
Cleveland,Superintendent of Public Instruction,Linda Murphy,REP,140050,12,5,151,168,
Cleveland,Commissioner of Labor,Cathy Costello,REP,140050,8,9,163,180,
Cleveland,Commissioner of Labor,Leslie Osborn,REP,140050,14,4,178,196,
Cleveland,Corporation Commissioner,Bob Anthony,REP,140050,11,6,198,215,
Cleveland,Corporation Commissioner,Brian Bingman,REP,140050,11,7,146,164,
Cleveland,Governor,Chris Powell,LIB,140050,0,0,0,0,
Cleveland,Governor,Rex Lawhorn,LIB,140050,0,0,0,0,
Cleveland,Corporation Commissioner,Ashley Nicole Mccray,DEM,140050,6,2,46,54,
Cleveland,Corporation Commissioner,Blake Cummings,DEM,140050,2,1,30,33,
Cleveland,U.S. House,Mary Brannon,DEM,140050,3,3,39,45,04
Cleveland,U.S. House,Fred Gipson,DEM,140050,5,0,36,41,04
Cleveland,Governor,Mick Cornett,REP,140051,2,3,59,64,
Cleveland,Governor,Kevin Stitt,REP,140051,1,1,46,48,
Cleveland,Lieutenant Governor,Dana Murphy,REP,140051,3,2,45,50,
Cleveland,Lieutenant Governor,Matt Pinnell,REP,140051,0,2,57,59,
Cleveland,State Auditor,Cindy Byrd,REP,140051,2,2,43,47,
Cleveland,State Auditor,Charlie Prater,REP,140051,1,2,57,60,
Cleveland,Attorney General,Mike Hunter,REP,140051,1,1,49,51,
Cleveland,Attorney General,Gentner Drummond,REP,140051,2,3,51,56,
Cleveland,Superintendent of Public Instruction,Joy Hofmeister,REP,140051,1,1,60,62,
Cleveland,Superintendent of Public Instruction,Linda Murphy,REP,140051,2,3,42,47,
Cleveland,Commissioner of Labor,Cathy Costello,REP,140051,3,2,48,53,
Cleveland,Commissioner of Labor,Leslie Osborn,REP,140051,0,2,51,53,
Cleveland,Corporation Commissioner,Bob Anthony,REP,140051,1,1,56,58,
Cleveland,Corporation Commissioner,Brian Bingman,REP,140051,2,3,43,48,
Cleveland,Governor,Chris Powell,LIB,140051,0,0,0,0,
Cleveland,Governor,Rex Lawhorn,LIB,140051,0,0,0,0,
Cleveland,Corporation Commissioner,Ashley Nicole Mccray,DEM,140051,7,0,70,77,
Cleveland,Corporation Commissioner,Blake Cummings,DEM,140051,0,1,25,26,
Cleveland,U.S. House,Mary Brannon,DEM,140051,5,1,47,53,04
Cleveland,U.S. House,Fred Gipson,DEM,140051,2,0,50,52,04
Cleveland,State Senate,Mary Boren,DEM,140051,5,1,80,86,16
Cleveland,State Senate,Claudia Griffith,DEM,140051,2,0,17,19,16
Cleveland,Governor,Mick Cornett,REP,140053,40,17,285,342,
Cleveland,Governor,Kevin Stitt,REP,140053,16,19,186,221,
Cleveland,Lieutenant Governor,Dana Murphy,REP,140053,27,22,221,270,
Cleveland,Lieutenant Governor,Matt Pinnell,REP,140053,29,13,225,267,
Cleveland,State Auditor,Cindy Byrd,REP,140053,29,16,217,262,
Cleveland,State Auditor,Charlie Prater,REP,140053,23,17,209,249,
Cleveland,Attorney General,Mike Hunter,REP,140053,36,25,264,325,
Cleveland,Attorney General,Gentner Drummond,REP,140053,17,10,185,212,
Cleveland,Superintendent of Public Instruction,Joy Hofmeister,REP,140053,39,23,288,350,
Cleveland,Superintendent of Public Instruction,Linda Murphy,REP,140053,16,12,168,196,
Cleveland,Commissioner of Labor,Cathy Costello,REP,140053,24,16,211,251,
Cleveland,Commissioner of Labor,Leslie Osborn,REP,140053,29,18,229,276,
Cleveland,Corporation Commissioner,Bob Anthony,REP,140053,34,23,260,317,
Cleveland,Corporation Commissioner,Brian Bingman,REP,140053,19,11,185,215,
Cleveland,Governor,Chris Powell,LIB,140053,0,1,1,2,
Cleveland,Governor,Rex Lawhorn,LIB,140053,0,0,0,0,
Cleveland,Corporation Commissioner,Ashley Nicole Mccray,DEM,140053,22,12,151,185,
Cleveland,Corporation Commissioner,Blake Cummings,DEM,140053,9,3,43,55,
Cleveland,U.S. House,Mary Brannon,DEM,140053,11,6,85,102,04
Cleveland,U.S. House,Fred Gipson,DEM,140053,20,9,113,142,04
Cleveland,Governor,Mick Cornett,REP,140054,2,0,68,70,
Cleveland,Governor,Kevin Stitt,REP,140054,5,4,77,86,
Cleveland,Lieutenant Governor,Dana Murphy,REP,140054,4,2,79,85,
Cleveland,Lieutenant Governor,Matt Pinnell,REP,140054,3,2,67,72,
Cleveland,State Auditor,Cindy Byrd,REP,140054,5,3,68,76,
Cleveland,State Auditor,Charlie Prater,REP,140054,2,1,76,79,
Cleveland,Attorney General,Mike Hunter,REP,140054,5,4,68,77,
Cleveland,Attorney General,Gentner Drummond,REP,140054,2,0,78,80,
Cleveland,Superintendent of Public Instruction,Joy Hofmeister,REP,140054,2,3,76,81,
Cleveland,Superintendent of Public Instruction,Linda Murphy,REP,140054,5,1,68,74,
Cleveland,Commissioner of Labor,Cathy Costello,REP,140054,0,1,70,71,
Cleveland,Commissioner of Labor,Leslie Osborn,REP,140054,7,3,73,83,
Cleveland,Corporation Commissioner,Bob Anthony,REP,140054,5,3,77,85,
Cleveland,Corporation Commissioner,Brian Bingman,REP,140054,2,1,68,71,
Cleveland,Governor,Chris Powell,LIB,140054,0,0,0,0,
Cleveland,Governor,Rex Lawhorn,LIB,140054,0,0,1,1,
Cleveland,Corporation Commissioner,Ashley Nicole Mccray,DEM,140054,1,0,34,35,
Cleveland,Corporation Commissioner,Blake Cummings,DEM,140054,1,1,12,14,
Cleveland,U.S. House,Mary Brannon,DEM,140054,1,0,35,36,04
Cleveland,U.S. House,Fred Gipson,DEM,140054,1,1,11,13,04
Cleveland,Governor,Mick Cornett,REP,140055,12,16,173,201,
Cleveland,Governor,Kevin Stitt,REP,140055,5,10,114,129,
Cleveland,Lieutenant Governor,Dana Murphy,REP,140055,9,9,142,160,
Cleveland,Lieutenant Governor,Matt Pinnell,REP,140055,8,16,131,155,
Cleveland,State Auditor,Cindy Byrd,REP,140055,12,8,139,159,
Cleveland,State Auditor,Charlie Prater,REP,140055,5,16,127,148,
Cleveland,Attorney General,Mike Hunter,REP,140055,11,16,150,177,
Cleveland,Attorney General,Gentner Drummond,REP,140055,5,9,128,142,
Cleveland,Superintendent of Public Instruction,Joy Hofmeister,REP,140055,8,11,165,184,
Cleveland,Superintendent of Public Instruction,Linda Murphy,REP,140055,9,13,114,136,
Cleveland,Commissioner of Labor,Cathy Costello,REP,140055,12,13,119,144,
Cleveland,Commissioner of Labor,Leslie Osborn,REP,140055,5,12,157,174,
Cleveland,Corporation Commissioner,Bob Anthony,REP,140055,12,18,167,197,
Cleveland,Corporation Commissioner,Brian Bingman,REP,140055,4,7,106,117,
Cleveland,Governor,Chris Powell,LIB,140055,0,0,1,1,
Cleveland,Governor,Rex Lawhorn,LIB,140055,0,0,0,0,
Cleveland,Corporation Commissioner,Ashley Nicole Mccray,DEM,140055,12,17,115,144,
Cleveland,Corporation Commissioner,Blake Cummings,DEM,140055,5,2,35,42,
Cleveland,U.S. House,Mary Brannon,DEM,140055,8,9,91,108,04
Cleveland,U.S. House,Fred Gipson,DEM,140055,9,10,59,78,04
Cleveland,Governor,Mick Cornett,REP,140056,6,10,130,146,
Cleveland,Governor,Kevin Stitt,REP,140056,5,8,94,107,
Cleveland,Lieutenant Governor,Dana Murphy,REP,140056,6,10,90,106,
Cleveland,Lieutenant Governor,Matt Pinnell,REP,140056,5,8,127,140,
Cleveland,State Auditor,Cindy Byrd,REP,140056,4,4,117,125,
Cleveland,State Auditor,Charlie Prater,REP,140056,6,13,81,100,
Cleveland,Attorney General,Mike Hunter,REP,140056,7,16,95,118,
Cleveland,Attorney General,Gentner Drummond,REP,140056,4,2,117,123,
Cleveland,Superintendent of Public Instruction,Joy Hofmeister,REP,140056,5,9,117,131,
Cleveland,Superintendent of Public Instruction,Linda Murphy,REP,140056,6,9,98,113,
Cleveland,Commissioner of Labor,Cathy Costello,REP,140056,5,5,118,128,
Cleveland,Commissioner of Labor,Leslie Osborn,REP,140056,5,13,84,102,
Cleveland,Corporation Commissioner,Bob Anthony,REP,140056,8,14,120,142,
Cleveland,Corporation Commissioner,Brian Bingman,REP,140056,3,4,84,91,
Cleveland,Governor,Chris Powell,LIB,140056,0,0,1,1,
Cleveland,Governor,Rex Lawhorn,LIB,140056,0,0,1,1,
Cleveland,Corporation Commissioner,Ashley Nicole Mccray,DEM,140056,16,6,148,170,
Cleveland,Corporation Commissioner,Blake Cummings,DEM,140056,7,3,47,57,
Cleveland,U.S. House,Mary Brannon,DEM,140056,7,0,79,86,04
Cleveland,U.S. House,Fred Gipson,DEM,140056,16,9,126,151,04
Cleveland,State Senate,Mary Boren,DEM,140056,22,9,172,203,16
Cleveland,State Senate,Claudia Griffith,DEM,140056,1,0,27,28,16
Cleveland,Governor,Mick Cornett,REP,140057,15,4,196,215,
Cleveland,Governor,Kevin Stitt,REP,140057,7,5,197,209,
Cleveland,Lieutenant Governor,Dana Murphy,REP,140057,13,3,164,180,
Cleveland,Lieutenant Governor,Matt Pinnell,REP,140057,8,6,220,234,
Cleveland,State Auditor,Cindy Byrd,REP,140057,16,6,222,244,
Cleveland,State Auditor,Charlie Prater,REP,140057,6,3,158,167,
Cleveland,Attorney General,Mike Hunter,REP,140057,14,4,178,196,
Cleveland,Attorney General,Gentner Drummond,REP,140057,6,5,204,215,
Cleveland,Superintendent of Public Instruction,Joy Hofmeister,REP,140057,8,4,229,241,
Cleveland,Superintendent of Public Instruction,Linda Murphy,REP,140057,14,5,162,181,
Cleveland,Commissioner of Labor,Cathy Costello,REP,140057,12,0,176,188,
Cleveland,Commissioner of Labor,Leslie Osborn,REP,140057,10,9,201,220,
Cleveland,Corporation Commissioner,Bob Anthony,REP,140057,13,5,209,227,
Cleveland,Corporation Commissioner,Brian Bingman,REP,140057,9,4,167,180,
Cleveland,Governor,Chris Powell,LIB,140057,0,0,1,1,
Cleveland,Governor,Rex Lawhorn,LIB,140057,0,0,0,0,
Cleveland,Corporation Commissioner,Ashley Nicole Mccray,DEM,140057,11,7,120,138,
Cleveland,Corporation Commissioner,Blake Cummings,DEM,140057,4,0,65,69,
Cleveland,U.S. House,Mary Brannon,DEM,140057,10,5,119,134,04
Cleveland,U.S. House,Fred Gipson,DEM,140057,5,2,67,74,04
Cleveland,State Senate,Mary Boren,DEM,140057,12,5,138,155,16
Cleveland,State Senate,Claudia Griffith,DEM,140057,1,2,47,50,16
Cleveland,Governor,Mick Cornett,REP,140058,16,1,123,140,
Cleveland,Governor,Kevin Stitt,REP,140058,6,3,124,133,
Cleveland,Lieutenant Governor,Dana Murphy,REP,140058,13,0,109,122,
Cleveland,Lieutenant Governor,Matt Pinnell,REP,140058,9,4,136,149,
Cleveland,State Auditor,Cindy Byrd,REP,140058,11,4,113,128,
Cleveland,State Auditor,Charlie Prater,REP,140058,10,0,129,139,
Cleveland,Attorney General,Mike Hunter,REP,140058,14,2,126,142,
Cleveland,Attorney General,Gentner Drummond,REP,140058,8,2,120,130,
Cleveland,Superintendent of Public Instruction,Joy Hofmeister,REP,140058,13,1,141,155,
Cleveland,Superintendent of Public Instruction,Linda Murphy,REP,140058,9,3,103,115,
Cleveland,Commissioner of Labor,Cathy Costello,REP,140058,10,4,130,144,
Cleveland,Commissioner of Labor,Leslie Osborn,REP,140058,12,0,112,124,
Cleveland,Corporation Commissioner,Bob Anthony,REP,140058,11,3,128,142,
Cleveland,Corporation Commissioner,Brian Bingman,REP,140058,11,1,114,126,
Cleveland,Governor,Chris Powell,LIB,140058,0,0,2,2,
Cleveland,Governor,Rex Lawhorn,LIB,140058,0,0,0,0,
Cleveland,Corporation Commissioner,Ashley Nicole Mccray,DEM,140058,11,2,39,52,
Cleveland,Corporation Commissioner,Blake Cummings,DEM,140058,1,0,12,13,
Cleveland,U.S. House,Mary Brannon,DEM,140058,7,2,35,44,04
Cleveland,U.S. House,Fred Gipson,DEM,140058,4,0,16,20,04
Cleveland,Governor,Mick Cornett,REP,140059,1,0,58,59,
Cleveland,Governor,Kevin Stitt,REP,140059,1,1,35,37,
Cleveland,Lieutenant Governor,Dana Murphy,REP,140059,1,0,44,45,
Cleveland,Lieutenant Governor,Matt Pinnell,REP,140059,1,1,42,44,
Cleveland,State Auditor,Cindy Byrd,REP,140059,1,0,37,38,
Cleveland,State Auditor,Charlie Prater,REP,140059,1,1,44,46,
Cleveland,Attorney General,Mike Hunter,REP,140059,0,1,51,52,
Cleveland,Attorney General,Gentner Drummond,REP,140059,2,0,35,37,
Cleveland,Superintendent of Public Instruction,Joy Hofmeister,REP,140059,0,0,55,55,
Cleveland,Superintendent of Public Instruction,Linda Murphy,REP,140059,2,1,30,33,
Cleveland,Commissioner of Labor,Cathy Costello,REP,140059,1,1,41,43,
Cleveland,Commissioner of Labor,Leslie Osborn,REP,140059,1,0,45,46,
Cleveland,Corporation Commissioner,Bob Anthony,REP,140059,0,1,60,61,
Cleveland,Corporation Commissioner,Brian Bingman,REP,140059,2,0,27,29,
Cleveland,Governor,Chris Powell,LIB,140059,0,0,1,1,
Cleveland,Governor,Rex Lawhorn,LIB,140059,0,0,0,0,
Cleveland,Corporation Commissioner,Ashley Nicole Mccray,DEM,140059,2,1,59,62,
Cleveland,Corporation Commissioner,Blake Cummings,DEM,140059,3,0,21,24,
Cleveland,U.S. House,Mary Brannon,DEM,140059,3,0,35,38,04
Cleveland,U.S. House,Fred Gipson,DEM,140059,2,1,47,50,04
Cleveland,State Senate,Mary Boren,DEM,140059,3,1,67,71,16
Cleveland,State Senate,Claudia Griffith,DEM,140059,2,0,17,19,16
Cleveland,Governor,Mick Cornett,REP,140060,23,11,216,250,
Cleveland,Governor,Kevin Stitt,REP,140060,17,14,256,287,
Cleveland,Lieutenant Governor,Dana Murphy,REP,140060,15,10,202,227,
Cleveland,Lieutenant Governor,Matt Pinnell,REP,140060,25,15,258,298,
Cleveland,State Auditor,Cindy Byrd,REP,140060,23,11,227,261,
Cleveland,State Auditor,Charlie Prater,REP,140060,16,14,222,252,
Cleveland,Attorney General,Mike Hunter,REP,140060,29,18,246,293,
Cleveland,Attorney General,Gentner Drummond,REP,140060,11,5,217,233,
Cleveland,Superintendent of Public Instruction,Joy Hofmeister,REP,140060,24,14,265,303,
Cleveland,Superintendent of Public Instruction,Linda Murphy,REP,140060,16,11,197,224,
Cleveland,Commissioner of Labor,Cathy Costello,REP,140060,19,13,224,256,
Cleveland,Commissioner of Labor,Leslie Osborn,REP,140060,21,12,235,268,
Cleveland,Corporation Commissioner,Bob Anthony,REP,140060,25,19,245,289,
Cleveland,Corporation Commissioner,Brian Bingman,REP,140060,15,6,214,235,
Cleveland,Governor,Chris Powell,LIB,140060,0,0,0,0,
Cleveland,Governor,Rex Lawhorn,LIB,140060,0,0,0,0,
Cleveland,Corporation Commissioner,Ashley Nicole Mccray,DEM,140060,10,6,58,74,
Cleveland,Corporation Commissioner,Blake Cummings,DEM,140060,4,1,21,26,
Cleveland,U.S. House,Mary Brannon,DEM,140060,10,1,56,67,04
Cleveland,U.S. House,Fred Gipson,DEM,140060,4,6,22,32,04
Cleveland,Governor,Mick Cornett,REP,140061,35,8,215,258,
Cleveland,Governor,Kevin Stitt,REP,140061,42,9,206,257,
Cleveland,Lieutenant Governor,Dana Murphy,REP,140061,34,8,180,222,
Cleveland,Lieutenant Governor,Matt Pinnell,REP,140061,41,9,232,282,
Cleveland,State Auditor,Cindy Byrd,REP,140061,44,9,203,256,
Cleveland,State Auditor,Charlie Prater,REP,140061,30,7,196,233,
Cleveland,Attorney General,Mike Hunter,REP,140061,46,10,213,269,
Cleveland,Attorney General,Gentner Drummond,REP,140061,29,6,199,234,
Cleveland,Superintendent of Public Instruction,Joy Hofmeister,REP,140061,49,5,254,308,
Cleveland,Superintendent of Public Instruction,Linda Murphy,REP,140061,28,12,159,199,
Cleveland,Commissioner of Labor,Cathy Costello,REP,140061,38,6,180,224,
Cleveland,Commissioner of Labor,Leslie Osborn,REP,140061,37,11,223,271,
Cleveland,Corporation Commissioner,Bob Anthony,REP,140061,44,5,241,290,
Cleveland,Corporation Commissioner,Brian Bingman,REP,140061,32,12,171,215,
Cleveland,Governor,Chris Powell,LIB,140061,0,0,1,1,
Cleveland,Governor,Rex Lawhorn,LIB,140061,0,0,2,2,
Cleveland,Corporation Commissioner,Ashley Nicole Mccray,DEM,140061,17,5,53,75,
Cleveland,Corporation Commissioner,Blake Cummings,DEM,140061,8,3,13,24,
Cleveland,U.S. House,Mary Brannon,DEM,140061,17,7,40,64,04
Cleveland,U.S. House,Fred Gipson,DEM,140061,8,1,26,35,04
Cleveland,Governor,Mick Cornett,REP,140063,4,6,81,91,
Cleveland,Governor,Kevin Stitt,REP,140063,8,3,74,85,
Cleveland,Lieutenant Governor,Dana Murphy,REP,140063,5,2,67,74,
Cleveland,Lieutenant Governor,Matt Pinnell,REP,140063,7,7,88,102,
Cleveland,State Auditor,Cindy Byrd,REP,140063,8,5,69,82,
Cleveland,State Auditor,Charlie Prater,REP,140063,4,4,74,82,
Cleveland,Attorney General,Mike Hunter,REP,140063,6,2,73,81,
Cleveland,Attorney General,Gentner Drummond,REP,140063,6,7,81,94,
Cleveland,Superintendent of Public Instruction,Joy Hofmeister,REP,140063,4,5,77,86,
Cleveland,Superintendent of Public Instruction,Linda Murphy,REP,140063,8,4,74,86,
Cleveland,Commissioner of Labor,Cathy Costello,REP,140063,5,3,70,78,
Cleveland,Commissioner of Labor,Leslie Osborn,REP,140063,7,6,77,90,
Cleveland,Corporation Commissioner,Bob Anthony,REP,140063,7,5,76,88,
Cleveland,Corporation Commissioner,Brian Bingman,REP,140063,5,4,74,83,
Cleveland,State House,Danny Sterling,REP,140063,6,3,68,77,27
Cleveland,State House,Dave Spaulding,REP,140063,6,6,76,88,27
Cleveland,Governor,Chris Powell,LIB,140063,0,0,0,0,
Cleveland,Governor,Rex Lawhorn,LIB,140063,0,0,0,0,
Cleveland,Corporation Commissioner,Ashley Nicole Mccray,DEM,140063,0,0,21,21,
Cleveland,Corporation Commissioner,Blake Cummings,DEM,140063,0,1,9,10,
Cleveland,U.S. House,Mary Brannon,DEM,140063,0,0,14,14,04
Cleveland,U.S. House,Fred Gipson,DEM,140063,0,1,16,17,04
Cleveland,Governor,Mick Cornett,REP,140064,15,2,92,109,
Cleveland,Governor,Kevin Stitt,REP,140064,23,6,180,209,
Cleveland,Lieutenant Governor,Dana Murphy,REP,140064,12,3,117,132,
Cleveland,Lieutenant Governor,Matt Pinnell,REP,140064,26,6,147,179,
Cleveland,State Auditor,Cindy Byrd,REP,140064,21,5,128,154,
Cleveland,State Auditor,Charlie Prater,REP,140064,17,4,135,156,
Cleveland,Attorney General,Mike Hunter,REP,140064,16,4,110,130,
Cleveland,Attorney General,Gentner Drummond,REP,140064,22,5,160,187,
Cleveland,Superintendent of Public Instruction,Joy Hofmeister,REP,140064,10,3,133,146,
Cleveland,Superintendent of Public Instruction,Linda Murphy,REP,140064,27,6,135,168,
Cleveland,Commissioner of Labor,Cathy Costello,REP,140064,14,3,110,127,
Cleveland,Commissioner of Labor,Leslie Osborn,REP,140064,24,5,158,187,
Cleveland,Corporation Commissioner,Bob Anthony,REP,140064,21,5,121,147,
Cleveland,Corporation Commissioner,Brian Bingman,REP,140064,16,3,148,167,
Cleveland,State House,Danny Sterling,REP,140064,16,0,123,139,27
Cleveland,State House,Dave Spaulding,REP,140064,21,8,141,170,27
Cleveland,Governor,Chris Powell,LIB,140064,0,0,1,1,
Cleveland,Governor,Rex Lawhorn,LIB,140064,0,0,0,0,
Cleveland,Corporation Commissioner,Ashley Nicole Mccray,DEM,140064,7,2,24,33,
Cleveland,Corporation Commissioner,Blake Cummings,DEM,140064,5,1,18,24,
Cleveland,U.S. House,Mary Brannon,DEM,140064,8,2,29,39,04
Cleveland,U.S. House,Fred Gipson,DEM,140064,4,1,13,18,04
Cleveland,Governor,Mick Cornett,REP,140065,3,1,53,57,
Cleveland,Governor,Kevin Stitt,REP,140065,7,0,98,105,
Cleveland,Lieutenant Governor,Dana Murphy,REP,140065,5,0,55,60,
Cleveland,Lieutenant Governor,Matt Pinnell,REP,140065,4,1,96,101,
Cleveland,State Auditor,Cindy Byrd,REP,140065,3,0,72,75,
Cleveland,State Auditor,Charlie Prater,REP,140065,6,1,75,82,
Cleveland,Attorney General,Mike Hunter,REP,140065,5,0,58,63,
Cleveland,Attorney General,Gentner Drummond,REP,140065,5,1,93,99,
Cleveland,Superintendent of Public Instruction,Joy Hofmeister,REP,140065,3,1,73,77,
Cleveland,Superintendent of Public Instruction,Linda Murphy,REP,140065,6,0,74,80,
Cleveland,Commissioner of Labor,Cathy Costello,REP,140065,4,1,82,87,
Cleveland,Commissioner of Labor,Leslie Osborn,REP,140065,5,0,65,70,
Cleveland,Corporation Commissioner,Bob Anthony,REP,140065,6,1,76,83,
Cleveland,Corporation Commissioner,Brian Bingman,REP,140065,4,0,73,77,
Cleveland,State House,Danny Sterling,REP,140065,5,0,81,86,27
Cleveland,State House,Dave Spaulding,REP,140065,5,1,69,75,27
Cleveland,Governor,Chris Powell,LIB,140065,0,0,0,0,
Cleveland,Governor,Rex Lawhorn,LIB,140065,0,0,0,0,
Cleveland,Corporation Commissioner,Ashley Nicole Mccray,DEM,140065,2,1,24,27,
Cleveland,Corporation Commissioner,Blake Cummings,DEM,140065,0,0,14,14,
Cleveland,U.S. House,Mary Brannon,DEM,140065,2,1,22,25,04
Cleveland,U.S. House,Fred Gipson,DEM,140065,0,0,16,16,04
Cleveland,Governor,Mick Cornett,REP,140067,8,4,105,117,
Cleveland,Governor,Kevin Stitt,REP,140067,4,6,54,64,
Cleveland,Lieutenant Governor,Dana Murphy,REP,140067,8,3,68,79,
Cleveland,Lieutenant Governor,Matt Pinnell,REP,140067,3,7,91,101,
Cleveland,State Auditor,Cindy Byrd,REP,140067,3,4,80,87,
Cleveland,State Auditor,Charlie Prater,REP,140067,8,5,76,89,
Cleveland,Attorney General,Mike Hunter,REP,140067,9,8,84,101,
Cleveland,Attorney General,Gentner Drummond,REP,140067,3,2,73,78,
Cleveland,Superintendent of Public Instruction,Joy Hofmeister,REP,140067,8,5,101,114,
Cleveland,Superintendent of Public Instruction,Linda Murphy,REP,140067,4,5,56,65,
Cleveland,Commissioner of Labor,Cathy Costello,REP,140067,2,7,65,74,
Cleveland,Commissioner of Labor,Leslie Osborn,REP,140067,10,3,90,103,
Cleveland,Corporation Commissioner,Bob Anthony,REP,140067,8,6,82,96,
Cleveland,Corporation Commissioner,Brian Bingman,REP,140067,3,4,73,80,
Cleveland,Governor,Chris Powell,LIB,140067,0,0,1,1,
Cleveland,Governor,Rex Lawhorn,LIB,140067,0,0,0,0,
Cleveland,Corporation Commissioner,Ashley Nicole Mccray,DEM,140067,5,2,76,83,
Cleveland,Corporation Commissioner,Blake Cummings,DEM,140067,0,0,23,23,
Cleveland,U.S. House,Mary Brannon,DEM,140067,4,1,50,55,04
Cleveland,U.S. House,Fred Gipson,DEM,140067,1,1,51,53,04
Cleveland,State Senate,Mary Boren,DEM,140067,2,2,87,91,16
Cleveland,State Senate,Claudia Griffith,DEM,140067,3,0,13,16,16
Cleveland,Governor,Mick Cornett,REP,140068,2,7,119,128,
Cleveland,Governor,Kevin Stitt,REP,140068,3,2,81,86,
Cleveland,Lieutenant Governor,Dana Murphy,REP,140068,2,2,98,102,
Cleveland,Lieutenant Governor,Matt Pinnell,REP,140068,3,6,98,107,
Cleveland,State Auditor,Cindy Byrd,REP,140068,3,4,108,115,
Cleveland,State Auditor,Charlie Prater,REP,140068,1,5,79,85,
Cleveland,Attorney General,Mike Hunter,REP,140068,4,4,118,126,
Cleveland,Attorney General,Gentner Drummond,REP,140068,1,5,79,85,
Cleveland,Superintendent of Public Instruction,Joy Hofmeister,REP,140068,4,4,131,139,
Cleveland,Superintendent of Public Instruction,Linda Murphy,REP,140068,1,4,68,73,
Cleveland,Commissioner of Labor,Cathy Costello,REP,140068,3,5,85,93,
Cleveland,Commissioner of Labor,Leslie Osborn,REP,140068,1,3,111,115,
Cleveland,Corporation Commissioner,Bob Anthony,REP,140068,3,6,98,107,
Cleveland,Corporation Commissioner,Brian Bingman,REP,140068,2,3,97,102,
Cleveland,Governor,Chris Powell,LIB,140068,0,0,0,0,
Cleveland,Governor,Rex Lawhorn,LIB,140068,0,0,0,0,
Cleveland,Corporation Commissioner,Ashley Nicole Mccray,DEM,140068,7,1,68,76,
Cleveland,Corporation Commissioner,Blake Cummings,DEM,140068,0,0,25,25,
Cleveland,U.S. House,Mary Brannon,DEM,140068,6,1,46,53,04
Cleveland,U.S. House,Fred Gipson,DEM,140068,1,0,48,49,04
Cleveland,State Senate,Mary Boren,DEM,140068,5,1,78,84,16
Cleveland,State Senate,Claudia Griffith,DEM,140068,2,0,17,19,16
Cleveland,Governor,Mick Cornett,REP,140069,9,5,208,222,
Cleveland,Governor,Kevin Stitt,REP,140069,7,5,193,205,
Cleveland,Lieutenant Governor,Dana Murphy,REP,140069,13,3,190,206,
Cleveland,Lieutenant Governor,Matt Pinnell,REP,140069,3,7,203,213,
Cleveland,State Auditor,Cindy Byrd,REP,140069,7,5,204,216,
Cleveland,State Auditor,Charlie Prater,REP,140069,9,5,180,194,
Cleveland,Attorney General,Mike Hunter,REP,140069,9,5,215,229,
Cleveland,Attorney General,Gentner Drummond,REP,140069,6,5,174,185,
Cleveland,Superintendent of Public Instruction,Joy Hofmeister,REP,140069,7,7,222,236,
Cleveland,Superintendent of Public Instruction,Linda Murphy,REP,140069,9,3,171,183,
Cleveland,Commissioner of Labor,Cathy Costello,REP,140069,5,4,198,207,
Cleveland,Commissioner of Labor,Leslie Osborn,REP,140069,11,6,193,210,
Cleveland,Corporation Commissioner,Bob Anthony,REP,140069,12,6,230,248,
Cleveland,Corporation Commissioner,Brian Bingman,REP,140069,4,4,158,166,
Cleveland,Governor,Chris Powell,LIB,140069,0,0,0,0,
Cleveland,Governor,Rex Lawhorn,LIB,140069,0,0,0,0,
Cleveland,Corporation Commissioner,Ashley Nicole Mccray,DEM,140069,8,1,65,74,
Cleveland,Corporation Commissioner,Blake Cummings,DEM,140069,2,0,33,35,
Cleveland,U.S. House,Mary Brannon,DEM,140069,8,0,59,67,04
Cleveland,U.S. House,Fred Gipson,DEM,140069,2,1,39,42,04
Cleveland,Governor,Mick Cornett,REP,140070,14,5,109,128,
Cleveland,Governor,Kevin Stitt,REP,140070,11,1,148,160,
Cleveland,Lieutenant Governor,Dana Murphy,REP,140070,12,1,107,120,
Cleveland,Lieutenant Governor,Matt Pinnell,REP,140070,13,5,144,162,
Cleveland,State Auditor,Cindy Byrd,REP,140070,15,2,129,146,
Cleveland,State Auditor,Charlie Prater,REP,140070,10,4,120,134,
Cleveland,Attorney General,Mike Hunter,REP,140070,17,3,107,127,
Cleveland,Attorney General,Gentner Drummond,REP,140070,8,3,145,156,
Cleveland,Superintendent of Public Instruction,Joy Hofmeister,REP,140070,15,3,118,136,
Cleveland,Superintendent of Public Instruction,Linda Murphy,REP,140070,10,3,135,148,
Cleveland,Commissioner of Labor,Cathy Costello,REP,140070,14,3,122,139,
Cleveland,Commissioner of Labor,Leslie Osborn,REP,140070,11,3,127,141,
Cleveland,Corporation Commissioner,Bob Anthony,REP,140070,18,1,128,147,
Cleveland,Corporation Commissioner,Brian Bingman,REP,140070,7,5,121,133,
Cleveland,Governor,Chris Powell,LIB,140070,0,0,0,0,
Cleveland,Governor,Rex Lawhorn,LIB,140070,0,0,0,0,
Cleveland,Corporation Commissioner,Ashley Nicole Mccray,DEM,140070,3,3,59,65,
Cleveland,Corporation Commissioner,Blake Cummings,DEM,140070,0,4,28,32,
Cleveland,U.S. House,Mary Brannon,DEM,140070,1,5,64,70,04
Cleveland,U.S. House,Fred Gipson,DEM,140070,2,2,23,27,04
Cleveland,State House,Leslie Bonebreak,DEM,140070,2,6,46,54,53
Cleveland,State House,Cyndy Southerland,DEM,140070,1,1,43,45,53
Cleveland,Governor,Mick Cornett,REP,140071,14,11,95,120,
Cleveland,Governor,Kevin Stitt,REP,140071,1,4,45,50,
Cleveland,Lieutenant Governor,Dana Murphy,REP,140071,11,6,67,84,
Cleveland,Lieutenant Governor,Matt Pinnell,REP,140071,4,8,70,82,
Cleveland,State Auditor,Cindy Byrd,REP,140071,9,9,88,106,
Cleveland,State Auditor,Charlie Prater,REP,140071,2,5,47,54,
Cleveland,Attorney General,Mike Hunter,REP,140071,9,7,77,93,
Cleveland,Attorney General,Gentner Drummond,REP,140071,4,7,58,69,
Cleveland,Superintendent of Public Instruction,Joy Hofmeister,REP,140071,9,10,81,100,
Cleveland,Superintendent of Public Instruction,Linda Murphy,REP,140071,5,4,55,64,
Cleveland,Commissioner of Labor,Cathy Costello,REP,140071,9,5,66,80,
Cleveland,Commissioner of Labor,Leslie Osborn,REP,140071,5,9,65,79,
Cleveland,Corporation Commissioner,Bob Anthony,REP,140071,13,11,78,102,
Cleveland,Corporation Commissioner,Brian Bingman,REP,140071,2,3,56,61,
Cleveland,Governor,Chris Powell,LIB,140071,0,0,1,1,
Cleveland,Governor,Rex Lawhorn,LIB,140071,0,0,0,0,
Cleveland,Corporation Commissioner,Ashley Nicole Mccray,DEM,140071,12,1,62,75,
Cleveland,Corporation Commissioner,Blake Cummings,DEM,140071,1,2,18,21,
Cleveland,U.S. House,Mary Brannon,DEM,140071,5,0,36,41,04
Cleveland,U.S. House,Fred Gipson,DEM,140071,8,4,47,59,04
Cleveland,Governor,Mick Cornett,REP,140072,19,5,177,201,
Cleveland,Governor,Kevin Stitt,REP,140072,15,5,198,218,
Cleveland,Lieutenant Governor,Dana Murphy,REP,140072,17,2,178,197,
Cleveland,Lieutenant Governor,Matt Pinnell,REP,140072,16,8,191,215,
Cleveland,State Auditor,Cindy Byrd,REP,140072,16,2,185,203,
Cleveland,State Auditor,Charlie Prater,REP,140072,17,8,178,203,
Cleveland,Attorney General,Mike Hunter,REP,140072,14,7,172,193,
Cleveland,Attorney General,Gentner Drummond,REP,140072,19,3,196,218,
Cleveland,Superintendent of Public Instruction,Joy Hofmeister,REP,140072,19,6,202,227,
Cleveland,Superintendent of Public Instruction,Linda Murphy,REP,140072,15,4,166,185,
Cleveland,Commissioner of Labor,Cathy Costello,REP,140072,18,5,177,200,
Cleveland,Commissioner of Labor,Leslie Osborn,REP,140072,16,5,185,206,
Cleveland,Corporation Commissioner,Bob Anthony,REP,140072,21,5,167,193,
Cleveland,Corporation Commissioner,Brian Bingman,REP,140072,12,5,197,214,
Cleveland,Governor,Chris Powell,LIB,140072,0,0,0,0,
Cleveland,Governor,Rex Lawhorn,LIB,140072,0,0,0,0,
Cleveland,Corporation Commissioner,Ashley Nicole Mccray,DEM,140072,12,3,79,94,
Cleveland,Corporation Commissioner,Blake Cummings,DEM,140072,2,0,40,42,
Cleveland,U.S. House,Mary Brannon,DEM,140072,8,2,85,95,04
Cleveland,U.S. House,Fred Gipson,DEM,140072,6,1,33,40,04
Cleveland,State House,Leslie Bonebreak,DEM,140072,10,2,71,83,53
Cleveland,State House,Cyndy Southerland,DEM,140072,4,1,49,54,53
Cleveland,Governor,Mick Cornett,REP,140073,29,25,390,444,
Cleveland,Governor,Kevin Stitt,REP,140073,18,8,264,290,
Cleveland,Lieutenant Governor,Dana Murphy,REP,140073,17,22,296,335,
Cleveland,Lieutenant Governor,Matt Pinnell,REP,140073,28,11,323,362,
Cleveland,State Auditor,Cindy Byrd,REP,140073,18,26,290,334,
Cleveland,State Auditor,Charlie Prater,REP,140073,26,7,299,332,
Cleveland,Attorney General,Mike Hunter,REP,140073,35,21,339,395,
Cleveland,Attorney General,Gentner Drummond,REP,140073,13,10,286,309,
Cleveland,Superintendent of Public Instruction,Joy Hofmeister,REP,140073,30,24,396,450,
Cleveland,Superintendent of Public Instruction,Linda Murphy,REP,140073,15,9,232,256,
Cleveland,Commissioner of Labor,Cathy Costello,REP,140073,25,14,286,325,
Cleveland,Commissioner of Labor,Leslie Osborn,REP,140073,22,19,328,369,
Cleveland,Corporation Commissioner,Bob Anthony,REP,140073,30,21,368,419,
Cleveland,Corporation Commissioner,Brian Bingman,REP,140073,16,12,246,274,
Cleveland,Governor,Chris Powell,LIB,140073,0,0,0,0,
Cleveland,Governor,Rex Lawhorn,LIB,140073,0,0,0,0,
Cleveland,Corporation Commissioner,Ashley Nicole Mccray,DEM,140073,34,13,182,229,
Cleveland,Corporation Commissioner,Blake Cummings,DEM,140073,3,1,50,54,
Cleveland,U.S. House,Mary Brannon,DEM,140073,22,6,116,144,04
Cleveland,U.S. House,Fred Gipson,DEM,140073,15,8,118,141,04
Cleveland,Governor,Mick Cornett,REP,140074,7,11,157,175,
Cleveland,Governor,Kevin Stitt,REP,140074,3,4,90,97,
Cleveland,Lieutenant Governor,Dana Murphy,REP,140074,2,6,122,130,
Cleveland,Lieutenant Governor,Matt Pinnell,REP,140074,8,9,113,130,
Cleveland,State Auditor,Cindy Byrd,REP,140074,7,9,144,160,
Cleveland,State Auditor,Charlie Prater,REP,140074,2,6,84,92,
Cleveland,Attorney General,Mike Hunter,REP,140074,7,5,144,156,
Cleveland,Attorney General,Gentner Drummond,REP,140074,3,10,95,108,
Cleveland,Superintendent of Public Instruction,Joy Hofmeister,REP,140074,5,6,139,150,
Cleveland,Superintendent of Public Instruction,Linda Murphy,REP,140074,5,9,102,116,
Cleveland,Commissioner of Labor,Cathy Costello,REP,140074,7,5,120,132,
Cleveland,Commissioner of Labor,Leslie Osborn,REP,140074,3,10,112,125,
Cleveland,Corporation Commissioner,Bob Anthony,REP,140074,7,10,140,157,
Cleveland,Corporation Commissioner,Brian Bingman,REP,140074,3,5,94,102,
Cleveland,Governor,Chris Powell,LIB,140074,0,0,0,0,
Cleveland,Governor,Rex Lawhorn,LIB,140074,0,0,0,0,
Cleveland,Corporation Commissioner,Ashley Nicole Mccray,DEM,140074,5,7,56,68,
Cleveland,Corporation Commissioner,Blake Cummings,DEM,140074,1,7,23,31,
Cleveland,U.S. House,Mary Brannon,DEM,140074,3,7,35,45,04
Cleveland,U.S. House,Fred Gipson,DEM,140074,3,7,45,55,04
Cleveland,Governor,Mick Cornett,REP,140076,7,12,90,109,
Cleveland,Governor,Kevin Stitt,REP,140076,2,12,76,90,
Cleveland,Lieutenant Governor,Dana Murphy,REP,140076,5,13,62,80,
Cleveland,Lieutenant Governor,Matt Pinnell,REP,140076,4,11,96,111,
Cleveland,State Auditor,Cindy Byrd,REP,140076,5,15,80,100,
Cleveland,State Auditor,Charlie Prater,REP,140076,4,9,77,90,
Cleveland,Attorney General,Mike Hunter,REP,140076,4,13,86,103,
Cleveland,Attorney General,Gentner Drummond,REP,140076,5,11,71,87,
Cleveland,Superintendent of Public Instruction,Joy Hofmeister,REP,140076,2,15,99,116,
Cleveland,Superintendent of Public Instruction,Linda Murphy,REP,140076,7,9,64,80,
Cleveland,Commissioner of Labor,Cathy Costello,REP,140076,3,14,75,92,
Cleveland,Commissioner of Labor,Leslie Osborn,REP,140076,6,10,87,103,
Cleveland,Corporation Commissioner,Bob Anthony,REP,140076,4,17,74,95,
Cleveland,Corporation Commissioner,Brian Bingman,REP,140076,5,7,85,97,
Cleveland,Governor,Chris Powell,LIB,140076,0,0,1,1,
Cleveland,Governor,Rex Lawhorn,LIB,140076,0,0,0,0,
Cleveland,Corporation Commissioner,Ashley Nicole Mccray,DEM,140076,1,7,76,84,
Cleveland,Corporation Commissioner,Blake Cummings,DEM,140076,2,0,17,19,
Cleveland,U.S. House,Mary Brannon,DEM,140076,1,4,45,50,04
Cleveland,U.S. House,Fred Gipson,DEM,140076,2,3,50,55,04
Cleveland,Governor,Mick Cornett,REP,140077,1,0,13,14,
Cleveland,Governor,Kevin Stitt,REP,140077,3,1,12,16,
Cleveland,Lieutenant Governor,Dana Murphy,REP,140077,1,0,9,10,
Cleveland,Lieutenant Governor,Matt Pinnell,REP,140077,3,1,16,20,
Cleveland,State Auditor,Cindy Byrd,REP,140077,4,1,11,16,
Cleveland,State Auditor,Charlie Prater,REP,140077,0,0,13,13,
Cleveland,Attorney General,Mike Hunter,REP,140077,1,1,8,10,
Cleveland,Attorney General,Gentner Drummond,REP,140077,3,0,17,20,
Cleveland,Superintendent of Public Instruction,Joy Hofmeister,REP,140077,3,0,11,14,
Cleveland,Superintendent of Public Instruction,Linda Murphy,REP,140077,1,1,13,15,
Cleveland,Commissioner of Labor,Cathy Costello,REP,140077,4,0,12,16,
Cleveland,Commissioner of Labor,Leslie Osborn,REP,140077,0,1,12,13,
Cleveland,Corporation Commissioner,Bob Anthony,REP,140077,0,1,17,18,
Cleveland,Corporation Commissioner,Brian Bingman,REP,140077,4,0,8,12,
Cleveland,Governor,Chris Powell,LIB,140077,0,0,2,2,
Cleveland,Governor,Rex Lawhorn,LIB,140077,0,0,0,0,
Cleveland,Corporation Commissioner,Ashley Nicole Mccray,DEM,140077,2,0,28,30,
Cleveland,Corporation Commissioner,Blake Cummings,DEM,140077,0,0,6,6,
Cleveland,U.S. House,Mary Brannon,DEM,140077,2,0,19,21,04
Cleveland,U.S. House,Fred Gipson,DEM,140077,0,0,14,14,04
Cleveland,Governor,Mick Cornett,REP,140078,20,1,141,162,
Cleveland,Governor,Kevin Stitt,REP,140078,18,3,283,304,
Cleveland,Lieutenant Governor,Dana Murphy,REP,140078,13,3,179,195,
Cleveland,Lieutenant Governor,Matt Pinnell,REP,140078,24,1,242,267,
Cleveland,State Auditor,Cindy Byrd,REP,140078,15,2,185,202,
Cleveland,State Auditor,Charlie Prater,REP,140078,20,2,218,240,
Cleveland,Attorney General,Mike Hunter,REP,140078,19,2,214,235,
Cleveland,Attorney General,Gentner Drummond,REP,140078,18,2,205,225,
Cleveland,Superintendent of Public Instruction,Joy Hofmeister,REP,140078,22,4,223,249,
Cleveland,Superintendent of Public Instruction,Linda Murphy,REP,140078,16,0,194,210,
Cleveland,Commissioner of Labor,Cathy Costello,REP,140078,15,0,194,209,
Cleveland,Commissioner of Labor,Leslie Osborn,REP,140078,22,4,216,242,
Cleveland,Corporation Commissioner,Bob Anthony,REP,140078,23,3,223,249,
Cleveland,Corporation Commissioner,Brian Bingman,REP,140078,15,1,190,206,
Cleveland,State House,Danny Sterling,REP,140078,14,1,172,187,27
Cleveland,State House,Dave Spaulding,REP,140078,22,3,238,263,27
Cleveland,Governor,Chris Powell,LIB,140078,0,0,0,0,
Cleveland,Governor,Rex Lawhorn,LIB,140078,0,0,1,1,
Cleveland,Corporation Commissioner,Ashley Nicole Mccray,DEM,140078,6,2,35,43,
Cleveland,Corporation Commissioner,Blake Cummings,DEM,140078,5,0,13,18,
Cleveland,U.S. House,Mary Brannon,DEM,140078,6,1,34,41,04
Cleveland,U.S. House,Fred Gipson,DEM,140078,5,1,14,20,04
Cleveland,Governor,Mick Cornett,REP,140080,2,0,39,41,
Cleveland,Governor,Kevin Stitt,REP,140080,7,5,58,70,
Cleveland,Lieutenant Governor,Dana Murphy,REP,140080,1,4,33,38,
Cleveland,Lieutenant Governor,Matt Pinnell,REP,140080,8,1,62,71,
Cleveland,State Auditor,Cindy Byrd,REP,140080,5,1,39,45,
Cleveland,State Auditor,Charlie Prater,REP,140080,4,4,53,61,
Cleveland,Attorney General,Mike Hunter,REP,140080,3,0,53,56,
Cleveland,Attorney General,Gentner Drummond,REP,140080,6,5,43,54,
Cleveland,Superintendent of Public Instruction,Joy Hofmeister,REP,140080,7,2,47,56,
Cleveland,Superintendent of Public Instruction,Linda Murphy,REP,140080,2,2,48,52,
Cleveland,Commissioner of Labor,Cathy Costello,REP,140080,2,4,40,46,
Cleveland,Commissioner of Labor,Leslie Osborn,REP,140080,7,1,55,63,
Cleveland,Corporation Commissioner,Bob Anthony,REP,140080,7,5,45,57,
Cleveland,Corporation Commissioner,Brian Bingman,REP,140080,2,0,50,52,
Cleveland,Governor,Chris Powell,LIB,140080,0,0,0,0,
Cleveland,Governor,Rex Lawhorn,LIB,140080,0,0,0,0,
Cleveland,Corporation Commissioner,Ashley Nicole Mccray,DEM,140080,1,0,9,10,
Cleveland,Corporation Commissioner,Blake Cummings,DEM,140080,0,0,2,2,
Cleveland,U.S. House,Mary Brannon,DEM,140080,1,0,6,7,04
Cleveland,U.S. House,Fred Gipson,DEM,140080,0,0,5,5,04
Cleveland,Governor,Mick Cornett,REP,140081,21,8,122,151,
Cleveland,Governor,Kevin Stitt,REP,140081,14,8,116,138,
Cleveland,Lieutenant Governor,Dana Murphy,REP,140081,26,5,105,136,
Cleveland,Lieutenant Governor,Matt Pinnell,REP,140081,8,11,117,136,
Cleveland,State Auditor,Cindy Byrd,REP,140081,18,9,120,147,
Cleveland,State Auditor,Charlie Prater,REP,140081,16,7,96,119,
Cleveland,Attorney General,Mike Hunter,REP,140081,20,12,114,146,
Cleveland,Attorney General,Gentner Drummond,REP,140081,15,4,113,132,
Cleveland,Superintendent of Public Instruction,Joy Hofmeister,REP,140081,20,10,124,154,
Cleveland,Superintendent of Public Instruction,Linda Murphy,REP,140081,15,6,101,122,
Cleveland,Commissioner of Labor,Cathy Costello,REP,140081,19,11,103,133,
Cleveland,Commissioner of Labor,Leslie Osborn,REP,140081,16,5,117,138,
Cleveland,Corporation Commissioner,Bob Anthony,REP,140081,26,11,121,158,
Cleveland,Corporation Commissioner,Brian Bingman,REP,140081,8,5,101,114,
Cleveland,Governor,Chris Powell,LIB,140081,0,0,1,1,
Cleveland,Governor,Rex Lawhorn,LIB,140081,0,0,0,0,
Cleveland,Corporation Commissioner,Ashley Nicole Mccray,DEM,140081,24,13,176,213,
Cleveland,Corporation Commissioner,Blake Cummings,DEM,140081,7,3,27,37,
Cleveland,U.S. House,Mary Brannon,DEM,140081,19,7,142,168,04
Cleveland,U.S. House,Fred Gipson,DEM,140081,12,9,62,83,04
Cleveland,State Senate,Mary Boren,DEM,140081,27,14,180,221,16
Cleveland,State Senate,Claudia Griffith,DEM,140081,5,2,24,31,16
Cleveland,Governor,Mick Cornett,REP,140082,14,23,190,227,
Cleveland,Governor,Kevin Stitt,REP,140082,12,11,127,150,
Cleveland,Lieutenant Governor,Dana Murphy,REP,140082,17,17,163,197,
Cleveland,Lieutenant Governor,Matt Pinnell,REP,140082,10,16,148,174,
Cleveland,State Auditor,Cindy Byrd,REP,140082,17,17,168,202,
Cleveland,State Auditor,Charlie Prater,REP,140082,10,15,135,160,
Cleveland,Attorney General,Mike Hunter,REP,140082,11,17,142,170,
Cleveland,Attorney General,Gentner Drummond,REP,140082,16,16,166,198,
Cleveland,Superintendent of Public Instruction,Joy Hofmeister,REP,140082,14,24,185,223,
Cleveland,Superintendent of Public Instruction,Linda Murphy,REP,140082,13,10,124,147,
Cleveland,Commissioner of Labor,Cathy Costello,REP,140082,18,11,154,183,
Cleveland,Commissioner of Labor,Leslie Osborn,REP,140082,9,22,154,185,
Cleveland,Corporation Commissioner,Bob Anthony,REP,140082,19,22,173,214,
Cleveland,Corporation Commissioner,Brian Bingman,REP,140082,8,10,131,149,
Cleveland,Governor,Chris Powell,LIB,140082,0,0,1,1,
Cleveland,Governor,Rex Lawhorn,LIB,140082,0,0,0,0,
Cleveland,Corporation Commissioner,Ashley Nicole Mccray,DEM,140082,20,19,151,190,
Cleveland,Corporation Commissioner,Blake Cummings,DEM,140082,2,8,34,44,
Cleveland,U.S. House,Mary Brannon,DEM,140082,17,15,101,133,04
Cleveland,U.S. House,Fred Gipson,DEM,140082,5,12,84,101,04
Cleveland,State Senate,Mary Boren,DEM,140082,18,22,161,201,16
Cleveland,State Senate,Claudia Griffith,DEM,140082,4,5,25,34,16
Cleveland,Governor,Mick Cornett,REP,140083,0,6,57,63,
Cleveland,Governor,Kevin Stitt,REP,140083,1,1,47,49,
Cleveland,Lieutenant Governor,Dana Murphy,REP,140083,1,5,36,42,
Cleveland,Lieutenant Governor,Matt Pinnell,REP,140083,0,2,65,67,
Cleveland,State Auditor,Cindy Byrd,REP,140083,0,6,49,55,
Cleveland,State Auditor,Charlie Prater,REP,140083,1,1,46,48,
Cleveland,Attorney General,Mike Hunter,REP,140083,1,5,47,53,
Cleveland,Attorney General,Gentner Drummond,REP,140083,0,2,52,54,
Cleveland,Superintendent of Public Instruction,Joy Hofmeister,REP,140083,0,5,59,64,
Cleveland,Superintendent of Public Instruction,Linda Murphy,REP,140083,1,2,41,44,
Cleveland,Commissioner of Labor,Cathy Costello,REP,140083,0,4,39,43,
Cleveland,Commissioner of Labor,Leslie Osborn,REP,140083,1,3,58,62,
Cleveland,Corporation Commissioner,Bob Anthony,REP,140083,0,5,47,52,
Cleveland,Corporation Commissioner,Brian Bingman,REP,140083,1,2,51,54,
Cleveland,State House,Bobby Cleveland,REP,140083,0,0,48,48,20
Cleveland,State House,Sherrie Conley,REP,140083,1,7,54,62,20
Cleveland,Governor,Chris Powell,LIB,140083,0,0,0,0,
Cleveland,Governor,Rex Lawhorn,LIB,140083,0,0,0,0,
Cleveland,Corporation Commissioner,Ashley Nicole Mccray,DEM,140083,3,1,38,42,
Cleveland,Corporation Commissioner,Blake Cummings,DEM,140083,0,0,11,11,
Cleveland,U.S. House,Mary Brannon,DEM,140083,2,0,26,28,04
Cleveland,U.S. House,Fred Gipson,DEM,140083,1,1,23,25,04
Cleveland,State Senate,Mary Boren,DEM,140083,3,1,40,44,16
Cleveland,State Senate,Claudia Griffith,DEM,140083,0,0,10,10,16
Cleveland,Governor,Mick Cornett,REP,140086,8,18,188,214,
Cleveland,Governor,Kevin Stitt,REP,140086,12,10,179,201,
Cleveland,Lieutenant Governor,Dana Murphy,REP,140086,4,6,174,184,
Cleveland,Lieutenant Governor,Matt Pinnell,REP,140086,16,23,185,224,
Cleveland,State Auditor,Cindy Byrd,REP,140086,8,12,161,181,
Cleveland,State Auditor,Charlie Prater,REP,140086,11,16,188,215,
Cleveland,Attorney General,Mike Hunter,REP,140086,10,17,186,213,
Cleveland,Attorney General,Gentner Drummond,REP,140086,10,11,174,195,
Cleveland,Superintendent of Public Instruction,Joy Hofmeister,REP,140086,9,24,221,254,
Cleveland,Superintendent of Public Instruction,Linda Murphy,REP,140086,11,5,139,155,
Cleveland,Commissioner of Labor,Cathy Costello,REP,140086,11,9,159,179,
Cleveland,Commissioner of Labor,Leslie Osborn,REP,140086,8,18,199,225,
Cleveland,Corporation Commissioner,Bob Anthony,REP,140086,10,15,191,216,
Cleveland,Corporation Commissioner,Brian Bingman,REP,140086,9,13,164,186,
Cleveland,Governor,Chris Powell,LIB,140086,0,1,0,1,
Cleveland,Governor,Rex Lawhorn,LIB,140086,0,0,2,2,
Cleveland,Corporation Commissioner,Ashley Nicole Mccray,DEM,140086,9,6,37,52,
Cleveland,Corporation Commissioner,Blake Cummings,DEM,140086,2,6,15,23,
Cleveland,U.S. House,Mary Brannon,DEM,140086,8,7,39,54,04
Cleveland,U.S. House,Fred Gipson,DEM,140086,3,6,13,22,04
Cleveland,Governor,Mick Cornett,REP,140087,4,1,82,87,
Cleveland,Governor,Kevin Stitt,REP,140087,5,0,96,101,
Cleveland,Lieutenant Governor,Dana Murphy,REP,140087,2,1,60,63,
Cleveland,Lieutenant Governor,Matt Pinnell,REP,140087,7,0,113,120,
Cleveland,State Auditor,Cindy Byrd,REP,140087,6,1,65,72,
Cleveland,State Auditor,Charlie Prater,REP,140087,2,0,104,106,
Cleveland,Attorney General,Mike Hunter,REP,140087,6,1,76,83,
Cleveland,Attorney General,Gentner Drummond,REP,140087,3,0,100,103,
Cleveland,Superintendent of Public Instruction,Joy Hofmeister,REP,140087,4,0,88,92,
Cleveland,Superintendent of Public Instruction,Linda Murphy,REP,140087,5,1,80,86,
Cleveland,Commissioner of Labor,Cathy Costello,REP,140087,5,1,68,74,
Cleveland,Commissioner of Labor,Leslie Osborn,REP,140087,4,0,101,105,
Cleveland,Corporation Commissioner,Bob Anthony,REP,140087,6,1,96,103,
Cleveland,Corporation Commissioner,Brian Bingman,REP,140087,3,0,77,80,
Cleveland,State House,Danny Sterling,REP,140087,4,1,97,102,27
Cleveland,State House,Dave Spaulding,REP,140087,3,0,75,78,27
Cleveland,Governor,Chris Powell,LIB,140087,0,0,0,0,
Cleveland,Governor,Rex Lawhorn,LIB,140087,0,0,0,0,
Cleveland,Corporation Commissioner,Ashley Nicole Mccray,DEM,140087,4,0,28,32,
Cleveland,Corporation Commissioner,Blake Cummings,DEM,140087,3,1,9,13,
Cleveland,U.S. House,Mary Brannon,DEM,140087,3,0,24,27,04
Cleveland,U.S. House,Fred Gipson,DEM,140087,4,1,12,17,04
Cleveland,Governor,Mick Cornett,REP,140088,12,15,222,249,
Cleveland,Governor,Kevin Stitt,REP,140088,27,23,244,294,
Cleveland,Lieutenant Governor,Dana Murphy,REP,140088,17,17,206,240,
Cleveland,Lieutenant Governor,Matt Pinnell,REP,140088,22,21,240,283,
Cleveland,State Auditor,Cindy Byrd,REP,140088,15,15,224,254,
Cleveland,State Auditor,Charlie Prater,REP,140088,21,23,209,253,
Cleveland,Attorney General,Mike Hunter,REP,140088,23,16,230,269,
Cleveland,Attorney General,Gentner Drummond,REP,140088,15,22,226,263,
Cleveland,Superintendent of Public Instruction,Joy Hofmeister,REP,140088,24,22,247,293,
Cleveland,Superintendent of Public Instruction,Linda Murphy,REP,140088,15,16,200,231,
Cleveland,Commissioner of Labor,Cathy Costello,REP,140088,26,10,190,226,
Cleveland,Commissioner of Labor,Leslie Osborn,REP,140088,13,28,246,287,
Cleveland,Corporation Commissioner,Bob Anthony,REP,140088,23,18,268,309,
Cleveland,Corporation Commissioner,Brian Bingman,REP,140088,16,20,174,210,
Cleveland,Governor,Chris Powell,LIB,140088,0,0,0,0,
Cleveland,Governor,Rex Lawhorn,LIB,140088,0,0,0,0,
Cleveland,Corporation Commissioner,Ashley Nicole Mccray,DEM,140088,12,1,46,59,
Cleveland,Corporation Commissioner,Blake Cummings,DEM,140088,1,0,18,19,
Cleveland,U.S. House,Mary Brannon,DEM,140088,12,1,40,53,04
Cleveland,U.S. House,Fred Gipson,DEM,140088,1,0,24,25,04
Cleveland,Governor,Mick Cornett,REP,140089,22,14,201,237,
Cleveland,Governor,Kevin Stitt,REP,140089,22,21,173,216,
Cleveland,Lieutenant Governor,Dana Murphy,REP,140089,22,15,159,196,
Cleveland,Lieutenant Governor,Matt Pinnell,REP,140089,21,20,205,246,
Cleveland,State Auditor,Cindy Byrd,REP,140089,24,15,189,228,
Cleveland,State Auditor,Charlie Prater,REP,140089,16,20,173,209,
Cleveland,Attorney General,Mike Hunter,REP,140089,25,19,188,232,
Cleveland,Attorney General,Gentner Drummond,REP,140089,18,16,183,217,
Cleveland,Superintendent of Public Instruction,Joy Hofmeister,REP,140089,21,24,214,259,
Cleveland,Superintendent of Public Instruction,Linda Murphy,REP,140089,19,11,152,182,
Cleveland,Commissioner of Labor,Cathy Costello,REP,140089,16,15,166,197,
Cleveland,Commissioner of Labor,Leslie Osborn,REP,140089,25,20,198,243,
Cleveland,Corporation Commissioner,Bob Anthony,REP,140089,25,19,193,237,
Cleveland,Corporation Commissioner,Brian Bingman,REP,140089,16,16,174,206,
Cleveland,Governor,Chris Powell,LIB,140089,0,0,2,2,
Cleveland,Governor,Rex Lawhorn,LIB,140089,0,0,0,0,
Cleveland,Corporation Commissioner,Ashley Nicole Mccray,DEM,140089,14,4,89,107,
Cleveland,Corporation Commissioner,Blake Cummings,DEM,140089,3,1,35,39,
Cleveland,U.S. House,Mary Brannon,DEM,140089,9,4,75,88,04
Cleveland,U.S. House,Fred Gipson,DEM,140089,8,1,48,57,04
Cleveland,State House,Leslie Bonebreak,DEM,140089,14,3,84,101,53
Cleveland,State House,Cyndy Southerland,DEM,140089,3,2,40,45,53
Cleveland,Governor,Mick Cornett,REP,140090,0,0,0,0,
Cleveland,Governor,Kevin Stitt,REP,140090,0,0,0,0,
Cleveland,Lieutenant Governor,Dana Murphy,REP,140090,0,0,0,0,
Cleveland,Lieutenant Governor,Matt Pinnell,REP,140090,0,0,0,0,
Cleveland,State Auditor,Cindy Byrd,REP,140090,0,0,0,0,
Cleveland,State Auditor,Charlie Prater,REP,140090,0,0,0,0,
Cleveland,Attorney General,Mike Hunter,REP,140090,0,0,0,0,
Cleveland,Attorney General,Gentner Drummond,REP,140090,0,0,0,0,
Cleveland,Superintendent of Public Instruction,Joy Hofmeister,REP,140090,0,0,0,0,
Cleveland,Superintendent of Public Instruction,Linda Murphy,REP,140090,0,0,0,0,
Cleveland,Commissioner of Labor,Cathy Costello,REP,140090,0,0,0,0,
Cleveland,Commissioner of Labor,Leslie Osborn,REP,140090,0,0,0,0,
Cleveland,Corporation Commissioner,Bob Anthony,REP,140090,0,0,0,0,
Cleveland,Corporation Commissioner,Brian Bingman,REP,140090,0,0,0,0,
Cleveland,Governor,Chris Powell,LIB,140090,0,0,0,0,
Cleveland,Governor,Rex Lawhorn,LIB,140090,0,0,0,0,
Cleveland,Corporation Commissioner,Ashley Nicole Mccray,DEM,140090,0,0,0,0,
Cleveland,Corporation Commissioner,Blake Cummings,DEM,140090,0,0,0,0,
Cleveland,U.S. House,Mary Brannon,DEM,140090,0,0,0,0,04
Cleveland,U.S. House,Fred Gipson,DEM,140090,0,0,0,0,04
Cleveland,Governor,Mick Cornett,REP,140091,1,3,18,22,
Cleveland,Governor,Kevin Stitt,REP,140091,0,4,16,20,
Cleveland,Lieutenant Governor,Dana Murphy,REP,140091,0,3,21,24,
Cleveland,Lieutenant Governor,Matt Pinnell,REP,140091,1,4,13,18,
Cleveland,State Auditor,Cindy Byrd,REP,140091,1,1,22,24,
Cleveland,State Auditor,Charlie Prater,REP,140091,0,6,12,18,
Cleveland,Attorney General,Mike Hunter,REP,140091,1,2,19,22,
Cleveland,Attorney General,Gentner Drummond,REP,140091,0,5,17,22,
Cleveland,Superintendent of Public Instruction,Joy Hofmeister,REP,140091,0,5,24,29,
Cleveland,Superintendent of Public Instruction,Linda Murphy,REP,140091,1,2,12,15,
Cleveland,Commissioner of Labor,Cathy Costello,REP,140091,0,1,14,15,
Cleveland,Commissioner of Labor,Leslie Osborn,REP,140091,1,6,21,28,
Cleveland,Corporation Commissioner,Bob Anthony,REP,140091,0,6,20,26,
Cleveland,Corporation Commissioner,Brian Bingman,REP,140091,1,1,16,18,
Cleveland,Governor,Chris Powell,LIB,140091,0,0,0,0,
Cleveland,Governor,Rex Lawhorn,LIB,140091,0,0,0,0,
Cleveland,Corporation Commissioner,Ashley Nicole Mccray,DEM,140091,0,3,4,7,
Cleveland,Corporation Commissioner,Blake Cummings,DEM,140091,0,0,2,2,
Cleveland,U.S. House,Mary Brannon,DEM,140091,0,1,6,7,04
Cleveland,U.S. House,Fred Gipson,DEM,140091,0,2,0,2,04
Cleveland,Governor,Mick Cornett,REP,140092,0,0,0,0,
Cleveland,Governor,Kevin Stitt,REP,140092,0,0,0,0,
Cleveland,Lieutenant Governor,Dana Murphy,REP,140092,0,0,0,0,
Cleveland,Lieutenant Governor,Matt Pinnell,REP,140092,0,0,0,0,
Cleveland,State Auditor,Cindy Byrd,REP,140092,0,0,0,0,
Cleveland,State Auditor,Charlie Prater,REP,140092,0,0,0,0,
Cleveland,Attorney General,Mike Hunter,REP,140092,0,0,0,0,
Cleveland,Attorney General,Gentner Drummond,REP,140092,0,0,0,0,
Cleveland,Superintendent of Public Instruction,Joy Hofmeister,REP,140092,0,0,0,0,
Cleveland,Superintendent of Public Instruction,Linda Murphy,REP,140092,0,0,0,0,
Cleveland,Commissioner of Labor,Cathy Costello,REP,140092,0,0,0,0,
Cleveland,Commissioner of Labor,Leslie Osborn,REP,140092,0,0,0,0,
Cleveland,Corporation Commissioner,Bob Anthony,REP,140092,0,0,0,0,
Cleveland,Corporation Commissioner,Brian Bingman,REP,140092,0,0,0,0,
Cleveland,Governor,Chris Powell,LIB,140092,0,0,0,0,
Cleveland,Governor,Rex Lawhorn,LIB,140092,0,0,0,0,
Cleveland,Corporation Commissioner,Ashley Nicole Mccray,DEM,140092,0,0,0,0,
Cleveland,Corporation Commissioner,Blake Cummings,DEM,140092,0,0,0,0,
Cleveland,U.S. House,Mary Brannon,DEM,140092,0,0,0,0,04
Cleveland,U.S. House,Fred Gipson,DEM,140092,0,0,0,0,04
Cleveland,State Senate,Mary Boren,DEM,140092,0,0,0,0,16
Cleveland,State Senate,Claudia Griffith,DEM,140092,0,0,0,0,16
Cleveland,Governor,Mick Cornett,REP,140093,3,4,57,64,
Cleveland,Governor,Kevin Stitt,REP,140093,1,1,29,31,
Cleveland,Lieutenant Governor,Dana Murphy,REP,140093,3,3,36,42,
Cleveland,Lieutenant Governor,Matt Pinnell,REP,140093,1,2,45,48,
Cleveland,State Auditor,Cindy Byrd,REP,140093,2,1,33,36,
Cleveland,State Auditor,Charlie Prater,REP,140093,2,4,41,47,
Cleveland,Attorney General,Mike Hunter,REP,140093,4,3,38,45,
Cleveland,Attorney General,Gentner Drummond,REP,140093,0,2,40,42,
Cleveland,Superintendent of Public Instruction,Joy Hofmeister,REP,140093,2,4,53,59,
Cleveland,Superintendent of Public Instruction,Linda Murphy,REP,140093,1,1,24,26,
Cleveland,Commissioner of Labor,Cathy Costello,REP,140093,2,3,40,45,
Cleveland,Commissioner of Labor,Leslie Osborn,REP,140093,2,2,37,41,
Cleveland,Corporation Commissioner,Bob Anthony,REP,140093,3,3,53,59,
Cleveland,Corporation Commissioner,Brian Bingman,REP,140093,1,2,23,26,
Cleveland,Governor,Chris Powell,LIB,140093,0,0,3,3,
Cleveland,Governor,Rex Lawhorn,LIB,140093,0,0,1,1,
Cleveland,Corporation Commissioner,Ashley Nicole Mccray,DEM,140093,9,1,61,71,
Cleveland,Corporation Commissioner,Blake Cummings,DEM,140093,2,4,20,26,
Cleveland,U.S. House,Mary Brannon,DEM,140093,2,4,27,33,04
Cleveland,U.S. House,Fred Gipson,DEM,140093,11,1,56,68,04
Cleveland,State Senate,Mary Boren,DEM,140093,13,5,74,92,16
Cleveland,State Senate,Claudia Griffith,DEM,140093,0,0,10,10,16
Cleveland,Governor,Mick Cornett,REP,140094,0,5,26,31,
Cleveland,Governor,Kevin Stitt,REP,140094,2,8,25,35,
Cleveland,Lieutenant Governor,Dana Murphy,REP,140094,2,5,27,34,
Cleveland,Lieutenant Governor,Matt Pinnell,REP,140094,0,8,24,32,
Cleveland,State Auditor,Cindy Byrd,REP,140094,0,7,23,30,
Cleveland,State Auditor,Charlie Prater,REP,140094,2,6,26,34,
Cleveland,Attorney General,Mike Hunter,REP,140094,2,8,22,32,
Cleveland,Attorney General,Gentner Drummond,REP,140094,0,5,29,34,
Cleveland,Superintendent of Public Instruction,Joy Hofmeister,REP,140094,0,11,26,37,
Cleveland,Superintendent of Public Instruction,Linda Murphy,REP,140094,0,2,23,25,
Cleveland,Commissioner of Labor,Cathy Costello,REP,140094,0,8,26,34,
Cleveland,Commissioner of Labor,Leslie Osborn,REP,140094,2,4,23,29,
Cleveland,Corporation Commissioner,Bob Anthony,REP,140094,1,6,27,34,
Cleveland,Corporation Commissioner,Brian Bingman,REP,140094,1,6,23,30,
Cleveland,Governor,Chris Powell,LIB,140094,0,0,0,0,
Cleveland,Governor,Rex Lawhorn,LIB,140094,0,0,0,0,
Cleveland,Corporation Commissioner,Ashley Nicole Mccray,DEM,140094,4,0,20,24,
Cleveland,Corporation Commissioner,Blake Cummings,DEM,140094,1,0,7,8,
Cleveland,U.S. House,Mary Brannon,DEM,140094,2,0,17,19,04
Cleveland,U.S. House,Fred Gipson,DEM,140094,3,0,11,14,04
Cleveland,Governor,Mick Cornett,REP,140095,2,3,48,53,
Cleveland,Governor,Kevin Stitt,REP,140095,0,1,67,68,
Cleveland,Lieutenant Governor,Dana Murphy,REP,140095,3,2,51,56,
Cleveland,Lieutenant Governor,Matt Pinnell,REP,140095,0,2,60,62,
Cleveland,State Auditor,Cindy Byrd,REP,140095,2,3,57,62,
Cleveland,State Auditor,Charlie Prater,REP,140095,1,1,54,56,
Cleveland,Attorney General,Mike Hunter,REP,140095,2,2,57,61,
Cleveland,Attorney General,Gentner Drummond,REP,140095,1,2,55,58,
Cleveland,Superintendent of Public Instruction,Joy Hofmeister,REP,140095,1,3,47,51,
Cleveland,Superintendent of Public Instruction,Linda Murphy,REP,140095,2,1,63,66,
Cleveland,Commissioner of Labor,Cathy Costello,REP,140095,2,2,49,53,
Cleveland,Commissioner of Labor,Leslie Osborn,REP,140095,1,2,58,61,
Cleveland,Corporation Commissioner,Bob Anthony,REP,140095,2,2,50,54,
Cleveland,Corporation Commissioner,Brian Bingman,REP,140095,1,2,59,62,
Cleveland,State House,Bobby Cleveland,REP,140095,2,1,67,70,20
Cleveland,State House,Sherrie Conley,REP,140095,1,3,46,50,20
Cleveland,Governor,Chris Powell,LIB,140095,0,0,0,0,
Cleveland,Governor,Rex Lawhorn,LIB,140095,0,0,0,0,
Cleveland,Corporation Commissioner,Ashley Nicole Mccray,DEM,140095,0,1,39,40,
Cleveland,Corporation Commissioner,Blake Cummings,DEM,140095,0,0,15,15,
Cleveland,U.S. House,Mary Brannon,DEM,140095,0,0,38,38,04
Cleveland,U.S. House,Fred Gipson,DEM,140095,0,1,16,17,04
Coal,Governor,Mick Cornett,REP,150002,0,2,15,17,
Coal,Governor,Kevin Stitt,REP,150002,0,2,25,27,
Coal,Lieutenant Governor,Dana Murphy,REP,150002,0,4,17,21,
Coal,Lieutenant Governor,Matt Pinnell,REP,150002,0,0,21,21,
Coal,State Auditor,Cindy Byrd,REP,150002,0,2,26,28,
Coal,State Auditor,Charlie Prater,REP,150002,0,2,12,14,
Coal,Attorney General,Mike Hunter,REP,150002,0,2,18,20,
Coal,Attorney General,Gentner Drummond,REP,150002,0,2,20,22,
Coal,Superintendent of Public Instruction,Joy Hofmeister,REP,150002,0,3,19,22,
Coal,Superintendent of Public Instruction,Linda Murphy,REP,150002,0,1,19,20,
Coal,Commissioner of Labor,Cathy Costello,REP,150002,0,3,17,20,
Coal,Commissioner of Labor,Leslie Osborn,REP,150002,0,0,21,21,
Coal,Corporation Commissioner,Bob Anthony,REP,150002,0,4,23,27,
Coal,Corporation Commissioner,Brian Bingman,REP,150002,0,0,14,14,
Coal,Governor,Chris Powell,LIB,150002,0,0,0,0,
Coal,Governor,Rex Lawhorn,LIB,150002,0,0,0,0,
Coal,Corporation Commissioner,Ashley Nicole Mccray,DEM,150002,5,22,129,156,
Coal,Corporation Commissioner,Blake Cummings,DEM,150002,7,14,159,180,
Coal,U.S. House,Jason Nichols,DEM,150002,7,21,153,181,02
Coal,U.S. House,Clay Padgett,DEM,150002,5,15,134,154,02
Coal,Governor,Mick Cornett,REP,150003,0,0,6,6,
Coal,Governor,Kevin Stitt,REP,150003,0,0,10,10,
Coal,Lieutenant Governor,Dana Murphy,REP,150003,0,0,5,5,
Coal,Lieutenant Governor,Matt Pinnell,REP,150003,0,0,11,11,
Coal,State Auditor,Cindy Byrd,REP,150003,0,0,14,14,
Coal,State Auditor,Charlie Prater,REP,150003,0,0,2,2,
Coal,Attorney General,Mike Hunter,REP,150003,0,0,10,10,
Coal,Attorney General,Gentner Drummond,REP,150003,0,0,6,6,
Coal,Superintendent of Public Instruction,Joy Hofmeister,REP,150003,0,0,7,7,
Coal,Superintendent of Public Instruction,Linda Murphy,REP,150003,0,0,9,9,
Coal,Commissioner of Labor,Cathy Costello,REP,150003,0,0,5,5,
Coal,Commissioner of Labor,Leslie Osborn,REP,150003,0,0,11,11,
Coal,Corporation Commissioner,Bob Anthony,REP,150003,0,0,6,6,
Coal,Corporation Commissioner,Brian Bingman,REP,150003,0,0,10,10,
Coal,Governor,Chris Powell,LIB,150003,0,0,0,0,
Coal,Governor,Rex Lawhorn,LIB,150003,0,0,0,0,
Coal,Corporation Commissioner,Ashley Nicole Mccray,DEM,150003,2,6,44,52,
Coal,Corporation Commissioner,Blake Cummings,DEM,150003,3,12,75,90,
Coal,U.S. House,Jason Nichols,DEM,150003,5,12,52,69,02
Coal,U.S. House,Clay Padgett,DEM,150003,0,6,67,73,02
Coal,Governor,Mick Cornett,REP,150004,0,3,9,12,
Coal,Governor,Kevin Stitt,REP,150004,2,6,16,24,
Coal,Lieutenant Governor,Dana Murphy,REP,150004,2,2,13,17,
Coal,Lieutenant Governor,Matt Pinnell,REP,150004,0,7,9,16,
Coal,State Auditor,Cindy Byrd,REP,150004,2,8,22,32,
Coal,State Auditor,Charlie Prater,REP,150004,0,1,3,4,
Coal,Attorney General,Mike Hunter,REP,150004,0,5,10,15,
Coal,Attorney General,Gentner Drummond,REP,150004,2,4,13,19,
Coal,Superintendent of Public Instruction,Joy Hofmeister,REP,150004,0,1,10,11,
Coal,Superintendent of Public Instruction,Linda Murphy,REP,150004,2,8,13,23,
Coal,Commissioner of Labor,Cathy Costello,REP,150004,2,3,9,14,
Coal,Commissioner of Labor,Leslie Osborn,REP,150004,0,5,13,18,
Coal,Corporation Commissioner,Bob Anthony,REP,150004,2,4,12,18,
Coal,Corporation Commissioner,Brian Bingman,REP,150004,0,5,10,15,
Coal,Governor,Chris Powell,LIB,150004,0,0,0,0,
Coal,Governor,Rex Lawhorn,LIB,150004,0,0,0,0,
Coal,Corporation Commissioner,Ashley Nicole Mccray,DEM,150004,5,2,27,34,
Coal,Corporation Commissioner,Blake Cummings,DEM,150004,2,1,24,27,
Coal,U.S. House,Jason Nichols,DEM,150004,1,2,15,18,02
Coal,U.S. House,Clay Padgett,DEM,150004,6,1,36,43,02
Coal,Governor,Mick Cornett,REP,150005,0,3,13,16,
Coal,Governor,Kevin Stitt,REP,150005,2,6,9,17,
Coal,Lieutenant Governor,Dana Murphy,REP,150005,0,7,10,17,
Coal,Lieutenant Governor,Matt Pinnell,REP,150005,2,2,12,16,
Coal,State Auditor,Cindy Byrd,REP,150005,2,9,23,34,
Coal,State Auditor,Charlie Prater,REP,150005,0,0,0,0,
Coal,Attorney General,Mike Hunter,REP,150005,0,4,12,16,
Coal,Attorney General,Gentner Drummond,REP,150005,2,5,10,17,
Coal,Superintendent of Public Instruction,Joy Hofmeister,REP,150005,0,2,8,10,
Coal,Superintendent of Public Instruction,Linda Murphy,REP,150005,2,7,12,21,
Coal,Commissioner of Labor,Cathy Costello,REP,150005,0,8,14,22,
Coal,Commissioner of Labor,Leslie Osborn,REP,150005,2,1,8,11,
Coal,Corporation Commissioner,Bob Anthony,REP,150005,0,5,12,17,
Coal,Corporation Commissioner,Brian Bingman,REP,150005,2,4,10,16,
Coal,Governor,Chris Powell,LIB,150005,0,0,1,1,
Coal,Governor,Rex Lawhorn,LIB,150005,0,0,0,0,
Coal,Corporation Commissioner,Ashley Nicole Mccray,DEM,150005,2,9,21,32,
Coal,Corporation Commissioner,Blake Cummings,DEM,150005,1,10,25,36,
Coal,U.S. House,Jason Nichols,DEM,150005,2,7,17,26,02
Coal,U.S. House,Clay Padgett,DEM,150005,1,12,29,42,02
Coal,Governor,Mick Cornett,REP,150006,1,1,10,12,
Coal,Governor,Kevin Stitt,REP,150006,0,3,5,8,
Coal,Lieutenant Governor,Dana Murphy,REP,150006,0,2,7,9,
Coal,Lieutenant Governor,Matt Pinnell,REP,150006,1,2,7,10,
Coal,State Auditor,Cindy Byrd,REP,150006,0,4,14,18,
Coal,State Auditor,Charlie Prater,REP,150006,1,0,2,3,
Coal,Attorney General,Mike Hunter,REP,150006,1,3,5,9,
Coal,Attorney General,Gentner Drummond,REP,150006,0,1,10,11,
Coal,Superintendent of Public Instruction,Joy Hofmeister,REP,150006,0,2,5,7,
Coal,Superintendent of Public Instruction,Linda Murphy,REP,150006,1,2,11,14,
Coal,Commissioner of Labor,Cathy Costello,REP,150006,1,2,8,11,
Coal,Commissioner of Labor,Leslie Osborn,REP,150006,0,2,6,8,
Coal,Corporation Commissioner,Bob Anthony,REP,150006,1,3,10,14,
Coal,Corporation Commissioner,Brian Bingman,REP,150006,0,1,3,4,
Coal,Governor,Chris Powell,LIB,150006,0,0,0,0,
Coal,Governor,Rex Lawhorn,LIB,150006,0,0,0,0,
Coal,Corporation Commissioner,Ashley Nicole Mccray,DEM,150006,0,5,22,27,
Coal,Corporation Commissioner,Blake Cummings,DEM,150006,0,3,17,20,
Coal,U.S. House,Jason Nichols,DEM,150006,0,5,15,20,02
Coal,U.S. House,Clay Padgett,DEM,150006,0,4,24,28,02
Coal,Governor,Mick Cornett,REP,150007,0,0,3,3,
Coal,Governor,Kevin Stitt,REP,150007,1,2,22,25,
Coal,Lieutenant Governor,Dana Murphy,REP,150007,0,1,7,8,
Coal,Lieutenant Governor,Matt Pinnell,REP,150007,1,1,17,19,
Coal,State Auditor,Cindy Byrd,REP,150007,1,2,25,28,
Coal,State Auditor,Charlie Prater,REP,150007,0,0,1,1,
Coal,Attorney General,Mike Hunter,REP,150007,0,1,11,12,
Coal,Attorney General,Gentner Drummond,REP,150007,1,1,13,15,
Coal,Superintendent of Public Instruction,Joy Hofmeister,REP,150007,0,1,12,13,
Coal,Superintendent of Public Instruction,Linda Murphy,REP,150007,1,1,13,15,
Coal,Commissioner of Labor,Cathy Costello,REP,150007,1,1,13,15,
Coal,Commissioner of Labor,Leslie Osborn,REP,150007,0,1,12,13,
Coal,Corporation Commissioner,Bob Anthony,REP,150007,1,2,13,16,
Coal,Corporation Commissioner,Brian Bingman,REP,150007,0,0,12,12,
Coal,Governor,Chris Powell,LIB,150007,0,0,0,0,
Coal,Governor,Rex Lawhorn,LIB,150007,0,0,0,0,
Coal,Corporation Commissioner,Ashley Nicole Mccray,DEM,150007,5,13,46,64,
Coal,Corporation Commissioner,Blake Cummings,DEM,150007,0,19,59,78,
Coal,U.S. House,Jason Nichols,DEM,150007,2,15,41,58,02
Coal,U.S. House,Clay Padgett,DEM,150007,3,18,62,83,02
Coal,Governor,Mick Cornett,REP,150009,0,0,2,2,
Coal,Governor,Kevin Stitt,REP,150009,0,0,10,10,
Coal,Lieutenant Governor,Dana Murphy,REP,150009,0,0,3,3,
Coal,Lieutenant Governor,Matt Pinnell,REP,150009,0,0,9,9,
Coal,State Auditor,Cindy Byrd,REP,150009,0,0,9,9,
Coal,State Auditor,Charlie Prater,REP,150009,0,0,3,3,
Coal,Attorney General,Mike Hunter,REP,150009,0,0,7,7,
Coal,Attorney General,Gentner Drummond,REP,150009,0,0,5,5,
Coal,Superintendent of Public Instruction,Joy Hofmeister,REP,150009,0,0,6,6,
Coal,Superintendent of Public Instruction,Linda Murphy,REP,150009,0,0,6,6,
Coal,Commissioner of Labor,Cathy Costello,REP,150009,0,0,2,2,
Coal,Commissioner of Labor,Leslie Osborn,REP,150009,0,0,10,10,
Coal,Corporation Commissioner,Bob Anthony,REP,150009,0,0,9,9,
Coal,Corporation Commissioner,Brian Bingman,REP,150009,0,0,3,3,
Coal,Governor,Chris Powell,LIB,150009,0,0,0,0,
Coal,Governor,Rex Lawhorn,LIB,150009,0,0,0,0,
Coal,Corporation Commissioner,Ashley Nicole Mccray,DEM,150009,0,1,10,11,
Coal,Corporation Commissioner,Blake Cummings,DEM,150009,0,1,22,23,
Coal,U.S. House,Jason Nichols,DEM,150009,0,2,10,12,02
Coal,U.S. House,Clay Padgett,DEM,150009,0,0,22,22,02
Coal,Governor,Mick Cornett,REP,150010,0,1,7,8,
Coal,Governor,Kevin Stitt,REP,150010,0,1,9,10,
Coal,Lieutenant Governor,Dana Murphy,REP,150010,0,1,4,5,
Coal,Lieutenant Governor,Matt Pinnell,REP,150010,0,1,12,13,
Coal,State Auditor,Cindy Byrd,REP,150010,0,2,11,13,
Coal,State Auditor,Charlie Prater,REP,150010,0,1,5,6,
Coal,Attorney General,Mike Hunter,REP,150010,0,2,13,15,
Coal,Attorney General,Gentner Drummond,REP,150010,0,1,3,4,
Coal,Superintendent of Public Instruction,Joy Hofmeister,REP,150010,0,2,4,6,
Coal,Superintendent of Public Instruction,Linda Murphy,REP,150010,0,0,12,12,
Coal,Commissioner of Labor,Cathy Costello,REP,150010,0,1,11,12,
Coal,Commissioner of Labor,Leslie Osborn,REP,150010,0,1,5,6,
Coal,Corporation Commissioner,Bob Anthony,REP,150010,0,2,10,12,
Coal,Corporation Commissioner,Brian Bingman,REP,150010,0,0,6,6,
Coal,Governor,Chris Powell,LIB,150010,0,0,0,0,
Coal,Governor,Rex Lawhorn,LIB,150010,0,0,0,0,
Coal,Corporation Commissioner,Ashley Nicole Mccray,DEM,150010,0,5,20,25,
Coal,Corporation Commissioner,Blake Cummings,DEM,150010,0,3,27,30,
Coal,U.S. House,Jason Nichols,DEM,150010,0,5,16,21,02
Coal,U.S. House,Clay Padgett,DEM,150010,0,3,32,35,02
Coal,Governor,Mick Cornett,REP,150011,0,1,3,4,
Coal,Governor,Kevin Stitt,REP,150011,0,0,11,11,
Coal,Lieutenant Governor,Dana Murphy,REP,150011,0,0,4,4,
Coal,Lieutenant Governor,Matt Pinnell,REP,150011,0,1,9,10,
Coal,State Auditor,Cindy Byrd,REP,150011,0,1,11,12,
Coal,State Auditor,Charlie Prater,REP,150011,0,0,3,3,
Coal,Attorney General,Mike Hunter,REP,150011,0,0,8,8,
Coal,Attorney General,Gentner Drummond,REP,150011,0,1,6,7,
Coal,Superintendent of Public Instruction,Joy Hofmeister,REP,150011,0,0,6,6,
Coal,Superintendent of Public Instruction,Linda Murphy,REP,150011,0,1,7,8,
Coal,Commissioner of Labor,Cathy Costello,REP,150011,0,1,7,8,
Coal,Commissioner of Labor,Leslie Osborn,REP,150011,0,0,6,6,
Coal,Corporation Commissioner,Bob Anthony,REP,150011,0,1,6,7,
Coal,Corporation Commissioner,Brian Bingman,REP,150011,0,0,8,8,
Coal,Governor,Chris Powell,LIB,150011,0,0,0,0,
Coal,Governor,Rex Lawhorn,LIB,150011,0,0,0,0,
Coal,Corporation Commissioner,Ashley Nicole Mccray,DEM,150011,3,16,82,101,
Coal,Corporation Commissioner,Blake Cummings,DEM,150011,2,25,83,110,
Coal,U.S. House,Jason Nichols,DEM,150011,2,21,74,97,02
Coal,U.S. House,Clay Padgett,DEM,150011,4,20,87,111,02
Comanche,Governor,Mick Cornett,REP,160001,6,6,126,138,
Comanche,Governor,Kevin Stitt,REP,160001,5,5,117,127,
Comanche,Lieutenant Governor,Dana Murphy,REP,160001,6,5,118,129,
Comanche,Lieutenant Governor,Matt Pinnell,REP,160001,5,5,119,129,
Comanche,State Auditor,Cindy Byrd,REP,160001,8,5,141,154,
Comanche,State Auditor,Charlie Prater,REP,160001,3,6,96,105,
Comanche,Attorney General,Mike Hunter,REP,160001,4,8,123,135,
Comanche,Attorney General,Gentner Drummond,REP,160001,7,3,114,124,
Comanche,Superintendent of Public Instruction,Joy Hofmeister,REP,160001,4,6,128,138,
Comanche,Superintendent of Public Instruction,Linda Murphy,REP,160001,7,5,109,121,
Comanche,Commissioner of Labor,Cathy Costello,REP,160001,9,4,117,130,
Comanche,Commissioner of Labor,Leslie Osborn,REP,160001,2,6,116,124,
Comanche,Corporation Commissioner,Bob Anthony,REP,160001,6,5,147,158,
Comanche,Corporation Commissioner,Brian Bingman,REP,160001,5,5,87,97,
Comanche,Governor,Chris Powell,LIB,160001,0,0,1,1,
Comanche,Governor,Rex Lawhorn,LIB,160001,0,0,0,0,
Comanche,Corporation Commissioner,Ashley Nicole Mccray,DEM,160001,13,7,136,156,
Comanche,Corporation Commissioner,Blake Cummings,DEM,160001,10,3,60,73,
Comanche,U.S. House,Mary Brannon,DEM,160001,14,3,123,140,04
Comanche,U.S. House,Fred Gipson,DEM,160001,12,6,72,90,04
Comanche,Governor,Mick Cornett,REP,160002,3,2,65,70,
Comanche,Governor,Kevin Stitt,REP,160002,7,5,98,110,
Comanche,Lieutenant Governor,Dana Murphy,REP,160002,6,5,81,92,
Comanche,Lieutenant Governor,Matt Pinnell,REP,160002,3,2,83,88,
Comanche,State Auditor,Cindy Byrd,REP,160002,9,5,90,104,
Comanche,State Auditor,Charlie Prater,REP,160002,1,2,71,74,
Comanche,Attorney General,Mike Hunter,REP,160002,2,5,78,85,
Comanche,Attorney General,Gentner Drummond,REP,160002,8,2,85,95,
Comanche,Superintendent of Public Instruction,Joy Hofmeister,REP,160002,8,2,90,100,
Comanche,Superintendent of Public Instruction,Linda Murphy,REP,160002,2,5,70,77,
Comanche,Commissioner of Labor,Cathy Costello,REP,160002,4,4,80,88,
Comanche,Commissioner of Labor,Leslie Osborn,REP,160002,6,3,77,86,
Comanche,Corporation Commissioner,Bob Anthony,REP,160002,9,2,87,98,
Comanche,Corporation Commissioner,Brian Bingman,REP,160002,0,5,69,74,
Comanche,Governor,Chris Powell,LIB,160002,0,0,0,0,
Comanche,Governor,Rex Lawhorn,LIB,160002,0,0,0,0,
Comanche,Corporation Commissioner,Ashley Nicole Mccray,DEM,160002,6,7,125,138,
Comanche,Corporation Commissioner,Blake Cummings,DEM,160002,1,2,53,56,
Comanche,U.S. House,Mary Brannon,DEM,160002,6,5,121,132,04
Comanche,U.S. House,Fred Gipson,DEM,160002,1,4,59,64,04
Comanche,Governor,Mick Cornett,REP,160003,7,3,50,60,
Comanche,Governor,Kevin Stitt,REP,160003,4,2,67,73,
Comanche,Lieutenant Governor,Dana Murphy,REP,160003,8,3,60,71,
Comanche,Lieutenant Governor,Matt Pinnell,REP,160003,4,2,56,62,
Comanche,State Auditor,Cindy Byrd,REP,160003,6,4,71,81,
Comanche,State Auditor,Charlie Prater,REP,160003,6,1,45,52,
Comanche,Attorney General,Mike Hunter,REP,160003,8,2,65,75,
Comanche,Attorney General,Gentner Drummond,REP,160003,3,3,52,58,
Comanche,Superintendent of Public Instruction,Joy Hofmeister,REP,160003,4,2,61,67,
Comanche,Superintendent of Public Instruction,Linda Murphy,REP,160003,7,3,55,65,
Comanche,Commissioner of Labor,Cathy Costello,REP,160003,2,3,49,54,
Comanche,Commissioner of Labor,Leslie Osborn,REP,160003,9,2,67,78,
Comanche,Corporation Commissioner,Bob Anthony,REP,160003,8,2,55,65,
Comanche,Corporation Commissioner,Brian Bingman,REP,160003,3,3,60,66,
Comanche,Governor,Chris Powell,LIB,160003,0,0,0,0,
Comanche,Governor,Rex Lawhorn,LIB,160003,0,0,1,1,
Comanche,Corporation Commissioner,Ashley Nicole Mccray,DEM,160003,2,5,96,103,
Comanche,Corporation Commissioner,Blake Cummings,DEM,160003,4,1,43,48,
Comanche,U.S. House,Mary Brannon,DEM,160003,2,4,94,100,04
Comanche,U.S. House,Fred Gipson,DEM,160003,5,2,46,53,04
Comanche,Governor,Mick Cornett,REP,160007,0,2,49,51,
Comanche,Governor,Kevin Stitt,REP,160007,4,5,102,111,
Comanche,Lieutenant Governor,Dana Murphy,REP,160007,1,2,60,63,
Comanche,Lieutenant Governor,Matt Pinnell,REP,160007,3,4,90,97,
Comanche,State Auditor,Cindy Byrd,REP,160007,2,1,70,73,
Comanche,State Auditor,Charlie Prater,REP,160007,1,5,74,80,
Comanche,Attorney General,Mike Hunter,REP,160007,1,1,75,77,
Comanche,Attorney General,Gentner Drummond,REP,160007,3,5,73,81,
Comanche,Superintendent of Public Instruction,Joy Hofmeister,REP,160007,3,6,70,79,
Comanche,Superintendent of Public Instruction,Linda Murphy,REP,160007,1,0,82,83,
Comanche,Commissioner of Labor,Cathy Costello,REP,160007,3,6,67,76,
Comanche,Commissioner of Labor,Leslie Osborn,REP,160007,1,0,79,80,
Comanche,Corporation Commissioner,Bob Anthony,REP,160007,4,2,71,77,
Comanche,Corporation Commissioner,Brian Bingman,REP,160007,0,4,75,79,
Comanche,Governor,Chris Powell,LIB,160007,0,0,4,4,
Comanche,Governor,Rex Lawhorn,LIB,160007,0,0,0,0,
Comanche,Corporation Commissioner,Ashley Nicole Mccray,DEM,160007,7,6,105,118,
Comanche,Corporation Commissioner,Blake Cummings,DEM,160007,4,3,47,54,
Comanche,U.S. House,Mary Brannon,DEM,160007,7,6,86,99,04
Comanche,U.S. House,Fred Gipson,DEM,160007,4,3,67,74,04
Comanche,Governor,Mick Cornett,REP,160008,6,8,97,111,
Comanche,Governor,Kevin Stitt,REP,160008,6,18,99,123,
Comanche,Lieutenant Governor,Dana Murphy,REP,160008,5,8,95,108,
Comanche,Lieutenant Governor,Matt Pinnell,REP,160008,7,17,94,118,
Comanche,State Auditor,Cindy Byrd,REP,160008,8,15,104,127,
Comanche,State Auditor,Charlie Prater,REP,160008,4,8,79,91,
Comanche,Attorney General,Mike Hunter,REP,160008,7,11,108,126,
Comanche,Attorney General,Gentner Drummond,REP,160008,5,12,83,100,
Comanche,Superintendent of Public Instruction,Joy Hofmeister,REP,160008,10,13,116,139,
Comanche,Superintendent of Public Instruction,Linda Murphy,REP,160008,2,9,74,85,
Comanche,Commissioner of Labor,Cathy Costello,REP,160008,10,15,114,139,
Comanche,Commissioner of Labor,Leslie Osborn,REP,160008,1,8,74,83,
Comanche,Corporation Commissioner,Bob Anthony,REP,160008,9,18,115,142,
Comanche,Corporation Commissioner,Brian Bingman,REP,160008,2,5,67,74,
Comanche,Governor,Chris Powell,LIB,160008,0,0,0,0,
Comanche,Governor,Rex Lawhorn,LIB,160008,0,0,0,0,
Comanche,Corporation Commissioner,Ashley Nicole Mccray,DEM,160008,12,22,167,201,
Comanche,Corporation Commissioner,Blake Cummings,DEM,160008,9,8,83,100,
Comanche,U.S. House,Mary Brannon,DEM,160008,9,20,161,190,04
Comanche,U.S. House,Fred Gipson,DEM,160008,12,10,90,112,04
Comanche,Governor,Mick Cornett,REP,160009,2,3,74,79,
Comanche,Governor,Kevin Stitt,REP,160009,8,10,86,104,
Comanche,Lieutenant Governor,Dana Murphy,REP,160009,4,8,65,77,
Comanche,Lieutenant Governor,Matt Pinnell,REP,160009,6,5,91,102,
Comanche,State Auditor,Cindy Byrd,REP,160009,6,10,89,105,
Comanche,State Auditor,Charlie Prater,REP,160009,2,3,65,70,
Comanche,Attorney General,Mike Hunter,REP,160009,6,2,81,89,
Comanche,Attorney General,Gentner Drummond,REP,160009,4,11,78,93,
Comanche,Superintendent of Public Instruction,Joy Hofmeister,REP,160009,6,12,77,95,
Comanche,Superintendent of Public Instruction,Linda Murphy,REP,160009,4,1,78,83,
Comanche,Commissioner of Labor,Cathy Costello,REP,160009,8,12,71,91,
Comanche,Commissioner of Labor,Leslie Osborn,REP,160009,2,0,84,86,
Comanche,Corporation Commissioner,Bob Anthony,REP,160009,8,7,85,100,
Comanche,Corporation Commissioner,Brian Bingman,REP,160009,2,5,71,78,
Comanche,Governor,Chris Powell,LIB,160009,0,0,0,0,
Comanche,Governor,Rex Lawhorn,LIB,160009,0,0,0,0,
Comanche,Corporation Commissioner,Ashley Nicole Mccray,DEM,160009,2,2,166,170,
Comanche,Corporation Commissioner,Blake Cummings,DEM,160009,3,9,81,93,
Comanche,U.S. House,Mary Brannon,DEM,160009,1,3,159,163,04
Comanche,U.S. House,Fred Gipson,DEM,160009,4,8,88,100,04
Comanche,Governor,Mick Cornett,REP,160011,0,6,70,76,
Comanche,Governor,Kevin Stitt,REP,160011,3,3,69,75,
Comanche,Lieutenant Governor,Dana Murphy,REP,160011,2,7,67,76,
Comanche,Lieutenant Governor,Matt Pinnell,REP,160011,1,2,70,73,
Comanche,State Auditor,Cindy Byrd,REP,160011,1,6,79,86,
Comanche,State Auditor,Charlie Prater,REP,160011,2,3,57,62,
Comanche,Attorney General,Mike Hunter,REP,160011,2,1,64,67,
Comanche,Attorney General,Gentner Drummond,REP,160011,1,8,71,80,
Comanche,Superintendent of Public Instruction,Joy Hofmeister,REP,160011,2,6,73,81,
Comanche,Superintendent of Public Instruction,Linda Murphy,REP,160011,1,3,64,68,
Comanche,Commissioner of Labor,Cathy Costello,REP,160011,2,5,66,73,
Comanche,Commissioner of Labor,Leslie Osborn,REP,160011,1,4,68,73,
Comanche,Corporation Commissioner,Bob Anthony,REP,160011,3,4,66,73,
Comanche,Corporation Commissioner,Brian Bingman,REP,160011,0,4,68,72,
Comanche,Governor,Chris Powell,LIB,160011,0,0,1,1,
Comanche,Governor,Rex Lawhorn,LIB,160011,0,0,0,0,
Comanche,Corporation Commissioner,Ashley Nicole Mccray,DEM,160011,4,14,143,161,
Comanche,Corporation Commissioner,Blake Cummings,DEM,160011,1,1,60,62,
Comanche,U.S. House,Mary Brannon,DEM,160011,1,10,141,152,04
Comanche,U.S. House,Fred Gipson,DEM,160011,4,5,62,71,04
Comanche,Governor,Mick Cornett,REP,160013,4,3,60,67,
Comanche,Governor,Kevin Stitt,REP,160013,1,3,77,81,
Comanche,Lieutenant Governor,Dana Murphy,REP,160013,3,3,60,66,
Comanche,Lieutenant Governor,Matt Pinnell,REP,160013,2,3,74,79,
Comanche,State Auditor,Cindy Byrd,REP,160013,4,4,83,91,
Comanche,State Auditor,Charlie Prater,REP,160013,1,1,48,50,
Comanche,Attorney General,Mike Hunter,REP,160013,5,3,57,65,
Comanche,Attorney General,Gentner Drummond,REP,160013,0,3,79,82,
Comanche,Superintendent of Public Instruction,Joy Hofmeister,REP,160013,2,2,64,68,
Comanche,Superintendent of Public Instruction,Linda Murphy,REP,160013,3,4,67,74,
Comanche,Commissioner of Labor,Cathy Costello,REP,160013,5,5,68,78,
Comanche,Commissioner of Labor,Leslie Osborn,REP,160013,0,1,62,63,
Comanche,Corporation Commissioner,Bob Anthony,REP,160013,5,3,62,70,
Comanche,Corporation Commissioner,Brian Bingman,REP,160013,0,3,68,71,
Comanche,Governor,Chris Powell,LIB,160013,0,0,0,0,
Comanche,Governor,Rex Lawhorn,LIB,160013,0,0,1,1,
Comanche,Corporation Commissioner,Ashley Nicole Mccray,DEM,160013,6,11,136,153,
Comanche,Corporation Commissioner,Blake Cummings,DEM,160013,4,5,70,79,
Comanche,U.S. House,Mary Brannon,DEM,160013,4,9,145,158,04
Comanche,U.S. House,Fred Gipson,DEM,160013,7,7,62,76,04
Comanche,Governor,Mick Cornett,REP,160014,0,0,0,0,
Comanche,Governor,Kevin Stitt,REP,160014,0,0,0,0,
Comanche,Lieutenant Governor,Dana Murphy,REP,160014,0,0,0,0,
Comanche,Lieutenant Governor,Matt Pinnell,REP,160014,0,0,0,0,
Comanche,State Auditor,Cindy Byrd,REP,160014,0,0,0,0,
Comanche,State Auditor,Charlie Prater,REP,160014,0,0,0,0,
Comanche,Attorney General,Mike Hunter,REP,160014,0,0,0,0,
Comanche,Attorney General,Gentner Drummond,REP,160014,0,0,0,0,
Comanche,Superintendent of Public Instruction,Joy Hofmeister,REP,160014,0,0,0,0,
Comanche,Superintendent of Public Instruction,Linda Murphy,REP,160014,0,0,0,0,
Comanche,Commissioner of Labor,Cathy Costello,REP,160014,0,0,0,0,
Comanche,Commissioner of Labor,Leslie Osborn,REP,160014,0,0,0,0,
Comanche,Corporation Commissioner,Bob Anthony,REP,160014,0,0,0,0,
Comanche,Corporation Commissioner,Brian Bingman,REP,160014,0,0,0,0,
Comanche,Governor,Chris Powell,LIB,160014,0,0,1,1,
Comanche,Governor,Rex Lawhorn,LIB,160014,0,0,0,0,
Comanche,Corporation Commissioner,Ashley Nicole Mccray,DEM,160014,0,0,6,6,
Comanche,Corporation Commissioner,Blake Cummings,DEM,160014,0,0,0,0,
Comanche,U.S. House,Mary Brannon,DEM,160014,0,0,5,5,04
Comanche,U.S. House,Fred Gipson,DEM,160014,0,0,1,1,04
Comanche,Governor,Mick Cornett,REP,160015,9,11,68,88,
Comanche,Governor,Kevin Stitt,REP,160015,1,13,72,86,
Comanche,Lieutenant Governor,Dana Murphy,REP,160015,7,13,65,85,
Comanche,Lieutenant Governor,Matt Pinnell,REP,160015,3,10,74,87,
Comanche,State Auditor,Cindy Byrd,REP,160015,8,10,79,97,
Comanche,State Auditor,Charlie Prater,REP,160015,1,14,58,73,
Comanche,Attorney General,Mike Hunter,REP,160015,3,8,75,86,
Comanche,Attorney General,Gentner Drummond,REP,160015,7,15,65,87,
Comanche,Superintendent of Public Instruction,Joy Hofmeister,REP,160015,4,12,77,93,
Comanche,Superintendent of Public Instruction,Linda Murphy,REP,160015,6,11,65,82,
Comanche,Commissioner of Labor,Cathy Costello,REP,160015,4,17,67,88,
Comanche,Commissioner of Labor,Leslie Osborn,REP,160015,5,6,71,82,
Comanche,Corporation Commissioner,Bob Anthony,REP,160015,6,14,72,92,
Comanche,Corporation Commissioner,Brian Bingman,REP,160015,4,9,64,77,
Comanche,Governor,Chris Powell,LIB,160015,0,0,0,0,
Comanche,Governor,Rex Lawhorn,LIB,160015,0,0,0,0,
Comanche,Corporation Commissioner,Ashley Nicole Mccray,DEM,160015,13,10,138,161,
Comanche,Corporation Commissioner,Blake Cummings,DEM,160015,6,5,61,72,
Comanche,U.S. House,Mary Brannon,DEM,160015,7,9,135,151,04
Comanche,U.S. House,Fred Gipson,DEM,160015,12,6,65,83,04
Comanche,Governor,Mick Cornett,REP,160017,5,8,98,111,
Comanche,Governor,Kevin Stitt,REP,160017,5,8,82,95,
Comanche,Lieutenant Governor,Dana Murphy,REP,160017,4,10,81,95,
Comanche,Lieutenant Governor,Matt Pinnell,REP,160017,6,5,92,103,
Comanche,State Auditor,Cindy Byrd,REP,160017,9,12,89,110,
Comanche,State Auditor,Charlie Prater,REP,160017,1,3,83,87,
Comanche,Attorney General,Mike Hunter,REP,160017,6,11,94,111,
Comanche,Attorney General,Gentner Drummond,REP,160017,4,5,79,88,
Comanche,Superintendent of Public Instruction,Joy Hofmeister,REP,160017,5,9,99,113,
Comanche,Superintendent of Public Instruction,Linda Murphy,REP,160017,5,7,73,85,
Comanche,Commissioner of Labor,Cathy Costello,REP,160017,6,11,82,99,
Comanche,Commissioner of Labor,Leslie Osborn,REP,160017,4,4,87,95,
Comanche,Corporation Commissioner,Bob Anthony,REP,160017,5,12,97,114,
Comanche,Corporation Commissioner,Brian Bingman,REP,160017,5,3,72,80,
Comanche,Governor,Chris Powell,LIB,160017,0,0,1,1,
Comanche,Governor,Rex Lawhorn,LIB,160017,0,0,0,0,
Comanche,Corporation Commissioner,Ashley Nicole Mccray,DEM,160017,18,21,120,159,
Comanche,Corporation Commissioner,Blake Cummings,DEM,160017,5,4,51,60,
Comanche,U.S. House,Mary Brannon,DEM,160017,8,14,100,122,04
Comanche,U.S. House,Fred Gipson,DEM,160017,15,11,67,93,04
Comanche,Governor,Mick Cornett,REP,160019,0,4,72,76,
Comanche,Governor,Kevin Stitt,REP,160019,2,7,82,91,
Comanche,Lieutenant Governor,Dana Murphy,REP,160019,2,5,70,77,
Comanche,Lieutenant Governor,Matt Pinnell,REP,160019,0,6,82,88,
Comanche,State Auditor,Cindy Byrd,REP,160019,0,7,84,91,
Comanche,State Auditor,Charlie Prater,REP,160019,2,4,66,72,
Comanche,Attorney General,Mike Hunter,REP,160019,0,6,90,96,
Comanche,Attorney General,Gentner Drummond,REP,160019,2,5,61,68,
Comanche,Superintendent of Public Instruction,Joy Hofmeister,REP,160019,0,3,74,77,
Comanche,Superintendent of Public Instruction,Linda Murphy,REP,160019,2,8,76,86,
Comanche,Commissioner of Labor,Cathy Costello,REP,160019,2,4,66,72,
Comanche,Commissioner of Labor,Leslie Osborn,REP,160019,0,6,83,89,
Comanche,Corporation Commissioner,Bob Anthony,REP,160019,0,4,70,74,
Comanche,Corporation Commissioner,Brian Bingman,REP,160019,2,7,76,85,
Comanche,Governor,Chris Powell,LIB,160019,0,0,2,2,
Comanche,Governor,Rex Lawhorn,LIB,160019,0,0,1,1,
Comanche,Corporation Commissioner,Ashley Nicole Mccray,DEM,160019,2,4,74,80,
Comanche,Corporation Commissioner,Blake Cummings,DEM,160019,1,5,57,63,
Comanche,U.S. House,Mary Brannon,DEM,160019,1,5,78,84,04
Comanche,U.S. House,Fred Gipson,DEM,160019,2,4,54,60,04
Comanche,Governor,Mick Cornett,REP,160020,1,2,36,39,
Comanche,Governor,Kevin Stitt,REP,160020,2,5,67,74,
Comanche,Lieutenant Governor,Dana Murphy,REP,160020,1,2,54,57,
Comanche,Lieutenant Governor,Matt Pinnell,REP,160020,2,5,48,55,
Comanche,State Auditor,Cindy Byrd,REP,160020,3,3,54,60,
Comanche,State Auditor,Charlie Prater,REP,160020,0,4,45,49,
Comanche,Attorney General,Mike Hunter,REP,160020,1,6,51,58,
Comanche,Attorney General,Gentner Drummond,REP,160020,2,1,50,53,
Comanche,Superintendent of Public Instruction,Joy Hofmeister,REP,160020,1,3,46,50,
Comanche,Superintendent of Public Instruction,Linda Murphy,REP,160020,3,4,58,65,
Comanche,Commissioner of Labor,Cathy Costello,REP,160020,1,7,50,58,
Comanche,Commissioner of Labor,Leslie Osborn,REP,160020,2,0,50,52,
Comanche,Corporation Commissioner,Bob Anthony,REP,160020,2,3,56,61,
Comanche,Corporation Commissioner,Brian Bingman,REP,160020,1,4,44,49,
Comanche,Governor,Chris Powell,LIB,160020,0,0,0,0,
Comanche,Governor,Rex Lawhorn,LIB,160020,0,0,0,0,
Comanche,Corporation Commissioner,Ashley Nicole Mccray,DEM,160020,2,6,109,117,
Comanche,Corporation Commissioner,Blake Cummings,DEM,160020,0,2,45,47,
Comanche,U.S. House,Mary Brannon,DEM,160020,2,6,89,97,04
Comanche,U.S. House,Fred Gipson,DEM,160020,0,2,63,65,04
Comanche,Governor,Mick Cornett,REP,160021,3,1,31,35,
Comanche,Governor,Kevin Stitt,REP,160021,2,6,44,52,
Comanche,Lieutenant Governor,Dana Murphy,REP,160021,2,3,32,37,
Comanche,Lieutenant Governor,Matt Pinnell,REP,160021,3,4,40,47,
Comanche,State Auditor,Cindy Byrd,REP,160021,2,3,47,52,
Comanche,State Auditor,Charlie Prater,REP,160021,3,4,25,32,
Comanche,Attorney General,Mike Hunter,REP,160021,4,3,34,41,
Comanche,Attorney General,Gentner Drummond,REP,160021,1,4,41,46,
Comanche,Superintendent of Public Instruction,Joy Hofmeister,REP,160021,1,2,37,40,
Comanche,Superintendent of Public Instruction,Linda Murphy,REP,160021,4,5,36,45,
Comanche,Commissioner of Labor,Cathy Costello,REP,160021,2,2,33,37,
Comanche,Commissioner of Labor,Leslie Osborn,REP,160021,3,5,41,49,
Comanche,Corporation Commissioner,Bob Anthony,REP,160021,4,5,32,41,
Comanche,Corporation Commissioner,Brian Bingman,REP,160021,1,2,41,44,
Comanche,Governor,Chris Powell,LIB,160021,0,0,0,0,
Comanche,Governor,Rex Lawhorn,LIB,160021,0,0,1,1,
Comanche,Corporation Commissioner,Ashley Nicole Mccray,DEM,160021,1,18,62,81,
Comanche,Corporation Commissioner,Blake Cummings,DEM,160021,1,8,42,51,
Comanche,U.S. House,Mary Brannon,DEM,160021,0,14,61,75,04
Comanche,U.S. House,Fred Gipson,DEM,160021,1,13,43,57,04
Comanche,Governor,Mick Cornett,REP,160025,0,0,5,5,
Comanche,Governor,Kevin Stitt,REP,160025,0,0,11,11,
Comanche,Lieutenant Governor,Dana Murphy,REP,160025,0,0,6,6,
Comanche,Lieutenant Governor,Matt Pinnell,REP,160025,0,0,10,10,
Comanche,State Auditor,Cindy Byrd,REP,160025,0,0,10,10,
Comanche,State Auditor,Charlie Prater,REP,160025,0,0,6,6,
Comanche,Attorney General,Mike Hunter,REP,160025,0,0,10,10,
Comanche,Attorney General,Gentner Drummond,REP,160025,0,0,6,6,
Comanche,Superintendent of Public Instruction,Joy Hofmeister,REP,160025,0,0,10,10,
Comanche,Superintendent of Public Instruction,Linda Murphy,REP,160025,0,0,5,5,
Comanche,Commissioner of Labor,Cathy Costello,REP,160025,0,0,8,8,
Comanche,Commissioner of Labor,Leslie Osborn,REP,160025,0,0,7,7,
Comanche,Corporation Commissioner,Bob Anthony,REP,160025,0,0,7,7,
Comanche,Corporation Commissioner,Brian Bingman,REP,160025,0,0,8,8,
Comanche,Governor,Chris Powell,LIB,160025,0,0,0,0,
Comanche,Governor,Rex Lawhorn,LIB,160025,0,0,0,0,
Comanche,Corporation Commissioner,Ashley Nicole Mccray,DEM,160025,1,6,103,110,
Comanche,Corporation Commissioner,Blake Cummings,DEM,160025,1,2,32,35,
Comanche,U.S. House,Mary Brannon,DEM,160025,0,6,89,95,04
Comanche,U.S. House,Fred Gipson,DEM,160025,2,2,45,49,04
Comanche,Governor,Mick Cornett,REP,160026,0,0,30,30,
Comanche,Governor,Kevin Stitt,REP,160026,0,0,24,24,
Comanche,Lieutenant Governor,Dana Murphy,REP,160026,0,0,21,21,
Comanche,Lieutenant Governor,Matt Pinnell,REP,160026,0,0,34,34,
Comanche,State Auditor,Cindy Byrd,REP,160026,0,0,24,24,
Comanche,State Auditor,Charlie Prater,REP,160026,0,0,29,29,
Comanche,Attorney General,Mike Hunter,REP,160026,0,0,30,30,
Comanche,Attorney General,Gentner Drummond,REP,160026,0,0,26,26,
Comanche,Superintendent of Public Instruction,Joy Hofmeister,REP,160026,0,0,26,26,
Comanche,Superintendent of Public Instruction,Linda Murphy,REP,160026,0,0,28,28,
Comanche,Commissioner of Labor,Cathy Costello,REP,160026,0,0,26,26,
Comanche,Commissioner of Labor,Leslie Osborn,REP,160026,0,0,28,28,
Comanche,Corporation Commissioner,Bob Anthony,REP,160026,0,0,25,25,
Comanche,Corporation Commissioner,Brian Bingman,REP,160026,0,0,29,29,
Comanche,State House,Jeff Coody,REP,160026,0,0,34,34,63
Comanche,State House,Trey Caldwell,REP,160026,0,0,22,22,63
Comanche,Governor,Chris Powell,LIB,160026,0,0,0,0,
Comanche,Governor,Rex Lawhorn,LIB,160026,0,0,0,0,
Comanche,Corporation Commissioner,Ashley Nicole Mccray,DEM,160026,1,4,45,50,
Comanche,Corporation Commissioner,Blake Cummings,DEM,160026,0,2,28,30,
Comanche,U.S. House,Mary Brannon,DEM,160026,1,3,44,48,04
Comanche,U.S. House,Fred Gipson,DEM,160026,0,3,28,31,04
Comanche,Governor,Mick Cornett,REP,160027,0,1,13,14,
Comanche,Governor,Kevin Stitt,REP,160027,0,1,25,26,
Comanche,Lieutenant Governor,Dana Murphy,REP,160027,0,2,19,21,
Comanche,Lieutenant Governor,Matt Pinnell,REP,160027,0,0,17,17,
Comanche,State Auditor,Cindy Byrd,REP,160027,0,1,22,23,
Comanche,State Auditor,Charlie Prater,REP,160027,0,1,13,14,
Comanche,Attorney General,Mike Hunter,REP,160027,0,2,22,24,
Comanche,Attorney General,Gentner Drummond,REP,160027,0,0,15,15,
Comanche,Superintendent of Public Instruction,Joy Hofmeister,REP,160027,0,0,17,17,
Comanche,Superintendent of Public Instruction,Linda Murphy,REP,160027,0,2,19,21,
Comanche,Commissioner of Labor,Cathy Costello,REP,160027,0,2,17,19,
Comanche,Commissioner of Labor,Leslie Osborn,REP,160027,0,0,18,18,
Comanche,Corporation Commissioner,Bob Anthony,REP,160027,0,2,17,19,
Comanche,Corporation Commissioner,Brian Bingman,REP,160027,0,0,16,16,
Comanche,Governor,Chris Powell,LIB,160027,0,0,0,0,
Comanche,Governor,Rex Lawhorn,LIB,160027,0,0,0,0,
Comanche,Corporation Commissioner,Ashley Nicole Mccray,DEM,160027,4,4,42,50,
Comanche,Corporation Commissioner,Blake Cummings,DEM,160027,0,0,28,28,
Comanche,U.S. House,Mary Brannon,DEM,160027,1,4,34,39,04
Comanche,U.S. House,Fred Gipson,DEM,160027,3,0,35,38,04
Comanche,Governor,Mick Cornett,REP,160029,2,1,7,10,
Comanche,Governor,Kevin Stitt,REP,160029,0,2,7,9,
Comanche,Lieutenant Governor,Dana Murphy,REP,160029,2,1,6,9,
Comanche,Lieutenant Governor,Matt Pinnell,REP,160029,0,2,8,10,
Comanche,State Auditor,Cindy Byrd,REP,160029,2,2,5,9,
Comanche,State Auditor,Charlie Prater,REP,160029,0,1,9,10,
Comanche,Attorney General,Mike Hunter,REP,160029,0,2,8,10,
Comanche,Attorney General,Gentner Drummond,REP,160029,2,1,6,9,
Comanche,Superintendent of Public Instruction,Joy Hofmeister,REP,160029,2,0,9,11,
Comanche,Superintendent of Public Instruction,Linda Murphy,REP,160029,0,2,5,7,
Comanche,Commissioner of Labor,Cathy Costello,REP,160029,0,2,4,6,
Comanche,Commissioner of Labor,Leslie Osborn,REP,160029,2,1,10,13,
Comanche,Corporation Commissioner,Bob Anthony,REP,160029,2,0,4,6,
Comanche,Corporation Commissioner,Brian Bingman,REP,160029,0,3,10,13,
Comanche,State House,Jeff Coody,REP,160029,0,3,4,7,63
Comanche,State House,Trey Caldwell,REP,160029,2,0,10,12,63
Comanche,Governor,Chris Powell,LIB,160029,0,0,0,0,
Comanche,Governor,Rex Lawhorn,LIB,160029,0,0,0,0,
Comanche,Corporation Commissioner,Ashley Nicole Mccray,DEM,160029,3,3,66,72,
Comanche,Corporation Commissioner,Blake Cummings,DEM,160029,2,2,38,42,
Comanche,U.S. House,Mary Brannon,DEM,160029,3,3,65,71,04
Comanche,U.S. House,Fred Gipson,DEM,160029,2,1,41,44,04
Comanche,Governor,Mick Cornett,REP,160030,0,1,20,21,
Comanche,Governor,Kevin Stitt,REP,160030,0,3,19,22,
Comanche,Lieutenant Governor,Dana Murphy,REP,160030,0,3,27,30,
Comanche,Lieutenant Governor,Matt Pinnell,REP,160030,0,1,11,12,
Comanche,State Auditor,Cindy Byrd,REP,160030,0,2,28,30,
Comanche,State Auditor,Charlie Prater,REP,160030,0,1,10,11,
Comanche,Attorney General,Mike Hunter,REP,160030,0,2,24,26,
Comanche,Attorney General,Gentner Drummond,REP,160030,0,2,15,17,
Comanche,Superintendent of Public Instruction,Joy Hofmeister,REP,160030,0,2,23,25,
Comanche,Superintendent of Public Instruction,Linda Murphy,REP,160030,0,2,15,17,
Comanche,Commissioner of Labor,Cathy Costello,REP,160030,0,2,19,21,
Comanche,Commissioner of Labor,Leslie Osborn,REP,160030,0,2,19,21,
Comanche,Corporation Commissioner,Bob Anthony,REP,160030,0,3,27,30,
Comanche,Corporation Commissioner,Brian Bingman,REP,160030,0,1,11,12,
Comanche,Governor,Chris Powell,LIB,160030,0,0,0,0,
Comanche,Governor,Rex Lawhorn,LIB,160030,0,0,0,0,
Comanche,Corporation Commissioner,Ashley Nicole Mccray,DEM,160030,0,2,42,44,
Comanche,Corporation Commissioner,Blake Cummings,DEM,160030,0,0,30,30,
Comanche,U.S. House,Mary Brannon,DEM,160030,0,2,45,47,04
Comanche,U.S. House,Fred Gipson,DEM,160030,0,0,27,27,04
Comanche,Governor,Mick Cornett,REP,160031,18,29,203,250,
Comanche,Governor,Kevin Stitt,REP,160031,14,43,224,281,
Comanche,Lieutenant Governor,Dana Murphy,REP,160031,14,29,184,227,
Comanche,Lieutenant Governor,Matt Pinnell,REP,160031,16,42,232,290,
Comanche,State Auditor,Cindy Byrd,REP,160031,21,43,242,306,
Comanche,State Auditor,Charlie Prater,REP,160031,10,24,158,192,
Comanche,Attorney General,Mike Hunter,REP,160031,18,33,213,264,
Comanche,Attorney General,Gentner Drummond,REP,160031,13,37,201,251,
Comanche,Superintendent of Public Instruction,Joy Hofmeister,REP,160031,19,47,249,315,
Comanche,Superintendent of Public Instruction,Linda Murphy,REP,160031,12,23,172,207,
Comanche,Commissioner of Labor,Cathy Costello,REP,160031,16,37,218,271,
Comanche,Commissioner of Labor,Leslie Osborn,REP,160031,15,28,189,232,
Comanche,Corporation Commissioner,Bob Anthony,REP,160031,25,32,239,296,
Comanche,Corporation Commissioner,Brian Bingman,REP,160031,6,37,160,203,
Comanche,Governor,Chris Powell,LIB,160031,0,1,1,2,
Comanche,Governor,Rex Lawhorn,LIB,160031,0,0,2,2,
Comanche,Corporation Commissioner,Ashley Nicole Mccray,DEM,160031,10,36,190,236,
Comanche,Corporation Commissioner,Blake Cummings,DEM,160031,5,16,85,106,
Comanche,U.S. House,Mary Brannon,DEM,160031,9,36,184,229,04
Comanche,U.S. House,Fred Gipson,DEM,160031,6,17,93,116,04
Comanche,Governor,Mick Cornett,REP,160032,0,0,0,0,
Comanche,Governor,Kevin Stitt,REP,160032,0,0,0,0,
Comanche,Lieutenant Governor,Dana Murphy,REP,160032,0,0,0,0,
Comanche,Lieutenant Governor,Matt Pinnell,REP,160032,0,0,0,0,
Comanche,State Auditor,Cindy Byrd,REP,160032,0,0,0,0,
Comanche,State Auditor,Charlie Prater,REP,160032,0,0,0,0,
Comanche,Attorney General,Mike Hunter,REP,160032,0,0,0,0,
Comanche,Attorney General,Gentner Drummond,REP,160032,0,0,0,0,
Comanche,Superintendent of Public Instruction,Joy Hofmeister,REP,160032,0,0,0,0,
Comanche,Superintendent of Public Instruction,Linda Murphy,REP,160032,0,0,0,0,
Comanche,Commissioner of Labor,Cathy Costello,REP,160032,0,0,0,0,
Comanche,Commissioner of Labor,Leslie Osborn,REP,160032,0,0,0,0,
Comanche,Corporation Commissioner,Bob Anthony,REP,160032,0,0,0,0,
Comanche,Corporation Commissioner,Brian Bingman,REP,160032,0,0,0,0,
Comanche,Governor,Chris Powell,LIB,160032,0,0,0,0,
Comanche,Governor,Rex Lawhorn,LIB,160032,0,0,0,0,
Comanche,Corporation Commissioner,Ashley Nicole Mccray,DEM,160032,0,2,34,36,
Comanche,Corporation Commissioner,Blake Cummings,DEM,160032,0,1,7,8,
Comanche,U.S. House,Mary Brannon,DEM,160032,0,2,27,29,04
Comanche,U.S. House,Fred Gipson,DEM,160032,0,1,13,14,04
Comanche,Governor,Mick Cornett,REP,160033,3,1,22,26,
Comanche,Governor,Kevin Stitt,REP,160033,4,2,40,46,
Comanche,Lieutenant Governor,Dana Murphy,REP,160033,3,3,35,41,
Comanche,Lieutenant Governor,Matt Pinnell,REP,160033,3,0,25,28,
Comanche,State Auditor,Cindy Byrd,REP,160033,3,1,28,32,
Comanche,State Auditor,Charlie Prater,REP,160033,5,2,31,38,
Comanche,Attorney General,Mike Hunter,REP,160033,7,2,34,43,
Comanche,Attorney General,Gentner Drummond,REP,160033,1,1,26,28,
Comanche,Superintendent of Public Instruction,Joy Hofmeister,REP,160033,5,3,36,44,
Comanche,Superintendent of Public Instruction,Linda Murphy,REP,160033,3,0,25,28,
Comanche,Commissioner of Labor,Cathy Costello,REP,160033,3,3,33,39,
Comanche,Commissioner of Labor,Leslie Osborn,REP,160033,5,0,28,33,
Comanche,Corporation Commissioner,Bob Anthony,REP,160033,5,3,27,35,
Comanche,Corporation Commissioner,Brian Bingman,REP,160033,3,0,31,34,
Comanche,Governor,Chris Powell,LIB,160033,0,0,0,0,
Comanche,Governor,Rex Lawhorn,LIB,160033,0,0,0,0,
Comanche,Corporation Commissioner,Ashley Nicole Mccray,DEM,160033,9,5,39,53,
Comanche,Corporation Commissioner,Blake Cummings,DEM,160033,6,0,19,25,
Comanche,U.S. House,Mary Brannon,DEM,160033,11,4,34,49,04
Comanche,U.S. House,Fred Gipson,DEM,160033,6,1,25,32,04
Comanche,Governor,Mick Cornett,REP,160034,2,12,107,121,
Comanche,Governor,Kevin Stitt,REP,160034,8,8,121,137,
Comanche,Lieutenant Governor,Dana Murphy,REP,160034,6,10,108,124,
Comanche,Lieutenant Governor,Matt Pinnell,REP,160034,4,9,121,134,
Comanche,State Auditor,Cindy Byrd,REP,160034,6,13,117,136,
Comanche,State Auditor,Charlie Prater,REP,160034,4,7,100,111,
Comanche,Attorney General,Mike Hunter,REP,160034,4,12,121,137,
Comanche,Attorney General,Gentner Drummond,REP,160034,6,8,103,117,
Comanche,Superintendent of Public Instruction,Joy Hofmeister,REP,160034,5,12,130,147,
Comanche,Superintendent of Public Instruction,Linda Murphy,REP,160034,5,8,97,110,
Comanche,Commissioner of Labor,Cathy Costello,REP,160034,9,9,118,136,
Comanche,Commissioner of Labor,Leslie Osborn,REP,160034,1,10,105,116,
Comanche,Corporation Commissioner,Bob Anthony,REP,160034,6,10,127,143,
Comanche,Corporation Commissioner,Brian Bingman,REP,160034,4,8,88,100,
Comanche,State House,Jeff Coody,REP,160034,8,8,117,133,63
Comanche,State House,Trey Caldwell,REP,160034,2,12,114,128,63
Comanche,Governor,Chris Powell,LIB,160034,0,0,0,0,
Comanche,Governor,Rex Lawhorn,LIB,160034,0,0,3,3,
Comanche,Corporation Commissioner,Ashley Nicole Mccray,DEM,160034,6,17,129,152,
Comanche,Corporation Commissioner,Blake Cummings,DEM,160034,0,14,82,96,
Comanche,U.S. House,Mary Brannon,DEM,160034,4,20,133,157,04
Comanche,U.S. House,Fred Gipson,DEM,160034,1,11,78,90,04
Comanche,Governor,Mick Cornett,REP,160035,1,0,36,37,
Comanche,Governor,Kevin Stitt,REP,160035,2,2,52,56,
Comanche,Lieutenant Governor,Dana Murphy,REP,160035,0,1,28,29,
Comanche,Lieutenant Governor,Matt Pinnell,REP,160035,3,1,58,62,
Comanche,State Auditor,Cindy Byrd,REP,160035,2,2,44,48,
Comanche,State Auditor,Charlie Prater,REP,160035,1,0,40,41,
Comanche,Attorney General,Mike Hunter,REP,160035,3,0,39,42,
Comanche,Attorney General,Gentner Drummond,REP,160035,0,2,49,51,
Comanche,Superintendent of Public Instruction,Joy Hofmeister,REP,160035,2,0,44,46,
Comanche,Superintendent of Public Instruction,Linda Murphy,REP,160035,1,2,43,46,
Comanche,Commissioner of Labor,Cathy Costello,REP,160035,0,1,50,51,
Comanche,Commissioner of Labor,Leslie Osborn,REP,160035,3,1,33,37,
Comanche,Corporation Commissioner,Bob Anthony,REP,160035,3,0,47,50,
Comanche,Corporation Commissioner,Brian Bingman,REP,160035,0,2,38,40,
Comanche,State House,Jeff Coody,REP,160035,2,1,52,55,63
Comanche,State House,Trey Caldwell,REP,160035,1,1,37,39,63
Comanche,Governor,Chris Powell,LIB,160035,0,0,0,0,
Comanche,Governor,Rex Lawhorn,LIB,160035,0,0,1,1,
Comanche,Corporation Commissioner,Ashley Nicole Mccray,DEM,160035,1,0,18,19,
Comanche,Corporation Commissioner,Blake Cummings,DEM,160035,0,0,5,5,
Comanche,U.S. House,Mary Brannon,DEM,160035,1,0,12,13,04
Comanche,U.S. House,Fred Gipson,DEM,160035,0,0,11,11,04
Comanche,Governor,Mick Cornett,REP,160036,1,2,30,33,
Comanche,Governor,Kevin Stitt,REP,160036,2,2,44,48,
Comanche,Lieutenant Governor,Dana Murphy,REP,160036,3,4,28,35,
Comanche,Lieutenant Governor,Matt Pinnell,REP,160036,0,0,44,44,
Comanche,State Auditor,Cindy Byrd,REP,160036,1,3,40,44,
Comanche,State Auditor,Charlie Prater,REP,160036,2,1,29,32,
Comanche,Attorney General,Mike Hunter,REP,160036,2,3,43,48,
Comanche,Attorney General,Gentner Drummond,REP,160036,1,1,30,32,
Comanche,Superintendent of Public Instruction,Joy Hofmeister,REP,160036,3,2,34,39,
Comanche,Superintendent of Public Instruction,Linda Murphy,REP,160036,0,2,38,40,
Comanche,Commissioner of Labor,Cathy Costello,REP,160036,2,1,32,35,
Comanche,Commissioner of Labor,Leslie Osborn,REP,160036,1,3,40,44,
Comanche,Corporation Commissioner,Bob Anthony,REP,160036,2,3,33,38,
Comanche,Corporation Commissioner,Brian Bingman,REP,160036,0,1,37,38,
Comanche,State House,Jeff Coody,REP,160036,0,2,37,39,63
Comanche,State House,Trey Caldwell,REP,160036,3,2,38,43,63
Comanche,Governor,Chris Powell,LIB,160036,0,0,1,1,
Comanche,Governor,Rex Lawhorn,LIB,160036,0,0,0,0,
Comanche,Corporation Commissioner,Ashley Nicole Mccray,DEM,160036,0,0,19,19,
Comanche,Corporation Commissioner,Blake Cummings,DEM,160036,0,0,18,18,
Comanche,U.S. House,Mary Brannon,DEM,160036,0,0,19,19,04
Comanche,U.S. House,Fred Gipson,DEM,160036,0,0,17,17,04
Comanche,Governor,Mick Cornett,REP,160037,2,0,30,32,
Comanche,Governor,Kevin Stitt,REP,160037,1,0,33,34,
Comanche,Lieutenant Governor,Dana Murphy,REP,160037,2,0,29,31,
Comanche,Lieutenant Governor,Matt Pinnell,REP,160037,1,0,32,33,
Comanche,State Auditor,Cindy Byrd,REP,160037,2,0,22,24,
Comanche,State Auditor,Charlie Prater,REP,160037,1,0,36,37,
Comanche,Attorney General,Mike Hunter,REP,160037,3,0,40,43,
Comanche,Attorney General,Gentner Drummond,REP,160037,0,0,23,23,
Comanche,Superintendent of Public Instruction,Joy Hofmeister,REP,160037,0,0,28,28,
Comanche,Superintendent of Public Instruction,Linda Murphy,REP,160037,3,0,35,38,
Comanche,Commissioner of Labor,Cathy Costello,REP,160037,3,0,28,31,
Comanche,Commissioner of Labor,Leslie Osborn,REP,160037,0,0,33,33,
Comanche,Corporation Commissioner,Bob Anthony,REP,160037,2,0,32,34,
Comanche,Corporation Commissioner,Brian Bingman,REP,160037,1,0,26,27,
Comanche,State House,Jeff Coody,REP,160037,3,0,19,22,63
Comanche,State House,Trey Caldwell,REP,160037,0,0,45,45,63
Comanche,Governor,Chris Powell,LIB,160037,0,0,0,0,
Comanche,Governor,Rex Lawhorn,LIB,160037,0,0,0,0,
Comanche,Corporation Commissioner,Ashley Nicole Mccray,DEM,160037,0,0,16,16,
Comanche,Corporation Commissioner,Blake Cummings,DEM,160037,0,0,16,16,
Comanche,U.S. House,Mary Brannon,DEM,160037,0,0,17,17,04
Comanche,U.S. House,Fred Gipson,DEM,160037,0,0,15,15,04
Comanche,Governor,Mick Cornett,REP,160038,9,19,133,161,
Comanche,Governor,Kevin Stitt,REP,160038,5,28,152,185,
Comanche,Lieutenant Governor,Dana Murphy,REP,160038,5,19,133,157,
Comanche,Lieutenant Governor,Matt Pinnell,REP,160038,8,27,145,180,
Comanche,State Auditor,Cindy Byrd,REP,160038,5,24,151,180,
Comanche,State Auditor,Charlie Prater,REP,160038,9,22,126,157,
Comanche,Attorney General,Mike Hunter,REP,160038,6,20,132,158,
Comanche,Attorney General,Gentner Drummond,REP,160038,8,26,149,183,
Comanche,Superintendent of Public Instruction,Joy Hofmeister,REP,160038,5,26,156,187,
Comanche,Superintendent of Public Instruction,Linda Murphy,REP,160038,9,20,125,154,
Comanche,Commissioner of Labor,Cathy Costello,REP,160038,7,22,140,169,
Comanche,Commissioner of Labor,Leslie Osborn,REP,160038,7,22,139,168,
Comanche,Corporation Commissioner,Bob Anthony,REP,160038,9,23,140,172,
Comanche,Corporation Commissioner,Brian Bingman,REP,160038,5,22,138,165,
Comanche,Governor,Chris Powell,LIB,160038,0,0,0,0,
Comanche,Governor,Rex Lawhorn,LIB,160038,0,0,1,1,
Comanche,Corporation Commissioner,Ashley Nicole Mccray,DEM,160038,9,7,53,69,
Comanche,Corporation Commissioner,Blake Cummings,DEM,160038,4,7,25,36,
Comanche,U.S. House,Mary Brannon,DEM,160038,9,10,52,71,04
Comanche,U.S. House,Fred Gipson,DEM,160038,4,4,26,34,04
Comanche,Governor,Mick Cornett,REP,160039,0,4,58,62,
Comanche,Governor,Kevin Stitt,REP,160039,1,3,70,74,
Comanche,Lieutenant Governor,Dana Murphy,REP,160039,0,3,55,58,
Comanche,Lieutenant Governor,Matt Pinnell,REP,160039,1,4,70,75,
Comanche,State Auditor,Cindy Byrd,REP,160039,0,3,53,56,
Comanche,State Auditor,Charlie Prater,REP,160039,1,4,72,77,
Comanche,Attorney General,Mike Hunter,REP,160039,0,5,50,55,
Comanche,Attorney General,Gentner Drummond,REP,160039,1,2,77,80,
Comanche,Superintendent of Public Instruction,Joy Hofmeister,REP,160039,0,4,62,66,
Comanche,Superintendent of Public Instruction,Linda Murphy,REP,160039,1,3,63,67,
Comanche,Commissioner of Labor,Cathy Costello,REP,160039,0,5,57,62,
Comanche,Commissioner of Labor,Leslie Osborn,REP,160039,1,2,67,70,
Comanche,Corporation Commissioner,Bob Anthony,REP,160039,0,3,53,56,
Comanche,Corporation Commissioner,Brian Bingman,REP,160039,1,4,74,79,
Comanche,Governor,Chris Powell,LIB,160039,0,0,0,0,
Comanche,Governor,Rex Lawhorn,LIB,160039,0,0,0,0,
Comanche,Corporation Commissioner,Ashley Nicole Mccray,DEM,160039,2,0,20,22,
Comanche,Corporation Commissioner,Blake Cummings,DEM,160039,4,2,17,23,
Comanche,U.S. House,Mary Brannon,DEM,160039,2,0,20,22,04
Comanche,U.S. House,Fred Gipson,DEM,160039,4,2,17,23,04
Comanche,Governor,Mick Cornett,REP,160040,2,3,55,60,
Comanche,Governor,Kevin Stitt,REP,160040,1,4,64,69,
Comanche,Lieutenant Governor,Dana Murphy,REP,160040,2,2,49,53,
Comanche,Lieutenant Governor,Matt Pinnell,REP,160040,1,5,69,75,
Comanche,State Auditor,Cindy Byrd,REP,160040,2,1,45,48,
Comanche,State Auditor,Charlie Prater,REP,160040,1,6,70,77,
Comanche,Attorney General,Mike Hunter,REP,160040,3,2,49,54,
Comanche,Attorney General,Gentner Drummond,REP,160040,0,5,69,74,
Comanche,Superintendent of Public Instruction,Joy Hofmeister,REP,160040,3,2,68,73,
Comanche,Superintendent of Public Instruction,Linda Murphy,REP,160040,0,5,48,53,
Comanche,Commissioner of Labor,Cathy Costello,REP,160040,0,4,57,61,
Comanche,Commissioner of Labor,Leslie Osborn,REP,160040,3,3,60,66,
Comanche,Corporation Commissioner,Bob Anthony,REP,160040,3,0,58,61,
Comanche,Corporation Commissioner,Brian Bingman,REP,160040,0,7,55,62,
Comanche,Governor,Chris Powell,LIB,160040,0,0,0,0,
Comanche,Governor,Rex Lawhorn,LIB,160040,0,0,0,0,
Comanche,Corporation Commissioner,Ashley Nicole Mccray,DEM,160040,2,2,29,33,
Comanche,Corporation Commissioner,Blake Cummings,DEM,160040,0,3,31,34,
Comanche,U.S. House,Mary Brannon,DEM,160040,2,3,29,34,04
Comanche,U.S. House,Fred Gipson,DEM,160040,0,2,31,33,04
Comanche,Governor,Mick Cornett,REP,160041,2,1,40,43,
Comanche,Governor,Kevin Stitt,REP,160041,1,0,52,53,
Comanche,Lieutenant Governor,Dana Murphy,REP,160041,1,0,36,37,
Comanche,Lieutenant Governor,Matt Pinnell,REP,160041,1,1,52,54,
Comanche,State Auditor,Cindy Byrd,REP,160041,3,1,48,52,
Comanche,State Auditor,Charlie Prater,REP,160041,0,0,40,40,
Comanche,Attorney General,Mike Hunter,REP,160041,1,0,49,50,
Comanche,Attorney General,Gentner Drummond,REP,160041,1,1,42,44,
Comanche,Superintendent of Public Instruction,Joy Hofmeister,REP,160041,1,1,46,48,
Comanche,Superintendent of Public Instruction,Linda Murphy,REP,160041,1,0,44,45,
Comanche,Commissioner of Labor,Cathy Costello,REP,160041,1,1,34,36,
Comanche,Commissioner of Labor,Leslie Osborn,REP,160041,1,0,54,55,
Comanche,Corporation Commissioner,Bob Anthony,REP,160041,1,1,46,48,
Comanche,Corporation Commissioner,Brian Bingman,REP,160041,1,0,43,44,
Comanche,State House,Jeff Coody,REP,160041,2,0,30,32,63
Comanche,State House,Trey Caldwell,REP,160041,1,1,63,65,63
Comanche,Governor,Chris Powell,LIB,160041,0,0,0,0,
Comanche,Governor,Rex Lawhorn,LIB,160041,0,0,0,0,
Comanche,Corporation Commissioner,Ashley Nicole Mccray,DEM,160041,3,0,36,39,
Comanche,Corporation Commissioner,Blake Cummings,DEM,160041,2,0,25,27,
Comanche,U.S. House,Mary Brannon,DEM,160041,2,0,37,39,04
Comanche,U.S. House,Fred Gipson,DEM,160041,3,0,25,28,04
Comanche,Governor,Mick Cornett,REP,160042,19,13,196,228,
Comanche,Governor,Kevin Stitt,REP,160042,19,11,179,209,
Comanche,Lieutenant Governor,Dana Murphy,REP,160042,16,8,188,212,
Comanche,Lieutenant Governor,Matt Pinnell,REP,160042,21,16,180,217,
Comanche,State Auditor,Cindy Byrd,REP,160042,23,15,212,250,
Comanche,State Auditor,Charlie Prater,REP,160042,15,8,146,169,
Comanche,Attorney General,Mike Hunter,REP,160042,11,12,183,206,
Comanche,Attorney General,Gentner Drummond,REP,160042,27,11,183,221,
Comanche,Superintendent of Public Instruction,Joy Hofmeister,REP,160042,15,14,204,233,
Comanche,Superintendent of Public Instruction,Linda Murphy,REP,160042,23,10,165,198,
Comanche,Commissioner of Labor,Cathy Costello,REP,160042,24,15,180,219,
Comanche,Commissioner of Labor,Leslie Osborn,REP,160042,13,8,182,203,
Comanche,Corporation Commissioner,Bob Anthony,REP,160042,25,15,209,249,
Comanche,Corporation Commissioner,Brian Bingman,REP,160042,12,7,150,169,
Comanche,State House,Jeff Coody,REP,160042,18,15,138,171,63
Comanche,State House,Trey Caldwell,REP,160042,20,9,238,267,63
Comanche,Governor,Chris Powell,LIB,160042,0,0,0,0,
Comanche,Governor,Rex Lawhorn,LIB,160042,0,0,0,0,
Comanche,Corporation Commissioner,Ashley Nicole Mccray,DEM,160042,11,9,93,113,
Comanche,Corporation Commissioner,Blake Cummings,DEM,160042,7,7,55,69,
Comanche,U.S. House,Mary Brannon,DEM,160042,10,12,85,107,04
Comanche,U.S. House,Fred Gipson,DEM,160042,8,4,63,75,04
Comanche,Governor,Mick Cornett,REP,160043,3,6,41,50,
Comanche,Governor,Kevin Stitt,REP,160043,2,6,53,61,
Comanche,Lieutenant Governor,Dana Murphy,REP,160043,2,0,44,46,
Comanche,Lieutenant Governor,Matt Pinnell,REP,160043,3,12,48,63,
Comanche,State Auditor,Cindy Byrd,REP,160043,5,7,52,64,
Comanche,State Auditor,Charlie Prater,REP,160043,0,5,37,42,
Comanche,Attorney General,Mike Hunter,REP,160043,4,6,40,50,
Comanche,Attorney General,Gentner Drummond,REP,160043,1,6,52,59,
Comanche,Superintendent of Public Instruction,Joy Hofmeister,REP,160043,4,6,44,54,
Comanche,Superintendent of Public Instruction,Linda Murphy,REP,160043,1,6,47,54,
Comanche,Commissioner of Labor,Cathy Costello,REP,160043,2,7,47,56,
Comanche,Commissioner of Labor,Leslie Osborn,REP,160043,3,5,44,52,
Comanche,Corporation Commissioner,Bob Anthony,REP,160043,4,5,50,59,
Comanche,Corporation Commissioner,Brian Bingman,REP,160043,1,7,40,48,
Comanche,State House,Jeff Coody,REP,160043,3,6,36,45,63
Comanche,State House,Trey Caldwell,REP,160043,2,6,58,66,63
Comanche,Governor,Chris Powell,LIB,160043,0,0,0,0,
Comanche,Governor,Rex Lawhorn,LIB,160043,0,0,0,0,
Comanche,Corporation Commissioner,Ashley Nicole Mccray,DEM,160043,1,1,19,21,
Comanche,Corporation Commissioner,Blake Cummings,DEM,160043,0,1,16,17,
Comanche,U.S. House,Mary Brannon,DEM,160043,1,1,16,18,04
Comanche,U.S. House,Fred Gipson,DEM,160043,0,1,19,20,04
Comanche,Governor,Mick Cornett,REP,160045,1,12,73,86,
Comanche,Governor,Kevin Stitt,REP,160045,4,11,113,128,
Comanche,Lieutenant Governor,Dana Murphy,REP,160045,3,11,85,99,
Comanche,Lieutenant Governor,Matt Pinnell,REP,160045,2,12,99,113,
Comanche,State Auditor,Cindy Byrd,REP,160045,2,15,112,129,
Comanche,State Auditor,Charlie Prater,REP,160045,3,7,71,81,
Comanche,Attorney General,Mike Hunter,REP,160045,2,9,90,101,
Comanche,Attorney General,Gentner Drummond,REP,160045,3,14,90,107,
Comanche,Superintendent of Public Instruction,Joy Hofmeister,REP,160045,2,18,113,133,
Comanche,Superintendent of Public Instruction,Linda Murphy,REP,160045,3,6,70,79,
Comanche,Commissioner of Labor,Cathy Costello,REP,160045,2,10,79,91,
Comanche,Commissioner of Labor,Leslie Osborn,REP,160045,3,11,105,119,
Comanche,Corporation Commissioner,Bob Anthony,REP,160045,4,8,80,92,
Comanche,Corporation Commissioner,Brian Bingman,REP,160045,1,13,102,116,
Comanche,State House,Jeff Coody,REP,160045,1,9,70,80,63
Comanche,State House,Trey Caldwell,REP,160045,4,16,116,136,63
Comanche,Governor,Chris Powell,LIB,160045,0,0,0,0,
Comanche,Governor,Rex Lawhorn,LIB,160045,0,0,1,1,
Comanche,Corporation Commissioner,Ashley Nicole Mccray,DEM,160045,0,6,40,46,
Comanche,Corporation Commissioner,Blake Cummings,DEM,160045,3,5,33,41,
Comanche,U.S. House,Mary Brannon,DEM,160045,1,7,37,45,04
Comanche,U.S. House,Fred Gipson,DEM,160045,2,4,37,43,04
Comanche,Governor,Mick Cornett,REP,160046,0,0,47,47,
Comanche,Governor,Kevin Stitt,REP,160046,1,1,54,56,
Comanche,Lieutenant Governor,Dana Murphy,REP,160046,0,1,45,46,
Comanche,Lieutenant Governor,Matt Pinnell,REP,160046,1,0,50,51,
Comanche,State Auditor,Cindy Byrd,REP,160046,1,1,55,57,
Comanche,State Auditor,Charlie Prater,REP,160046,0,0,43,43,
Comanche,Attorney General,Mike Hunter,REP,160046,0,1,37,38,
Comanche,Attorney General,Gentner Drummond,REP,160046,1,0,61,62,
Comanche,Superintendent of Public Instruction,Joy Hofmeister,REP,160046,0,1,53,54,
Comanche,Superintendent of Public Instruction,Linda Murphy,REP,160046,1,0,44,45,
Comanche,Commissioner of Labor,Cathy Costello,REP,160046,1,1,38,40,
Comanche,Commissioner of Labor,Leslie Osborn,REP,160046,0,0,58,58,
Comanche,Corporation Commissioner,Bob Anthony,REP,160046,0,0,60,60,
Comanche,Corporation Commissioner,Brian Bingman,REP,160046,1,1,32,34,
Comanche,State House,Jeff Coody,REP,160046,0,0,28,28,63
Comanche,State House,Trey Caldwell,REP,160046,1,1,74,76,63
Comanche,Governor,Chris Powell,LIB,160046,0,0,0,0,
Comanche,Governor,Rex Lawhorn,LIB,160046,0,0,1,1,
Comanche,Corporation Commissioner,Ashley Nicole Mccray,DEM,160046,1,2,17,20,
Comanche,Corporation Commissioner,Blake Cummings,DEM,160046,1,1,19,21,
Comanche,U.S. House,Mary Brannon,DEM,160046,0,0,19,19,04
Comanche,U.S. House,Fred Gipson,DEM,160046,2,3,16,21,04
Comanche,Governor,Mick Cornett,REP,160048,2,1,52,55,
Comanche,Governor,Kevin Stitt,REP,160048,1,3,73,77,
Comanche,Lieutenant Governor,Dana Murphy,REP,160048,1,2,55,58,
Comanche,Lieutenant Governor,Matt Pinnell,REP,160048,2,2,68,72,
Comanche,State Auditor,Cindy Byrd,REP,160048,3,3,67,73,
Comanche,State Auditor,Charlie Prater,REP,160048,0,1,55,56,
Comanche,Attorney General,Mike Hunter,REP,160048,2,2,64,68,
Comanche,Attorney General,Gentner Drummond,REP,160048,1,2,60,63,
Comanche,Superintendent of Public Instruction,Joy Hofmeister,REP,160048,2,1,65,68,
Comanche,Superintendent of Public Instruction,Linda Murphy,REP,160048,1,3,61,65,
Comanche,Commissioner of Labor,Cathy Costello,REP,160048,0,3,47,50,
Comanche,Commissioner of Labor,Leslie Osborn,REP,160048,3,1,73,77,
Comanche,Corporation Commissioner,Bob Anthony,REP,160048,1,3,59,63,
Comanche,Corporation Commissioner,Brian Bingman,REP,160048,2,1,61,64,
Comanche,State House,Jeff Coody,REP,160048,0,0,52,52,63
Comanche,State House,Trey Caldwell,REP,160048,3,4,74,81,63
Comanche,Governor,Chris Powell,LIB,160048,0,0,0,0,
Comanche,Governor,Rex Lawhorn,LIB,160048,0,0,1,1,
Comanche,Corporation Commissioner,Ashley Nicole Mccray,DEM,160048,0,1,38,39,
Comanche,Corporation Commissioner,Blake Cummings,DEM,160048,0,0,21,21,
Comanche,U.S. House,Mary Brannon,DEM,160048,0,1,33,34,04
Comanche,U.S. House,Fred Gipson,DEM,160048,0,0,25,25,04
Comanche,Governor,Mick Cornett,REP,160049,1,0,57,58,
Comanche,Governor,Kevin Stitt,REP,160049,2,0,75,77,
Comanche,Lieutenant Governor,Dana Murphy,REP,160049,0,0,69,69,
Comanche,Lieutenant Governor,Matt Pinnell,REP,160049,3,0,56,59,
Comanche,State Auditor,Cindy Byrd,REP,160049,0,0,79,79,
Comanche,State Auditor,Charlie Prater,REP,160049,3,0,45,48,
Comanche,Attorney General,Mike Hunter,REP,160049,1,0,58,59,
Comanche,Attorney General,Gentner Drummond,REP,160049,2,0,69,71,
Comanche,Superintendent of Public Instruction,Joy Hofmeister,REP,160049,0,0,66,66,
Comanche,Superintendent of Public Instruction,Linda Murphy,REP,160049,2,0,60,62,
Comanche,Commissioner of Labor,Cathy Costello,REP,160049,0,0,61,61,
Comanche,Commissioner of Labor,Leslie Osborn,REP,160049,2,0,67,69,
Comanche,Corporation Commissioner,Bob Anthony,REP,160049,1,0,55,56,
Comanche,Corporation Commissioner,Brian Bingman,REP,160049,2,0,70,72,
Comanche,Governor,Chris Powell,LIB,160049,0,0,0,0,
Comanche,Governor,Rex Lawhorn,LIB,160049,0,0,0,0,
Comanche,Corporation Commissioner,Ashley Nicole Mccray,DEM,160049,2,2,28,32,
Comanche,Corporation Commissioner,Blake Cummings,DEM,160049,0,2,18,20,
Comanche,U.S. House,Mary Brannon,DEM,160049,0,3,18,21,04
Comanche,U.S. House,Fred Gipson,DEM,160049,2,3,27,32,04
Comanche,Governor,Mick Cornett,REP,160050,8,18,180,206,
Comanche,Governor,Kevin Stitt,REP,160050,18,21,163,202,
Comanche,Lieutenant Governor,Dana Murphy,REP,160050,10,14,152,176,
Comanche,Lieutenant Governor,Matt Pinnell,REP,160050,14,24,183,221,
Comanche,State Auditor,Cindy Byrd,REP,160050,13,20,201,234,
Comanche,State Auditor,Charlie Prater,REP,160050,10,18,130,158,
Comanche,Attorney General,Mike Hunter,REP,160050,14,21,170,205,
Comanche,Attorney General,Gentner Drummond,REP,160050,10,16,163,189,
Comanche,Superintendent of Public Instruction,Joy Hofmeister,REP,160050,14,16,208,238,
Comanche,Superintendent of Public Instruction,Linda Murphy,REP,160050,12,22,127,161,
Comanche,Commissioner of Labor,Cathy Costello,REP,160050,8,20,166,194,
Comanche,Commissioner of Labor,Leslie Osborn,REP,160050,15,15,162,192,
Comanche,Corporation Commissioner,Bob Anthony,REP,160050,12,23,192,227,
Comanche,Corporation Commissioner,Brian Bingman,REP,160050,12,15,137,164,
Comanche,Governor,Chris Powell,LIB,160050,0,0,0,0,
Comanche,Governor,Rex Lawhorn,LIB,160050,0,0,0,0,
Comanche,Corporation Commissioner,Ashley Nicole Mccray,DEM,160050,19,17,152,188,
Comanche,Corporation Commissioner,Blake Cummings,DEM,160050,7,7,84,98,
Comanche,U.S. House,Mary Brannon,DEM,160050,13,14,132,159,04
Comanche,U.S. House,Fred Gipson,DEM,160050,13,10,110,133,04
Comanche,Governor,Mick Cornett,REP,160051,8,4,91,103,
Comanche,Governor,Kevin Stitt,REP,160051,4,9,121,134,
Comanche,Lieutenant Governor,Dana Murphy,REP,160051,7,2,84,93,
Comanche,Lieutenant Governor,Matt Pinnell,REP,160051,5,10,125,140,
Comanche,State Auditor,Cindy Byrd,REP,160051,10,5,103,118,
Comanche,State Auditor,Charlie Prater,REP,160051,2,7,98,107,
Comanche,Attorney General,Mike Hunter,REP,160051,7,3,98,108,
Comanche,Attorney General,Gentner Drummond,REP,160051,5,9,107,121,
Comanche,Superintendent of Public Instruction,Joy Hofmeister,REP,160051,5,4,130,139,
Comanche,Superintendent of Public Instruction,Linda Murphy,REP,160051,7,9,81,97,
Comanche,Commissioner of Labor,Cathy Costello,REP,160051,2,6,96,104,
Comanche,Commissioner of Labor,Leslie Osborn,REP,160051,10,6,105,121,
Comanche,Corporation Commissioner,Bob Anthony,REP,160051,4,5,105,114,
Comanche,Corporation Commissioner,Brian Bingman,REP,160051,8,7,97,112,
Comanche,State House,Jeff Coody,REP,160051,1,7,91,99,63
Comanche,State House,Trey Caldwell,REP,160051,11,6,121,138,63
Comanche,Governor,Chris Powell,LIB,160051,0,0,0,0,
Comanche,Governor,Rex Lawhorn,LIB,160051,0,0,0,0,
Comanche,Corporation Commissioner,Ashley Nicole Mccray,DEM,160051,1,3,40,44,
Comanche,Corporation Commissioner,Blake Cummings,DEM,160051,0,2,36,38,
Comanche,U.S. House,Mary Brannon,DEM,160051,0,3,40,43,04
Comanche,U.S. House,Fred Gipson,DEM,160051,1,2,36,39,04
Comanche,Governor,Mick Cornett,REP,160053,0,0,0,0,
Comanche,Governor,Kevin Stitt,REP,160053,0,0,0,0,
Comanche,Lieutenant Governor,Dana Murphy,REP,160053,0,0,0,0,
Comanche,Lieutenant Governor,Matt Pinnell,REP,160053,0,0,0,0,
Comanche,State Auditor,Cindy Byrd,REP,160053,0,0,0,0,
Comanche,State Auditor,Charlie Prater,REP,160053,0,0,0,0,
Comanche,Attorney General,Mike Hunter,REP,160053,0,0,0,0,
Comanche,Attorney General,Gentner Drummond,REP,160053,0,0,0,0,
Comanche,Superintendent of Public Instruction,Joy Hofmeister,REP,160053,0,0,0,0,
Comanche,Superintendent of Public Instruction,Linda Murphy,REP,160053,0,0,0,0,
Comanche,Commissioner of Labor,Cathy Costello,REP,160053,0,0,0,0,
Comanche,Commissioner of Labor,Leslie Osborn,REP,160053,0,0,0,0,
Comanche,Corporation Commissioner,Bob Anthony,REP,160053,0,0,0,0,
Comanche,Corporation Commissioner,Brian Bingman,REP,160053,0,0,0,0,
Comanche,Governor,Chris Powell,LIB,160053,0,0,0,0,
Comanche,Governor,Rex Lawhorn,LIB,160053,0,0,0,0,
Comanche,Corporation Commissioner,Ashley Nicole Mccray,DEM,160053,0,0,0,0,
Comanche,Corporation Commissioner,Blake Cummings,DEM,160053,0,0,0,0,
Comanche,U.S. House,Mary Brannon,DEM,160053,0,0,0,0,04
Comanche,U.S. House,Fred Gipson,DEM,160053,0,0,0,0,04
Cotton,Governor,Mick Cornett,REP,170001,0,1,1,2,
Cotton,Governor,Kevin Stitt,REP,170001,2,0,4,6,
Cotton,Lieutenant Governor,Dana Murphy,REP,170001,0,0,1,1,
Cotton,Lieutenant Governor,Matt Pinnell,REP,170001,2,1,4,7,
Cotton,State Auditor,Cindy Byrd,REP,170001,1,1,2,4,
Cotton,State Auditor,Charlie Prater,REP,170001,1,0,3,4,
Cotton,Attorney General,Mike Hunter,REP,170001,1,1,3,5,
Cotton,Attorney General,Gentner Drummond,REP,170001,1,0,2,3,
Cotton,Superintendent of Public Instruction,Joy Hofmeister,REP,170001,2,0,3,5,
Cotton,Superintendent of Public Instruction,Linda Murphy,REP,170001,0,1,2,3,
Cotton,Commissioner of Labor,Cathy Costello,REP,170001,2,1,2,5,
Cotton,Commissioner of Labor,Leslie Osborn,REP,170001,0,0,3,3,
Cotton,Corporation Commissioner,Bob Anthony,REP,170001,2,0,3,5,
Cotton,Corporation Commissioner,Brian Bingman,REP,170001,0,1,2,3,
Cotton,Governor,Chris Powell,LIB,170001,0,0,0,0,
Cotton,Governor,Rex Lawhorn,LIB,170001,0,0,0,0,
Cotton,Corporation Commissioner,Ashley Nicole Mccray,DEM,170001,0,0,5,5,
Cotton,Corporation Commissioner,Blake Cummings,DEM,170001,0,1,8,9,
Cotton,U.S. House,Mary Brannon,DEM,170001,0,0,8,8,04
Cotton,U.S. House,Fred Gipson,DEM,170001,0,2,5,7,04
Cotton,Governor,Mick Cornett,REP,170003,2,1,24,27,
Cotton,Governor,Kevin Stitt,REP,170003,0,8,39,47,
Cotton,Lieutenant Governor,Dana Murphy,REP,170003,2,5,21,28,
Cotton,Lieutenant Governor,Matt Pinnell,REP,170003,0,4,42,46,
Cotton,State Auditor,Cindy Byrd,REP,170003,2,5,35,42,
Cotton,State Auditor,Charlie Prater,REP,170003,0,4,26,30,
Cotton,Attorney General,Mike Hunter,REP,170003,0,7,26,33,
Cotton,Attorney General,Gentner Drummond,REP,170003,2,2,38,42,
Cotton,Superintendent of Public Instruction,Joy Hofmeister,REP,170003,2,8,31,41,
Cotton,Superintendent of Public Instruction,Linda Murphy,REP,170003,0,1,30,31,
Cotton,Commissioner of Labor,Cathy Costello,REP,170003,2,5,29,36,
Cotton,Commissioner of Labor,Leslie Osborn,REP,170003,0,4,31,35,
Cotton,Corporation Commissioner,Bob Anthony,REP,170003,2,4,41,47,
Cotton,Corporation Commissioner,Brian Bingman,REP,170003,0,5,21,26,
Cotton,Governor,Chris Powell,LIB,170003,0,0,0,0,
Cotton,Governor,Rex Lawhorn,LIB,170003,0,0,0,0,
Cotton,Corporation Commissioner,Ashley Nicole Mccray,DEM,170003,1,5,19,25,
Cotton,Corporation Commissioner,Blake Cummings,DEM,170003,1,0,10,11,
Cotton,U.S. House,Mary Brannon,DEM,170003,2,5,20,27,04
Cotton,U.S. House,Fred Gipson,DEM,170003,0,0,9,9,04
Cotton,Governor,Mick Cornett,REP,170004,0,0,20,20,
Cotton,Governor,Kevin Stitt,REP,170004,0,1,27,28,
Cotton,Lieutenant Governor,Dana Murphy,REP,170004,0,0,15,15,
Cotton,Lieutenant Governor,Matt Pinnell,REP,170004,0,1,29,30,
Cotton,State Auditor,Cindy Byrd,REP,170004,0,1,22,23,
Cotton,State Auditor,Charlie Prater,REP,170004,0,0,21,21,
Cotton,Attorney General,Mike Hunter,REP,170004,0,0,27,27,
Cotton,Attorney General,Gentner Drummond,REP,170004,0,1,17,18,
Cotton,Superintendent of Public Instruction,Joy Hofmeister,REP,170004,0,0,27,27,
Cotton,Superintendent of Public Instruction,Linda Murphy,REP,170004,0,1,19,20,
Cotton,Commissioner of Labor,Cathy Costello,REP,170004,0,1,20,21,
Cotton,Commissioner of Labor,Leslie Osborn,REP,170004,0,0,24,24,
Cotton,Corporation Commissioner,Bob Anthony,REP,170004,0,1,24,25,
Cotton,Corporation Commissioner,Brian Bingman,REP,170004,0,0,20,20,
Cotton,Governor,Chris Powell,LIB,170004,0,0,0,0,
Cotton,Governor,Rex Lawhorn,LIB,170004,0,0,0,0,
Cotton,Corporation Commissioner,Ashley Nicole Mccray,DEM,170004,0,3,19,22,
Cotton,Corporation Commissioner,Blake Cummings,DEM,170004,3,4,15,22,
Cotton,U.S. House,Mary Brannon,DEM,170004,0,4,18,22,04
Cotton,U.S. House,Fred Gipson,DEM,170004,3,3,16,22,04
Cotton,Governor,Mick Cornett,REP,170005,1,0,12,13,
Cotton,Governor,Kevin Stitt,REP,170005,0,1,28,29,
Cotton,Lieutenant Governor,Dana Murphy,REP,170005,0,1,14,15,
Cotton,Lieutenant Governor,Matt Pinnell,REP,170005,1,0,26,27,
Cotton,State Auditor,Cindy Byrd,REP,170005,0,0,14,14,
Cotton,State Auditor,Charlie Prater,REP,170005,1,1,23,25,
Cotton,Attorney General,Mike Hunter,REP,170005,1,0,18,19,
Cotton,Attorney General,Gentner Drummond,REP,170005,0,1,22,23,
Cotton,Superintendent of Public Instruction,Joy Hofmeister,REP,170005,0,1,20,21,
Cotton,Superintendent of Public Instruction,Linda Murphy,REP,170005,1,0,20,21,
Cotton,Commissioner of Labor,Cathy Costello,REP,170005,1,1,18,20,
Cotton,Commissioner of Labor,Leslie Osborn,REP,170005,0,0,21,21,
Cotton,Corporation Commissioner,Bob Anthony,REP,170005,0,0,24,24,
Cotton,Corporation Commissioner,Brian Bingman,REP,170005,1,0,15,16,
Cotton,Governor,Chris Powell,LIB,170005,0,0,0,0,
Cotton,Governor,Rex Lawhorn,LIB,170005,0,0,0,0,
Cotton,Corporation Commissioner,Ashley Nicole Mccray,DEM,170005,2,1,19,22,
Cotton,Corporation Commissioner,Blake Cummings,DEM,170005,1,2,18,21,
Cotton,U.S. House,Mary Brannon,DEM,170005,3,1,21,25,04
Cotton,U.S. House,Fred Gipson,DEM,170005,0,2,16,18,04
Cotton,Governor,Mick Cornett,REP,170007,0,0,28,28,
Cotton,Governor,Kevin Stitt,REP,170007,1,4,28,33,
Cotton,Lieutenant Governor,Dana Murphy,REP,170007,0,0,22,22,
Cotton,Lieutenant Governor,Matt Pinnell,REP,170007,1,4,34,39,
Cotton,State Auditor,Cindy Byrd,REP,170007,0,2,32,34,
Cotton,State Auditor,Charlie Prater,REP,170007,1,2,20,23,
Cotton,Attorney General,Mike Hunter,REP,170007,0,2,25,27,
Cotton,Attorney General,Gentner Drummond,REP,170007,1,2,29,32,
Cotton,Superintendent of Public Instruction,Joy Hofmeister,REP,170007,1,4,37,42,
Cotton,Superintendent of Public Instruction,Linda Murphy,REP,170007,0,0,19,19,
Cotton,Commissioner of Labor,Cathy Costello,REP,170007,1,4,22,27,
Cotton,Commissioner of Labor,Leslie Osborn,REP,170007,0,0,33,33,
Cotton,Corporation Commissioner,Bob Anthony,REP,170007,1,2,38,41,
Cotton,Corporation Commissioner,Brian Bingman,REP,170007,0,2,16,18,
Cotton,Governor,Chris Powell,LIB,170007,0,0,0,0,
Cotton,Governor,Rex Lawhorn,LIB,170007,0,0,0,0,
Cotton,Corporation Commissioner,Ashley Nicole Mccray,DEM,170007,1,0,13,14,
Cotton,Corporation Commissioner,Blake Cummings,DEM,170007,1,2,13,16,
Cotton,U.S. House,Mary Brannon,DEM,170007,2,1,14,17,04
Cotton,U.S. House,Fred Gipson,DEM,170007,0,1,12,13,04
Cotton,Governor,Mick Cornett,REP,170008,2,0,4,6,
Cotton,Governor,Kevin Stitt,REP,170008,0,1,5,6,
Cotton,Lieutenant Governor,Dana Murphy,REP,170008,2,1,2,5,
Cotton,Lieutenant Governor,Matt Pinnell,REP,170008,0,0,7,7,
Cotton,State Auditor,Cindy Byrd,REP,170008,2,1,5,8,
Cotton,State Auditor,Charlie Prater,REP,170008,0,0,4,4,
Cotton,Attorney General,Mike Hunter,REP,170008,2,0,3,5,
Cotton,Attorney General,Gentner Drummond,REP,170008,0,1,6,7,
Cotton,Superintendent of Public Instruction,Joy Hofmeister,REP,170008,2,0,3,5,
Cotton,Superintendent of Public Instruction,Linda Murphy,REP,170008,0,0,6,6,
Cotton,Commissioner of Labor,Cathy Costello,REP,170008,1,0,0,1,
Cotton,Commissioner of Labor,Leslie Osborn,REP,170008,1,1,9,11,
Cotton,Corporation Commissioner,Bob Anthony,REP,170008,2,1,5,8,
Cotton,Corporation Commissioner,Brian Bingman,REP,170008,0,0,4,4,
Cotton,Governor,Chris Powell,LIB,170008,0,0,0,0,
Cotton,Governor,Rex Lawhorn,LIB,170008,0,0,0,0,
Cotton,Corporation Commissioner,Ashley Nicole Mccray,DEM,170008,0,0,2,2,
Cotton,Corporation Commissioner,Blake Cummings,DEM,170008,0,0,4,4,
Cotton,U.S. House,Mary Brannon,DEM,170008,0,0,3,3,04
Cotton,U.S. House,Fred Gipson,DEM,170008,0,0,3,3,04
Cotton,Governor,Mick Cornett,REP,170009,0,3,14,17,
Cotton,Governor,Kevin Stitt,REP,170009,0,5,30,35,
Cotton,Lieutenant Governor,Dana Murphy,REP,170009,0,3,22,25,
Cotton,Lieutenant Governor,Matt Pinnell,REP,170009,0,5,22,27,
Cotton,State Auditor,Cindy Byrd,REP,170009,0,5,22,27,
Cotton,State Auditor,Charlie Prater,REP,170009,0,2,22,24,
Cotton,Attorney General,Mike Hunter,REP,170009,0,3,17,20,
Cotton,Attorney General,Gentner Drummond,REP,170009,0,5,26,31,
Cotton,Superintendent of Public Instruction,Joy Hofmeister,REP,170009,0,6,29,35,
Cotton,Superintendent of Public Instruction,Linda Murphy,REP,170009,0,2,15,17,
Cotton,Commissioner of Labor,Cathy Costello,REP,170009,0,6,27,33,
Cotton,Commissioner of Labor,Leslie Osborn,REP,170009,0,2,17,19,
Cotton,Corporation Commissioner,Bob Anthony,REP,170009,0,6,31,37,
Cotton,Corporation Commissioner,Brian Bingman,REP,170009,0,2,13,15,
Cotton,Governor,Chris Powell,LIB,170009,0,0,0,0,
Cotton,Governor,Rex Lawhorn,LIB,170009,0,0,1,1,
Cotton,Corporation Commissioner,Ashley Nicole Mccray,DEM,170009,1,0,9,10,
Cotton,Corporation Commissioner,Blake Cummings,DEM,170009,1,1,9,11,
Cotton,U.S. House,Mary Brannon,DEM,170009,1,0,11,12,04
Cotton,U.S. House,Fred Gipson,DEM,170009,1,1,7,9,04
Cotton,Governor,Mick Cornett,REP,170010,0,0,8,8,
Cotton,Governor,Kevin Stitt,REP,170010,0,1,24,25,
Cotton,Lieutenant Governor,Dana Murphy,REP,170010,0,0,7,7,
Cotton,Lieutenant Governor,Matt Pinnell,REP,170010,0,1,23,24,
Cotton,State Auditor,Cindy Byrd,REP,170010,0,1,10,11,
Cotton,State Auditor,Charlie Prater,REP,170010,0,0,18,18,
Cotton,Attorney General,Mike Hunter,REP,170010,0,0,9,9,
Cotton,Attorney General,Gentner Drummond,REP,170010,0,1,22,23,
Cotton,Superintendent of Public Instruction,Joy Hofmeister,REP,170010,0,0,10,10,
Cotton,Superintendent of Public Instruction,Linda Murphy,REP,170010,0,1,20,21,
Cotton,Commissioner of Labor,Cathy Costello,REP,170010,0,0,9,9,
Cotton,Commissioner of Labor,Leslie Osborn,REP,170010,0,1,19,20,
Cotton,Corporation Commissioner,Bob Anthony,REP,170010,0,1,9,10,
Cotton,Corporation Commissioner,Brian Bingman,REP,170010,0,0,19,19,
Cotton,Governor,Chris Powell,LIB,170010,0,0,1,1,
Cotton,Governor,Rex Lawhorn,LIB,170010,0,0,0,0,
Cotton,Corporation Commissioner,Ashley Nicole Mccray,DEM,170010,0,0,4,4,
Cotton,Corporation Commissioner,Blake Cummings,DEM,170010,1,0,1,2,
Cotton,U.S. House,Mary Brannon,DEM,170010,1,0,5,6,04
Cotton,U.S. House,Fred Gipson,DEM,170010,0,0,0,0,04
Cotton,Governor,Mick Cornett,REP,170011,0,1,18,19,
Cotton,Governor,Kevin Stitt,REP,170011,0,0,12,12,
Cotton,Lieutenant Governor,Dana Murphy,REP,170011,0,0,6,6,
Cotton,Lieutenant Governor,Matt Pinnell,REP,170011,0,1,24,25,
Cotton,State Auditor,Cindy Byrd,REP,170011,0,0,15,15,
Cotton,State Auditor,Charlie Prater,REP,170011,0,1,15,16,
Cotton,Attorney General,Mike Hunter,REP,170011,0,0,15,15,
Cotton,Attorney General,Gentner Drummond,REP,170011,0,1,15,16,
Cotton,Superintendent of Public Instruction,Joy Hofmeister,REP,170011,0,0,10,10,
Cotton,Superintendent of Public Instruction,Linda Murphy,REP,170011,0,1,20,21,
Cotton,Commissioner of Labor,Cathy Costello,REP,170011,0,0,11,11,
Cotton,Commissioner of Labor,Leslie Osborn,REP,170011,0,1,19,20,
Cotton,Corporation Commissioner,Bob Anthony,REP,170011,0,0,17,17,
Cotton,Corporation Commissioner,Brian Bingman,REP,170011,0,1,12,13,
Cotton,Governor,Chris Powell,LIB,170011,0,0,0,0,
Cotton,Governor,Rex Lawhorn,LIB,170011,0,0,0,0,
Cotton,Corporation Commissioner,Ashley Nicole Mccray,DEM,170011,0,0,2,2,
Cotton,Corporation Commissioner,Blake Cummings,DEM,170011,0,0,1,1,
Cotton,U.S. House,Mary Brannon,DEM,170011,0,0,2,2,04
Cotton,U.S. House,Fred Gipson,DEM,170011,0,0,1,1,04
Craig,Governor,Mick Cornett,REP,180140,2,0,49,51,
Craig,Governor,Kevin Stitt,REP,180140,0,3,38,41,
Craig,Lieutenant Governor,Dana Murphy,REP,180140,0,0,27,27,
Craig,Lieutenant Governor,Matt Pinnell,REP,180140,2,3,58,63,
Craig,State Auditor,Cindy Byrd,REP,180140,2,3,34,39,
Craig,State Auditor,Charlie Prater,REP,180140,0,0,51,51,
Craig,Attorney General,Mike Hunter,REP,180140,1,3,36,40,
Craig,Attorney General,Gentner Drummond,REP,180140,1,0,49,50,
Craig,Superintendent of Public Instruction,Joy Hofmeister,REP,180140,0,0,47,47,
Craig,Superintendent of Public Instruction,Linda Murphy,REP,180140,2,3,38,43,
Craig,Commissioner of Labor,Cathy Costello,REP,180140,2,2,32,36,
Craig,Commissioner of Labor,Leslie Osborn,REP,180140,0,1,50,51,
Craig,Corporation Commissioner,Bob Anthony,REP,180140,2,3,29,34,
Craig,Corporation Commissioner,Brian Bingman,REP,180140,0,0,54,54,
Craig,Governor,Chris Powell,LIB,180140,0,0,0,0,
Craig,Governor,Rex Lawhorn,LIB,180140,0,0,0,0,
Craig,Corporation Commissioner,Ashley Nicole Mccray,DEM,180140,0,1,36,37,
Craig,Corporation Commissioner,Blake Cummings,DEM,180140,0,0,41,41,
Craig,U.S. House,Jason Nichols,DEM,180140,0,1,52,53,02
Craig,U.S. House,Clay Padgett,DEM,180140,0,0,26,26,02
Craig,Governor,Mick Cornett,REP,180320,2,0,5,7,
Craig,Governor,Kevin Stitt,REP,180320,5,1,14,20,
Craig,Lieutenant Governor,Dana Murphy,REP,180320,2,0,5,7,
Craig,Lieutenant Governor,Matt Pinnell,REP,180320,5,1,13,19,
Craig,State Auditor,Cindy Byrd,REP,180320,2,0,4,6,
Craig,State Auditor,Charlie Prater,REP,180320,5,1,11,17,
Craig,Attorney General,Mike Hunter,REP,180320,0,0,12,12,
Craig,Attorney General,Gentner Drummond,REP,180320,7,1,7,15,
Craig,Superintendent of Public Instruction,Joy Hofmeister,REP,180320,0,0,6,6,
Craig,Superintendent of Public Instruction,Linda Murphy,REP,180320,6,1,10,17,
Craig,Commissioner of Labor,Cathy Costello,REP,180320,6,0,5,11,
Craig,Commissioner of Labor,Leslie Osborn,REP,180320,1,1,14,16,
Craig,Corporation Commissioner,Bob Anthony,REP,180320,2,1,8,11,
Craig,Corporation Commissioner,Brian Bingman,REP,180320,4,0,8,12,
Craig,Governor,Chris Powell,LIB,180320,0,0,0,0,
Craig,Governor,Rex Lawhorn,LIB,180320,0,0,0,0,
Craig,Corporation Commissioner,Ashley Nicole Mccray,DEM,180320,0,0,9,9,
Craig,Corporation Commissioner,Blake Cummings,DEM,180320,0,1,12,13,
Craig,U.S. House,Jason Nichols,DEM,180320,0,0,14,14,02
Craig,U.S. House,Clay Padgett,DEM,180320,0,1,7,8,02
Craig,Governor,Mick Cornett,REP,180410,0,0,16,16,
Craig,Governor,Kevin Stitt,REP,180410,1,3,27,31,
Craig,Lieutenant Governor,Dana Murphy,REP,180410,0,2,12,14,
Craig,Lieutenant Governor,Matt Pinnell,REP,180410,1,1,31,33,
Craig,State Auditor,Cindy Byrd,REP,180410,0,2,14,16,
Craig,State Auditor,Charlie Prater,REP,180410,1,1,29,31,
Craig,Attorney General,Mike Hunter,REP,180410,0,3,24,27,
Craig,Attorney General,Gentner Drummond,REP,180410,1,0,19,20,
Craig,Superintendent of Public Instruction,Joy Hofmeister,REP,180410,1,1,14,16,
Craig,Superintendent of Public Instruction,Linda Murphy,REP,180410,0,2,29,31,
Craig,Commissioner of Labor,Cathy Costello,REP,180410,0,2,21,23,
Craig,Commissioner of Labor,Leslie Osborn,REP,180410,1,1,21,23,
Craig,Corporation Commissioner,Bob Anthony,REP,180410,0,0,26,26,
Craig,Corporation Commissioner,Brian Bingman,REP,180410,1,3,17,21,
Craig,Governor,Chris Powell,LIB,180410,0,0,0,0,
Craig,Governor,Rex Lawhorn,LIB,180410,0,0,0,0,
Craig,Corporation Commissioner,Ashley Nicole Mccray,DEM,180410,0,0,22,22,
Craig,Corporation Commissioner,Blake Cummings,DEM,180410,1,1,25,27,
Craig,U.S. House,Jason Nichols,DEM,180410,0,1,29,30,02
Craig,U.S. House,Clay Padgett,DEM,180410,1,0,18,19,02
Craig,Governor,Mick Cornett,REP,180520,0,1,13,14,
Craig,Governor,Kevin Stitt,REP,180520,0,0,38,38,
Craig,Lieutenant Governor,Dana Murphy,REP,180520,0,1,16,17,
Craig,Lieutenant Governor,Matt Pinnell,REP,180520,0,0,35,35,
Craig,State Auditor,Cindy Byrd,REP,180520,0,0,22,22,
Craig,State Auditor,Charlie Prater,REP,180520,0,1,27,28,
Craig,Attorney General,Mike Hunter,REP,180520,0,1,17,18,
Craig,Attorney General,Gentner Drummond,REP,180520,0,0,34,34,
Craig,Superintendent of Public Instruction,Joy Hofmeister,REP,180520,0,1,29,30,
Craig,Superintendent of Public Instruction,Linda Murphy,REP,180520,0,0,21,21,
Craig,Commissioner of Labor,Cathy Costello,REP,180520,0,0,22,22,
Craig,Commissioner of Labor,Leslie Osborn,REP,180520,0,1,29,30,
Craig,Corporation Commissioner,Bob Anthony,REP,180520,0,1,19,20,
Craig,Corporation Commissioner,Brian Bingman,REP,180520,0,0,32,32,
Craig,Governor,Chris Powell,LIB,180520,0,0,0,0,
Craig,Governor,Rex Lawhorn,LIB,180520,0,0,0,0,
Craig,Corporation Commissioner,Ashley Nicole Mccray,DEM,180520,1,2,24,27,
Craig,Corporation Commissioner,Blake Cummings,DEM,180520,0,0,28,28,
Craig,U.S. House,Jason Nichols,DEM,180520,0,2,30,32,02
Craig,U.S. House,Clay Padgett,DEM,180520,1,0,23,24,02
Craig,Governor,Mick Cornett,REP,180611,2,3,24,29,
Craig,Governor,Kevin Stitt,REP,180611,0,0,31,31,
Craig,Lieutenant Governor,Dana Murphy,REP,180611,0,1,19,20,
Craig,Lieutenant Governor,Matt Pinnell,REP,180611,2,2,38,42,
Craig,State Auditor,Cindy Byrd,REP,180611,0,3,34,37,
Craig,State Auditor,Charlie Prater,REP,180611,2,0,23,25,
Craig,Attorney General,Mike Hunter,REP,180611,0,1,16,17,
Craig,Attorney General,Gentner Drummond,REP,180611,2,2,39,43,
Craig,Superintendent of Public Instruction,Joy Hofmeister,REP,180611,0,3,33,36,
Craig,Superintendent of Public Instruction,Linda Murphy,REP,180611,2,0,23,25,
Craig,Commissioner of Labor,Cathy Costello,REP,180611,0,0,30,30,
Craig,Commissioner of Labor,Leslie Osborn,REP,180611,2,3,26,31,
Craig,Corporation Commissioner,Bob Anthony,REP,180611,0,2,30,32,
Craig,Corporation Commissioner,Brian Bingman,REP,180611,2,1,25,28,
Craig,Governor,Chris Powell,LIB,180611,0,0,0,0,
Craig,Governor,Rex Lawhorn,LIB,180611,0,0,0,0,
Craig,Corporation Commissioner,Ashley Nicole Mccray,DEM,180611,0,1,46,47,
Craig,Corporation Commissioner,Blake Cummings,DEM,180611,0,2,32,34,
Craig,U.S. House,Jason Nichols,DEM,180611,0,0,44,44,02
Craig,U.S. House,Clay Padgett,DEM,180611,0,3,34,37,02
Craig,Governor,Mick Cornett,REP,180612,2,1,18,21,
Craig,Governor,Kevin Stitt,REP,180612,1,0,28,29,
Craig,Lieutenant Governor,Dana Murphy,REP,180612,1,0,17,18,
Craig,Lieutenant Governor,Matt Pinnell,REP,180612,2,1,29,32,
Craig,State Auditor,Cindy Byrd,REP,180612,0,0,19,19,
Craig,State Auditor,Charlie Prater,REP,180612,2,1,23,26,
Craig,Attorney General,Mike Hunter,REP,180612,2,0,26,28,
Craig,Attorney General,Gentner Drummond,REP,180612,1,1,19,21,
Craig,Superintendent of Public Instruction,Joy Hofmeister,REP,180612,2,1,25,28,
Craig,Superintendent of Public Instruction,Linda Murphy,REP,180612,1,0,20,21,
Craig,Commissioner of Labor,Cathy Costello,REP,180612,2,1,17,20,
Craig,Commissioner of Labor,Leslie Osborn,REP,180612,0,0,24,24,
Craig,Corporation Commissioner,Bob Anthony,REP,180612,1,1,25,27,
Craig,Corporation Commissioner,Brian Bingman,REP,180612,1,0,17,18,
Craig,Governor,Chris Powell,LIB,180612,0,0,0,0,
Craig,Governor,Rex Lawhorn,LIB,180612,0,0,0,0,
Craig,Corporation Commissioner,Ashley Nicole Mccray,DEM,180612,1,0,26,27,
Craig,Corporation Commissioner,Blake Cummings,DEM,180612,0,0,28,28,
Craig,U.S. House,Jason Nichols,DEM,180612,1,0,28,29,02
Craig,U.S. House,Clay Padgett,DEM,180612,0,0,26,26,02
Craig,Governor,Mick Cornett,REP,180621,1,5,43,49,
Craig,Governor,Kevin Stitt,REP,180621,0,1,50,51,
Craig,Lieutenant Governor,Dana Murphy,REP,180621,0,1,36,37,
Craig,Lieutenant Governor,Matt Pinnell,REP,180621,0,5,57,62,
Craig,State Auditor,Cindy Byrd,REP,180621,0,2,43,45,
Craig,State Auditor,Charlie Prater,REP,180621,0,4,47,51,
Craig,Attorney General,Mike Hunter,REP,180621,0,4,39,43,
Craig,Attorney General,Gentner Drummond,REP,180621,0,2,53,55,
Craig,Superintendent of Public Instruction,Joy Hofmeister,REP,180621,0,5,58,63,
Craig,Superintendent of Public Instruction,Linda Murphy,REP,180621,0,1,34,35,
Craig,Commissioner of Labor,Cathy Costello,REP,180621,0,4,36,40,
Craig,Commissioner of Labor,Leslie Osborn,REP,180621,0,2,54,56,
Craig,Corporation Commissioner,Bob Anthony,REP,180621,0,4,54,58,
Craig,Corporation Commissioner,Brian Bingman,REP,180621,0,2,37,39,
Craig,Governor,Chris Powell,LIB,180621,0,0,0,0,
Craig,Governor,Rex Lawhorn,LIB,180621,0,0,0,0,
Craig,Corporation Commissioner,Ashley Nicole Mccray,DEM,180621,4,8,45,57,
Craig,Corporation Commissioner,Blake Cummings,DEM,180621,2,6,49,57,
Craig,U.S. House,Jason Nichols,DEM,180621,4,9,38,51,02
Craig,U.S. House,Clay Padgett,DEM,180621,2,5,56,63,02
Craig,Governor,Mick Cornett,REP,180622,0,0,24,24,
Craig,Governor,Kevin Stitt,REP,180622,1,1,27,29,
Craig,Lieutenant Governor,Dana Murphy,REP,180622,0,1,17,18,
Craig,Lieutenant Governor,Matt Pinnell,REP,180622,1,0,32,33,
Craig,State Auditor,Cindy Byrd,REP,180622,1,1,15,17,
Craig,State Auditor,Charlie Prater,REP,180622,0,0,33,33,
Craig,Attorney General,Mike Hunter,REP,180622,1,0,14,15,
Craig,Attorney General,Gentner Drummond,REP,180622,0,1,37,38,
Craig,Superintendent of Public Instruction,Joy Hofmeister,REP,180622,0,1,25,26,
Craig,Superintendent of Public Instruction,Linda Murphy,REP,180622,1,0,23,24,
Craig,Commissioner of Labor,Cathy Costello,REP,180622,1,1,16,18,
Craig,Commissioner of Labor,Leslie Osborn,REP,180622,0,0,33,33,
Craig,Corporation Commissioner,Bob Anthony,REP,180622,0,1,20,21,
Craig,Corporation Commissioner,Brian Bingman,REP,180622,1,0,29,30,
Craig,Governor,Chris Powell,LIB,180622,0,0,0,0,
Craig,Governor,Rex Lawhorn,LIB,180622,0,0,0,0,
Craig,Corporation Commissioner,Ashley Nicole Mccray,DEM,180622,3,1,36,40,
Craig,Corporation Commissioner,Blake Cummings,DEM,180622,0,1,32,33,
Craig,U.S. House,Jason Nichols,DEM,180622,1,2,35,38,02
Craig,U.S. House,Clay Padgett,DEM,180622,2,0,32,34,02
Craig,Governor,Mick Cornett,REP,180710,4,0,29,33,
Craig,Governor,Kevin Stitt,REP,180710,3,1,27,31,
Craig,Lieutenant Governor,Dana Murphy,REP,180710,2,0,19,21,
Craig,Lieutenant Governor,Matt Pinnell,REP,180710,5,1,35,41,
Craig,State Auditor,Cindy Byrd,REP,180710,3,0,27,30,
Craig,State Auditor,Charlie Prater,REP,180710,4,1,27,32,
Craig,Attorney General,Mike Hunter,REP,180710,4,0,23,27,
Craig,Attorney General,Gentner Drummond,REP,180710,3,1,31,35,
Craig,Superintendent of Public Instruction,Joy Hofmeister,REP,180710,5,0,32,37,
Craig,Superintendent of Public Instruction,Linda Murphy,REP,180710,2,1,23,26,
Craig,Commissioner of Labor,Cathy Costello,REP,180710,3,0,30,33,
Craig,Commissioner of Labor,Leslie Osborn,REP,180710,4,1,24,29,
Craig,Corporation Commissioner,Bob Anthony,REP,180710,2,0,21,23,
Craig,Corporation Commissioner,Brian Bingman,REP,180710,5,1,33,39,
Craig,Governor,Chris Powell,LIB,180710,0,0,0,0,
Craig,Governor,Rex Lawhorn,LIB,180710,0,0,0,0,
Craig,Corporation Commissioner,Ashley Nicole Mccray,DEM,180710,4,0,18,22,
Craig,Corporation Commissioner,Blake Cummings,DEM,180710,2,0,21,23,
Craig,U.S. House,Jason Nichols,DEM,180710,2,0,21,23,02
Craig,U.S. House,Clay Padgett,DEM,180710,4,0,16,20,02
Craig,Governor,Mick Cornett,REP,180810,0,2,23,25,
Craig,Governor,Kevin Stitt,REP,180810,1,9,82,92,
Craig,Lieutenant Governor,Dana Murphy,REP,180810,0,6,31,37,
Craig,Lieutenant Governor,Matt Pinnell,REP,180810,1,5,73,79,
Craig,State Auditor,Cindy Byrd,REP,180810,0,5,45,50,
Craig,State Auditor,Charlie Prater,REP,180810,1,6,58,65,
Craig,Attorney General,Mike Hunter,REP,180810,1,3,54,58,
Craig,Attorney General,Gentner Drummond,REP,180810,0,8,50,58,
Craig,Superintendent of Public Instruction,Joy Hofmeister,REP,180810,0,4,54,58,
Craig,Superintendent of Public Instruction,Linda Murphy,REP,180810,1,7,47,55,
Craig,Commissioner of Labor,Cathy Costello,REP,180810,1,6,46,53,
Craig,Commissioner of Labor,Leslie Osborn,REP,180810,0,5,54,59,
Craig,Corporation Commissioner,Bob Anthony,REP,180810,0,5,49,54,
Craig,Corporation Commissioner,Brian Bingman,REP,180810,1,6,54,61,
Craig,Governor,Chris Powell,LIB,180810,0,0,0,0,
Craig,Governor,Rex Lawhorn,LIB,180810,0,0,0,0,
Craig,Corporation Commissioner,Ashley Nicole Mccray,DEM,180810,1,2,27,30,
Craig,Corporation Commissioner,Blake Cummings,DEM,180810,3,0,24,27,
Craig,U.S. House,Jason Nichols,DEM,180810,4,3,25,32,02
Craig,U.S. House,Clay Padgett,DEM,180810,0,1,26,27,02
Craig,Governor,Mick Cornett,REP,180820,1,2,37,40,
Craig,Governor,Kevin Stitt,REP,180820,2,2,57,61,
Craig,Lieutenant Governor,Dana Murphy,REP,180820,2,1,35,38,
Craig,Lieutenant Governor,Matt Pinnell,REP,180820,1,3,61,65,
Craig,State Auditor,Cindy Byrd,REP,180820,3,2,45,50,
Craig,State Auditor,Charlie Prater,REP,180820,0,2,46,48,
Craig,Attorney General,Mike Hunter,REP,180820,0,2,35,37,
Craig,Attorney General,Gentner Drummond,REP,180820,3,2,61,66,
Craig,Superintendent of Public Instruction,Joy Hofmeister,REP,180820,3,3,44,50,
Craig,Superintendent of Public Instruction,Linda Murphy,REP,180820,0,1,49,50,
Craig,Commissioner of Labor,Cathy Costello,REP,180820,0,4,42,46,
Craig,Commissioner of Labor,Leslie Osborn,REP,180820,3,0,47,50,
Craig,Corporation Commissioner,Bob Anthony,REP,180820,2,2,32,36,
Craig,Corporation Commissioner,Brian Bingman,REP,180820,0,2,60,62,
Craig,Governor,Chris Powell,LIB,180820,0,0,0,0,
Craig,Governor,Rex Lawhorn,LIB,180820,0,0,0,0,
Craig,Corporation Commissioner,Ashley Nicole Mccray,DEM,180820,0,1,28,29,
Craig,Corporation Commissioner,Blake Cummings,DEM,180820,0,1,28,29,
Craig,U.S. House,Jason Nichols,DEM,180820,0,1,38,39,02
Craig,U.S. House,Clay Padgett,DEM,180820,0,1,18,19,02
Craig,Governor,Mick Cornett,REP,180910,1,0,26,27,
Craig,Governor,Kevin Stitt,REP,180910,0,3,27,30,
Craig,Lieutenant Governor,Dana Murphy,REP,180910,0,3,18,21,
Craig,Lieutenant Governor,Matt Pinnell,REP,180910,1,0,32,33,
Craig,State Auditor,Cindy Byrd,REP,180910,1,2,19,22,
Craig,State Auditor,Charlie Prater,REP,180910,0,1,32,33,
Craig,Attorney General,Mike Hunter,REP,180910,0,2,23,25,
Craig,Attorney General,Gentner Drummond,REP,180910,1,1,29,31,
Craig,Superintendent of Public Instruction,Joy Hofmeister,REP,180910,0,2,28,30,
Craig,Superintendent of Public Instruction,Linda Murphy,REP,180910,1,1,23,25,
Craig,Commissioner of Labor,Cathy Costello,REP,180910,0,0,23,23,
Craig,Commissioner of Labor,Leslie Osborn,REP,180910,1,3,27,31,
Craig,Corporation Commissioner,Bob Anthony,REP,180910,1,1,20,22,
Craig,Corporation Commissioner,Brian Bingman,REP,180910,0,2,30,32,
Craig,Governor,Chris Powell,LIB,180910,0,0,0,0,
Craig,Governor,Rex Lawhorn,LIB,180910,0,0,0,0,
Craig,Corporation Commissioner,Ashley Nicole Mccray,DEM,180910,0,1,22,23,
Craig,Corporation Commissioner,Blake Cummings,DEM,180910,0,2,26,28,
Craig,U.S. House,Jason Nichols,DEM,180910,0,3,24,27,02
Craig,U.S. House,Clay Padgett,DEM,180910,0,0,24,24,02
Creek,Governor,Mick Cornett,REP,190111,1,8,47,56,
Creek,Governor,Kevin Stitt,REP,190111,1,7,131,139,
Creek,Lieutenant Governor,Dana Murphy,REP,190111,1,6,65,72,
Creek,Lieutenant Governor,Matt Pinnell,REP,190111,1,9,110,120,
Creek,State Auditor,Cindy Byrd,REP,190111,2,9,87,98,
Creek,State Auditor,Charlie Prater,REP,190111,0,6,82,88,
Creek,Attorney General,Mike Hunter,REP,190111,0,9,86,95,
Creek,Attorney General,Gentner Drummond,REP,190111,2,6,88,96,
Creek,Superintendent of Public Instruction,Joy Hofmeister,REP,190111,1,10,99,110,
Creek,Superintendent of Public Instruction,Linda Murphy,REP,190111,1,5,71,77,
Creek,Commissioner of Labor,Cathy Costello,REP,190111,2,2,74,78,
Creek,Commissioner of Labor,Leslie Osborn,REP,190111,0,13,96,109,
Creek,Corporation Commissioner,Bob Anthony,REP,190111,0,7,62,69,
Creek,Corporation Commissioner,Brian Bingman,REP,190111,2,8,112,122,
Creek,State House,Mark Lawson,REP,190111,1,5,106,112,30
Creek,State House,Kent Glesener,REP,190111,1,10,69,80,30
Creek,Governor,Chris Powell,LIB,190111,0,0,0,0,
Creek,Governor,Rex Lawhorn,LIB,190111,0,0,0,0,
Creek,Corporation Commissioner,Ashley Nicole Mccray,DEM,190111,2,4,21,27,
Creek,Corporation Commissioner,Blake Cummings,DEM,190111,0,0,18,18,
Creek,Governor,Mick Cornett,REP,190112,0,2,22,24,
Creek,Governor,Kevin Stitt,REP,190112,0,1,48,49,
Creek,Lieutenant Governor,Dana Murphy,REP,190112,0,1,32,33,
Creek,Lieutenant Governor,Matt Pinnell,REP,190112,0,2,38,40,
Creek,State Auditor,Cindy Byrd,REP,190112,0,3,38,41,
Creek,State Auditor,Charlie Prater,REP,190112,0,0,30,30,
Creek,Attorney General,Mike Hunter,REP,190112,0,1,33,34,
Creek,Attorney General,Gentner Drummond,REP,190112,0,2,37,39,
Creek,Superintendent of Public Instruction,Joy Hofmeister,REP,190112,0,2,34,36,
Creek,Superintendent of Public Instruction,Linda Murphy,REP,190112,0,1,35,36,
Creek,Commissioner of Labor,Cathy Costello,REP,190112,0,3,32,35,
Creek,Commissioner of Labor,Leslie Osborn,REP,190112,0,0,38,38,
Creek,Corporation Commissioner,Bob Anthony,REP,190112,0,2,25,27,
Creek,Corporation Commissioner,Brian Bingman,REP,190112,0,1,43,44,
Creek,State House,Mark Lawson,REP,190112,0,0,44,44,30
Creek,State House,Kent Glesener,REP,190112,0,3,25,28,30
Creek,Governor,Chris Powell,LIB,190112,0,0,0,0,
Creek,Governor,Rex Lawhorn,LIB,190112,0,0,1,1,
Creek,Corporation Commissioner,Ashley Nicole Mccray,DEM,190112,1,0,11,12,
Creek,Corporation Commissioner,Blake Cummings,DEM,190112,0,0,3,3,
Creek,Governor,Mick Cornett,REP,190121,2,14,83,99,
Creek,Governor,Kevin Stitt,REP,190121,6,20,173,199,
Creek,Lieutenant Governor,Dana Murphy,REP,190121,0,8,91,99,
Creek,Lieutenant Governor,Matt Pinnell,REP,190121,7,26,162,195,
Creek,State Auditor,Cindy Byrd,REP,190121,3,12,116,131,
Creek,State Auditor,Charlie Prater,REP,190121,2,22,130,154,
Creek,Attorney General,Mike Hunter,REP,190121,4,10,102,116,
Creek,Attorney General,Gentner Drummond,REP,190121,4,24,151,179,
Creek,Superintendent of Public Instruction,Joy Hofmeister,REP,190121,4,20,132,156,
Creek,Superintendent of Public Instruction,Linda Murphy,REP,190121,4,14,117,135,
Creek,Commissioner of Labor,Cathy Costello,REP,190121,6,8,114,128,
Creek,Commissioner of Labor,Leslie Osborn,REP,190121,2,26,137,165,
Creek,Corporation Commissioner,Bob Anthony,REP,190121,4,18,90,112,
Creek,Corporation Commissioner,Brian Bingman,REP,190121,3,16,163,182,
Creek,Governor,Chris Powell,LIB,190121,0,0,1,1,
Creek,Governor,Rex Lawhorn,LIB,190121,0,0,0,0,
Creek,Corporation Commissioner,Ashley Nicole Mccray,DEM,190121,6,1,20,27,
Creek,Corporation Commissioner,Blake Cummings,DEM,190121,1,1,16,18,
Creek,Governor,Mick Cornett,REP,190122,0,0,3,3,
Creek,Governor,Kevin Stitt,REP,190122,0,1,7,8,
Creek,Lieutenant Governor,Dana Murphy,REP,190122,0,1,5,6,
Creek,Lieutenant Governor,Matt Pinnell,REP,190122,0,0,5,5,
Creek,State Auditor,Cindy Byrd,REP,190122,0,0,5,5,
Creek,State Auditor,Charlie Prater,REP,190122,0,1,4,5,
Creek,Attorney General,Mike Hunter,REP,190122,0,1,5,6,
Creek,Attorney General,Gentner Drummond,REP,190122,0,0,5,5,
Creek,Superintendent of Public Instruction,Joy Hofmeister,REP,190122,0,0,6,6,
Creek,Superintendent of Public Instruction,Linda Murphy,REP,190122,0,1,4,5,
Creek,Commissioner of Labor,Cathy Costello,REP,190122,0,0,4,4,
Creek,Commissioner of Labor,Leslie Osborn,REP,190122,0,1,5,6,
Creek,Corporation Commissioner,Bob Anthony,REP,190122,0,0,2,2,
Creek,Corporation Commissioner,Brian Bingman,REP,190122,0,1,8,9,
Creek,State House,Mark Lawson,REP,190122,0,1,6,7,30
Creek,State House,Kent Glesener,REP,190122,0,0,3,3,30
Creek,Governor,Chris Powell,LIB,190122,0,0,0,0,
Creek,Governor,Rex Lawhorn,LIB,190122,0,0,0,0,
Creek,Corporation Commissioner,Ashley Nicole Mccray,DEM,190122,0,3,14,17,
Creek,Corporation Commissioner,Blake Cummings,DEM,190122,0,0,13,13,
Creek,Governor,Mick Cornett,REP,190131,0,3,25,28,
Creek,Governor,Kevin Stitt,REP,190131,1,5,80,86,
Creek,Lieutenant Governor,Dana Murphy,REP,190131,0,4,42,46,
Creek,Lieutenant Governor,Matt Pinnell,REP,190131,1,4,62,67,
Creek,State Auditor,Cindy Byrd,REP,190131,1,5,59,65,
Creek,State Auditor,Charlie Prater,REP,190131,0,3,43,46,
Creek,Attorney General,Mike Hunter,REP,190131,0,4,52,56,
Creek,Attorney General,Gentner Drummond,REP,190131,1,4,55,60,
Creek,Superintendent of Public Instruction,Joy Hofmeister,REP,190131,0,5,50,55,
Creek,Superintendent of Public Instruction,Linda Murphy,REP,190131,1,3,52,56,
Creek,Commissioner of Labor,Cathy Costello,REP,190131,1,1,42,44,
Creek,Commissioner of Labor,Leslie Osborn,REP,190131,0,6,57,63,
Creek,Corporation Commissioner,Bob Anthony,REP,190131,0,4,32,36,
Creek,Corporation Commissioner,Brian Bingman,REP,190131,1,4,70,75,
Creek,State House,Mark Lawson,REP,190131,1,7,72,80,30
Creek,State House,Kent Glesener,REP,190131,0,2,33,35,30
Creek,Governor,Chris Powell,LIB,190131,0,0,0,0,
Creek,Governor,Rex Lawhorn,LIB,190131,0,0,0,0,
Creek,Corporation Commissioner,Ashley Nicole Mccray,DEM,190131,4,6,22,32,
Creek,Corporation Commissioner,Blake Cummings,DEM,190131,0,0,12,12,
Creek,Governor,Mick Cornett,REP,190132,2,9,61,72,
Creek,Governor,Kevin Stitt,REP,190132,10,13,151,174,
Creek,Lieutenant Governor,Dana Murphy,REP,190132,6,11,87,104,
Creek,Lieutenant Governor,Matt Pinnell,REP,190132,6,11,123,140,
Creek,State Auditor,Cindy Byrd,REP,190132,7,9,106,122,
Creek,State Auditor,Charlie Prater,REP,190132,4,13,98,115,
Creek,Attorney General,Mike Hunter,REP,190132,7,12,84,103,
Creek,Attorney General,Gentner Drummond,REP,190132,5,10,126,141,
Creek,Superintendent of Public Instruction,Joy Hofmeister,REP,190132,5,13,111,129,
Creek,Superintendent of Public Instruction,Linda Murphy,REP,190132,6,9,96,111,
Creek,Commissioner of Labor,Cathy Costello,REP,190132,6,14,104,124,
Creek,Commissioner of Labor,Leslie Osborn,REP,190132,6,9,102,117,
Creek,Corporation Commissioner,Bob Anthony,REP,190132,0,9,60,69,
Creek,Corporation Commissioner,Brian Bingman,REP,190132,12,14,147,173,
Creek,State House,Mark Lawson,REP,190132,9,13,107,129,30
Creek,State House,Kent Glesener,REP,190132,3,10,103,116,30
Creek,Governor,Chris Powell,LIB,190132,0,0,0,0,
Creek,Governor,Rex Lawhorn,LIB,190132,0,0,0,0,
Creek,Corporation Commissioner,Ashley Nicole Mccray,DEM,190132,8,1,16,25,
Creek,Corporation Commissioner,Blake Cummings,DEM,190132,3,0,14,17,
Creek,Governor,Mick Cornett,REP,190142,7,49,152,208,
Creek,Governor,Kevin Stitt,REP,190142,12,39,274,325,
Creek,Lieutenant Governor,Dana Murphy,REP,190142,12,42,189,243,
Creek,Lieutenant Governor,Matt Pinnell,REP,190142,7,44,228,279,
Creek,State Auditor,Cindy Byrd,REP,190142,11,49,220,280,
Creek,State Auditor,Charlie Prater,REP,190142,9,34,187,230,
Creek,Attorney General,Mike Hunter,REP,190142,5,47,179,231,
Creek,Attorney General,Gentner Drummond,REP,190142,14,41,234,289,
Creek,Superintendent of Public Instruction,Joy Hofmeister,REP,190142,9,67,243,319,
Creek,Superintendent of Public Instruction,Linda Murphy,REP,190142,11,20,173,204,
Creek,Commissioner of Labor,Cathy Costello,REP,190142,8,38,200,246,
Creek,Commissioner of Labor,Leslie Osborn,REP,190142,12,45,213,270,
Creek,Corporation Commissioner,Bob Anthony,REP,190142,12,29,123,164,
Creek,Corporation Commissioner,Brian Bingman,REP,190142,8,59,299,366,
Creek,State House,Mark Lawson,REP,190142,9,70,272,351,30
Creek,State House,Kent Glesener,REP,190142,11,17,155,183,30
Creek,Governor,Chris Powell,LIB,190142,0,0,0,0,
Creek,Governor,Rex Lawhorn,LIB,190142,0,0,0,0,
Creek,Corporation Commissioner,Ashley Nicole Mccray,DEM,190142,5,17,54,76,
Creek,Corporation Commissioner,Blake Cummings,DEM,190142,1,9,44,54,
Creek,Governor,Mick Cornett,REP,190143,1,12,44,57,
Creek,Governor,Kevin Stitt,REP,190143,5,17,102,124,
Creek,Lieutenant Governor,Dana Murphy,REP,190143,1,3,46,50,
Creek,Lieutenant Governor,Matt Pinnell,REP,190143,5,24,93,122,
Creek,State Auditor,Cindy Byrd,REP,190143,3,17,75,95,
Creek,State Auditor,Charlie Prater,REP,190143,3,10,60,73,
Creek,Attorney General,Mike Hunter,REP,190143,3,15,55,73,
Creek,Attorney General,Gentner Drummond,REP,190143,3,13,86,102,
Creek,Superintendent of Public Instruction,Joy Hofmeister,REP,190143,1,18,75,94,
Creek,Superintendent of Public Instruction,Linda Murphy,REP,190143,3,10,66,79,
Creek,Commissioner of Labor,Cathy Costello,REP,190143,3,14,69,86,
Creek,Commissioner of Labor,Leslie Osborn,REP,190143,3,13,67,83,
Creek,Corporation Commissioner,Bob Anthony,REP,190143,3,17,54,74,
Creek,Corporation Commissioner,Brian Bingman,REP,190143,3,12,86,101,
Creek,State House,Mark Lawson,REP,190143,4,17,83,104,30
Creek,State House,Kent Glesener,REP,190143,2,12,59,73,30
Creek,Governor,Chris Powell,LIB,190143,0,0,0,0,
Creek,Governor,Rex Lawhorn,LIB,190143,0,0,0,0,
Creek,Corporation Commissioner,Ashley Nicole Mccray,DEM,190143,2,2,39,43,
Creek,Corporation Commissioner,Blake Cummings,DEM,190143,0,5,24,29,
Creek,Governor,Mick Cornett,REP,190211,0,0,19,19,
Creek,Governor,Kevin Stitt,REP,190211,0,0,45,45,
Creek,Lieutenant Governor,Dana Murphy,REP,190211,0,0,18,18,
Creek,Lieutenant Governor,Matt Pinnell,REP,190211,0,0,45,45,
Creek,State Auditor,Cindy Byrd,REP,190211,0,0,27,27,
Creek,State Auditor,Charlie Prater,REP,190211,0,0,32,32,
Creek,Attorney General,Mike Hunter,REP,190211,0,0,28,28,
Creek,Attorney General,Gentner Drummond,REP,190211,0,0,36,36,
Creek,Superintendent of Public Instruction,Joy Hofmeister,REP,190211,0,0,38,38,
Creek,Superintendent of Public Instruction,Linda Murphy,REP,190211,0,0,24,24,
Creek,Commissioner of Labor,Cathy Costello,REP,190211,0,0,23,23,
Creek,Commissioner of Labor,Leslie Osborn,REP,190211,0,0,39,39,
Creek,Corporation Commissioner,Bob Anthony,REP,190211,0,0,18,18,
Creek,Corporation Commissioner,Brian Bingman,REP,190211,0,0,44,44,
Creek,Governor,Chris Powell,LIB,190211,0,0,0,0,
Creek,Governor,Rex Lawhorn,LIB,190211,0,0,0,0,
Creek,Corporation Commissioner,Ashley Nicole Mccray,DEM,190211,2,0,15,17,
Creek,Corporation Commissioner,Blake Cummings,DEM,190211,0,0,17,17,
Creek,Governor,Mick Cornett,REP,190221,1,0,13,14,
Creek,Governor,Kevin Stitt,REP,190221,0,0,34,34,
Creek,Lieutenant Governor,Dana Murphy,REP,190221,0,0,17,17,
Creek,Lieutenant Governor,Matt Pinnell,REP,190221,1,0,30,31,
Creek,State Auditor,Cindy Byrd,REP,190221,0,0,25,25,
Creek,State Auditor,Charlie Prater,REP,190221,1,0,22,23,
Creek,Attorney General,Mike Hunter,REP,190221,0,0,21,21,
Creek,Attorney General,Gentner Drummond,REP,190221,1,0,26,27,
Creek,Superintendent of Public Instruction,Joy Hofmeister,REP,190221,0,0,30,30,
Creek,Superintendent of Public Instruction,Linda Murphy,REP,190221,1,0,16,17,
Creek,Commissioner of Labor,Cathy Costello,REP,190221,0,0,18,18,
Creek,Commissioner of Labor,Leslie Osborn,REP,190221,1,0,28,29,
Creek,Corporation Commissioner,Bob Anthony,REP,190221,1,0,19,20,
Creek,Corporation Commissioner,Brian Bingman,REP,190221,0,0,27,27,
Creek,Governor,Chris Powell,LIB,190221,0,0,0,0,
Creek,Governor,Rex Lawhorn,LIB,190221,0,0,0,0,
Creek,Corporation Commissioner,Ashley Nicole Mccray,DEM,190221,0,0,13,13,
Creek,Corporation Commissioner,Blake Cummings,DEM,190221,0,0,12,12,
Creek,Governor,Mick Cornett,REP,190231,1,1,25,27,
Creek,Governor,Kevin Stitt,REP,190231,0,2,42,44,
Creek,Lieutenant Governor,Dana Murphy,REP,190231,0,0,31,31,
Creek,Lieutenant Governor,Matt Pinnell,REP,190231,1,3,37,41,
Creek,State Auditor,Cindy Byrd,REP,190231,0,2,26,28,
Creek,State Auditor,Charlie Prater,REP,190231,1,1,41,43,
Creek,Attorney General,Mike Hunter,REP,190231,0,3,30,33,
Creek,Attorney General,Gentner Drummond,REP,190231,1,0,38,39,
Creek,Superintendent of Public Instruction,Joy Hofmeister,REP,190231,1,0,41,42,
Creek,Superintendent of Public Instruction,Linda Murphy,REP,190231,0,3,26,29,
Creek,Commissioner of Labor,Cathy Costello,REP,190231,0,2,33,35,
Creek,Commissioner of Labor,Leslie Osborn,REP,190231,1,1,33,35,
Creek,Corporation Commissioner,Bob Anthony,REP,190231,1,2,19,22,
Creek,Corporation Commissioner,Brian Bingman,REP,190231,0,1,49,50,
Creek,Governor,Chris Powell,LIB,190231,0,0,0,0,
Creek,Governor,Rex Lawhorn,LIB,190231,0,0,0,0,
Creek,Corporation Commissioner,Ashley Nicole Mccray,DEM,190231,2,0,14,16,
Creek,Corporation Commissioner,Blake Cummings,DEM,190231,0,0,18,18,
Creek,Governor,Mick Cornett,REP,190241,1,2,39,42,
Creek,Governor,Kevin Stitt,REP,190241,4,3,62,69,
Creek,Lieutenant Governor,Dana Murphy,REP,190241,2,3,34,39,
Creek,Lieutenant Governor,Matt Pinnell,REP,190241,3,2,67,72,
Creek,State Auditor,Cindy Byrd,REP,190241,2,4,39,45,
Creek,State Auditor,Charlie Prater,REP,190241,3,1,60,64,
Creek,Attorney General,Mike Hunter,REP,190241,4,1,51,56,
Creek,Attorney General,Gentner Drummond,REP,190241,1,4,51,56,
Creek,Superintendent of Public Instruction,Joy Hofmeister,REP,190241,4,5,71,80,
Creek,Superintendent of Public Instruction,Linda Murphy,REP,190241,1,0,31,32,
Creek,Commissioner of Labor,Cathy Costello,REP,190241,5,3,47,55,
Creek,Commissioner of Labor,Leslie Osborn,REP,190241,0,2,52,54,
Creek,Corporation Commissioner,Bob Anthony,REP,190241,2,3,32,37,
Creek,Corporation Commissioner,Brian Bingman,REP,190241,3,2,69,74,
Creek,Governor,Chris Powell,LIB,190241,0,0,0,0,
Creek,Governor,Rex Lawhorn,LIB,190241,0,0,0,0,
Creek,Corporation Commissioner,Ashley Nicole Mccray,DEM,190241,1,0,19,20,
Creek,Corporation Commissioner,Blake Cummings,DEM,190241,0,0,15,15,
Creek,Governor,Mick Cornett,REP,190311,0,1,58,59,
Creek,Governor,Kevin Stitt,REP,190311,2,1,73,76,
Creek,Lieutenant Governor,Dana Murphy,REP,190311,1,2,56,59,
Creek,Lieutenant Governor,Matt Pinnell,REP,190311,1,0,75,76,
Creek,State Auditor,Cindy Byrd,REP,190311,1,2,47,50,
Creek,State Auditor,Charlie Prater,REP,190311,1,0,80,81,
Creek,Attorney General,Mike Hunter,REP,190311,0,1,50,51,
Creek,Attorney General,Gentner Drummond,REP,190311,2,1,81,84,
Creek,Superintendent of Public Instruction,Joy Hofmeister,REP,190311,2,0,65,67,
Creek,Superintendent of Public Instruction,Linda Murphy,REP,190311,0,2,64,66,
Creek,Commissioner of Labor,Cathy Costello,REP,190311,2,2,67,71,
Creek,Commissioner of Labor,Leslie Osborn,REP,190311,0,0,61,61,
Creek,Corporation Commissioner,Bob Anthony,REP,190311,0,1,46,47,
Creek,Corporation Commissioner,Brian Bingman,REP,190311,2,1,84,87,
Creek,Governor,Chris Powell,LIB,190311,0,0,2,2,
Creek,Governor,Rex Lawhorn,LIB,190311,0,0,0,0,
Creek,Corporation Commissioner,Ashley Nicole Mccray,DEM,190311,7,0,19,26,
Creek,Corporation Commissioner,Blake Cummings,DEM,190311,2,0,23,25,
Creek,Governor,Mick Cornett,REP,190401,4,9,49,62,
Creek,Governor,Kevin Stitt,REP,190401,0,20,110,130,
Creek,Lieutenant Governor,Dana Murphy,REP,190401,1,18,71,90,
Creek,Lieutenant Governor,Matt Pinnell,REP,190401,3,11,84,98,
Creek,State Auditor,Cindy Byrd,REP,190401,1,16,68,85,
Creek,State Auditor,Charlie Prater,REP,190401,3,12,84,99,
Creek,Attorney General,Mike Hunter,REP,190401,2,12,53,67,
Creek,Attorney General,Gentner Drummond,REP,190401,2,17,104,123,
Creek,Superintendent of Public Instruction,Joy Hofmeister,REP,190401,1,17,71,89,
Creek,Superintendent of Public Instruction,Linda Murphy,REP,190401,3,12,88,103,
Creek,Commissioner of Labor,Cathy Costello,REP,190401,3,15,74,92,
Creek,Commissioner of Labor,Leslie Osborn,REP,190401,1,14,78,93,
Creek,Corporation Commissioner,Bob Anthony,REP,190401,1,13,68,82,
Creek,Corporation Commissioner,Brian Bingman,REP,190401,3,15,89,107,
Creek,Governor,Chris Powell,LIB,190401,0,0,0,0,
Creek,Governor,Rex Lawhorn,LIB,190401,1,0,0,1,
Creek,Corporation Commissioner,Ashley Nicole Mccray,DEM,190401,0,2,23,25,
Creek,Corporation Commissioner,Blake Cummings,DEM,190401,0,0,20,20,
Creek,Governor,Mick Cornett,REP,190402,2,8,46,56,
Creek,Governor,Kevin Stitt,REP,190402,3,20,126,149,
Creek,Lieutenant Governor,Dana Murphy,REP,190402,0,11,71,82,
Creek,Lieutenant Governor,Matt Pinnell,REP,190402,4,17,97,118,
Creek,State Auditor,Cindy Byrd,REP,190402,2,15,95,112,
Creek,State Auditor,Charlie Prater,REP,190402,2,11,67,80,
Creek,Attorney General,Mike Hunter,REP,190402,2,15,74,91,
Creek,Attorney General,Gentner Drummond,REP,190402,2,13,97,112,
Creek,Superintendent of Public Instruction,Joy Hofmeister,REP,190402,3,14,93,110,
Creek,Superintendent of Public Instruction,Linda Murphy,REP,190402,2,13,74,89,
Creek,Commissioner of Labor,Cathy Costello,REP,190402,0,11,100,111,
Creek,Commissioner of Labor,Leslie Osborn,REP,190402,4,16,67,87,
Creek,Corporation Commissioner,Bob Anthony,REP,190402,1,13,56,70,
Creek,Corporation Commissioner,Brian Bingman,REP,190402,4,15,115,134,
Creek,Governor,Chris Powell,LIB,190402,0,0,0,0,
Creek,Governor,Rex Lawhorn,LIB,190402,0,0,1,1,
Creek,Corporation Commissioner,Ashley Nicole Mccray,DEM,190402,0,6,15,21,
Creek,Corporation Commissioner,Blake Cummings,DEM,190402,1,1,13,15,
Creek,Governor,Mick Cornett,REP,190403,3,0,46,49,
Creek,Governor,Kevin Stitt,REP,190403,1,8,157,166,
Creek,Lieutenant Governor,Dana Murphy,REP,190403,2,2,78,82,
Creek,Lieutenant Governor,Matt Pinnell,REP,190403,2,6,124,132,
Creek,State Auditor,Cindy Byrd,REP,190403,3,3,89,95,
Creek,State Auditor,Charlie Prater,REP,190403,1,5,110,116,
Creek,Attorney General,Mike Hunter,REP,190403,3,2,81,86,
Creek,Attorney General,Gentner Drummond,REP,190403,1,6,121,128,
Creek,Superintendent of Public Instruction,Joy Hofmeister,REP,190403,3,3,101,107,
Creek,Superintendent of Public Instruction,Linda Murphy,REP,190403,1,5,102,108,
Creek,Commissioner of Labor,Cathy Costello,REP,190403,3,5,87,95,
Creek,Commissioner of Labor,Leslie Osborn,REP,190403,1,3,111,115,
Creek,Corporation Commissioner,Bob Anthony,REP,190403,3,1,70,74,
Creek,Corporation Commissioner,Brian Bingman,REP,190403,0,7,132,139,
Creek,Governor,Chris Powell,LIB,190403,0,0,0,0,
Creek,Governor,Rex Lawhorn,LIB,190403,0,0,0,0,
Creek,Corporation Commissioner,Ashley Nicole Mccray,DEM,190403,4,3,35,42,
Creek,Corporation Commissioner,Blake Cummings,DEM,190403,1,1,6,8,
Creek,Governor,Mick Cornett,REP,190404,5,3,126,134,
Creek,Governor,Kevin Stitt,REP,190404,11,6,241,258,
Creek,Lieutenant Governor,Dana Murphy,REP,190404,7,6,159,172,
Creek,Lieutenant Governor,Matt Pinnell,REP,190404,10,6,202,218,
Creek,State Auditor,Cindy Byrd,REP,190404,9,8,170,187,
Creek,State Auditor,Charlie Prater,REP,190404,7,4,182,193,
Creek,Attorney General,Mike Hunter,REP,190404,9,8,153,170,
Creek,Attorney General,Gentner Drummond,REP,190404,8,4,210,222,
Creek,Superintendent of Public Instruction,Joy Hofmeister,REP,190404,6,7,188,201,
Creek,Superintendent of Public Instruction,Linda Murphy,REP,190404,10,4,175,189,
Creek,Commissioner of Labor,Cathy Costello,REP,190404,10,4,150,164,
Creek,Commissioner of Labor,Leslie Osborn,REP,190404,7,8,204,219,
Creek,Corporation Commissioner,Bob Anthony,REP,190404,5,9,159,173,
Creek,Corporation Commissioner,Brian Bingman,REP,190404,12,3,201,216,
Creek,Governor,Chris Powell,LIB,190404,0,0,0,0,
Creek,Governor,Rex Lawhorn,LIB,190404,0,0,0,0,
Creek,Corporation Commissioner,Ashley Nicole Mccray,DEM,190404,3,3,54,60,
Creek,Corporation Commissioner,Blake Cummings,DEM,190404,0,1,25,26,
Creek,Governor,Mick Cornett,REP,190405,2,9,51,62,
Creek,Governor,Kevin Stitt,REP,190405,7,14,135,156,
Creek,Lieutenant Governor,Dana Murphy,REP,190405,2,9,65,76,
Creek,Lieutenant Governor,Matt Pinnell,REP,190405,7,13,118,138,
Creek,State Auditor,Cindy Byrd,REP,190405,3,17,77,97,
Creek,State Auditor,Charlie Prater,REP,190405,6,6,103,115,
Creek,Attorney General,Mike Hunter,REP,190405,2,13,64,79,
Creek,Attorney General,Gentner Drummond,REP,190405,7,10,119,136,
Creek,Superintendent of Public Instruction,Joy Hofmeister,REP,190405,8,11,105,124,
Creek,Superintendent of Public Instruction,Linda Murphy,REP,190405,1,12,76,89,
Creek,Commissioner of Labor,Cathy Costello,REP,190405,2,9,97,108,
Creek,Commissioner of Labor,Leslie Osborn,REP,190405,7,14,84,105,
Creek,Corporation Commissioner,Bob Anthony,REP,190405,5,11,82,98,
Creek,Corporation Commissioner,Brian Bingman,REP,190405,4,12,99,115,
Creek,Governor,Chris Powell,LIB,190405,0,0,2,2,
Creek,Governor,Rex Lawhorn,LIB,190405,0,0,0,0,
Creek,Corporation Commissioner,Ashley Nicole Mccray,DEM,190405,1,1,13,15,
Creek,Corporation Commissioner,Blake Cummings,DEM,190405,0,0,8,8,
Creek,Governor,Mick Cornett,REP,190406,1,0,38,39,
Creek,Governor,Kevin Stitt,REP,190406,1,3,86,90,
Creek,Lieutenant Governor,Dana Murphy,REP,190406,1,1,34,36,
Creek,Lieutenant Governor,Matt Pinnell,REP,190406,1,2,90,93,
Creek,State Auditor,Cindy Byrd,REP,190406,2,1,56,59,
Creek,State Auditor,Charlie Prater,REP,190406,0,2,67,69,
Creek,Attorney General,Mike Hunter,REP,190406,0,1,39,40,
Creek,Attorney General,Gentner Drummond,REP,190406,2,2,85,89,
Creek,Superintendent of Public Instruction,Joy Hofmeister,REP,190406,1,0,58,59,
Creek,Superintendent of Public Instruction,Linda Murphy,REP,190406,1,3,65,69,
Creek,Commissioner of Labor,Cathy Costello,REP,190406,2,2,58,62,
Creek,Commissioner of Labor,Leslie Osborn,REP,190406,0,1,63,64,
Creek,Corporation Commissioner,Bob Anthony,REP,190406,1,2,58,61,
Creek,Corporation Commissioner,Brian Bingman,REP,190406,1,1,66,68,
Creek,Governor,Chris Powell,LIB,190406,0,0,0,0,
Creek,Governor,Rex Lawhorn,LIB,190406,0,0,0,0,
Creek,Corporation Commissioner,Ashley Nicole Mccray,DEM,190406,2,0,20,22,
Creek,Corporation Commissioner,Blake Cummings,DEM,190406,0,0,22,22,
Creek,Governor,Mick Cornett,REP,190407,0,0,22,22,
Creek,Governor,Kevin Stitt,REP,190407,1,2,59,62,
Creek,Lieutenant Governor,Dana Murphy,REP,190407,0,0,29,29,
Creek,Lieutenant Governor,Matt Pinnell,REP,190407,1,2,45,48,
Creek,State Auditor,Cindy Byrd,REP,190407,0,1,27,28,
Creek,State Auditor,Charlie Prater,REP,190407,1,1,43,45,
Creek,Attorney General,Mike Hunter,REP,190407,0,1,30,31,
Creek,Attorney General,Gentner Drummond,REP,190407,1,1,47,49,
Creek,Superintendent of Public Instruction,Joy Hofmeister,REP,190407,1,2,34,37,
Creek,Superintendent of Public Instruction,Linda Murphy,REP,190407,0,0,42,42,
Creek,Commissioner of Labor,Cathy Costello,REP,190407,0,0,28,28,
Creek,Commissioner of Labor,Leslie Osborn,REP,190407,1,2,46,49,
Creek,Corporation Commissioner,Bob Anthony,REP,190407,0,1,24,25,
Creek,Corporation Commissioner,Brian Bingman,REP,190407,1,1,53,55,
Creek,Governor,Chris Powell,LIB,190407,0,0,0,0,
Creek,Governor,Rex Lawhorn,LIB,190407,0,0,0,0,
Creek,Corporation Commissioner,Ashley Nicole Mccray,DEM,190407,0,0,16,16,
Creek,Corporation Commissioner,Blake Cummings,DEM,190407,0,0,5,5,
Creek,Governor,Mick Cornett,REP,190408,1,1,27,29,
Creek,Governor,Kevin Stitt,REP,190408,1,1,72,74,
Creek,Lieutenant Governor,Dana Murphy,REP,190408,0,2,32,34,
Creek,Lieutenant Governor,Matt Pinnell,REP,190408,2,0,66,68,
Creek,State Auditor,Cindy Byrd,REP,190408,1,1,40,42,
Creek,State Auditor,Charlie Prater,REP,190408,0,1,53,54,
Creek,Attorney General,Mike Hunter,REP,190408,1,0,27,28,
Creek,Attorney General,Gentner Drummond,REP,190408,1,2,71,74,
Creek,Superintendent of Public Instruction,Joy Hofmeister,REP,190408,0,1,50,51,
Creek,Superintendent of Public Instruction,Linda Murphy,REP,190408,2,1,47,50,
Creek,Commissioner of Labor,Cathy Costello,REP,190408,0,2,38,40,
Creek,Commissioner of Labor,Leslie Osborn,REP,190408,1,0,57,58,
Creek,Corporation Commissioner,Bob Anthony,REP,190408,1,1,41,43,
Creek,Corporation Commissioner,Brian Bingman,REP,190408,1,1,53,55,
Creek,Governor,Chris Powell,LIB,190408,0,0,0,0,
Creek,Governor,Rex Lawhorn,LIB,190408,0,0,0,0,
Creek,Corporation Commissioner,Ashley Nicole Mccray,DEM,190408,0,0,17,17,
Creek,Corporation Commissioner,Blake Cummings,DEM,190408,0,0,10,10,
Creek,Governor,Mick Cornett,REP,190409,2,1,61,64,
Creek,Governor,Kevin Stitt,REP,190409,0,6,148,154,
Creek,Lieutenant Governor,Dana Murphy,REP,190409,2,3,85,90,
Creek,Lieutenant Governor,Matt Pinnell,REP,190409,0,4,122,126,
Creek,State Auditor,Cindy Byrd,REP,190409,0,3,84,87,
Creek,State Auditor,Charlie Prater,REP,190409,2,4,118,124,
Creek,Attorney General,Mike Hunter,REP,190409,2,2,76,80,
Creek,Attorney General,Gentner Drummond,REP,190409,0,5,133,138,
Creek,Superintendent of Public Instruction,Joy Hofmeister,REP,190409,2,3,122,127,
Creek,Superintendent of Public Instruction,Linda Murphy,REP,190409,0,4,86,90,
Creek,Commissioner of Labor,Cathy Costello,REP,190409,2,3,93,98,
Creek,Commissioner of Labor,Leslie Osborn,REP,190409,0,4,115,119,
Creek,Corporation Commissioner,Bob Anthony,REP,190409,2,1,73,76,
Creek,Corporation Commissioner,Brian Bingman,REP,190409,0,6,134,140,
Creek,Governor,Chris Powell,LIB,190409,0,0,0,0,
Creek,Governor,Rex Lawhorn,LIB,190409,0,0,0,0,
Creek,Corporation Commissioner,Ashley Nicole Mccray,DEM,190409,0,1,17,18,
Creek,Corporation Commissioner,Blake Cummings,DEM,190409,0,1,21,22,
Creek,Governor,Mick Cornett,REP,190410,0,0,24,24,
Creek,Governor,Kevin Stitt,REP,190410,1,0,31,32,
Creek,Lieutenant Governor,Dana Murphy,REP,190410,0,0,16,16,
Creek,Lieutenant Governor,Matt Pinnell,REP,190410,1,0,38,39,
Creek,State Auditor,Cindy Byrd,REP,190410,1,0,15,16,
Creek,State Auditor,Charlie Prater,REP,190410,0,0,37,37,
Creek,Attorney General,Mike Hunter,REP,190410,1,0,25,26,
Creek,Attorney General,Gentner Drummond,REP,190410,0,0,30,30,
Creek,Superintendent of Public Instruction,Joy Hofmeister,REP,190410,0,0,30,30,
Creek,Superintendent of Public Instruction,Linda Murphy,REP,190410,1,0,24,25,
Creek,Commissioner of Labor,Cathy Costello,REP,190410,1,0,18,19,
Creek,Commissioner of Labor,Leslie Osborn,REP,190410,0,0,35,35,
Creek,Corporation Commissioner,Bob Anthony,REP,190410,1,0,25,26,
Creek,Corporation Commissioner,Brian Bingman,REP,190410,0,0,29,29,
Creek,Governor,Chris Powell,LIB,190410,0,0,0,0,
Creek,Governor,Rex Lawhorn,LIB,190410,0,0,0,0,
Creek,Corporation Commissioner,Ashley Nicole Mccray,DEM,190410,0,0,7,7,
Creek,Corporation Commissioner,Blake Cummings,DEM,190410,0,0,9,9,
Creek,Governor,Mick Cornett,REP,190411,0,2,34,36,
Creek,Governor,Kevin Stitt,REP,190411,0,1,77,78,
Creek,Lieutenant Governor,Dana Murphy,REP,190411,0,1,33,34,
Creek,Lieutenant Governor,Matt Pinnell,REP,190411,0,2,79,81,
Creek,State Auditor,Cindy Byrd,REP,190411,0,2,61,63,
Creek,State Auditor,Charlie Prater,REP,190411,0,1,47,48,
Creek,Attorney General,Mike Hunter,REP,190411,0,2,59,61,
Creek,Attorney General,Gentner Drummond,REP,190411,0,1,53,54,
Creek,Superintendent of Public Instruction,Joy Hofmeister,REP,190411,0,2,49,51,
Creek,Superintendent of Public Instruction,Linda Murphy,REP,190411,0,1,62,63,
Creek,Commissioner of Labor,Cathy Costello,REP,190411,0,1,43,44,
Creek,Commissioner of Labor,Leslie Osborn,REP,190411,0,1,68,69,
Creek,Corporation Commissioner,Bob Anthony,REP,190411,0,0,45,45,
Creek,Corporation Commissioner,Brian Bingman,REP,190411,0,2,67,69,
Creek,Governor,Chris Powell,LIB,190411,0,0,0,0,
Creek,Governor,Rex Lawhorn,LIB,190411,0,0,0,0,
Creek,Corporation Commissioner,Ashley Nicole Mccray,DEM,190411,0,0,19,19,
Creek,Corporation Commissioner,Blake Cummings,DEM,190411,0,0,16,16,
Creek,Governor,Mick Cornett,REP,190412,1,0,36,37,
Creek,Governor,Kevin Stitt,REP,190412,2,1,80,83,
Creek,Lieutenant Governor,Dana Murphy,REP,190412,1,1,34,36,
Creek,Lieutenant Governor,Matt Pinnell,REP,190412,2,0,78,80,
Creek,State Auditor,Cindy Byrd,REP,190412,2,1,51,54,
Creek,State Auditor,Charlie Prater,REP,190412,1,0,58,59,
Creek,Attorney General,Mike Hunter,REP,190412,1,1,48,50,
Creek,Attorney General,Gentner Drummond,REP,190412,2,0,66,68,
Creek,Superintendent of Public Instruction,Joy Hofmeister,REP,190412,1,1,63,65,
Creek,Superintendent of Public Instruction,Linda Murphy,REP,190412,2,0,49,51,
Creek,Commissioner of Labor,Cathy Costello,REP,190412,1,1,52,54,
Creek,Commissioner of Labor,Leslie Osborn,REP,190412,2,0,56,58,
Creek,Corporation Commissioner,Bob Anthony,REP,190412,1,0,44,45,
Creek,Corporation Commissioner,Brian Bingman,REP,190412,2,1,66,69,
Creek,Governor,Chris Powell,LIB,190412,0,0,0,0,
Creek,Governor,Rex Lawhorn,LIB,190412,0,0,0,0,
Creek,Corporation Commissioner,Ashley Nicole Mccray,DEM,190412,0,0,14,14,
Creek,Corporation Commissioner,Blake Cummings,DEM,190412,0,0,16,16,
Creek,Governor,Mick Cornett,REP,190413,0,1,58,59,
Creek,Governor,Kevin Stitt,REP,190413,0,4,141,145,
Creek,Lieutenant Governor,Dana Murphy,REP,190413,0,0,78,78,
Creek,Lieutenant Governor,Matt Pinnell,REP,190413,0,5,119,124,
Creek,State Auditor,Cindy Byrd,REP,190413,0,2,87,89,
Creek,State Auditor,Charlie Prater,REP,190413,0,3,106,109,
Creek,Attorney General,Mike Hunter,REP,190413,0,3,100,103,
Creek,Attorney General,Gentner Drummond,REP,190413,0,2,98,100,
Creek,Superintendent of Public Instruction,Joy Hofmeister,REP,190413,0,1,119,120,
Creek,Superintendent of Public Instruction,Linda Murphy,REP,190413,0,3,78,81,
Creek,Commissioner of Labor,Cathy Costello,REP,190413,0,2,78,80,
Creek,Commissioner of Labor,Leslie Osborn,REP,190413,0,3,114,117,
Creek,Corporation Commissioner,Bob Anthony,REP,190413,0,0,70,70,
Creek,Corporation Commissioner,Brian Bingman,REP,190413,0,5,125,130,
Creek,Governor,Chris Powell,LIB,190413,0,0,0,0,
Creek,Governor,Rex Lawhorn,LIB,190413,0,0,0,0,
Creek,Corporation Commissioner,Ashley Nicole Mccray,DEM,190413,0,1,26,27,
Creek,Corporation Commissioner,Blake Cummings,DEM,190413,0,0,18,18,
Creek,Governor,Mick Cornett,REP,190414,7,21,101,129,
Creek,Governor,Kevin Stitt,REP,190414,3,43,279,325,
Creek,Lieutenant Governor,Dana Murphy,REP,190414,7,26,172,205,
Creek,Lieutenant Governor,Matt Pinnell,REP,190414,3,36,202,241,
Creek,State Auditor,Cindy Byrd,REP,190414,6,33,189,228,
Creek,State Auditor,Charlie Prater,REP,190414,4,28,180,212,
Creek,Attorney General,Mike Hunter,REP,190414,3,19,154,176,
Creek,Attorney General,Gentner Drummond,REP,190414,7,43,221,271,
Creek,Superintendent of Public Instruction,Joy Hofmeister,REP,190414,2,32,200,234,
Creek,Superintendent of Public Instruction,Linda Murphy,REP,190414,8,30,174,212,
Creek,Commissioner of Labor,Cathy Costello,REP,190414,5,32,181,218,
Creek,Commissioner of Labor,Leslie Osborn,REP,190414,5,31,192,228,
Creek,Corporation Commissioner,Bob Anthony,REP,190414,8,35,151,194,
Creek,Corporation Commissioner,Brian Bingman,REP,190414,2,29,228,259,
Creek,Governor,Chris Powell,LIB,190414,0,0,1,1,
Creek,Governor,Rex Lawhorn,LIB,190414,0,0,0,0,
Creek,Corporation Commissioner,Ashley Nicole Mccray,DEM,190414,4,3,35,42,
Creek,Corporation Commissioner,Blake Cummings,DEM,190414,1,1,41,43,
Creek,Governor,Mick Cornett,REP,190415,2,0,33,35,
Creek,Governor,Kevin Stitt,REP,190415,0,3,78,81,
Creek,Lieutenant Governor,Dana Murphy,REP,190415,1,2,49,52,
Creek,Lieutenant Governor,Matt Pinnell,REP,190415,1,1,59,61,
Creek,State Auditor,Cindy Byrd,REP,190415,2,3,59,64,
Creek,State Auditor,Charlie Prater,REP,190415,1,0,45,46,
Creek,Attorney General,Mike Hunter,REP,190415,1,2,46,49,
Creek,Attorney General,Gentner Drummond,REP,190415,2,1,61,64,
Creek,Superintendent of Public Instruction,Joy Hofmeister,REP,190415,1,1,53,55,
Creek,Superintendent of Public Instruction,Linda Murphy,REP,190415,2,2,55,59,
Creek,Commissioner of Labor,Cathy Costello,REP,190415,1,2,50,53,
Creek,Commissioner of Labor,Leslie Osborn,REP,190415,2,1,56,59,
Creek,Corporation Commissioner,Bob Anthony,REP,190415,1,0,50,51,
Creek,Corporation Commissioner,Brian Bingman,REP,190415,2,3,57,62,
Creek,U.S. House,Tim Harris,REP,190415,1,2,37,40,01
Creek,U.S. House,Kevin Hern,REP,190415,2,1,73,76,01
Creek,Governor,Chris Powell,LIB,190415,0,0,0,0,
Creek,Governor,Rex Lawhorn,LIB,190415,0,0,0,0,
Creek,Corporation Commissioner,Ashley Nicole Mccray,DEM,190415,0,0,15,15,
Creek,Corporation Commissioner,Blake Cummings,DEM,190415,0,0,7,7,
Creek,U.S. House,Tim Gilpin,DEM,190415,0,0,8,8,01
Creek,U.S. House,Amanda Douglas,DEM,190415,0,0,14,14,01
Creek,Governor,Mick Cornett,REP,190416,0,8,51,59,
Creek,Governor,Kevin Stitt,REP,190416,3,9,162,174,
Creek,Lieutenant Governor,Dana Murphy,REP,190416,2,8,74,84,
Creek,Lieutenant Governor,Matt Pinnell,REP,190416,1,9,135,145,
Creek,State Auditor,Cindy Byrd,REP,190416,3,9,99,111,
Creek,State Auditor,Charlie Prater,REP,190416,0,8,102,110,
Creek,Attorney General,Mike Hunter,REP,190416,2,8,86,96,
Creek,Attorney General,Gentner Drummond,REP,190416,1,9,119,129,
Creek,Superintendent of Public Instruction,Joy Hofmeister,REP,190416,3,10,102,115,
Creek,Superintendent of Public Instruction,Linda Murphy,REP,190416,0,7,99,106,
Creek,Commissioner of Labor,Cathy Costello,REP,190416,1,13,114,128,
Creek,Commissioner of Labor,Leslie Osborn,REP,190416,2,4,90,96,
Creek,Corporation Commissioner,Bob Anthony,REP,190416,1,7,80,88,
Creek,Corporation Commissioner,Brian Bingman,REP,190416,2,10,125,137,
Creek,U.S. House,Tim Harris,REP,190416,3,8,81,92,01
Creek,U.S. House,Kevin Hern,REP,190416,0,9,130,139,01
Creek,State House,Mark Lawson,REP,190416,2,5,94,101,30
Creek,State House,Kent Glesener,REP,190416,1,12,117,130,30
Creek,Governor,Chris Powell,LIB,190416,0,0,0,0,
Creek,Governor,Rex Lawhorn,LIB,190416,0,0,0,0,
Creek,Corporation Commissioner,Ashley Nicole Mccray,DEM,190416,1,1,36,38,
Creek,Corporation Commissioner,Blake Cummings,DEM,190416,0,0,29,29,
Creek,U.S. House,Tim Gilpin,DEM,190416,1,0,30,31,01
Creek,U.S. House,Amanda Douglas,DEM,190416,0,1,35,36,01
Creek,Governor,Mick Cornett,REP,190417,2,21,126,149,
Creek,Governor,Kevin Stitt,REP,190417,13,27,332,372,
Creek,Lieutenant Governor,Dana Murphy,REP,190417,1,25,157,183,
Creek,Lieutenant Governor,Matt Pinnell,REP,190417,13,23,291,327,
Creek,State Auditor,Cindy Byrd,REP,190417,7,28,218,253,
Creek,State Auditor,Charlie Prater,REP,190417,7,18,217,242,
Creek,Attorney General,Mike Hunter,REP,190417,9,25,206,240,
Creek,Attorney General,Gentner Drummond,REP,190417,6,22,244,272,
Creek,Superintendent of Public Instruction,Joy Hofmeister,REP,190417,3,24,257,284,
Creek,Superintendent of Public Instruction,Linda Murphy,REP,190417,12,23,193,228,
Creek,Commissioner of Labor,Cathy Costello,REP,190417,7,22,204,233,
Creek,Commissioner of Labor,Leslie Osborn,REP,190417,8,24,231,263,
Creek,Corporation Commissioner,Bob Anthony,REP,190417,5,18,171,194,
Creek,Corporation Commissioner,Brian Bingman,REP,190417,10,30,273,313,
Creek,U.S. House,Tim Harris,REP,190417,5,14,127,146,01
Creek,U.S. House,Kevin Hern,REP,190417,10,33,323,366,01
Creek,State House,Mark Lawson,REP,190417,8,24,237,269,30
Creek,State House,Kent Glesener,REP,190417,7,25,215,247,30
Creek,Governor,Chris Powell,LIB,190417,0,0,0,0,
Creek,Governor,Rex Lawhorn,LIB,190417,0,0,0,0,
Creek,Corporation Commissioner,Ashley Nicole Mccray,DEM,190417,0,3,59,62,
Creek,Corporation Commissioner,Blake Cummings,DEM,190417,0,4,19,23,
Creek,U.S. House,Tim Gilpin,DEM,190417,0,6,46,52,01
Creek,U.S. House,Amanda Douglas,DEM,190417,0,1,32,33,01
Creek,Governor,Mick Cornett,REP,190418,0,18,107,125,
Creek,Governor,Kevin Stitt,REP,190418,10,36,237,283,
Creek,Lieutenant Governor,Dana Murphy,REP,190418,4,22,138,164,
Creek,Lieutenant Governor,Matt Pinnell,REP,190418,6,32,201,239,
Creek,State Auditor,Cindy Byrd,REP,190418,5,35,159,199,
Creek,State Auditor,Charlie Prater,REP,190418,5,17,165,187,
Creek,Attorney General,Mike Hunter,REP,190418,5,27,152,184,
Creek,Attorney General,Gentner Drummond,REP,190418,4,27,183,214,
Creek,Superintendent of Public Instruction,Joy Hofmeister,REP,190418,6,28,191,225,
Creek,Superintendent of Public Instruction,Linda Murphy,REP,190418,4,25,144,173,
Creek,Commissioner of Labor,Cathy Costello,REP,190418,6,31,186,223,
Creek,Commissioner of Labor,Leslie Osborn,REP,190418,4,20,141,165,
Creek,Corporation Commissioner,Bob Anthony,REP,190418,5,16,115,136,
Creek,Corporation Commissioner,Brian Bingman,REP,190418,5,36,221,262,
Creek,State House,Mark Lawson,REP,190418,4,31,202,237,30
Creek,State House,Kent Glesener,REP,190418,6,22,137,165,30
Creek,Governor,Chris Powell,LIB,190418,0,0,0,0,
Creek,Governor,Rex Lawhorn,LIB,190418,0,0,0,0,
Creek,Corporation Commissioner,Ashley Nicole Mccray,DEM,190418,1,2,35,38,
Creek,Corporation Commissioner,Blake Cummings,DEM,190418,2,1,22,25,
Creek,Governor,Mick Cornett,REP,190419,4,7,75,86,
Creek,Governor,Kevin Stitt,REP,190419,6,15,204,225,
Creek,Lieutenant Governor,Dana Murphy,REP,190419,2,11,92,105,
Creek,Lieutenant Governor,Matt Pinnell,REP,190419,8,11,181,200,
Creek,State Auditor,Cindy Byrd,REP,190419,6,14,129,149,
Creek,State Auditor,Charlie Prater,REP,190419,4,5,134,143,
Creek,Attorney General,Mike Hunter,REP,190419,8,6,104,118,
Creek,Attorney General,Gentner Drummond,REP,190419,2,16,171,189,
Creek,Superintendent of Public Instruction,Joy Hofmeister,REP,190419,2,8,161,171,
Creek,Superintendent of Public Instruction,Linda Murphy,REP,190419,8,14,110,132,
Creek,Commissioner of Labor,Cathy Costello,REP,190419,5,10,124,139,
Creek,Commissioner of Labor,Leslie Osborn,REP,190419,5,11,143,159,
Creek,Corporation Commissioner,Bob Anthony,REP,190419,5,16,111,132,
Creek,Corporation Commissioner,Brian Bingman,REP,190419,5,6,160,171,
Creek,State House,Mark Lawson,REP,190419,2,7,118,127,30
Creek,State House,Kent Glesener,REP,190419,8,15,152,175,30
Creek,Governor,Chris Powell,LIB,190419,0,0,1,1,
Creek,Governor,Rex Lawhorn,LIB,190419,0,0,0,0,
Creek,Corporation Commissioner,Ashley Nicole Mccray,DEM,190419,1,0,27,28,
Creek,Corporation Commissioner,Blake Cummings,DEM,190419,0,3,25,28,
Creek,Governor,Mick Cornett,REP,190420,3,1,75,79,
Creek,Governor,Kevin Stitt,REP,190420,0,2,117,119,
Creek,Lieutenant Governor,Dana Murphy,REP,190420,0,1,71,72,
Creek,Lieutenant Governor,Matt Pinnell,REP,190420,3,2,115,120,
Creek,State Auditor,Cindy Byrd,REP,190420,3,2,101,106,
Creek,State Auditor,Charlie Prater,REP,190420,0,1,80,81,
Creek,Attorney General,Mike Hunter,REP,190420,0,2,75,77,
Creek,Attorney General,Gentner Drummond,REP,190420,3,1,114,118,
Creek,Superintendent of Public Instruction,Joy Hofmeister,REP,190420,2,1,126,129,
Creek,Superintendent of Public Instruction,Linda Murphy,REP,190420,1,2,63,66,
Creek,Commissioner of Labor,Cathy Costello,REP,190420,1,0,87,88,
Creek,Commissioner of Labor,Leslie Osborn,REP,190420,2,3,96,101,
Creek,Corporation Commissioner,Bob Anthony,REP,190420,2,1,90,93,
Creek,Corporation Commissioner,Brian Bingman,REP,190420,1,2,93,96,
Creek,State House,Lonnie Sims,REP,190420,1,3,106,110,68
Creek,State House,Nicole Nixon,REP,190420,2,0,78,80,68
Creek,Governor,Chris Powell,LIB,190420,0,0,0,0,
Creek,Governor,Rex Lawhorn,LIB,190420,0,0,2,2,
Creek,Corporation Commissioner,Ashley Nicole Mccray,DEM,190420,1,0,31,32,
Creek,Corporation Commissioner,Blake Cummings,DEM,190420,0,0,12,12,
Creek,State House,Angela Statum,DEM,190420,1,0,22,23,68
Creek,State House,Michael Ross,DEM,190420,0,0,21,21,68
Creek,Governor,Mick Cornett,REP,190421,8,4,104,116,
Creek,Governor,Kevin Stitt,REP,190421,7,6,166,179,
Creek,Lieutenant Governor,Dana Murphy,REP,190421,8,5,103,116,
Creek,Lieutenant Governor,Matt Pinnell,REP,190421,6,5,163,174,
Creek,State Auditor,Cindy Byrd,REP,190421,9,5,151,165,
Creek,State Auditor,Charlie Prater,REP,190421,4,5,103,112,
Creek,Attorney General,Mike Hunter,REP,190421,7,5,124,136,
Creek,Attorney General,Gentner Drummond,REP,190421,7,5,142,154,
Creek,Superintendent of Public Instruction,Joy Hofmeister,REP,190421,10,5,171,186,
Creek,Superintendent of Public Instruction,Linda Murphy,REP,190421,4,5,95,104,
Creek,Commissioner of Labor,Cathy Costello,REP,190421,5,6,108,119,
Creek,Commissioner of Labor,Leslie Osborn,REP,190421,8,4,144,156,
Creek,Corporation Commissioner,Bob Anthony,REP,190421,8,3,123,134,
Creek,Corporation Commissioner,Brian Bingman,REP,190421,5,7,137,149,
Creek,State House,Mark Lawson,REP,190421,8,5,127,140,30
Creek,State House,Kent Glesener,REP,190421,6,5,131,142,30
Creek,Governor,Chris Powell,LIB,190421,0,0,0,0,
Creek,Governor,Rex Lawhorn,LIB,190421,0,0,0,0,
Creek,Corporation Commissioner,Ashley Nicole Mccray,DEM,190421,1,1,42,44,
Creek,Corporation Commissioner,Blake Cummings,DEM,190421,0,1,19,20,
Creek,Governor,Mick Cornett,REP,190422,0,0,28,28,
Creek,Governor,Kevin Stitt,REP,190422,12,3,96,111,
Creek,Lieutenant Governor,Dana Murphy,REP,190422,4,0,45,49,
Creek,Lieutenant Governor,Matt Pinnell,REP,190422,8,2,78,88,
Creek,State Auditor,Cindy Byrd,REP,190422,5,1,61,67,
Creek,State Auditor,Charlie Prater,REP,190422,7,2,61,70,
Creek,Attorney General,Mike Hunter,REP,190422,8,0,54,62,
Creek,Attorney General,Gentner Drummond,REP,190422,4,2,71,77,
Creek,Superintendent of Public Instruction,Joy Hofmeister,REP,190422,4,0,65,69,
Creek,Superintendent of Public Instruction,Linda Murphy,REP,190422,8,1,58,67,
Creek,Commissioner of Labor,Cathy Costello,REP,190422,6,1,40,47,
Creek,Commissioner of Labor,Leslie Osborn,REP,190422,6,1,83,90,
Creek,Corporation Commissioner,Bob Anthony,REP,190422,2,1,53,56,
Creek,Corporation Commissioner,Brian Bingman,REP,190422,10,1,69,80,
Creek,Governor,Chris Powell,LIB,190422,0,0,0,0,
Creek,Governor,Rex Lawhorn,LIB,190422,0,0,0,0,
Creek,Corporation Commissioner,Ashley Nicole Mccray,DEM,190422,1,0,20,21,
Creek,Corporation Commissioner,Blake Cummings,DEM,190422,0,1,12,13,
Custer,Governor,Mick Cornett,REP,200001,0,2,49,51,
Custer,Governor,Kevin Stitt,REP,200001,2,3,34,39,
Custer,Lieutenant Governor,Dana Murphy,REP,200001,1,2,31,34,
Custer,Lieutenant Governor,Matt Pinnell,REP,200001,1,3,53,57,
Custer,State Auditor,Cindy Byrd,REP,200001,1,5,39,45,
Custer,State Auditor,Charlie Prater,REP,200001,1,0,45,46,
Custer,Attorney General,Mike Hunter,REP,200001,1,0,44,45,
Custer,Attorney General,Gentner Drummond,REP,200001,1,5,40,46,
Custer,Superintendent of Public Instruction,Joy Hofmeister,REP,200001,1,2,34,37,
Custer,Superintendent of Public Instruction,Linda Murphy,REP,200001,1,3,49,53,
Custer,Commissioner of Labor,Cathy Costello,REP,200001,2,1,32,35,
Custer,Commissioner of Labor,Leslie Osborn,REP,200001,0,4,52,56,
Custer,Corporation Commissioner,Bob Anthony,REP,200001,1,3,47,51,
Custer,Corporation Commissioner,Brian Bingman,REP,200001,1,2,37,40,
Custer,Governor,Chris Powell,LIB,200001,0,0,0,0,
Custer,Governor,Rex Lawhorn,LIB,200001,0,0,0,0,
Custer,Corporation Commissioner,Ashley Nicole Mccray,DEM,200001,1,2,11,14,
Custer,Corporation Commissioner,Blake Cummings,DEM,200001,1,1,9,11,
Custer,Governor,Mick Cornett,REP,200003,2,10,102,114,
Custer,Governor,Kevin Stitt,REP,200003,2,5,72,79,
Custer,Lieutenant Governor,Dana Murphy,REP,200003,4,6,82,92,
Custer,Lieutenant Governor,Matt Pinnell,REP,200003,0,9,89,98,
Custer,State Auditor,Cindy Byrd,REP,200003,4,4,75,83,
Custer,State Auditor,Charlie Prater,REP,200003,0,11,95,106,
Custer,Attorney General,Mike Hunter,REP,200003,4,8,79,91,
Custer,Attorney General,Gentner Drummond,REP,200003,0,6,90,96,
Custer,Superintendent of Public Instruction,Joy Hofmeister,REP,200003,4,12,101,117,
Custer,Superintendent of Public Instruction,Linda Murphy,REP,200003,0,2,71,73,
Custer,Commissioner of Labor,Cathy Costello,REP,200003,0,8,66,74,
Custer,Commissioner of Labor,Leslie Osborn,REP,200003,4,7,103,114,
Custer,Corporation Commissioner,Bob Anthony,REP,200003,4,9,91,104,
Custer,Corporation Commissioner,Brian Bingman,REP,200003,0,6,78,84,
Custer,Governor,Chris Powell,LIB,200003,0,0,1,1,
Custer,Governor,Rex Lawhorn,LIB,200003,0,0,0,0,
Custer,Corporation Commissioner,Ashley Nicole Mccray,DEM,200003,2,0,32,34,
Custer,Corporation Commissioner,Blake Cummings,DEM,200003,2,0,20,22,
Custer,Governor,Mick Cornett,REP,200005,5,7,111,123,
Custer,Governor,Kevin Stitt,REP,200005,3,3,54,60,
Custer,Lieutenant Governor,Dana Murphy,REP,200005,5,5,77,87,
Custer,Lieutenant Governor,Matt Pinnell,REP,200005,3,5,86,94,
Custer,State Auditor,Cindy Byrd,REP,200005,5,5,73,83,
Custer,State Auditor,Charlie Prater,REP,200005,2,5,84,91,
Custer,Attorney General,Mike Hunter,REP,200005,5,5,91,101,
Custer,Attorney General,Gentner Drummond,REP,200005,2,5,72,79,
Custer,Superintendent of Public Instruction,Joy Hofmeister,REP,200005,4,4,99,107,
Custer,Superintendent of Public Instruction,Linda Murphy,REP,200005,4,6,63,73,
Custer,Commissioner of Labor,Cathy Costello,REP,200005,4,2,66,72,
Custer,Commissioner of Labor,Leslie Osborn,REP,200005,3,8,94,105,
Custer,Corporation Commissioner,Bob Anthony,REP,200005,2,2,86,90,
Custer,Corporation Commissioner,Brian Bingman,REP,200005,5,8,76,89,
Custer,Governor,Chris Powell,LIB,200005,0,0,0,0,
Custer,Governor,Rex Lawhorn,LIB,200005,0,0,0,0,
Custer,Corporation Commissioner,Ashley Nicole Mccray,DEM,200005,3,2,30,35,
Custer,Corporation Commissioner,Blake Cummings,DEM,200005,0,2,25,27,
Custer,Governor,Mick Cornett,REP,200007,7,2,56,65,
Custer,Governor,Kevin Stitt,REP,200007,3,0,38,41,
Custer,Lieutenant Governor,Dana Murphy,REP,200007,4,2,53,59,
Custer,Lieutenant Governor,Matt Pinnell,REP,200007,6,0,38,44,
Custer,State Auditor,Cindy Byrd,REP,200007,7,2,51,60,
Custer,State Auditor,Charlie Prater,REP,200007,3,0,42,45,
Custer,Attorney General,Mike Hunter,REP,200007,7,1,54,62,
Custer,Attorney General,Gentner Drummond,REP,200007,3,1,41,45,
Custer,Superintendent of Public Instruction,Joy Hofmeister,REP,200007,6,1,52,59,
Custer,Superintendent of Public Instruction,Linda Murphy,REP,200007,4,1,41,46,
Custer,Commissioner of Labor,Cathy Costello,REP,200007,6,2,40,48,
Custer,Commissioner of Labor,Leslie Osborn,REP,200007,4,0,53,57,
Custer,Corporation Commissioner,Bob Anthony,REP,200007,5,1,48,54,
Custer,Corporation Commissioner,Brian Bingman,REP,200007,5,1,46,52,
Custer,Governor,Chris Powell,LIB,200007,0,0,0,0,
Custer,Governor,Rex Lawhorn,LIB,200007,0,0,0,0,
Custer,Corporation Commissioner,Ashley Nicole Mccray,DEM,200007,2,1,13,16,
Custer,Corporation Commissioner,Blake Cummings,DEM,200007,0,0,19,19,
Custer,Governor,Mick Cornett,REP,200012,1,6,56,63,
Custer,Governor,Kevin Stitt,REP,200012,3,8,54,65,
Custer,Lieutenant Governor,Dana Murphy,REP,200012,2,9,53,64,
Custer,Lieutenant Governor,Matt Pinnell,REP,200012,2,5,56,63,
Custer,State Auditor,Cindy Byrd,REP,200012,1,7,46,54,
Custer,State Auditor,Charlie Prater,REP,200012,3,6,61,70,
Custer,Attorney General,Mike Hunter,REP,200012,3,9,54,66,
Custer,Attorney General,Gentner Drummond,REP,200012,1,5,56,62,
Custer,Superintendent of Public Instruction,Joy Hofmeister,REP,200012,3,12,54,69,
Custer,Superintendent of Public Instruction,Linda Murphy,REP,200012,1,2,56,59,
Custer,Commissioner of Labor,Cathy Costello,REP,200012,4,7,59,70,
Custer,Commissioner of Labor,Leslie Osborn,REP,200012,0,7,51,58,
Custer,Corporation Commissioner,Bob Anthony,REP,200012,4,7,54,65,
Custer,Corporation Commissioner,Brian Bingman,REP,200012,0,7,54,61,
Custer,Governor,Chris Powell,LIB,200012,0,0,0,0,
Custer,Governor,Rex Lawhorn,LIB,200012,0,0,0,0,
Custer,Corporation Commissioner,Ashley Nicole Mccray,DEM,200012,0,2,12,14,
Custer,Corporation Commissioner,Blake Cummings,DEM,200012,1,2,23,26,
Custer,Governor,Mick Cornett,REP,200013,1,4,44,49,
Custer,Governor,Kevin Stitt,REP,200013,2,7,58,67,
Custer,Lieutenant Governor,Dana Murphy,REP,200013,3,6,53,62,
Custer,Lieutenant Governor,Matt Pinnell,REP,200013,0,4,48,52,
Custer,State Auditor,Cindy Byrd,REP,200013,3,5,47,55,
Custer,State Auditor,Charlie Prater,REP,200013,0,5,52,57,
Custer,Attorney General,Mike Hunter,REP,200013,3,3,55,61,
Custer,Attorney General,Gentner Drummond,REP,200013,0,8,45,53,
Custer,Superintendent of Public Instruction,Joy Hofmeister,REP,200013,1,4,43,48,
Custer,Superintendent of Public Instruction,Linda Murphy,REP,200013,2,6,56,64,
Custer,Commissioner of Labor,Cathy Costello,REP,200013,0,6,44,50,
Custer,Commissioner of Labor,Leslie Osborn,REP,200013,3,5,55,63,
Custer,Corporation Commissioner,Bob Anthony,REP,200013,3,8,64,75,
Custer,Corporation Commissioner,Brian Bingman,REP,200013,0,3,37,40,
Custer,Governor,Chris Powell,LIB,200013,0,0,0,0,
Custer,Governor,Rex Lawhorn,LIB,200013,0,0,0,0,
Custer,Corporation Commissioner,Ashley Nicole Mccray,DEM,200013,1,1,34,36,
Custer,Corporation Commissioner,Blake Cummings,DEM,200013,1,2,39,42,
Custer,Governor,Mick Cornett,REP,200018,6,6,197,209,
Custer,Governor,Kevin Stitt,REP,200018,6,8,191,205,
Custer,Lieutenant Governor,Dana Murphy,REP,200018,5,5,185,195,
Custer,Lieutenant Governor,Matt Pinnell,REP,200018,7,9,193,209,
Custer,State Auditor,Cindy Byrd,REP,200018,8,7,223,238,
Custer,State Auditor,Charlie Prater,REP,200018,4,7,153,164,
Custer,Attorney General,Mike Hunter,REP,200018,7,7,223,237,
Custer,Attorney General,Gentner Drummond,REP,200018,5,7,155,167,
Custer,Superintendent of Public Instruction,Joy Hofmeister,REP,200018,8,7,241,256,
Custer,Superintendent of Public Instruction,Linda Murphy,REP,200018,4,7,141,152,
Custer,Commissioner of Labor,Cathy Costello,REP,200018,5,5,172,182,
Custer,Commissioner of Labor,Leslie Osborn,REP,200018,7,9,204,220,
Custer,Corporation Commissioner,Bob Anthony,REP,200018,9,4,210,223,
Custer,Corporation Commissioner,Brian Bingman,REP,200018,3,9,169,181,
Custer,Governor,Chris Powell,LIB,200018,0,0,0,0,
Custer,Governor,Rex Lawhorn,LIB,200018,0,0,0,0,
Custer,Corporation Commissioner,Ashley Nicole Mccray,DEM,200018,7,0,84,91,
Custer,Corporation Commissioner,Blake Cummings,DEM,200018,1,0,80,81,
Custer,Governor,Mick Cornett,REP,200019,13,6,192,211,
Custer,Governor,Kevin Stitt,REP,200019,8,6,162,176,
Custer,Lieutenant Governor,Dana Murphy,REP,200019,8,7,179,194,
Custer,Lieutenant Governor,Matt Pinnell,REP,200019,13,7,165,185,
Custer,State Auditor,Cindy Byrd,REP,200019,16,10,211,237,
Custer,State Auditor,Charlie Prater,REP,200019,4,4,132,140,
Custer,Attorney General,Mike Hunter,REP,200019,10,8,203,221,
Custer,Attorney General,Gentner Drummond,REP,200019,10,6,143,159,
Custer,Superintendent of Public Instruction,Joy Hofmeister,REP,200019,17,7,213,237,
Custer,Superintendent of Public Instruction,Linda Murphy,REP,200019,4,6,137,147,
Custer,Commissioner of Labor,Cathy Costello,REP,200019,8,7,164,179,
Custer,Commissioner of Labor,Leslie Osborn,REP,200019,12,7,181,200,
Custer,Corporation Commissioner,Bob Anthony,REP,200019,13,11,207,231,
Custer,Corporation Commissioner,Brian Bingman,REP,200019,8,3,139,150,
Custer,Governor,Chris Powell,LIB,200019,0,0,1,1,
Custer,Governor,Rex Lawhorn,LIB,200019,0,0,2,2,
Custer,Corporation Commissioner,Ashley Nicole Mccray,DEM,200019,3,0,88,91,
Custer,Corporation Commissioner,Blake Cummings,DEM,200019,0,0,67,67,
Custer,Governor,Mick Cornett,REP,200020,8,8,256,272,
Custer,Governor,Kevin Stitt,REP,200020,1,10,241,252,
Custer,Lieutenant Governor,Dana Murphy,REP,200020,6,2,257,265,
Custer,Lieutenant Governor,Matt Pinnell,REP,200020,3,16,231,250,
Custer,State Auditor,Cindy Byrd,REP,200020,6,11,291,308,
Custer,State Auditor,Charlie Prater,REP,200020,3,6,180,189,
Custer,Attorney General,Mike Hunter,REP,200020,2,14,305,321,
Custer,Attorney General,Gentner Drummond,REP,200020,7,4,175,186,
Custer,Superintendent of Public Instruction,Joy Hofmeister,REP,200020,5,6,306,317,
Custer,Superintendent of Public Instruction,Linda Murphy,REP,200020,4,11,178,193,
Custer,Commissioner of Labor,Cathy Costello,REP,200020,3,8,209,220,
Custer,Commissioner of Labor,Leslie Osborn,REP,200020,6,9,265,280,
Custer,Corporation Commissioner,Bob Anthony,REP,200020,6,10,279,295,
Custer,Corporation Commissioner,Brian Bingman,REP,200020,3,8,198,209,
Custer,Governor,Chris Powell,LIB,200020,0,0,0,0,
Custer,Governor,Rex Lawhorn,LIB,200020,0,0,0,0,
Custer,Corporation Commissioner,Ashley Nicole Mccray,DEM,200020,4,4,111,119,
Custer,Corporation Commissioner,Blake Cummings,DEM,200020,2,2,79,83,
Custer,Governor,Mick Cornett,REP,200021,4,1,118,123,
Custer,Governor,Kevin Stitt,REP,200021,1,0,104,105,
Custer,Lieutenant Governor,Dana Murphy,REP,200021,3,0,111,114,
Custer,Lieutenant Governor,Matt Pinnell,REP,200021,2,1,104,107,
Custer,State Auditor,Cindy Byrd,REP,200021,4,1,147,152,
Custer,State Auditor,Charlie Prater,REP,200021,1,0,68,69,
Custer,Attorney General,Mike Hunter,REP,200021,2,1,119,122,
Custer,Attorney General,Gentner Drummond,REP,200021,3,0,94,97,
Custer,Superintendent of Public Instruction,Joy Hofmeister,REP,200021,5,1,120,126,
Custer,Superintendent of Public Instruction,Linda Murphy,REP,200021,0,0,97,97,
Custer,Commissioner of Labor,Cathy Costello,REP,200021,4,0,122,126,
Custer,Commissioner of Labor,Leslie Osborn,REP,200021,1,1,93,95,
Custer,Corporation Commissioner,Bob Anthony,REP,200021,4,0,116,120,
Custer,Corporation Commissioner,Brian Bingman,REP,200021,1,1,97,99,
Custer,Governor,Chris Powell,LIB,200021,0,0,0,0,
Custer,Governor,Rex Lawhorn,LIB,200021,0,0,0,0,
Custer,Corporation Commissioner,Ashley Nicole Mccray,DEM,200021,3,2,76,81,
Custer,Corporation Commissioner,Blake Cummings,DEM,200021,2,0,44,46,
Custer,Governor,Mick Cornett,REP,200022,2,2,55,59,
Custer,Governor,Kevin Stitt,REP,200022,3,2,70,75,
Custer,Lieutenant Governor,Dana Murphy,REP,200022,2,3,59,64,
Custer,Lieutenant Governor,Matt Pinnell,REP,200022,2,1,63,66,
Custer,State Auditor,Cindy Byrd,REP,200022,0,4,62,66,
Custer,State Auditor,Charlie Prater,REP,200022,4,0,60,64,
Custer,Attorney General,Mike Hunter,REP,200022,1,2,63,66,
Custer,Attorney General,Gentner Drummond,REP,200022,4,2,60,66,
Custer,Superintendent of Public Instruction,Joy Hofmeister,REP,200022,2,2,66,70,
Custer,Superintendent of Public Instruction,Linda Murphy,REP,200022,2,2,59,63,
Custer,Commissioner of Labor,Cathy Costello,REP,200022,3,1,46,50,
Custer,Commissioner of Labor,Leslie Osborn,REP,200022,1,3,75,79,
Custer,Corporation Commissioner,Bob Anthony,REP,200022,2,4,56,62,
Custer,Corporation Commissioner,Brian Bingman,REP,200022,3,0,67,70,
Custer,Governor,Chris Powell,LIB,200022,0,0,0,0,
Custer,Governor,Rex Lawhorn,LIB,200022,0,0,0,0,
Custer,Corporation Commissioner,Ashley Nicole Mccray,DEM,200022,0,1,14,15,
Custer,Corporation Commissioner,Blake Cummings,DEM,200022,1,0,18,19,
Custer,Governor,Mick Cornett,REP,200023,8,7,208,223,
Custer,Governor,Kevin Stitt,REP,200023,7,12,183,202,
Custer,Lieutenant Governor,Dana Murphy,REP,200023,11,12,183,206,
Custer,Lieutenant Governor,Matt Pinnell,REP,200023,4,6,193,203,
Custer,State Auditor,Cindy Byrd,REP,200023,10,8,169,187,
Custer,State Auditor,Charlie Prater,REP,200023,5,10,203,218,
Custer,Attorney General,Mike Hunter,REP,200023,10,11,200,221,
Custer,Attorney General,Gentner Drummond,REP,200023,5,7,180,192,
Custer,Superintendent of Public Instruction,Joy Hofmeister,REP,200023,9,8,174,191,
Custer,Superintendent of Public Instruction,Linda Murphy,REP,200023,6,10,201,217,
Custer,Commissioner of Labor,Cathy Costello,REP,200023,6,8,175,189,
Custer,Commissioner of Labor,Leslie Osborn,REP,200023,9,10,193,212,
Custer,Corporation Commissioner,Bob Anthony,REP,200023,12,9,189,210,
Custer,Corporation Commissioner,Brian Bingman,REP,200023,3,9,182,194,
Custer,Governor,Chris Powell,LIB,200023,0,0,0,0,
Custer,Governor,Rex Lawhorn,LIB,200023,0,0,0,0,
Custer,Corporation Commissioner,Ashley Nicole Mccray,DEM,200023,3,4,58,65,
Custer,Corporation Commissioner,Blake Cummings,DEM,200023,1,4,98,103,
Custer,Governor,Mick Cornett,REP,200026,1,2,49,52,
Custer,Governor,Kevin Stitt,REP,200026,2,5,92,99,
Custer,Lieutenant Governor,Dana Murphy,REP,200026,2,2,71,75,
Custer,Lieutenant Governor,Matt Pinnell,REP,200026,1,5,68,74,
Custer,State Auditor,Cindy Byrd,REP,200026,2,2,60,64,
Custer,State Auditor,Charlie Prater,REP,200026,1,5,79,85,
Custer,Attorney General,Mike Hunter,REP,200026,1,1,75,77,
Custer,Attorney General,Gentner Drummond,REP,200026,2,6,66,74,
Custer,Superintendent of Public Instruction,Joy Hofmeister,REP,200026,1,4,72,77,
Custer,Superintendent of Public Instruction,Linda Murphy,REP,200026,2,3,69,74,
Custer,Commissioner of Labor,Cathy Costello,REP,200026,0,5,72,77,
Custer,Commissioner of Labor,Leslie Osborn,REP,200026,3,2,69,74,
Custer,Corporation Commissioner,Bob Anthony,REP,200026,1,6,76,83,
Custer,Corporation Commissioner,Brian Bingman,REP,200026,2,1,62,65,
Custer,Governor,Chris Powell,LIB,200026,0,0,0,0,
Custer,Governor,Rex Lawhorn,LIB,200026,0,0,0,0,
Custer,Corporation Commissioner,Ashley Nicole Mccray,DEM,200026,2,0,13,15,
Custer,Corporation Commissioner,Blake Cummings,DEM,200026,0,0,16,16,
Delaware,Governor,Mick Cornett,REP,210001,6,0,135,141,
Delaware,Governor,Kevin Stitt,REP,210001,4,0,135,139,
Delaware,Lieutenant Governor,Dana Murphy,REP,210001,5,0,105,110,
Delaware,Lieutenant Governor,Matt Pinnell,REP,210001,5,0,162,167,
Delaware,State Auditor,Cindy Byrd,REP,210001,5,0,129,134,
Delaware,State Auditor,Charlie Prater,REP,210001,4,0,135,139,
Delaware,Attorney General,Mike Hunter,REP,210001,6,0,96,102,
Delaware,Attorney General,Gentner Drummond,REP,210001,4,0,173,177,
Delaware,Superintendent of Public Instruction,Joy Hofmeister,REP,210001,3,0,164,167,
Delaware,Superintendent of Public Instruction,Linda Murphy,REP,210001,7,0,101,108,
Delaware,Commissioner of Labor,Cathy Costello,REP,210001,5,0,112,117,
Delaware,Commissioner of Labor,Leslie Osborn,REP,210001,4,0,153,157,
Delaware,Corporation Commissioner,Bob Anthony,REP,210001,6,0,113,119,
Delaware,Corporation Commissioner,Brian Bingman,REP,210001,4,0,150,154,
Delaware,Governor,Chris Powell,LIB,210001,0,0,0,0,
Delaware,Governor,Rex Lawhorn,LIB,210001,0,0,0,0,
Delaware,Corporation Commissioner,Ashley Nicole Mccray,DEM,210001,5,1,24,30,
Delaware,Corporation Commissioner,Blake Cummings,DEM,210001,0,0,27,27,
Delaware,U.S. House,Jason Nichols,DEM,210001,3,1,35,39,02
Delaware,U.S. House,Clay Padgett,DEM,210001,2,0,16,18,02
Delaware,Governor,Mick Cornett,REP,210002,2,0,37,39,
Delaware,Governor,Kevin Stitt,REP,210002,2,0,45,47,
Delaware,Lieutenant Governor,Dana Murphy,REP,210002,1,0,32,33,
Delaware,Lieutenant Governor,Matt Pinnell,REP,210002,3,0,46,49,
Delaware,State Auditor,Cindy Byrd,REP,210002,2,0,36,38,
Delaware,State Auditor,Charlie Prater,REP,210002,1,0,40,41,
Delaware,Attorney General,Mike Hunter,REP,210002,1,0,26,27,
Delaware,Attorney General,Gentner Drummond,REP,210002,3,0,51,54,
Delaware,Superintendent of Public Instruction,Joy Hofmeister,REP,210002,3,0,37,40,
Delaware,Superintendent of Public Instruction,Linda Murphy,REP,210002,1,0,41,42,
Delaware,Commissioner of Labor,Cathy Costello,REP,210002,2,0,29,31,
Delaware,Commissioner of Labor,Leslie Osborn,REP,210002,1,0,48,49,
Delaware,Corporation Commissioner,Bob Anthony,REP,210002,2,0,30,32,
Delaware,Corporation Commissioner,Brian Bingman,REP,210002,2,0,46,48,
Delaware,Governor,Chris Powell,LIB,210002,0,0,0,0,
Delaware,Governor,Rex Lawhorn,LIB,210002,0,0,0,0,
Delaware,Corporation Commissioner,Ashley Nicole Mccray,DEM,210002,2,0,18,20,
Delaware,Corporation Commissioner,Blake Cummings,DEM,210002,1,0,19,20,
Delaware,U.S. House,Jason Nichols,DEM,210002,3,0,27,30,02
Delaware,U.S. House,Clay Padgett,DEM,210002,0,0,10,10,02
Delaware,Governor,Mick Cornett,REP,210003,5,0,91,96,
Delaware,Governor,Kevin Stitt,REP,210003,3,0,97,100,
Delaware,Lieutenant Governor,Dana Murphy,REP,210003,1,0,59,60,
Delaware,Lieutenant Governor,Matt Pinnell,REP,210003,4,0,125,129,
Delaware,State Auditor,Cindy Byrd,REP,210003,3,0,91,94,
Delaware,State Auditor,Charlie Prater,REP,210003,2,0,87,89,
Delaware,Attorney General,Mike Hunter,REP,210003,5,0,93,98,
Delaware,Attorney General,Gentner Drummond,REP,210003,3,0,92,95,
Delaware,Superintendent of Public Instruction,Joy Hofmeister,REP,210003,6,0,107,113,
Delaware,Superintendent of Public Instruction,Linda Murphy,REP,210003,1,0,77,78,
Delaware,Commissioner of Labor,Cathy Costello,REP,210003,3,0,63,66,
Delaware,Commissioner of Labor,Leslie Osborn,REP,210003,2,0,113,115,
Delaware,Corporation Commissioner,Bob Anthony,REP,210003,6,0,86,92,
Delaware,Corporation Commissioner,Brian Bingman,REP,210003,1,0,90,91,
Delaware,Governor,Chris Powell,LIB,210003,0,0,0,0,
Delaware,Governor,Rex Lawhorn,LIB,210003,0,0,0,0,
Delaware,Corporation Commissioner,Ashley Nicole Mccray,DEM,210003,4,1,48,53,
Delaware,Corporation Commissioner,Blake Cummings,DEM,210003,0,0,15,15,
Delaware,U.S. House,Jason Nichols,DEM,210003,4,1,36,41,02
Delaware,U.S. House,Clay Padgett,DEM,210003,0,0,27,27,02
Delaware,Governor,Mick Cornett,REP,210004,1,0,24,25,
Delaware,Governor,Kevin Stitt,REP,210004,4,0,56,60,
Delaware,Lieutenant Governor,Dana Murphy,REP,210004,5,0,21,26,
Delaware,Lieutenant Governor,Matt Pinnell,REP,210004,0,0,60,60,
Delaware,State Auditor,Cindy Byrd,REP,210004,0,0,35,35,
Delaware,State Auditor,Charlie Prater,REP,210004,4,0,46,50,
Delaware,Attorney General,Mike Hunter,REP,210004,0,0,35,35,
Delaware,Attorney General,Gentner Drummond,REP,210004,5,0,46,51,
Delaware,Superintendent of Public Instruction,Joy Hofmeister,REP,210004,3,0,43,46,
Delaware,Superintendent of Public Instruction,Linda Murphy,REP,210004,2,0,37,39,
Delaware,Commissioner of Labor,Cathy Costello,REP,210004,1,0,32,33,
Delaware,Commissioner of Labor,Leslie Osborn,REP,210004,4,0,48,52,
Delaware,Corporation Commissioner,Bob Anthony,REP,210004,2,0,34,36,
Delaware,Corporation Commissioner,Brian Bingman,REP,210004,3,0,46,49,
Delaware,Governor,Chris Powell,LIB,210004,0,0,0,0,
Delaware,Governor,Rex Lawhorn,LIB,210004,0,0,0,0,
Delaware,Corporation Commissioner,Ashley Nicole Mccray,DEM,210004,3,0,40,43,
Delaware,Corporation Commissioner,Blake Cummings,DEM,210004,0,0,16,16,
Delaware,U.S. House,Jason Nichols,DEM,210004,3,0,44,47,02
Delaware,U.S. House,Clay Padgett,DEM,210004,0,0,11,11,02
Delaware,Governor,Mick Cornett,REP,210005,2,2,71,75,
Delaware,Governor,Kevin Stitt,REP,210005,10,0,154,164,
Delaware,Lieutenant Governor,Dana Murphy,REP,210005,4,0,58,62,
Delaware,Lieutenant Governor,Matt Pinnell,REP,210005,8,2,166,176,
Delaware,State Auditor,Cindy Byrd,REP,210005,4,1,92,97,
Delaware,State Auditor,Charlie Prater,REP,210005,8,1,134,143,
Delaware,Attorney General,Mike Hunter,REP,210005,9,1,73,83,
Delaware,Attorney General,Gentner Drummond,REP,210005,3,1,152,156,
Delaware,Superintendent of Public Instruction,Joy Hofmeister,REP,210005,5,1,124,130,
Delaware,Superintendent of Public Instruction,Linda Murphy,REP,210005,7,1,96,104,
Delaware,Commissioner of Labor,Cathy Costello,REP,210005,6,1,85,92,
Delaware,Commissioner of Labor,Leslie Osborn,REP,210005,6,1,136,143,
Delaware,Corporation Commissioner,Bob Anthony,REP,210005,8,0,107,115,
Delaware,Corporation Commissioner,Brian Bingman,REP,210005,4,2,110,116,
Delaware,Governor,Chris Powell,LIB,210005,0,0,0,0,
Delaware,Governor,Rex Lawhorn,LIB,210005,0,0,0,0,
Delaware,Corporation Commissioner,Ashley Nicole Mccray,DEM,210005,4,3,43,50,
Delaware,Corporation Commissioner,Blake Cummings,DEM,210005,0,0,25,25,
Delaware,U.S. House,Jason Nichols,DEM,210005,4,3,53,60,02
Delaware,U.S. House,Clay Padgett,DEM,210005,0,0,15,15,02
Delaware,Governor,Mick Cornett,REP,210006,1,1,35,37,
Delaware,Governor,Kevin Stitt,REP,210006,4,2,66,72,
Delaware,Lieutenant Governor,Dana Murphy,REP,210006,1,0,27,28,
Delaware,Lieutenant Governor,Matt Pinnell,REP,210006,4,3,76,83,
Delaware,State Auditor,Cindy Byrd,REP,210006,1,1,32,34,
Delaware,State Auditor,Charlie Prater,REP,210006,4,2,66,72,
Delaware,Attorney General,Mike Hunter,REP,210006,3,1,47,51,
Delaware,Attorney General,Gentner Drummond,REP,210006,2,2,55,59,
Delaware,Superintendent of Public Instruction,Joy Hofmeister,REP,210006,5,3,63,71,
Delaware,Superintendent of Public Instruction,Linda Murphy,REP,210006,0,0,39,39,
Delaware,Commissioner of Labor,Cathy Costello,REP,210006,3,1,36,40,
Delaware,Commissioner of Labor,Leslie Osborn,REP,210006,2,2,64,68,
Delaware,Corporation Commissioner,Bob Anthony,REP,210006,3,1,43,47,
Delaware,Corporation Commissioner,Brian Bingman,REP,210006,2,2,56,60,
Delaware,Governor,Chris Powell,LIB,210006,0,0,1,1,
Delaware,Governor,Rex Lawhorn,LIB,210006,0,0,0,0,
Delaware,Corporation Commissioner,Ashley Nicole Mccray,DEM,210006,3,0,28,31,
Delaware,Corporation Commissioner,Blake Cummings,DEM,210006,2,0,19,21,
Delaware,U.S. House,Jason Nichols,DEM,210006,4,0,28,32,02
Delaware,U.S. House,Clay Padgett,DEM,210006,1,0,18,19,02
Delaware,Governor,Mick Cornett,REP,210007,10,0,148,158,
Delaware,Governor,Kevin Stitt,REP,210007,18,15,230,263,
Delaware,Lieutenant Governor,Dana Murphy,REP,210007,10,2,119,131,
Delaware,Lieutenant Governor,Matt Pinnell,REP,210007,17,13,256,286,
Delaware,State Auditor,Cindy Byrd,REP,210007,14,4,165,183,
Delaware,State Auditor,Charlie Prater,REP,210007,11,9,198,218,
Delaware,Attorney General,Mike Hunter,REP,210007,16,4,143,163,
Delaware,Attorney General,Gentner Drummond,REP,210007,12,11,229,252,
Delaware,Superintendent of Public Instruction,Joy Hofmeister,REP,210007,9,9,230,248,
Delaware,Superintendent of Public Instruction,Linda Murphy,REP,210007,19,4,138,161,
Delaware,Commissioner of Labor,Cathy Costello,REP,210007,14,8,166,188,
Delaware,Commissioner of Labor,Leslie Osborn,REP,210007,12,6,199,217,
Delaware,Corporation Commissioner,Bob Anthony,REP,210007,8,6,173,187,
Delaware,Corporation Commissioner,Brian Bingman,REP,210007,19,7,190,216,
Delaware,Governor,Chris Powell,LIB,210007,0,0,0,0,
Delaware,Governor,Rex Lawhorn,LIB,210007,0,0,0,0,
Delaware,Corporation Commissioner,Ashley Nicole Mccray,DEM,210007,10,5,77,92,
Delaware,Corporation Commissioner,Blake Cummings,DEM,210007,1,4,31,36,
Delaware,U.S. House,Jason Nichols,DEM,210007,10,10,87,107,02
Delaware,U.S. House,Clay Padgett,DEM,210007,2,0,22,24,02
Delaware,Governor,Mick Cornett,REP,210008,0,1,22,23,
Delaware,Governor,Kevin Stitt,REP,210008,2,2,31,35,
Delaware,Lieutenant Governor,Dana Murphy,REP,210008,0,1,20,21,
Delaware,Lieutenant Governor,Matt Pinnell,REP,210008,2,2,32,36,
Delaware,State Auditor,Cindy Byrd,REP,210008,0,1,27,28,
Delaware,State Auditor,Charlie Prater,REP,210008,2,2,22,26,
Delaware,Attorney General,Mike Hunter,REP,210008,1,2,25,28,
Delaware,Attorney General,Gentner Drummond,REP,210008,1,1,27,29,
Delaware,Superintendent of Public Instruction,Joy Hofmeister,REP,210008,2,2,26,30,
Delaware,Superintendent of Public Instruction,Linda Murphy,REP,210008,0,1,24,25,
Delaware,Commissioner of Labor,Cathy Costello,REP,210008,2,1,26,29,
Delaware,Commissioner of Labor,Leslie Osborn,REP,210008,0,2,22,24,
Delaware,Corporation Commissioner,Bob Anthony,REP,210008,1,1,13,15,
Delaware,Corporation Commissioner,Brian Bingman,REP,210008,1,2,35,38,
Delaware,Governor,Chris Powell,LIB,210008,0,0,0,0,
Delaware,Governor,Rex Lawhorn,LIB,210008,0,0,0,0,
Delaware,Corporation Commissioner,Ashley Nicole Mccray,DEM,210008,1,1,15,17,
Delaware,Corporation Commissioner,Blake Cummings,DEM,210008,0,3,11,14,
Delaware,U.S. House,Jason Nichols,DEM,210008,1,2,20,23,02
Delaware,U.S. House,Clay Padgett,DEM,210008,0,1,6,7,02
Delaware,Governor,Mick Cornett,REP,210009,11,9,130,150,
Delaware,Governor,Kevin Stitt,REP,210009,4,6,229,239,
Delaware,Lieutenant Governor,Dana Murphy,REP,210009,7,3,113,123,
Delaware,Lieutenant Governor,Matt Pinnell,REP,210009,7,12,246,265,
Delaware,State Auditor,Cindy Byrd,REP,210009,5,6,174,185,
Delaware,State Auditor,Charlie Prater,REP,210009,9,9,179,197,
Delaware,Attorney General,Mike Hunter,REP,210009,8,7,136,151,
Delaware,Attorney General,Gentner Drummond,REP,210009,7,9,220,236,
Delaware,Superintendent of Public Instruction,Joy Hofmeister,REP,210009,5,9,215,229,
Delaware,Superintendent of Public Instruction,Linda Murphy,REP,210009,10,7,133,150,
Delaware,Commissioner of Labor,Cathy Costello,REP,210009,8,6,167,181,
Delaware,Commissioner of Labor,Leslie Osborn,REP,210009,6,9,183,198,
Delaware,Corporation Commissioner,Bob Anthony,REP,210009,7,4,173,184,
Delaware,Corporation Commissioner,Brian Bingman,REP,210009,6,11,177,194,
Delaware,Governor,Chris Powell,LIB,210009,0,0,0,0,
Delaware,Governor,Rex Lawhorn,LIB,210009,1,0,0,1,
Delaware,Corporation Commissioner,Ashley Nicole Mccray,DEM,210009,4,3,57,64,
Delaware,Corporation Commissioner,Blake Cummings,DEM,210009,3,0,39,42,
Delaware,U.S. House,Jason Nichols,DEM,210009,4,3,61,68,02
Delaware,U.S. House,Clay Padgett,DEM,210009,3,0,37,40,02
Delaware,Governor,Mick Cornett,REP,210010,0,0,1,1,
Delaware,Governor,Kevin Stitt,REP,210010,0,2,2,4,
Delaware,Lieutenant Governor,Dana Murphy,REP,210010,0,0,0,0,
Delaware,Lieutenant Governor,Matt Pinnell,REP,210010,0,0,3,3,
Delaware,State Auditor,Cindy Byrd,REP,210010,0,0,2,2,
Delaware,State Auditor,Charlie Prater,REP,210010,0,0,1,1,
Delaware,Attorney General,Mike Hunter,REP,210010,0,2,0,2,
Delaware,Attorney General,Gentner Drummond,REP,210010,0,0,3,3,
Delaware,Superintendent of Public Instruction,Joy Hofmeister,REP,210010,0,0,3,3,
Delaware,Superintendent of Public Instruction,Linda Murphy,REP,210010,0,0,0,0,
Delaware,Commissioner of Labor,Cathy Costello,REP,210010,0,0,2,2,
Delaware,Commissioner of Labor,Leslie Osborn,REP,210010,0,0,1,1,
Delaware,Corporation Commissioner,Bob Anthony,REP,210010,0,0,3,3,
Delaware,Corporation Commissioner,Brian Bingman,REP,210010,0,0,0,0,
Delaware,Governor,Chris Powell,LIB,210010,0,0,0,0,
Delaware,Governor,Rex Lawhorn,LIB,210010,0,0,0,0,
Delaware,Corporation Commissioner,Ashley Nicole Mccray,DEM,210010,0,0,1,1,
Delaware,Corporation Commissioner,Blake Cummings,DEM,210010,0,0,0,0,
Delaware,U.S. House,Jason Nichols,DEM,210010,0,0,1,1,02
Delaware,U.S. House,Clay Padgett,DEM,210010,0,0,0,0,02
Delaware,Governor,Mick Cornett,REP,210011,0,0,55,55,
Delaware,Governor,Kevin Stitt,REP,210011,6,1,126,133,
Delaware,Lieutenant Governor,Dana Murphy,REP,210011,4,0,51,55,
Delaware,Lieutenant Governor,Matt Pinnell,REP,210011,2,1,127,130,
Delaware,State Auditor,Cindy Byrd,REP,210011,3,0,72,75,
Delaware,State Auditor,Charlie Prater,REP,210011,3,1,103,107,
Delaware,Attorney General,Mike Hunter,REP,210011,1,0,61,62,
Delaware,Attorney General,Gentner Drummond,REP,210011,5,1,120,126,
Delaware,Superintendent of Public Instruction,Joy Hofmeister,REP,210011,2,1,91,94,
Delaware,Superintendent of Public Instruction,Linda Murphy,REP,210011,4,0,83,87,
Delaware,Commissioner of Labor,Cathy Costello,REP,210011,4,1,68,73,
Delaware,Commissioner of Labor,Leslie Osborn,REP,210011,2,0,105,107,
Delaware,Corporation Commissioner,Bob Anthony,REP,210011,3,1,67,71,
Delaware,Corporation Commissioner,Brian Bingman,REP,210011,3,0,105,108,
Delaware,Governor,Chris Powell,LIB,210011,0,0,0,0,
Delaware,Governor,Rex Lawhorn,LIB,210011,0,0,0,0,
Delaware,Corporation Commissioner,Ashley Nicole Mccray,DEM,210011,1,1,33,35,
Delaware,Corporation Commissioner,Blake Cummings,DEM,210011,1,0,17,18,
Delaware,U.S. House,Jason Nichols,DEM,210011,2,0,30,32,02
Delaware,U.S. House,Clay Padgett,DEM,210011,0,1,20,21,02
Delaware,Governor,Mick Cornett,REP,210012,1,0,56,57,
Delaware,Governor,Kevin Stitt,REP,210012,1,2,76,79,
Delaware,Lieutenant Governor,Dana Murphy,REP,210012,1,1,49,51,
Delaware,Lieutenant Governor,Matt Pinnell,REP,210012,1,1,85,87,
Delaware,State Auditor,Cindy Byrd,REP,210012,2,2,70,74,
Delaware,State Auditor,Charlie Prater,REP,210012,0,0,62,62,
Delaware,Attorney General,Mike Hunter,REP,210012,1,0,59,60,
Delaware,Attorney General,Gentner Drummond,REP,210012,1,2,75,78,
Delaware,Superintendent of Public Instruction,Joy Hofmeister,REP,210012,2,2,66,70,
Delaware,Superintendent of Public Instruction,Linda Murphy,REP,210012,0,0,67,67,
Delaware,Commissioner of Labor,Cathy Costello,REP,210012,2,2,60,64,
Delaware,Commissioner of Labor,Leslie Osborn,REP,210012,0,0,70,70,
Delaware,Corporation Commissioner,Bob Anthony,REP,210012,1,1,67,69,
Delaware,Corporation Commissioner,Brian Bingman,REP,210012,1,1,60,62,
Delaware,Governor,Chris Powell,LIB,210012,0,0,0,0,
Delaware,Governor,Rex Lawhorn,LIB,210012,0,0,0,0,
Delaware,Corporation Commissioner,Ashley Nicole Mccray,DEM,210012,1,3,34,38,
Delaware,Corporation Commissioner,Blake Cummings,DEM,210012,0,0,34,34,
Delaware,U.S. House,Jason Nichols,DEM,210012,1,3,48,52,02
Delaware,U.S. House,Clay Padgett,DEM,210012,0,0,18,18,02
Delaware,Governor,Mick Cornett,REP,210014,1,1,29,31,
Delaware,Governor,Kevin Stitt,REP,210014,0,7,41,48,
Delaware,Lieutenant Governor,Dana Murphy,REP,210014,0,2,16,18,
Delaware,Lieutenant Governor,Matt Pinnell,REP,210014,1,6,51,58,
Delaware,State Auditor,Cindy Byrd,REP,210014,0,2,29,31,
Delaware,State Auditor,Charlie Prater,REP,210014,1,6,36,43,
Delaware,Attorney General,Mike Hunter,REP,210014,0,3,33,36,
Delaware,Attorney General,Gentner Drummond,REP,210014,1,5,36,42,
Delaware,Superintendent of Public Instruction,Joy Hofmeister,REP,210014,0,3,32,35,
Delaware,Superintendent of Public Instruction,Linda Murphy,REP,210014,1,5,35,41,
Delaware,Commissioner of Labor,Cathy Costello,REP,210014,0,6,26,32,
Delaware,Commissioner of Labor,Leslie Osborn,REP,210014,1,2,40,43,
Delaware,Corporation Commissioner,Bob Anthony,REP,210014,1,6,27,34,
Delaware,Corporation Commissioner,Brian Bingman,REP,210014,0,2,38,40,
Delaware,Governor,Chris Powell,LIB,210014,0,0,0,0,
Delaware,Governor,Rex Lawhorn,LIB,210014,0,0,0,0,
Delaware,Corporation Commissioner,Ashley Nicole Mccray,DEM,210014,3,9,31,43,
Delaware,Corporation Commissioner,Blake Cummings,DEM,210014,0,5,39,44,
Delaware,U.S. House,Jason Nichols,DEM,210014,3,10,48,61,02
Delaware,U.S. House,Clay Padgett,DEM,210014,0,6,21,27,02
Delaware,Governor,Mick Cornett,REP,210015,3,4,41,48,
Delaware,Governor,Kevin Stitt,REP,210015,5,5,86,96,
Delaware,Lieutenant Governor,Dana Murphy,REP,210015,5,2,54,61,
Delaware,Lieutenant Governor,Matt Pinnell,REP,210015,3,7,72,82,
Delaware,State Auditor,Cindy Byrd,REP,210015,4,3,46,53,
Delaware,State Auditor,Charlie Prater,REP,210015,4,6,74,84,
Delaware,Attorney General,Mike Hunter,REP,210015,4,4,53,61,
Delaware,Attorney General,Gentner Drummond,REP,210015,4,5,74,83,
Delaware,Superintendent of Public Instruction,Joy Hofmeister,REP,210015,1,4,85,90,
Delaware,Superintendent of Public Instruction,Linda Murphy,REP,210015,7,5,39,51,
Delaware,Commissioner of Labor,Cathy Costello,REP,210015,5,4,53,62,
Delaware,Commissioner of Labor,Leslie Osborn,REP,210015,3,5,66,74,
Delaware,Corporation Commissioner,Bob Anthony,REP,210015,4,4,53,61,
Delaware,Corporation Commissioner,Brian Bingman,REP,210015,4,5,70,79,
Delaware,Governor,Chris Powell,LIB,210015,0,0,0,0,
Delaware,Governor,Rex Lawhorn,LIB,210015,0,0,0,0,
Delaware,Corporation Commissioner,Ashley Nicole Mccray,DEM,210015,6,7,32,45,
Delaware,Corporation Commissioner,Blake Cummings,DEM,210015,0,6,26,32,
Delaware,U.S. House,Jason Nichols,DEM,210015,6,10,43,59,02
Delaware,U.S. House,Clay Padgett,DEM,210015,0,3,15,18,02
Delaware,Governor,Mick Cornett,REP,210016,2,1,12,15,
Delaware,Governor,Kevin Stitt,REP,210016,0,5,29,34,
Delaware,Lieutenant Governor,Dana Murphy,REP,210016,2,5,16,23,
Delaware,Lieutenant Governor,Matt Pinnell,REP,210016,0,1,24,25,
Delaware,State Auditor,Cindy Byrd,REP,210016,1,4,19,24,
Delaware,State Auditor,Charlie Prater,REP,210016,1,1,21,23,
Delaware,Attorney General,Mike Hunter,REP,210016,1,1,16,18,
Delaware,Attorney General,Gentner Drummond,REP,210016,1,5,24,30,
Delaware,Superintendent of Public Instruction,Joy Hofmeister,REP,210016,0,3,21,24,
Delaware,Superintendent of Public Instruction,Linda Murphy,REP,210016,2,3,21,26,
Delaware,Commissioner of Labor,Cathy Costello,REP,210016,1,3,23,27,
Delaware,Commissioner of Labor,Leslie Osborn,REP,210016,1,3,17,21,
Delaware,Corporation Commissioner,Bob Anthony,REP,210016,1,3,17,21,
Delaware,Corporation Commissioner,Brian Bingman,REP,210016,1,3,24,28,
Delaware,Governor,Chris Powell,LIB,210016,0,0,0,0,
Delaware,Governor,Rex Lawhorn,LIB,210016,1,0,0,1,
Delaware,Corporation Commissioner,Ashley Nicole Mccray,DEM,210016,6,5,42,53,
Delaware,Corporation Commissioner,Blake Cummings,DEM,210016,2,4,28,34,
Delaware,U.S. House,Jason Nichols,DEM,210016,7,5,50,62,02
Delaware,U.S. House,Clay Padgett,DEM,210016,1,4,20,25,02
Delaware,Governor,Mick Cornett,REP,210017,0,1,10,11,
Delaware,Governor,Kevin Stitt,REP,210017,0,5,26,31,
Delaware,Lieutenant Governor,Dana Murphy,REP,210017,0,1,2,3,
Delaware,Lieutenant Governor,Matt Pinnell,REP,210017,0,6,33,39,
Delaware,State Auditor,Cindy Byrd,REP,210017,0,4,19,23,
Delaware,State Auditor,Charlie Prater,REP,210017,0,2,17,19,
Delaware,Attorney General,Mike Hunter,REP,210017,0,3,10,13,
Delaware,Attorney General,Gentner Drummond,REP,210017,0,3,26,29,
Delaware,Superintendent of Public Instruction,Joy Hofmeister,REP,210017,0,2,18,20,
Delaware,Superintendent of Public Instruction,Linda Murphy,REP,210017,0,5,17,22,
Delaware,Commissioner of Labor,Cathy Costello,REP,210017,0,3,15,18,
Delaware,Commissioner of Labor,Leslie Osborn,REP,210017,0,2,20,22,
Delaware,Corporation Commissioner,Bob Anthony,REP,210017,0,4,10,14,
Delaware,Corporation Commissioner,Brian Bingman,REP,210017,0,1,25,26,
Delaware,Governor,Chris Powell,LIB,210017,0,0,0,0,
Delaware,Governor,Rex Lawhorn,LIB,210017,0,0,0,0,
Delaware,Corporation Commissioner,Ashley Nicole Mccray,DEM,210017,5,2,16,23,
Delaware,Corporation Commissioner,Blake Cummings,DEM,210017,0,2,21,23,
Delaware,U.S. House,Jason Nichols,DEM,210017,4,1,25,30,02
Delaware,U.S. House,Clay Padgett,DEM,210017,1,2,12,15,02
Delaware,Governor,Mick Cornett,REP,210018,0,3,5,8,
Delaware,Governor,Kevin Stitt,REP,210018,2,5,30,37,
Delaware,Lieutenant Governor,Dana Murphy,REP,210018,0,2,20,22,
Delaware,Lieutenant Governor,Matt Pinnell,REP,210018,2,7,15,24,
Delaware,State Auditor,Cindy Byrd,REP,210018,0,3,16,19,
Delaware,State Auditor,Charlie Prater,REP,210018,2,3,18,23,
Delaware,Attorney General,Mike Hunter,REP,210018,2,4,18,24,
Delaware,Attorney General,Gentner Drummond,REP,210018,0,5,17,22,
Delaware,Superintendent of Public Instruction,Joy Hofmeister,REP,210018,2,4,16,22,
Delaware,Superintendent of Public Instruction,Linda Murphy,REP,210018,0,4,19,23,
Delaware,Commissioner of Labor,Cathy Costello,REP,210018,0,5,12,17,
Delaware,Commissioner of Labor,Leslie Osborn,REP,210018,2,3,22,27,
Delaware,Corporation Commissioner,Bob Anthony,REP,210018,2,5,20,27,
Delaware,Corporation Commissioner,Brian Bingman,REP,210018,0,4,15,19,
Delaware,Governor,Chris Powell,LIB,210018,0,0,0,0,
Delaware,Governor,Rex Lawhorn,LIB,210018,0,0,0,0,
Delaware,Corporation Commissioner,Ashley Nicole Mccray,DEM,210018,1,5,12,18,
Delaware,Corporation Commissioner,Blake Cummings,DEM,210018,4,3,14,21,
Delaware,U.S. House,Jason Nichols,DEM,210018,4,6,21,31,02
Delaware,U.S. House,Clay Padgett,DEM,210018,2,3,6,11,02
Delaware,Governor,Mick Cornett,REP,210019,0,1,14,15,
Delaware,Governor,Kevin Stitt,REP,210019,5,0,42,47,
Delaware,Lieutenant Governor,Dana Murphy,REP,210019,0,1,26,27,
Delaware,Lieutenant Governor,Matt Pinnell,REP,210019,5,0,30,35,
Delaware,State Auditor,Cindy Byrd,REP,210019,3,1,25,29,
Delaware,State Auditor,Charlie Prater,REP,210019,2,0,31,33,
Delaware,Attorney General,Mike Hunter,REP,210019,2,1,24,27,
Delaware,Attorney General,Gentner Drummond,REP,210019,3,0,34,37,
Delaware,Superintendent of Public Instruction,Joy Hofmeister,REP,210019,4,1,25,30,
Delaware,Superintendent of Public Instruction,Linda Murphy,REP,210019,1,0,29,30,
Delaware,Commissioner of Labor,Cathy Costello,REP,210019,2,0,23,25,
Delaware,Commissioner of Labor,Leslie Osborn,REP,210019,3,1,33,37,
Delaware,Corporation Commissioner,Bob Anthony,REP,210019,2,1,30,33,
Delaware,Corporation Commissioner,Brian Bingman,REP,210019,3,0,23,26,
Delaware,Governor,Chris Powell,LIB,210019,0,0,0,0,
Delaware,Governor,Rex Lawhorn,LIB,210019,0,0,0,0,
Delaware,Corporation Commissioner,Ashley Nicole Mccray,DEM,210019,4,3,44,51,
Delaware,Corporation Commissioner,Blake Cummings,DEM,210019,4,1,37,42,
Delaware,U.S. House,Jason Nichols,DEM,210019,5,3,58,66,02
Delaware,U.S. House,Clay Padgett,DEM,210019,3,1,25,29,02
Delaware,Governor,Mick Cornett,REP,210020,0,0,5,5,
Delaware,Governor,Kevin Stitt,REP,210020,1,0,7,8,
Delaware,Lieutenant Governor,Dana Murphy,REP,210020,1,0,3,4,
Delaware,Lieutenant Governor,Matt Pinnell,REP,210020,0,0,9,9,
Delaware,State Auditor,Cindy Byrd,REP,210020,1,0,4,5,
Delaware,State Auditor,Charlie Prater,REP,210020,0,0,7,7,
Delaware,Attorney General,Mike Hunter,REP,210020,1,0,5,6,
Delaware,Attorney General,Gentner Drummond,REP,210020,0,0,7,7,
Delaware,Superintendent of Public Instruction,Joy Hofmeister,REP,210020,0,0,5,5,
Delaware,Superintendent of Public Instruction,Linda Murphy,REP,210020,1,0,7,8,
Delaware,Commissioner of Labor,Cathy Costello,REP,210020,0,0,6,6,
Delaware,Commissioner of Labor,Leslie Osborn,REP,210020,1,0,6,7,
Delaware,Corporation Commissioner,Bob Anthony,REP,210020,0,0,1,1,
Delaware,Corporation Commissioner,Brian Bingman,REP,210020,1,0,11,12,
Delaware,Governor,Chris Powell,LIB,210020,0,0,0,0,
Delaware,Governor,Rex Lawhorn,LIB,210020,0,0,0,0,
Delaware,Corporation Commissioner,Ashley Nicole Mccray,DEM,210020,2,0,5,7,
Delaware,Corporation Commissioner,Blake Cummings,DEM,210020,0,0,13,13,
Delaware,U.S. House,Jason Nichols,DEM,210020,0,0,14,14,02
Delaware,U.S. House,Clay Padgett,DEM,210020,2,0,4,6,02
Delaware,Governor,Mick Cornett,REP,210021,0,0,5,5,
Delaware,Governor,Kevin Stitt,REP,210021,2,0,12,14,
Delaware,Lieutenant Governor,Dana Murphy,REP,210021,0,0,5,5,
Delaware,Lieutenant Governor,Matt Pinnell,REP,210021,2,0,12,14,
Delaware,State Auditor,Cindy Byrd,REP,210021,0,0,11,11,
Delaware,State Auditor,Charlie Prater,REP,210021,2,0,6,8,
Delaware,Attorney General,Mike Hunter,REP,210021,0,0,6,6,
Delaware,Attorney General,Gentner Drummond,REP,210021,2,0,11,13,
Delaware,Superintendent of Public Instruction,Joy Hofmeister,REP,210021,0,0,6,6,
Delaware,Superintendent of Public Instruction,Linda Murphy,REP,210021,2,0,11,13,
Delaware,Commissioner of Labor,Cathy Costello,REP,210021,2,0,7,9,
Delaware,Commissioner of Labor,Leslie Osborn,REP,210021,0,0,10,10,
Delaware,Corporation Commissioner,Bob Anthony,REP,210021,2,0,10,12,
Delaware,Corporation Commissioner,Brian Bingman,REP,210021,0,0,7,7,
Delaware,Governor,Chris Powell,LIB,210021,0,0,0,0,
Delaware,Governor,Rex Lawhorn,LIB,210021,0,0,0,0,
Delaware,Corporation Commissioner,Ashley Nicole Mccray,DEM,210021,0,0,9,9,
Delaware,Corporation Commissioner,Blake Cummings,DEM,210021,0,0,8,8,
Delaware,U.S. House,Jason Nichols,DEM,210021,0,0,12,12,02
Delaware,U.S. House,Clay Padgett,DEM,210021,0,0,5,5,02
Delaware,Governor,Mick Cornett,REP,210022,2,0,44,46,
Delaware,Governor,Kevin Stitt,REP,210022,10,4,100,114,
Delaware,Lieutenant Governor,Dana Murphy,REP,210022,3,2,56,61,
Delaware,Lieutenant Governor,Matt Pinnell,REP,210022,9,2,85,96,
Delaware,State Auditor,Cindy Byrd,REP,210022,9,3,63,75,
Delaware,State Auditor,Charlie Prater,REP,210022,3,1,76,80,
Delaware,Attorney General,Mike Hunter,REP,210022,3,2,55,60,
Delaware,Attorney General,Gentner Drummond,REP,210022,9,2,88,99,
Delaware,Superintendent of Public Instruction,Joy Hofmeister,REP,210022,7,2,73,82,
Delaware,Superintendent of Public Instruction,Linda Murphy,REP,210022,5,2,68,75,
Delaware,Commissioner of Labor,Cathy Costello,REP,210022,6,2,60,68,
Delaware,Commissioner of Labor,Leslie Osborn,REP,210022,6,2,80,88,
Delaware,Corporation Commissioner,Bob Anthony,REP,210022,7,2,66,75,
Delaware,Corporation Commissioner,Brian Bingman,REP,210022,5,0,74,79,
Delaware,Governor,Chris Powell,LIB,210022,0,0,0,0,
Delaware,Governor,Rex Lawhorn,LIB,210022,0,0,0,0,
Delaware,Corporation Commissioner,Ashley Nicole Mccray,DEM,210022,10,1,60,71,
Delaware,Corporation Commissioner,Blake Cummings,DEM,210022,3,0,53,56,
Delaware,U.S. House,Jason Nichols,DEM,210022,11,0,84,95,02
Delaware,U.S. House,Clay Padgett,DEM,210022,2,1,29,32,02
Delaware,Governor,Mick Cornett,REP,210023,4,0,17,21,
Delaware,Governor,Kevin Stitt,REP,210023,1,0,45,46,
Delaware,Lieutenant Governor,Dana Murphy,REP,210023,4,0,25,29,
Delaware,Lieutenant Governor,Matt Pinnell,REP,210023,1,0,39,40,
Delaware,State Auditor,Cindy Byrd,REP,210023,4,0,29,33,
Delaware,State Auditor,Charlie Prater,REP,210023,1,0,33,34,
Delaware,Attorney General,Mike Hunter,REP,210023,4,0,31,35,
Delaware,Attorney General,Gentner Drummond,REP,210023,1,0,34,35,
Delaware,Superintendent of Public Instruction,Joy Hofmeister,REP,210023,4,0,30,34,
Delaware,Superintendent of Public Instruction,Linda Murphy,REP,210023,1,0,32,33,
Delaware,Commissioner of Labor,Cathy Costello,REP,210023,2,0,31,33,
Delaware,Commissioner of Labor,Leslie Osborn,REP,210023,2,0,32,34,
Delaware,Corporation Commissioner,Bob Anthony,REP,210023,3,0,28,31,
Delaware,Corporation Commissioner,Brian Bingman,REP,210023,2,0,33,35,
Delaware,Governor,Chris Powell,LIB,210023,0,0,0,0,
Delaware,Governor,Rex Lawhorn,LIB,210023,0,0,0,0,
Delaware,Corporation Commissioner,Ashley Nicole Mccray,DEM,210023,4,0,24,28,
Delaware,Corporation Commissioner,Blake Cummings,DEM,210023,1,0,22,23,
Delaware,U.S. House,Jason Nichols,DEM,210023,3,0,31,34,02
Delaware,U.S. House,Clay Padgett,DEM,210023,3,0,15,18,02
Dewey,Governor,Mick Cornett,REP,220001,1,2,21,24,
Dewey,Governor,Kevin Stitt,REP,220001,3,4,45,52,
Dewey,Lieutenant Governor,Dana Murphy,REP,220001,1,2,23,26,
Dewey,Lieutenant Governor,Matt Pinnell,REP,220001,3,4,42,49,
Dewey,State Auditor,Cindy Byrd,REP,220001,0,4,25,29,
Dewey,State Auditor,Charlie Prater,REP,220001,4,2,38,44,
Dewey,Attorney General,Mike Hunter,REP,220001,3,4,34,41,
Dewey,Attorney General,Gentner Drummond,REP,220001,1,2,29,32,
Dewey,Superintendent of Public Instruction,Joy Hofmeister,REP,220001,2,2,37,41,
Dewey,Superintendent of Public Instruction,Linda Murphy,REP,220001,2,4,28,34,
Dewey,Commissioner of Labor,Cathy Costello,REP,220001,2,5,37,44,
Dewey,Commissioner of Labor,Leslie Osborn,REP,220001,2,1,27,30,
Dewey,Corporation Commissioner,Bob Anthony,REP,220001,2,5,38,45,
Dewey,Corporation Commissioner,Brian Bingman,REP,220001,2,1,26,29,
Dewey,Governor,Chris Powell,LIB,220001,0,0,0,0,
Dewey,Governor,Rex Lawhorn,LIB,220001,0,0,0,0,
Dewey,Corporation Commissioner,Ashley Nicole Mccray,DEM,220001,1,0,8,9,
Dewey,Corporation Commissioner,Blake Cummings,DEM,220001,0,1,23,24,
Dewey,Governor,Mick Cornett,REP,220002,0,0,13,13,
Dewey,Governor,Kevin Stitt,REP,220002,1,0,15,16,
Dewey,Lieutenant Governor,Dana Murphy,REP,220002,1,0,16,17,
Dewey,Lieutenant Governor,Matt Pinnell,REP,220002,0,0,11,11,
Dewey,State Auditor,Cindy Byrd,REP,220002,0,0,16,16,
Dewey,State Auditor,Charlie Prater,REP,220002,1,0,11,12,
Dewey,Attorney General,Mike Hunter,REP,220002,0,0,13,13,
Dewey,Attorney General,Gentner Drummond,REP,220002,1,0,15,16,
Dewey,Superintendent of Public Instruction,Joy Hofmeister,REP,220002,1,0,19,20,
Dewey,Superintendent of Public Instruction,Linda Murphy,REP,220002,0,0,8,8,
Dewey,Commissioner of Labor,Cathy Costello,REP,220002,0,0,13,13,
Dewey,Commissioner of Labor,Leslie Osborn,REP,220002,1,0,14,15,
Dewey,Corporation Commissioner,Bob Anthony,REP,220002,0,0,19,19,
Dewey,Corporation Commissioner,Brian Bingman,REP,220002,1,0,9,10,
Dewey,Governor,Chris Powell,LIB,220002,0,0,0,0,
Dewey,Governor,Rex Lawhorn,LIB,220002,0,0,0,0,
Dewey,Corporation Commissioner,Ashley Nicole Mccray,DEM,220002,1,0,8,9,
Dewey,Corporation Commissioner,Blake Cummings,DEM,220002,1,0,13,14,
Dewey,Governor,Mick Cornett,REP,220003,3,1,20,24,
Dewey,Governor,Kevin Stitt,REP,220003,0,1,39,40,
Dewey,Lieutenant Governor,Dana Murphy,REP,220003,0,2,29,31,
Dewey,Lieutenant Governor,Matt Pinnell,REP,220003,3,0,28,31,
Dewey,State Auditor,Cindy Byrd,REP,220003,1,2,23,26,
Dewey,State Auditor,Charlie Prater,REP,220003,2,0,34,36,
Dewey,Attorney General,Mike Hunter,REP,220003,2,0,32,34,
Dewey,Attorney General,Gentner Drummond,REP,220003,1,2,27,30,
Dewey,Superintendent of Public Instruction,Joy Hofmeister,REP,220003,2,1,34,37,
Dewey,Superintendent of Public Instruction,Linda Murphy,REP,220003,1,0,22,23,
Dewey,Commissioner of Labor,Cathy Costello,REP,220003,2,0,24,26,
Dewey,Commissioner of Labor,Leslie Osborn,REP,220003,1,1,33,35,
Dewey,Corporation Commissioner,Bob Anthony,REP,220003,2,2,26,30,
Dewey,Corporation Commissioner,Brian Bingman,REP,220003,1,0,31,32,
Dewey,Governor,Chris Powell,LIB,220003,0,0,0,0,
Dewey,Governor,Rex Lawhorn,LIB,220003,0,0,0,0,
Dewey,Corporation Commissioner,Ashley Nicole Mccray,DEM,220003,0,0,24,24,
Dewey,Corporation Commissioner,Blake Cummings,DEM,220003,1,0,12,13,
Dewey,Governor,Mick Cornett,REP,220004,1,0,9,10,
Dewey,Governor,Kevin Stitt,REP,220004,0,1,27,28,
Dewey,Lieutenant Governor,Dana Murphy,REP,220004,1,0,17,18,
Dewey,Lieutenant Governor,Matt Pinnell,REP,220004,0,1,16,17,
Dewey,State Auditor,Cindy Byrd,REP,220004,1,1,11,13,
Dewey,State Auditor,Charlie Prater,REP,220004,0,0,23,23,
Dewey,Attorney General,Mike Hunter,REP,220004,1,1,23,25,
Dewey,Attorney General,Gentner Drummond,REP,220004,0,0,12,12,
Dewey,Superintendent of Public Instruction,Joy Hofmeister,REP,220004,1,0,15,16,
Dewey,Superintendent of Public Instruction,Linda Murphy,REP,220004,0,1,18,19,
Dewey,Commissioner of Labor,Cathy Costello,REP,220004,1,1,18,20,
Dewey,Commissioner of Labor,Leslie Osborn,REP,220004,0,0,15,15,
Dewey,Corporation Commissioner,Bob Anthony,REP,220004,1,1,18,20,
Dewey,Corporation Commissioner,Brian Bingman,REP,220004,0,0,16,16,
Dewey,Governor,Chris Powell,LIB,220004,0,0,0,0,
Dewey,Governor,Rex Lawhorn,LIB,220004,0,0,0,0,
Dewey,Corporation Commissioner,Ashley Nicole Mccray,DEM,220004,0,0,8,8,
Dewey,Corporation Commissioner,Blake Cummings,DEM,220004,0,0,9,9,
Dewey,Governor,Mick Cornett,REP,220005,5,4,67,76,
Dewey,Governor,Kevin Stitt,REP,220005,0,10,98,108,
Dewey,Lieutenant Governor,Dana Murphy,REP,220005,4,5,76,85,
Dewey,Lieutenant Governor,Matt Pinnell,REP,220005,1,9,89,99,
Dewey,State Auditor,Cindy Byrd,REP,220005,4,6,69,79,
Dewey,State Auditor,Charlie Prater,REP,220005,1,8,90,99,
Dewey,Attorney General,Mike Hunter,REP,220005,5,5,68,78,
Dewey,Attorney General,Gentner Drummond,REP,220005,0,9,93,102,
Dewey,Superintendent of Public Instruction,Joy Hofmeister,REP,220005,2,7,80,89,
Dewey,Superintendent of Public Instruction,Linda Murphy,REP,220005,3,7,86,96,
Dewey,Commissioner of Labor,Cathy Costello,REP,220005,3,7,73,83,
Dewey,Commissioner of Labor,Leslie Osborn,REP,220005,2,7,89,98,
Dewey,Corporation Commissioner,Bob Anthony,REP,220005,2,3,86,91,
Dewey,Corporation Commissioner,Brian Bingman,REP,220005,3,11,78,92,
Dewey,Governor,Chris Powell,LIB,220005,0,0,0,0,
Dewey,Governor,Rex Lawhorn,LIB,220005,0,0,0,0,
Dewey,Corporation Commissioner,Ashley Nicole Mccray,DEM,220005,0,0,8,8,
Dewey,Corporation Commissioner,Blake Cummings,DEM,220005,0,0,14,14,
Dewey,Governor,Mick Cornett,REP,220007,0,0,9,9,
Dewey,Governor,Kevin Stitt,REP,220007,0,0,30,30,
Dewey,Lieutenant Governor,Dana Murphy,REP,220007,0,0,5,5,
Dewey,Lieutenant Governor,Matt Pinnell,REP,220007,0,0,33,33,
Dewey,State Auditor,Cindy Byrd,REP,220007,0,0,10,10,
Dewey,State Auditor,Charlie Prater,REP,220007,0,0,26,26,
Dewey,Attorney General,Mike Hunter,REP,220007,0,0,20,20,
Dewey,Attorney General,Gentner Drummond,REP,220007,0,0,19,19,
Dewey,Superintendent of Public Instruction,Joy Hofmeister,REP,220007,0,0,21,21,
Dewey,Superintendent of Public Instruction,Linda Murphy,REP,220007,0,0,18,18,
Dewey,Commissioner of Labor,Cathy Costello,REP,220007,0,0,19,19,
Dewey,Commissioner of Labor,Leslie Osborn,REP,220007,0,0,18,18,
Dewey,Corporation Commissioner,Bob Anthony,REP,220007,0,0,21,21,
Dewey,Corporation Commissioner,Brian Bingman,REP,220007,0,0,18,18,
Dewey,Governor,Chris Powell,LIB,220007,0,0,0,0,
Dewey,Governor,Rex Lawhorn,LIB,220007,0,0,0,0,
Dewey,Corporation Commissioner,Ashley Nicole Mccray,DEM,220007,0,0,3,3,
Dewey,Corporation Commissioner,Blake Cummings,DEM,220007,0,0,4,4,
Dewey,Governor,Mick Cornett,REP,220008,1,1,43,45,
Dewey,Governor,Kevin Stitt,REP,220008,5,8,109,122,
Dewey,Lieutenant Governor,Dana Murphy,REP,220008,1,5,50,56,
Dewey,Lieutenant Governor,Matt Pinnell,REP,220008,5,4,101,110,
Dewey,State Auditor,Cindy Byrd,REP,220008,4,7,59,70,
Dewey,State Auditor,Charlie Prater,REP,220008,1,2,86,89,
Dewey,Attorney General,Mike Hunter,REP,220008,1,7,77,85,
Dewey,Attorney General,Gentner Drummond,REP,220008,4,2,71,77,
Dewey,Superintendent of Public Instruction,Joy Hofmeister,REP,220008,4,4,70,78,
Dewey,Superintendent of Public Instruction,Linda Murphy,REP,220008,1,5,79,85,
Dewey,Commissioner of Labor,Cathy Costello,REP,220008,2,5,81,88,
Dewey,Commissioner of Labor,Leslie Osborn,REP,220008,3,4,66,73,
Dewey,Corporation Commissioner,Bob Anthony,REP,220008,2,5,83,90,
Dewey,Corporation Commissioner,Brian Bingman,REP,220008,3,4,66,73,
Dewey,Governor,Chris Powell,LIB,220008,0,0,0,0,
Dewey,Governor,Rex Lawhorn,LIB,220008,0,0,0,0,
Dewey,Corporation Commissioner,Ashley Nicole Mccray,DEM,220008,0,2,9,11,
Dewey,Corporation Commissioner,Blake Cummings,DEM,220008,1,1,8,10,
Dewey,Governor,Mick Cornett,REP,220009,1,0,21,22,
Dewey,Governor,Kevin Stitt,REP,220009,0,0,42,42,
Dewey,Lieutenant Governor,Dana Murphy,REP,220009,0,0,33,33,
Dewey,Lieutenant Governor,Matt Pinnell,REP,220009,1,0,28,29,
Dewey,State Auditor,Cindy Byrd,REP,220009,0,0,25,25,
Dewey,State Auditor,Charlie Prater,REP,220009,1,0,36,37,
Dewey,Attorney General,Mike Hunter,REP,220009,0,0,23,23,
Dewey,Attorney General,Gentner Drummond,REP,220009,1,0,39,40,
Dewey,Superintendent of Public Instruction,Joy Hofmeister,REP,220009,0,0,33,33,
Dewey,Superintendent of Public Instruction,Linda Murphy,REP,220009,1,0,29,30,
Dewey,Commissioner of Labor,Cathy Costello,REP,220009,0,0,30,30,
Dewey,Commissioner of Labor,Leslie Osborn,REP,220009,1,0,30,31,
Dewey,Corporation Commissioner,Bob Anthony,REP,220009,1,0,30,31,
Dewey,Corporation Commissioner,Brian Bingman,REP,220009,0,0,32,32,
Dewey,Governor,Chris Powell,LIB,220009,0,0,0,0,
Dewey,Governor,Rex Lawhorn,LIB,220009,0,0,0,0,
Dewey,Corporation Commissioner,Ashley Nicole Mccray,DEM,220009,1,0,2,3,
Dewey,Corporation Commissioner,Blake Cummings,DEM,220009,2,0,9,11,
Dewey,Governor,Mick Cornett,REP,220010,0,0,6,6,
Dewey,Governor,Kevin Stitt,REP,220010,1,0,13,14,
Dewey,Lieutenant Governor,Dana Murphy,REP,220010,0,0,9,9,
Dewey,Lieutenant Governor,Matt Pinnell,REP,220010,1,0,10,11,
Dewey,State Auditor,Cindy Byrd,REP,220010,1,0,7,8,
Dewey,State Auditor,Charlie Prater,REP,220010,0,0,12,12,
Dewey,Attorney General,Mike Hunter,REP,220010,0,0,10,10,
Dewey,Attorney General,Gentner Drummond,REP,220010,1,0,9,10,
Dewey,Superintendent of Public Instruction,Joy Hofmeister,REP,220010,0,0,9,9,
Dewey,Superintendent of Public Instruction,Linda Murphy,REP,220010,1,0,10,11,
Dewey,Commissioner of Labor,Cathy Costello,REP,220010,0,0,10,10,
Dewey,Commissioner of Labor,Leslie Osborn,REP,220010,1,0,9,10,
Dewey,Corporation Commissioner,Bob Anthony,REP,220010,0,0,8,8,
Dewey,Corporation Commissioner,Brian Bingman,REP,220010,1,0,11,12,
Dewey,Governor,Chris Powell,LIB,220010,0,0,0,0,
Dewey,Governor,Rex Lawhorn,LIB,220010,0,0,0,0,
Dewey,Corporation Commissioner,Ashley Nicole Mccray,DEM,220010,0,0,3,3,
Dewey,Corporation Commissioner,Blake Cummings,DEM,220010,0,0,5,5,
Ellis,Governor,Mick Cornett,REP,230001,9,10,47,66,
Ellis,Governor,Kevin Stitt,REP,230001,5,25,81,111,
Ellis,Lieutenant Governor,Dana Murphy,REP,230001,8,17,76,101,
Ellis,Lieutenant Governor,Matt Pinnell,REP,230001,5,18,52,75,
Ellis,State Auditor,Cindy Byrd,REP,230001,8,18,48,74,
Ellis,State Auditor,Charlie Prater,REP,230001,5,16,78,99,
Ellis,Attorney General,Mike Hunter,REP,230001,9,16,63,88,
Ellis,Attorney General,Gentner Drummond,REP,230001,4,18,64,86,
Ellis,Superintendent of Public Instruction,Joy Hofmeister,REP,230001,5,17,65,87,
Ellis,Superintendent of Public Instruction,Linda Murphy,REP,230001,8,17,63,88,
Ellis,Commissioner of Labor,Cathy Costello,REP,230001,7,13,50,70,
Ellis,Commissioner of Labor,Leslie Osborn,REP,230001,7,20,76,103,
Ellis,Corporation Commissioner,Bob Anthony,REP,230001,11,18,64,93,
Ellis,Corporation Commissioner,Brian Bingman,REP,230001,2,14,61,77,
Ellis,State House,Kenton Patzkowsky,REP,230001,8,22,67,97,61
Ellis,State House,Brad Raven,REP,230001,6,11,59,76,61
Ellis,Governor,Chris Powell,LIB,230001,0,0,0,0,
Ellis,Governor,Rex Lawhorn,LIB,230001,0,0,0,0,
Ellis,Corporation Commissioner,Ashley Nicole Mccray,DEM,230001,1,4,8,13,
Ellis,Corporation Commissioner,Blake Cummings,DEM,230001,0,2,13,15,
Ellis,Governor,Mick Cornett,REP,230003,1,3,70,74,
Ellis,Governor,Kevin Stitt,REP,230003,5,6,126,137,
Ellis,Lieutenant Governor,Dana Murphy,REP,230003,3,9,91,103,
Ellis,Lieutenant Governor,Matt Pinnell,REP,230003,3,0,104,107,
Ellis,State Auditor,Cindy Byrd,REP,230003,2,5,67,74,
Ellis,State Auditor,Charlie Prater,REP,230003,3,3,121,127,
Ellis,Attorney General,Mike Hunter,REP,230003,2,6,83,91,
Ellis,Attorney General,Gentner Drummond,REP,230003,4,3,105,112,
Ellis,Superintendent of Public Instruction,Joy Hofmeister,REP,230003,2,3,122,127,
Ellis,Superintendent of Public Instruction,Linda Murphy,REP,230003,4,6,69,79,
Ellis,Commissioner of Labor,Cathy Costello,REP,230003,2,6,61,69,
Ellis,Commissioner of Labor,Leslie Osborn,REP,230003,4,3,127,134,
Ellis,Corporation Commissioner,Bob Anthony,REP,230003,3,7,89,99,
Ellis,Corporation Commissioner,Brian Bingman,REP,230003,2,2,99,103,
Ellis,State House,Kenton Patzkowsky,REP,230003,2,6,104,112,61
Ellis,State House,Brad Raven,REP,230003,4,3,89,96,61
Ellis,Governor,Chris Powell,LIB,230003,0,0,0,0,
Ellis,Governor,Rex Lawhorn,LIB,230003,0,0,0,0,
Ellis,Corporation Commissioner,Ashley Nicole Mccray,DEM,230003,2,0,8,10,
Ellis,Corporation Commissioner,Blake Cummings,DEM,230003,0,0,17,17,
Ellis,Governor,Mick Cornett,REP,230004,0,1,18,19,
Ellis,Governor,Kevin Stitt,REP,230004,0,0,18,18,
Ellis,Lieutenant Governor,Dana Murphy,REP,230004,0,1,14,15,
Ellis,Lieutenant Governor,Matt Pinnell,REP,230004,0,0,22,22,
Ellis,State Auditor,Cindy Byrd,REP,230004,0,1,9,10,
Ellis,State Auditor,Charlie Prater,REP,230004,0,0,24,24,
Ellis,Attorney General,Mike Hunter,REP,230004,0,1,16,17,
Ellis,Attorney General,Gentner Drummond,REP,230004,0,0,20,20,
Ellis,Superintendent of Public Instruction,Joy Hofmeister,REP,230004,0,0,22,22,
Ellis,Superintendent of Public Instruction,Linda Murphy,REP,230004,0,1,13,14,
Ellis,Commissioner of Labor,Cathy Costello,REP,230004,0,0,13,13,
Ellis,Commissioner of Labor,Leslie Osborn,REP,230004,0,1,22,23,
Ellis,Corporation Commissioner,Bob Anthony,REP,230004,0,1,11,12,
Ellis,Corporation Commissioner,Brian Bingman,REP,230004,0,0,24,24,
Ellis,State House,Kenton Patzkowsky,REP,230004,0,1,26,27,61
Ellis,State House,Brad Raven,REP,230004,0,0,10,10,61
Ellis,Governor,Chris Powell,LIB,230004,0,0,0,0,
Ellis,Governor,Rex Lawhorn,LIB,230004,0,0,0,0,
Ellis,Corporation Commissioner,Ashley Nicole Mccray,DEM,230004,0,0,4,4,
Ellis,Corporation Commissioner,Blake Cummings,DEM,230004,0,0,0,0,
Ellis,Governor,Mick Cornett,REP,230006,0,1,8,9,
Ellis,Governor,Kevin Stitt,REP,230006,0,1,13,14,
Ellis,Lieutenant Governor,Dana Murphy,REP,230006,0,2,16,18,
Ellis,Lieutenant Governor,Matt Pinnell,REP,230006,0,0,5,5,
Ellis,State Auditor,Cindy Byrd,REP,230006,0,1,10,11,
Ellis,State Auditor,Charlie Prater,REP,230006,0,1,11,12,
Ellis,Attorney General,Mike Hunter,REP,230006,0,2,10,12,
Ellis,Attorney General,Gentner Drummond,REP,230006,0,0,11,11,
Ellis,Superintendent of Public Instruction,Joy Hofmeister,REP,230006,0,0,9,9,
Ellis,Superintendent of Public Instruction,Linda Murphy,REP,230006,0,2,11,13,
Ellis,Commissioner of Labor,Cathy Costello,REP,230006,0,1,6,7,
Ellis,Commissioner of Labor,Leslie Osborn,REP,230006,0,1,15,16,
Ellis,Corporation Commissioner,Bob Anthony,REP,230006,0,2,13,15,
Ellis,Corporation Commissioner,Brian Bingman,REP,230006,0,0,7,7,
Ellis,State House,Kenton Patzkowsky,REP,230006,0,2,13,15,61
Ellis,State House,Brad Raven,REP,230006,0,0,8,8,61
Ellis,Governor,Chris Powell,LIB,230006,0,0,0,0,
Ellis,Governor,Rex Lawhorn,LIB,230006,0,0,0,0,
Ellis,Corporation Commissioner,Ashley Nicole Mccray,DEM,230006,0,0,1,1,
Ellis,Corporation Commissioner,Blake Cummings,DEM,230006,1,0,0,1,
Ellis,Governor,Mick Cornett,REP,230007,0,0,35,35,
Ellis,Governor,Kevin Stitt,REP,230007,4,3,61,68,
Ellis,Lieutenant Governor,Dana Murphy,REP,230007,4,3,64,71,
Ellis,Lieutenant Governor,Matt Pinnell,REP,230007,0,0,31,31,
Ellis,State Auditor,Cindy Byrd,REP,230007,1,2,33,36,
Ellis,State Auditor,Charlie Prater,REP,230007,3,1,59,63,
Ellis,Attorney General,Mike Hunter,REP,230007,3,1,46,50,
Ellis,Attorney General,Gentner Drummond,REP,230007,1,2,49,52,
Ellis,Superintendent of Public Instruction,Joy Hofmeister,REP,230007,1,2,51,54,
Ellis,Superintendent of Public Instruction,Linda Murphy,REP,230007,3,1,44,48,
Ellis,Commissioner of Labor,Cathy Costello,REP,230007,1,2,42,45,
Ellis,Commissioner of Labor,Leslie Osborn,REP,230007,3,1,51,55,
Ellis,Corporation Commissioner,Bob Anthony,REP,230007,3,3,55,61,
Ellis,Corporation Commissioner,Brian Bingman,REP,230007,1,0,41,42,
Ellis,State House,Kenton Patzkowsky,REP,230007,3,2,45,50,61
Ellis,State House,Brad Raven,REP,230007,1,1,51,53,61
Ellis,Governor,Chris Powell,LIB,230007,0,0,0,0,
Ellis,Governor,Rex Lawhorn,LIB,230007,0,0,0,0,
Ellis,Corporation Commissioner,Ashley Nicole Mccray,DEM,230007,0,1,11,12,
Ellis,Corporation Commissioner,Blake Cummings,DEM,230007,0,0,6,6,
Ellis,Governor,Mick Cornett,REP,230008,1,1,27,29,
Ellis,Governor,Kevin Stitt,REP,230008,5,2,65,72,
Ellis,Lieutenant Governor,Dana Murphy,REP,230008,5,3,56,64,
Ellis,Lieutenant Governor,Matt Pinnell,REP,230008,2,0,39,41,
Ellis,State Auditor,Cindy Byrd,REP,230008,2,2,37,41,
Ellis,State Auditor,Charlie Prater,REP,230008,4,1,52,57,
Ellis,Attorney General,Mike Hunter,REP,230008,3,0,38,41,
Ellis,Attorney General,Gentner Drummond,REP,230008,4,3,52,59,
Ellis,Superintendent of Public Instruction,Joy Hofmeister,REP,230008,3,3,47,53,
Ellis,Superintendent of Public Instruction,Linda Murphy,REP,230008,3,0,48,51,
Ellis,Commissioner of Labor,Cathy Costello,REP,230008,5,3,40,48,
Ellis,Commissioner of Labor,Leslie Osborn,REP,230008,1,0,52,53,
Ellis,Corporation Commissioner,Bob Anthony,REP,230008,0,1,43,44,
Ellis,Corporation Commissioner,Brian Bingman,REP,230008,7,2,48,57,
Ellis,State House,Kenton Patzkowsky,REP,230008,4,2,46,52,61
Ellis,State House,Brad Raven,REP,230008,2,1,47,50,61
Ellis,Governor,Chris Powell,LIB,230008,0,0,0,0,
Ellis,Governor,Rex Lawhorn,LIB,230008,0,0,0,0,
Ellis,Corporation Commissioner,Ashley Nicole Mccray,DEM,230008,0,0,4,4,
Ellis,Corporation Commissioner,Blake Cummings,DEM,230008,0,1,6,7,
Ellis,Governor,Mick Cornett,REP,230009,3,1,11,15,
Ellis,Governor,Kevin Stitt,REP,230009,0,5,20,25,
Ellis,Lieutenant Governor,Dana Murphy,REP,230009,3,5,14,22,
Ellis,Lieutenant Governor,Matt Pinnell,REP,230009,0,1,17,18,
Ellis,State Auditor,Cindy Byrd,REP,230009,3,3,10,16,
Ellis,State Auditor,Charlie Prater,REP,230009,0,3,21,24,
Ellis,Attorney General,Mike Hunter,REP,230009,1,3,15,19,
Ellis,Attorney General,Gentner Drummond,REP,230009,2,3,16,21,
Ellis,Superintendent of Public Instruction,Joy Hofmeister,REP,230009,2,3,17,22,
Ellis,Superintendent of Public Instruction,Linda Murphy,REP,230009,1,3,13,17,
Ellis,Commissioner of Labor,Cathy Costello,REP,230009,1,3,13,17,
Ellis,Commissioner of Labor,Leslie Osborn,REP,230009,2,3,18,23,
Ellis,Corporation Commissioner,Bob Anthony,REP,230009,3,5,17,25,
Ellis,Corporation Commissioner,Brian Bingman,REP,230009,0,1,14,15,
Ellis,State House,Kenton Patzkowsky,REP,230009,0,4,23,27,61
Ellis,State House,Brad Raven,REP,230009,3,2,7,12,61
Ellis,Governor,Chris Powell,LIB,230009,0,0,0,0,
Ellis,Governor,Rex Lawhorn,LIB,230009,0,0,0,0,
Ellis,Corporation Commissioner,Ashley Nicole Mccray,DEM,230009,0,0,1,1,
Ellis,Corporation Commissioner,Blake Cummings,DEM,230009,0,0,1,1,
Garfield,Governor,Mick Cornett,REP,240101,8,3,38,49,
Garfield,Governor,Kevin Stitt,REP,240101,3,0,40,43,
Garfield,Lieutenant Governor,Dana Murphy,REP,240101,6,1,30,37,
Garfield,Lieutenant Governor,Matt Pinnell,REP,240101,5,2,48,55,
Garfield,State Auditor,Cindy Byrd,REP,240101,6,1,46,53,
Garfield,State Auditor,Charlie Prater,REP,240101,4,2,32,38,
Garfield,Attorney General,Mike Hunter,REP,240101,7,1,44,52,
Garfield,Attorney General,Gentner Drummond,REP,240101,3,2,34,39,
Garfield,Superintendent of Public Instruction,Joy Hofmeister,REP,240101,5,0,27,32,
Garfield,Superintendent of Public Instruction,Linda Murphy,REP,240101,5,3,51,59,
Garfield,Commissioner of Labor,Cathy Costello,REP,240101,4,2,45,51,
Garfield,Commissioner of Labor,Leslie Osborn,REP,240101,6,1,33,40,
Garfield,Corporation Commissioner,Bob Anthony,REP,240101,8,0,36,44,
Garfield,Corporation Commissioner,Brian Bingman,REP,240101,3,3,42,48,
Garfield,Governor,Chris Powell,LIB,240101,0,0,0,0,
Garfield,Governor,Rex Lawhorn,LIB,240101,0,0,1,1,
Garfield,Corporation Commissioner,Ashley Nicole Mccray,DEM,240101,2,0,22,24,
Garfield,Corporation Commissioner,Blake Cummings,DEM,240101,0,0,13,13,
Garfield,Governor,Mick Cornett,REP,240102,2,3,44,49,
Garfield,Governor,Kevin Stitt,REP,240102,1,1,42,44,
Garfield,Lieutenant Governor,Dana Murphy,REP,240102,0,3,32,35,
Garfield,Lieutenant Governor,Matt Pinnell,REP,240102,3,1,52,56,
Garfield,State Auditor,Cindy Byrd,REP,240102,0,3,32,35,
Garfield,State Auditor,Charlie Prater,REP,240102,2,1,52,55,
Garfield,Attorney General,Mike Hunter,REP,240102,3,3,46,52,
Garfield,Attorney General,Gentner Drummond,REP,240102,0,1,39,40,
Garfield,Superintendent of Public Instruction,Joy Hofmeister,REP,240102,2,1,47,50,
Garfield,Superintendent of Public Instruction,Linda Murphy,REP,240102,0,3,38,41,
Garfield,Commissioner of Labor,Cathy Costello,REP,240102,1,3,39,43,
Garfield,Commissioner of Labor,Leslie Osborn,REP,240102,2,1,45,48,
Garfield,Corporation Commissioner,Bob Anthony,REP,240102,2,3,40,45,
Garfield,Corporation Commissioner,Brian Bingman,REP,240102,0,1,45,46,
Garfield,Governor,Chris Powell,LIB,240102,0,0,0,0,
Garfield,Governor,Rex Lawhorn,LIB,240102,0,0,0,0,
Garfield,Corporation Commissioner,Ashley Nicole Mccray,DEM,240102,0,2,15,17,
Garfield,Corporation Commissioner,Blake Cummings,DEM,240102,0,0,6,6,
Garfield,Governor,Mick Cornett,REP,240103,2,2,76,80,
Garfield,Governor,Kevin Stitt,REP,240103,2,2,69,73,
Garfield,Lieutenant Governor,Dana Murphy,REP,240103,1,3,55,59,
Garfield,Lieutenant Governor,Matt Pinnell,REP,240103,3,1,88,92,
Garfield,State Auditor,Cindy Byrd,REP,240103,3,3,58,64,
Garfield,State Auditor,Charlie Prater,REP,240103,1,1,83,85,
Garfield,Attorney General,Mike Hunter,REP,240103,3,2,71,76,
Garfield,Attorney General,Gentner Drummond,REP,240103,1,2,73,76,
Garfield,Superintendent of Public Instruction,Joy Hofmeister,REP,240103,2,3,77,82,
Garfield,Superintendent of Public Instruction,Linda Murphy,REP,240103,2,1,66,69,
Garfield,Commissioner of Labor,Cathy Costello,REP,240103,1,2,63,66,
Garfield,Commissioner of Labor,Leslie Osborn,REP,240103,3,2,78,83,
Garfield,Corporation Commissioner,Bob Anthony,REP,240103,1,3,70,74,
Garfield,Corporation Commissioner,Brian Bingman,REP,240103,3,1,72,76,
Garfield,Governor,Chris Powell,LIB,240103,0,0,0,0,
Garfield,Governor,Rex Lawhorn,LIB,240103,0,0,1,1,
Garfield,Corporation Commissioner,Ashley Nicole Mccray,DEM,240103,1,0,31,32,
Garfield,Corporation Commissioner,Blake Cummings,DEM,240103,1,0,15,16,
Garfield,Governor,Mick Cornett,REP,240104,8,7,56,71,
Garfield,Governor,Kevin Stitt,REP,240104,1,6,72,79,
Garfield,Lieutenant Governor,Dana Murphy,REP,240104,5,2,47,54,
Garfield,Lieutenant Governor,Matt Pinnell,REP,240104,4,11,81,96,
Garfield,State Auditor,Cindy Byrd,REP,240104,6,7,46,59,
Garfield,State Auditor,Charlie Prater,REP,240104,3,6,78,87,
Garfield,Attorney General,Mike Hunter,REP,240104,7,3,71,81,
Garfield,Attorney General,Gentner Drummond,REP,240104,2,10,55,67,
Garfield,Superintendent of Public Instruction,Joy Hofmeister,REP,240104,6,10,79,95,
Garfield,Superintendent of Public Instruction,Linda Murphy,REP,240104,3,3,47,53,
Garfield,Commissioner of Labor,Cathy Costello,REP,240104,6,3,65,74,
Garfield,Commissioner of Labor,Leslie Osborn,REP,240104,3,10,60,73,
Garfield,Corporation Commissioner,Bob Anthony,REP,240104,6,5,59,70,
Garfield,Corporation Commissioner,Brian Bingman,REP,240104,3,8,64,75,
Garfield,Governor,Chris Powell,LIB,240104,0,0,0,0,
Garfield,Governor,Rex Lawhorn,LIB,240104,0,0,0,0,
Garfield,Corporation Commissioner,Ashley Nicole Mccray,DEM,240104,2,0,32,34,
Garfield,Corporation Commissioner,Blake Cummings,DEM,240104,3,0,17,20,
Garfield,Governor,Mick Cornett,REP,240105,0,4,69,73,
Garfield,Governor,Kevin Stitt,REP,240105,0,0,57,57,
Garfield,Lieutenant Governor,Dana Murphy,REP,240105,0,3,58,61,
Garfield,Lieutenant Governor,Matt Pinnell,REP,240105,0,1,67,68,
Garfield,State Auditor,Cindy Byrd,REP,240105,0,2,50,52,
Garfield,State Auditor,Charlie Prater,REP,240105,0,2,74,76,
Garfield,Attorney General,Mike Hunter,REP,240105,0,2,68,70,
Garfield,Attorney General,Gentner Drummond,REP,240105,0,2,58,60,
Garfield,Superintendent of Public Instruction,Joy Hofmeister,REP,240105,0,3,71,74,
Garfield,Superintendent of Public Instruction,Linda Murphy,REP,240105,0,1,54,55,
Garfield,Commissioner of Labor,Cathy Costello,REP,240105,0,1,56,57,
Garfield,Commissioner of Labor,Leslie Osborn,REP,240105,0,3,69,72,
Garfield,Corporation Commissioner,Bob Anthony,REP,240105,0,4,62,66,
Garfield,Corporation Commissioner,Brian Bingman,REP,240105,0,0,61,61,
Garfield,State House,Roxanne Pollard,REP,240105,0,2,61,63,41
Garfield,State House,Denise Crosswhite Hader,REP,240105,0,2,65,67,41
Garfield,Governor,Chris Powell,LIB,240105,0,0,0,0,
Garfield,Governor,Rex Lawhorn,LIB,240105,0,0,0,0,
Garfield,Corporation Commissioner,Ashley Nicole Mccray,DEM,240105,2,2,26,30,
Garfield,Corporation Commissioner,Blake Cummings,DEM,240105,0,5,14,19,
Garfield,State House,Sara Peterson,DEM,240105,0,0,7,7,41
Garfield,State House,Jennie Scott,DEM,240105,2,7,35,44,41
Garfield,Governor,Mick Cornett,REP,240106,1,5,82,88,
Garfield,Governor,Kevin Stitt,REP,240106,0,0,58,58,
Garfield,Lieutenant Governor,Dana Murphy,REP,240106,1,2,66,69,
Garfield,Lieutenant Governor,Matt Pinnell,REP,240106,0,3,75,78,
Garfield,State Auditor,Cindy Byrd,REP,240106,1,2,60,63,
Garfield,State Auditor,Charlie Prater,REP,240106,0,3,74,77,
Garfield,Attorney General,Mike Hunter,REP,240106,1,2,80,83,
Garfield,Attorney General,Gentner Drummond,REP,240106,0,3,61,64,
Garfield,Superintendent of Public Instruction,Joy Hofmeister,REP,240106,1,2,104,107,
Garfield,Superintendent of Public Instruction,Linda Murphy,REP,240106,0,3,38,41,
Garfield,Commissioner of Labor,Cathy Costello,REP,240106,1,1,53,55,
Garfield,Commissioner of Labor,Leslie Osborn,REP,240106,0,4,87,91,
Garfield,Corporation Commissioner,Bob Anthony,REP,240106,1,2,86,89,
Garfield,Corporation Commissioner,Brian Bingman,REP,240106,0,3,53,56,
Garfield,State House,John Pfeiffer,REP,240106,1,3,94,98,38
Garfield,State House,Brian Hobbs,REP,240106,0,2,48,50,38
Garfield,Governor,Chris Powell,LIB,240106,0,0,0,0,
Garfield,Governor,Rex Lawhorn,LIB,240106,0,0,0,0,
Garfield,Corporation Commissioner,Ashley Nicole Mccray,DEM,240106,0,0,19,19,
Garfield,Corporation Commissioner,Blake Cummings,DEM,240106,1,0,7,8,
Garfield,Governor,Mick Cornett,REP,240107,2,4,17,23,
Garfield,Governor,Kevin Stitt,REP,240107,1,0,25,26,
Garfield,Lieutenant Governor,Dana Murphy,REP,240107,1,2,15,18,
Garfield,Lieutenant Governor,Matt Pinnell,REP,240107,2,2,27,31,
Garfield,State Auditor,Cindy Byrd,REP,240107,2,1,13,16,
Garfield,State Auditor,Charlie Prater,REP,240107,1,3,27,31,
Garfield,Attorney General,Mike Hunter,REP,240107,3,4,28,35,
Garfield,Attorney General,Gentner Drummond,REP,240107,0,0,14,14,
Garfield,Superintendent of Public Instruction,Joy Hofmeister,REP,240107,2,1,25,28,
Garfield,Superintendent of Public Instruction,Linda Murphy,REP,240107,1,3,17,21,
Garfield,Commissioner of Labor,Cathy Costello,REP,240107,2,1,17,20,
Garfield,Commissioner of Labor,Leslie Osborn,REP,240107,1,3,23,27,
Garfield,Corporation Commissioner,Bob Anthony,REP,240107,2,4,23,29,
Garfield,Corporation Commissioner,Brian Bingman,REP,240107,1,0,18,19,
Garfield,State House,Roxanne Pollard,REP,240107,3,4,26,33,41
Garfield,State House,Denise Crosswhite Hader,REP,240107,0,0,16,16,41
Garfield,Governor,Chris Powell,LIB,240107,0,0,0,0,
Garfield,Governor,Rex Lawhorn,LIB,240107,0,0,0,0,
Garfield,Corporation Commissioner,Ashley Nicole Mccray,DEM,240107,0,0,3,3,
Garfield,Corporation Commissioner,Blake Cummings,DEM,240107,0,0,2,2,
Garfield,State House,Sara Peterson,DEM,240107,0,0,3,3,41
Garfield,State House,Jennie Scott,DEM,240107,0,0,2,2,41
Garfield,Governor,Mick Cornett,REP,240108,1,3,25,29,
Garfield,Governor,Kevin Stitt,REP,240108,0,0,6,6,
Garfield,Lieutenant Governor,Dana Murphy,REP,240108,1,3,16,20,
Garfield,Lieutenant Governor,Matt Pinnell,REP,240108,0,0,15,15,
Garfield,State Auditor,Cindy Byrd,REP,240108,0,2,7,9,
Garfield,State Auditor,Charlie Prater,REP,240108,1,0,22,23,
Garfield,Attorney General,Mike Hunter,REP,240108,1,3,24,28,
Garfield,Attorney General,Gentner Drummond,REP,240108,0,0,7,7,
Garfield,Superintendent of Public Instruction,Joy Hofmeister,REP,240108,0,2,13,15,
Garfield,Superintendent of Public Instruction,Linda Murphy,REP,240108,1,1,17,19,
Garfield,Commissioner of Labor,Cathy Costello,REP,240108,1,2,15,18,
Garfield,Commissioner of Labor,Leslie Osborn,REP,240108,0,0,15,15,
Garfield,Corporation Commissioner,Bob Anthony,REP,240108,1,2,21,24,
Garfield,Corporation Commissioner,Brian Bingman,REP,240108,0,1,9,10,
Garfield,State House,John Pfeiffer,REP,240108,0,2,22,24,38
Garfield,State House,Brian Hobbs,REP,240108,1,0,9,10,38
Garfield,Governor,Chris Powell,LIB,240108,0,0,0,0,
Garfield,Governor,Rex Lawhorn,LIB,240108,0,0,0,0,
Garfield,Corporation Commissioner,Ashley Nicole Mccray,DEM,240108,1,1,2,4,
Garfield,Corporation Commissioner,Blake Cummings,DEM,240108,0,0,1,1,
Garfield,Governor,Mick Cornett,REP,240109,0,3,52,55,
Garfield,Governor,Kevin Stitt,REP,240109,0,3,37,40,
Garfield,Lieutenant Governor,Dana Murphy,REP,240109,0,3,34,37,
Garfield,Lieutenant Governor,Matt Pinnell,REP,240109,0,3,53,56,
Garfield,State Auditor,Cindy Byrd,REP,240109,0,4,37,41,
Garfield,State Auditor,Charlie Prater,REP,240109,0,2,50,52,
Garfield,Attorney General,Mike Hunter,REP,240109,0,4,42,46,
Garfield,Attorney General,Gentner Drummond,REP,240109,0,2,46,48,
Garfield,Superintendent of Public Instruction,Joy Hofmeister,REP,240109,0,5,51,56,
Garfield,Superintendent of Public Instruction,Linda Murphy,REP,240109,0,1,35,36,
Garfield,Commissioner of Labor,Cathy Costello,REP,240109,0,4,27,31,
Garfield,Commissioner of Labor,Leslie Osborn,REP,240109,0,2,59,61,
Garfield,Corporation Commissioner,Bob Anthony,REP,240109,0,6,45,51,
Garfield,Corporation Commissioner,Brian Bingman,REP,240109,0,0,41,41,
Garfield,State House,John Pfeiffer,REP,240109,0,4,61,65,38
Garfield,State House,Brian Hobbs,REP,240109,0,2,25,27,38
Garfield,Governor,Chris Powell,LIB,240109,0,0,0,0,
Garfield,Governor,Rex Lawhorn,LIB,240109,0,0,0,0,
Garfield,Corporation Commissioner,Ashley Nicole Mccray,DEM,240109,0,0,10,10,
Garfield,Corporation Commissioner,Blake Cummings,DEM,240109,1,0,4,5,
Garfield,Governor,Mick Cornett,REP,240110,1,7,80,88,
Garfield,Governor,Kevin Stitt,REP,240110,0,4,91,95,
Garfield,Lieutenant Governor,Dana Murphy,REP,240110,1,5,73,79,
Garfield,Lieutenant Governor,Matt Pinnell,REP,240110,0,6,95,101,
Garfield,State Auditor,Cindy Byrd,REP,240110,1,5,80,86,
Garfield,State Auditor,Charlie Prater,REP,240110,0,6,81,87,
Garfield,Attorney General,Mike Hunter,REP,240110,0,6,85,91,
Garfield,Attorney General,Gentner Drummond,REP,240110,1,5,84,90,
Garfield,Superintendent of Public Instruction,Joy Hofmeister,REP,240110,0,6,87,93,
Garfield,Superintendent of Public Instruction,Linda Murphy,REP,240110,1,5,78,84,
Garfield,Commissioner of Labor,Cathy Costello,REP,240110,1,4,75,80,
Garfield,Commissioner of Labor,Leslie Osborn,REP,240110,0,7,91,98,
Garfield,Corporation Commissioner,Bob Anthony,REP,240110,1,4,77,82,
Garfield,Corporation Commissioner,Brian Bingman,REP,240110,0,7,89,96,
Garfield,State House,Roxanne Pollard,REP,240110,0,8,116,124,41
Garfield,State House,Denise Crosswhite Hader,REP,240110,1,3,53,57,41
Garfield,Governor,Chris Powell,LIB,240110,0,0,0,0,
Garfield,Governor,Rex Lawhorn,LIB,240110,0,0,1,1,
Garfield,Corporation Commissioner,Ashley Nicole Mccray,DEM,240110,1,3,31,35,
Garfield,Corporation Commissioner,Blake Cummings,DEM,240110,0,1,12,13,
Garfield,State House,Sara Peterson,DEM,240110,0,1,12,13,41
Garfield,State House,Jennie Scott,DEM,240110,1,3,32,36,41
Garfield,Governor,Mick Cornett,REP,240201,9,21,178,208,
Garfield,Governor,Kevin Stitt,REP,240201,5,11,118,134,
Garfield,Lieutenant Governor,Dana Murphy,REP,240201,12,10,123,145,
Garfield,Lieutenant Governor,Matt Pinnell,REP,240201,2,21,168,191,
Garfield,State Auditor,Cindy Byrd,REP,240201,12,13,146,171,
Garfield,State Auditor,Charlie Prater,REP,240201,1,17,136,154,
Garfield,Attorney General,Mike Hunter,REP,240201,11,20,167,198,
Garfield,Attorney General,Gentner Drummond,REP,240201,3,11,120,134,
Garfield,Superintendent of Public Instruction,Joy Hofmeister,REP,240201,9,21,183,213,
Garfield,Superintendent of Public Instruction,Linda Murphy,REP,240201,5,10,108,123,
Garfield,Commissioner of Labor,Cathy Costello,REP,240201,6,17,155,178,
Garfield,Commissioner of Labor,Leslie Osborn,REP,240201,8,14,129,151,
Garfield,Corporation Commissioner,Bob Anthony,REP,240201,8,22,157,187,
Garfield,Corporation Commissioner,Brian Bingman,REP,240201,6,9,132,147,
Garfield,Governor,Chris Powell,LIB,240201,0,0,0,0,
Garfield,Governor,Rex Lawhorn,LIB,240201,0,0,1,1,
Garfield,Corporation Commissioner,Ashley Nicole Mccray,DEM,240201,2,10,47,59,
Garfield,Corporation Commissioner,Blake Cummings,DEM,240201,0,2,18,20,
Garfield,Governor,Mick Cornett,REP,240202,21,11,181,213,
Garfield,Governor,Kevin Stitt,REP,240202,15,17,134,166,
Garfield,Lieutenant Governor,Dana Murphy,REP,240202,16,18,137,171,
Garfield,Lieutenant Governor,Matt Pinnell,REP,240202,19,11,176,206,
Garfield,State Auditor,Cindy Byrd,REP,240202,19,20,139,178,
Garfield,State Auditor,Charlie Prater,REP,240202,12,8,169,189,
Garfield,Attorney General,Mike Hunter,REP,240202,18,17,179,214,
Garfield,Attorney General,Gentner Drummond,REP,240202,16,12,131,159,
Garfield,Superintendent of Public Instruction,Joy Hofmeister,REP,240202,16,17,191,224,
Garfield,Superintendent of Public Instruction,Linda Murphy,REP,240202,19,11,120,150,
Garfield,Commissioner of Labor,Cathy Costello,REP,240202,16,12,137,165,
Garfield,Commissioner of Labor,Leslie Osborn,REP,240202,18,16,170,204,
Garfield,Corporation Commissioner,Bob Anthony,REP,240202,18,19,171,208,
Garfield,Corporation Commissioner,Brian Bingman,REP,240202,16,10,139,165,
Garfield,Governor,Chris Powell,LIB,240202,0,0,0,0,
Garfield,Governor,Rex Lawhorn,LIB,240202,0,0,0,0,
Garfield,Corporation Commissioner,Ashley Nicole Mccray,DEM,240202,2,7,37,46,
Garfield,Corporation Commissioner,Blake Cummings,DEM,240202,2,4,23,29,
Garfield,Governor,Mick Cornett,REP,240203,4,4,49,57,
Garfield,Governor,Kevin Stitt,REP,240203,1,6,44,51,
Garfield,Lieutenant Governor,Dana Murphy,REP,240203,3,5,38,46,
Garfield,Lieutenant Governor,Matt Pinnell,REP,240203,2,5,55,62,
Garfield,State Auditor,Cindy Byrd,REP,240203,4,3,36,43,
Garfield,State Auditor,Charlie Prater,REP,240203,0,7,56,63,
Garfield,Attorney General,Mike Hunter,REP,240203,3,6,49,58,
Garfield,Attorney General,Gentner Drummond,REP,240203,2,4,43,49,
Garfield,Superintendent of Public Instruction,Joy Hofmeister,REP,240203,3,8,48,59,
Garfield,Superintendent of Public Instruction,Linda Murphy,REP,240203,2,2,44,48,
Garfield,Commissioner of Labor,Cathy Costello,REP,240203,1,5,51,57,
Garfield,Commissioner of Labor,Leslie Osborn,REP,240203,4,5,41,50,
Garfield,Corporation Commissioner,Bob Anthony,REP,240203,3,2,35,40,
Garfield,Corporation Commissioner,Brian Bingman,REP,240203,2,8,57,67,
Garfield,Governor,Chris Powell,LIB,240203,0,0,0,0,
Garfield,Governor,Rex Lawhorn,LIB,240203,0,0,0,0,
Garfield,Corporation Commissioner,Ashley Nicole Mccray,DEM,240203,1,2,14,17,
Garfield,Corporation Commissioner,Blake Cummings,DEM,240203,0,1,13,14,
Garfield,Governor,Mick Cornett,REP,240204,4,23,262,289,
Garfield,Governor,Kevin Stitt,REP,240204,9,15,206,230,
Garfield,Lieutenant Governor,Dana Murphy,REP,240204,3,11,201,215,
Garfield,Lieutenant Governor,Matt Pinnell,REP,240204,10,26,256,292,
Garfield,State Auditor,Cindy Byrd,REP,240204,4,14,234,252,
Garfield,State Auditor,Charlie Prater,REP,240204,9,22,216,247,
Garfield,Attorney General,Mike Hunter,REP,240204,9,20,263,292,
Garfield,Attorney General,Gentner Drummond,REP,240204,3,18,199,220,
Garfield,Superintendent of Public Instruction,Joy Hofmeister,REP,240204,8,28,285,321,
Garfield,Superintendent of Public Instruction,Linda Murphy,REP,240204,5,10,172,187,
Garfield,Commissioner of Labor,Cathy Costello,REP,240204,9,21,241,271,
Garfield,Commissioner of Labor,Leslie Osborn,REP,240204,4,17,213,234,
Garfield,Corporation Commissioner,Bob Anthony,REP,240204,11,20,253,284,
Garfield,Corporation Commissioner,Brian Bingman,REP,240204,2,18,203,223,
Garfield,Governor,Chris Powell,LIB,240204,0,0,0,0,
Garfield,Governor,Rex Lawhorn,LIB,240204,0,0,0,0,
Garfield,Corporation Commissioner,Ashley Nicole Mccray,DEM,240204,2,3,48,53,
Garfield,Corporation Commissioner,Blake Cummings,DEM,240204,0,2,25,27,
Garfield,Governor,Mick Cornett,REP,240206,0,4,94,98,
Garfield,Governor,Kevin Stitt,REP,240206,1,8,97,106,
Garfield,Lieutenant Governor,Dana Murphy,REP,240206,0,7,66,73,
Garfield,Lieutenant Governor,Matt Pinnell,REP,240206,1,5,123,129,
Garfield,State Auditor,Cindy Byrd,REP,240206,0,9,81,90,
Garfield,State Auditor,Charlie Prater,REP,240206,1,3,108,112,
Garfield,Attorney General,Mike Hunter,REP,240206,0,6,122,128,
Garfield,Attorney General,Gentner Drummond,REP,240206,1,6,66,73,
Garfield,Superintendent of Public Instruction,Joy Hofmeister,REP,240206,1,6,103,110,
Garfield,Superintendent of Public Instruction,Linda Murphy,REP,240206,0,5,86,91,
Garfield,Commissioner of Labor,Cathy Costello,REP,240206,0,10,89,99,
Garfield,Commissioner of Labor,Leslie Osborn,REP,240206,1,1,101,103,
Garfield,Corporation Commissioner,Bob Anthony,REP,240206,0,11,101,112,
Garfield,Corporation Commissioner,Brian Bingman,REP,240206,1,1,88,90,
Garfield,Governor,Chris Powell,LIB,240206,0,0,1,1,
Garfield,Governor,Rex Lawhorn,LIB,240206,0,0,0,0,
Garfield,Corporation Commissioner,Ashley Nicole Mccray,DEM,240206,1,1,22,24,
Garfield,Corporation Commissioner,Blake Cummings,DEM,240206,0,0,17,17,
Garfield,Governor,Mick Cornett,REP,240207,0,5,96,101,
Garfield,Governor,Kevin Stitt,REP,240207,2,3,108,113,
Garfield,Lieutenant Governor,Dana Murphy,REP,240207,1,7,80,88,
Garfield,Lieutenant Governor,Matt Pinnell,REP,240207,1,1,121,123,
Garfield,State Auditor,Cindy Byrd,REP,240207,2,7,85,94,
Garfield,State Auditor,Charlie Prater,REP,240207,0,1,115,116,
Garfield,Attorney General,Mike Hunter,REP,240207,1,7,103,111,
Garfield,Attorney General,Gentner Drummond,REP,240207,1,1,95,97,
Garfield,Superintendent of Public Instruction,Joy Hofmeister,REP,240207,1,4,109,114,
Garfield,Superintendent of Public Instruction,Linda Murphy,REP,240207,1,4,93,98,
Garfield,Commissioner of Labor,Cathy Costello,REP,240207,0,0,94,94,
Garfield,Commissioner of Labor,Leslie Osborn,REP,240207,2,8,104,114,
Garfield,Corporation Commissioner,Bob Anthony,REP,240207,0,6,97,103,
Garfield,Corporation Commissioner,Brian Bingman,REP,240207,2,2,103,107,
Garfield,Governor,Chris Powell,LIB,240207,0,0,2,2,
Garfield,Governor,Rex Lawhorn,LIB,240207,0,0,1,1,
Garfield,Corporation Commissioner,Ashley Nicole Mccray,DEM,240207,1,1,19,21,
Garfield,Corporation Commissioner,Blake Cummings,DEM,240207,0,0,11,11,
Garfield,Governor,Mick Cornett,REP,240208,0,1,20,21,
Garfield,Governor,Kevin Stitt,REP,240208,0,0,36,36,
Garfield,Lieutenant Governor,Dana Murphy,REP,240208,0,0,22,22,
Garfield,Lieutenant Governor,Matt Pinnell,REP,240208,0,1,32,33,
Garfield,State Auditor,Cindy Byrd,REP,240208,0,0,26,26,
Garfield,State Auditor,Charlie Prater,REP,240208,0,1,28,29,
Garfield,Attorney General,Mike Hunter,REP,240208,0,1,24,25,
Garfield,Attorney General,Gentner Drummond,REP,240208,0,0,30,30,
Garfield,Superintendent of Public Instruction,Joy Hofmeister,REP,240208,0,1,28,29,
Garfield,Superintendent of Public Instruction,Linda Murphy,REP,240208,0,0,27,27,
Garfield,Commissioner of Labor,Cathy Costello,REP,240208,0,1,20,21,
Garfield,Commissioner of Labor,Leslie Osborn,REP,240208,0,0,34,34,
Garfield,Corporation Commissioner,Bob Anthony,REP,240208,0,1,22,23,
Garfield,Corporation Commissioner,Brian Bingman,REP,240208,0,0,32,32,
Garfield,State House,Roxanne Pollard,REP,240208,0,1,30,31,41
Garfield,State House,Denise Crosswhite Hader,REP,240208,0,0,25,25,41
Garfield,Governor,Chris Powell,LIB,240208,0,0,0,0,
Garfield,Governor,Rex Lawhorn,LIB,240208,0,0,0,0,
Garfield,Corporation Commissioner,Ashley Nicole Mccray,DEM,240208,0,0,4,4,
Garfield,Corporation Commissioner,Blake Cummings,DEM,240208,0,0,2,2,
Garfield,State House,Sara Peterson,DEM,240208,0,0,4,4,41
Garfield,State House,Jennie Scott,DEM,240208,0,1,2,3,41
Garfield,Governor,Mick Cornett,REP,240210,1,2,60,63,
Garfield,Governor,Kevin Stitt,REP,240210,0,2,54,56,
Garfield,Lieutenant Governor,Dana Murphy,REP,240210,0,3,42,45,
Garfield,Lieutenant Governor,Matt Pinnell,REP,240210,1,1,72,74,
Garfield,State Auditor,Cindy Byrd,REP,240210,1,2,54,57,
Garfield,State Auditor,Charlie Prater,REP,240210,0,1,59,60,
Garfield,Attorney General,Mike Hunter,REP,240210,1,3,59,63,
Garfield,Attorney General,Gentner Drummond,REP,240210,0,1,55,56,
Garfield,Superintendent of Public Instruction,Joy Hofmeister,REP,240210,0,4,62,66,
Garfield,Superintendent of Public Instruction,Linda Murphy,REP,240210,1,0,49,50,
Garfield,Commissioner of Labor,Cathy Costello,REP,240210,0,1,37,38,
Garfield,Commissioner of Labor,Leslie Osborn,REP,240210,1,3,75,79,
Garfield,Corporation Commissioner,Bob Anthony,REP,240210,1,1,41,43,
Garfield,Corporation Commissioner,Brian Bingman,REP,240210,0,3,72,75,
Garfield,State House,John Pfeiffer,REP,240210,0,4,76,80,38
Garfield,State House,Brian Hobbs,REP,240210,1,0,38,39,38
Garfield,Governor,Chris Powell,LIB,240210,0,0,0,0,
Garfield,Governor,Rex Lawhorn,LIB,240210,0,0,0,0,
Garfield,Corporation Commissioner,Ashley Nicole Mccray,DEM,240210,1,0,17,18,
Garfield,Corporation Commissioner,Blake Cummings,DEM,240210,1,0,6,7,
Garfield,Governor,Mick Cornett,REP,240211,12,9,84,105,
Garfield,Governor,Kevin Stitt,REP,240211,3,2,112,117,
Garfield,Lieutenant Governor,Dana Murphy,REP,240211,10,8,73,91,
Garfield,Lieutenant Governor,Matt Pinnell,REP,240211,4,3,119,126,
Garfield,State Auditor,Cindy Byrd,REP,240211,8,3,90,101,
Garfield,State Auditor,Charlie Prater,REP,240211,4,7,98,109,
Garfield,Attorney General,Mike Hunter,REP,240211,7,5,99,111,
Garfield,Attorney General,Gentner Drummond,REP,240211,5,6,93,104,
Garfield,Superintendent of Public Instruction,Joy Hofmeister,REP,240211,9,4,118,131,
Garfield,Superintendent of Public Instruction,Linda Murphy,REP,240211,5,7,75,87,
Garfield,Commissioner of Labor,Cathy Costello,REP,240211,10,9,89,108,
Garfield,Commissioner of Labor,Leslie Osborn,REP,240211,3,2,100,105,
Garfield,Corporation Commissioner,Bob Anthony,REP,240211,9,7,95,111,
Garfield,Corporation Commissioner,Brian Bingman,REP,240211,4,4,96,104,
Garfield,State House,John Pfeiffer,REP,240211,9,6,117,132,38
Garfield,State House,Brian Hobbs,REP,240211,5,5,74,84,38
Garfield,Governor,Chris Powell,LIB,240211,0,0,0,0,
Garfield,Governor,Rex Lawhorn,LIB,240211,0,0,0,0,
Garfield,Corporation Commissioner,Ashley Nicole Mccray,DEM,240211,1,0,9,10,
Garfield,Corporation Commissioner,Blake Cummings,DEM,240211,0,0,9,9,
Garfield,Governor,Mick Cornett,REP,240212,5,2,70,77,
Garfield,Governor,Kevin Stitt,REP,240212,2,1,62,65,
Garfield,Lieutenant Governor,Dana Murphy,REP,240212,1,1,71,73,
Garfield,Lieutenant Governor,Matt Pinnell,REP,240212,6,2,59,67,
Garfield,State Auditor,Cindy Byrd,REP,240212,3,2,58,63,
Garfield,State Auditor,Charlie Prater,REP,240212,4,1,72,77,
Garfield,Attorney General,Mike Hunter,REP,240212,7,1,74,82,
Garfield,Attorney General,Gentner Drummond,REP,240212,0,2,56,58,
Garfield,Superintendent of Public Instruction,Joy Hofmeister,REP,240212,4,1,80,85,
Garfield,Superintendent of Public Instruction,Linda Murphy,REP,240212,3,2,52,57,
Garfield,Commissioner of Labor,Cathy Costello,REP,240212,2,2,47,51,
Garfield,Commissioner of Labor,Leslie Osborn,REP,240212,5,1,81,87,
Garfield,Corporation Commissioner,Bob Anthony,REP,240212,6,1,57,64,
Garfield,Corporation Commissioner,Brian Bingman,REP,240212,1,2,74,77,
Garfield,State House,John Pfeiffer,REP,240212,5,1,74,80,38
Garfield,State House,Brian Hobbs,REP,240212,2,2,55,59,38
Garfield,Governor,Chris Powell,LIB,240212,0,0,0,0,
Garfield,Governor,Rex Lawhorn,LIB,240212,0,0,0,0,
Garfield,Corporation Commissioner,Ashley Nicole Mccray,DEM,240212,4,0,10,14,
Garfield,Corporation Commissioner,Blake Cummings,DEM,240212,0,0,9,9,
Garfield,Governor,Mick Cornett,REP,240301,3,10,102,115,
Garfield,Governor,Kevin Stitt,REP,240301,3,3,90,96,
Garfield,Lieutenant Governor,Dana Murphy,REP,240301,2,7,73,82,
Garfield,Lieutenant Governor,Matt Pinnell,REP,240301,4,6,115,125,
Garfield,State Auditor,Cindy Byrd,REP,240301,4,7,89,100,
Garfield,State Auditor,Charlie Prater,REP,240301,0,6,94,100,
Garfield,Attorney General,Mike Hunter,REP,240301,2,10,104,116,
Garfield,Attorney General,Gentner Drummond,REP,240301,4,3,86,93,
Garfield,Superintendent of Public Instruction,Joy Hofmeister,REP,240301,1,8,114,123,
Garfield,Superintendent of Public Instruction,Linda Murphy,REP,240301,4,5,71,80,
Garfield,Commissioner of Labor,Cathy Costello,REP,240301,5,3,79,87,
Garfield,Commissioner of Labor,Leslie Osborn,REP,240301,0,10,99,109,
Garfield,Corporation Commissioner,Bob Anthony,REP,240301,2,10,102,114,
Garfield,Corporation Commissioner,Brian Bingman,REP,240301,4,3,82,89,
Garfield,Governor,Chris Powell,LIB,240301,0,0,0,0,
Garfield,Governor,Rex Lawhorn,LIB,240301,0,0,0,0,
Garfield,Corporation Commissioner,Ashley Nicole Mccray,DEM,240301,0,2,25,27,
Garfield,Corporation Commissioner,Blake Cummings,DEM,240301,0,0,13,13,
Garfield,Governor,Mick Cornett,REP,240302,15,29,248,292,
Garfield,Governor,Kevin Stitt,REP,240302,8,27,211,246,
Garfield,Lieutenant Governor,Dana Murphy,REP,240302,15,25,198,238,
Garfield,Lieutenant Governor,Matt Pinnell,REP,240302,9,30,253,292,
Garfield,State Auditor,Cindy Byrd,REP,240302,13,23,212,248,
Garfield,State Auditor,Charlie Prater,REP,240302,9,31,231,271,
Garfield,Attorney General,Mike Hunter,REP,240302,13,28,243,284,
Garfield,Attorney General,Gentner Drummond,REP,240302,11,28,208,247,
Garfield,Superintendent of Public Instruction,Joy Hofmeister,REP,240302,13,35,274,322,
Garfield,Superintendent of Public Instruction,Linda Murphy,REP,240302,9,21,177,207,
Garfield,Commissioner of Labor,Cathy Costello,REP,240302,16,27,247,290,
Garfield,Commissioner of Labor,Leslie Osborn,REP,240302,6,28,201,235,
Garfield,Corporation Commissioner,Bob Anthony,REP,240302,12,31,233,276,
Garfield,Corporation Commissioner,Brian Bingman,REP,240302,10,25,218,253,
Garfield,State House,Roxanne Pollard,REP,240302,17,34,285,336,41
Garfield,State House,Denise Crosswhite Hader,REP,240302,7,22,173,202,41
Garfield,Governor,Chris Powell,LIB,240302,0,0,1,1,
Garfield,Governor,Rex Lawhorn,LIB,240302,0,0,2,2,
Garfield,Corporation Commissioner,Ashley Nicole Mccray,DEM,240302,2,7,46,55,
Garfield,Corporation Commissioner,Blake Cummings,DEM,240302,2,5,28,35,
Garfield,State House,Sara Peterson,DEM,240302,0,2,14,16,41
Garfield,State House,Jennie Scott,DEM,240302,4,10,63,77,41
Garfield,Governor,Mick Cornett,REP,240304,11,18,275,304,
Garfield,Governor,Kevin Stitt,REP,240304,15,24,220,259,
Garfield,Lieutenant Governor,Dana Murphy,REP,240304,7,15,256,278,
Garfield,Lieutenant Governor,Matt Pinnell,REP,240304,18,27,228,273,
Garfield,State Auditor,Cindy Byrd,REP,240304,16,17,252,285,
Garfield,State Auditor,Charlie Prater,REP,240304,8,25,214,247,
Garfield,Attorney General,Mike Hunter,REP,240304,13,22,308,343,
Garfield,Attorney General,Gentner Drummond,REP,240304,12,20,184,216,
Garfield,Superintendent of Public Instruction,Joy Hofmeister,REP,240304,15,29,308,352,
Garfield,Superintendent of Public Instruction,Linda Murphy,REP,240304,9,12,181,202,
Garfield,Commissioner of Labor,Cathy Costello,REP,240304,11,15,237,263,
Garfield,Commissioner of Labor,Leslie Osborn,REP,240304,13,27,243,283,
Garfield,Corporation Commissioner,Bob Anthony,REP,240304,13,28,265,306,
Garfield,Corporation Commissioner,Brian Bingman,REP,240304,11,14,210,235,
Garfield,State House,Roxanne Pollard,REP,240304,14,30,364,408,41
Garfield,State House,Denise Crosswhite Hader,REP,240304,12,12,130,154,41
Garfield,Governor,Chris Powell,LIB,240304,0,0,0,0,
Garfield,Governor,Rex Lawhorn,LIB,240304,0,0,1,1,
Garfield,Corporation Commissioner,Ashley Nicole Mccray,DEM,240304,6,5,54,65,
Garfield,Corporation Commissioner,Blake Cummings,DEM,240304,3,2,28,33,
Garfield,State House,Sara Peterson,DEM,240304,1,0,17,18,41
Garfield,State House,Jennie Scott,DEM,240304,8,7,69,84,41
Garfield,Governor,Mick Cornett,REP,240305,20,43,243,306,
Garfield,Governor,Kevin Stitt,REP,240305,8,22,201,231,
Garfield,Lieutenant Governor,Dana Murphy,REP,240305,11,27,202,240,
Garfield,Lieutenant Governor,Matt Pinnell,REP,240305,15,37,232,284,
Garfield,State Auditor,Cindy Byrd,REP,240305,19,35,213,267,
Garfield,State Auditor,Charlie Prater,REP,240305,9,26,207,242,
Garfield,Attorney General,Mike Hunter,REP,240305,23,41,290,354,
Garfield,Attorney General,Gentner Drummond,REP,240305,5,24,146,175,
Garfield,Superintendent of Public Instruction,Joy Hofmeister,REP,240305,23,42,286,351,
Garfield,Superintendent of Public Instruction,Linda Murphy,REP,240305,5,22,144,171,
Garfield,Commissioner of Labor,Cathy Costello,REP,240305,9,34,220,263,
Garfield,Commissioner of Labor,Leslie Osborn,REP,240305,18,29,195,242,
Garfield,Corporation Commissioner,Bob Anthony,REP,240305,16,32,239,287,
Garfield,Corporation Commissioner,Brian Bingman,REP,240305,12,32,190,234,
Garfield,Governor,Chris Powell,LIB,240305,0,0,0,0,
Garfield,Governor,Rex Lawhorn,LIB,240305,0,0,0,0,
Garfield,Corporation Commissioner,Ashley Nicole Mccray,DEM,240305,3,2,28,33,
Garfield,Corporation Commissioner,Blake Cummings,DEM,240305,1,6,17,24,
Garfield,Governor,Mick Cornett,REP,240306,2,8,128,138,
Garfield,Governor,Kevin Stitt,REP,240306,2,8,69,79,
Garfield,Lieutenant Governor,Dana Murphy,REP,240306,2,8,84,94,
Garfield,Lieutenant Governor,Matt Pinnell,REP,240306,2,8,111,121,
Garfield,State Auditor,Cindy Byrd,REP,240306,3,7,86,96,
Garfield,State Auditor,Charlie Prater,REP,240306,1,9,107,117,
Garfield,Attorney General,Mike Hunter,REP,240306,2,11,117,130,
Garfield,Attorney General,Gentner Drummond,REP,240306,2,5,80,87,
Garfield,Superintendent of Public Instruction,Joy Hofmeister,REP,240306,2,11,127,140,
Garfield,Superintendent of Public Instruction,Linda Murphy,REP,240306,2,5,68,75,
Garfield,Commissioner of Labor,Cathy Costello,REP,240306,3,8,84,95,
Garfield,Commissioner of Labor,Leslie Osborn,REP,240306,1,7,111,119,
Garfield,Corporation Commissioner,Bob Anthony,REP,240306,2,14,88,104,
Garfield,Corporation Commissioner,Brian Bingman,REP,240306,2,2,105,109,
Garfield,Governor,Chris Powell,LIB,240306,0,0,0,0,
Garfield,Governor,Rex Lawhorn,LIB,240306,0,0,0,0,
Garfield,Corporation Commissioner,Ashley Nicole Mccray,DEM,240306,2,2,20,24,
Garfield,Corporation Commissioner,Blake Cummings,DEM,240306,2,1,9,12,
Garfield,Governor,Mick Cornett,REP,240307,3,2,36,41,
Garfield,Governor,Kevin Stitt,REP,240307,2,1,52,55,
Garfield,Lieutenant Governor,Dana Murphy,REP,240307,1,1,32,34,
Garfield,Lieutenant Governor,Matt Pinnell,REP,240307,4,2,54,60,
Garfield,State Auditor,Cindy Byrd,REP,240307,2,0,39,41,
Garfield,State Auditor,Charlie Prater,REP,240307,3,3,45,51,
Garfield,Attorney General,Mike Hunter,REP,240307,2,2,57,61,
Garfield,Attorney General,Gentner Drummond,REP,240307,3,1,30,34,
Garfield,Superintendent of Public Instruction,Joy Hofmeister,REP,240307,5,3,54,62,
Garfield,Superintendent of Public Instruction,Linda Murphy,REP,240307,0,0,34,34,
Garfield,Commissioner of Labor,Cathy Costello,REP,240307,0,0,39,39,
Garfield,Commissioner of Labor,Leslie Osborn,REP,240307,5,3,46,54,
Garfield,Corporation Commissioner,Bob Anthony,REP,240307,3,2,40,45,
Garfield,Corporation Commissioner,Brian Bingman,REP,240307,2,1,45,48,
Garfield,Governor,Chris Powell,LIB,240307,0,0,0,0,
Garfield,Governor,Rex Lawhorn,LIB,240307,0,0,0,0,
Garfield,Corporation Commissioner,Ashley Nicole Mccray,DEM,240307,2,1,2,5,
Garfield,Corporation Commissioner,Blake Cummings,DEM,240307,0,1,7,8,
Garfield,Governor,Mick Cornett,REP,240308,12,14,113,139,
Garfield,Governor,Kevin Stitt,REP,240308,5,3,101,109,
Garfield,Lieutenant Governor,Dana Murphy,REP,240308,3,12,100,115,
Garfield,Lieutenant Governor,Matt Pinnell,REP,240308,14,5,109,128,
Garfield,State Auditor,Cindy Byrd,REP,240308,9,8,98,115,
Garfield,State Auditor,Charlie Prater,REP,240308,8,8,106,122,
Garfield,Attorney General,Mike Hunter,REP,240308,12,12,123,147,
Garfield,Attorney General,Gentner Drummond,REP,240308,5,5,86,96,
Garfield,Superintendent of Public Instruction,Joy Hofmeister,REP,240308,11,14,145,170,
Garfield,Superintendent of Public Instruction,Linda Murphy,REP,240308,6,3,64,73,
Garfield,Commissioner of Labor,Cathy Costello,REP,240308,4,9,88,101,
Garfield,Commissioner of Labor,Leslie Osborn,REP,240308,13,8,115,136,
Garfield,Corporation Commissioner,Bob Anthony,REP,240308,13,12,121,146,
Garfield,Corporation Commissioner,Brian Bingman,REP,240308,5,5,85,95,
Garfield,State House,Roxanne Pollard,REP,240308,10,16,153,179,41
Garfield,State House,Denise Crosswhite Hader,REP,240308,7,1,58,66,41
Garfield,Governor,Chris Powell,LIB,240308,0,0,0,0,
Garfield,Governor,Rex Lawhorn,LIB,240308,0,0,0,0,
Garfield,Corporation Commissioner,Ashley Nicole Mccray,DEM,240308,2,3,22,27,
Garfield,Corporation Commissioner,Blake Cummings,DEM,240308,3,1,9,13,
Garfield,State House,Sara Peterson,DEM,240308,3,0,7,10,41
Garfield,State House,Jennie Scott,DEM,240308,2,5,23,30,41
Garfield,Governor,Mick Cornett,REP,240309,2,1,81,84,
Garfield,Governor,Kevin Stitt,REP,240309,0,9,90,99,
Garfield,Lieutenant Governor,Dana Murphy,REP,240309,2,3,71,76,
Garfield,Lieutenant Governor,Matt Pinnell,REP,240309,0,7,96,103,
Garfield,State Auditor,Cindy Byrd,REP,240309,1,6,76,83,
Garfield,State Auditor,Charlie Prater,REP,240309,1,3,89,93,
Garfield,Attorney General,Mike Hunter,REP,240309,2,4,77,83,
Garfield,Attorney General,Gentner Drummond,REP,240309,0,7,93,100,
Garfield,Superintendent of Public Instruction,Joy Hofmeister,REP,240309,1,4,91,96,
Garfield,Superintendent of Public Instruction,Linda Murphy,REP,240309,1,6,79,86,
Garfield,Commissioner of Labor,Cathy Costello,REP,240309,1,6,73,80,
Garfield,Commissioner of Labor,Leslie Osborn,REP,240309,1,4,93,98,
Garfield,Corporation Commissioner,Bob Anthony,REP,240309,1,7,93,101,
Garfield,Corporation Commissioner,Brian Bingman,REP,240309,1,3,73,77,
Garfield,State House,Roxanne Pollard,REP,240309,1,2,109,112,41
Garfield,State House,Denise Crosswhite Hader,REP,240309,1,9,61,71,41
Garfield,Governor,Chris Powell,LIB,240309,0,0,0,0,
Garfield,Governor,Rex Lawhorn,LIB,240309,0,0,0,0,
Garfield,Corporation Commissioner,Ashley Nicole Mccray,DEM,240309,3,1,13,17,
Garfield,Corporation Commissioner,Blake Cummings,DEM,240309,0,0,6,6,
Garfield,State House,Sara Peterson,DEM,240309,2,0,8,10,41
Garfield,State House,Jennie Scott,DEM,240309,1,1,11,13,41
Garfield,Governor,Mick Cornett,REP,240310,6,8,116,130,
Garfield,Governor,Kevin Stitt,REP,240310,3,6,91,100,
Garfield,Lieutenant Governor,Dana Murphy,REP,240310,4,10,94,108,
Garfield,Lieutenant Governor,Matt Pinnell,REP,240310,4,4,112,120,
Garfield,State Auditor,Cindy Byrd,REP,240310,6,4,103,113,
Garfield,State Auditor,Charlie Prater,REP,240310,2,10,100,112,
Garfield,Attorney General,Mike Hunter,REP,240310,5,6,109,120,
Garfield,Attorney General,Gentner Drummond,REP,240310,4,8,99,111,
Garfield,Superintendent of Public Instruction,Joy Hofmeister,REP,240310,6,6,121,133,
Garfield,Superintendent of Public Instruction,Linda Murphy,REP,240310,3,8,83,94,
Garfield,Commissioner of Labor,Cathy Costello,REP,240310,3,6,111,120,
Garfield,Commissioner of Labor,Leslie Osborn,REP,240310,5,8,92,105,
Garfield,Corporation Commissioner,Bob Anthony,REP,240310,8,8,81,97,
Garfield,Corporation Commissioner,Brian Bingman,REP,240310,1,6,124,131,
Garfield,State House,Roxanne Pollard,REP,240310,7,10,141,158,41
Garfield,State House,Denise Crosswhite Hader,REP,240310,2,4,65,71,41
Garfield,Governor,Chris Powell,LIB,240310,0,0,0,0,
Garfield,Governor,Rex Lawhorn,LIB,240310,0,0,0,0,
Garfield,Corporation Commissioner,Ashley Nicole Mccray,DEM,240310,0,1,20,21,
Garfield,Corporation Commissioner,Blake Cummings,DEM,240310,0,1,14,15,
Garfield,State House,Sara Peterson,DEM,240310,0,2,12,14,41
Garfield,State House,Jennie Scott,DEM,240310,0,0,22,22,41
Garfield,Governor,Mick Cornett,REP,240311,5,13,187,205,
Garfield,Governor,Kevin Stitt,REP,240311,3,7,139,149,
Garfield,Lieutenant Governor,Dana Murphy,REP,240311,2,7,163,172,
Garfield,Lieutenant Governor,Matt Pinnell,REP,240311,6,13,161,180,
Garfield,State Auditor,Cindy Byrd,REP,240311,6,12,167,185,
Garfield,State Auditor,Charlie Prater,REP,240311,2,7,153,162,
Garfield,Attorney General,Mike Hunter,REP,240311,5,10,183,198,
Garfield,Attorney General,Gentner Drummond,REP,240311,3,10,140,153,
Garfield,Superintendent of Public Instruction,Joy Hofmeister,REP,240311,3,10,192,205,
Garfield,Superintendent of Public Instruction,Linda Murphy,REP,240311,5,10,131,146,
Garfield,Commissioner of Labor,Cathy Costello,REP,240311,4,10,148,162,
Garfield,Commissioner of Labor,Leslie Osborn,REP,240311,4,10,172,186,
Garfield,Corporation Commissioner,Bob Anthony,REP,240311,5,10,155,170,
Garfield,Corporation Commissioner,Brian Bingman,REP,240311,3,10,167,180,
Garfield,State House,Roxanne Pollard,REP,240311,5,11,252,268,41
Garfield,State House,Denise Crosswhite Hader,REP,240311,3,9,72,84,41
Garfield,Governor,Chris Powell,LIB,240311,0,0,0,0,
Garfield,Governor,Rex Lawhorn,LIB,240311,0,0,0,0,
Garfield,Corporation Commissioner,Ashley Nicole Mccray,DEM,240311,1,4,18,23,
Garfield,Corporation Commissioner,Blake Cummings,DEM,240311,1,2,26,29,
Garfield,State House,Sara Peterson,DEM,240311,1,2,18,21,41
Garfield,State House,Jennie Scott,DEM,240311,1,4,26,31,41
Garvin,Governor,Mick Cornett,REP,250001,0,1,42,43,
Garvin,Governor,Kevin Stitt,REP,250001,0,2,35,37,
Garvin,Lieutenant Governor,Dana Murphy,REP,250001,0,2,30,32,
Garvin,Lieutenant Governor,Matt Pinnell,REP,250001,0,1,44,45,
Garvin,State Auditor,Cindy Byrd,REP,250001,0,1,31,32,
Garvin,State Auditor,Charlie Prater,REP,250001,0,2,42,44,
Garvin,Attorney General,Mike Hunter,REP,250001,0,2,38,40,
Garvin,Attorney General,Gentner Drummond,REP,250001,0,1,37,38,
Garvin,Superintendent of Public Instruction,Joy Hofmeister,REP,250001,0,3,37,40,
Garvin,Superintendent of Public Instruction,Linda Murphy,REP,250001,0,0,39,39,
Garvin,Commissioner of Labor,Cathy Costello,REP,250001,0,1,47,48,
Garvin,Commissioner of Labor,Leslie Osborn,REP,250001,0,2,26,28,
Garvin,Corporation Commissioner,Bob Anthony,REP,250001,0,1,43,44,
Garvin,Corporation Commissioner,Brian Bingman,REP,250001,0,2,31,33,
Garvin,Governor,Chris Powell,LIB,250001,0,0,0,0,
Garvin,Governor,Rex Lawhorn,LIB,250001,0,0,0,0,
Garvin,Corporation Commissioner,Ashley Nicole Mccray,DEM,250001,0,0,13,13,
Garvin,Corporation Commissioner,Blake Cummings,DEM,250001,2,0,11,13,
Garvin,U.S. House,Mary Brannon,DEM,250001,0,0,16,16,04
Garvin,U.S. House,Fred Gipson,DEM,250001,2,0,8,10,04
Garvin,Governor,Mick Cornett,REP,250002,0,0,51,51,
Garvin,Governor,Kevin Stitt,REP,250002,1,0,51,52,
Garvin,Lieutenant Governor,Dana Murphy,REP,250002,0,0,40,40,
Garvin,Lieutenant Governor,Matt Pinnell,REP,250002,0,0,61,61,
Garvin,State Auditor,Cindy Byrd,REP,250002,0,0,53,53,
Garvin,State Auditor,Charlie Prater,REP,250002,0,0,47,47,
Garvin,Attorney General,Mike Hunter,REP,250002,1,0,43,44,
Garvin,Attorney General,Gentner Drummond,REP,250002,0,0,59,59,
Garvin,Superintendent of Public Instruction,Joy Hofmeister,REP,250002,1,0,57,58,
Garvin,Superintendent of Public Instruction,Linda Murphy,REP,250002,0,0,44,44,
Garvin,Commissioner of Labor,Cathy Costello,REP,250002,0,0,49,49,
Garvin,Commissioner of Labor,Leslie Osborn,REP,250002,1,0,51,52,
Garvin,Corporation Commissioner,Bob Anthony,REP,250002,1,0,42,43,
Garvin,Corporation Commissioner,Brian Bingman,REP,250002,0,0,61,61,
Garvin,Governor,Chris Powell,LIB,250002,0,0,0,0,
Garvin,Governor,Rex Lawhorn,LIB,250002,0,0,0,0,
Garvin,Corporation Commissioner,Ashley Nicole Mccray,DEM,250002,2,0,20,22,
Garvin,Corporation Commissioner,Blake Cummings,DEM,250002,3,0,25,28,
Garvin,U.S. House,Mary Brannon,DEM,250002,2,0,27,29,04
Garvin,U.S. House,Fred Gipson,DEM,250002,3,0,18,21,04
Garvin,Governor,Mick Cornett,REP,250003,3,0,41,44,
Garvin,Governor,Kevin Stitt,REP,250003,1,4,68,73,
Garvin,Lieutenant Governor,Dana Murphy,REP,250003,0,0,35,35,
Garvin,Lieutenant Governor,Matt Pinnell,REP,250003,4,4,73,81,
Garvin,State Auditor,Cindy Byrd,REP,250003,2,4,48,54,
Garvin,State Auditor,Charlie Prater,REP,250003,2,0,58,60,
Garvin,Attorney General,Mike Hunter,REP,250003,3,0,44,47,
Garvin,Attorney General,Gentner Drummond,REP,250003,1,4,65,70,
Garvin,Superintendent of Public Instruction,Joy Hofmeister,REP,250003,2,2,57,61,
Garvin,Superintendent of Public Instruction,Linda Murphy,REP,250003,2,2,51,55,
Garvin,Commissioner of Labor,Cathy Costello,REP,250003,0,3,35,38,
Garvin,Commissioner of Labor,Leslie Osborn,REP,250003,4,1,74,79,
Garvin,Corporation Commissioner,Bob Anthony,REP,250003,2,3,42,47,
Garvin,Corporation Commissioner,Brian Bingman,REP,250003,2,1,64,67,
Garvin,Governor,Chris Powell,LIB,250003,0,0,0,0,
Garvin,Governor,Rex Lawhorn,LIB,250003,0,0,0,0,
Garvin,Corporation Commissioner,Ashley Nicole Mccray,DEM,250003,1,0,15,16,
Garvin,Corporation Commissioner,Blake Cummings,DEM,250003,0,0,20,20,
Garvin,U.S. House,Mary Brannon,DEM,250003,1,0,23,24,04
Garvin,U.S. House,Fred Gipson,DEM,250003,0,0,12,12,04
Garvin,Governor,Mick Cornett,REP,250005,3,4,56,63,
Garvin,Governor,Kevin Stitt,REP,250005,3,2,68,73,
Garvin,Lieutenant Governor,Dana Murphy,REP,250005,2,2,45,49,
Garvin,Lieutenant Governor,Matt Pinnell,REP,250005,4,4,78,86,
Garvin,State Auditor,Cindy Byrd,REP,250005,0,5,39,44,
Garvin,State Auditor,Charlie Prater,REP,250005,6,1,82,89,
Garvin,Attorney General,Mike Hunter,REP,250005,0,2,53,55,
Garvin,Attorney General,Gentner Drummond,REP,250005,6,4,72,82,
Garvin,Superintendent of Public Instruction,Joy Hofmeister,REP,250005,5,6,70,81,
Garvin,Superintendent of Public Instruction,Linda Murphy,REP,250005,1,0,50,51,
Garvin,Commissioner of Labor,Cathy Costello,REP,250005,5,2,36,43,
Garvin,Commissioner of Labor,Leslie Osborn,REP,250005,1,4,83,88,
Garvin,Corporation Commissioner,Bob Anthony,REP,250005,3,0,51,54,
Garvin,Corporation Commissioner,Brian Bingman,REP,250005,3,6,71,80,
Garvin,Governor,Chris Powell,LIB,250005,0,0,0,0,
Garvin,Governor,Rex Lawhorn,LIB,250005,0,0,0,0,
Garvin,Corporation Commissioner,Ashley Nicole Mccray,DEM,250005,0,0,24,24,
Garvin,Corporation Commissioner,Blake Cummings,DEM,250005,1,2,23,26,
Garvin,U.S. House,Mary Brannon,DEM,250005,1,1,26,28,04
Garvin,U.S. House,Fred Gipson,DEM,250005,0,1,21,22,04
Garvin,Governor,Mick Cornett,REP,250006,0,5,15,20,
Garvin,Governor,Kevin Stitt,REP,250006,0,1,24,25,
Garvin,Lieutenant Governor,Dana Murphy,REP,250006,0,3,13,16,
Garvin,Lieutenant Governor,Matt Pinnell,REP,250006,0,3,25,28,
Garvin,State Auditor,Cindy Byrd,REP,250006,0,4,16,20,
Garvin,State Auditor,Charlie Prater,REP,250006,0,2,20,22,
Garvin,Attorney General,Mike Hunter,REP,250006,0,5,16,21,
Garvin,Attorney General,Gentner Drummond,REP,250006,0,1,21,22,
Garvin,Superintendent of Public Instruction,Joy Hofmeister,REP,250006,0,5,20,25,
Garvin,Superintendent of Public Instruction,Linda Murphy,REP,250006,0,1,17,18,
Garvin,Commissioner of Labor,Cathy Costello,REP,250006,0,2,16,18,
Garvin,Commissioner of Labor,Leslie Osborn,REP,250006,0,4,21,25,
Garvin,Corporation Commissioner,Bob Anthony,REP,250006,0,5,16,21,
Garvin,Corporation Commissioner,Brian Bingman,REP,250006,0,1,21,22,
Garvin,Governor,Chris Powell,LIB,250006,0,0,0,0,
Garvin,Governor,Rex Lawhorn,LIB,250006,0,0,0,0,
Garvin,Corporation Commissioner,Ashley Nicole Mccray,DEM,250006,0,1,17,18,
Garvin,Corporation Commissioner,Blake Cummings,DEM,250006,0,0,14,14,
Garvin,U.S. House,Mary Brannon,DEM,250006,0,1,11,12,04
Garvin,U.S. House,Fred Gipson,DEM,250006,0,0,20,20,04
Garvin,Governor,Mick Cornett,REP,250007,0,7,39,46,
Garvin,Governor,Kevin Stitt,REP,250007,3,5,44,52,
Garvin,Lieutenant Governor,Dana Murphy,REP,250007,2,7,31,40,
Garvin,Lieutenant Governor,Matt Pinnell,REP,250007,1,5,49,55,
Garvin,State Auditor,Cindy Byrd,REP,250007,3,5,37,45,
Garvin,State Auditor,Charlie Prater,REP,250007,0,7,42,49,
Garvin,Attorney General,Mike Hunter,REP,250007,2,8,39,49,
Garvin,Attorney General,Gentner Drummond,REP,250007,1,4,42,47,
Garvin,Superintendent of Public Instruction,Joy Hofmeister,REP,250007,1,7,40,48,
Garvin,Superintendent of Public Instruction,Linda Murphy,REP,250007,2,5,41,48,
Garvin,Commissioner of Labor,Cathy Costello,REP,250007,3,4,27,34,
Garvin,Commissioner of Labor,Leslie Osborn,REP,250007,0,8,51,59,
Garvin,Corporation Commissioner,Bob Anthony,REP,250007,0,8,38,46,
Garvin,Corporation Commissioner,Brian Bingman,REP,250007,3,4,42,49,
Garvin,Governor,Chris Powell,LIB,250007,0,0,0,0,
Garvin,Governor,Rex Lawhorn,LIB,250007,0,0,0,0,
Garvin,Corporation Commissioner,Ashley Nicole Mccray,DEM,250007,2,0,16,18,
Garvin,Corporation Commissioner,Blake Cummings,DEM,250007,0,1,17,18,
Garvin,U.S. House,Mary Brannon,DEM,250007,1,0,14,15,04
Garvin,U.S. House,Fred Gipson,DEM,250007,1,1,19,21,04
Garvin,Governor,Mick Cornett,REP,250008,3,5,47,55,
Garvin,Governor,Kevin Stitt,REP,250008,0,10,43,53,
Garvin,Lieutenant Governor,Dana Murphy,REP,250008,1,4,39,44,
Garvin,Lieutenant Governor,Matt Pinnell,REP,250008,2,11,48,61,
Garvin,State Auditor,Cindy Byrd,REP,250008,3,7,42,52,
Garvin,State Auditor,Charlie Prater,REP,250008,0,8,44,52,
Garvin,Attorney General,Mike Hunter,REP,250008,1,5,44,50,
Garvin,Attorney General,Gentner Drummond,REP,250008,2,10,45,57,
Garvin,Superintendent of Public Instruction,Joy Hofmeister,REP,250008,3,4,47,54,
Garvin,Superintendent of Public Instruction,Linda Murphy,REP,250008,0,11,40,51,
Garvin,Commissioner of Labor,Cathy Costello,REP,250008,3,11,41,55,
Garvin,Commissioner of Labor,Leslie Osborn,REP,250008,0,4,44,48,
Garvin,Corporation Commissioner,Bob Anthony,REP,250008,1,11,55,67,
Garvin,Corporation Commissioner,Brian Bingman,REP,250008,2,4,32,38,
Garvin,Governor,Chris Powell,LIB,250008,0,0,1,1,
Garvin,Governor,Rex Lawhorn,LIB,250008,0,0,0,0,
Garvin,Corporation Commissioner,Ashley Nicole Mccray,DEM,250008,0,0,9,9,
Garvin,Corporation Commissioner,Blake Cummings,DEM,250008,0,2,19,21,
Garvin,U.S. House,Mary Brannon,DEM,250008,0,0,13,13,04
Garvin,U.S. House,Fred Gipson,DEM,250008,0,2,15,17,04
Garvin,Governor,Mick Cornett,REP,250009,1,5,54,60,
Garvin,Governor,Kevin Stitt,REP,250009,2,3,60,65,
Garvin,Lieutenant Governor,Dana Murphy,REP,250009,0,4,46,50,
Garvin,Lieutenant Governor,Matt Pinnell,REP,250009,3,4,67,74,
Garvin,State Auditor,Cindy Byrd,REP,250009,0,7,52,59,
Garvin,State Auditor,Charlie Prater,REP,250009,3,1,60,64,
Garvin,Attorney General,Mike Hunter,REP,250009,0,4,43,47,
Garvin,Attorney General,Gentner Drummond,REP,250009,3,4,70,77,
Garvin,Superintendent of Public Instruction,Joy Hofmeister,REP,250009,0,7,55,62,
Garvin,Superintendent of Public Instruction,Linda Murphy,REP,250009,3,1,57,61,
Garvin,Commissioner of Labor,Cathy Costello,REP,250009,0,3,49,52,
Garvin,Commissioner of Labor,Leslie Osborn,REP,250009,3,5,65,73,
Garvin,Corporation Commissioner,Bob Anthony,REP,250009,0,4,48,52,
Garvin,Corporation Commissioner,Brian Bingman,REP,250009,3,4,64,71,
Garvin,Governor,Chris Powell,LIB,250009,0,0,0,0,
Garvin,Governor,Rex Lawhorn,LIB,250009,0,0,0,0,
Garvin,Corporation Commissioner,Ashley Nicole Mccray,DEM,250009,1,1,32,34,
Garvin,Corporation Commissioner,Blake Cummings,DEM,250009,0,5,33,38,
Garvin,U.S. House,Mary Brannon,DEM,250009,0,5,42,47,04
Garvin,U.S. House,Fred Gipson,DEM,250009,1,1,23,25,04
Garvin,Governor,Mick Cornett,REP,250013,2,1,17,20,
Garvin,Governor,Kevin Stitt,REP,250013,0,0,33,33,
Garvin,Lieutenant Governor,Dana Murphy,REP,250013,0,0,30,30,
Garvin,Lieutenant Governor,Matt Pinnell,REP,250013,2,1,18,21,
Garvin,State Auditor,Cindy Byrd,REP,250013,0,0,27,27,
Garvin,State Auditor,Charlie Prater,REP,250013,2,0,21,23,
Garvin,Attorney General,Mike Hunter,REP,250013,0,0,21,21,
Garvin,Attorney General,Gentner Drummond,REP,250013,2,1,29,32,
Garvin,Superintendent of Public Instruction,Joy Hofmeister,REP,250013,0,0,23,23,
Garvin,Superintendent of Public Instruction,Linda Murphy,REP,250013,2,1,24,27,
Garvin,Commissioner of Labor,Cathy Costello,REP,250013,0,1,18,19,
Garvin,Commissioner of Labor,Leslie Osborn,REP,250013,2,0,29,31,
Garvin,Corporation Commissioner,Bob Anthony,REP,250013,0,0,30,30,
Garvin,Corporation Commissioner,Brian Bingman,REP,250013,2,1,18,21,
Garvin,Governor,Chris Powell,LIB,250013,0,0,0,0,
Garvin,Governor,Rex Lawhorn,LIB,250013,0,0,0,0,
Garvin,Corporation Commissioner,Ashley Nicole Mccray,DEM,250013,0,1,20,21,
Garvin,Corporation Commissioner,Blake Cummings,DEM,250013,1,0,12,13,
Garvin,U.S. House,Mary Brannon,DEM,250013,0,1,15,16,04
Garvin,U.S. House,Fred Gipson,DEM,250013,1,0,17,18,04
Garvin,Governor,Mick Cornett,REP,250015,1,8,50,59,
Garvin,Governor,Kevin Stitt,REP,250015,1,10,48,59,
Garvin,Lieutenant Governor,Dana Murphy,REP,250015,0,4,34,38,
Garvin,Lieutenant Governor,Matt Pinnell,REP,250015,2,14,65,81,
Garvin,State Auditor,Cindy Byrd,REP,250015,1,7,45,53,
Garvin,State Auditor,Charlie Prater,REP,250015,1,11,53,65,
Garvin,Attorney General,Mike Hunter,REP,250015,1,14,44,59,
Garvin,Attorney General,Gentner Drummond,REP,250015,1,4,53,58,
Garvin,Superintendent of Public Instruction,Joy Hofmeister,REP,250015,2,10,53,65,
Garvin,Superintendent of Public Instruction,Linda Murphy,REP,250015,0,8,46,54,
Garvin,Commissioner of Labor,Cathy Costello,REP,250015,2,10,49,61,
Garvin,Commissioner of Labor,Leslie Osborn,REP,250015,0,8,48,56,
Garvin,Corporation Commissioner,Bob Anthony,REP,250015,2,14,48,64,
Garvin,Corporation Commissioner,Brian Bingman,REP,250015,0,4,51,55,
Garvin,Governor,Chris Powell,LIB,250015,0,0,0,0,
Garvin,Governor,Rex Lawhorn,LIB,250015,0,0,0,0,
Garvin,Corporation Commissioner,Ashley Nicole Mccray,DEM,250015,0,4,20,24,
Garvin,Corporation Commissioner,Blake Cummings,DEM,250015,0,3,26,29,
Garvin,U.S. House,Mary Brannon,DEM,250015,0,4,18,22,04
Garvin,U.S. House,Fred Gipson,DEM,250015,0,3,28,31,04
Garvin,Governor,Mick Cornett,REP,250016,4,4,42,50,
Garvin,Governor,Kevin Stitt,REP,250016,3,4,46,53,
Garvin,Lieutenant Governor,Dana Murphy,REP,250016,5,4,36,45,
Garvin,Lieutenant Governor,Matt Pinnell,REP,250016,2,4,51,57,
Garvin,State Auditor,Cindy Byrd,REP,250016,3,6,38,47,
Garvin,State Auditor,Charlie Prater,REP,250016,3,1,45,49,
Garvin,Attorney General,Mike Hunter,REP,250016,7,5,48,60,
Garvin,Attorney General,Gentner Drummond,REP,250016,0,3,39,42,
Garvin,Superintendent of Public Instruction,Joy Hofmeister,REP,250016,4,3,40,47,
Garvin,Superintendent of Public Instruction,Linda Murphy,REP,250016,3,5,44,52,
Garvin,Commissioner of Labor,Cathy Costello,REP,250016,6,4,37,47,
Garvin,Commissioner of Labor,Leslie Osborn,REP,250016,1,4,47,52,
Garvin,Corporation Commissioner,Bob Anthony,REP,250016,7,5,40,52,
Garvin,Corporation Commissioner,Brian Bingman,REP,250016,0,3,44,47,
Garvin,Governor,Chris Powell,LIB,250016,0,0,0,0,
Garvin,Governor,Rex Lawhorn,LIB,250016,0,0,0,0,
Garvin,Corporation Commissioner,Ashley Nicole Mccray,DEM,250016,2,4,16,22,
Garvin,Corporation Commissioner,Blake Cummings,DEM,250016,0,3,16,19,
Garvin,U.S. House,Mary Brannon,DEM,250016,0,3,13,16,04
Garvin,U.S. House,Fred Gipson,DEM,250016,2,4,19,25,04
Garvin,Governor,Mick Cornett,REP,250017,2,5,50,57,
Garvin,Governor,Kevin Stitt,REP,250017,0,4,25,29,
Garvin,Lieutenant Governor,Dana Murphy,REP,250017,2,1,35,38,
Garvin,Lieutenant Governor,Matt Pinnell,REP,250017,0,8,39,47,
Garvin,State Auditor,Cindy Byrd,REP,250017,1,4,34,39,
Garvin,State Auditor,Charlie Prater,REP,250017,1,5,37,43,
Garvin,Attorney General,Mike Hunter,REP,250017,2,4,44,50,
Garvin,Attorney General,Gentner Drummond,REP,250017,0,5,31,36,
Garvin,Superintendent of Public Instruction,Joy Hofmeister,REP,250017,2,5,49,56,
Garvin,Superintendent of Public Instruction,Linda Murphy,REP,250017,0,4,24,28,
Garvin,Commissioner of Labor,Cathy Costello,REP,250017,2,4,37,43,
Garvin,Commissioner of Labor,Leslie Osborn,REP,250017,0,5,35,40,
Garvin,Corporation Commissioner,Bob Anthony,REP,250017,2,5,40,47,
Garvin,Corporation Commissioner,Brian Bingman,REP,250017,0,3,34,37,
Garvin,Governor,Chris Powell,LIB,250017,0,0,0,0,
Garvin,Governor,Rex Lawhorn,LIB,250017,0,0,0,0,
Garvin,Corporation Commissioner,Ashley Nicole Mccray,DEM,250017,1,2,19,22,
Garvin,Corporation Commissioner,Blake Cummings,DEM,250017,0,2,23,25,
Garvin,U.S. House,Mary Brannon,DEM,250017,1,2,22,25,04
Garvin,U.S. House,Fred Gipson,DEM,250017,0,2,20,22,04
Garvin,Governor,Mick Cornett,REP,250018,5,10,63,78,
Garvin,Governor,Kevin Stitt,REP,250018,4,9,87,100,
Garvin,Lieutenant Governor,Dana Murphy,REP,250018,4,8,62,74,
Garvin,Lieutenant Governor,Matt Pinnell,REP,250018,5,11,85,101,
Garvin,State Auditor,Cindy Byrd,REP,250018,5,9,70,84,
Garvin,State Auditor,Charlie Prater,REP,250018,4,10,74,88,
Garvin,Attorney General,Mike Hunter,REP,250018,3,14,67,84,
Garvin,Attorney General,Gentner Drummond,REP,250018,6,5,81,92,
Garvin,Superintendent of Public Instruction,Joy Hofmeister,REP,250018,6,9,91,106,
Garvin,Superintendent of Public Instruction,Linda Murphy,REP,250018,3,10,56,69,
Garvin,Commissioner of Labor,Cathy Costello,REP,250018,4,12,74,90,
Garvin,Commissioner of Labor,Leslie Osborn,REP,250018,5,7,73,85,
Garvin,Corporation Commissioner,Bob Anthony,REP,250018,7,8,73,88,
Garvin,Corporation Commissioner,Brian Bingman,REP,250018,2,11,75,88,
Garvin,State House,Bobby Cleveland,REP,250018,5,10,71,86,20
Garvin,State House,Sherrie Conley,REP,250018,4,9,75,88,20
Garvin,Governor,Chris Powell,LIB,250018,0,0,1,1,
Garvin,Governor,Rex Lawhorn,LIB,250018,0,0,0,0,
Garvin,Corporation Commissioner,Ashley Nicole Mccray,DEM,250018,4,1,28,33,
Garvin,Corporation Commissioner,Blake Cummings,DEM,250018,2,2,40,44,
Garvin,U.S. House,Mary Brannon,DEM,250018,4,1,34,39,04
Garvin,U.S. House,Fred Gipson,DEM,250018,2,2,34,38,04
Garvin,Governor,Mick Cornett,REP,250020,2,4,41,47,
Garvin,Governor,Kevin Stitt,REP,250020,3,1,59,63,
Garvin,Lieutenant Governor,Dana Murphy,REP,250020,2,3,41,46,
Garvin,Lieutenant Governor,Matt Pinnell,REP,250020,3,2,60,65,
Garvin,State Auditor,Cindy Byrd,REP,250020,2,2,36,40,
Garvin,State Auditor,Charlie Prater,REP,250020,3,2,63,68,
Garvin,Attorney General,Mike Hunter,REP,250020,1,2,48,51,
Garvin,Attorney General,Gentner Drummond,REP,250020,4,3,53,60,
Garvin,Superintendent of Public Instruction,Joy Hofmeister,REP,250020,3,4,61,68,
Garvin,Superintendent of Public Instruction,Linda Murphy,REP,250020,1,1,40,42,
Garvin,Commissioner of Labor,Cathy Costello,REP,250020,1,2,43,46,
Garvin,Commissioner of Labor,Leslie Osborn,REP,250020,4,3,57,64,
Garvin,Corporation Commissioner,Bob Anthony,REP,250020,4,3,46,53,
Garvin,Corporation Commissioner,Brian Bingman,REP,250020,1,2,55,58,
Garvin,Governor,Chris Powell,LIB,250020,0,0,0,0,
Garvin,Governor,Rex Lawhorn,LIB,250020,0,0,0,0,
Garvin,Corporation Commissioner,Ashley Nicole Mccray,DEM,250020,0,1,51,52,
Garvin,Corporation Commissioner,Blake Cummings,DEM,250020,0,1,43,44,
Garvin,U.S. House,Mary Brannon,DEM,250020,0,1,62,63,04
Garvin,U.S. House,Fred Gipson,DEM,250020,0,1,33,34,04
Garvin,Governor,Mick Cornett,REP,250021,0,0,0,0,
Garvin,Governor,Kevin Stitt,REP,250021,0,0,1,1,
Garvin,Lieutenant Governor,Dana Murphy,REP,250021,0,0,1,1,
Garvin,Lieutenant Governor,Matt Pinnell,REP,250021,0,0,0,0,
Garvin,State Auditor,Cindy Byrd,REP,250021,0,0,1,1,
Garvin,State Auditor,Charlie Prater,REP,250021,0,0,0,0,
Garvin,Attorney General,Mike Hunter,REP,250021,0,0,0,0,
Garvin,Attorney General,Gentner Drummond,REP,250021,0,0,1,1,
Garvin,Superintendent of Public Instruction,Joy Hofmeister,REP,250021,0,0,0,0,
Garvin,Superintendent of Public Instruction,Linda Murphy,REP,250021,0,0,1,1,
Garvin,Commissioner of Labor,Cathy Costello,REP,250021,0,0,0,0,
Garvin,Commissioner of Labor,Leslie Osborn,REP,250021,0,0,1,1,
Garvin,Corporation Commissioner,Bob Anthony,REP,250021,0,0,1,1,
Garvin,Corporation Commissioner,Brian Bingman,REP,250021,0,0,0,0,
Garvin,State House,Bobby Cleveland,REP,250021,0,0,1,1,20
Garvin,State House,Sherrie Conley,REP,250021,0,0,0,0,20
Garvin,Governor,Chris Powell,LIB,250021,0,0,0,0,
Garvin,Governor,Rex Lawhorn,LIB,250021,0,0,0,0,
Garvin,Corporation Commissioner,Ashley Nicole Mccray,DEM,250021,0,0,1,1,
Garvin,Corporation Commissioner,Blake Cummings,DEM,250021,0,0,0,0,
Garvin,U.S. House,Mary Brannon,DEM,250021,0,0,0,0,04
Garvin,U.S. House,Fred Gipson,DEM,250021,0,0,1,1,04
Garvin,Governor,Mick Cornett,REP,250024,0,0,54,54,
Garvin,Governor,Kevin Stitt,REP,250024,0,0,50,50,
Garvin,Lieutenant Governor,Dana Murphy,REP,250024,0,0,46,46,
Garvin,Lieutenant Governor,Matt Pinnell,REP,250024,0,0,55,55,
Garvin,State Auditor,Cindy Byrd,REP,250024,0,0,54,54,
Garvin,State Auditor,Charlie Prater,REP,250024,0,0,48,48,
Garvin,Attorney General,Mike Hunter,REP,250024,0,0,40,40,
Garvin,Attorney General,Gentner Drummond,REP,250024,0,0,63,63,
Garvin,Superintendent of Public Instruction,Joy Hofmeister,REP,250024,0,0,52,52,
Garvin,Superintendent of Public Instruction,Linda Murphy,REP,250024,0,0,50,50,
Garvin,Commissioner of Labor,Cathy Costello,REP,250024,0,0,49,49,
Garvin,Commissioner of Labor,Leslie Osborn,REP,250024,0,0,54,54,
Garvin,Corporation Commissioner,Bob Anthony,REP,250024,0,0,70,70,
Garvin,Corporation Commissioner,Brian Bingman,REP,250024,0,0,33,33,
Garvin,Governor,Chris Powell,LIB,250024,0,0,0,0,
Garvin,Governor,Rex Lawhorn,LIB,250024,0,0,0,0,
Garvin,Corporation Commissioner,Ashley Nicole Mccray,DEM,250024,1,1,18,20,
Garvin,Corporation Commissioner,Blake Cummings,DEM,250024,0,0,19,19,
Garvin,U.S. House,Mary Brannon,DEM,250024,1,0,19,20,04
Garvin,U.S. House,Fred Gipson,DEM,250024,0,1,19,20,04
Garvin,Governor,Mick Cornett,REP,250025,0,1,33,34,
Garvin,Governor,Kevin Stitt,REP,250025,2,3,49,54,
Garvin,Lieutenant Governor,Dana Murphy,REP,250025,0,3,29,32,
Garvin,Lieutenant Governor,Matt Pinnell,REP,250025,2,1,51,54,
Garvin,State Auditor,Cindy Byrd,REP,250025,2,2,38,42,
Garvin,State Auditor,Charlie Prater,REP,250025,0,2,41,43,
Garvin,Attorney General,Mike Hunter,REP,250025,0,1,35,36,
Garvin,Attorney General,Gentner Drummond,REP,250025,2,3,46,51,
Garvin,Superintendent of Public Instruction,Joy Hofmeister,REP,250025,2,2,47,51,
Garvin,Superintendent of Public Instruction,Linda Murphy,REP,250025,0,2,33,35,
Garvin,Commissioner of Labor,Cathy Costello,REP,250025,0,0,25,25,
Garvin,Commissioner of Labor,Leslie Osborn,REP,250025,2,4,51,57,
Garvin,Corporation Commissioner,Bob Anthony,REP,250025,2,1,39,42,
Garvin,Corporation Commissioner,Brian Bingman,REP,250025,0,3,40,43,
Garvin,State House,Bobby Cleveland,REP,250025,2,2,52,56,20
Garvin,State House,Sherrie Conley,REP,250025,0,2,27,29,20
Garvin,Governor,Chris Powell,LIB,250025,0,0,0,0,
Garvin,Governor,Rex Lawhorn,LIB,250025,0,0,1,1,
Garvin,Corporation Commissioner,Ashley Nicole Mccray,DEM,250025,4,2,13,19,
Garvin,Corporation Commissioner,Blake Cummings,DEM,250025,2,1,10,13,
Garvin,U.S. House,Mary Brannon,DEM,250025,4,0,12,16,04
Garvin,U.S. House,Fred Gipson,DEM,250025,2,3,11,16,04
Grady,Governor,Mick Cornett,REP,260001,4,5,74,83,
Grady,Governor,Kevin Stitt,REP,260001,3,7,55,65,
Grady,Lieutenant Governor,Dana Murphy,REP,260001,5,3,59,67,
Grady,Lieutenant Governor,Matt Pinnell,REP,260001,2,7,68,77,
Grady,State Auditor,Cindy Byrd,REP,260001,6,6,49,61,
Grady,State Auditor,Charlie Prater,REP,260001,1,4,75,80,
Grady,Attorney General,Mike Hunter,REP,260001,2,6,59,67,
Grady,Attorney General,Gentner Drummond,REP,260001,5,4,68,77,
Grady,Superintendent of Public Instruction,Joy Hofmeister,REP,260001,5,6,79,90,
Grady,Superintendent of Public Instruction,Linda Murphy,REP,260001,2,4,49,55,
Grady,Commissioner of Labor,Cathy Costello,REP,260001,4,3,37,44,
Grady,Commissioner of Labor,Leslie Osborn,REP,260001,3,7,90,100,
Grady,Corporation Commissioner,Bob Anthony,REP,260001,5,8,58,71,
Grady,Corporation Commissioner,Brian Bingman,REP,260001,2,3,67,72,
Grady,Governor,Chris Powell,LIB,260001,0,0,1,1,
Grady,Governor,Rex Lawhorn,LIB,260001,0,0,0,0,
Grady,Corporation Commissioner,Ashley Nicole Mccray,DEM,260001,3,3,19,25,
Grady,Corporation Commissioner,Blake Cummings,DEM,260001,2,1,15,18,
Grady,U.S. House,Mary Brannon,DEM,260001,1,3,22,26,04
Grady,U.S. House,Fred Gipson,DEM,260001,4,1,12,17,04
Grady,Governor,Mick Cornett,REP,260002,8,12,92,112,
Grady,Governor,Kevin Stitt,REP,260002,3,8,93,104,
Grady,Lieutenant Governor,Dana Murphy,REP,260002,7,8,52,67,
Grady,Lieutenant Governor,Matt Pinnell,REP,260002,4,12,131,147,
Grady,State Auditor,Cindy Byrd,REP,260002,11,11,91,113,
Grady,State Auditor,Charlie Prater,REP,260002,0,8,87,95,
Grady,Attorney General,Mike Hunter,REP,260002,3,9,106,118,
Grady,Attorney General,Gentner Drummond,REP,260002,8,11,78,97,
Grady,Superintendent of Public Instruction,Joy Hofmeister,REP,260002,4,15,111,130,
Grady,Superintendent of Public Instruction,Linda Murphy,REP,260002,7,5,71,83,
Grady,Commissioner of Labor,Cathy Costello,REP,260002,4,6,63,73,
Grady,Commissioner of Labor,Leslie Osborn,REP,260002,7,13,121,141,
Grady,Corporation Commissioner,Bob Anthony,REP,260002,6,8,104,118,
Grady,Corporation Commissioner,Brian Bingman,REP,260002,5,12,78,95,
Grady,Governor,Chris Powell,LIB,260002,0,0,0,0,
Grady,Governor,Rex Lawhorn,LIB,260002,0,0,0,0,
Grady,Corporation Commissioner,Ashley Nicole Mccray,DEM,260002,1,2,32,35,
Grady,Corporation Commissioner,Blake Cummings,DEM,260002,2,0,29,31,
Grady,U.S. House,Mary Brannon,DEM,260002,4,1,32,37,04
Grady,U.S. House,Fred Gipson,DEM,260002,0,1,29,30,04
Grady,Governor,Mick Cornett,REP,260003,2,5,63,70,
Grady,Governor,Kevin Stitt,REP,260003,6,8,57,71,
Grady,Lieutenant Governor,Dana Murphy,REP,260003,3,5,38,46,
Grady,Lieutenant Governor,Matt Pinnell,REP,260003,6,8,81,95,
Grady,State Auditor,Cindy Byrd,REP,260003,5,7,60,72,
Grady,State Auditor,Charlie Prater,REP,260003,3,6,59,68,
Grady,Attorney General,Mike Hunter,REP,260003,7,4,51,62,
Grady,Attorney General,Gentner Drummond,REP,260003,2,9,68,79,
Grady,Superintendent of Public Instruction,Joy Hofmeister,REP,260003,4,9,69,82,
Grady,Superintendent of Public Instruction,Linda Murphy,REP,260003,5,4,49,58,
Grady,Commissioner of Labor,Cathy Costello,REP,260003,3,6,36,45,
Grady,Commissioner of Labor,Leslie Osborn,REP,260003,6,7,80,93,
Grady,Corporation Commissioner,Bob Anthony,REP,260003,5,6,53,64,
Grady,Corporation Commissioner,Brian Bingman,REP,260003,4,7,66,77,
Grady,Governor,Chris Powell,LIB,260003,0,0,0,0,
Grady,Governor,Rex Lawhorn,LIB,260003,0,0,0,0,
Grady,Corporation Commissioner,Ashley Nicole Mccray,DEM,260003,1,2,30,33,
Grady,Corporation Commissioner,Blake Cummings,DEM,260003,2,1,12,15,
Grady,U.S. House,Mary Brannon,DEM,260003,0,3,27,30,04
Grady,U.S. House,Fred Gipson,DEM,260003,3,0,15,18,04
Grady,Governor,Mick Cornett,REP,260005,1,6,29,36,
Grady,Governor,Kevin Stitt,REP,260005,2,2,28,32,
Grady,Lieutenant Governor,Dana Murphy,REP,260005,1,1,21,23,
Grady,Lieutenant Governor,Matt Pinnell,REP,260005,2,7,35,44,
Grady,State Auditor,Cindy Byrd,REP,260005,1,3,22,26,
Grady,State Auditor,Charlie Prater,REP,260005,2,5,33,40,
Grady,Attorney General,Mike Hunter,REP,260005,1,3,18,22,
Grady,Attorney General,Gentner Drummond,REP,260005,2,5,39,46,
Grady,Superintendent of Public Instruction,Joy Hofmeister,REP,260005,0,7,33,40,
Grady,Superintendent of Public Instruction,Linda Murphy,REP,260005,3,1,23,27,
Grady,Commissioner of Labor,Cathy Costello,REP,260005,0,1,19,20,
Grady,Commissioner of Labor,Leslie Osborn,REP,260005,3,7,38,48,
Grady,Corporation Commissioner,Bob Anthony,REP,260005,0,5,18,23,
Grady,Corporation Commissioner,Brian Bingman,REP,260005,3,3,37,43,
Grady,Governor,Chris Powell,LIB,260005,0,0,0,0,
Grady,Governor,Rex Lawhorn,LIB,260005,0,0,0,0,
Grady,Corporation Commissioner,Ashley Nicole Mccray,DEM,260005,2,0,21,23,
Grady,Corporation Commissioner,Blake Cummings,DEM,260005,1,1,22,24,
Grady,U.S. House,Mary Brannon,DEM,260005,2,0,20,22,04
Grady,U.S. House,Fred Gipson,DEM,260005,1,1,24,26,04
Grady,Governor,Mick Cornett,REP,260006,8,5,43,56,
Grady,Governor,Kevin Stitt,REP,260006,7,3,52,62,
Grady,Lieutenant Governor,Dana Murphy,REP,260006,7,5,37,49,
Grady,Lieutenant Governor,Matt Pinnell,REP,260006,8,2,58,68,
Grady,State Auditor,Cindy Byrd,REP,260006,9,3,49,61,
Grady,State Auditor,Charlie Prater,REP,260006,6,5,46,57,
Grady,Attorney General,Mike Hunter,REP,260006,12,4,48,64,
Grady,Attorney General,Gentner Drummond,REP,260006,3,4,46,53,
Grady,Superintendent of Public Instruction,Joy Hofmeister,REP,260006,8,5,46,59,
Grady,Superintendent of Public Instruction,Linda Murphy,REP,260006,7,3,49,59,
Grady,Commissioner of Labor,Cathy Costello,REP,260006,7,3,43,53,
Grady,Commissioner of Labor,Leslie Osborn,REP,260006,8,5,52,65,
Grady,Corporation Commissioner,Bob Anthony,REP,260006,6,5,47,58,
Grady,Corporation Commissioner,Brian Bingman,REP,260006,9,3,47,59,
Grady,Governor,Chris Powell,LIB,260006,0,0,0,0,
Grady,Governor,Rex Lawhorn,LIB,260006,0,0,0,0,
Grady,Corporation Commissioner,Ashley Nicole Mccray,DEM,260006,6,0,22,28,
Grady,Corporation Commissioner,Blake Cummings,DEM,260006,5,0,10,15,
Grady,U.S. House,Mary Brannon,DEM,260006,9,0,17,26,04
Grady,U.S. House,Fred Gipson,DEM,260006,2,0,15,17,04
Grady,Governor,Mick Cornett,REP,260008,0,1,50,51,
Grady,Governor,Kevin Stitt,REP,260008,2,2,50,54,
Grady,Lieutenant Governor,Dana Murphy,REP,260008,1,1,35,37,
Grady,Lieutenant Governor,Matt Pinnell,REP,260008,1,2,61,64,
Grady,State Auditor,Cindy Byrd,REP,260008,2,2,65,69,
Grady,State Auditor,Charlie Prater,REP,260008,0,1,34,35,
Grady,Attorney General,Mike Hunter,REP,260008,1,2,50,53,
Grady,Attorney General,Gentner Drummond,REP,260008,1,1,48,50,
Grady,Superintendent of Public Instruction,Joy Hofmeister,REP,260008,1,3,50,54,
Grady,Superintendent of Public Instruction,Linda Murphy,REP,260008,1,0,48,49,
Grady,Commissioner of Labor,Cathy Costello,REP,260008,1,1,36,38,
Grady,Commissioner of Labor,Leslie Osborn,REP,260008,1,2,62,65,
Grady,Corporation Commissioner,Bob Anthony,REP,260008,0,2,51,53,
Grady,Corporation Commissioner,Brian Bingman,REP,260008,2,1,48,51,
Grady,Governor,Chris Powell,LIB,260008,0,0,4,4,
Grady,Governor,Rex Lawhorn,LIB,260008,0,0,0,0,
Grady,Corporation Commissioner,Ashley Nicole Mccray,DEM,260008,1,1,24,26,
Grady,Corporation Commissioner,Blake Cummings,DEM,260008,0,2,17,19,
Grady,U.S. House,Mary Brannon,DEM,260008,1,1,23,25,04
Grady,U.S. House,Fred Gipson,DEM,260008,0,2,18,20,04
Grady,Governor,Mick Cornett,REP,260009,8,4,86,98,
Grady,Governor,Kevin Stitt,REP,260009,3,7,64,74,
Grady,Lieutenant Governor,Dana Murphy,REP,260009,6,7,70,83,
Grady,Lieutenant Governor,Matt Pinnell,REP,260009,5,4,78,87,
Grady,State Auditor,Cindy Byrd,REP,260009,2,4,74,80,
Grady,State Auditor,Charlie Prater,REP,260009,6,7,69,82,
Grady,Attorney General,Mike Hunter,REP,260009,8,6,71,85,
Grady,Attorney General,Gentner Drummond,REP,260009,3,6,73,82,
Grady,Superintendent of Public Instruction,Joy Hofmeister,REP,260009,7,7,85,99,
Grady,Superintendent of Public Instruction,Linda Murphy,REP,260009,4,5,59,68,
Grady,Commissioner of Labor,Cathy Costello,REP,260009,0,3,58,61,
Grady,Commissioner of Labor,Leslie Osborn,REP,260009,11,9,91,111,
Grady,Corporation Commissioner,Bob Anthony,REP,260009,7,7,81,95,
Grady,Corporation Commissioner,Brian Bingman,REP,260009,4,4,64,72,
Grady,Governor,Chris Powell,LIB,260009,0,0,0,0,
Grady,Governor,Rex Lawhorn,LIB,260009,0,0,0,0,
Grady,Corporation Commissioner,Ashley Nicole Mccray,DEM,260009,8,6,46,60,
Grady,Corporation Commissioner,Blake Cummings,DEM,260009,2,3,32,37,
Grady,U.S. House,Mary Brannon,DEM,260009,5,4,45,54,04
Grady,U.S. House,Fred Gipson,DEM,260009,5,5,33,43,04
Grady,Governor,Mick Cornett,REP,260011,2,6,24,32,
Grady,Governor,Kevin Stitt,REP,260011,1,3,31,35,
Grady,Lieutenant Governor,Dana Murphy,REP,260011,1,2,25,28,
Grady,Lieutenant Governor,Matt Pinnell,REP,260011,2,7,29,38,
Grady,State Auditor,Cindy Byrd,REP,260011,1,5,28,34,
Grady,State Auditor,Charlie Prater,REP,260011,2,4,24,30,
Grady,Attorney General,Mike Hunter,REP,260011,3,9,18,30,
Grady,Attorney General,Gentner Drummond,REP,260011,0,0,36,36,
Grady,Superintendent of Public Instruction,Joy Hofmeister,REP,260011,1,8,24,33,
Grady,Superintendent of Public Instruction,Linda Murphy,REP,260011,2,1,29,32,
Grady,Commissioner of Labor,Cathy Costello,REP,260011,2,0,23,25,
Grady,Commissioner of Labor,Leslie Osborn,REP,260011,1,9,31,41,
Grady,Corporation Commissioner,Bob Anthony,REP,260011,2,6,27,35,
Grady,Corporation Commissioner,Brian Bingman,REP,260011,1,3,26,30,
Grady,Governor,Chris Powell,LIB,260011,0,0,0,0,
Grady,Governor,Rex Lawhorn,LIB,260011,0,0,0,0,
Grady,Corporation Commissioner,Ashley Nicole Mccray,DEM,260011,1,2,5,8,
Grady,Corporation Commissioner,Blake Cummings,DEM,260011,1,3,13,17,
Grady,U.S. House,Mary Brannon,DEM,260011,2,2,6,10,04
Grady,U.S. House,Fred Gipson,DEM,260011,0,3,12,15,04
Grady,Governor,Mick Cornett,REP,260016,0,0,10,10,
Grady,Governor,Kevin Stitt,REP,260016,1,0,17,18,
Grady,Lieutenant Governor,Dana Murphy,REP,260016,1,0,11,12,
Grady,Lieutenant Governor,Matt Pinnell,REP,260016,0,0,16,16,
Grady,State Auditor,Cindy Byrd,REP,260016,1,0,12,13,
Grady,State Auditor,Charlie Prater,REP,260016,0,0,15,15,
Grady,Attorney General,Mike Hunter,REP,260016,1,0,15,16,
Grady,Attorney General,Gentner Drummond,REP,260016,0,0,12,12,
Grady,Superintendent of Public Instruction,Joy Hofmeister,REP,260016,0,0,14,14,
Grady,Superintendent of Public Instruction,Linda Murphy,REP,260016,1,0,13,14,
Grady,Commissioner of Labor,Cathy Costello,REP,260016,0,0,7,7,
Grady,Commissioner of Labor,Leslie Osborn,REP,260016,1,0,20,21,
Grady,Corporation Commissioner,Bob Anthony,REP,260016,1,0,15,16,
Grady,Corporation Commissioner,Brian Bingman,REP,260016,0,0,12,12,
Grady,Governor,Chris Powell,LIB,260016,0,0,0,0,
Grady,Governor,Rex Lawhorn,LIB,260016,0,0,0,0,
Grady,Corporation Commissioner,Ashley Nicole Mccray,DEM,260016,5,0,10,15,
Grady,Corporation Commissioner,Blake Cummings,DEM,260016,0,0,15,15,
Grady,U.S. House,Mary Brannon,DEM,260016,5,0,11,16,04
Grady,U.S. House,Fred Gipson,DEM,260016,0,0,14,14,04
Grady,Governor,Mick Cornett,REP,260017,0,1,16,17,
Grady,Governor,Kevin Stitt,REP,260017,0,0,19,19,
Grady,Lieutenant Governor,Dana Murphy,REP,260017,1,0,15,16,
Grady,Lieutenant Governor,Matt Pinnell,REP,260017,0,1,20,21,
Grady,State Auditor,Cindy Byrd,REP,260017,0,0,20,20,
Grady,State Auditor,Charlie Prater,REP,260017,0,1,16,17,
Grady,Attorney General,Mike Hunter,REP,260017,1,0,9,10,
Grady,Attorney General,Gentner Drummond,REP,260017,0,1,27,28,
Grady,Superintendent of Public Instruction,Joy Hofmeister,REP,260017,1,1,7,9,
Grady,Superintendent of Public Instruction,Linda Murphy,REP,260017,0,0,28,28,
Grady,Commissioner of Labor,Cathy Costello,REP,260017,0,1,13,14,
Grady,Commissioner of Labor,Leslie Osborn,REP,260017,1,0,23,24,
Grady,Corporation Commissioner,Bob Anthony,REP,260017,0,1,18,19,
Grady,Corporation Commissioner,Brian Bingman,REP,260017,1,0,17,18,
Grady,Governor,Chris Powell,LIB,260017,0,0,0,0,
Grady,Governor,Rex Lawhorn,LIB,260017,0,0,0,0,
Grady,Corporation Commissioner,Ashley Nicole Mccray,DEM,260017,0,0,9,9,
Grady,Corporation Commissioner,Blake Cummings,DEM,260017,0,1,11,12,
Grady,U.S. House,Mary Brannon,DEM,260017,0,0,10,10,04
Grady,U.S. House,Fred Gipson,DEM,260017,0,1,11,12,04
Grady,Governor,Mick Cornett,REP,260020,1,4,24,29,
Grady,Governor,Kevin Stitt,REP,260020,1,3,20,24,
Grady,Lieutenant Governor,Dana Murphy,REP,260020,2,4,9,15,
Grady,Lieutenant Governor,Matt Pinnell,REP,260020,0,2,33,35,
Grady,State Auditor,Cindy Byrd,REP,260020,2,4,13,19,
Grady,State Auditor,Charlie Prater,REP,260020,0,2,27,29,
Grady,Attorney General,Mike Hunter,REP,260020,2,3,17,22,
Grady,Attorney General,Gentner Drummond,REP,260020,0,4,26,30,
Grady,Superintendent of Public Instruction,Joy Hofmeister,REP,260020,1,6,24,31,
Grady,Superintendent of Public Instruction,Linda Murphy,REP,260020,1,1,20,22,
Grady,Commissioner of Labor,Cathy Costello,REP,260020,0,2,16,18,
Grady,Commissioner of Labor,Leslie Osborn,REP,260020,2,5,28,35,
Grady,Corporation Commissioner,Bob Anthony,REP,260020,1,5,16,22,
Grady,Corporation Commissioner,Brian Bingman,REP,260020,1,2,27,30,
Grady,Governor,Chris Powell,LIB,260020,0,0,1,1,
Grady,Governor,Rex Lawhorn,LIB,260020,0,0,0,0,
Grady,Corporation Commissioner,Ashley Nicole Mccray,DEM,260020,1,1,24,26,
Grady,Corporation Commissioner,Blake Cummings,DEM,260020,3,2,25,30,
Grady,U.S. House,Mary Brannon,DEM,260020,2,1,28,31,04
Grady,U.S. House,Fred Gipson,DEM,260020,3,2,20,25,04
Grady,Governor,Mick Cornett,REP,260021,2,0,26,28,
Grady,Governor,Kevin Stitt,REP,260021,2,1,24,27,
Grady,Lieutenant Governor,Dana Murphy,REP,260021,0,1,14,15,
Grady,Lieutenant Governor,Matt Pinnell,REP,260021,4,0,33,37,
Grady,State Auditor,Cindy Byrd,REP,260021,1,1,22,24,
Grady,State Auditor,Charlie Prater,REP,260021,3,0,24,27,
Grady,Attorney General,Mike Hunter,REP,260021,3,1,25,29,
Grady,Attorney General,Gentner Drummond,REP,260021,1,0,24,25,
Grady,Superintendent of Public Instruction,Joy Hofmeister,REP,260021,1,1,29,31,
Grady,Superintendent of Public Instruction,Linda Murphy,REP,260021,3,0,18,21,
Grady,Commissioner of Labor,Cathy Costello,REP,260021,0,1,15,16,
Grady,Commissioner of Labor,Leslie Osborn,REP,260021,4,0,33,37,
Grady,Corporation Commissioner,Bob Anthony,REP,260021,0,0,22,22,
Grady,Corporation Commissioner,Brian Bingman,REP,260021,4,1,26,31,
Grady,Governor,Chris Powell,LIB,260021,0,0,0,0,
Grady,Governor,Rex Lawhorn,LIB,260021,0,0,0,0,
Grady,Corporation Commissioner,Ashley Nicole Mccray,DEM,260021,0,0,12,12,
Grady,Corporation Commissioner,Blake Cummings,DEM,260021,0,0,10,10,
Grady,U.S. House,Mary Brannon,DEM,260021,0,0,14,14,04
Grady,U.S. House,Fred Gipson,DEM,260021,0,0,8,8,04
Grady,Governor,Mick Cornett,REP,260023,0,0,15,15,
Grady,Governor,Kevin Stitt,REP,260023,1,3,17,21,
Grady,Lieutenant Governor,Dana Murphy,REP,260023,1,1,9,11,
Grady,Lieutenant Governor,Matt Pinnell,REP,260023,0,2,22,24,
Grady,State Auditor,Cindy Byrd,REP,260023,0,3,11,14,
Grady,State Auditor,Charlie Prater,REP,260023,1,0,21,22,
Grady,Attorney General,Mike Hunter,REP,260023,1,1,13,15,
Grady,Attorney General,Gentner Drummond,REP,260023,0,2,19,21,
Grady,Superintendent of Public Instruction,Joy Hofmeister,REP,260023,1,3,20,24,
Grady,Superintendent of Public Instruction,Linda Murphy,REP,260023,0,0,12,12,
Grady,Commissioner of Labor,Cathy Costello,REP,260023,0,0,10,10,
Grady,Commissioner of Labor,Leslie Osborn,REP,260023,1,3,22,26,
Grady,Corporation Commissioner,Bob Anthony,REP,260023,0,0,16,16,
Grady,Corporation Commissioner,Brian Bingman,REP,260023,1,3,15,19,
Grady,Governor,Chris Powell,LIB,260023,0,0,0,0,
Grady,Governor,Rex Lawhorn,LIB,260023,0,0,0,0,
Grady,Corporation Commissioner,Ashley Nicole Mccray,DEM,260023,0,2,10,12,
Grady,Corporation Commissioner,Blake Cummings,DEM,260023,0,0,4,4,
Grady,U.S. House,Mary Brannon,DEM,260023,0,1,10,11,04
Grady,U.S. House,Fred Gipson,DEM,260023,0,1,4,5,04
Grady,Governor,Mick Cornett,REP,260025,0,4,41,45,
Grady,Governor,Kevin Stitt,REP,260025,0,6,67,73,
Grady,Lieutenant Governor,Dana Murphy,REP,260025,0,7,48,55,
Grady,Lieutenant Governor,Matt Pinnell,REP,260025,0,3,59,62,
Grady,State Auditor,Cindy Byrd,REP,260025,0,8,39,47,
Grady,State Auditor,Charlie Prater,REP,260025,0,2,66,68,
Grady,Attorney General,Mike Hunter,REP,260025,0,8,44,52,
Grady,Attorney General,Gentner Drummond,REP,260025,0,2,64,66,
Grady,Superintendent of Public Instruction,Joy Hofmeister,REP,260025,0,8,73,81,
Grady,Superintendent of Public Instruction,Linda Murphy,REP,260025,0,2,35,37,
Grady,Commissioner of Labor,Cathy Costello,REP,260025,0,4,31,35,
Grady,Commissioner of Labor,Leslie Osborn,REP,260025,0,6,75,81,
Grady,Corporation Commissioner,Bob Anthony,REP,260025,0,3,55,58,
Grady,Corporation Commissioner,Brian Bingman,REP,260025,0,7,52,59,
Grady,Governor,Chris Powell,LIB,260025,0,0,0,0,
Grady,Governor,Rex Lawhorn,LIB,260025,0,0,0,0,
Grady,Corporation Commissioner,Ashley Nicole Mccray,DEM,260025,1,0,11,12,
Grady,Corporation Commissioner,Blake Cummings,DEM,260025,0,1,13,14,
Grady,U.S. House,Mary Brannon,DEM,260025,0,1,13,14,04
Grady,U.S. House,Fred Gipson,DEM,260025,1,0,11,12,04
Grady,Governor,Mick Cornett,REP,260026,2,2,19,23,
Grady,Governor,Kevin Stitt,REP,260026,4,1,24,29,
Grady,Lieutenant Governor,Dana Murphy,REP,260026,1,3,16,20,
Grady,Lieutenant Governor,Matt Pinnell,REP,260026,5,0,27,32,
Grady,State Auditor,Cindy Byrd,REP,260026,3,3,20,26,
Grady,State Auditor,Charlie Prater,REP,260026,3,0,23,26,
Grady,Attorney General,Mike Hunter,REP,260026,1,0,21,22,
Grady,Attorney General,Gentner Drummond,REP,260026,5,3,22,30,
Grady,Superintendent of Public Instruction,Joy Hofmeister,REP,260026,3,0,17,20,
Grady,Superintendent of Public Instruction,Linda Murphy,REP,260026,3,3,26,32,
Grady,Commissioner of Labor,Cathy Costello,REP,260026,0,0,15,15,
Grady,Commissioner of Labor,Leslie Osborn,REP,260026,6,3,28,37,
Grady,Corporation Commissioner,Bob Anthony,REP,260026,1,0,22,23,
Grady,Corporation Commissioner,Brian Bingman,REP,260026,5,3,21,29,
Grady,Governor,Chris Powell,LIB,260026,0,0,0,0,
Grady,Governor,Rex Lawhorn,LIB,260026,0,0,0,0,
Grady,Corporation Commissioner,Ashley Nicole Mccray,DEM,260026,2,1,16,19,
Grady,Corporation Commissioner,Blake Cummings,DEM,260026,0,2,30,32,
Grady,U.S. House,Mary Brannon,DEM,260026,2,1,24,27,04
Grady,U.S. House,Fred Gipson,DEM,260026,0,2,22,24,04
Grady,Governor,Mick Cornett,REP,260027,2,4,29,35,
Grady,Governor,Kevin Stitt,REP,260027,1,11,38,50,
Grady,Lieutenant Governor,Dana Murphy,REP,260027,1,4,23,28,
Grady,Lieutenant Governor,Matt Pinnell,REP,260027,2,11,44,57,
Grady,State Auditor,Cindy Byrd,REP,260027,3,11,29,43,
Grady,State Auditor,Charlie Prater,REP,260027,0,2,36,38,
Grady,Attorney General,Mike Hunter,REP,260027,1,10,32,43,
Grady,Attorney General,Gentner Drummond,REP,260027,2,5,34,41,
Grady,Superintendent of Public Instruction,Joy Hofmeister,REP,260027,0,5,35,40,
Grady,Superintendent of Public Instruction,Linda Murphy,REP,260027,3,10,31,44,
Grady,Commissioner of Labor,Cathy Costello,REP,260027,1,4,29,34,
Grady,Commissioner of Labor,Leslie Osborn,REP,260027,2,11,38,51,
Grady,Corporation Commissioner,Bob Anthony,REP,260027,1,11,36,48,
Grady,Corporation Commissioner,Brian Bingman,REP,260027,2,4,30,36,
Grady,Governor,Chris Powell,LIB,260027,0,0,0,0,
Grady,Governor,Rex Lawhorn,LIB,260027,0,0,0,0,
Grady,Corporation Commissioner,Ashley Nicole Mccray,DEM,260027,0,1,5,6,
Grady,Corporation Commissioner,Blake Cummings,DEM,260027,0,2,6,8,
Grady,U.S. House,Mary Brannon,DEM,260027,0,1,8,9,04
Grady,U.S. House,Fred Gipson,DEM,260027,0,2,3,5,04
Grady,Governor,Mick Cornett,REP,260028,1,1,66,68,
Grady,Governor,Kevin Stitt,REP,260028,5,4,117,126,
Grady,Lieutenant Governor,Dana Murphy,REP,260028,2,3,70,75,
Grady,Lieutenant Governor,Matt Pinnell,REP,260028,4,2,111,117,
Grady,State Auditor,Cindy Byrd,REP,260028,5,2,81,88,
Grady,State Auditor,Charlie Prater,REP,260028,1,3,96,100,
Grady,Attorney General,Mike Hunter,REP,260028,0,3,79,82,
Grady,Attorney General,Gentner Drummond,REP,260028,6,2,102,110,
Grady,Superintendent of Public Instruction,Joy Hofmeister,REP,260028,3,2,99,104,
Grady,Superintendent of Public Instruction,Linda Murphy,REP,260028,3,3,78,84,
Grady,Commissioner of Labor,Cathy Costello,REP,260028,3,2,77,82,
Grady,Commissioner of Labor,Leslie Osborn,REP,260028,3,3,103,109,
Grady,Corporation Commissioner,Bob Anthony,REP,260028,3,1,76,80,
Grady,Corporation Commissioner,Brian Bingman,REP,260028,3,4,104,111,
Grady,Governor,Chris Powell,LIB,260028,0,0,0,0,
Grady,Governor,Rex Lawhorn,LIB,260028,0,0,0,0,
Grady,Corporation Commissioner,Ashley Nicole Mccray,DEM,260028,4,0,21,25,
Grady,Corporation Commissioner,Blake Cummings,DEM,260028,6,1,28,35,
Grady,U.S. House,Mary Brannon,DEM,260028,5,0,21,26,04
Grady,U.S. House,Fred Gipson,DEM,260028,5,1,28,34,04
Grady,Governor,Mick Cornett,REP,260029,9,2,107,118,
Grady,Governor,Kevin Stitt,REP,260029,8,5,182,195,
Grady,Lieutenant Governor,Dana Murphy,REP,260029,11,3,113,127,
Grady,Lieutenant Governor,Matt Pinnell,REP,260029,6,4,172,182,
Grady,State Auditor,Cindy Byrd,REP,260029,9,6,139,154,
Grady,State Auditor,Charlie Prater,REP,260029,7,1,140,148,
Grady,Attorney General,Mike Hunter,REP,260029,10,6,135,151,
Grady,Attorney General,Gentner Drummond,REP,260029,6,1,151,158,
Grady,Superintendent of Public Instruction,Joy Hofmeister,REP,260029,11,4,163,178,
Grady,Superintendent of Public Instruction,Linda Murphy,REP,260029,6,3,124,133,
Grady,Commissioner of Labor,Cathy Costello,REP,260029,2,4,106,112,
Grady,Commissioner of Labor,Leslie Osborn,REP,260029,15,3,180,198,
Grady,Corporation Commissioner,Bob Anthony,REP,260029,10,0,151,161,
Grady,Corporation Commissioner,Brian Bingman,REP,260029,7,7,137,151,
Grady,Governor,Chris Powell,LIB,260029,0,0,0,0,
Grady,Governor,Rex Lawhorn,LIB,260029,0,0,0,0,
Grady,Corporation Commissioner,Ashley Nicole Mccray,DEM,260029,0,0,39,39,
Grady,Corporation Commissioner,Blake Cummings,DEM,260029,1,0,51,52,
Grady,U.S. House,Mary Brannon,DEM,260029,0,0,46,46,04
Grady,U.S. House,Fred Gipson,DEM,260029,1,0,44,45,04
Grady,Governor,Mick Cornett,REP,260031,1,0,31,32,
Grady,Governor,Kevin Stitt,REP,260031,3,4,45,52,
Grady,Lieutenant Governor,Dana Murphy,REP,260031,2,1,32,35,
Grady,Lieutenant Governor,Matt Pinnell,REP,260031,2,3,43,48,
Grady,State Auditor,Cindy Byrd,REP,260031,0,0,21,21,
Grady,State Auditor,Charlie Prater,REP,260031,4,4,52,60,
Grady,Attorney General,Mike Hunter,REP,260031,2,0,37,39,
Grady,Attorney General,Gentner Drummond,REP,260031,2,4,36,42,
Grady,Superintendent of Public Instruction,Joy Hofmeister,REP,260031,2,1,53,56,
Grady,Superintendent of Public Instruction,Linda Murphy,REP,260031,2,3,21,26,
Grady,Commissioner of Labor,Cathy Costello,REP,260031,0,2,29,31,
Grady,Commissioner of Labor,Leslie Osborn,REP,260031,4,2,47,53,
Grady,Corporation Commissioner,Bob Anthony,REP,260031,0,0,41,41,
Grady,Corporation Commissioner,Brian Bingman,REP,260031,4,4,34,42,
Grady,Governor,Chris Powell,LIB,260031,0,0,0,0,
Grady,Governor,Rex Lawhorn,LIB,260031,0,0,1,1,
Grady,Corporation Commissioner,Ashley Nicole Mccray,DEM,260031,0,0,19,19,
Grady,Corporation Commissioner,Blake Cummings,DEM,260031,2,0,11,13,
Grady,U.S. House,Mary Brannon,DEM,260031,1,0,20,21,04
Grady,U.S. House,Fred Gipson,DEM,260031,1,0,10,11,04
Grady,Governor,Mick Cornett,REP,260032,8,9,74,91,
Grady,Governor,Kevin Stitt,REP,260032,1,10,100,111,
Grady,Lieutenant Governor,Dana Murphy,REP,260032,3,6,72,81,
Grady,Lieutenant Governor,Matt Pinnell,REP,260032,5,12,98,115,
Grady,State Auditor,Cindy Byrd,REP,260032,5,8,64,77,
Grady,State Auditor,Charlie Prater,REP,260032,4,11,102,117,
Grady,Attorney General,Mike Hunter,REP,260032,5,13,70,88,
Grady,Attorney General,Gentner Drummond,REP,260032,4,5,100,109,
Grady,Superintendent of Public Instruction,Joy Hofmeister,REP,260032,5,14,85,104,
Grady,Superintendent of Public Instruction,Linda Murphy,REP,260032,4,5,84,93,
Grady,Commissioner of Labor,Cathy Costello,REP,260032,6,6,64,76,
Grady,Commissioner of Labor,Leslie Osborn,REP,260032,3,12,103,118,
Grady,Corporation Commissioner,Bob Anthony,REP,260032,5,8,87,100,
Grady,Corporation Commissioner,Brian Bingman,REP,260032,3,10,82,95,
Grady,Governor,Chris Powell,LIB,260032,0,0,0,0,
Grady,Governor,Rex Lawhorn,LIB,260032,0,0,0,0,
Grady,Corporation Commissioner,Ashley Nicole Mccray,DEM,260032,3,2,47,52,
Grady,Corporation Commissioner,Blake Cummings,DEM,260032,2,3,65,70,
Grady,U.S. House,Mary Brannon,DEM,260032,4,2,58,64,04
Grady,U.S. House,Fred Gipson,DEM,260032,1,3,53,57,04
Grady,Governor,Mick Cornett,REP,260033,0,0,18,18,
Grady,Governor,Kevin Stitt,REP,260033,1,0,32,33,
Grady,Lieutenant Governor,Dana Murphy,REP,260033,0,0,14,14,
Grady,Lieutenant Governor,Matt Pinnell,REP,260033,1,0,35,36,
Grady,State Auditor,Cindy Byrd,REP,260033,0,0,19,19,
Grady,State Auditor,Charlie Prater,REP,260033,1,0,30,31,
Grady,Attorney General,Mike Hunter,REP,260033,1,0,20,21,
Grady,Attorney General,Gentner Drummond,REP,260033,0,0,30,30,
Grady,Superintendent of Public Instruction,Joy Hofmeister,REP,260033,0,0,24,24,
Grady,Superintendent of Public Instruction,Linda Murphy,REP,260033,1,0,25,26,
Grady,Commissioner of Labor,Cathy Costello,REP,260033,0,0,16,16,
Grady,Commissioner of Labor,Leslie Osborn,REP,260033,1,0,31,32,
Grady,Corporation Commissioner,Bob Anthony,REP,260033,1,0,23,24,
Grady,Corporation Commissioner,Brian Bingman,REP,260033,0,0,26,26,
Grady,Governor,Chris Powell,LIB,260033,0,0,0,0,
Grady,Governor,Rex Lawhorn,LIB,260033,0,0,0,0,
Grady,Corporation Commissioner,Ashley Nicole Mccray,DEM,260033,0,3,5,8,
Grady,Corporation Commissioner,Blake Cummings,DEM,260033,0,0,18,18,
Grady,U.S. House,Mary Brannon,DEM,260033,0,3,12,15,04
Grady,U.S. House,Fred Gipson,DEM,260033,0,0,11,11,04
Grady,Governor,Mick Cornett,REP,260035,0,1,14,15,
Grady,Governor,Kevin Stitt,REP,260035,0,2,22,24,
Grady,Lieutenant Governor,Dana Murphy,REP,260035,0,2,16,18,
Grady,Lieutenant Governor,Matt Pinnell,REP,260035,0,1,18,19,
Grady,State Auditor,Cindy Byrd,REP,260035,0,2,17,19,
Grady,State Auditor,Charlie Prater,REP,260035,0,1,18,19,
Grady,Attorney General,Mike Hunter,REP,260035,0,1,20,21,
Grady,Attorney General,Gentner Drummond,REP,260035,0,2,15,17,
Grady,Superintendent of Public Instruction,Joy Hofmeister,REP,260035,0,1,14,15,
Grady,Superintendent of Public Instruction,Linda Murphy,REP,260035,0,2,21,23,
Grady,Commissioner of Labor,Cathy Costello,REP,260035,0,1,15,16,
Grady,Commissioner of Labor,Leslie Osborn,REP,260035,0,2,21,23,
Grady,Corporation Commissioner,Bob Anthony,REP,260035,0,1,11,12,
Grady,Corporation Commissioner,Brian Bingman,REP,260035,0,2,24,26,
Grady,Governor,Chris Powell,LIB,260035,0,0,0,0,
Grady,Governor,Rex Lawhorn,LIB,260035,0,0,0,0,
Grady,Corporation Commissioner,Ashley Nicole Mccray,DEM,260035,2,0,3,5,
Grady,Corporation Commissioner,Blake Cummings,DEM,260035,0,0,14,14,
Grady,U.S. House,Mary Brannon,DEM,260035,2,0,5,7,04
Grady,U.S. House,Fred Gipson,DEM,260035,0,0,12,12,04
Grady,Governor,Mick Cornett,REP,260036,5,4,81,90,
Grady,Governor,Kevin Stitt,REP,260036,6,4,119,129,
Grady,Lieutenant Governor,Dana Murphy,REP,260036,4,2,93,99,
Grady,Lieutenant Governor,Matt Pinnell,REP,260036,7,6,105,118,
Grady,State Auditor,Cindy Byrd,REP,260036,6,3,66,75,
Grady,State Auditor,Charlie Prater,REP,260036,3,5,130,138,
Grady,Attorney General,Mike Hunter,REP,260036,4,6,99,109,
Grady,Attorney General,Gentner Drummond,REP,260036,7,2,98,107,
Grady,Superintendent of Public Instruction,Joy Hofmeister,REP,260036,5,3,92,100,
Grady,Superintendent of Public Instruction,Linda Murphy,REP,260036,5,5,103,113,
Grady,Commissioner of Labor,Cathy Costello,REP,260036,4,2,83,89,
Grady,Commissioner of Labor,Leslie Osborn,REP,260036,7,6,110,123,
Grady,Corporation Commissioner,Bob Anthony,REP,260036,5,4,98,107,
Grady,Corporation Commissioner,Brian Bingman,REP,260036,6,4,94,104,
Grady,Governor,Chris Powell,LIB,260036,0,0,1,1,
Grady,Governor,Rex Lawhorn,LIB,260036,0,0,1,1,
Grady,Corporation Commissioner,Ashley Nicole Mccray,DEM,260036,7,1,165,173,
Grady,Corporation Commissioner,Blake Cummings,DEM,260036,1,2,199,202,
Grady,U.S. House,Mary Brannon,DEM,260036,6,1,195,202,04
Grady,U.S. House,Fred Gipson,DEM,260036,2,2,167,171,04
Grady,Governor,Mick Cornett,REP,260037,37,3,279,319,
Grady,Governor,Kevin Stitt,REP,260037,15,6,311,332,
Grady,Lieutenant Governor,Dana Murphy,REP,260037,21,4,239,264,
Grady,Lieutenant Governor,Matt Pinnell,REP,260037,30,5,338,373,
Grady,State Auditor,Cindy Byrd,REP,260037,25,6,245,276,
Grady,State Auditor,Charlie Prater,REP,260037,21,3,320,344,
Grady,Attorney General,Mike Hunter,REP,260037,30,4,287,321,
Grady,Attorney General,Gentner Drummond,REP,260037,19,5,292,316,
Grady,Superintendent of Public Instruction,Joy Hofmeister,REP,260037,28,1,319,348,
Grady,Superintendent of Public Instruction,Linda Murphy,REP,260037,23,8,260,291,
Grady,Commissioner of Labor,Cathy Costello,REP,260037,21,5,230,256,
Grady,Commissioner of Labor,Leslie Osborn,REP,260037,30,4,352,386,
Grady,Corporation Commissioner,Bob Anthony,REP,260037,26,6,285,317,
Grady,Corporation Commissioner,Brian Bingman,REP,260037,25,3,285,313,
Grady,Governor,Chris Powell,LIB,260037,0,0,0,0,
Grady,Governor,Rex Lawhorn,LIB,260037,0,0,0,0,
Grady,Corporation Commissioner,Ashley Nicole Mccray,DEM,260037,16,0,47,63,
Grady,Corporation Commissioner,Blake Cummings,DEM,260037,7,0,20,27,
Grady,U.S. House,Mary Brannon,DEM,260037,15,0,45,60,04
Grady,U.S. House,Fred Gipson,DEM,260037,8,0,23,31,04
Grady,Governor,Mick Cornett,REP,260038,8,3,151,162,
Grady,Governor,Kevin Stitt,REP,260038,15,8,262,285,
Grady,Lieutenant Governor,Dana Murphy,REP,260038,12,2,138,152,
Grady,Lieutenant Governor,Matt Pinnell,REP,260038,11,9,270,290,
Grady,State Auditor,Cindy Byrd,REP,260038,10,3,164,177,
Grady,State Auditor,Charlie Prater,REP,260038,13,8,236,257,
Grady,Attorney General,Mike Hunter,REP,260038,10,3,174,187,
Grady,Attorney General,Gentner Drummond,REP,260038,13,8,235,256,
Grady,Superintendent of Public Instruction,Joy Hofmeister,REP,260038,9,7,203,219,
Grady,Superintendent of Public Instruction,Linda Murphy,REP,260038,14,4,204,222,
Grady,Commissioner of Labor,Cathy Costello,REP,260038,7,6,172,185,
Grady,Commissioner of Labor,Leslie Osborn,REP,260038,16,5,229,250,
Grady,Corporation Commissioner,Bob Anthony,REP,260038,14,6,186,206,
Grady,Corporation Commissioner,Brian Bingman,REP,260038,9,5,217,231,
Grady,Governor,Chris Powell,LIB,260038,0,0,0,0,
Grady,Governor,Rex Lawhorn,LIB,260038,0,0,0,0,
Grady,Corporation Commissioner,Ashley Nicole Mccray,DEM,260038,11,0,35,46,
Grady,Corporation Commissioner,Blake Cummings,DEM,260038,1,0,16,17,
Grady,U.S. House,Mary Brannon,DEM,260038,10,0,34,44,04
Grady,U.S. House,Fred Gipson,DEM,260038,2,0,17,19,04
Grady,Governor,Mick Cornett,REP,260039,5,1,98,104,
Grady,Governor,Kevin Stitt,REP,260039,5,2,171,178,
Grady,Lieutenant Governor,Dana Murphy,REP,260039,5,1,104,110,
Grady,Lieutenant Governor,Matt Pinnell,REP,260039,5,2,160,167,
Grady,State Auditor,Cindy Byrd,REP,260039,3,2,114,119,
Grady,State Auditor,Charlie Prater,REP,260039,7,1,154,162,
Grady,Attorney General,Mike Hunter,REP,260039,5,1,112,118,
Grady,Attorney General,Gentner Drummond,REP,260039,5,2,157,164,
Grady,Superintendent of Public Instruction,Joy Hofmeister,REP,260039,3,1,136,140,
Grady,Superintendent of Public Instruction,Linda Murphy,REP,260039,7,2,130,139,
Grady,Commissioner of Labor,Cathy Costello,REP,260039,4,2,117,123,
Grady,Commissioner of Labor,Leslie Osborn,REP,260039,6,1,152,159,
Grady,Corporation Commissioner,Bob Anthony,REP,260039,4,3,126,133,
Grady,Corporation Commissioner,Brian Bingman,REP,260039,6,0,141,147,
Grady,Governor,Chris Powell,LIB,260039,0,0,0,0,
Grady,Governor,Rex Lawhorn,LIB,260039,0,0,0,0,
Grady,Corporation Commissioner,Ashley Nicole Mccray,DEM,260039,3,0,20,23,
Grady,Corporation Commissioner,Blake Cummings,DEM,260039,2,1,20,23,
Grady,U.S. House,Mary Brannon,DEM,260039,2,0,23,25,04
Grady,U.S. House,Fred Gipson,DEM,260039,3,1,17,21,04
Grady,Governor,Mick Cornett,REP,260040,22,1,214,237,
Grady,Governor,Kevin Stitt,REP,260040,19,4,249,272,
Grady,Lieutenant Governor,Dana Murphy,REP,260040,21,2,171,194,
Grady,Lieutenant Governor,Matt Pinnell,REP,260040,19,3,278,300,
Grady,State Auditor,Cindy Byrd,REP,260040,19,4,189,212,
Grady,State Auditor,Charlie Prater,REP,260040,21,1,249,271,
Grady,Attorney General,Mike Hunter,REP,260040,24,4,229,257,
Grady,Attorney General,Gentner Drummond,REP,260040,15,1,224,240,
Grady,Superintendent of Public Instruction,Joy Hofmeister,REP,260040,28,4,270,302,
Grady,Superintendent of Public Instruction,Linda Murphy,REP,260040,12,1,179,192,
Grady,Commissioner of Labor,Cathy Costello,REP,260040,8,1,126,135,
Grady,Commissioner of Labor,Leslie Osborn,REP,260040,33,4,331,368,
Grady,Corporation Commissioner,Bob Anthony,REP,260040,26,3,220,249,
Grady,Corporation Commissioner,Brian Bingman,REP,260040,15,1,224,240,
Grady,State House,Brian Hill,REP,260040,28,1,242,271,47
Grady,State House,Beverly Adams,REP,260040,12,4,209,225,47
Grady,Governor,Chris Powell,LIB,260040,0,0,0,0,
Grady,Governor,Rex Lawhorn,LIB,260040,0,0,0,0,
Grady,Corporation Commissioner,Ashley Nicole Mccray,DEM,260040,10,0,39,49,
Grady,Corporation Commissioner,Blake Cummings,DEM,260040,1,0,31,32,
Grady,U.S. House,Mary Brannon,DEM,260040,9,0,42,51,04
Grady,U.S. House,Fred Gipson,DEM,260040,2,0,28,30,04
Grady,Governor,Mick Cornett,REP,260041,20,0,222,242,
Grady,Governor,Kevin Stitt,REP,260041,27,4,270,301,
Grady,Lieutenant Governor,Dana Murphy,REP,260041,25,1,204,230,
Grady,Lieutenant Governor,Matt Pinnell,REP,260041,22,1,274,297,
Grady,State Auditor,Cindy Byrd,REP,260041,26,1,232,259,
Grady,State Auditor,Charlie Prater,REP,260041,19,1,238,258,
Grady,Attorney General,Mike Hunter,REP,260041,29,4,236,269,
Grady,Attorney General,Gentner Drummond,REP,260041,18,0,245,263,
Grady,Superintendent of Public Instruction,Joy Hofmeister,REP,260041,25,1,265,291,
Grady,Superintendent of Public Instruction,Linda Murphy,REP,260041,22,3,215,240,
Grady,Commissioner of Labor,Cathy Costello,REP,260041,14,1,146,161,
Grady,Commissioner of Labor,Leslie Osborn,REP,260041,33,3,340,376,
Grady,Corporation Commissioner,Bob Anthony,REP,260041,27,1,240,268,
Grady,Corporation Commissioner,Brian Bingman,REP,260041,18,1,237,256,
Grady,State House,Brian Hill,REP,260041,17,4,235,256,47
Grady,State House,Beverly Adams,REP,260041,30,0,241,271,47
Grady,Governor,Chris Powell,LIB,260041,0,0,0,0,
Grady,Governor,Rex Lawhorn,LIB,260041,0,0,2,2,
Grady,Corporation Commissioner,Ashley Nicole Mccray,DEM,260041,5,0,43,48,
Grady,Corporation Commissioner,Blake Cummings,DEM,260041,3,0,21,24,
Grady,U.S. House,Mary Brannon,DEM,260041,4,0,42,46,04
Grady,U.S. House,Fred Gipson,DEM,260041,4,0,22,26,04
Grant,Governor,Mick Cornett,REP,270011,2,1,17,20,
Grant,Governor,Kevin Stitt,REP,270011,1,0,22,23,
Grant,Lieutenant Governor,Dana Murphy,REP,270011,0,0,18,18,
Grant,Lieutenant Governor,Matt Pinnell,REP,270011,3,0,21,24,
Grant,State Auditor,Cindy Byrd,REP,270011,1,0,15,16,
Grant,State Auditor,Charlie Prater,REP,270011,2,0,22,24,
Grant,Attorney General,Mike Hunter,REP,270011,2,0,16,18,
Grant,Attorney General,Gentner Drummond,REP,270011,1,0,24,25,
Grant,Superintendent of Public Instruction,Joy Hofmeister,REP,270011,1,0,20,21,
Grant,Superintendent of Public Instruction,Linda Murphy,REP,270011,2,0,17,19,
Grant,Commissioner of Labor,Cathy Costello,REP,270011,2,0,18,20,
Grant,Commissioner of Labor,Leslie Osborn,REP,270011,1,0,20,21,
Grant,Corporation Commissioner,Bob Anthony,REP,270011,2,0,16,18,
Grant,Corporation Commissioner,Brian Bingman,REP,270011,1,0,22,23,
Grant,State House,John Pfeiffer,REP,270011,2,0,21,23,38
Grant,State House,Brian Hobbs,REP,270011,1,0,20,21,38
Grant,Governor,Chris Powell,LIB,270011,0,0,0,0,
Grant,Governor,Rex Lawhorn,LIB,270011,0,0,0,0,
Grant,Corporation Commissioner,Ashley Nicole Mccray,DEM,270011,0,0,5,5,
Grant,Corporation Commissioner,Blake Cummings,DEM,270011,0,0,3,3,
Grant,Governor,Mick Cornett,REP,270017,2,2,49,53,
Grant,Governor,Kevin Stitt,REP,270017,5,0,60,65,
Grant,Lieutenant Governor,Dana Murphy,REP,270017,5,1,45,51,
Grant,Lieutenant Governor,Matt Pinnell,REP,270017,2,1,61,64,
Grant,State Auditor,Cindy Byrd,REP,270017,4,1,60,65,
Grant,State Auditor,Charlie Prater,REP,270017,3,1,44,48,
Grant,Attorney General,Mike Hunter,REP,270017,5,1,41,47,
Grant,Attorney General,Gentner Drummond,REP,270017,2,1,67,70,
Grant,Superintendent of Public Instruction,Joy Hofmeister,REP,270017,3,2,59,64,
Grant,Superintendent of Public Instruction,Linda Murphy,REP,270017,4,0,50,54,
Grant,Commissioner of Labor,Cathy Costello,REP,270017,1,0,46,47,
Grant,Commissioner of Labor,Leslie Osborn,REP,270017,6,2,55,63,
Grant,Corporation Commissioner,Bob Anthony,REP,270017,4,1,57,62,
Grant,Corporation Commissioner,Brian Bingman,REP,270017,3,1,48,52,
Grant,State House,John Pfeiffer,REP,270017,3,2,55,60,38
Grant,State House,Brian Hobbs,REP,270017,4,0,54,58,38
Grant,Governor,Chris Powell,LIB,270017,0,0,0,0,
Grant,Governor,Rex Lawhorn,LIB,270017,0,0,0,0,
Grant,Corporation Commissioner,Ashley Nicole Mccray,DEM,270017,0,0,11,11,
Grant,Corporation Commissioner,Blake Cummings,DEM,270017,0,0,3,3,
Grant,Governor,Mick Cornett,REP,270023,0,1,82,83,
Grant,Governor,Kevin Stitt,REP,270023,3,4,96,103,
Grant,Lieutenant Governor,Dana Murphy,REP,270023,1,3,75,79,
Grant,Lieutenant Governor,Matt Pinnell,REP,270023,2,2,100,104,
Grant,State Auditor,Cindy Byrd,REP,270023,1,2,80,83,
Grant,State Auditor,Charlie Prater,REP,270023,2,3,92,97,
Grant,Attorney General,Mike Hunter,REP,270023,0,2,78,80,
Grant,Attorney General,Gentner Drummond,REP,270023,3,3,97,103,
Grant,Superintendent of Public Instruction,Joy Hofmeister,REP,270023,0,2,102,104,
Grant,Superintendent of Public Instruction,Linda Murphy,REP,270023,3,3,76,82,
Grant,Commissioner of Labor,Cathy Costello,REP,270023,1,3,77,81,
Grant,Commissioner of Labor,Leslie Osborn,REP,270023,2,2,97,101,
Grant,Corporation Commissioner,Bob Anthony,REP,270023,0,4,78,82,
Grant,Corporation Commissioner,Brian Bingman,REP,270023,3,1,95,99,
Grant,State House,John Pfeiffer,REP,270023,3,4,106,113,38
Grant,State House,Brian Hobbs,REP,270023,0,1,72,73,38
Grant,Governor,Chris Powell,LIB,270023,0,0,0,0,
Grant,Governor,Rex Lawhorn,LIB,270023,0,0,0,0,
Grant,Corporation Commissioner,Ashley Nicole Mccray,DEM,270023,0,0,15,15,
Grant,Corporation Commissioner,Blake Cummings,DEM,270023,0,0,11,11,
Grant,Governor,Mick Cornett,REP,270025,5,0,28,33,
Grant,Governor,Kevin Stitt,REP,270025,2,3,62,67,
Grant,Lieutenant Governor,Dana Murphy,REP,270025,2,2,30,34,
Grant,Lieutenant Governor,Matt Pinnell,REP,270025,5,1,59,65,
Grant,State Auditor,Cindy Byrd,REP,270025,3,0,35,38,
Grant,State Auditor,Charlie Prater,REP,270025,4,3,52,59,
Grant,Attorney General,Mike Hunter,REP,270025,3,0,33,36,
Grant,Attorney General,Gentner Drummond,REP,270025,3,3,58,64,
Grant,Superintendent of Public Instruction,Joy Hofmeister,REP,270025,3,1,54,58,
Grant,Superintendent of Public Instruction,Linda Murphy,REP,270025,4,2,33,39,
Grant,Commissioner of Labor,Cathy Costello,REP,270025,6,1,39,46,
Grant,Commissioner of Labor,Leslie Osborn,REP,270025,1,2,49,52,
Grant,Corporation Commissioner,Bob Anthony,REP,270025,3,3,40,46,
Grant,Corporation Commissioner,Brian Bingman,REP,270025,4,0,47,51,
Grant,State House,John Pfeiffer,REP,270025,5,0,49,54,38
Grant,State House,Brian Hobbs,REP,270025,2,3,39,44,38
Grant,Governor,Chris Powell,LIB,270025,0,0,0,0,
Grant,Governor,Rex Lawhorn,LIB,270025,0,0,0,0,
Grant,Corporation Commissioner,Ashley Nicole Mccray,DEM,270025,0,0,7,7,
Grant,Corporation Commissioner,Blake Cummings,DEM,270025,0,0,3,3,
Grant,Governor,Mick Cornett,REP,270026,0,1,36,37,
Grant,Governor,Kevin Stitt,REP,270026,1,0,44,45,
Grant,Lieutenant Governor,Dana Murphy,REP,270026,0,1,29,30,
Grant,Lieutenant Governor,Matt Pinnell,REP,270026,1,0,49,50,
Grant,State Auditor,Cindy Byrd,REP,270026,0,1,38,39,
Grant,State Auditor,Charlie Prater,REP,270026,1,0,39,40,
Grant,Attorney General,Mike Hunter,REP,270026,0,1,42,43,
Grant,Attorney General,Gentner Drummond,REP,270026,1,0,39,40,
Grant,Superintendent of Public Instruction,Joy Hofmeister,REP,270026,0,0,37,37,
Grant,Superintendent of Public Instruction,Linda Murphy,REP,270026,1,1,42,44,
Grant,Commissioner of Labor,Cathy Costello,REP,270026,1,0,41,42,
Grant,Commissioner of Labor,Leslie Osborn,REP,270026,0,1,40,41,
Grant,Corporation Commissioner,Bob Anthony,REP,270026,0,0,42,42,
Grant,Corporation Commissioner,Brian Bingman,REP,270026,1,1,37,39,
Grant,State House,John Pfeiffer,REP,270026,1,1,35,37,38
Grant,State House,Brian Hobbs,REP,270026,0,0,48,48,38
Grant,Governor,Chris Powell,LIB,270026,0,0,0,0,
Grant,Governor,Rex Lawhorn,LIB,270026,0,0,1,1,
Grant,Corporation Commissioner,Ashley Nicole Mccray,DEM,270026,0,0,8,8,
Grant,Corporation Commissioner,Blake Cummings,DEM,270026,0,0,2,2,
Grant,Governor,Mick Cornett,REP,270029,5,0,29,34,
Grant,Governor,Kevin Stitt,REP,270029,1,12,32,45,
Grant,Lieutenant Governor,Dana Murphy,REP,270029,4,6,30,40,
Grant,Lieutenant Governor,Matt Pinnell,REP,270029,2,6,28,36,
Grant,State Auditor,Cindy Byrd,REP,270029,4,9,17,30,
Grant,State Auditor,Charlie Prater,REP,270029,2,2,39,43,
Grant,Attorney General,Mike Hunter,REP,270029,3,2,33,38,
Grant,Attorney General,Gentner Drummond,REP,270029,3,9,28,40,
Grant,Superintendent of Public Instruction,Joy Hofmeister,REP,270029,4,2,35,41,
Grant,Superintendent of Public Instruction,Linda Murphy,REP,270029,2,10,23,35,
Grant,Commissioner of Labor,Cathy Costello,REP,270029,4,8,30,42,
Grant,Commissioner of Labor,Leslie Osborn,REP,270029,2,4,26,32,
Grant,Corporation Commissioner,Bob Anthony,REP,270029,5,8,29,42,
Grant,Corporation Commissioner,Brian Bingman,REP,270029,1,4,29,34,
Grant,State House,John Pfeiffer,REP,270029,1,5,26,32,38
Grant,State House,Brian Hobbs,REP,270029,5,7,35,47,38
Grant,Governor,Chris Powell,LIB,270029,0,0,0,0,
Grant,Governor,Rex Lawhorn,LIB,270029,0,0,0,0,
Grant,Corporation Commissioner,Ashley Nicole Mccray,DEM,270029,3,0,3,6,
Grant,Corporation Commissioner,Blake Cummings,DEM,270029,1,0,3,4,
Grant,Governor,Mick Cornett,REP,270030,3,6,51,60,
Grant,Governor,Kevin Stitt,REP,270030,2,6,58,66,
Grant,Lieutenant Governor,Dana Murphy,REP,270030,2,8,45,55,
Grant,Lieutenant Governor,Matt Pinnell,REP,270030,3,4,63,70,
Grant,State Auditor,Cindy Byrd,REP,270030,3,7,50,60,
Grant,State Auditor,Charlie Prater,REP,270030,2,5,56,63,
Grant,Attorney General,Mike Hunter,REP,270030,2,3,53,58,
Grant,Attorney General,Gentner Drummond,REP,270030,3,9,56,68,
Grant,Superintendent of Public Instruction,Joy Hofmeister,REP,270030,3,6,58,67,
Grant,Superintendent of Public Instruction,Linda Murphy,REP,270030,2,6,51,59,
Grant,Commissioner of Labor,Cathy Costello,REP,270030,1,7,49,57,
Grant,Commissioner of Labor,Leslie Osborn,REP,270030,4,5,60,69,
Grant,Corporation Commissioner,Bob Anthony,REP,270030,3,5,42,50,
Grant,Corporation Commissioner,Brian Bingman,REP,270030,2,7,64,73,
Grant,State House,John Pfeiffer,REP,270030,4,3,51,58,38
Grant,State House,Brian Hobbs,REP,270030,1,9,58,68,38
Grant,Governor,Chris Powell,LIB,270030,0,0,0,0,
Grant,Governor,Rex Lawhorn,LIB,270030,0,0,0,0,
Grant,Corporation Commissioner,Ashley Nicole Mccray,DEM,270030,0,3,14,17,
Grant,Corporation Commissioner,Blake Cummings,DEM,270030,0,0,5,5,
Greer,Governor,Mick Cornett,REP,280101,1,3,10,14,
Greer,Governor,Kevin Stitt,REP,280101,1,7,19,27,
Greer,Lieutenant Governor,Dana Murphy,REP,280101,0,6,12,18,
Greer,Lieutenant Governor,Matt Pinnell,REP,280101,2,4,16,22,
Greer,State Auditor,Cindy Byrd,REP,280101,0,5,14,19,
Greer,State Auditor,Charlie Prater,REP,280101,2,5,16,23,
Greer,Attorney General,Mike Hunter,REP,280101,0,3,17,20,
Greer,Attorney General,Gentner Drummond,REP,280101,2,7,13,22,
Greer,Superintendent of Public Instruction,Joy Hofmeister,REP,280101,1,6,21,28,
Greer,Superintendent of Public Instruction,Linda Murphy,REP,280101,1,4,8,13,
Greer,Commissioner of Labor,Cathy Costello,REP,280101,0,6,9,15,
Greer,Commissioner of Labor,Leslie Osborn,REP,280101,2,4,21,27,
Greer,Corporation Commissioner,Bob Anthony,REP,280101,2,4,17,23,
Greer,Corporation Commissioner,Brian Bingman,REP,280101,0,6,13,19,
Greer,Governor,Chris Powell,LIB,280101,0,0,0,0,
Greer,Governor,Rex Lawhorn,LIB,280101,0,0,0,0,
Greer,Corporation Commissioner,Ashley Nicole Mccray,DEM,280101,1,3,16,20,
Greer,Corporation Commissioner,Blake Cummings,DEM,280101,2,3,30,35,
Greer,Governor,Mick Cornett,REP,280102,1,6,18,25,
Greer,Governor,Kevin Stitt,REP,280102,0,2,34,36,
Greer,Lieutenant Governor,Dana Murphy,REP,280102,1,5,13,19,
Greer,Lieutenant Governor,Matt Pinnell,REP,280102,0,4,39,43,
Greer,State Auditor,Cindy Byrd,REP,280102,1,4,27,32,
Greer,State Auditor,Charlie Prater,REP,280102,0,5,25,30,
Greer,Attorney General,Mike Hunter,REP,280102,0,5,17,22,
Greer,Attorney General,Gentner Drummond,REP,280102,1,4,35,40,
Greer,Superintendent of Public Instruction,Joy Hofmeister,REP,280102,0,5,29,34,
Greer,Superintendent of Public Instruction,Linda Murphy,REP,280102,1,4,23,28,
Greer,Commissioner of Labor,Cathy Costello,REP,280102,0,2,23,25,
Greer,Commissioner of Labor,Leslie Osborn,REP,280102,1,7,28,36,
Greer,Corporation Commissioner,Bob Anthony,REP,280102,1,7,25,33,
Greer,Corporation Commissioner,Brian Bingman,REP,280102,0,2,27,29,
Greer,Governor,Chris Powell,LIB,280102,0,0,0,0,
Greer,Governor,Rex Lawhorn,LIB,280102,0,0,0,0,
Greer,Corporation Commissioner,Ashley Nicole Mccray,DEM,280102,0,5,16,21,
Greer,Corporation Commissioner,Blake Cummings,DEM,280102,0,4,20,24,
Greer,Governor,Mick Cornett,REP,280103,0,1,1,2,
Greer,Governor,Kevin Stitt,REP,280103,0,0,0,0,
Greer,Lieutenant Governor,Dana Murphy,REP,280103,0,1,0,1,
Greer,Lieutenant Governor,Matt Pinnell,REP,280103,0,0,0,0,
Greer,State Auditor,Cindy Byrd,REP,280103,0,1,0,1,
Greer,State Auditor,Charlie Prater,REP,280103,0,0,0,0,
Greer,Attorney General,Mike Hunter,REP,280103,0,0,0,0,
Greer,Attorney General,Gentner Drummond,REP,280103,0,1,0,1,
Greer,Superintendent of Public Instruction,Joy Hofmeister,REP,280103,0,0,0,0,
Greer,Superintendent of Public Instruction,Linda Murphy,REP,280103,0,1,0,1,
Greer,Commissioner of Labor,Cathy Costello,REP,280103,0,1,0,1,
Greer,Commissioner of Labor,Leslie Osborn,REP,280103,0,0,0,0,
Greer,Corporation Commissioner,Bob Anthony,REP,280103,0,0,0,0,
Greer,Corporation Commissioner,Brian Bingman,REP,280103,0,1,0,1,
Greer,Governor,Chris Powell,LIB,280103,0,0,0,0,
Greer,Governor,Rex Lawhorn,LIB,280103,0,0,0,0,
Greer,Corporation Commissioner,Ashley Nicole Mccray,DEM,280103,0,0,2,2,
Greer,Corporation Commissioner,Blake Cummings,DEM,280103,0,1,2,3,
Greer,Governor,Mick Cornett,REP,280105,1,0,1,2,
Greer,Governor,Kevin Stitt,REP,280105,0,0,6,6,
Greer,Lieutenant Governor,Dana Murphy,REP,280105,0,0,1,1,
Greer,Lieutenant Governor,Matt Pinnell,REP,280105,1,0,6,7,
Greer,State Auditor,Cindy Byrd,REP,280105,0,0,0,0,
Greer,State Auditor,Charlie Prater,REP,280105,0,0,6,6,
Greer,Attorney General,Mike Hunter,REP,280105,0,0,3,3,
Greer,Attorney General,Gentner Drummond,REP,280105,0,0,4,4,
Greer,Superintendent of Public Instruction,Joy Hofmeister,REP,280105,0,0,4,4,
Greer,Superintendent of Public Instruction,Linda Murphy,REP,280105,0,0,2,2,
Greer,Commissioner of Labor,Cathy Costello,REP,280105,0,0,2,2,
Greer,Commissioner of Labor,Leslie Osborn,REP,280105,0,0,5,5,
Greer,Corporation Commissioner,Bob Anthony,REP,280105,0,0,4,4,
Greer,Corporation Commissioner,Brian Bingman,REP,280105,0,0,2,2,
Greer,Governor,Chris Powell,LIB,280105,0,0,0,0,
Greer,Governor,Rex Lawhorn,LIB,280105,0,0,0,0,
Greer,Corporation Commissioner,Ashley Nicole Mccray,DEM,280105,0,0,4,4,
Greer,Corporation Commissioner,Blake Cummings,DEM,280105,1,0,6,7,
Greer,Governor,Mick Cornett,REP,280106,0,1,0,1,
Greer,Governor,Kevin Stitt,REP,280106,0,0,6,6,
Greer,Lieutenant Governor,Dana Murphy,REP,280106,0,0,3,3,
Greer,Lieutenant Governor,Matt Pinnell,REP,280106,0,1,3,4,
Greer,State Auditor,Cindy Byrd,REP,280106,0,0,1,1,
Greer,State Auditor,Charlie Prater,REP,280106,0,1,4,5,
Greer,Attorney General,Mike Hunter,REP,280106,0,1,0,1,
Greer,Attorney General,Gentner Drummond,REP,280106,0,0,6,6,
Greer,Superintendent of Public Instruction,Joy Hofmeister,REP,280106,0,1,2,3,
Greer,Superintendent of Public Instruction,Linda Murphy,REP,280106,0,0,4,4,
Greer,Commissioner of Labor,Cathy Costello,REP,280106,0,0,3,3,
Greer,Commissioner of Labor,Leslie Osborn,REP,280106,0,1,2,3,
Greer,Corporation Commissioner,Bob Anthony,REP,280106,0,0,4,4,
Greer,Corporation Commissioner,Brian Bingman,REP,280106,0,1,1,2,
Greer,Governor,Chris Powell,LIB,280106,0,0,0,0,
Greer,Governor,Rex Lawhorn,LIB,280106,0,0,0,0,
Greer,Corporation Commissioner,Ashley Nicole Mccray,DEM,280106,0,0,1,1,
Greer,Corporation Commissioner,Blake Cummings,DEM,280106,0,0,1,1,
Greer,Governor,Mick Cornett,REP,280202,0,1,31,32,
Greer,Governor,Kevin Stitt,REP,280202,0,2,33,35,
Greer,Lieutenant Governor,Dana Murphy,REP,280202,0,3,22,25,
Greer,Lieutenant Governor,Matt Pinnell,REP,280202,0,0,38,38,
Greer,State Auditor,Cindy Byrd,REP,280202,0,3,21,24,
Greer,State Auditor,Charlie Prater,REP,280202,0,0,40,40,
Greer,Attorney General,Mike Hunter,REP,280202,0,1,23,24,
Greer,Attorney General,Gentner Drummond,REP,280202,0,2,37,39,
Greer,Superintendent of Public Instruction,Joy Hofmeister,REP,280202,0,2,38,40,
Greer,Superintendent of Public Instruction,Linda Murphy,REP,280202,0,1,24,25,
Greer,Commissioner of Labor,Cathy Costello,REP,280202,0,2,24,26,
Greer,Commissioner of Labor,Leslie Osborn,REP,280202,0,1,37,38,
Greer,Corporation Commissioner,Bob Anthony,REP,280202,0,1,23,24,
Greer,Corporation Commissioner,Brian Bingman,REP,280202,0,2,38,40,
Greer,Governor,Chris Powell,LIB,280202,0,0,0,0,
Greer,Governor,Rex Lawhorn,LIB,280202,0,0,0,0,
Greer,Corporation Commissioner,Ashley Nicole Mccray,DEM,280202,0,0,12,12,
Greer,Corporation Commissioner,Blake Cummings,DEM,280202,0,0,21,21,
Greer,Governor,Mick Cornett,REP,280203,0,1,7,8,
Greer,Governor,Kevin Stitt,REP,280203,0,1,9,10,
Greer,Lieutenant Governor,Dana Murphy,REP,280203,0,1,5,6,
Greer,Lieutenant Governor,Matt Pinnell,REP,280203,0,1,11,12,
Greer,State Auditor,Cindy Byrd,REP,280203,0,1,5,6,
Greer,State Auditor,Charlie Prater,REP,280203,0,1,11,12,
Greer,Attorney General,Mike Hunter,REP,280203,0,0,7,7,
Greer,Attorney General,Gentner Drummond,REP,280203,0,2,9,11,
Greer,Superintendent of Public Instruction,Joy Hofmeister,REP,280203,0,1,11,12,
Greer,Superintendent of Public Instruction,Linda Murphy,REP,280203,0,1,5,6,
Greer,Commissioner of Labor,Cathy Costello,REP,280203,0,1,8,9,
Greer,Commissioner of Labor,Leslie Osborn,REP,280203,0,1,8,9,
Greer,Corporation Commissioner,Bob Anthony,REP,280203,0,1,8,9,
Greer,Corporation Commissioner,Brian Bingman,REP,280203,0,1,8,9,
Greer,Governor,Chris Powell,LIB,280203,0,0,0,0,
Greer,Governor,Rex Lawhorn,LIB,280203,0,0,0,0,
Greer,Corporation Commissioner,Ashley Nicole Mccray,DEM,280203,0,0,7,7,
Greer,Corporation Commissioner,Blake Cummings,DEM,280203,1,0,14,15,
Greer,Governor,Mick Cornett,REP,280302,0,0,0,0,
Greer,Governor,Kevin Stitt,REP,280302,0,0,1,1,
Greer,Lieutenant Governor,Dana Murphy,REP,280302,0,0,0,0,
Greer,Lieutenant Governor,Matt Pinnell,REP,280302,0,0,0,0,
Greer,State Auditor,Cindy Byrd,REP,280302,0,0,0,0,
Greer,State Auditor,Charlie Prater,REP,280302,0,0,1,1,
Greer,Attorney General,Mike Hunter,REP,280302,0,0,0,0,
Greer,Attorney General,Gentner Drummond,REP,280302,0,0,1,1,
Greer,Superintendent of Public Instruction,Joy Hofmeister,REP,280302,0,0,0,0,
Greer,Superintendent of Public Instruction,Linda Murphy,REP,280302,0,0,1,1,
Greer,Commissioner of Labor,Cathy Costello,REP,280302,0,0,0,0,
Greer,Commissioner of Labor,Leslie Osborn,REP,280302,0,0,1,1,
Greer,Corporation Commissioner,Bob Anthony,REP,280302,0,0,0,0,
Greer,Corporation Commissioner,Brian Bingman,REP,280302,0,0,0,0,
Greer,Governor,Chris Powell,LIB,280302,0,0,0,0,
Greer,Governor,Rex Lawhorn,LIB,280302,0,0,0,0,
Greer,Corporation Commissioner,Ashley Nicole Mccray,DEM,280302,0,0,4,4,
Greer,Corporation Commissioner,Blake Cummings,DEM,280302,0,1,1,2,
Harmon,Governor,Mick Cornett,REP,290101,0,0,1,1,
Harmon,Governor,Kevin Stitt,REP,290101,0,1,4,5,
Harmon,Lieutenant Governor,Dana Murphy,REP,290101,0,0,1,1,
Harmon,Lieutenant Governor,Matt Pinnell,REP,290101,0,1,4,5,
Harmon,State Auditor,Cindy Byrd,REP,290101,0,1,1,2,
Harmon,State Auditor,Charlie Prater,REP,290101,0,0,4,4,
Harmon,Attorney General,Mike Hunter,REP,290101,0,1,3,4,
Harmon,Attorney General,Gentner Drummond,REP,290101,0,0,2,2,
Harmon,Superintendent of Public Instruction,Joy Hofmeister,REP,290101,0,1,5,6,
Harmon,Superintendent of Public Instruction,Linda Murphy,REP,290101,0,0,0,0,
Harmon,Commissioner of Labor,Cathy Costello,REP,290101,0,0,1,1,
Harmon,Commissioner of Labor,Leslie Osborn,REP,290101,0,1,4,5,
Harmon,Corporation Commissioner,Bob Anthony,REP,290101,0,1,1,2,
Harmon,Corporation Commissioner,Brian Bingman,REP,290101,0,0,4,4,
Harmon,Governor,Chris Powell,LIB,290101,0,0,0,0,
Harmon,Governor,Rex Lawhorn,LIB,290101,0,0,0,0,
Harmon,Corporation Commissioner,Ashley Nicole Mccray,DEM,290101,0,0,2,2,
Harmon,Corporation Commissioner,Blake Cummings,DEM,290101,0,1,11,12,
Harmon,Governor,Mick Cornett,REP,290102,1,4,14,19,
Harmon,Governor,Kevin Stitt,REP,290102,1,4,13,18,
Harmon,Lieutenant Governor,Dana Murphy,REP,290102,0,4,11,15,
Harmon,Lieutenant Governor,Matt Pinnell,REP,290102,2,4,15,21,
Harmon,State Auditor,Cindy Byrd,REP,290102,1,1,13,15,
Harmon,State Auditor,Charlie Prater,REP,290102,1,6,13,20,
Harmon,Attorney General,Mike Hunter,REP,290102,0,4,16,20,
Harmon,Attorney General,Gentner Drummond,REP,290102,2,4,10,16,
Harmon,Superintendent of Public Instruction,Joy Hofmeister,REP,290102,2,7,17,26,
Harmon,Superintendent of Public Instruction,Linda Murphy,REP,290102,0,1,10,11,
Harmon,Commissioner of Labor,Cathy Costello,REP,290102,2,4,12,18,
Harmon,Commissioner of Labor,Leslie Osborn,REP,290102,0,3,14,17,
Harmon,Corporation Commissioner,Bob Anthony,REP,290102,2,6,12,20,
Harmon,Corporation Commissioner,Brian Bingman,REP,290102,0,2,15,17,
Harmon,Governor,Chris Powell,LIB,290102,0,0,0,0,
Harmon,Governor,Rex Lawhorn,LIB,290102,0,0,0,0,
Harmon,Corporation Commissioner,Ashley Nicole Mccray,DEM,290102,0,0,9,9,
Harmon,Corporation Commissioner,Blake Cummings,DEM,290102,2,1,19,22,
Harmon,Governor,Mick Cornett,REP,290201,0,0,12,12,
Harmon,Governor,Kevin Stitt,REP,290201,0,11,18,29,
Harmon,Lieutenant Governor,Dana Murphy,REP,290201,0,1,10,11,
Harmon,Lieutenant Governor,Matt Pinnell,REP,290201,0,10,18,28,
Harmon,State Auditor,Cindy Byrd,REP,290201,0,4,12,16,
Harmon,State Auditor,Charlie Prater,REP,290201,0,6,16,22,
Harmon,Attorney General,Mike Hunter,REP,290201,0,3,18,21,
Harmon,Attorney General,Gentner Drummond,REP,290201,0,7,12,19,
Harmon,Superintendent of Public Instruction,Joy Hofmeister,REP,290201,0,6,24,30,
Harmon,Superintendent of Public Instruction,Linda Murphy,REP,290201,0,4,4,8,
Harmon,Commissioner of Labor,Cathy Costello,REP,290201,0,4,9,13,
Harmon,Commissioner of Labor,Leslie Osborn,REP,290201,0,6,18,24,
Harmon,Corporation Commissioner,Bob Anthony,REP,290201,0,3,13,16,
Harmon,Corporation Commissioner,Brian Bingman,REP,290201,0,7,15,22,
Harmon,Governor,Chris Powell,LIB,290201,0,0,0,0,
Harmon,Governor,Rex Lawhorn,LIB,290201,0,0,0,0,
Harmon,Corporation Commissioner,Ashley Nicole Mccray,DEM,290201,0,0,7,7,
Harmon,Corporation Commissioner,Blake Cummings,DEM,290201,1,0,8,9,
Harmon,Governor,Mick Cornett,REP,290203,0,0,0,0,
Harmon,Governor,Kevin Stitt,REP,290203,0,1,4,5,
Harmon,Lieutenant Governor,Dana Murphy,REP,290203,0,0,0,0,
Harmon,Lieutenant Governor,Matt Pinnell,REP,290203,0,1,3,4,
Harmon,State Auditor,Cindy Byrd,REP,290203,0,0,0,0,
Harmon,State Auditor,Charlie Prater,REP,290203,0,1,2,3,
Harmon,Attorney General,Mike Hunter,REP,290203,0,1,1,2,
Harmon,Attorney General,Gentner Drummond,REP,290203,0,0,3,3,
Harmon,Superintendent of Public Instruction,Joy Hofmeister,REP,290203,0,1,2,3,
Harmon,Superintendent of Public Instruction,Linda Murphy,REP,290203,0,0,2,2,
Harmon,Commissioner of Labor,Cathy Costello,REP,290203,0,0,2,2,
Harmon,Commissioner of Labor,Leslie Osborn,REP,290203,0,1,2,3,
Harmon,Corporation Commissioner,Bob Anthony,REP,290203,0,1,1,2,
Harmon,Corporation Commissioner,Brian Bingman,REP,290203,0,0,3,3,
Harmon,Governor,Chris Powell,LIB,290203,0,0,0,0,
Harmon,Governor,Rex Lawhorn,LIB,290203,0,0,0,0,
Harmon,Corporation Commissioner,Ashley Nicole Mccray,DEM,290203,0,0,1,1,
Harmon,Corporation Commissioner,Blake Cummings,DEM,290203,0,0,0,0,
Harmon,Governor,Mick Cornett,REP,290204,0,0,0,0,
Harmon,Governor,Kevin Stitt,REP,290204,0,1,4,5,
Harmon,Lieutenant Governor,Dana Murphy,REP,290204,0,0,2,2,
Harmon,Lieutenant Governor,Matt Pinnell,REP,290204,0,1,2,3,
Harmon,State Auditor,Cindy Byrd,REP,290204,0,1,0,1,
Harmon,State Auditor,Charlie Prater,REP,290204,0,0,4,4,
Harmon,Attorney General,Mike Hunter,REP,290204,0,1,3,4,
Harmon,Attorney General,Gentner Drummond,REP,290204,0,0,0,0,
Harmon,Superintendent of Public Instruction,Joy Hofmeister,REP,290204,0,0,4,4,
Harmon,Superintendent of Public Instruction,Linda Murphy,REP,290204,0,1,0,1,
Harmon,Commissioner of Labor,Cathy Costello,REP,290204,0,1,2,3,
Harmon,Commissioner of Labor,Leslie Osborn,REP,290204,0,0,1,1,
Harmon,Corporation Commissioner,Bob Anthony,REP,290204,0,1,2,3,
Harmon,Corporation Commissioner,Brian Bingman,REP,290204,0,0,1,1,
Harmon,Governor,Chris Powell,LIB,290204,0,0,0,0,
Harmon,Governor,Rex Lawhorn,LIB,290204,0,0,0,0,
Harmon,Corporation Commissioner,Ashley Nicole Mccray,DEM,290204,0,0,0,0,
Harmon,Corporation Commissioner,Blake Cummings,DEM,290204,0,0,3,3,
Harmon,Governor,Mick Cornett,REP,290301,0,0,3,3,
Harmon,Governor,Kevin Stitt,REP,290301,1,0,14,15,
Harmon,Lieutenant Governor,Dana Murphy,REP,290301,0,0,5,5,
Harmon,Lieutenant Governor,Matt Pinnell,REP,290301,1,0,12,13,
Harmon,State Auditor,Cindy Byrd,REP,290301,0,0,8,8,
Harmon,State Auditor,Charlie Prater,REP,290301,0,0,9,9,
Harmon,Attorney General,Mike Hunter,REP,290301,1,0,7,8,
Harmon,Attorney General,Gentner Drummond,REP,290301,0,0,9,9,
Harmon,Superintendent of Public Instruction,Joy Hofmeister,REP,290301,1,0,10,11,
Harmon,Superintendent of Public Instruction,Linda Murphy,REP,290301,0,0,6,6,
Harmon,Commissioner of Labor,Cathy Costello,REP,290301,0,0,4,4,
Harmon,Commissioner of Labor,Leslie Osborn,REP,290301,0,0,12,12,
Harmon,Corporation Commissioner,Bob Anthony,REP,290301,1,0,5,6,
Harmon,Corporation Commissioner,Brian Bingman,REP,290301,0,0,11,11,
Harmon,Governor,Chris Powell,LIB,290301,0,0,0,0,
Harmon,Governor,Rex Lawhorn,LIB,290301,0,0,0,0,
Harmon,Corporation Commissioner,Ashley Nicole Mccray,DEM,290301,0,1,2,3,
Harmon,Corporation Commissioner,Blake Cummings,DEM,290301,1,1,3,5,
Harmon,Governor,Mick Cornett,REP,290302,0,0,24,24,
Harmon,Governor,Kevin Stitt,REP,290302,1,0,19,20,
Harmon,Lieutenant Governor,Dana Murphy,REP,290302,0,0,15,15,
Harmon,Lieutenant Governor,Matt Pinnell,REP,290302,1,0,28,29,
Harmon,State Auditor,Cindy Byrd,REP,290302,1,0,15,16,
Harmon,State Auditor,Charlie Prater,REP,290302,0,0,26,26,
Harmon,Attorney General,Mike Hunter,REP,290302,0,0,19,19,
Harmon,Attorney General,Gentner Drummond,REP,290302,1,0,24,25,
Harmon,Superintendent of Public Instruction,Joy Hofmeister,REP,290302,0,0,29,29,
Harmon,Superintendent of Public Instruction,Linda Murphy,REP,290302,1,0,14,15,
Harmon,Commissioner of Labor,Cathy Costello,REP,290302,1,0,13,14,
Harmon,Commissioner of Labor,Leslie Osborn,REP,290302,0,0,28,28,
Harmon,Corporation Commissioner,Bob Anthony,REP,290302,0,0,15,15,
Harmon,Corporation Commissioner,Brian Bingman,REP,290302,1,0,27,28,
Harmon,Governor,Chris Powell,LIB,290302,0,0,0,0,
Harmon,Governor,Rex Lawhorn,LIB,290302,0,0,0,0,
Harmon,Corporation Commissioner,Ashley Nicole Mccray,DEM,290302,0,0,5,5,
Harmon,Corporation Commissioner,Blake Cummings,DEM,290302,0,0,9,9,
Harper,Governor,Mick Cornett,REP,300201,2,1,58,61,
Harper,Governor,Kevin Stitt,REP,300201,5,7,175,187,
Harper,Lieutenant Governor,Dana Murphy,REP,300201,6,6,191,203,
Harper,Lieutenant Governor,Matt Pinnell,REP,300201,1,2,44,47,
Harper,State Auditor,Cindy Byrd,REP,300201,4,5,93,102,
Harper,State Auditor,Charlie Prater,REP,300201,3,3,128,134,
Harper,Attorney General,Mike Hunter,REP,300201,3,4,116,123,
Harper,Attorney General,Gentner Drummond,REP,300201,4,4,114,122,
Harper,Superintendent of Public Instruction,Joy Hofmeister,REP,300201,3,1,125,129,
Harper,Superintendent of Public Instruction,Linda Murphy,REP,300201,4,7,108,119,
Harper,Commissioner of Labor,Cathy Costello,REP,300201,3,4,123,130,
Harper,Commissioner of Labor,Leslie Osborn,REP,300201,4,4,104,112,
Harper,Corporation Commissioner,Bob Anthony,REP,300201,5,8,124,137,
Harper,Corporation Commissioner,Brian Bingman,REP,300201,2,0,105,107,
Harper,State House,Kenton Patzkowsky,REP,300201,5,7,143,155,61
Harper,State House,Brad Raven,REP,300201,2,1,95,98,61
Harper,Governor,Chris Powell,LIB,300201,0,0,0,0,
Harper,Governor,Rex Lawhorn,LIB,300201,0,0,0,0,
Harper,Corporation Commissioner,Ashley Nicole Mccray,DEM,300201,0,0,20,20,
Harper,Corporation Commissioner,Blake Cummings,DEM,300201,0,0,19,19,
Harper,Governor,Mick Cornett,REP,300203,2,1,16,19,
Harper,Governor,Kevin Stitt,REP,300203,2,0,29,31,
Harper,Lieutenant Governor,Dana Murphy,REP,300203,4,1,29,34,
Harper,Lieutenant Governor,Matt Pinnell,REP,300203,0,0,14,14,
Harper,State Auditor,Cindy Byrd,REP,300203,1,0,18,19,
Harper,State Auditor,Charlie Prater,REP,300203,3,1,25,29,
Harper,Attorney General,Mike Hunter,REP,300203,3,0,13,16,
Harper,Attorney General,Gentner Drummond,REP,300203,1,1,32,34,
Harper,Superintendent of Public Instruction,Joy Hofmeister,REP,300203,1,0,26,27,
Harper,Superintendent of Public Instruction,Linda Murphy,REP,300203,3,1,17,21,
Harper,Commissioner of Labor,Cathy Costello,REP,300203,1,1,16,18,
Harper,Commissioner of Labor,Leslie Osborn,REP,300203,3,0,25,28,
Harper,Corporation Commissioner,Bob Anthony,REP,300203,1,1,18,20,
Harper,Corporation Commissioner,Brian Bingman,REP,300203,3,0,24,27,
Harper,State House,Kenton Patzkowsky,REP,300203,2,0,20,22,61
Harper,State House,Brad Raven,REP,300203,2,1,25,28,61
Harper,Governor,Chris Powell,LIB,300203,0,0,0,0,
Harper,Governor,Rex Lawhorn,LIB,300203,0,0,0,0,
Harper,Corporation Commissioner,Ashley Nicole Mccray,DEM,300203,0,0,7,7,
Harper,Corporation Commissioner,Blake Cummings,DEM,300203,0,1,1,2,
Harper,Governor,Mick Cornett,REP,300301,0,2,29,31,
Harper,Governor,Kevin Stitt,REP,300301,1,5,50,56,
Harper,Lieutenant Governor,Dana Murphy,REP,300301,1,6,48,55,
Harper,Lieutenant Governor,Matt Pinnell,REP,300301,0,1,34,35,
Harper,State Auditor,Cindy Byrd,REP,300301,1,3,27,31,
Harper,State Auditor,Charlie Prater,REP,300301,0,4,54,58,
Harper,Attorney General,Mike Hunter,REP,300301,1,1,37,39,
Harper,Attorney General,Gentner Drummond,REP,300301,0,6,43,49,
Harper,Superintendent of Public Instruction,Joy Hofmeister,REP,300301,0,2,42,44,
Harper,Superintendent of Public Instruction,Linda Murphy,REP,300301,1,5,40,46,
Harper,Commissioner of Labor,Cathy Costello,REP,300301,1,2,35,38,
Harper,Commissioner of Labor,Leslie Osborn,REP,300301,0,5,45,50,
Harper,Corporation Commissioner,Bob Anthony,REP,300301,0,4,42,46,
Harper,Corporation Commissioner,Brian Bingman,REP,300301,1,3,34,38,
Harper,State House,Kenton Patzkowsky,REP,300301,1,4,34,39,61
Harper,State House,Brad Raven,REP,300301,0,3,45,48,61
Harper,Governor,Chris Powell,LIB,300301,0,0,0,0,
Harper,Governor,Rex Lawhorn,LIB,300301,0,0,0,0,
Harper,Corporation Commissioner,Ashley Nicole Mccray,DEM,300301,1,1,15,17,
Harper,Corporation Commissioner,Blake Cummings,DEM,300301,0,0,5,5,
Harper,Governor,Mick Cornett,REP,300302,0,3,6,9,
Harper,Governor,Kevin Stitt,REP,300302,0,1,17,18,
Harper,Lieutenant Governor,Dana Murphy,REP,300302,0,3,18,21,
Harper,Lieutenant Governor,Matt Pinnell,REP,300302,0,1,6,7,
Harper,State Auditor,Cindy Byrd,REP,300302,0,1,7,8,
Harper,State Auditor,Charlie Prater,REP,300302,0,3,14,17,
Harper,Attorney General,Mike Hunter,REP,300302,0,2,13,15,
Harper,Attorney General,Gentner Drummond,REP,300302,0,2,10,12,
Harper,Superintendent of Public Instruction,Joy Hofmeister,REP,300302,0,4,10,14,
Harper,Superintendent of Public Instruction,Linda Murphy,REP,300302,0,0,13,13,
Harper,Commissioner of Labor,Cathy Costello,REP,300302,0,1,10,11,
Harper,Commissioner of Labor,Leslie Osborn,REP,300302,0,3,13,16,
Harper,Corporation Commissioner,Bob Anthony,REP,300302,0,3,13,16,
Harper,Corporation Commissioner,Brian Bingman,REP,300302,0,1,9,10,
Harper,State House,Kenton Patzkowsky,REP,300302,0,3,14,17,61
Harper,State House,Brad Raven,REP,300302,0,1,10,11,61
Harper,Governor,Chris Powell,LIB,300302,0,0,0,0,
Harper,Governor,Rex Lawhorn,LIB,300302,0,0,0,0,
Harper,Corporation Commissioner,Ashley Nicole Mccray,DEM,300302,0,1,1,2,
Harper,Corporation Commissioner,Blake Cummings,DEM,300302,0,0,1,1,
Harper,Governor,Mick Cornett,REP,300303,1,1,14,16,
Harper,Governor,Kevin Stitt,REP,300303,1,3,30,34,
Harper,Lieutenant Governor,Dana Murphy,REP,300303,2,3,28,33,
Harper,Lieutenant Governor,Matt Pinnell,REP,300303,0,1,16,17,
Harper,State Auditor,Cindy Byrd,REP,300303,2,4,19,25,
Harper,State Auditor,Charlie Prater,REP,300303,0,0,23,23,
Harper,Attorney General,Mike Hunter,REP,300303,0,2,26,28,
Harper,Attorney General,Gentner Drummond,REP,300303,2,2,18,22,
Harper,Superintendent of Public Instruction,Joy Hofmeister,REP,300303,1,1,24,26,
Harper,Superintendent of Public Instruction,Linda Murphy,REP,300303,1,3,17,21,
Harper,Commissioner of Labor,Cathy Costello,REP,300303,0,1,23,24,
Harper,Commissioner of Labor,Leslie Osborn,REP,300303,2,3,19,24,
Harper,Corporation Commissioner,Bob Anthony,REP,300303,0,2,30,32,
Harper,Corporation Commissioner,Brian Bingman,REP,300303,2,2,12,16,
Harper,State House,Kenton Patzkowsky,REP,300303,2,1,26,29,61
Harper,State House,Brad Raven,REP,300303,0,3,16,19,61
Harper,Governor,Chris Powell,LIB,300303,0,0,0,0,
Harper,Governor,Rex Lawhorn,LIB,300303,0,0,0,0,
Harper,Corporation Commissioner,Ashley Nicole Mccray,DEM,300303,0,1,3,4,
Harper,Corporation Commissioner,Blake Cummings,DEM,300303,0,1,1,2,
Harper,Governor,Mick Cornett,REP,300402,2,7,37,46,
Harper,Governor,Kevin Stitt,REP,300402,4,11,60,75,
Harper,Lieutenant Governor,Dana Murphy,REP,300402,5,13,57,75,
Harper,Lieutenant Governor,Matt Pinnell,REP,300402,1,5,41,47,
Harper,State Auditor,Cindy Byrd,REP,300402,2,9,38,49,
Harper,State Auditor,Charlie Prater,REP,300402,3,9,56,68,
Harper,Attorney General,Mike Hunter,REP,300402,3,8,40,51,
Harper,Attorney General,Gentner Drummond,REP,300402,3,10,55,68,
Harper,Superintendent of Public Instruction,Joy Hofmeister,REP,300402,3,15,47,65,
Harper,Superintendent of Public Instruction,Linda Murphy,REP,300402,3,3,49,55,
Harper,Commissioner of Labor,Cathy Costello,REP,300402,3,9,38,50,
Harper,Commissioner of Labor,Leslie Osborn,REP,300402,2,7,57,66,
Harper,Corporation Commissioner,Bob Anthony,REP,300402,1,13,65,79,
Harper,Corporation Commissioner,Brian Bingman,REP,300402,5,5,29,39,
Harper,State House,Kenton Patzkowsky,REP,300402,1,11,45,57,61
Harper,State House,Brad Raven,REP,300402,5,7,52,64,61
Harper,Governor,Chris Powell,LIB,300402,0,0,0,0,
Harper,Governor,Rex Lawhorn,LIB,300402,0,0,0,0,
Harper,Corporation Commissioner,Ashley Nicole Mccray,DEM,300402,3,0,7,10,
Harper,Corporation Commissioner,Blake Cummings,DEM,300402,0,2,7,9,
Haskell,Governor,Mick Cornett,REP,310007,0,2,4,6,
Haskell,Governor,Kevin Stitt,REP,310007,0,0,16,16,
Haskell,Lieutenant Governor,Dana Murphy,REP,310007,0,1,5,6,
Haskell,Lieutenant Governor,Matt Pinnell,REP,310007,0,1,15,16,
Haskell,State Auditor,Cindy Byrd,REP,310007,0,2,9,11,
Haskell,State Auditor,Charlie Prater,REP,310007,0,0,10,10,
Haskell,Attorney General,Mike Hunter,REP,310007,0,0,5,5,
Haskell,Attorney General,Gentner Drummond,REP,310007,0,2,15,17,
Haskell,Superintendent of Public Instruction,Joy Hofmeister,REP,310007,0,1,12,13,
Haskell,Superintendent of Public Instruction,Linda Murphy,REP,310007,0,1,8,9,
Haskell,Commissioner of Labor,Cathy Costello,REP,310007,0,1,4,5,
Haskell,Commissioner of Labor,Leslie Osborn,REP,310007,0,1,16,17,
Haskell,Corporation Commissioner,Bob Anthony,REP,310007,0,1,4,5,
Haskell,Corporation Commissioner,Brian Bingman,REP,310007,0,1,15,16,
Haskell,Governor,Chris Powell,LIB,310007,0,0,0,0,
Haskell,Governor,Rex Lawhorn,LIB,310007,0,0,0,0,
Haskell,Corporation Commissioner,Ashley Nicole Mccray,DEM,310007,0,0,11,11,
Haskell,Corporation Commissioner,Blake Cummings,DEM,310007,0,2,16,18,
Haskell,U.S. House,Jason Nichols,DEM,310007,0,0,16,16,02
Haskell,U.S. House,Clay Padgett,DEM,310007,0,2,10,12,02
Haskell,Governor,Mick Cornett,REP,310009,0,0,3,3,
Haskell,Governor,Kevin Stitt,REP,310009,0,0,6,6,
Haskell,Lieutenant Governor,Dana Murphy,REP,310009,0,0,4,4,
Haskell,Lieutenant Governor,Matt Pinnell,REP,310009,0,0,5,5,
Haskell,State Auditor,Cindy Byrd,REP,310009,0,0,3,3,
Haskell,State Auditor,Charlie Prater,REP,310009,0,0,6,6,
Haskell,Attorney General,Mike Hunter,REP,310009,0,0,1,1,
Haskell,Attorney General,Gentner Drummond,REP,310009,0,0,8,8,
Haskell,Superintendent of Public Instruction,Joy Hofmeister,REP,310009,0,0,4,4,
Haskell,Superintendent of Public Instruction,Linda Murphy,REP,310009,0,0,5,5,
Haskell,Commissioner of Labor,Cathy Costello,REP,310009,0,0,3,3,
Haskell,Commissioner of Labor,Leslie Osborn,REP,310009,0,0,6,6,
Haskell,Corporation Commissioner,Bob Anthony,REP,310009,0,0,1,1,
Haskell,Corporation Commissioner,Brian Bingman,REP,310009,0,0,8,8,
Haskell,Governor,Chris Powell,LIB,310009,0,0,0,0,
Haskell,Governor,Rex Lawhorn,LIB,310009,0,0,0,0,
Haskell,Corporation Commissioner,Ashley Nicole Mccray,DEM,310009,0,0,1,1,
Haskell,Corporation Commissioner,Blake Cummings,DEM,310009,2,3,15,20,
Haskell,U.S. House,Jason Nichols,DEM,310009,2,0,10,12,02
Haskell,U.S. House,Clay Padgett,DEM,310009,0,3,5,8,02
Haskell,Governor,Mick Cornett,REP,310011,0,0,2,2,
Haskell,Governor,Kevin Stitt,REP,310011,2,0,21,23,
Haskell,Lieutenant Governor,Dana Murphy,REP,310011,0,0,8,8,
Haskell,Lieutenant Governor,Matt Pinnell,REP,310011,2,0,15,17,
Haskell,State Auditor,Cindy Byrd,REP,310011,2,0,11,13,
Haskell,State Auditor,Charlie Prater,REP,310011,0,0,10,10,
Haskell,Attorney General,Mike Hunter,REP,310011,0,0,8,8,
Haskell,Attorney General,Gentner Drummond,REP,310011,2,0,14,16,
Haskell,Superintendent of Public Instruction,Joy Hofmeister,REP,310011,2,0,8,10,
Haskell,Superintendent of Public Instruction,Linda Murphy,REP,310011,0,0,13,13,
Haskell,Commissioner of Labor,Cathy Costello,REP,310011,2,0,9,11,
Haskell,Commissioner of Labor,Leslie Osborn,REP,310011,0,0,12,12,
Haskell,Corporation Commissioner,Bob Anthony,REP,310011,2,0,11,13,
Haskell,Corporation Commissioner,Brian Bingman,REP,310011,0,0,11,11,
Haskell,Governor,Chris Powell,LIB,310011,0,0,0,0,
Haskell,Governor,Rex Lawhorn,LIB,310011,0,0,0,0,
Haskell,Corporation Commissioner,Ashley Nicole Mccray,DEM,310011,0,2,3,5,
Haskell,Corporation Commissioner,Blake Cummings,DEM,310011,0,0,12,12,
Haskell,U.S. House,Jason Nichols,DEM,310011,0,2,10,12,02
Haskell,U.S. House,Clay Padgett,DEM,310011,0,0,5,5,02
Haskell,Governor,Mick Cornett,REP,310015,0,2,7,9,
Haskell,Governor,Kevin Stitt,REP,310015,0,2,10,12,
Haskell,Lieutenant Governor,Dana Murphy,REP,310015,0,2,4,6,
Haskell,Lieutenant Governor,Matt Pinnell,REP,310015,0,2,13,15,
Haskell,State Auditor,Cindy Byrd,REP,310015,0,1,3,4,
Haskell,State Auditor,Charlie Prater,REP,310015,0,2,14,16,
Haskell,Attorney General,Mike Hunter,REP,310015,0,1,8,9,
Haskell,Attorney General,Gentner Drummond,REP,310015,0,2,9,11,
Haskell,Superintendent of Public Instruction,Joy Hofmeister,REP,310015,0,1,8,9,
Haskell,Superintendent of Public Instruction,Linda Murphy,REP,310015,0,3,9,12,
Haskell,Commissioner of Labor,Cathy Costello,REP,310015,0,1,5,6,
Haskell,Commissioner of Labor,Leslie Osborn,REP,310015,0,2,11,13,
Haskell,Corporation Commissioner,Bob Anthony,REP,310015,0,1,6,7,
Haskell,Corporation Commissioner,Brian Bingman,REP,310015,0,2,10,12,
Haskell,Governor,Chris Powell,LIB,310015,0,0,0,0,
Haskell,Governor,Rex Lawhorn,LIB,310015,0,0,0,0,
Haskell,Corporation Commissioner,Ashley Nicole Mccray,DEM,310015,1,2,13,16,
Haskell,Corporation Commissioner,Blake Cummings,DEM,310015,1,8,23,32,
Haskell,U.S. House,Jason Nichols,DEM,310015,1,2,21,24,02
Haskell,U.S. House,Clay Padgett,DEM,310015,1,8,14,23,02
Haskell,Governor,Mick Cornett,REP,310016,1,0,13,14,
Haskell,Governor,Kevin Stitt,REP,310016,0,3,20,23,
Haskell,Lieutenant Governor,Dana Murphy,REP,310016,0,1,15,16,
Haskell,Lieutenant Governor,Matt Pinnell,REP,310016,1,2,19,22,
Haskell,State Auditor,Cindy Byrd,REP,310016,1,3,15,19,
Haskell,State Auditor,Charlie Prater,REP,310016,0,0,18,18,
Haskell,Attorney General,Mike Hunter,REP,310016,1,3,17,21,
Haskell,Attorney General,Gentner Drummond,REP,310016,0,0,16,16,
Haskell,Superintendent of Public Instruction,Joy Hofmeister,REP,310016,0,2,18,20,
Haskell,Superintendent of Public Instruction,Linda Murphy,REP,310016,1,1,14,16,
Haskell,Commissioner of Labor,Cathy Costello,REP,310016,0,2,19,21,
Haskell,Commissioner of Labor,Leslie Osborn,REP,310016,1,0,14,15,
Haskell,Corporation Commissioner,Bob Anthony,REP,310016,0,2,12,14,
Haskell,Corporation Commissioner,Brian Bingman,REP,310016,1,1,20,22,
Haskell,Governor,Chris Powell,LIB,310016,0,0,0,0,
Haskell,Governor,Rex Lawhorn,LIB,310016,0,0,0,0,
Haskell,Corporation Commissioner,Ashley Nicole Mccray,DEM,310016,2,2,13,17,
Haskell,Corporation Commissioner,Blake Cummings,DEM,310016,0,2,35,37,
Haskell,U.S. House,Jason Nichols,DEM,310016,2,3,33,38,02
Haskell,U.S. House,Clay Padgett,DEM,310016,0,1,15,16,02
Haskell,Governor,Mick Cornett,REP,310019,0,1,6,7,
Haskell,Governor,Kevin Stitt,REP,310019,0,1,32,33,
Haskell,Lieutenant Governor,Dana Murphy,REP,310019,0,1,11,12,
Haskell,Lieutenant Governor,Matt Pinnell,REP,310019,0,0,27,27,
Haskell,State Auditor,Cindy Byrd,REP,310019,0,0,15,15,
Haskell,State Auditor,Charlie Prater,REP,310019,0,1,22,23,
Haskell,Attorney General,Mike Hunter,REP,310019,0,0,15,15,
Haskell,Attorney General,Gentner Drummond,REP,310019,0,2,24,26,
Haskell,Superintendent of Public Instruction,Joy Hofmeister,REP,310019,0,1,19,20,
Haskell,Superintendent of Public Instruction,Linda Murphy,REP,310019,0,1,17,18,
Haskell,Commissioner of Labor,Cathy Costello,REP,310019,0,0,18,18,
Haskell,Commissioner of Labor,Leslie Osborn,REP,310019,0,1,18,19,
Haskell,Corporation Commissioner,Bob Anthony,REP,310019,0,2,23,25,
Haskell,Corporation Commissioner,Brian Bingman,REP,310019,0,0,16,16,
Haskell,Governor,Chris Powell,LIB,310019,0,0,0,0,
Haskell,Governor,Rex Lawhorn,LIB,310019,0,0,0,0,
Haskell,Corporation Commissioner,Ashley Nicole Mccray,DEM,310019,0,0,23,23,
Haskell,Corporation Commissioner,Blake Cummings,DEM,310019,1,8,50,59,
Haskell,U.S. House,Jason Nichols,DEM,310019,1,6,44,51,02
Haskell,U.S. House,Clay Padgett,DEM,310019,0,2,29,31,02
Haskell,Governor,Mick Cornett,REP,310023,0,0,11,11,
Haskell,Governor,Kevin Stitt,REP,310023,1,0,50,51,
Haskell,Lieutenant Governor,Dana Murphy,REP,310023,1,0,14,15,
Haskell,Lieutenant Governor,Matt Pinnell,REP,310023,0,0,47,47,
Haskell,State Auditor,Cindy Byrd,REP,310023,0,0,28,28,
Haskell,State Auditor,Charlie Prater,REP,310023,1,0,32,33,
Haskell,Attorney General,Mike Hunter,REP,310023,0,0,24,24,
Haskell,Attorney General,Gentner Drummond,REP,310023,1,0,37,38,
Haskell,Superintendent of Public Instruction,Joy Hofmeister,REP,310023,1,0,30,31,
Haskell,Superintendent of Public Instruction,Linda Murphy,REP,310023,0,0,31,31,
Haskell,Commissioner of Labor,Cathy Costello,REP,310023,0,0,16,16,
Haskell,Commissioner of Labor,Leslie Osborn,REP,310023,1,0,45,46,
Haskell,Corporation Commissioner,Bob Anthony,REP,310023,0,0,24,24,
Haskell,Corporation Commissioner,Brian Bingman,REP,310023,1,0,35,36,
Haskell,Governor,Chris Powell,LIB,310023,0,0,0,0,
Haskell,Governor,Rex Lawhorn,LIB,310023,0,0,0,0,
Haskell,Corporation Commissioner,Ashley Nicole Mccray,DEM,310023,1,0,38,39,
Haskell,Corporation Commissioner,Blake Cummings,DEM,310023,0,4,62,66,
Haskell,U.S. House,Jason Nichols,DEM,310023,1,3,50,54,02
Haskell,U.S. House,Clay Padgett,DEM,310023,0,1,47,48,02
Haskell,Governor,Mick Cornett,REP,310027,0,3,8,11,
Haskell,Governor,Kevin Stitt,REP,310027,2,6,16,24,
Haskell,Lieutenant Governor,Dana Murphy,REP,310027,2,6,6,14,
Haskell,Lieutenant Governor,Matt Pinnell,REP,310027,0,3,17,20,
Haskell,State Auditor,Cindy Byrd,REP,310027,1,2,11,14,
Haskell,State Auditor,Charlie Prater,REP,310027,1,6,12,19,
Haskell,Attorney General,Mike Hunter,REP,310027,1,4,9,14,
Haskell,Attorney General,Gentner Drummond,REP,310027,1,5,15,21,
Haskell,Superintendent of Public Instruction,Joy Hofmeister,REP,310027,2,7,12,21,
Haskell,Superintendent of Public Instruction,Linda Murphy,REP,310027,0,2,12,14,
Haskell,Commissioner of Labor,Cathy Costello,REP,310027,1,3,9,13,
Haskell,Commissioner of Labor,Leslie Osborn,REP,310027,1,5,15,21,
Haskell,Corporation Commissioner,Bob Anthony,REP,310027,2,7,10,19,
Haskell,Corporation Commissioner,Brian Bingman,REP,310027,0,2,13,15,
Haskell,Governor,Chris Powell,LIB,310027,0,0,0,0,
Haskell,Governor,Rex Lawhorn,LIB,310027,0,0,0,0,
Haskell,Corporation Commissioner,Ashley Nicole Mccray,DEM,310027,1,6,8,15,
Haskell,Corporation Commissioner,Blake Cummings,DEM,310027,3,7,45,55,
Haskell,U.S. House,Jason Nichols,DEM,310027,3,4,19,26,02
Haskell,U.S. House,Clay Padgett,DEM,310027,1,9,29,39,02
Haskell,Governor,Mick Cornett,REP,310030,0,1,12,13,
Haskell,Governor,Kevin Stitt,REP,310030,0,0,26,26,
Haskell,Lieutenant Governor,Dana Murphy,REP,310030,0,1,12,13,
Haskell,Lieutenant Governor,Matt Pinnell,REP,310030,0,0,25,25,
Haskell,State Auditor,Cindy Byrd,REP,310030,0,1,18,19,
Haskell,State Auditor,Charlie Prater,REP,310030,0,0,17,17,
Haskell,Attorney General,Mike Hunter,REP,310030,0,1,15,16,
Haskell,Attorney General,Gentner Drummond,REP,310030,0,0,23,23,
Haskell,Superintendent of Public Instruction,Joy Hofmeister,REP,310030,0,0,20,20,
Haskell,Superintendent of Public Instruction,Linda Murphy,REP,310030,0,1,16,17,
Haskell,Commissioner of Labor,Cathy Costello,REP,310030,0,1,13,14,
Haskell,Commissioner of Labor,Leslie Osborn,REP,310030,0,0,24,24,
Haskell,Corporation Commissioner,Bob Anthony,REP,310030,0,0,21,21,
Haskell,Corporation Commissioner,Brian Bingman,REP,310030,0,1,17,18,
Haskell,Governor,Chris Powell,LIB,310030,0,0,0,0,
Haskell,Governor,Rex Lawhorn,LIB,310030,0,0,0,0,
Haskell,Corporation Commissioner,Ashley Nicole Mccray,DEM,310030,2,2,14,18,
Haskell,Corporation Commissioner,Blake Cummings,DEM,310030,2,4,27,33,
Haskell,U.S. House,Jason Nichols,DEM,310030,1,4,22,27,02
Haskell,U.S. House,Clay Padgett,DEM,310030,3,2,18,23,02
Haskell,Governor,Mick Cornett,REP,310031,0,0,8,8,
Haskell,Governor,Kevin Stitt,REP,310031,2,2,34,38,
Haskell,Lieutenant Governor,Dana Murphy,REP,310031,0,2,14,16,
Haskell,Lieutenant Governor,Matt Pinnell,REP,310031,2,0,27,29,
Haskell,State Auditor,Cindy Byrd,REP,310031,2,0,22,24,
Haskell,State Auditor,Charlie Prater,REP,310031,0,2,21,23,
Haskell,Attorney General,Mike Hunter,REP,310031,0,2,19,21,
Haskell,Attorney General,Gentner Drummond,REP,310031,2,0,24,26,
Haskell,Superintendent of Public Instruction,Joy Hofmeister,REP,310031,0,2,16,18,
Haskell,Superintendent of Public Instruction,Linda Murphy,REP,310031,2,0,27,29,
Haskell,Commissioner of Labor,Cathy Costello,REP,310031,2,2,19,23,
Haskell,Commissioner of Labor,Leslie Osborn,REP,310031,0,0,22,22,
Haskell,Corporation Commissioner,Bob Anthony,REP,310031,2,0,24,26,
Haskell,Corporation Commissioner,Brian Bingman,REP,310031,0,2,18,20,
Haskell,Governor,Chris Powell,LIB,310031,0,0,0,0,
Haskell,Governor,Rex Lawhorn,LIB,310031,0,0,0,0,
Haskell,Corporation Commissioner,Ashley Nicole Mccray,DEM,310031,1,1,20,22,
Haskell,Corporation Commissioner,Blake Cummings,DEM,310031,16,6,47,69,
Haskell,U.S. House,Jason Nichols,DEM,310031,15,5,43,63,02
Haskell,U.S. House,Clay Padgett,DEM,310031,2,2,24,28,02
Haskell,Governor,Mick Cornett,REP,310032,0,1,10,11,
Haskell,Governor,Kevin Stitt,REP,310032,0,1,29,30,
Haskell,Lieutenant Governor,Dana Murphy,REP,310032,0,0,14,14,
Haskell,Lieutenant Governor,Matt Pinnell,REP,310032,0,2,22,24,
Haskell,State Auditor,Cindy Byrd,REP,310032,0,1,21,22,
Haskell,State Auditor,Charlie Prater,REP,310032,0,1,14,15,
Haskell,Attorney General,Mike Hunter,REP,310032,0,2,16,18,
Haskell,Attorney General,Gentner Drummond,REP,310032,0,0,22,22,
Haskell,Superintendent of Public Instruction,Joy Hofmeister,REP,310032,0,0,16,16,
Haskell,Superintendent of Public Instruction,Linda Murphy,REP,310032,0,2,20,22,
Haskell,Commissioner of Labor,Cathy Costello,REP,310032,0,1,15,16,
Haskell,Commissioner of Labor,Leslie Osborn,REP,310032,0,1,20,21,
Haskell,Corporation Commissioner,Bob Anthony,REP,310032,0,1,19,20,
Haskell,Corporation Commissioner,Brian Bingman,REP,310032,0,1,18,19,
Haskell,Governor,Chris Powell,LIB,310032,0,0,0,0,
Haskell,Governor,Rex Lawhorn,LIB,310032,0,0,0,0,
Haskell,Corporation Commissioner,Ashley Nicole Mccray,DEM,310032,2,1,12,15,
Haskell,Corporation Commissioner,Blake Cummings,DEM,310032,0,10,38,48,
Haskell,U.S. House,Jason Nichols,DEM,310032,0,6,30,36,02
Haskell,U.S. House,Clay Padgett,DEM,310032,2,5,18,25,02
Hughes,Governor,Mick Cornett,REP,320010,0,0,0,0,
Hughes,Governor,Kevin Stitt,REP,320010,0,0,0,0,
Hughes,Lieutenant Governor,Dana Murphy,REP,320010,0,0,0,0,
Hughes,Lieutenant Governor,Matt Pinnell,REP,320010,0,0,0,0,
Hughes,State Auditor,Cindy Byrd,REP,320010,0,0,0,0,
Hughes,State Auditor,Charlie Prater,REP,320010,0,0,0,0,
Hughes,Attorney General,Mike Hunter,REP,320010,0,0,0,0,
Hughes,Attorney General,Gentner Drummond,REP,320010,0,0,0,0,
Hughes,Superintendent of Public Instruction,Joy Hofmeister,REP,320010,0,0,0,0,
Hughes,Superintendent of Public Instruction,Linda Murphy,REP,320010,0,0,0,0,
Hughes,Commissioner of Labor,Cathy Costello,REP,320010,0,0,0,0,
Hughes,Commissioner of Labor,Leslie Osborn,REP,320010,0,0,0,0,
Hughes,Corporation Commissioner,Bob Anthony,REP,320010,0,0,0,0,
Hughes,Corporation Commissioner,Brian Bingman,REP,320010,0,0,0,0,
Hughes,Governor,Chris Powell,LIB,320010,0,0,0,0,
Hughes,Governor,Rex Lawhorn,LIB,320010,0,0,0,0,
Hughes,Corporation Commissioner,Ashley Nicole Mccray,DEM,320010,0,0,0,0,
Hughes,Corporation Commissioner,Blake Cummings,DEM,320010,0,0,0,0,
Hughes,U.S. House,Jason Nichols,DEM,320010,0,0,0,0,02
Hughes,U.S. House,Clay Padgett,DEM,320010,0,0,0,0,02
Hughes,Governor,Mick Cornett,REP,320011,0,5,39,44,
Hughes,Governor,Kevin Stitt,REP,320011,2,3,45,50,
Hughes,Lieutenant Governor,Dana Murphy,REP,320011,0,3,32,35,
Hughes,Lieutenant Governor,Matt Pinnell,REP,320011,2,5,48,55,
Hughes,State Auditor,Cindy Byrd,REP,320011,0,4,45,49,
Hughes,State Auditor,Charlie Prater,REP,320011,2,4,35,41,
Hughes,Attorney General,Mike Hunter,REP,320011,0,3,41,44,
Hughes,Attorney General,Gentner Drummond,REP,320011,2,5,42,49,
Hughes,Superintendent of Public Instruction,Joy Hofmeister,REP,320011,0,5,42,47,
Hughes,Superintendent of Public Instruction,Linda Murphy,REP,320011,2,3,43,48,
Hughes,Commissioner of Labor,Cathy Costello,REP,320011,2,4,40,46,
Hughes,Commissioner of Labor,Leslie Osborn,REP,320011,0,4,42,46,
Hughes,Corporation Commissioner,Bob Anthony,REP,320011,0,6,45,51,
Hughes,Corporation Commissioner,Brian Bingman,REP,320011,2,2,36,40,
Hughes,Governor,Chris Powell,LIB,320011,0,0,1,1,
Hughes,Governor,Rex Lawhorn,LIB,320011,0,0,0,0,
Hughes,Corporation Commissioner,Ashley Nicole Mccray,DEM,320011,0,7,91,98,
Hughes,Corporation Commissioner,Blake Cummings,DEM,320011,3,15,87,105,
Hughes,U.S. House,Jason Nichols,DEM,320011,0,9,100,109,02
Hughes,U.S. House,Clay Padgett,DEM,320011,3,13,81,97,02
Hughes,Governor,Mick Cornett,REP,320012,2,4,19,25,
Hughes,Governor,Kevin Stitt,REP,320012,1,2,30,33,
Hughes,Lieutenant Governor,Dana Murphy,REP,320012,3,3,19,25,
Hughes,Lieutenant Governor,Matt Pinnell,REP,320012,0,3,29,32,
Hughes,State Auditor,Cindy Byrd,REP,320012,1,1,28,30,
Hughes,State Auditor,Charlie Prater,REP,320012,2,5,20,27,
Hughes,Attorney General,Mike Hunter,REP,320012,2,5,23,30,
Hughes,Attorney General,Gentner Drummond,REP,320012,1,1,26,28,
Hughes,Superintendent of Public Instruction,Joy Hofmeister,REP,320012,0,2,19,21,
Hughes,Superintendent of Public Instruction,Linda Murphy,REP,320012,3,4,30,37,
Hughes,Commissioner of Labor,Cathy Costello,REP,320012,0,3,25,28,
Hughes,Commissioner of Labor,Leslie Osborn,REP,320012,3,3,23,29,
Hughes,Corporation Commissioner,Bob Anthony,REP,320012,3,6,24,33,
Hughes,Corporation Commissioner,Brian Bingman,REP,320012,0,0,25,25,
Hughes,Governor,Chris Powell,LIB,320012,0,0,0,0,
Hughes,Governor,Rex Lawhorn,LIB,320012,0,0,0,0,
Hughes,Corporation Commissioner,Ashley Nicole Mccray,DEM,320012,3,9,48,60,
Hughes,Corporation Commissioner,Blake Cummings,DEM,320012,3,13,49,65,
Hughes,U.S. House,Jason Nichols,DEM,320012,4,4,44,52,02
Hughes,U.S. House,Clay Padgett,DEM,320012,2,18,51,71,02
Hughes,Governor,Mick Cornett,REP,320016,0,0,11,11,
Hughes,Governor,Kevin Stitt,REP,320016,0,0,14,14,
Hughes,Lieutenant Governor,Dana Murphy,REP,320016,0,0,7,7,
Hughes,Lieutenant Governor,Matt Pinnell,REP,320016,0,0,18,18,
Hughes,State Auditor,Cindy Byrd,REP,320016,0,0,6,6,
Hughes,State Auditor,Charlie Prater,REP,320016,0,0,19,19,
Hughes,Attorney General,Mike Hunter,REP,320016,0,0,12,12,
Hughes,Attorney General,Gentner Drummond,REP,320016,0,0,13,13,
Hughes,Superintendent of Public Instruction,Joy Hofmeister,REP,320016,0,0,13,13,
Hughes,Superintendent of Public Instruction,Linda Murphy,REP,320016,0,0,11,11,
Hughes,Commissioner of Labor,Cathy Costello,REP,320016,0,0,9,9,
Hughes,Commissioner of Labor,Leslie Osborn,REP,320016,0,0,13,13,
Hughes,Corporation Commissioner,Bob Anthony,REP,320016,0,0,9,9,
Hughes,Corporation Commissioner,Brian Bingman,REP,320016,0,0,14,14,
Hughes,Governor,Chris Powell,LIB,320016,0,0,0,0,
Hughes,Governor,Rex Lawhorn,LIB,320016,0,0,0,0,
Hughes,Corporation Commissioner,Ashley Nicole Mccray,DEM,320016,1,3,15,19,
Hughes,Corporation Commissioner,Blake Cummings,DEM,320016,1,0,22,23,
Hughes,U.S. House,Jason Nichols,DEM,320016,1,1,18,20,02
Hughes,U.S. House,Clay Padgett,DEM,320016,1,2,19,22,02
Hughes,Governor,Mick Cornett,REP,320018,0,0,10,10,
Hughes,Governor,Kevin Stitt,REP,320018,1,0,17,18,
Hughes,Lieutenant Governor,Dana Murphy,REP,320018,0,0,6,6,
Hughes,Lieutenant Governor,Matt Pinnell,REP,320018,1,0,20,21,
Hughes,State Auditor,Cindy Byrd,REP,320018,1,0,15,16,
Hughes,State Auditor,Charlie Prater,REP,320018,0,0,11,11,
Hughes,Attorney General,Mike Hunter,REP,320018,1,0,17,18,
Hughes,Attorney General,Gentner Drummond,REP,320018,0,0,9,9,
Hughes,Superintendent of Public Instruction,Joy Hofmeister,REP,320018,1,0,10,11,
Hughes,Superintendent of Public Instruction,Linda Murphy,REP,320018,0,0,14,14,
Hughes,Commissioner of Labor,Cathy Costello,REP,320018,1,0,10,11,
Hughes,Commissioner of Labor,Leslie Osborn,REP,320018,0,0,16,16,
Hughes,Corporation Commissioner,Bob Anthony,REP,320018,1,0,11,12,
Hughes,Corporation Commissioner,Brian Bingman,REP,320018,0,0,13,13,
Hughes,Governor,Chris Powell,LIB,320018,0,0,0,0,
Hughes,Governor,Rex Lawhorn,LIB,320018,0,0,0,0,
Hughes,Corporation Commissioner,Ashley Nicole Mccray,DEM,320018,1,5,29,35,
Hughes,Corporation Commissioner,Blake Cummings,DEM,320018,2,2,40,44,
Hughes,U.S. House,Jason Nichols,DEM,320018,0,3,28,31,02
Hughes,U.S. House,Clay Padgett,DEM,320018,3,3,42,48,02
Hughes,Governor,Mick Cornett,REP,320019,0,0,2,2,
Hughes,Governor,Kevin Stitt,REP,320019,0,0,11,11,
Hughes,Lieutenant Governor,Dana Murphy,REP,320019,0,0,3,3,
Hughes,Lieutenant Governor,Matt Pinnell,REP,320019,0,0,10,10,
Hughes,State Auditor,Cindy Byrd,REP,320019,0,0,4,4,
Hughes,State Auditor,Charlie Prater,REP,320019,0,0,9,9,
Hughes,Attorney General,Mike Hunter,REP,320019,0,0,4,4,
Hughes,Attorney General,Gentner Drummond,REP,320019,0,0,9,9,
Hughes,Superintendent of Public Instruction,Joy Hofmeister,REP,320019,0,0,5,5,
Hughes,Superintendent of Public Instruction,Linda Murphy,REP,320019,0,0,6,6,
Hughes,Commissioner of Labor,Cathy Costello,REP,320019,0,0,5,5,
Hughes,Commissioner of Labor,Leslie Osborn,REP,320019,0,0,7,7,
Hughes,Corporation Commissioner,Bob Anthony,REP,320019,0,0,4,4,
Hughes,Corporation Commissioner,Brian Bingman,REP,320019,0,0,8,8,
Hughes,Governor,Chris Powell,LIB,320019,0,0,0,0,
Hughes,Governor,Rex Lawhorn,LIB,320019,0,0,0,0,
Hughes,Corporation Commissioner,Ashley Nicole Mccray,DEM,320019,0,2,14,16,
Hughes,Corporation Commissioner,Blake Cummings,DEM,320019,0,1,21,22,
Hughes,U.S. House,Jason Nichols,DEM,320019,0,2,18,20,02
Hughes,U.S. House,Clay Padgett,DEM,320019,0,1,19,20,02
Hughes,Governor,Mick Cornett,REP,320020,0,3,31,34,
Hughes,Governor,Kevin Stitt,REP,320020,1,3,48,52,
Hughes,Lieutenant Governor,Dana Murphy,REP,320020,0,2,24,26,
Hughes,Lieutenant Governor,Matt Pinnell,REP,320020,1,4,55,60,
Hughes,State Auditor,Cindy Byrd,REP,320020,0,1,19,20,
Hughes,State Auditor,Charlie Prater,REP,320020,1,5,58,64,
Hughes,Attorney General,Mike Hunter,REP,320020,1,1,32,34,
Hughes,Attorney General,Gentner Drummond,REP,320020,0,5,46,51,
Hughes,Superintendent of Public Instruction,Joy Hofmeister,REP,320020,0,1,48,49,
Hughes,Superintendent of Public Instruction,Linda Murphy,REP,320020,1,4,30,35,
Hughes,Commissioner of Labor,Cathy Costello,REP,320020,1,2,34,37,
Hughes,Commissioner of Labor,Leslie Osborn,REP,320020,0,4,42,46,
Hughes,Corporation Commissioner,Bob Anthony,REP,320020,0,1,31,32,
Hughes,Corporation Commissioner,Brian Bingman,REP,320020,1,5,48,54,
Hughes,Governor,Chris Powell,LIB,320020,0,0,0,0,
Hughes,Governor,Rex Lawhorn,LIB,320020,0,0,0,0,
Hughes,Corporation Commissioner,Ashley Nicole Mccray,DEM,320020,0,1,50,51,
Hughes,Corporation Commissioner,Blake Cummings,DEM,320020,0,4,55,59,
Hughes,U.S. House,Jason Nichols,DEM,320020,0,4,69,73,02
Hughes,U.S. House,Clay Padgett,DEM,320020,0,1,36,37,02
Hughes,Governor,Mick Cornett,REP,320021,0,0,16,16,
Hughes,Governor,Kevin Stitt,REP,320021,0,1,22,23,
Hughes,Lieutenant Governor,Dana Murphy,REP,320021,0,0,11,11,
Hughes,Lieutenant Governor,Matt Pinnell,REP,320021,0,1,25,26,
Hughes,State Auditor,Cindy Byrd,REP,320021,0,1,19,20,
Hughes,State Auditor,Charlie Prater,REP,320021,0,0,16,16,
Hughes,Attorney General,Mike Hunter,REP,320021,0,0,17,17,
Hughes,Attorney General,Gentner Drummond,REP,320021,0,1,19,20,
Hughes,Superintendent of Public Instruction,Joy Hofmeister,REP,320021,0,1,14,15,
Hughes,Superintendent of Public Instruction,Linda Murphy,REP,320021,0,0,22,22,
Hughes,Commissioner of Labor,Cathy Costello,REP,320021,0,0,10,10,
Hughes,Commissioner of Labor,Leslie Osborn,REP,320021,0,1,24,25,
Hughes,Corporation Commissioner,Bob Anthony,REP,320021,0,0,18,18,
Hughes,Corporation Commissioner,Brian Bingman,REP,320021,0,1,16,17,
Hughes,Governor,Chris Powell,LIB,320021,0,0,0,0,
Hughes,Governor,Rex Lawhorn,LIB,320021,0,0,0,0,
Hughes,Corporation Commissioner,Ashley Nicole Mccray,DEM,320021,0,5,40,45,
Hughes,Corporation Commissioner,Blake Cummings,DEM,320021,0,6,38,44,
Hughes,U.S. House,Jason Nichols,DEM,320021,0,4,47,51,02
Hughes,U.S. House,Clay Padgett,DEM,320021,0,7,29,36,02
Hughes,Governor,Mick Cornett,REP,320022,0,0,11,11,
Hughes,Governor,Kevin Stitt,REP,320022,0,2,24,26,
Hughes,Lieutenant Governor,Dana Murphy,REP,320022,0,2,7,9,
Hughes,Lieutenant Governor,Matt Pinnell,REP,320022,0,0,27,27,
Hughes,State Auditor,Cindy Byrd,REP,320022,0,1,9,10,
Hughes,State Auditor,Charlie Prater,REP,320022,0,1,25,26,
Hughes,Attorney General,Mike Hunter,REP,320022,0,0,14,14,
Hughes,Attorney General,Gentner Drummond,REP,320022,0,2,21,23,
Hughes,Superintendent of Public Instruction,Joy Hofmeister,REP,320022,0,1,20,21,
Hughes,Superintendent of Public Instruction,Linda Murphy,REP,320022,0,1,15,16,
Hughes,Commissioner of Labor,Cathy Costello,REP,320022,0,2,13,15,
Hughes,Commissioner of Labor,Leslie Osborn,REP,320022,0,0,21,21,
Hughes,Corporation Commissioner,Bob Anthony,REP,320022,0,1,13,14,
Hughes,Corporation Commissioner,Brian Bingman,REP,320022,0,1,22,23,
Hughes,Governor,Chris Powell,LIB,320022,0,0,0,0,
Hughes,Governor,Rex Lawhorn,LIB,320022,0,0,0,0,
Hughes,Corporation Commissioner,Ashley Nicole Mccray,DEM,320022,1,0,21,22,
Hughes,Corporation Commissioner,Blake Cummings,DEM,320022,0,0,24,24,
Hughes,U.S. House,Jason Nichols,DEM,320022,1,0,32,33,02
Hughes,U.S. House,Clay Padgett,DEM,320022,0,0,13,13,02
Hughes,Governor,Mick Cornett,REP,320023,0,0,2,2,
Hughes,Governor,Kevin Stitt,REP,320023,1,2,15,18,
Hughes,Lieutenant Governor,Dana Murphy,REP,320023,0,0,6,6,
Hughes,Lieutenant Governor,Matt Pinnell,REP,320023,1,2,10,13,
Hughes,State Auditor,Cindy Byrd,REP,320023,1,0,6,7,
Hughes,State Auditor,Charlie Prater,REP,320023,0,2,10,12,
Hughes,Attorney General,Mike Hunter,REP,320023,1,1,10,12,
Hughes,Attorney General,Gentner Drummond,REP,320023,0,1,7,8,
Hughes,Superintendent of Public Instruction,Joy Hofmeister,REP,320023,1,2,8,11,
Hughes,Superintendent of Public Instruction,Linda Murphy,REP,320023,0,0,10,10,
Hughes,Commissioner of Labor,Cathy Costello,REP,320023,0,2,5,7,
Hughes,Commissioner of Labor,Leslie Osborn,REP,320023,1,0,12,13,
Hughes,Corporation Commissioner,Bob Anthony,REP,320023,1,2,7,10,
Hughes,Corporation Commissioner,Brian Bingman,REP,320023,0,0,11,11,
Hughes,Governor,Chris Powell,LIB,320023,0,0,0,0,
Hughes,Governor,Rex Lawhorn,LIB,320023,0,0,0,0,
Hughes,Corporation Commissioner,Ashley Nicole Mccray,DEM,320023,1,0,10,11,
Hughes,Corporation Commissioner,Blake Cummings,DEM,320023,0,2,21,23,
Hughes,U.S. House,Jason Nichols,DEM,320023,0,0,11,11,02
Hughes,U.S. House,Clay Padgett,DEM,320023,1,2,19,22,02
Hughes,Governor,Mick Cornett,REP,320030,0,0,5,5,
Hughes,Governor,Kevin Stitt,REP,320030,0,0,15,15,
Hughes,Lieutenant Governor,Dana Murphy,REP,320030,0,0,9,9,
Hughes,Lieutenant Governor,Matt Pinnell,REP,320030,0,0,10,10,
Hughes,State Auditor,Cindy Byrd,REP,320030,0,0,11,11,
Hughes,State Auditor,Charlie Prater,REP,320030,0,0,8,8,
Hughes,Attorney General,Mike Hunter,REP,320030,0,0,6,6,
Hughes,Attorney General,Gentner Drummond,REP,320030,0,0,14,14,
Hughes,Superintendent of Public Instruction,Joy Hofmeister,REP,320030,0,0,11,11,
Hughes,Superintendent of Public Instruction,Linda Murphy,REP,320030,0,0,9,9,
Hughes,Commissioner of Labor,Cathy Costello,REP,320030,0,0,7,7,
Hughes,Commissioner of Labor,Leslie Osborn,REP,320030,0,0,13,13,
Hughes,Corporation Commissioner,Bob Anthony,REP,320030,0,0,8,8,
Hughes,Corporation Commissioner,Brian Bingman,REP,320030,0,0,11,11,
Hughes,Governor,Chris Powell,LIB,320030,0,0,0,0,
Hughes,Governor,Rex Lawhorn,LIB,320030,0,0,0,0,
Hughes,Corporation Commissioner,Ashley Nicole Mccray,DEM,320030,0,0,16,16,
Hughes,Corporation Commissioner,Blake Cummings,DEM,320030,0,0,42,42,
Hughes,U.S. House,Jason Nichols,DEM,320030,0,0,22,22,02
Hughes,U.S. House,Clay Padgett,DEM,320030,0,0,36,36,02
Hughes,Governor,Mick Cornett,REP,320031,0,1,8,9,
Hughes,Governor,Kevin Stitt,REP,320031,0,0,16,16,
Hughes,Lieutenant Governor,Dana Murphy,REP,320031,0,1,12,13,
Hughes,Lieutenant Governor,Matt Pinnell,REP,320031,0,0,11,11,
Hughes,State Auditor,Cindy Byrd,REP,320031,0,1,8,9,
Hughes,State Auditor,Charlie Prater,REP,320031,0,0,15,15,
Hughes,Attorney General,Mike Hunter,REP,320031,0,1,12,13,
Hughes,Attorney General,Gentner Drummond,REP,320031,0,0,11,11,
Hughes,Superintendent of Public Instruction,Joy Hofmeister,REP,320031,0,0,19,19,
Hughes,Superintendent of Public Instruction,Linda Murphy,REP,320031,0,1,5,6,
Hughes,Commissioner of Labor,Cathy Costello,REP,320031,0,0,12,12,
Hughes,Commissioner of Labor,Leslie Osborn,REP,320031,0,0,10,10,
Hughes,Corporation Commissioner,Bob Anthony,REP,320031,0,0,14,14,
Hughes,Corporation Commissioner,Brian Bingman,REP,320031,0,1,8,9,
Hughes,Governor,Chris Powell,LIB,320031,0,0,0,0,
Hughes,Governor,Rex Lawhorn,LIB,320031,0,0,0,0,
Hughes,Corporation Commissioner,Ashley Nicole Mccray,DEM,320031,0,0,24,24,
Hughes,Corporation Commissioner,Blake Cummings,DEM,320031,0,2,40,42,
Hughes,U.S. House,Jason Nichols,DEM,320031,0,0,28,28,02
Hughes,U.S. House,Clay Padgett,DEM,320031,0,2,43,45,02
Hughes,Governor,Mick Cornett,REP,320032,1,0,6,7,
Hughes,Governor,Kevin Stitt,REP,320032,1,0,10,11,
Hughes,Lieutenant Governor,Dana Murphy,REP,320032,1,0,3,4,
Hughes,Lieutenant Governor,Matt Pinnell,REP,320032,1,0,13,14,
Hughes,State Auditor,Cindy Byrd,REP,320032,1,0,6,7,
Hughes,State Auditor,Charlie Prater,REP,320032,1,0,9,10,
Hughes,Attorney General,Mike Hunter,REP,320032,0,0,8,8,
Hughes,Attorney General,Gentner Drummond,REP,320032,2,0,8,10,
Hughes,Superintendent of Public Instruction,Joy Hofmeister,REP,320032,1,0,8,9,
Hughes,Superintendent of Public Instruction,Linda Murphy,REP,320032,1,0,8,9,
Hughes,Commissioner of Labor,Cathy Costello,REP,320032,1,0,7,8,
Hughes,Commissioner of Labor,Leslie Osborn,REP,320032,1,0,9,10,
Hughes,Corporation Commissioner,Bob Anthony,REP,320032,1,0,8,9,
Hughes,Corporation Commissioner,Brian Bingman,REP,320032,1,0,7,8,
Hughes,Governor,Chris Powell,LIB,320032,0,0,0,0,
Hughes,Governor,Rex Lawhorn,LIB,320032,0,0,0,0,
Hughes,Corporation Commissioner,Ashley Nicole Mccray,DEM,320032,0,0,24,24,
Hughes,Corporation Commissioner,Blake Cummings,DEM,320032,0,0,20,20,
Hughes,U.S. House,Jason Nichols,DEM,320032,0,0,20,20,02
Hughes,U.S. House,Clay Padgett,DEM,320032,0,0,25,25,02
Hughes,Governor,Mick Cornett,REP,320033,0,0,6,6,
Hughes,Governor,Kevin Stitt,REP,320033,0,1,20,21,
Hughes,Lieutenant Governor,Dana Murphy,REP,320033,0,0,9,9,
Hughes,Lieutenant Governor,Matt Pinnell,REP,320033,0,1,17,18,
Hughes,State Auditor,Cindy Byrd,REP,320033,0,0,15,15,
Hughes,State Auditor,Charlie Prater,REP,320033,0,1,11,12,
Hughes,Attorney General,Mike Hunter,REP,320033,0,0,5,5,
Hughes,Attorney General,Gentner Drummond,REP,320033,0,1,21,22,
Hughes,Superintendent of Public Instruction,Joy Hofmeister,REP,320033,0,1,14,15,
Hughes,Superintendent of Public Instruction,Linda Murphy,REP,320033,0,0,12,12,
Hughes,Commissioner of Labor,Cathy Costello,REP,320033,0,0,6,6,
Hughes,Commissioner of Labor,Leslie Osborn,REP,320033,0,1,19,20,
Hughes,Corporation Commissioner,Bob Anthony,REP,320033,0,0,8,8,
Hughes,Corporation Commissioner,Brian Bingman,REP,320033,0,1,18,19,
Hughes,Governor,Chris Powell,LIB,320033,0,0,0,0,
Hughes,Governor,Rex Lawhorn,LIB,320033,0,0,0,0,
Hughes,Corporation Commissioner,Ashley Nicole Mccray,DEM,320033,0,1,18,19,
Hughes,Corporation Commissioner,Blake Cummings,DEM,320033,0,2,26,28,
Hughes,U.S. House,Jason Nichols,DEM,320033,0,0,19,19,02
Hughes,U.S. House,Clay Padgett,DEM,320033,0,5,25,30,02
Hughes,Governor,Mick Cornett,REP,320034,0,0,12,12,
Hughes,Governor,Kevin Stitt,REP,320034,0,0,12,12,
Hughes,Lieutenant Governor,Dana Murphy,REP,320034,0,0,6,6,
Hughes,Lieutenant Governor,Matt Pinnell,REP,320034,0,0,18,18,
Hughes,State Auditor,Cindy Byrd,REP,320034,0,0,8,8,
Hughes,State Auditor,Charlie Prater,REP,320034,0,0,16,16,
Hughes,Attorney General,Mike Hunter,REP,320034,0,0,7,7,
Hughes,Attorney General,Gentner Drummond,REP,320034,0,0,17,17,
Hughes,Superintendent of Public Instruction,Joy Hofmeister,REP,320034,0,0,13,13,
Hughes,Superintendent of Public Instruction,Linda Murphy,REP,320034,0,0,11,11,
Hughes,Commissioner of Labor,Cathy Costello,REP,320034,0,0,7,7,
Hughes,Commissioner of Labor,Leslie Osborn,REP,320034,0,0,16,16,
Hughes,Corporation Commissioner,Bob Anthony,REP,320034,0,0,10,10,
Hughes,Corporation Commissioner,Brian Bingman,REP,320034,0,0,14,14,
Hughes,Governor,Chris Powell,LIB,320034,0,0,0,0,
Hughes,Governor,Rex Lawhorn,LIB,320034,0,0,0,0,
Hughes,Corporation Commissioner,Ashley Nicole Mccray,DEM,320034,0,0,16,16,
Hughes,Corporation Commissioner,Blake Cummings,DEM,320034,0,1,21,22,
Hughes,U.S. House,Jason Nichols,DEM,320034,0,0,13,13,02
Hughes,U.S. House,Clay Padgett,DEM,320034,0,1,24,25,02
Hughes,Governor,Mick Cornett,REP,320035,1,5,45,51,
Hughes,Governor,Kevin Stitt,REP,320035,2,2,48,52,
Hughes,Lieutenant Governor,Dana Murphy,REP,320035,1,4,43,48,
Hughes,Lieutenant Governor,Matt Pinnell,REP,320035,2,3,48,53,
Hughes,State Auditor,Cindy Byrd,REP,320035,1,3,33,37,
Hughes,State Auditor,Charlie Prater,REP,320035,2,4,57,63,
Hughes,Attorney General,Mike Hunter,REP,320035,3,4,49,56,
Hughes,Attorney General,Gentner Drummond,REP,320035,0,3,41,44,
Hughes,Superintendent of Public Instruction,Joy Hofmeister,REP,320035,2,6,44,52,
Hughes,Superintendent of Public Instruction,Linda Murphy,REP,320035,1,1,45,47,
Hughes,Commissioner of Labor,Cathy Costello,REP,320035,3,4,40,47,
Hughes,Commissioner of Labor,Leslie Osborn,REP,320035,0,3,50,53,
Hughes,Corporation Commissioner,Bob Anthony,REP,320035,0,4,52,56,
Hughes,Corporation Commissioner,Brian Bingman,REP,320035,3,2,39,44,
Hughes,Governor,Chris Powell,LIB,320035,0,0,0,0,
Hughes,Governor,Rex Lawhorn,LIB,320035,0,0,0,0,
Hughes,Corporation Commissioner,Ashley Nicole Mccray,DEM,320035,1,15,93,109,
Hughes,Corporation Commissioner,Blake Cummings,DEM,320035,2,11,91,104,
Hughes,U.S. House,Jason Nichols,DEM,320035,2,11,118,131,02
Hughes,U.S. House,Clay Padgett,DEM,320035,1,16,68,85,02
Jackson,Governor,Mick Cornett,REP,330001,6,17,108,131,
Jackson,Governor,Kevin Stitt,REP,330001,8,19,166,193,
Jackson,Lieutenant Governor,Dana Murphy,REP,330001,2,15,119,136,
Jackson,Lieutenant Governor,Matt Pinnell,REP,330001,12,20,147,179,
Jackson,State Auditor,Cindy Byrd,REP,330001,9,19,128,156,
Jackson,State Auditor,Charlie Prater,REP,330001,5,15,126,146,
Jackson,Attorney General,Mike Hunter,REP,330001,8,23,147,178,
Jackson,Attorney General,Gentner Drummond,REP,330001,6,12,119,137,
Jackson,Superintendent of Public Instruction,Joy Hofmeister,REP,330001,10,20,158,188,
Jackson,Superintendent of Public Instruction,Linda Murphy,REP,330001,4,15,107,126,
Jackson,Commissioner of Labor,Cathy Costello,REP,330001,6,20,126,152,
Jackson,Commissioner of Labor,Leslie Osborn,REP,330001,8,15,131,154,
Jackson,Corporation Commissioner,Bob Anthony,REP,330001,8,16,134,158,
Jackson,Corporation Commissioner,Brian Bingman,REP,330001,6,19,120,145,
Jackson,Governor,Chris Powell,LIB,330001,0,0,0,0,
Jackson,Governor,Rex Lawhorn,LIB,330001,0,0,0,0,
Jackson,Corporation Commissioner,Ashley Nicole Mccray,DEM,330001,6,1,18,25,
Jackson,Corporation Commissioner,Blake Cummings,DEM,330001,0,1,9,10,
Jackson,Governor,Mick Cornett,REP,330002,3,6,50,59,
Jackson,Governor,Kevin Stitt,REP,330002,5,18,83,106,
Jackson,Lieutenant Governor,Dana Murphy,REP,330002,2,10,33,45,
Jackson,Lieutenant Governor,Matt Pinnell,REP,330002,6,12,95,113,
Jackson,State Auditor,Cindy Byrd,REP,330002,3,11,39,53,
Jackson,State Auditor,Charlie Prater,REP,330002,5,11,81,97,
Jackson,Attorney General,Mike Hunter,REP,330002,5,18,72,95,
Jackson,Attorney General,Gentner Drummond,REP,330002,3,6,58,67,
Jackson,Superintendent of Public Instruction,Joy Hofmeister,REP,330002,2,17,71,90,
Jackson,Superintendent of Public Instruction,Linda Murphy,REP,330002,6,7,57,70,
Jackson,Commissioner of Labor,Cathy Costello,REP,330002,4,10,51,65,
Jackson,Commissioner of Labor,Leslie Osborn,REP,330002,4,12,74,90,
Jackson,Corporation Commissioner,Bob Anthony,REP,330002,6,16,72,94,
Jackson,Corporation Commissioner,Brian Bingman,REP,330002,2,6,53,61,
Jackson,Governor,Chris Powell,LIB,330002,0,0,0,0,
Jackson,Governor,Rex Lawhorn,LIB,330002,0,0,0,0,
Jackson,Corporation Commissioner,Ashley Nicole Mccray,DEM,330002,2,0,7,9,
Jackson,Corporation Commissioner,Blake Cummings,DEM,330002,0,2,7,9,
Jackson,Governor,Mick Cornett,REP,330003,0,3,22,25,
Jackson,Governor,Kevin Stitt,REP,330003,1,1,32,34,
Jackson,Lieutenant Governor,Dana Murphy,REP,330003,1,3,29,33,
Jackson,Lieutenant Governor,Matt Pinnell,REP,330003,0,1,24,25,
Jackson,State Auditor,Cindy Byrd,REP,330003,1,3,31,35,
Jackson,State Auditor,Charlie Prater,REP,330003,0,1,23,24,
Jackson,Attorney General,Mike Hunter,REP,330003,1,3,27,31,
Jackson,Attorney General,Gentner Drummond,REP,330003,0,1,27,28,
Jackson,Superintendent of Public Instruction,Joy Hofmeister,REP,330003,1,1,30,32,
Jackson,Superintendent of Public Instruction,Linda Murphy,REP,330003,0,3,23,26,
Jackson,Commissioner of Labor,Cathy Costello,REP,330003,1,4,19,24,
Jackson,Commissioner of Labor,Leslie Osborn,REP,330003,0,0,35,35,
Jackson,Corporation Commissioner,Bob Anthony,REP,330003,1,1,19,21,
Jackson,Corporation Commissioner,Brian Bingman,REP,330003,0,3,34,37,
Jackson,Governor,Chris Powell,LIB,330003,0,0,0,0,
Jackson,Governor,Rex Lawhorn,LIB,330003,0,0,2,2,
Jackson,Corporation Commissioner,Ashley Nicole Mccray,DEM,330003,0,0,16,16,
Jackson,Corporation Commissioner,Blake Cummings,DEM,330003,0,0,16,16,
Jackson,Governor,Mick Cornett,REP,330006,4,13,79,96,
Jackson,Governor,Kevin Stitt,REP,330006,1,13,104,118,
Jackson,Lieutenant Governor,Dana Murphy,REP,330006,1,12,77,90,
Jackson,Lieutenant Governor,Matt Pinnell,REP,330006,3,14,102,119,
Jackson,State Auditor,Cindy Byrd,REP,330006,4,12,81,97,
Jackson,State Auditor,Charlie Prater,REP,330006,0,14,93,107,
Jackson,Attorney General,Mike Hunter,REP,330006,5,14,85,104,
Jackson,Attorney General,Gentner Drummond,REP,330006,0,11,92,103,
Jackson,Superintendent of Public Instruction,Joy Hofmeister,REP,330006,3,17,100,120,
Jackson,Superintendent of Public Instruction,Linda Murphy,REP,330006,1,9,81,91,
Jackson,Commissioner of Labor,Cathy Costello,REP,330006,2,14,77,93,
Jackson,Commissioner of Labor,Leslie Osborn,REP,330006,2,11,100,113,
Jackson,Corporation Commissioner,Bob Anthony,REP,330006,1,20,105,126,
Jackson,Corporation Commissioner,Brian Bingman,REP,330006,3,6,71,80,
Jackson,Governor,Chris Powell,LIB,330006,0,0,1,1,
Jackson,Governor,Rex Lawhorn,LIB,330006,0,0,0,0,
Jackson,Corporation Commissioner,Ashley Nicole Mccray,DEM,330006,2,1,19,22,
Jackson,Corporation Commissioner,Blake Cummings,DEM,330006,0,2,9,11,
Jackson,Governor,Mick Cornett,REP,330007,0,3,25,28,
Jackson,Governor,Kevin Stitt,REP,330007,2,3,30,35,
Jackson,Lieutenant Governor,Dana Murphy,REP,330007,0,1,30,31,
Jackson,Lieutenant Governor,Matt Pinnell,REP,330007,2,5,25,32,
Jackson,State Auditor,Cindy Byrd,REP,330007,0,4,25,29,
Jackson,State Auditor,Charlie Prater,REP,330007,2,2,28,32,
Jackson,Attorney General,Mike Hunter,REP,330007,2,3,28,33,
Jackson,Attorney General,Gentner Drummond,REP,330007,0,3,26,29,
Jackson,Superintendent of Public Instruction,Joy Hofmeister,REP,330007,0,1,23,24,
Jackson,Superintendent of Public Instruction,Linda Murphy,REP,330007,2,5,30,37,
Jackson,Commissioner of Labor,Cathy Costello,REP,330007,0,4,27,31,
Jackson,Commissioner of Labor,Leslie Osborn,REP,330007,2,1,27,30,
Jackson,Corporation Commissioner,Bob Anthony,REP,330007,0,2,26,28,
Jackson,Corporation Commissioner,Brian Bingman,REP,330007,2,3,27,32,
Jackson,Governor,Chris Powell,LIB,330007,0,0,0,0,
Jackson,Governor,Rex Lawhorn,LIB,330007,0,0,1,1,
Jackson,Corporation Commissioner,Ashley Nicole Mccray,DEM,330007,0,0,9,9,
Jackson,Corporation Commissioner,Blake Cummings,DEM,330007,0,0,13,13,
Jackson,Governor,Mick Cornett,REP,330010,0,1,15,16,
Jackson,Governor,Kevin Stitt,REP,330010,1,2,28,31,
Jackson,Lieutenant Governor,Dana Murphy,REP,330010,1,0,17,18,
Jackson,Lieutenant Governor,Matt Pinnell,REP,330010,0,3,26,29,
Jackson,State Auditor,Cindy Byrd,REP,330010,0,0,16,16,
Jackson,State Auditor,Charlie Prater,REP,330010,1,3,26,30,
Jackson,Attorney General,Mike Hunter,REP,330010,0,2,22,24,
Jackson,Attorney General,Gentner Drummond,REP,330010,1,1,21,23,
Jackson,Superintendent of Public Instruction,Joy Hofmeister,REP,330010,0,1,27,28,
Jackson,Superintendent of Public Instruction,Linda Murphy,REP,330010,1,2,14,17,
Jackson,Commissioner of Labor,Cathy Costello,REP,330010,1,3,22,26,
Jackson,Commissioner of Labor,Leslie Osborn,REP,330010,0,0,19,19,
Jackson,Corporation Commissioner,Bob Anthony,REP,330010,0,1,27,28,
Jackson,Corporation Commissioner,Brian Bingman,REP,330010,1,2,16,19,
Jackson,Governor,Chris Powell,LIB,330010,0,0,0,0,
Jackson,Governor,Rex Lawhorn,LIB,330010,0,0,0,0,
Jackson,Corporation Commissioner,Ashley Nicole Mccray,DEM,330010,1,0,13,14,
Jackson,Corporation Commissioner,Blake Cummings,DEM,330010,0,2,8,10,
Jackson,Governor,Mick Cornett,REP,330014,1,3,63,67,
Jackson,Governor,Kevin Stitt,REP,330014,6,16,98,120,
Jackson,Lieutenant Governor,Dana Murphy,REP,330014,4,4,65,73,
Jackson,Lieutenant Governor,Matt Pinnell,REP,330014,3,15,92,110,
Jackson,State Auditor,Cindy Byrd,REP,330014,6,7,76,89,
Jackson,State Auditor,Charlie Prater,REP,330014,1,12,80,93,
Jackson,Attorney General,Mike Hunter,REP,330014,4,7,68,79,
Jackson,Attorney General,Gentner Drummond,REP,330014,3,12,91,106,
Jackson,Superintendent of Public Instruction,Joy Hofmeister,REP,330014,3,4,75,82,
Jackson,Superintendent of Public Instruction,Linda Murphy,REP,330014,4,15,82,101,
Jackson,Commissioner of Labor,Cathy Costello,REP,330014,2,14,73,89,
Jackson,Commissioner of Labor,Leslie Osborn,REP,330014,5,5,85,95,
Jackson,Corporation Commissioner,Bob Anthony,REP,330014,1,13,102,116,
Jackson,Corporation Commissioner,Brian Bingman,REP,330014,6,5,55,66,
Jackson,Governor,Chris Powell,LIB,330014,0,0,0,0,
Jackson,Governor,Rex Lawhorn,LIB,330014,0,0,0,0,
Jackson,Corporation Commissioner,Ashley Nicole Mccray,DEM,330014,0,5,19,24,
Jackson,Corporation Commissioner,Blake Cummings,DEM,330014,0,0,18,18,
Jackson,Governor,Mick Cornett,REP,330016,0,1,29,30,
Jackson,Governor,Kevin Stitt,REP,330016,1,3,44,48,
Jackson,Lieutenant Governor,Dana Murphy,REP,330016,0,2,32,34,
Jackson,Lieutenant Governor,Matt Pinnell,REP,330016,1,2,37,40,
Jackson,State Auditor,Cindy Byrd,REP,330016,0,4,31,35,
Jackson,State Auditor,Charlie Prater,REP,330016,1,0,37,38,
Jackson,Attorney General,Mike Hunter,REP,330016,1,2,38,41,
Jackson,Attorney General,Gentner Drummond,REP,330016,0,2,31,33,
Jackson,Superintendent of Public Instruction,Joy Hofmeister,REP,330016,0,2,30,32,
Jackson,Superintendent of Public Instruction,Linda Murphy,REP,330016,1,2,37,40,
Jackson,Commissioner of Labor,Cathy Costello,REP,330016,1,3,34,38,
Jackson,Commissioner of Labor,Leslie Osborn,REP,330016,0,1,36,37,
Jackson,Corporation Commissioner,Bob Anthony,REP,330016,1,3,35,39,
Jackson,Corporation Commissioner,Brian Bingman,REP,330016,0,1,32,33,
Jackson,Governor,Chris Powell,LIB,330016,0,0,1,1,
Jackson,Governor,Rex Lawhorn,LIB,330016,0,0,1,1,
Jackson,Corporation Commissioner,Ashley Nicole Mccray,DEM,330016,0,0,12,12,
Jackson,Corporation Commissioner,Blake Cummings,DEM,330016,0,1,8,9,
Jackson,Governor,Mick Cornett,REP,330017,0,2,37,39,
Jackson,Governor,Kevin Stitt,REP,330017,0,4,25,29,
Jackson,Lieutenant Governor,Dana Murphy,REP,330017,0,3,22,25,
Jackson,Lieutenant Governor,Matt Pinnell,REP,330017,0,3,39,42,
Jackson,State Auditor,Cindy Byrd,REP,330017,0,3,23,26,
Jackson,State Auditor,Charlie Prater,REP,330017,0,3,39,42,
Jackson,Attorney General,Mike Hunter,REP,330017,0,2,29,31,
Jackson,Attorney General,Gentner Drummond,REP,330017,0,4,33,37,
Jackson,Superintendent of Public Instruction,Joy Hofmeister,REP,330017,0,1,28,29,
Jackson,Superintendent of Public Instruction,Linda Murphy,REP,330017,0,5,34,39,
Jackson,Commissioner of Labor,Cathy Costello,REP,330017,0,0,16,16,
Jackson,Commissioner of Labor,Leslie Osborn,REP,330017,0,6,45,51,
Jackson,Corporation Commissioner,Bob Anthony,REP,330017,0,3,35,38,
Jackson,Corporation Commissioner,Brian Bingman,REP,330017,0,3,27,30,
Jackson,Governor,Chris Powell,LIB,330017,0,0,0,0,
Jackson,Governor,Rex Lawhorn,LIB,330017,0,0,1,1,
Jackson,Corporation Commissioner,Ashley Nicole Mccray,DEM,330017,0,0,9,9,
Jackson,Corporation Commissioner,Blake Cummings,DEM,330017,1,0,8,9,
Jackson,Governor,Mick Cornett,REP,330018,0,0,6,6,
Jackson,Governor,Kevin Stitt,REP,330018,0,1,15,16,
Jackson,Lieutenant Governor,Dana Murphy,REP,330018,0,1,6,7,
Jackson,Lieutenant Governor,Matt Pinnell,REP,330018,0,0,13,13,
Jackson,State Auditor,Cindy Byrd,REP,330018,0,1,3,4,
Jackson,State Auditor,Charlie Prater,REP,330018,0,0,17,17,
Jackson,Attorney General,Mike Hunter,REP,330018,0,1,9,10,
Jackson,Attorney General,Gentner Drummond,REP,330018,0,0,11,11,
Jackson,Superintendent of Public Instruction,Joy Hofmeister,REP,330018,0,1,9,10,
Jackson,Superintendent of Public Instruction,Linda Murphy,REP,330018,0,0,11,11,
Jackson,Commissioner of Labor,Cathy Costello,REP,330018,0,1,12,13,
Jackson,Commissioner of Labor,Leslie Osborn,REP,330018,0,0,8,8,
Jackson,Corporation Commissioner,Bob Anthony,REP,330018,0,1,6,7,
Jackson,Corporation Commissioner,Brian Bingman,REP,330018,0,0,13,13,
Jackson,Governor,Chris Powell,LIB,330018,0,0,0,0,
Jackson,Governor,Rex Lawhorn,LIB,330018,0,0,0,0,
Jackson,Corporation Commissioner,Ashley Nicole Mccray,DEM,330018,0,0,7,7,
Jackson,Corporation Commissioner,Blake Cummings,DEM,330018,1,0,7,8,
Jackson,Governor,Mick Cornett,REP,330019,0,0,10,10,
Jackson,Governor,Kevin Stitt,REP,330019,0,1,28,29,
Jackson,Lieutenant Governor,Dana Murphy,REP,330019,0,0,13,13,
Jackson,Lieutenant Governor,Matt Pinnell,REP,330019,0,1,24,25,
Jackson,State Auditor,Cindy Byrd,REP,330019,0,1,19,20,
Jackson,State Auditor,Charlie Prater,REP,330019,0,0,18,18,
Jackson,Attorney General,Mike Hunter,REP,330019,0,1,20,21,
Jackson,Attorney General,Gentner Drummond,REP,330019,0,0,16,16,
Jackson,Superintendent of Public Instruction,Joy Hofmeister,REP,330019,0,0,24,24,
Jackson,Superintendent of Public Instruction,Linda Murphy,REP,330019,0,1,11,12,
Jackson,Commissioner of Labor,Cathy Costello,REP,330019,0,0,18,18,
Jackson,Commissioner of Labor,Leslie Osborn,REP,330019,0,1,19,20,
Jackson,Corporation Commissioner,Bob Anthony,REP,330019,0,1,28,29,
Jackson,Corporation Commissioner,Brian Bingman,REP,330019,0,0,7,7,
Jackson,Governor,Chris Powell,LIB,330019,0,0,0,0,
Jackson,Governor,Rex Lawhorn,LIB,330019,0,0,0,0,
Jackson,Corporation Commissioner,Ashley Nicole Mccray,DEM,330019,0,0,0,0,
Jackson,Corporation Commissioner,Blake Cummings,DEM,330019,0,1,2,3,
Jackson,Governor,Mick Cornett,REP,330020,0,4,32,36,
Jackson,Governor,Kevin Stitt,REP,330020,1,15,86,102,
Jackson,Lieutenant Governor,Dana Murphy,REP,330020,0,9,52,61,
Jackson,Lieutenant Governor,Matt Pinnell,REP,330020,1,10,64,75,
Jackson,State Auditor,Cindy Byrd,REP,330020,0,11,54,65,
Jackson,State Auditor,Charlie Prater,REP,330020,1,8,62,71,
Jackson,Attorney General,Mike Hunter,REP,330020,0,12,62,74,
Jackson,Attorney General,Gentner Drummond,REP,330020,1,7,56,64,
Jackson,Superintendent of Public Instruction,Joy Hofmeister,REP,330020,1,9,56,66,
Jackson,Superintendent of Public Instruction,Linda Murphy,REP,330020,0,10,59,69,
Jackson,Commissioner of Labor,Cathy Costello,REP,330020,1,12,49,62,
Jackson,Commissioner of Labor,Leslie Osborn,REP,330020,0,7,67,74,
Jackson,Corporation Commissioner,Bob Anthony,REP,330020,1,8,62,71,
Jackson,Corporation Commissioner,Brian Bingman,REP,330020,0,11,52,63,
Jackson,Governor,Chris Powell,LIB,330020,0,0,0,0,
Jackson,Governor,Rex Lawhorn,LIB,330020,0,0,0,0,
Jackson,Corporation Commissioner,Ashley Nicole Mccray,DEM,330020,0,0,6,6,
Jackson,Corporation Commissioner,Blake Cummings,DEM,330020,0,1,6,7,
Jackson,Governor,Mick Cornett,REP,330021,0,4,5,9,
Jackson,Governor,Kevin Stitt,REP,330021,0,1,9,10,
Jackson,Lieutenant Governor,Dana Murphy,REP,330021,0,1,9,10,
Jackson,Lieutenant Governor,Matt Pinnell,REP,330021,0,4,5,9,
Jackson,State Auditor,Cindy Byrd,REP,330021,0,0,4,4,
Jackson,State Auditor,Charlie Prater,REP,330021,0,5,10,15,
Jackson,Attorney General,Mike Hunter,REP,330021,0,2,9,11,
Jackson,Attorney General,Gentner Drummond,REP,330021,0,3,5,8,
Jackson,Superintendent of Public Instruction,Joy Hofmeister,REP,330021,0,3,10,13,
Jackson,Superintendent of Public Instruction,Linda Murphy,REP,330021,0,2,3,5,
Jackson,Commissioner of Labor,Cathy Costello,REP,330021,0,2,6,8,
Jackson,Commissioner of Labor,Leslie Osborn,REP,330021,0,3,8,11,
Jackson,Corporation Commissioner,Bob Anthony,REP,330021,0,1,9,10,
Jackson,Corporation Commissioner,Brian Bingman,REP,330021,0,4,5,9,
Jackson,Governor,Chris Powell,LIB,330021,0,0,0,0,
Jackson,Governor,Rex Lawhorn,LIB,330021,0,0,0,0,
Jackson,Corporation Commissioner,Ashley Nicole Mccray,DEM,330021,0,0,6,6,
Jackson,Corporation Commissioner,Blake Cummings,DEM,330021,0,0,2,2,
Jackson,Governor,Mick Cornett,REP,330023,0,2,25,27,
Jackson,Governor,Kevin Stitt,REP,330023,0,4,57,61,
Jackson,Lieutenant Governor,Dana Murphy,REP,330023,0,2,34,36,
Jackson,Lieutenant Governor,Matt Pinnell,REP,330023,0,4,47,51,
Jackson,State Auditor,Cindy Byrd,REP,330023,0,2,39,41,
Jackson,State Auditor,Charlie Prater,REP,330023,0,4,40,44,
Jackson,Attorney General,Mike Hunter,REP,330023,0,0,41,41,
Jackson,Attorney General,Gentner Drummond,REP,330023,0,6,40,46,
Jackson,Superintendent of Public Instruction,Joy Hofmeister,REP,330023,0,2,41,43,
Jackson,Superintendent of Public Instruction,Linda Murphy,REP,330023,0,4,39,43,
Jackson,Commissioner of Labor,Cathy Costello,REP,330023,0,3,35,38,
Jackson,Commissioner of Labor,Leslie Osborn,REP,330023,0,3,45,48,
Jackson,Corporation Commissioner,Bob Anthony,REP,330023,0,4,33,37,
Jackson,Corporation Commissioner,Brian Bingman,REP,330023,0,2,48,50,
Jackson,Governor,Chris Powell,LIB,330023,0,0,0,0,
Jackson,Governor,Rex Lawhorn,LIB,330023,0,0,0,0,
Jackson,Corporation Commissioner,Ashley Nicole Mccray,DEM,330023,0,0,5,5,
Jackson,Corporation Commissioner,Blake Cummings,DEM,330023,0,0,10,10,
Jackson,Governor,Mick Cornett,REP,330024,1,0,14,15,
Jackson,Governor,Kevin Stitt,REP,330024,0,0,16,16,
Jackson,Lieutenant Governor,Dana Murphy,REP,330024,0,0,9,9,
Jackson,Lieutenant Governor,Matt Pinnell,REP,330024,1,0,21,22,
Jackson,State Auditor,Cindy Byrd,REP,330024,1,0,12,13,
Jackson,State Auditor,Charlie Prater,REP,330024,0,0,19,19,
Jackson,Attorney General,Mike Hunter,REP,330024,1,0,12,13,
Jackson,Attorney General,Gentner Drummond,REP,330024,0,0,18,18,
Jackson,Superintendent of Public Instruction,Joy Hofmeister,REP,330024,1,0,15,16,
Jackson,Superintendent of Public Instruction,Linda Murphy,REP,330024,0,0,15,15,
Jackson,Commissioner of Labor,Cathy Costello,REP,330024,0,0,10,10,
Jackson,Commissioner of Labor,Leslie Osborn,REP,330024,1,0,20,21,
Jackson,Corporation Commissioner,Bob Anthony,REP,330024,1,0,15,16,
Jackson,Corporation Commissioner,Brian Bingman,REP,330024,0,0,14,14,
Jackson,Governor,Chris Powell,LIB,330024,0,0,0,0,
Jackson,Governor,Rex Lawhorn,LIB,330024,0,0,0,0,
Jackson,Corporation Commissioner,Ashley Nicole Mccray,DEM,330024,0,0,2,2,
Jackson,Corporation Commissioner,Blake Cummings,DEM,330024,0,0,6,6,
Jefferson,Governor,Mick Cornett,REP,340001,0,3,18,21,
Jefferson,Governor,Kevin Stitt,REP,340001,0,3,23,26,
Jefferson,Lieutenant Governor,Dana Murphy,REP,340001,0,3,17,20,
Jefferson,Lieutenant Governor,Matt Pinnell,REP,340001,0,2,23,25,
Jefferson,State Auditor,Cindy Byrd,REP,340001,0,1,18,19,
Jefferson,State Auditor,Charlie Prater,REP,340001,0,3,21,24,
Jefferson,Attorney General,Mike Hunter,REP,340001,0,4,18,22,
Jefferson,Attorney General,Gentner Drummond,REP,340001,0,1,23,24,
Jefferson,Superintendent of Public Instruction,Joy Hofmeister,REP,340001,0,3,20,23,
Jefferson,Superintendent of Public Instruction,Linda Murphy,REP,340001,0,3,18,21,
Jefferson,Commissioner of Labor,Cathy Costello,REP,340001,0,4,17,21,
Jefferson,Commissioner of Labor,Leslie Osborn,REP,340001,0,2,22,24,
Jefferson,Corporation Commissioner,Bob Anthony,REP,340001,0,4,23,27,
Jefferson,Corporation Commissioner,Brian Bingman,REP,340001,0,1,17,18,
Jefferson,Governor,Chris Powell,LIB,340001,1,0,0,1,
Jefferson,Governor,Rex Lawhorn,LIB,340001,0,0,0,0,
Jefferson,Corporation Commissioner,Ashley Nicole Mccray,DEM,340001,2,2,13,17,
Jefferson,Corporation Commissioner,Blake Cummings,DEM,340001,0,3,13,16,
Jefferson,U.S. House,Mary Brannon,DEM,340001,1,2,4,7,04
Jefferson,U.S. House,Fred Gipson,DEM,340001,1,3,22,26,04
Jefferson,Governor,Mick Cornett,REP,340002,1,3,23,27,
Jefferson,Governor,Kevin Stitt,REP,340002,1,7,29,37,
Jefferson,Lieutenant Governor,Dana Murphy,REP,340002,1,3,17,21,
Jefferson,Lieutenant Governor,Matt Pinnell,REP,340002,1,5,35,41,
Jefferson,State Auditor,Cindy Byrd,REP,340002,0,3,27,30,
Jefferson,State Auditor,Charlie Prater,REP,340002,1,6,24,31,
Jefferson,Attorney General,Mike Hunter,REP,340002,1,3,21,25,
Jefferson,Attorney General,Gentner Drummond,REP,340002,1,6,31,38,
Jefferson,Superintendent of Public Instruction,Joy Hofmeister,REP,340002,1,3,30,34,
Jefferson,Superintendent of Public Instruction,Linda Murphy,REP,340002,1,7,21,29,
Jefferson,Commissioner of Labor,Cathy Costello,REP,340002,1,5,19,25,
Jefferson,Commissioner of Labor,Leslie Osborn,REP,340002,0,2,30,32,
Jefferson,Corporation Commissioner,Bob Anthony,REP,340002,1,6,27,34,
Jefferson,Corporation Commissioner,Brian Bingman,REP,340002,0,1,23,24,
Jefferson,Governor,Chris Powell,LIB,340002,0,0,0,0,
Jefferson,Governor,Rex Lawhorn,LIB,340002,0,0,0,0,
Jefferson,Corporation Commissioner,Ashley Nicole Mccray,DEM,340002,0,0,6,6,
Jefferson,Corporation Commissioner,Blake Cummings,DEM,340002,0,3,8,11,
Jefferson,U.S. House,Mary Brannon,DEM,340002,0,0,7,7,04
Jefferson,U.S. House,Fred Gipson,DEM,340002,0,3,7,10,04
Jefferson,Governor,Mick Cornett,REP,340003,2,0,8,10,
Jefferson,Governor,Kevin Stitt,REP,340003,1,0,10,11,
Jefferson,Lieutenant Governor,Dana Murphy,REP,340003,0,0,6,6,
Jefferson,Lieutenant Governor,Matt Pinnell,REP,340003,3,0,10,13,
Jefferson,State Auditor,Cindy Byrd,REP,340003,1,0,8,9,
Jefferson,State Auditor,Charlie Prater,REP,340003,2,0,8,10,
Jefferson,Attorney General,Mike Hunter,REP,340003,0,0,6,6,
Jefferson,Attorney General,Gentner Drummond,REP,340003,3,0,12,15,
Jefferson,Superintendent of Public Instruction,Joy Hofmeister,REP,340003,3,0,10,13,
Jefferson,Superintendent of Public Instruction,Linda Murphy,REP,340003,0,0,5,5,
Jefferson,Commissioner of Labor,Cathy Costello,REP,340003,1,0,12,13,
Jefferson,Commissioner of Labor,Leslie Osborn,REP,340003,2,0,4,6,
Jefferson,Corporation Commissioner,Bob Anthony,REP,340003,0,0,4,4,
Jefferson,Corporation Commissioner,Brian Bingman,REP,340003,3,0,12,15,
Jefferson,Governor,Chris Powell,LIB,340003,0,0,0,0,
Jefferson,Governor,Rex Lawhorn,LIB,340003,0,0,0,0,
Jefferson,Corporation Commissioner,Ashley Nicole Mccray,DEM,340003,0,0,5,5,
Jefferson,Corporation Commissioner,Blake Cummings,DEM,340003,2,1,6,9,
Jefferson,U.S. House,Mary Brannon,DEM,340003,2,0,7,9,04
Jefferson,U.S. House,Fred Gipson,DEM,340003,0,1,4,5,04
Jefferson,Governor,Mick Cornett,REP,340004,0,0,3,3,
Jefferson,Governor,Kevin Stitt,REP,340004,0,2,8,10,
Jefferson,Lieutenant Governor,Dana Murphy,REP,340004,0,1,5,6,
Jefferson,Lieutenant Governor,Matt Pinnell,REP,340004,0,1,6,7,
Jefferson,State Auditor,Cindy Byrd,REP,340004,0,1,2,3,
Jefferson,State Auditor,Charlie Prater,REP,340004,0,1,9,10,
Jefferson,Attorney General,Mike Hunter,REP,340004,0,1,2,3,
Jefferson,Attorney General,Gentner Drummond,REP,340004,0,1,9,10,
Jefferson,Superintendent of Public Instruction,Joy Hofmeister,REP,340004,0,2,4,6,
Jefferson,Superintendent of Public Instruction,Linda Murphy,REP,340004,0,0,7,7,
Jefferson,Commissioner of Labor,Cathy Costello,REP,340004,0,1,4,5,
Jefferson,Commissioner of Labor,Leslie Osborn,REP,340004,0,1,7,8,
Jefferson,Corporation Commissioner,Bob Anthony,REP,340004,0,1,4,5,
Jefferson,Corporation Commissioner,Brian Bingman,REP,340004,0,1,7,8,
Jefferson,Governor,Chris Powell,LIB,340004,0,0,0,0,
Jefferson,Governor,Rex Lawhorn,LIB,340004,0,0,0,0,
Jefferson,Corporation Commissioner,Ashley Nicole Mccray,DEM,340004,0,1,2,3,
Jefferson,Corporation Commissioner,Blake Cummings,DEM,340004,0,0,4,4,
Jefferson,U.S. House,Mary Brannon,DEM,340004,0,0,5,5,04
Jefferson,U.S. House,Fred Gipson,DEM,340004,0,1,2,3,04
Jefferson,Governor,Mick Cornett,REP,340005,0,0,0,0,
Jefferson,Governor,Kevin Stitt,REP,340005,0,1,5,6,
Jefferson,Lieutenant Governor,Dana Murphy,REP,340005,0,0,1,1,
Jefferson,Lieutenant Governor,Matt Pinnell,REP,340005,0,1,4,5,
Jefferson,State Auditor,Cindy Byrd,REP,340005,0,1,3,4,
Jefferson,State Auditor,Charlie Prater,REP,340005,0,0,2,2,
Jefferson,Attorney General,Mike Hunter,REP,340005,0,0,3,3,
Jefferson,Attorney General,Gentner Drummond,REP,340005,0,0,2,2,
Jefferson,Superintendent of Public Instruction,Joy Hofmeister,REP,340005,0,0,1,1,
Jefferson,Superintendent of Public Instruction,Linda Murphy,REP,340005,0,1,4,5,
Jefferson,Commissioner of Labor,Cathy Costello,REP,340005,0,1,4,5,
Jefferson,Commissioner of Labor,Leslie Osborn,REP,340005,0,0,1,1,
Jefferson,Corporation Commissioner,Bob Anthony,REP,340005,0,1,3,4,
Jefferson,Corporation Commissioner,Brian Bingman,REP,340005,0,0,2,2,
Jefferson,Governor,Chris Powell,LIB,340005,0,0,0,0,
Jefferson,Governor,Rex Lawhorn,LIB,340005,0,0,1,1,
Jefferson,Corporation Commissioner,Ashley Nicole Mccray,DEM,340005,0,1,1,2,
Jefferson,Corporation Commissioner,Blake Cummings,DEM,340005,0,0,5,5,
Jefferson,U.S. House,Mary Brannon,DEM,340005,0,1,3,4,04
Jefferson,U.S. House,Fred Gipson,DEM,340005,0,0,3,3,04
Jefferson,Governor,Mick Cornett,REP,340006,0,1,14,15,
Jefferson,Governor,Kevin Stitt,REP,340006,0,2,11,13,
Jefferson,Lieutenant Governor,Dana Murphy,REP,340006,0,1,8,9,
Jefferson,Lieutenant Governor,Matt Pinnell,REP,340006,0,2,16,18,
Jefferson,State Auditor,Cindy Byrd,REP,340006,0,2,8,10,
Jefferson,State Auditor,Charlie Prater,REP,340006,0,1,17,18,
Jefferson,Attorney General,Mike Hunter,REP,340006,0,2,6,8,
Jefferson,Attorney General,Gentner Drummond,REP,340006,0,1,18,19,
Jefferson,Superintendent of Public Instruction,Joy Hofmeister,REP,340006,0,2,16,18,
Jefferson,Superintendent of Public Instruction,Linda Murphy,REP,340006,0,1,8,9,
Jefferson,Commissioner of Labor,Cathy Costello,REP,340006,0,2,8,10,
Jefferson,Commissioner of Labor,Leslie Osborn,REP,340006,0,1,17,18,
Jefferson,Corporation Commissioner,Bob Anthony,REP,340006,0,2,12,14,
Jefferson,Corporation Commissioner,Brian Bingman,REP,340006,0,1,12,13,
Jefferson,Governor,Chris Powell,LIB,340006,0,0,0,0,
Jefferson,Governor,Rex Lawhorn,LIB,340006,0,0,0,0,
Jefferson,Corporation Commissioner,Ashley Nicole Mccray,DEM,340006,1,1,15,17,
Jefferson,Corporation Commissioner,Blake Cummings,DEM,340006,1,1,19,21,
Jefferson,U.S. House,Mary Brannon,DEM,340006,2,1,17,20,04
Jefferson,U.S. House,Fred Gipson,DEM,340006,0,1,17,18,04
Jefferson,Governor,Mick Cornett,REP,340007,1,0,9,10,
Jefferson,Governor,Kevin Stitt,REP,340007,0,0,10,10,
Jefferson,Lieutenant Governor,Dana Murphy,REP,340007,0,0,8,8,
Jefferson,Lieutenant Governor,Matt Pinnell,REP,340007,1,0,11,12,
Jefferson,State Auditor,Cindy Byrd,REP,340007,1,0,4,5,
Jefferson,State Auditor,Charlie Prater,REP,340007,0,0,14,14,
Jefferson,Attorney General,Mike Hunter,REP,340007,0,0,11,11,
Jefferson,Attorney General,Gentner Drummond,REP,340007,1,0,8,9,
Jefferson,Superintendent of Public Instruction,Joy Hofmeister,REP,340007,1,0,11,12,
Jefferson,Superintendent of Public Instruction,Linda Murphy,REP,340007,0,0,8,8,
Jefferson,Commissioner of Labor,Cathy Costello,REP,340007,1,0,10,11,
Jefferson,Commissioner of Labor,Leslie Osborn,REP,340007,0,0,9,9,
Jefferson,Corporation Commissioner,Bob Anthony,REP,340007,1,0,9,10,
Jefferson,Corporation Commissioner,Brian Bingman,REP,340007,0,0,10,10,
Jefferson,Governor,Chris Powell,LIB,340007,0,0,0,0,
Jefferson,Governor,Rex Lawhorn,LIB,340007,0,0,0,0,
Jefferson,Corporation Commissioner,Ashley Nicole Mccray,DEM,340007,0,0,11,11,
Jefferson,Corporation Commissioner,Blake Cummings,DEM,340007,0,0,12,12,
Jefferson,U.S. House,Mary Brannon,DEM,340007,0,0,12,12,04
Jefferson,U.S. House,Fred Gipson,DEM,340007,0,0,12,12,04
Jefferson,Governor,Mick Cornett,REP,340008,0,0,1,1,
Jefferson,Governor,Kevin Stitt,REP,340008,0,0,3,3,
Jefferson,Lieutenant Governor,Dana Murphy,REP,340008,0,0,3,3,
Jefferson,Lieutenant Governor,Matt Pinnell,REP,340008,0,0,1,1,
Jefferson,State Auditor,Cindy Byrd,REP,340008,0,0,3,3,
Jefferson,State Auditor,Charlie Prater,REP,340008,0,0,1,1,
Jefferson,Attorney General,Mike Hunter,REP,340008,0,0,1,1,
Jefferson,Attorney General,Gentner Drummond,REP,340008,0,0,3,3,
Jefferson,Superintendent of Public Instruction,Joy Hofmeister,REP,340008,0,0,1,1,
Jefferson,Superintendent of Public Instruction,Linda Murphy,REP,340008,0,0,3,3,
Jefferson,Commissioner of Labor,Cathy Costello,REP,340008,0,0,2,2,
Jefferson,Commissioner of Labor,Leslie Osborn,REP,340008,0,0,2,2,
Jefferson,Corporation Commissioner,Bob Anthony,REP,340008,0,0,2,2,
Jefferson,Corporation Commissioner,Brian Bingman,REP,340008,0,0,2,2,
Jefferson,Governor,Chris Powell,LIB,340008,0,0,0,0,
Jefferson,Governor,Rex Lawhorn,LIB,340008,0,0,0,0,
Jefferson,Corporation Commissioner,Ashley Nicole Mccray,DEM,340008,0,0,0,0,
Jefferson,Corporation Commissioner,Blake Cummings,DEM,340008,0,0,1,1,
Jefferson,U.S. House,Mary Brannon,DEM,340008,0,0,1,1,04
Jefferson,U.S. House,Fred Gipson,DEM,340008,0,0,1,1,04
Jefferson,Governor,Mick Cornett,REP,340009,0,0,13,13,
Jefferson,Governor,Kevin Stitt,REP,340009,1,0,28,29,
Jefferson,Lieutenant Governor,Dana Murphy,REP,340009,0,0,18,18,
Jefferson,Lieutenant Governor,Matt Pinnell,REP,340009,1,0,23,24,
Jefferson,State Auditor,Cindy Byrd,REP,340009,0,0,16,16,
Jefferson,State Auditor,Charlie Prater,REP,340009,1,0,24,25,
Jefferson,Attorney General,Mike Hunter,REP,340009,0,0,24,24,
Jefferson,Attorney General,Gentner Drummond,REP,340009,1,0,17,18,
Jefferson,Superintendent of Public Instruction,Joy Hofmeister,REP,340009,0,0,17,17,
Jefferson,Superintendent of Public Instruction,Linda Murphy,REP,340009,1,0,24,25,
Jefferson,Commissioner of Labor,Cathy Costello,REP,340009,0,0,17,17,
Jefferson,Commissioner of Labor,Leslie Osborn,REP,340009,1,0,23,24,
Jefferson,Corporation Commissioner,Bob Anthony,REP,340009,1,0,17,18,
Jefferson,Corporation Commissioner,Brian Bingman,REP,340009,0,0,23,23,
Jefferson,Governor,Chris Powell,LIB,340009,0,0,0,0,
Jefferson,Governor,Rex Lawhorn,LIB,340009,0,0,0,0,
Jefferson,Corporation Commissioner,Ashley Nicole Mccray,DEM,340009,1,0,23,24,
Jefferson,Corporation Commissioner,Blake Cummings,DEM,340009,2,0,22,24,
Jefferson,U.S. House,Mary Brannon,DEM,340009,3,0,29,32,04
Jefferson,U.S. House,Fred Gipson,DEM,340009,0,0,16,16,04
Jefferson,Governor,Mick Cornett,REP,340010,0,1,3,4,
Jefferson,Governor,Kevin Stitt,REP,340010,0,0,1,1,
Jefferson,Lieutenant Governor,Dana Murphy,REP,340010,0,0,3,3,
Jefferson,Lieutenant Governor,Matt Pinnell,REP,340010,0,1,1,2,
Jefferson,State Auditor,Cindy Byrd,REP,340010,0,1,4,5,
Jefferson,State Auditor,Charlie Prater,REP,340010,0,0,0,0,
Jefferson,Attorney General,Mike Hunter,REP,340010,0,0,2,2,
Jefferson,Attorney General,Gentner Drummond,REP,340010,0,1,2,3,
Jefferson,Superintendent of Public Instruction,Joy Hofmeister,REP,340010,0,0,1,1,
Jefferson,Superintendent of Public Instruction,Linda Murphy,REP,340010,0,1,3,4,
Jefferson,Commissioner of Labor,Cathy Costello,REP,340010,0,0,2,2,
Jefferson,Commissioner of Labor,Leslie Osborn,REP,340010,0,1,2,3,
Jefferson,Corporation Commissioner,Bob Anthony,REP,340010,0,0,3,3,
Jefferson,Corporation Commissioner,Brian Bingman,REP,340010,0,1,1,2,
Jefferson,Governor,Chris Powell,LIB,340010,0,0,0,0,
Jefferson,Governor,Rex Lawhorn,LIB,340010,0,0,0,0,
Jefferson,Corporation Commissioner,Ashley Nicole Mccray,DEM,340010,0,0,2,2,
Jefferson,Corporation Commissioner,Blake Cummings,DEM,340010,0,0,4,4,
Jefferson,U.S. House,Mary Brannon,DEM,340010,0,0,3,3,04
Jefferson,U.S. House,Fred Gipson,DEM,340010,0,0,3,3,04
Johnston,Governor,Mick Cornett,REP,350001,0,0,15,15,
Johnston,Governor,Kevin Stitt,REP,350001,0,5,26,31,
Johnston,Lieutenant Governor,Dana Murphy,REP,350001,0,2,15,17,
Johnston,Lieutenant Governor,Matt Pinnell,REP,350001,0,3,25,28,
Johnston,State Auditor,Cindy Byrd,REP,350001,0,4,25,29,
Johnston,State Auditor,Charlie Prater,REP,350001,0,1,15,16,
Johnston,Attorney General,Mike Hunter,REP,350001,0,2,21,23,
Johnston,Attorney General,Gentner Drummond,REP,350001,0,3,18,21,
Johnston,Superintendent of Public Instruction,Joy Hofmeister,REP,350001,0,4,22,26,
Johnston,Superintendent of Public Instruction,Linda Murphy,REP,350001,0,1,18,19,
Johnston,Commissioner of Labor,Cathy Costello,REP,350001,0,5,13,18,
Johnston,Commissioner of Labor,Leslie Osborn,REP,350001,0,0,27,27,
Johnston,Corporation Commissioner,Bob Anthony,REP,350001,0,4,21,25,
Johnston,Corporation Commissioner,Brian Bingman,REP,350001,0,1,18,19,
Johnston,Governor,Chris Powell,LIB,350001,0,0,0,0,
Johnston,Governor,Rex Lawhorn,LIB,350001,0,1,0,1,
Johnston,Corporation Commissioner,Ashley Nicole Mccray,DEM,350001,0,3,10,13,
Johnston,Corporation Commissioner,Blake Cummings,DEM,350001,0,6,11,17,
Johnston,U.S. House,Jason Nichols,DEM,350001,0,5,7,12,02
Johnston,U.S. House,Clay Padgett,DEM,350001,0,4,14,18,02
Johnston,Governor,Mick Cornett,REP,350002,0,1,0,1,
Johnston,Governor,Kevin Stitt,REP,350002,3,2,16,21,
Johnston,Lieutenant Governor,Dana Murphy,REP,350002,2,2,8,12,
Johnston,Lieutenant Governor,Matt Pinnell,REP,350002,1,1,8,10,
Johnston,State Auditor,Cindy Byrd,REP,350002,2,2,11,15,
Johnston,State Auditor,Charlie Prater,REP,350002,1,1,4,6,
Johnston,Attorney General,Mike Hunter,REP,350002,1,2,6,9,
Johnston,Attorney General,Gentner Drummond,REP,350002,2,1,10,13,
Johnston,Superintendent of Public Instruction,Joy Hofmeister,REP,350002,3,2,7,12,
Johnston,Superintendent of Public Instruction,Linda Murphy,REP,350002,0,1,8,9,
Johnston,Commissioner of Labor,Cathy Costello,REP,350002,2,2,10,14,
Johnston,Commissioner of Labor,Leslie Osborn,REP,350002,1,1,5,7,
Johnston,Corporation Commissioner,Bob Anthony,REP,350002,3,1,6,10,
Johnston,Corporation Commissioner,Brian Bingman,REP,350002,0,2,9,11,
Johnston,Governor,Chris Powell,LIB,350002,0,0,0,0,
Johnston,Governor,Rex Lawhorn,LIB,350002,0,0,0,0,
Johnston,Corporation Commissioner,Ashley Nicole Mccray,DEM,350002,0,1,13,14,
Johnston,Corporation Commissioner,Blake Cummings,DEM,350002,1,0,12,13,
Johnston,U.S. House,Jason Nichols,DEM,350002,1,0,14,15,02
Johnston,U.S. House,Clay Padgett,DEM,350002,0,1,11,12,02
Johnston,Governor,Mick Cornett,REP,350003,0,0,8,8,
Johnston,Governor,Kevin Stitt,REP,350003,1,5,8,14,
Johnston,Lieutenant Governor,Dana Murphy,REP,350003,1,0,3,4,
Johnston,Lieutenant Governor,Matt Pinnell,REP,350003,0,5,13,18,
Johnston,State Auditor,Cindy Byrd,REP,350003,0,2,9,11,
Johnston,State Auditor,Charlie Prater,REP,350003,1,3,7,11,
Johnston,Attorney General,Mike Hunter,REP,350003,0,1,7,8,
Johnston,Attorney General,Gentner Drummond,REP,350003,1,4,9,14,
Johnston,Superintendent of Public Instruction,Joy Hofmeister,REP,350003,1,2,9,12,
Johnston,Superintendent of Public Instruction,Linda Murphy,REP,350003,0,2,7,9,
Johnston,Commissioner of Labor,Cathy Costello,REP,350003,0,3,5,8,
Johnston,Commissioner of Labor,Leslie Osborn,REP,350003,1,1,11,13,
Johnston,Corporation Commissioner,Bob Anthony,REP,350003,0,1,8,9,
Johnston,Corporation Commissioner,Brian Bingman,REP,350003,1,4,8,13,
Johnston,Governor,Chris Powell,LIB,350003,0,0,0,0,
Johnston,Governor,Rex Lawhorn,LIB,350003,0,0,0,0,
Johnston,Corporation Commissioner,Ashley Nicole Mccray,DEM,350003,0,0,18,18,
Johnston,Corporation Commissioner,Blake Cummings,DEM,350003,0,0,6,6,
Johnston,U.S. House,Jason Nichols,DEM,350003,0,0,9,9,02
Johnston,U.S. House,Clay Padgett,DEM,350003,0,0,14,14,02
Johnston,Governor,Mick Cornett,REP,350004,2,2,14,18,
Johnston,Governor,Kevin Stitt,REP,350004,1,9,48,58,
Johnston,Lieutenant Governor,Dana Murphy,REP,350004,2,4,19,25,
Johnston,Lieutenant Governor,Matt Pinnell,REP,350004,1,6,40,47,
Johnston,State Auditor,Cindy Byrd,REP,350004,2,11,46,59,
Johnston,State Auditor,Charlie Prater,REP,350004,1,0,12,13,
Johnston,Attorney General,Mike Hunter,REP,350004,3,6,24,33,
Johnston,Attorney General,Gentner Drummond,REP,350004,0,5,35,40,
Johnston,Superintendent of Public Instruction,Joy Hofmeister,REP,350004,1,5,32,38,
Johnston,Superintendent of Public Instruction,Linda Murphy,REP,350004,1,6,24,31,
Johnston,Commissioner of Labor,Cathy Costello,REP,350004,2,9,35,46,
Johnston,Commissioner of Labor,Leslie Osborn,REP,350004,0,2,20,22,
Johnston,Corporation Commissioner,Bob Anthony,REP,350004,3,7,34,44,
Johnston,Corporation Commissioner,Brian Bingman,REP,350004,0,3,23,26,
Johnston,Governor,Chris Powell,LIB,350004,0,0,0,0,
Johnston,Governor,Rex Lawhorn,LIB,350004,0,0,2,2,
Johnston,Corporation Commissioner,Ashley Nicole Mccray,DEM,350004,2,6,27,35,
Johnston,Corporation Commissioner,Blake Cummings,DEM,350004,0,3,24,27,
Johnston,U.S. House,Jason Nichols,DEM,350004,1,5,22,28,02
Johnston,U.S. House,Clay Padgett,DEM,350004,1,4,29,34,02
Johnston,Governor,Mick Cornett,REP,350005,0,0,16,16,
Johnston,Governor,Kevin Stitt,REP,350005,0,0,17,17,
Johnston,Lieutenant Governor,Dana Murphy,REP,350005,0,0,15,15,
Johnston,Lieutenant Governor,Matt Pinnell,REP,350005,0,0,18,18,
Johnston,State Auditor,Cindy Byrd,REP,350005,0,0,22,22,
Johnston,State Auditor,Charlie Prater,REP,350005,0,0,11,11,
Johnston,Attorney General,Mike Hunter,REP,350005,0,0,19,19,
Johnston,Attorney General,Gentner Drummond,REP,350005,0,0,14,14,
Johnston,Superintendent of Public Instruction,Joy Hofmeister,REP,350005,0,0,23,23,
Johnston,Superintendent of Public Instruction,Linda Murphy,REP,350005,0,0,10,10,
Johnston,Commissioner of Labor,Cathy Costello,REP,350005,0,0,17,17,
Johnston,Commissioner of Labor,Leslie Osborn,REP,350005,0,0,15,15,
Johnston,Corporation Commissioner,Bob Anthony,REP,350005,0,0,15,15,
Johnston,Corporation Commissioner,Brian Bingman,REP,350005,0,0,17,17,
Johnston,Governor,Chris Powell,LIB,350005,0,0,0,0,
Johnston,Governor,Rex Lawhorn,LIB,350005,0,0,0,0,
Johnston,Corporation Commissioner,Ashley Nicole Mccray,DEM,350005,0,0,10,10,
Johnston,Corporation Commissioner,Blake Cummings,DEM,350005,0,0,19,19,
Johnston,U.S. House,Jason Nichols,DEM,350005,0,0,16,16,02
Johnston,U.S. House,Clay Padgett,DEM,350005,0,0,14,14,02
Johnston,Governor,Mick Cornett,REP,350006,0,0,8,8,
Johnston,Governor,Kevin Stitt,REP,350006,0,0,12,12,
Johnston,Lieutenant Governor,Dana Murphy,REP,350006,0,0,6,6,
Johnston,Lieutenant Governor,Matt Pinnell,REP,350006,0,0,12,12,
Johnston,State Auditor,Cindy Byrd,REP,350006,0,0,8,8,
Johnston,State Auditor,Charlie Prater,REP,350006,0,0,9,9,
Johnston,Attorney General,Mike Hunter,REP,350006,0,0,6,6,
Johnston,Attorney General,Gentner Drummond,REP,350006,0,0,12,12,
Johnston,Superintendent of Public Instruction,Joy Hofmeister,REP,350006,0,0,8,8,
Johnston,Superintendent of Public Instruction,Linda Murphy,REP,350006,0,0,10,10,
Johnston,Commissioner of Labor,Cathy Costello,REP,350006,0,0,6,6,
Johnston,Commissioner of Labor,Leslie Osborn,REP,350006,0,0,10,10,
Johnston,Corporation Commissioner,Bob Anthony,REP,350006,0,0,14,14,
Johnston,Corporation Commissioner,Brian Bingman,REP,350006,0,0,2,2,
Johnston,Governor,Chris Powell,LIB,350006,0,0,0,0,
Johnston,Governor,Rex Lawhorn,LIB,350006,0,0,0,0,
Johnston,Corporation Commissioner,Ashley Nicole Mccray,DEM,350006,0,0,8,8,
Johnston,Corporation Commissioner,Blake Cummings,DEM,350006,1,0,14,15,
Johnston,U.S. House,Jason Nichols,DEM,350006,1,0,10,11,02
Johnston,U.S. House,Clay Padgett,DEM,350006,0,0,12,12,02
Johnston,Governor,Mick Cornett,REP,350007,0,0,2,2,
Johnston,Governor,Kevin Stitt,REP,350007,0,0,1,1,
Johnston,Lieutenant Governor,Dana Murphy,REP,350007,0,0,3,3,
Johnston,Lieutenant Governor,Matt Pinnell,REP,350007,0,0,1,1,
Johnston,State Auditor,Cindy Byrd,REP,350007,0,0,4,4,
Johnston,State Auditor,Charlie Prater,REP,350007,0,0,0,0,
Johnston,Attorney General,Mike Hunter,REP,350007,0,0,2,2,
Johnston,Attorney General,Gentner Drummond,REP,350007,0,0,2,2,
Johnston,Superintendent of Public Instruction,Joy Hofmeister,REP,350007,0,0,0,0,
Johnston,Superintendent of Public Instruction,Linda Murphy,REP,350007,0,0,3,3,
Johnston,Commissioner of Labor,Cathy Costello,REP,350007,0,0,0,0,
Johnston,Commissioner of Labor,Leslie Osborn,REP,350007,0,0,4,4,
Johnston,Corporation Commissioner,Bob Anthony,REP,350007,0,0,1,1,
Johnston,Corporation Commissioner,Brian Bingman,REP,350007,0,0,2,2,
Johnston,Governor,Chris Powell,LIB,350007,0,0,0,0,
Johnston,Governor,Rex Lawhorn,LIB,350007,0,0,0,0,
Johnston,Corporation Commissioner,Ashley Nicole Mccray,DEM,350007,0,0,0,0,
Johnston,Corporation Commissioner,Blake Cummings,DEM,350007,0,0,0,0,
Johnston,U.S. House,Jason Nichols,DEM,350007,0,0,0,0,02
Johnston,U.S. House,Clay Padgett,DEM,350007,0,0,0,0,02
Johnston,Governor,Mick Cornett,REP,350008,0,0,4,4,
Johnston,Governor,Kevin Stitt,REP,350008,0,1,8,9,
Johnston,Lieutenant Governor,Dana Murphy,REP,350008,0,1,4,5,
Johnston,Lieutenant Governor,Matt Pinnell,REP,350008,0,0,7,7,
Johnston,State Auditor,Cindy Byrd,REP,350008,0,0,6,6,
Johnston,State Auditor,Charlie Prater,REP,350008,0,1,6,7,
Johnston,Attorney General,Mike Hunter,REP,350008,0,0,4,4,
Johnston,Attorney General,Gentner Drummond,REP,350008,0,1,7,8,
Johnston,Superintendent of Public Instruction,Joy Hofmeister,REP,350008,0,1,4,5,
Johnston,Superintendent of Public Instruction,Linda Murphy,REP,350008,0,0,8,8,
Johnston,Commissioner of Labor,Cathy Costello,REP,350008,0,1,7,8,
Johnston,Commissioner of Labor,Leslie Osborn,REP,350008,0,0,5,5,
Johnston,Corporation Commissioner,Bob Anthony,REP,350008,0,1,4,5,
Johnston,Corporation Commissioner,Brian Bingman,REP,350008,0,0,7,7,
Johnston,Governor,Chris Powell,LIB,350008,0,0,0,0,
Johnston,Governor,Rex Lawhorn,LIB,350008,0,0,0,0,
Johnston,Corporation Commissioner,Ashley Nicole Mccray,DEM,350008,0,0,8,8,
Johnston,Corporation Commissioner,Blake Cummings,DEM,350008,0,0,14,14,
Johnston,U.S. House,Jason Nichols,DEM,350008,0,0,9,9,02
Johnston,U.S. House,Clay Padgett,DEM,350008,0,0,13,13,02
Johnston,Governor,Mick Cornett,REP,350009,0,0,2,2,
Johnston,Governor,Kevin Stitt,REP,350009,0,0,10,10,
Johnston,Lieutenant Governor,Dana Murphy,REP,350009,0,0,5,5,
Johnston,Lieutenant Governor,Matt Pinnell,REP,350009,0,0,6,6,
Johnston,State Auditor,Cindy Byrd,REP,350009,0,0,9,9,
Johnston,State Auditor,Charlie Prater,REP,350009,0,0,3,3,
Johnston,Attorney General,Mike Hunter,REP,350009,0,0,2,2,
Johnston,Attorney General,Gentner Drummond,REP,350009,0,0,10,10,
Johnston,Superintendent of Public Instruction,Joy Hofmeister,REP,350009,0,0,6,6,
Johnston,Superintendent of Public Instruction,Linda Murphy,REP,350009,0,0,5,5,
Johnston,Commissioner of Labor,Cathy Costello,REP,350009,0,0,8,8,
Johnston,Commissioner of Labor,Leslie Osborn,REP,350009,0,0,4,4,
Johnston,Corporation Commissioner,Bob Anthony,REP,350009,0,0,4,4,
Johnston,Corporation Commissioner,Brian Bingman,REP,350009,0,0,7,7,
Johnston,Governor,Chris Powell,LIB,350009,0,0,0,0,
Johnston,Governor,Rex Lawhorn,LIB,350009,0,0,0,0,
Johnston,Corporation Commissioner,Ashley Nicole Mccray,DEM,350009,0,0,16,16,
Johnston,Corporation Commissioner,Blake Cummings,DEM,350009,0,0,7,7,
Johnston,U.S. House,Jason Nichols,DEM,350009,0,0,10,10,02
Johnston,U.S. House,Clay Padgett,DEM,350009,0,0,12,12,02
Johnston,Governor,Mick Cornett,REP,350010,0,0,2,2,
Johnston,Governor,Kevin Stitt,REP,350010,0,0,11,11,
Johnston,Lieutenant Governor,Dana Murphy,REP,350010,0,0,2,2,
Johnston,Lieutenant Governor,Matt Pinnell,REP,350010,0,0,11,11,
Johnston,State Auditor,Cindy Byrd,REP,350010,0,0,9,9,
Johnston,State Auditor,Charlie Prater,REP,350010,0,0,4,4,
Johnston,Attorney General,Mike Hunter,REP,350010,0,0,6,6,
Johnston,Attorney General,Gentner Drummond,REP,350010,0,0,6,6,
Johnston,Superintendent of Public Instruction,Joy Hofmeister,REP,350010,0,0,5,5,
Johnston,Superintendent of Public Instruction,Linda Murphy,REP,350010,0,0,7,7,
Johnston,Commissioner of Labor,Cathy Costello,REP,350010,0,0,7,7,
Johnston,Commissioner of Labor,Leslie Osborn,REP,350010,0,0,5,5,
Johnston,Corporation Commissioner,Bob Anthony,REP,350010,0,0,6,6,
Johnston,Corporation Commissioner,Brian Bingman,REP,350010,0,0,7,7,
Johnston,Governor,Chris Powell,LIB,350010,0,0,1,1,
Johnston,Governor,Rex Lawhorn,LIB,350010,0,0,0,0,
Johnston,Corporation Commissioner,Ashley Nicole Mccray,DEM,350010,0,0,6,6,
Johnston,Corporation Commissioner,Blake Cummings,DEM,350010,0,0,5,5,
Johnston,U.S. House,Jason Nichols,DEM,350010,0,0,2,2,02
Johnston,U.S. House,Clay Padgett,DEM,350010,0,0,9,9,02
Johnston,Governor,Mick Cornett,REP,350011,0,0,2,2,
Johnston,Governor,Kevin Stitt,REP,350011,0,1,4,5,
Johnston,Lieutenant Governor,Dana Murphy,REP,350011,0,0,0,0,
Johnston,Lieutenant Governor,Matt Pinnell,REP,350011,0,1,5,6,
Johnston,State Auditor,Cindy Byrd,REP,350011,0,1,2,3,
Johnston,State Auditor,Charlie Prater,REP,350011,0,0,3,3,
Johnston,Attorney General,Mike Hunter,REP,350011,0,1,2,3,
Johnston,Attorney General,Gentner Drummond,REP,350011,0,0,4,4,
Johnston,Superintendent of Public Instruction,Joy Hofmeister,REP,350011,0,0,2,2,
Johnston,Superintendent of Public Instruction,Linda Murphy,REP,350011,0,1,3,4,
Johnston,Commissioner of Labor,Cathy Costello,REP,350011,0,1,3,4,
Johnston,Commissioner of Labor,Leslie Osborn,REP,350011,0,0,1,1,
Johnston,Corporation Commissioner,Bob Anthony,REP,350011,0,1,2,3,
Johnston,Corporation Commissioner,Brian Bingman,REP,350011,0,0,3,3,
Johnston,Governor,Chris Powell,LIB,350011,0,0,0,0,
Johnston,Governor,Rex Lawhorn,LIB,350011,0,0,0,0,
Johnston,Corporation Commissioner,Ashley Nicole Mccray,DEM,350011,2,0,3,5,
Johnston,Corporation Commissioner,Blake Cummings,DEM,350011,0,0,17,17,
Johnston,U.S. House,Jason Nichols,DEM,350011,2,0,7,9,02
Johnston,U.S. House,Clay Padgett,DEM,350011,0,0,12,12,02
Johnston,Governor,Mick Cornett,REP,350012,1,1,8,10,
Johnston,Governor,Kevin Stitt,REP,350012,1,1,12,14,
Johnston,Lieutenant Governor,Dana Murphy,REP,350012,0,1,6,7,
Johnston,Lieutenant Governor,Matt Pinnell,REP,350012,2,1,14,17,
Johnston,State Auditor,Cindy Byrd,REP,350012,2,2,14,18,
Johnston,State Auditor,Charlie Prater,REP,350012,0,0,4,4,
Johnston,Attorney General,Mike Hunter,REP,350012,0,1,10,11,
Johnston,Attorney General,Gentner Drummond,REP,350012,2,1,10,13,
Johnston,Superintendent of Public Instruction,Joy Hofmeister,REP,350012,0,1,5,6,
Johnston,Superintendent of Public Instruction,Linda Murphy,REP,350012,2,1,14,17,
Johnston,Commissioner of Labor,Cathy Costello,REP,350012,0,2,11,13,
Johnston,Commissioner of Labor,Leslie Osborn,REP,350012,2,0,7,9,
Johnston,Corporation Commissioner,Bob Anthony,REP,350012,1,2,5,8,
Johnston,Corporation Commissioner,Brian Bingman,REP,350012,1,0,12,13,
Johnston,Governor,Chris Powell,LIB,350012,0,0,0,0,
Johnston,Governor,Rex Lawhorn,LIB,350012,0,0,0,0,
Johnston,Corporation Commissioner,Ashley Nicole Mccray,DEM,350012,0,1,13,14,
Johnston,Corporation Commissioner,Blake Cummings,DEM,350012,0,0,9,9,
Johnston,U.S. House,Jason Nichols,DEM,350012,0,0,11,11,02
Johnston,U.S. House,Clay Padgett,DEM,350012,0,1,11,12,02
Johnston,Governor,Mick Cornett,REP,350013,2,1,18,21,
Johnston,Governor,Kevin Stitt,REP,350013,2,2,40,44,
Johnston,Lieutenant Governor,Dana Murphy,REP,350013,0,2,22,24,
Johnston,Lieutenant Governor,Matt Pinnell,REP,350013,4,1,35,40,
Johnston,State Auditor,Cindy Byrd,REP,350013,2,3,46,51,
Johnston,State Auditor,Charlie Prater,REP,350013,2,0,12,14,
Johnston,Attorney General,Mike Hunter,REP,350013,2,2,26,30,
Johnston,Attorney General,Gentner Drummond,REP,350013,2,1,32,35,
Johnston,Superintendent of Public Instruction,Joy Hofmeister,REP,350013,2,2,26,30,
Johnston,Superintendent of Public Instruction,Linda Murphy,REP,350013,2,1,32,35,
Johnston,Commissioner of Labor,Cathy Costello,REP,350013,2,1,33,36,
Johnston,Commissioner of Labor,Leslie Osborn,REP,350013,2,2,23,27,
Johnston,Corporation Commissioner,Bob Anthony,REP,350013,4,1,32,37,
Johnston,Corporation Commissioner,Brian Bingman,REP,350013,0,1,24,25,
Johnston,Governor,Chris Powell,LIB,350013,0,0,0,0,
Johnston,Governor,Rex Lawhorn,LIB,350013,0,0,0,0,
Johnston,Corporation Commissioner,Ashley Nicole Mccray,DEM,350013,0,3,20,23,
Johnston,Corporation Commissioner,Blake Cummings,DEM,350013,0,1,25,26,
Johnston,U.S. House,Jason Nichols,DEM,350013,0,2,23,25,02
Johnston,U.S. House,Clay Padgett,DEM,350013,0,2,24,26,02
Johnston,Governor,Mick Cornett,REP,350014,0,0,7,7,
Johnston,Governor,Kevin Stitt,REP,350014,0,0,6,6,
Johnston,Lieutenant Governor,Dana Murphy,REP,350014,0,0,7,7,
Johnston,Lieutenant Governor,Matt Pinnell,REP,350014,0,0,5,5,
Johnston,State Auditor,Cindy Byrd,REP,350014,0,0,9,9,
Johnston,State Auditor,Charlie Prater,REP,350014,0,0,3,3,
Johnston,Attorney General,Mike Hunter,REP,350014,0,0,3,3,
Johnston,Attorney General,Gentner Drummond,REP,350014,0,0,10,10,
Johnston,Superintendent of Public Instruction,Joy Hofmeister,REP,350014,0,0,8,8,
Johnston,Superintendent of Public Instruction,Linda Murphy,REP,350014,0,0,5,5,
Johnston,Commissioner of Labor,Cathy Costello,REP,350014,0,0,6,6,
Johnston,Commissioner of Labor,Leslie Osborn,REP,350014,0,0,6,6,
Johnston,Corporation Commissioner,Bob Anthony,REP,350014,0,0,6,6,
Johnston,Corporation Commissioner,Brian Bingman,REP,350014,0,0,7,7,
Johnston,Governor,Chris Powell,LIB,350014,0,0,0,0,
Johnston,Governor,Rex Lawhorn,LIB,350014,0,0,0,0,
Johnston,Corporation Commissioner,Ashley Nicole Mccray,DEM,350014,0,0,5,5,
Johnston,Corporation Commissioner,Blake Cummings,DEM,350014,0,0,6,6,
Johnston,U.S. House,Jason Nichols,DEM,350014,0,0,5,5,02
Johnston,U.S. House,Clay Padgett,DEM,350014,0,0,6,6,02
Kay,Governor,Mick Cornett,REP,360001,1,14,103,118,
Kay,Governor,Kevin Stitt,REP,360001,4,16,117,137,
Kay,Lieutenant Governor,Dana Murphy,REP,360001,0,14,105,119,
Kay,Lieutenant Governor,Matt Pinnell,REP,360001,3,16,111,130,
Kay,State Auditor,Cindy Byrd,REP,360001,0,14,88,102,
Kay,State Auditor,Charlie Prater,REP,360001,3,14,126,143,
Kay,Attorney General,Mike Hunter,REP,360001,1,18,100,119,
Kay,Attorney General,Gentner Drummond,REP,360001,4,11,119,134,
Kay,Superintendent of Public Instruction,Joy Hofmeister,REP,360001,5,18,119,142,
Kay,Superintendent of Public Instruction,Linda Murphy,REP,360001,0,8,95,103,
Kay,Commissioner of Labor,Cathy Costello,REP,360001,3,15,106,124,
Kay,Commissioner of Labor,Leslie Osborn,REP,360001,2,13,110,125,
Kay,Corporation Commissioner,Bob Anthony,REP,360001,3,21,111,135,
Kay,Corporation Commissioner,Brian Bingman,REP,360001,0,7,105,112,
Kay,State Senate,Bill Coleman,REP,360001,4,18,151,173,10
Kay,State Senate,Amber Roberts,REP,360001,0,11,67,78,10
Kay,State House,John Pfeiffer,REP,360001,4,19,107,130,38
Kay,State House,Brian Hobbs,REP,360001,1,10,111,122,38
Kay,Governor,Chris Powell,LIB,360001,0,0,0,0,
Kay,Governor,Rex Lawhorn,LIB,360001,0,0,2,2,
Kay,Corporation Commissioner,Ashley Nicole Mccray,DEM,360001,2,6,29,37,
Kay,Corporation Commissioner,Blake Cummings,DEM,360001,1,0,21,22,
Kay,Governor,Mick Cornett,REP,360101,1,4,104,109,
Kay,Governor,Kevin Stitt,REP,360101,0,0,90,90,
Kay,Lieutenant Governor,Dana Murphy,REP,360101,0,3,88,91,
Kay,Lieutenant Governor,Matt Pinnell,REP,360101,1,1,101,103,
Kay,State Auditor,Cindy Byrd,REP,360101,1,5,77,83,
Kay,State Auditor,Charlie Prater,REP,360101,0,0,107,107,
Kay,Attorney General,Mike Hunter,REP,360101,1,0,74,75,
Kay,Attorney General,Gentner Drummond,REP,360101,0,4,118,122,
Kay,Superintendent of Public Instruction,Joy Hofmeister,REP,360101,0,2,102,104,
Kay,Superintendent of Public Instruction,Linda Murphy,REP,360101,1,3,86,90,
Kay,Commissioner of Labor,Cathy Costello,REP,360101,1,4,97,102,
Kay,Commissioner of Labor,Leslie Osborn,REP,360101,0,1,92,93,
Kay,Corporation Commissioner,Bob Anthony,REP,360101,0,2,91,93,
Kay,Corporation Commissioner,Brian Bingman,REP,360101,1,3,99,103,
Kay,State Senate,Bill Coleman,REP,360101,1,3,132,136,10
Kay,State Senate,Amber Roberts,REP,360101,0,2,55,57,10
Kay,State House,John Pfeiffer,REP,360101,1,3,120,124,38
Kay,State House,Brian Hobbs,REP,360101,0,2,72,74,38
Kay,Governor,Chris Powell,LIB,360101,0,0,0,0,
Kay,Governor,Rex Lawhorn,LIB,360101,0,0,1,1,
Kay,Corporation Commissioner,Ashley Nicole Mccray,DEM,360101,0,0,37,37,
Kay,Corporation Commissioner,Blake Cummings,DEM,360101,0,0,25,25,
Kay,Governor,Mick Cornett,REP,360103,3,2,107,112,
Kay,Governor,Kevin Stitt,REP,360103,3,1,94,98,
Kay,Lieutenant Governor,Dana Murphy,REP,360103,3,0,76,79,
Kay,Lieutenant Governor,Matt Pinnell,REP,360103,3,3,120,126,
Kay,State Auditor,Cindy Byrd,REP,360103,4,2,83,89,
Kay,State Auditor,Charlie Prater,REP,360103,2,0,111,113,
Kay,Attorney General,Mike Hunter,REP,360103,5,2,94,101,
Kay,Attorney General,Gentner Drummond,REP,360103,1,1,108,110,
Kay,Superintendent of Public Instruction,Joy Hofmeister,REP,360103,2,3,112,117,
Kay,Superintendent of Public Instruction,Linda Murphy,REP,360103,4,0,82,86,
Kay,Commissioner of Labor,Cathy Costello,REP,360103,3,1,110,114,
Kay,Commissioner of Labor,Leslie Osborn,REP,360103,3,2,87,92,
Kay,Corporation Commissioner,Bob Anthony,REP,360103,1,1,90,92,
Kay,Corporation Commissioner,Brian Bingman,REP,360103,5,2,102,109,
Kay,State Senate,Bill Coleman,REP,360103,3,3,138,144,10
Kay,State Senate,Amber Roberts,REP,360103,3,0,53,56,10
Kay,State House,John Pfeiffer,REP,360103,3,2,107,112,38
Kay,State House,Brian Hobbs,REP,360103,3,1,95,99,38
Kay,Governor,Chris Powell,LIB,360103,0,0,0,0,
Kay,Governor,Rex Lawhorn,LIB,360103,0,0,0,0,
Kay,Corporation Commissioner,Ashley Nicole Mccray,DEM,360103,0,1,18,19,
Kay,Corporation Commissioner,Blake Cummings,DEM,360103,0,0,19,19,
Kay,Governor,Mick Cornett,REP,360202,4,5,115,124,
Kay,Governor,Kevin Stitt,REP,360202,5,3,81,89,
Kay,Lieutenant Governor,Dana Murphy,REP,360202,3,2,86,91,
Kay,Lieutenant Governor,Matt Pinnell,REP,360202,6,6,108,120,
Kay,State Auditor,Cindy Byrd,REP,360202,4,7,83,94,
Kay,State Auditor,Charlie Prater,REP,360202,5,1,105,111,
Kay,Attorney General,Mike Hunter,REP,360202,5,6,87,98,
Kay,Attorney General,Gentner Drummond,REP,360202,4,2,107,113,
Kay,Superintendent of Public Instruction,Joy Hofmeister,REP,360202,3,2,101,106,
Kay,Superintendent of Public Instruction,Linda Murphy,REP,360202,6,5,91,102,
Kay,Commissioner of Labor,Cathy Costello,REP,360202,4,3,80,87,
Kay,Commissioner of Labor,Leslie Osborn,REP,360202,5,5,108,118,
Kay,Corporation Commissioner,Bob Anthony,REP,360202,3,5,75,83,
Kay,Corporation Commissioner,Brian Bingman,REP,360202,6,3,116,125,
Kay,State House,John Pfeiffer,REP,360202,7,7,102,116,38
Kay,State House,Brian Hobbs,REP,360202,2,1,94,97,38
Kay,Governor,Chris Powell,LIB,360202,0,0,0,0,
Kay,Governor,Rex Lawhorn,LIB,360202,0,0,0,0,
Kay,Corporation Commissioner,Ashley Nicole Mccray,DEM,360202,0,0,18,18,
Kay,Corporation Commissioner,Blake Cummings,DEM,360202,1,0,25,26,
Kay,Governor,Mick Cornett,REP,360205,3,1,87,91,
Kay,Governor,Kevin Stitt,REP,360205,3,1,96,100,
Kay,Lieutenant Governor,Dana Murphy,REP,360205,4,1,78,83,
Kay,Lieutenant Governor,Matt Pinnell,REP,360205,2,1,104,107,
Kay,State Auditor,Cindy Byrd,REP,360205,3,1,75,79,
Kay,State Auditor,Charlie Prater,REP,360205,3,1,104,108,
Kay,Attorney General,Mike Hunter,REP,360205,2,0,69,71,
Kay,Attorney General,Gentner Drummond,REP,360205,4,2,114,120,
Kay,Superintendent of Public Instruction,Joy Hofmeister,REP,360205,3,1,91,95,
Kay,Superintendent of Public Instruction,Linda Murphy,REP,360205,3,1,89,93,
Kay,Commissioner of Labor,Cathy Costello,REP,360205,0,1,78,79,
Kay,Commissioner of Labor,Leslie Osborn,REP,360205,6,1,105,112,
Kay,Corporation Commissioner,Bob Anthony,REP,360205,4,1,74,79,
Kay,Corporation Commissioner,Brian Bingman,REP,360205,2,1,106,109,
Kay,State House,John Pfeiffer,REP,360205,6,2,90,98,38
Kay,State House,Brian Hobbs,REP,360205,0,0,91,91,38
Kay,Governor,Chris Powell,LIB,360205,0,0,0,0,
Kay,Governor,Rex Lawhorn,LIB,360205,0,0,2,2,
Kay,Corporation Commissioner,Ashley Nicole Mccray,DEM,360205,1,0,34,35,
Kay,Corporation Commissioner,Blake Cummings,DEM,360205,0,0,27,27,
Kay,Governor,Mick Cornett,REP,360206,8,9,226,243,
Kay,Governor,Kevin Stitt,REP,360206,9,6,151,166,
Kay,Lieutenant Governor,Dana Murphy,REP,360206,4,8,144,156,
Kay,Lieutenant Governor,Matt Pinnell,REP,360206,13,7,228,248,
Kay,State Auditor,Cindy Byrd,REP,360206,9,8,153,170,
Kay,State Auditor,Charlie Prater,REP,360206,8,7,216,231,
Kay,Attorney General,Mike Hunter,REP,360206,10,13,170,193,
Kay,Attorney General,Gentner Drummond,REP,360206,7,2,204,213,
Kay,Superintendent of Public Instruction,Joy Hofmeister,REP,360206,7,5,218,230,
Kay,Superintendent of Public Instruction,Linda Murphy,REP,360206,10,8,155,173,
Kay,Commissioner of Labor,Cathy Costello,REP,360206,7,9,169,185,
Kay,Commissioner of Labor,Leslie Osborn,REP,360206,10,6,198,214,
Kay,Corporation Commissioner,Bob Anthony,REP,360206,7,7,156,170,
Kay,Corporation Commissioner,Brian Bingman,REP,360206,10,7,210,227,
Kay,State House,John Pfeiffer,REP,360206,10,7,224,241,38
Kay,State House,Brian Hobbs,REP,360206,7,8,156,171,38
Kay,Governor,Chris Powell,LIB,360206,0,0,1,1,
Kay,Governor,Rex Lawhorn,LIB,360206,0,0,1,1,
Kay,Corporation Commissioner,Ashley Nicole Mccray,DEM,360206,3,3,24,30,
Kay,Corporation Commissioner,Blake Cummings,DEM,360206,1,0,27,28,
Kay,Governor,Mick Cornett,REP,360400,0,0,19,19,
Kay,Governor,Kevin Stitt,REP,360400,0,3,14,17,
Kay,Lieutenant Governor,Dana Murphy,REP,360400,0,1,14,15,
Kay,Lieutenant Governor,Matt Pinnell,REP,360400,0,2,17,19,
Kay,State Auditor,Cindy Byrd,REP,360400,0,0,18,18,
Kay,State Auditor,Charlie Prater,REP,360400,0,3,13,16,
Kay,Attorney General,Mike Hunter,REP,360400,0,1,15,16,
Kay,Attorney General,Gentner Drummond,REP,360400,0,2,17,19,
Kay,Superintendent of Public Instruction,Joy Hofmeister,REP,360400,0,1,20,21,
Kay,Superintendent of Public Instruction,Linda Murphy,REP,360400,0,2,11,13,
Kay,Commissioner of Labor,Cathy Costello,REP,360400,0,3,12,15,
Kay,Commissioner of Labor,Leslie Osborn,REP,360400,0,0,19,19,
Kay,Corporation Commissioner,Bob Anthony,REP,360400,0,1,15,16,
Kay,Corporation Commissioner,Brian Bingman,REP,360400,0,2,16,18,
Kay,State Senate,Bill Coleman,REP,360400,0,1,21,22,10
Kay,State Senate,Amber Roberts,REP,360400,0,2,10,12,10
Kay,Governor,Chris Powell,LIB,360400,0,0,0,0,
Kay,Governor,Rex Lawhorn,LIB,360400,0,0,0,0,
Kay,Corporation Commissioner,Ashley Nicole Mccray,DEM,360400,0,0,1,1,
Kay,Corporation Commissioner,Blake Cummings,DEM,360400,0,0,1,1,
Kay,Governor,Mick Cornett,REP,360401,0,3,3,6,
Kay,Governor,Kevin Stitt,REP,360401,0,3,5,8,
Kay,Lieutenant Governor,Dana Murphy,REP,360401,0,4,2,6,
Kay,Lieutenant Governor,Matt Pinnell,REP,360401,0,2,6,8,
Kay,State Auditor,Cindy Byrd,REP,360401,0,3,2,5,
Kay,State Auditor,Charlie Prater,REP,360401,0,4,6,10,
Kay,Attorney General,Mike Hunter,REP,360401,0,2,3,5,
Kay,Attorney General,Gentner Drummond,REP,360401,0,5,5,10,
Kay,Superintendent of Public Instruction,Joy Hofmeister,REP,360401,0,2,2,4,
Kay,Superintendent of Public Instruction,Linda Murphy,REP,360401,0,5,6,11,
Kay,Commissioner of Labor,Cathy Costello,REP,360401,0,2,4,6,
Kay,Commissioner of Labor,Leslie Osborn,REP,360401,0,3,4,7,
Kay,Corporation Commissioner,Bob Anthony,REP,360401,0,3,2,5,
Kay,Corporation Commissioner,Brian Bingman,REP,360401,0,3,6,9,
Kay,State Senate,Bill Coleman,REP,360401,0,6,5,11,10
Kay,State Senate,Amber Roberts,REP,360401,0,1,3,4,10
Kay,Governor,Chris Powell,LIB,360401,0,0,0,0,
Kay,Governor,Rex Lawhorn,LIB,360401,0,0,0,0,
Kay,Corporation Commissioner,Ashley Nicole Mccray,DEM,360401,0,0,2,2,
Kay,Corporation Commissioner,Blake Cummings,DEM,360401,0,0,1,1,
Kay,Governor,Mick Cornett,REP,360403,1,6,49,56,
Kay,Governor,Kevin Stitt,REP,360403,1,8,71,80,
Kay,Lieutenant Governor,Dana Murphy,REP,360403,1,8,51,60,
Kay,Lieutenant Governor,Matt Pinnell,REP,360403,1,5,67,73,
Kay,State Auditor,Cindy Byrd,REP,360403,1,4,47,52,
Kay,State Auditor,Charlie Prater,REP,360403,1,9,67,77,
Kay,Attorney General,Mike Hunter,REP,360403,0,6,57,63,
Kay,Attorney General,Gentner Drummond,REP,360403,2,8,61,71,
Kay,Superintendent of Public Instruction,Joy Hofmeister,REP,360403,2,6,72,80,
Kay,Superintendent of Public Instruction,Linda Murphy,REP,360403,0,7,47,54,
Kay,Commissioner of Labor,Cathy Costello,REP,360403,2,8,64,74,
Kay,Commissioner of Labor,Leslie Osborn,REP,360403,0,5,51,56,
Kay,Corporation Commissioner,Bob Anthony,REP,360403,1,12,69,82,
Kay,Corporation Commissioner,Brian Bingman,REP,360403,1,1,48,50,
Kay,State Senate,Bill Coleman,REP,360403,1,9,63,73,10
Kay,State Senate,Amber Roberts,REP,360403,1,5,54,60,10
Kay,State House,John Pfeiffer,REP,360403,0,11,61,72,38
Kay,State House,Brian Hobbs,REP,360403,2,3,58,63,38
Kay,Governor,Chris Powell,LIB,360403,0,0,0,0,
Kay,Governor,Rex Lawhorn,LIB,360403,0,0,0,0,
Kay,Corporation Commissioner,Ashley Nicole Mccray,DEM,360403,0,0,10,10,
Kay,Corporation Commissioner,Blake Cummings,DEM,360403,0,0,9,9,
Kay,Governor,Mick Cornett,REP,360404,0,5,22,27,
Kay,Governor,Kevin Stitt,REP,360404,0,0,29,29,
Kay,Lieutenant Governor,Dana Murphy,REP,360404,0,1,15,16,
Kay,Lieutenant Governor,Matt Pinnell,REP,360404,0,4,36,40,
Kay,State Auditor,Cindy Byrd,REP,360404,0,5,18,23,
Kay,State Auditor,Charlie Prater,REP,360404,0,0,30,30,
Kay,Attorney General,Mike Hunter,REP,360404,0,1,19,20,
Kay,Attorney General,Gentner Drummond,REP,360404,0,4,32,36,
Kay,Superintendent of Public Instruction,Joy Hofmeister,REP,360404,0,2,27,29,
Kay,Superintendent of Public Instruction,Linda Murphy,REP,360404,0,3,23,26,
Kay,Commissioner of Labor,Cathy Costello,REP,360404,0,4,20,24,
Kay,Commissioner of Labor,Leslie Osborn,REP,360404,0,1,29,30,
Kay,Corporation Commissioner,Bob Anthony,REP,360404,0,2,22,24,
Kay,Corporation Commissioner,Brian Bingman,REP,360404,0,3,28,31,
Kay,State Senate,Bill Coleman,REP,360404,0,3,35,38,10
Kay,State Senate,Amber Roberts,REP,360404,0,2,14,16,10
Kay,State House,John Pfeiffer,REP,360404,0,3,42,45,38
Kay,State House,Brian Hobbs,REP,360404,0,2,9,11,38
Kay,Governor,Chris Powell,LIB,360404,0,0,0,0,
Kay,Governor,Rex Lawhorn,LIB,360404,0,0,0,0,
Kay,Corporation Commissioner,Ashley Nicole Mccray,DEM,360404,0,1,5,6,
Kay,Corporation Commissioner,Blake Cummings,DEM,360404,0,0,6,6,
Kay,Governor,Mick Cornett,REP,360406,0,1,46,47,
Kay,Governor,Kevin Stitt,REP,360406,0,3,57,60,
Kay,Lieutenant Governor,Dana Murphy,REP,360406,0,1,49,50,
Kay,Lieutenant Governor,Matt Pinnell,REP,360406,0,3,52,55,
Kay,State Auditor,Cindy Byrd,REP,360406,0,2,37,39,
Kay,State Auditor,Charlie Prater,REP,360406,0,2,64,66,
Kay,Attorney General,Mike Hunter,REP,360406,0,3,41,44,
Kay,Attorney General,Gentner Drummond,REP,360406,0,1,63,64,
Kay,Superintendent of Public Instruction,Joy Hofmeister,REP,360406,0,3,55,58,
Kay,Superintendent of Public Instruction,Linda Murphy,REP,360406,0,1,46,47,
Kay,Commissioner of Labor,Cathy Costello,REP,360406,0,4,50,54,
Kay,Commissioner of Labor,Leslie Osborn,REP,360406,0,0,51,51,
Kay,Corporation Commissioner,Bob Anthony,REP,360406,0,2,46,48,
Kay,Corporation Commissioner,Brian Bingman,REP,360406,0,2,53,55,
Kay,State House,John Pfeiffer,REP,360406,0,4,52,56,38
Kay,State House,Brian Hobbs,REP,360406,0,0,55,55,38
Kay,Governor,Chris Powell,LIB,360406,0,0,0,0,
Kay,Governor,Rex Lawhorn,LIB,360406,0,0,0,0,
Kay,Corporation Commissioner,Ashley Nicole Mccray,DEM,360406,1,0,5,6,
Kay,Corporation Commissioner,Blake Cummings,DEM,360406,0,1,5,6,
Kay,Governor,Mick Cornett,REP,360407,0,0,6,6,
Kay,Governor,Kevin Stitt,REP,360407,0,0,5,5,
Kay,Lieutenant Governor,Dana Murphy,REP,360407,0,0,5,5,
Kay,Lieutenant Governor,Matt Pinnell,REP,360407,0,0,6,6,
Kay,State Auditor,Cindy Byrd,REP,360407,0,0,3,3,
Kay,State Auditor,Charlie Prater,REP,360407,0,0,8,8,
Kay,Attorney General,Mike Hunter,REP,360407,0,0,4,4,
Kay,Attorney General,Gentner Drummond,REP,360407,0,0,7,7,
Kay,Superintendent of Public Instruction,Joy Hofmeister,REP,360407,0,0,6,6,
Kay,Superintendent of Public Instruction,Linda Murphy,REP,360407,0,0,5,5,
Kay,Commissioner of Labor,Cathy Costello,REP,360407,0,0,4,4,
Kay,Commissioner of Labor,Leslie Osborn,REP,360407,0,0,7,7,
Kay,Corporation Commissioner,Bob Anthony,REP,360407,0,0,6,6,
Kay,Corporation Commissioner,Brian Bingman,REP,360407,0,0,4,4,
Kay,State Senate,Bill Coleman,REP,360407,0,0,10,10,10
Kay,State Senate,Amber Roberts,REP,360407,0,0,1,1,10
Kay,State House,John Pfeiffer,REP,360407,0,0,9,9,38
Kay,State House,Brian Hobbs,REP,360407,0,0,2,2,38
Kay,Governor,Chris Powell,LIB,360407,0,0,0,0,
Kay,Governor,Rex Lawhorn,LIB,360407,0,0,0,0,
Kay,Corporation Commissioner,Ashley Nicole Mccray,DEM,360407,0,0,0,0,
Kay,Corporation Commissioner,Blake Cummings,DEM,360407,0,0,3,3,
Kay,Governor,Mick Cornett,REP,360409,0,0,12,12,
Kay,Governor,Kevin Stitt,REP,360409,1,1,14,16,
Kay,Lieutenant Governor,Dana Murphy,REP,360409,1,0,10,11,
Kay,Lieutenant Governor,Matt Pinnell,REP,360409,0,1,16,17,
Kay,State Auditor,Cindy Byrd,REP,360409,0,1,5,6,
Kay,State Auditor,Charlie Prater,REP,360409,1,0,19,20,
Kay,Attorney General,Mike Hunter,REP,360409,1,0,11,12,
Kay,Attorney General,Gentner Drummond,REP,360409,0,1,15,16,
Kay,Superintendent of Public Instruction,Joy Hofmeister,REP,360409,0,0,17,17,
Kay,Superintendent of Public Instruction,Linda Murphy,REP,360409,1,1,7,9,
Kay,Commissioner of Labor,Cathy Costello,REP,360409,0,0,8,8,
Kay,Commissioner of Labor,Leslie Osborn,REP,360409,1,1,18,20,
Kay,Corporation Commissioner,Bob Anthony,REP,360409,0,0,8,8,
Kay,Corporation Commissioner,Brian Bingman,REP,360409,1,1,16,18,
Kay,State Senate,Bill Coleman,REP,360409,1,1,19,21,10
Kay,State Senate,Amber Roberts,REP,360409,0,0,7,7,10
Kay,State House,John Pfeiffer,REP,360409,0,1,17,18,38
Kay,State House,Brian Hobbs,REP,360409,1,0,9,10,38
Kay,Governor,Chris Powell,LIB,360409,0,0,0,0,
Kay,Governor,Rex Lawhorn,LIB,360409,0,0,0,0,
Kay,Corporation Commissioner,Ashley Nicole Mccray,DEM,360409,0,0,3,3,
Kay,Corporation Commissioner,Blake Cummings,DEM,360409,0,0,2,2,
Kay,Governor,Mick Cornett,REP,360411,0,1,17,18,
Kay,Governor,Kevin Stitt,REP,360411,0,1,18,19,
Kay,Lieutenant Governor,Dana Murphy,REP,360411,0,2,19,21,
Kay,Lieutenant Governor,Matt Pinnell,REP,360411,0,0,16,16,
Kay,State Auditor,Cindy Byrd,REP,360411,0,1,9,10,
Kay,State Auditor,Charlie Prater,REP,360411,0,1,26,27,
Kay,Attorney General,Mike Hunter,REP,360411,0,2,13,15,
Kay,Attorney General,Gentner Drummond,REP,360411,0,0,22,22,
Kay,Superintendent of Public Instruction,Joy Hofmeister,REP,360411,0,0,20,20,
Kay,Superintendent of Public Instruction,Linda Murphy,REP,360411,0,1,15,16,
Kay,Commissioner of Labor,Cathy Costello,REP,360411,0,0,21,21,
Kay,Commissioner of Labor,Leslie Osborn,REP,360411,0,2,14,16,
Kay,Corporation Commissioner,Bob Anthony,REP,360411,0,2,16,18,
Kay,Corporation Commissioner,Brian Bingman,REP,360411,0,0,18,18,
Kay,State Senate,Bill Coleman,REP,360411,0,2,20,22,10
Kay,State Senate,Amber Roberts,REP,360411,0,0,15,15,10
Kay,Governor,Chris Powell,LIB,360411,0,0,0,0,
Kay,Governor,Rex Lawhorn,LIB,360411,0,0,1,1,
Kay,Corporation Commissioner,Ashley Nicole Mccray,DEM,360411,1,0,8,9,
Kay,Corporation Commissioner,Blake Cummings,DEM,360411,0,0,7,7,
Kay,Governor,Mick Cornett,REP,360412,0,0,29,29,
Kay,Governor,Kevin Stitt,REP,360412,1,0,37,38,
Kay,Lieutenant Governor,Dana Murphy,REP,360412,0,0,26,26,
Kay,Lieutenant Governor,Matt Pinnell,REP,360412,1,0,40,41,
Kay,State Auditor,Cindy Byrd,REP,360412,1,0,24,25,
Kay,State Auditor,Charlie Prater,REP,360412,0,0,41,41,
Kay,Attorney General,Mike Hunter,REP,360412,0,0,28,28,
Kay,Attorney General,Gentner Drummond,REP,360412,1,0,38,39,
Kay,Superintendent of Public Instruction,Joy Hofmeister,REP,360412,0,0,29,29,
Kay,Superintendent of Public Instruction,Linda Murphy,REP,360412,1,0,36,37,
Kay,Commissioner of Labor,Cathy Costello,REP,360412,1,0,15,16,
Kay,Commissioner of Labor,Leslie Osborn,REP,360412,0,0,49,49,
Kay,Corporation Commissioner,Bob Anthony,REP,360412,1,0,21,22,
Kay,Corporation Commissioner,Brian Bingman,REP,360412,0,0,44,44,
Kay,State Senate,Bill Coleman,REP,360412,1,0,38,39,10
Kay,State Senate,Amber Roberts,REP,360412,0,0,25,25,10
Kay,Governor,Chris Powell,LIB,360412,0,0,0,0,
Kay,Governor,Rex Lawhorn,LIB,360412,0,0,0,0,
Kay,Corporation Commissioner,Ashley Nicole Mccray,DEM,360412,0,0,9,9,
Kay,Corporation Commissioner,Blake Cummings,DEM,360412,0,0,4,4,
Kay,Governor,Mick Cornett,REP,360413,3,11,160,174,
Kay,Governor,Kevin Stitt,REP,360413,5,2,150,157,
Kay,Lieutenant Governor,Dana Murphy,REP,360413,3,6,129,138,
Kay,Lieutenant Governor,Matt Pinnell,REP,360413,4,7,170,181,
Kay,State Auditor,Cindy Byrd,REP,360413,1,5,130,136,
Kay,State Auditor,Charlie Prater,REP,360413,7,8,160,175,
Kay,Attorney General,Mike Hunter,REP,360413,7,6,145,158,
Kay,Attorney General,Gentner Drummond,REP,360413,1,7,157,165,
Kay,Superintendent of Public Instruction,Joy Hofmeister,REP,360413,6,10,198,214,
Kay,Superintendent of Public Instruction,Linda Murphy,REP,360413,2,3,105,110,
Kay,Commissioner of Labor,Cathy Costello,REP,360413,4,5,118,127,
Kay,Commissioner of Labor,Leslie Osborn,REP,360413,4,8,172,184,
Kay,Corporation Commissioner,Bob Anthony,REP,360413,5,8,154,167,
Kay,Corporation Commissioner,Brian Bingman,REP,360413,3,5,143,151,
Kay,State Senate,Bill Coleman,REP,360413,7,11,233,251,10
Kay,State Senate,Amber Roberts,REP,360413,1,2,72,75,10
Kay,Governor,Chris Powell,LIB,360413,0,0,0,0,
Kay,Governor,Rex Lawhorn,LIB,360413,0,0,0,0,
Kay,Corporation Commissioner,Ashley Nicole Mccray,DEM,360413,2,3,27,32,
Kay,Corporation Commissioner,Blake Cummings,DEM,360413,1,0,17,18,
Kay,Governor,Mick Cornett,REP,360419,0,2,65,67,
Kay,Governor,Kevin Stitt,REP,360419,3,3,51,57,
Kay,Lieutenant Governor,Dana Murphy,REP,360419,0,0,46,46,
Kay,Lieutenant Governor,Matt Pinnell,REP,360419,3,5,64,72,
Kay,State Auditor,Cindy Byrd,REP,360419,2,2,38,42,
Kay,State Auditor,Charlie Prater,REP,360419,1,3,73,77,
Kay,Attorney General,Mike Hunter,REP,360419,2,1,52,55,
Kay,Attorney General,Gentner Drummond,REP,360419,1,4,62,67,
Kay,Superintendent of Public Instruction,Joy Hofmeister,REP,360419,2,4,62,68,
Kay,Superintendent of Public Instruction,Linda Murphy,REP,360419,1,1,50,52,
Kay,Commissioner of Labor,Cathy Costello,REP,360419,0,3,47,50,
Kay,Commissioner of Labor,Leslie Osborn,REP,360419,3,2,63,68,
Kay,Corporation Commissioner,Bob Anthony,REP,360419,0,1,57,58,
Kay,Corporation Commissioner,Brian Bingman,REP,360419,3,4,54,61,
Kay,State Senate,Bill Coleman,REP,360419,3,3,85,91,10
Kay,State Senate,Amber Roberts,REP,360419,0,2,29,31,10
Kay,Governor,Chris Powell,LIB,360419,0,0,0,0,
Kay,Governor,Rex Lawhorn,LIB,360419,0,0,0,0,
Kay,Corporation Commissioner,Ashley Nicole Mccray,DEM,360419,1,1,21,23,
Kay,Corporation Commissioner,Blake Cummings,DEM,360419,0,0,13,13,
Kay,Governor,Mick Cornett,REP,360420,0,2,27,29,
Kay,Governor,Kevin Stitt,REP,360420,0,3,25,28,
Kay,Lieutenant Governor,Dana Murphy,REP,360420,0,3,27,30,
Kay,Lieutenant Governor,Matt Pinnell,REP,360420,0,2,26,28,
Kay,State Auditor,Cindy Byrd,REP,360420,0,4,24,28,
Kay,State Auditor,Charlie Prater,REP,360420,0,1,29,30,
Kay,Attorney General,Mike Hunter,REP,360420,0,2,32,34,
Kay,Attorney General,Gentner Drummond,REP,360420,0,3,20,23,
Kay,Superintendent of Public Instruction,Joy Hofmeister,REP,360420,0,1,35,36,
Kay,Superintendent of Public Instruction,Linda Murphy,REP,360420,0,4,17,21,
Kay,Commissioner of Labor,Cathy Costello,REP,360420,0,4,13,17,
Kay,Commissioner of Labor,Leslie Osborn,REP,360420,0,1,37,38,
Kay,Corporation Commissioner,Bob Anthony,REP,360420,0,0,29,29,
Kay,Corporation Commissioner,Brian Bingman,REP,360420,0,5,24,29,
Kay,State Senate,Bill Coleman,REP,360420,0,3,34,37,10
Kay,State Senate,Amber Roberts,REP,360420,0,2,19,21,10
Kay,State House,John Pfeiffer,REP,360420,0,2,31,33,38
Kay,State House,Brian Hobbs,REP,360420,0,3,22,25,38
Kay,Governor,Chris Powell,LIB,360420,0,0,0,0,
Kay,Governor,Rex Lawhorn,LIB,360420,0,0,0,0,
Kay,Corporation Commissioner,Ashley Nicole Mccray,DEM,360420,0,0,11,11,
Kay,Corporation Commissioner,Blake Cummings,DEM,360420,0,0,10,10,
Kay,Governor,Mick Cornett,REP,360503,1,2,101,104,
Kay,Governor,Kevin Stitt,REP,360503,3,5,89,97,
Kay,Lieutenant Governor,Dana Murphy,REP,360503,1,5,93,99,
Kay,Lieutenant Governor,Matt Pinnell,REP,360503,3,2,95,100,
Kay,State Auditor,Cindy Byrd,REP,360503,3,2,72,77,
Kay,State Auditor,Charlie Prater,REP,360503,1,5,109,115,
Kay,Attorney General,Mike Hunter,REP,360503,3,5,84,92,
Kay,Attorney General,Gentner Drummond,REP,360503,1,2,106,109,
Kay,Superintendent of Public Instruction,Joy Hofmeister,REP,360503,1,3,101,105,
Kay,Superintendent of Public Instruction,Linda Murphy,REP,360503,3,4,87,94,
Kay,Commissioner of Labor,Cathy Costello,REP,360503,4,5,101,110,
Kay,Commissioner of Labor,Leslie Osborn,REP,360503,0,2,82,84,
Kay,Corporation Commissioner,Bob Anthony,REP,360503,3,3,93,99,
Kay,Corporation Commissioner,Brian Bingman,REP,360503,1,4,91,96,
Kay,State Senate,Bill Coleman,REP,360503,1,6,139,146,10
Kay,State Senate,Amber Roberts,REP,360503,3,1,49,53,10
Kay,Governor,Chris Powell,LIB,360503,0,0,0,0,
Kay,Governor,Rex Lawhorn,LIB,360503,0,0,1,1,
Kay,Corporation Commissioner,Ashley Nicole Mccray,DEM,360503,0,1,30,31,
Kay,Corporation Commissioner,Blake Cummings,DEM,360503,2,1,24,27,
Kay,Governor,Mick Cornett,REP,360507,3,3,57,63,
Kay,Governor,Kevin Stitt,REP,360507,5,1,58,64,
Kay,Lieutenant Governor,Dana Murphy,REP,360507,2,3,50,55,
Kay,Lieutenant Governor,Matt Pinnell,REP,360507,6,1,63,70,
Kay,State Auditor,Cindy Byrd,REP,360507,1,1,42,44,
Kay,State Auditor,Charlie Prater,REP,360507,7,3,71,81,
Kay,Attorney General,Mike Hunter,REP,360507,4,0,56,60,
Kay,Attorney General,Gentner Drummond,REP,360507,4,4,58,66,
Kay,Superintendent of Public Instruction,Joy Hofmeister,REP,360507,3,0,45,48,
Kay,Superintendent of Public Instruction,Linda Murphy,REP,360507,5,4,68,77,
Kay,Commissioner of Labor,Cathy Costello,REP,360507,5,1,48,54,
Kay,Commissioner of Labor,Leslie Osborn,REP,360507,3,3,65,71,
Kay,Corporation Commissioner,Bob Anthony,REP,360507,5,0,57,62,
Kay,Corporation Commissioner,Brian Bingman,REP,360507,3,4,56,63,
Kay,State Senate,Bill Coleman,REP,360507,4,4,87,95,10
Kay,State Senate,Amber Roberts,REP,360507,4,0,28,32,10
Kay,Governor,Chris Powell,LIB,360507,0,0,0,0,
Kay,Governor,Rex Lawhorn,LIB,360507,0,0,0,0,
Kay,Corporation Commissioner,Ashley Nicole Mccray,DEM,360507,0,0,16,16,
Kay,Corporation Commissioner,Blake Cummings,DEM,360507,0,0,10,10,
Kay,Governor,Mick Cornett,REP,360516,2,2,36,40,
Kay,Governor,Kevin Stitt,REP,360516,2,0,46,48,
Kay,Lieutenant Governor,Dana Murphy,REP,360516,2,1,33,36,
Kay,Lieutenant Governor,Matt Pinnell,REP,360516,2,1,47,50,
Kay,State Auditor,Cindy Byrd,REP,360516,2,2,39,43,
Kay,State Auditor,Charlie Prater,REP,360516,2,0,42,44,
Kay,Attorney General,Mike Hunter,REP,360516,2,0,39,41,
Kay,Attorney General,Gentner Drummond,REP,360516,2,2,42,46,
Kay,Superintendent of Public Instruction,Joy Hofmeister,REP,360516,0,2,39,41,
Kay,Superintendent of Public Instruction,Linda Murphy,REP,360516,4,0,42,46,
Kay,Commissioner of Labor,Cathy Costello,REP,360516,2,1,42,45,
Kay,Commissioner of Labor,Leslie Osborn,REP,360516,2,1,39,42,
Kay,Corporation Commissioner,Bob Anthony,REP,360516,1,0,36,37,
Kay,Corporation Commissioner,Brian Bingman,REP,360516,3,2,45,50,
Kay,State Senate,Bill Coleman,REP,360516,2,2,48,52,10
Kay,State Senate,Amber Roberts,REP,360516,2,0,34,36,10
Kay,Governor,Chris Powell,LIB,360516,0,0,0,0,
Kay,Governor,Rex Lawhorn,LIB,360516,0,0,0,0,
Kay,Corporation Commissioner,Ashley Nicole Mccray,DEM,360516,0,0,20,20,
Kay,Corporation Commissioner,Blake Cummings,DEM,360516,0,0,14,14,
Kay,Governor,Mick Cornett,REP,360517,0,2,51,53,
Kay,Governor,Kevin Stitt,REP,360517,0,6,52,58,
Kay,Lieutenant Governor,Dana Murphy,REP,360517,0,2,46,48,
Kay,Lieutenant Governor,Matt Pinnell,REP,360517,0,6,55,61,
Kay,State Auditor,Cindy Byrd,REP,360517,0,5,46,51,
Kay,State Auditor,Charlie Prater,REP,360517,0,3,54,57,
Kay,Attorney General,Mike Hunter,REP,360517,0,5,53,58,
Kay,Attorney General,Gentner Drummond,REP,360517,0,3,50,53,
Kay,Superintendent of Public Instruction,Joy Hofmeister,REP,360517,0,2,68,70,
Kay,Superintendent of Public Instruction,Linda Murphy,REP,360517,0,6,35,41,
Kay,Commissioner of Labor,Cathy Costello,REP,360517,0,3,48,51,
Kay,Commissioner of Labor,Leslie Osborn,REP,360517,0,5,52,57,
Kay,Corporation Commissioner,Bob Anthony,REP,360517,0,2,51,53,
Kay,Corporation Commissioner,Brian Bingman,REP,360517,0,6,50,56,
Kay,State Senate,Bill Coleman,REP,360517,0,5,73,78,10
Kay,State Senate,Amber Roberts,REP,360517,0,3,28,31,10
Kay,Governor,Chris Powell,LIB,360517,0,0,1,1,
Kay,Governor,Rex Lawhorn,LIB,360517,0,0,0,0,
Kay,Corporation Commissioner,Ashley Nicole Mccray,DEM,360517,2,0,28,30,
Kay,Corporation Commissioner,Blake Cummings,DEM,360517,0,1,29,30,
Kay,Governor,Mick Cornett,REP,360527,4,1,125,130,
Kay,Governor,Kevin Stitt,REP,360527,2,5,113,120,
Kay,Lieutenant Governor,Dana Murphy,REP,360527,5,4,104,113,
Kay,Lieutenant Governor,Matt Pinnell,REP,360527,1,2,129,132,
Kay,State Auditor,Cindy Byrd,REP,360527,6,4,105,115,
Kay,State Auditor,Charlie Prater,REP,360527,0,2,126,128,
Kay,Attorney General,Mike Hunter,REP,360527,4,1,128,133,
Kay,Attorney General,Gentner Drummond,REP,360527,2,5,107,114,
Kay,Superintendent of Public Instruction,Joy Hofmeister,REP,360527,3,1,142,146,
Kay,Superintendent of Public Instruction,Linda Murphy,REP,360527,3,5,91,99,
Kay,Commissioner of Labor,Cathy Costello,REP,360527,3,5,98,106,
Kay,Commissioner of Labor,Leslie Osborn,REP,360527,2,1,127,130,
Kay,Corporation Commissioner,Bob Anthony,REP,360527,4,3,115,122,
Kay,Corporation Commissioner,Brian Bingman,REP,360527,1,3,119,123,
Kay,State Senate,Bill Coleman,REP,360527,3,6,168,177,10
Kay,State Senate,Amber Roberts,REP,360527,3,0,69,72,10
Kay,Governor,Chris Powell,LIB,360527,0,0,0,0,
Kay,Governor,Rex Lawhorn,LIB,360527,0,0,0,0,
Kay,Corporation Commissioner,Ashley Nicole Mccray,DEM,360527,1,2,27,30,
Kay,Corporation Commissioner,Blake Cummings,DEM,360527,1,1,12,14,
Kay,Governor,Mick Cornett,REP,360530,2,2,90,94,
Kay,Governor,Kevin Stitt,REP,360530,2,3,80,85,
Kay,Lieutenant Governor,Dana Murphy,REP,360530,1,5,73,79,
Kay,Lieutenant Governor,Matt Pinnell,REP,360530,3,0,91,94,
Kay,State Auditor,Cindy Byrd,REP,360530,0,4,60,64,
Kay,State Auditor,Charlie Prater,REP,360530,4,1,100,105,
Kay,Attorney General,Mike Hunter,REP,360530,2,3,90,95,
Kay,Attorney General,Gentner Drummond,REP,360530,2,2,79,83,
Kay,Superintendent of Public Instruction,Joy Hofmeister,REP,360530,3,2,85,90,
Kay,Superintendent of Public Instruction,Linda Murphy,REP,360530,1,3,80,84,
Kay,Commissioner of Labor,Cathy Costello,REP,360530,1,4,66,71,
Kay,Commissioner of Labor,Leslie Osborn,REP,360530,3,1,97,101,
Kay,Corporation Commissioner,Bob Anthony,REP,360530,1,5,75,81,
Kay,Corporation Commissioner,Brian Bingman,REP,360530,3,0,92,95,
Kay,State Senate,Bill Coleman,REP,360530,4,3,124,131,10
Kay,State Senate,Amber Roberts,REP,360530,0,2,43,45,10
Kay,Governor,Chris Powell,LIB,360530,0,0,1,1,
Kay,Governor,Rex Lawhorn,LIB,360530,0,0,0,0,
Kay,Corporation Commissioner,Ashley Nicole Mccray,DEM,360530,0,0,24,24,
Kay,Corporation Commissioner,Blake Cummings,DEM,360530,0,0,16,16,
Kay,Governor,Mick Cornett,REP,360532,1,5,174,180,
Kay,Governor,Kevin Stitt,REP,360532,0,3,98,101,
Kay,Lieutenant Governor,Dana Murphy,REP,360532,1,3,127,131,
Kay,Lieutenant Governor,Matt Pinnell,REP,360532,0,5,140,145,
Kay,State Auditor,Cindy Byrd,REP,360532,1,4,114,119,
Kay,State Auditor,Charlie Prater,REP,360532,0,4,149,153,
Kay,Attorney General,Mike Hunter,REP,360532,1,5,149,155,
Kay,Attorney General,Gentner Drummond,REP,360532,0,3,119,122,
Kay,Superintendent of Public Instruction,Joy Hofmeister,REP,360532,0,6,166,172,
Kay,Superintendent of Public Instruction,Linda Murphy,REP,360532,1,2,101,104,
Kay,Commissioner of Labor,Cathy Costello,REP,360532,1,5,136,142,
Kay,Commissioner of Labor,Leslie Osborn,REP,360532,0,3,123,126,
Kay,Corporation Commissioner,Bob Anthony,REP,360532,1,5,151,157,
Kay,Corporation Commissioner,Brian Bingman,REP,360532,0,3,112,115,
Kay,State Senate,Bill Coleman,REP,360532,0,8,207,215,10
Kay,State Senate,Amber Roberts,REP,360532,1,0,63,64,10
Kay,Governor,Chris Powell,LIB,360532,0,0,0,0,
Kay,Governor,Rex Lawhorn,LIB,360532,0,0,0,0,
Kay,Corporation Commissioner,Ashley Nicole Mccray,DEM,360532,0,2,24,26,
Kay,Corporation Commissioner,Blake Cummings,DEM,360532,0,0,17,17,
Kay,Governor,Mick Cornett,REP,360533,1,2,111,114,
Kay,Governor,Kevin Stitt,REP,360533,1,1,91,93,
Kay,Lieutenant Governor,Dana Murphy,REP,360533,1,2,89,92,
Kay,Lieutenant Governor,Matt Pinnell,REP,360533,0,1,108,109,
Kay,State Auditor,Cindy Byrd,REP,360533,0,1,75,76,
Kay,State Auditor,Charlie Prater,REP,360533,1,2,115,118,
Kay,Attorney General,Mike Hunter,REP,360533,0,0,92,92,
Kay,Attorney General,Gentner Drummond,REP,360533,1,3,106,110,
Kay,Superintendent of Public Instruction,Joy Hofmeister,REP,360533,1,0,102,103,
Kay,Superintendent of Public Instruction,Linda Murphy,REP,360533,0,3,94,97,
Kay,Commissioner of Labor,Cathy Costello,REP,360533,1,0,79,80,
Kay,Commissioner of Labor,Leslie Osborn,REP,360533,1,3,108,112,
Kay,Corporation Commissioner,Bob Anthony,REP,360533,1,2,93,96,
Kay,Corporation Commissioner,Brian Bingman,REP,360533,1,1,100,102,
Kay,State Senate,Bill Coleman,REP,360533,1,2,146,149,10
Kay,State Senate,Amber Roberts,REP,360533,0,1,54,55,10
Kay,Governor,Chris Powell,LIB,360533,0,0,0,0,
Kay,Governor,Rex Lawhorn,LIB,360533,0,0,0,0,
Kay,Corporation Commissioner,Ashley Nicole Mccray,DEM,360533,1,0,18,19,
Kay,Corporation Commissioner,Blake Cummings,DEM,360533,0,0,17,17,
Kay,Governor,Mick Cornett,REP,360534,4,6,199,209,
Kay,Governor,Kevin Stitt,REP,360534,2,6,129,137,
Kay,Lieutenant Governor,Dana Murphy,REP,360534,5,6,150,161,
Kay,Lieutenant Governor,Matt Pinnell,REP,360534,0,6,178,184,
Kay,State Auditor,Cindy Byrd,REP,360534,3,7,131,141,
Kay,State Auditor,Charlie Prater,REP,360534,3,5,189,197,
Kay,Attorney General,Mike Hunter,REP,360534,0,4,175,179,
Kay,Attorney General,Gentner Drummond,REP,360534,6,8,151,165,
Kay,Superintendent of Public Instruction,Joy Hofmeister,REP,360534,5,8,207,220,
Kay,Superintendent of Public Instruction,Linda Murphy,REP,360534,1,4,119,124,
Kay,Commissioner of Labor,Cathy Costello,REP,360534,3,6,164,173,
Kay,Commissioner of Labor,Leslie Osborn,REP,360534,3,6,154,163,
Kay,Corporation Commissioner,Bob Anthony,REP,360534,4,3,181,188,
Kay,Corporation Commissioner,Brian Bingman,REP,360534,2,9,141,152,
Kay,State Senate,Bill Coleman,REP,360534,5,10,243,258,10
Kay,State Senate,Amber Roberts,REP,360534,1,2,84,87,10
Kay,Governor,Chris Powell,LIB,360534,0,0,0,0,
Kay,Governor,Rex Lawhorn,LIB,360534,0,0,1,1,
Kay,Corporation Commissioner,Ashley Nicole Mccray,DEM,360534,1,0,24,25,
Kay,Corporation Commissioner,Blake Cummings,DEM,360534,2,0,22,24,
Kay,Governor,Mick Cornett,REP,360535,5,9,217,231,
Kay,Governor,Kevin Stitt,REP,360535,2,3,120,125,
Kay,Lieutenant Governor,Dana Murphy,REP,360535,3,8,156,167,
Kay,Lieutenant Governor,Matt Pinnell,REP,360535,3,4,172,179,
Kay,State Auditor,Cindy Byrd,REP,360535,2,7,142,151,
Kay,State Auditor,Charlie Prater,REP,360535,1,5,179,185,
Kay,Attorney General,Mike Hunter,REP,360535,3,6,170,179,
Kay,Attorney General,Gentner Drummond,REP,360535,3,6,161,170,
Kay,Superintendent of Public Instruction,Joy Hofmeister,REP,360535,3,7,201,211,
Kay,Superintendent of Public Instruction,Linda Murphy,REP,360535,3,5,124,132,
Kay,Commissioner of Labor,Cathy Costello,REP,360535,4,2,153,159,
Kay,Commissioner of Labor,Leslie Osborn,REP,360535,2,10,168,180,
Kay,Corporation Commissioner,Bob Anthony,REP,360535,2,8,176,186,
Kay,Corporation Commissioner,Brian Bingman,REP,360535,3,4,148,155,
Kay,State Senate,Bill Coleman,REP,360535,4,10,256,270,10
Kay,State Senate,Amber Roberts,REP,360535,1,2,67,70,10
Kay,Governor,Chris Powell,LIB,360535,0,0,0,0,
Kay,Governor,Rex Lawhorn,LIB,360535,0,0,0,0,
Kay,Corporation Commissioner,Ashley Nicole Mccray,DEM,360535,1,1,28,30,
Kay,Corporation Commissioner,Blake Cummings,DEM,360535,0,0,19,19,
Kingfisher,Governor,Mick Cornett,REP,370101,6,16,206,228,
Kingfisher,Governor,Kevin Stitt,REP,370101,7,23,154,184,
Kingfisher,Lieutenant Governor,Dana Murphy,REP,370101,10,20,149,179,
Kingfisher,Lieutenant Governor,Matt Pinnell,REP,370101,3,19,203,225,
Kingfisher,State Auditor,Cindy Byrd,REP,370101,8,19,166,193,
Kingfisher,State Auditor,Charlie Prater,REP,370101,4,20,183,207,
Kingfisher,Attorney General,Mike Hunter,REP,370101,7,24,229,260,
Kingfisher,Attorney General,Gentner Drummond,REP,370101,5,15,123,143,
Kingfisher,Superintendent of Public Instruction,Joy Hofmeister,REP,370101,9,20,195,224,
Kingfisher,Superintendent of Public Instruction,Linda Murphy,REP,370101,3,19,159,181,
Kingfisher,Commissioner of Labor,Cathy Costello,REP,370101,7,25,192,224,
Kingfisher,Commissioner of Labor,Leslie Osborn,REP,370101,5,14,160,179,
Kingfisher,Corporation Commissioner,Bob Anthony,REP,370101,10,22,206,238,
Kingfisher,Corporation Commissioner,Brian Bingman,REP,370101,2,17,148,167,
Kingfisher,Governor,Chris Powell,LIB,370101,0,0,1,1,
Kingfisher,Governor,Rex Lawhorn,LIB,370101,0,0,0,0,
Kingfisher,Corporation Commissioner,Ashley Nicole Mccray,DEM,370101,7,5,27,39,
Kingfisher,Corporation Commissioner,Blake Cummings,DEM,370101,3,5,16,24,
Kingfisher,Governor,Mick Cornett,REP,370102,3,3,57,63,
Kingfisher,Governor,Kevin Stitt,REP,370102,1,3,38,42,
Kingfisher,Lieutenant Governor,Dana Murphy,REP,370102,0,4,37,41,
Kingfisher,Lieutenant Governor,Matt Pinnell,REP,370102,4,2,57,63,
Kingfisher,State Auditor,Cindy Byrd,REP,370102,2,2,33,37,
Kingfisher,State Auditor,Charlie Prater,REP,370102,2,3,57,62,
Kingfisher,Attorney General,Mike Hunter,REP,370102,2,2,45,49,
Kingfisher,Attorney General,Gentner Drummond,REP,370102,2,4,48,54,
Kingfisher,Superintendent of Public Instruction,Joy Hofmeister,REP,370102,0,5,55,60,
Kingfisher,Superintendent of Public Instruction,Linda Murphy,REP,370102,4,1,38,43,
Kingfisher,Commissioner of Labor,Cathy Costello,REP,370102,4,5,47,56,
Kingfisher,Commissioner of Labor,Leslie Osborn,REP,370102,0,1,46,47,
Kingfisher,Corporation Commissioner,Bob Anthony,REP,370102,2,4,46,52,
Kingfisher,Corporation Commissioner,Brian Bingman,REP,370102,2,2,46,50,
Kingfisher,Governor,Chris Powell,LIB,370102,0,0,0,0,
Kingfisher,Governor,Rex Lawhorn,LIB,370102,0,0,0,0,
Kingfisher,Corporation Commissioner,Ashley Nicole Mccray,DEM,370102,0,0,3,3,
Kingfisher,Corporation Commissioner,Blake Cummings,DEM,370102,0,0,4,4,
Kingfisher,Governor,Mick Cornett,REP,370103,1,7,49,57,
Kingfisher,Governor,Kevin Stitt,REP,370103,6,15,58,79,
Kingfisher,Lieutenant Governor,Dana Murphy,REP,370103,2,5,40,47,
Kingfisher,Lieutenant Governor,Matt Pinnell,REP,370103,5,16,64,85,
Kingfisher,State Auditor,Cindy Byrd,REP,370103,3,12,49,64,
Kingfisher,State Auditor,Charlie Prater,REP,370103,4,10,54,68,
Kingfisher,Attorney General,Mike Hunter,REP,370103,4,14,61,79,
Kingfisher,Attorney General,Gentner Drummond,REP,370103,3,8,45,56,
Kingfisher,Superintendent of Public Instruction,Joy Hofmeister,REP,370103,6,16,63,85,
Kingfisher,Superintendent of Public Instruction,Linda Murphy,REP,370103,1,6,41,48,
Kingfisher,Commissioner of Labor,Cathy Costello,REP,370103,4,9,47,60,
Kingfisher,Commissioner of Labor,Leslie Osborn,REP,370103,3,13,58,74,
Kingfisher,Corporation Commissioner,Bob Anthony,REP,370103,5,13,58,76,
Kingfisher,Corporation Commissioner,Brian Bingman,REP,370103,2,9,49,60,
Kingfisher,Governor,Chris Powell,LIB,370103,0,0,0,0,
Kingfisher,Governor,Rex Lawhorn,LIB,370103,0,0,0,0,
Kingfisher,Corporation Commissioner,Ashley Nicole Mccray,DEM,370103,0,4,4,8,
Kingfisher,Corporation Commissioner,Blake Cummings,DEM,370103,0,0,5,5,
Kingfisher,Governor,Mick Cornett,REP,370105,0,1,87,88,
Kingfisher,Governor,Kevin Stitt,REP,370105,4,3,101,108,
Kingfisher,Lieutenant Governor,Dana Murphy,REP,370105,1,2,83,86,
Kingfisher,Lieutenant Governor,Matt Pinnell,REP,370105,3,2,100,105,
Kingfisher,State Auditor,Cindy Byrd,REP,370105,2,0,87,89,
Kingfisher,State Auditor,Charlie Prater,REP,370105,2,4,92,98,
Kingfisher,Attorney General,Mike Hunter,REP,370105,2,3,94,99,
Kingfisher,Attorney General,Gentner Drummond,REP,370105,2,1,91,94,
Kingfisher,Superintendent of Public Instruction,Joy Hofmeister,REP,370105,3,3,97,103,
Kingfisher,Superintendent of Public Instruction,Linda Murphy,REP,370105,1,1,89,91,
Kingfisher,Commissioner of Labor,Cathy Costello,REP,370105,2,1,98,101,
Kingfisher,Commissioner of Labor,Leslie Osborn,REP,370105,2,3,85,90,
Kingfisher,Corporation Commissioner,Bob Anthony,REP,370105,3,4,105,112,
Kingfisher,Corporation Commissioner,Brian Bingman,REP,370105,1,0,79,80,
Kingfisher,State House,Roxanne Pollard,REP,370105,0,2,57,59,41
Kingfisher,State House,Denise Crosswhite Hader,REP,370105,4,2,122,128,41
Kingfisher,Governor,Chris Powell,LIB,370105,0,0,0,0,
Kingfisher,Governor,Rex Lawhorn,LIB,370105,0,0,0,0,
Kingfisher,Corporation Commissioner,Ashley Nicole Mccray,DEM,370105,0,0,10,10,
Kingfisher,Corporation Commissioner,Blake Cummings,DEM,370105,0,2,10,12,
Kingfisher,State House,Sara Peterson,DEM,370105,0,1,11,12,41
Kingfisher,State House,Jennie Scott,DEM,370105,0,1,9,10,41
Kingfisher,Governor,Mick Cornett,REP,370106,0,2,19,21,
Kingfisher,Governor,Kevin Stitt,REP,370106,0,3,15,18,
Kingfisher,Lieutenant Governor,Dana Murphy,REP,370106,0,1,15,16,
Kingfisher,Lieutenant Governor,Matt Pinnell,REP,370106,0,4,19,23,
Kingfisher,State Auditor,Cindy Byrd,REP,370106,0,2,16,18,
Kingfisher,State Auditor,Charlie Prater,REP,370106,0,3,18,21,
Kingfisher,Attorney General,Mike Hunter,REP,370106,0,2,19,21,
Kingfisher,Attorney General,Gentner Drummond,REP,370106,0,3,15,18,
Kingfisher,Superintendent of Public Instruction,Joy Hofmeister,REP,370106,0,0,17,17,
Kingfisher,Superintendent of Public Instruction,Linda Murphy,REP,370106,0,5,17,22,
Kingfisher,Commissioner of Labor,Cathy Costello,REP,370106,0,1,18,19,
Kingfisher,Commissioner of Labor,Leslie Osborn,REP,370106,0,4,16,20,
Kingfisher,Corporation Commissioner,Bob Anthony,REP,370106,0,0,16,16,
Kingfisher,Corporation Commissioner,Brian Bingman,REP,370106,0,5,18,23,
Kingfisher,State House,Roxanne Pollard,REP,370106,0,3,23,26,41
Kingfisher,State House,Denise Crosswhite Hader,REP,370106,0,2,11,13,41
Kingfisher,Governor,Chris Powell,LIB,370106,0,0,0,0,
Kingfisher,Governor,Rex Lawhorn,LIB,370106,0,0,0,0,
Kingfisher,Corporation Commissioner,Ashley Nicole Mccray,DEM,370106,1,0,0,1,
Kingfisher,Corporation Commissioner,Blake Cummings,DEM,370106,0,0,3,3,
Kingfisher,State House,Sara Peterson,DEM,370106,1,0,0,1,41
Kingfisher,State House,Jennie Scott,DEM,370106,0,0,3,3,41
Kingfisher,Governor,Mick Cornett,REP,370201,5,3,152,160,
Kingfisher,Governor,Kevin Stitt,REP,370201,10,5,218,233,
Kingfisher,Lieutenant Governor,Dana Murphy,REP,370201,6,4,174,184,
Kingfisher,Lieutenant Governor,Matt Pinnell,REP,370201,9,3,188,200,
Kingfisher,State Auditor,Cindy Byrd,REP,370201,6,3,159,168,
Kingfisher,State Auditor,Charlie Prater,REP,370201,8,3,195,206,
Kingfisher,Attorney General,Mike Hunter,REP,370201,9,5,223,237,
Kingfisher,Attorney General,Gentner Drummond,REP,370201,5,3,138,146,
Kingfisher,Superintendent of Public Instruction,Joy Hofmeister,REP,370201,6,3,207,216,
Kingfisher,Superintendent of Public Instruction,Linda Murphy,REP,370201,9,5,154,168,
Kingfisher,Commissioner of Labor,Cathy Costello,REP,370201,5,1,145,151,
Kingfisher,Commissioner of Labor,Leslie Osborn,REP,370201,8,6,209,223,
Kingfisher,Corporation Commissioner,Bob Anthony,REP,370201,11,8,176,195,
Kingfisher,Corporation Commissioner,Brian Bingman,REP,370201,3,0,182,185,
Kingfisher,Governor,Chris Powell,LIB,370201,0,0,1,1,
Kingfisher,Governor,Rex Lawhorn,LIB,370201,0,0,0,0,
Kingfisher,Corporation Commissioner,Ashley Nicole Mccray,DEM,370201,0,0,32,32,
Kingfisher,Corporation Commissioner,Blake Cummings,DEM,370201,6,0,27,33,
Kingfisher,Governor,Mick Cornett,REP,370203,5,4,12,21,
Kingfisher,Governor,Kevin Stitt,REP,370203,9,1,28,38,
Kingfisher,Lieutenant Governor,Dana Murphy,REP,370203,11,3,18,32,
Kingfisher,Lieutenant Governor,Matt Pinnell,REP,370203,2,2,22,26,
Kingfisher,State Auditor,Cindy Byrd,REP,370203,9,2,13,24,
Kingfisher,State Auditor,Charlie Prater,REP,370203,4,3,27,34,
Kingfisher,Attorney General,Mike Hunter,REP,370203,5,2,19,26,
Kingfisher,Attorney General,Gentner Drummond,REP,370203,9,3,21,33,
Kingfisher,Superintendent of Public Instruction,Joy Hofmeister,REP,370203,7,3,23,33,
Kingfisher,Superintendent of Public Instruction,Linda Murphy,REP,370203,7,2,16,25,
Kingfisher,Commissioner of Labor,Cathy Costello,REP,370203,3,0,18,21,
Kingfisher,Commissioner of Labor,Leslie Osborn,REP,370203,11,5,21,37,
Kingfisher,Corporation Commissioner,Bob Anthony,REP,370203,5,4,21,30,
Kingfisher,Corporation Commissioner,Brian Bingman,REP,370203,9,1,19,29,
Kingfisher,State House,Roxanne Pollard,REP,370203,12,3,31,46,41
Kingfisher,State House,Denise Crosswhite Hader,REP,370203,2,2,9,13,41
Kingfisher,Governor,Chris Powell,LIB,370203,0,0,0,0,
Kingfisher,Governor,Rex Lawhorn,LIB,370203,0,0,0,0,
Kingfisher,Corporation Commissioner,Ashley Nicole Mccray,DEM,370203,0,1,4,5,
Kingfisher,Corporation Commissioner,Blake Cummings,DEM,370203,1,0,1,2,
Kingfisher,State House,Sara Peterson,DEM,370203,0,1,3,4,41
Kingfisher,State House,Jennie Scott,DEM,370203,1,0,2,3,41
Kingfisher,Governor,Mick Cornett,REP,370204,0,3,34,37,
Kingfisher,Governor,Kevin Stitt,REP,370204,2,6,47,55,
Kingfisher,Lieutenant Governor,Dana Murphy,REP,370204,0,3,36,39,
Kingfisher,Lieutenant Governor,Matt Pinnell,REP,370204,2,5,44,51,
Kingfisher,State Auditor,Cindy Byrd,REP,370204,0,5,24,29,
Kingfisher,State Auditor,Charlie Prater,REP,370204,2,4,55,61,
Kingfisher,Attorney General,Mike Hunter,REP,370204,0,5,36,41,
Kingfisher,Attorney General,Gentner Drummond,REP,370204,2,4,43,49,
Kingfisher,Superintendent of Public Instruction,Joy Hofmeister,REP,370204,0,4,35,39,
Kingfisher,Superintendent of Public Instruction,Linda Murphy,REP,370204,2,5,46,53,
Kingfisher,Commissioner of Labor,Cathy Costello,REP,370204,0,3,22,25,
Kingfisher,Commissioner of Labor,Leslie Osborn,REP,370204,2,6,58,66,
Kingfisher,Corporation Commissioner,Bob Anthony,REP,370204,0,5,36,41,
Kingfisher,Corporation Commissioner,Brian Bingman,REP,370204,2,4,44,50,
Kingfisher,Governor,Chris Powell,LIB,370204,0,0,0,0,
Kingfisher,Governor,Rex Lawhorn,LIB,370204,0,0,0,0,
Kingfisher,Corporation Commissioner,Ashley Nicole Mccray,DEM,370204,0,0,15,15,
Kingfisher,Corporation Commissioner,Blake Cummings,DEM,370204,0,1,10,11,
Kingfisher,Governor,Mick Cornett,REP,370301,2,20,191,213,
Kingfisher,Governor,Kevin Stitt,REP,370301,4,24,178,206,
Kingfisher,Lieutenant Governor,Dana Murphy,REP,370301,2,13,161,176,
Kingfisher,Lieutenant Governor,Matt Pinnell,REP,370301,5,30,203,238,
Kingfisher,State Auditor,Cindy Byrd,REP,370301,3,19,166,188,
Kingfisher,State Auditor,Charlie Prater,REP,370301,3,24,191,218,
Kingfisher,Attorney General,Mike Hunter,REP,370301,4,27,224,255,
Kingfisher,Attorney General,Gentner Drummond,REP,370301,2,16,136,154,
Kingfisher,Superintendent of Public Instruction,Joy Hofmeister,REP,370301,2,22,214,238,
Kingfisher,Superintendent of Public Instruction,Linda Murphy,REP,370301,5,21,147,173,
Kingfisher,Commissioner of Labor,Cathy Costello,REP,370301,4,13,177,194,
Kingfisher,Commissioner of Labor,Leslie Osborn,REP,370301,3,31,184,218,
Kingfisher,Corporation Commissioner,Bob Anthony,REP,370301,6,28,205,239,
Kingfisher,Corporation Commissioner,Brian Bingman,REP,370301,1,16,155,172,
Kingfisher,Governor,Chris Powell,LIB,370301,0,0,0,0,
Kingfisher,Governor,Rex Lawhorn,LIB,370301,0,0,0,0,
Kingfisher,Corporation Commissioner,Ashley Nicole Mccray,DEM,370301,0,10,21,31,
Kingfisher,Corporation Commissioner,Blake Cummings,DEM,370301,0,3,18,21,
Kingfisher,Governor,Mick Cornett,REP,370302,3,2,96,101,
Kingfisher,Governor,Kevin Stitt,REP,370302,0,2,65,67,
Kingfisher,Lieutenant Governor,Dana Murphy,REP,370302,3,2,77,82,
Kingfisher,Lieutenant Governor,Matt Pinnell,REP,370302,0,1,82,83,
Kingfisher,State Auditor,Cindy Byrd,REP,370302,1,2,68,71,
Kingfisher,State Auditor,Charlie Prater,REP,370302,2,1,89,92,
Kingfisher,Attorney General,Mike Hunter,REP,370302,3,2,88,93,
Kingfisher,Attorney General,Gentner Drummond,REP,370302,0,1,70,71,
Kingfisher,Superintendent of Public Instruction,Joy Hofmeister,REP,370302,1,1,97,99,
Kingfisher,Superintendent of Public Instruction,Linda Murphy,REP,370302,2,3,61,66,
Kingfisher,Commissioner of Labor,Cathy Costello,REP,370302,0,1,66,67,
Kingfisher,Commissioner of Labor,Leslie Osborn,REP,370302,3,2,90,95,
Kingfisher,Corporation Commissioner,Bob Anthony,REP,370302,1,4,88,93,
Kingfisher,Corporation Commissioner,Brian Bingman,REP,370302,2,0,70,72,
Kingfisher,Governor,Chris Powell,LIB,370302,0,0,0,0,
Kingfisher,Governor,Rex Lawhorn,LIB,370302,0,0,0,0,
Kingfisher,Corporation Commissioner,Ashley Nicole Mccray,DEM,370302,0,0,10,10,
Kingfisher,Corporation Commissioner,Blake Cummings,DEM,370302,1,0,9,10,
Kingfisher,Governor,Mick Cornett,REP,370303,0,3,19,22,
Kingfisher,Governor,Kevin Stitt,REP,370303,1,8,35,44,
Kingfisher,Lieutenant Governor,Dana Murphy,REP,370303,0,4,24,28,
Kingfisher,Lieutenant Governor,Matt Pinnell,REP,370303,1,7,30,38,
Kingfisher,State Auditor,Cindy Byrd,REP,370303,0,4,26,30,
Kingfisher,State Auditor,Charlie Prater,REP,370303,1,7,26,34,
Kingfisher,Attorney General,Mike Hunter,REP,370303,0,5,23,28,
Kingfisher,Attorney General,Gentner Drummond,REP,370303,1,6,31,38,
Kingfisher,Superintendent of Public Instruction,Joy Hofmeister,REP,370303,0,4,26,30,
Kingfisher,Superintendent of Public Instruction,Linda Murphy,REP,370303,1,7,27,35,
Kingfisher,Commissioner of Labor,Cathy Costello,REP,370303,1,8,26,35,
Kingfisher,Commissioner of Labor,Leslie Osborn,REP,370303,0,3,27,30,
Kingfisher,Corporation Commissioner,Bob Anthony,REP,370303,1,5,30,36,
Kingfisher,Corporation Commissioner,Brian Bingman,REP,370303,0,6,24,30,
Kingfisher,Governor,Chris Powell,LIB,370303,0,0,0,0,
Kingfisher,Governor,Rex Lawhorn,LIB,370303,0,0,0,0,
Kingfisher,Corporation Commissioner,Ashley Nicole Mccray,DEM,370303,0,0,0,0,
Kingfisher,Corporation Commissioner,Blake Cummings,DEM,370303,0,0,3,3,
Kingfisher,Governor,Mick Cornett,REP,370304,0,2,31,33,
Kingfisher,Governor,Kevin Stitt,REP,370304,1,4,41,46,
Kingfisher,Lieutenant Governor,Dana Murphy,REP,370304,0,2,36,38,
Kingfisher,Lieutenant Governor,Matt Pinnell,REP,370304,1,4,36,41,
Kingfisher,State Auditor,Cindy Byrd,REP,370304,0,2,24,26,
Kingfisher,State Auditor,Charlie Prater,REP,370304,1,4,47,52,
Kingfisher,Attorney General,Mike Hunter,REP,370304,1,1,41,43,
Kingfisher,Attorney General,Gentner Drummond,REP,370304,0,5,30,35,
Kingfisher,Superintendent of Public Instruction,Joy Hofmeister,REP,370304,0,2,49,51,
Kingfisher,Superintendent of Public Instruction,Linda Murphy,REP,370304,0,4,22,26,
Kingfisher,Commissioner of Labor,Cathy Costello,REP,370304,0,3,27,30,
Kingfisher,Commissioner of Labor,Leslie Osborn,REP,370304,1,3,43,47,
Kingfisher,Corporation Commissioner,Bob Anthony,REP,370304,0,1,38,39,
Kingfisher,Corporation Commissioner,Brian Bingman,REP,370304,1,5,32,38,
Kingfisher,Governor,Chris Powell,LIB,370304,0,0,0,0,
Kingfisher,Governor,Rex Lawhorn,LIB,370304,0,0,0,0,
Kingfisher,Corporation Commissioner,Ashley Nicole Mccray,DEM,370304,0,0,1,1,
Kingfisher,Corporation Commissioner,Blake Cummings,DEM,370304,0,0,1,1,
Kingfisher,Governor,Mick Cornett,REP,370305,0,8,28,36,
Kingfisher,Governor,Kevin Stitt,REP,370305,0,9,41,50,
Kingfisher,Lieutenant Governor,Dana Murphy,REP,370305,0,7,23,30,
Kingfisher,Lieutenant Governor,Matt Pinnell,REP,370305,0,10,45,55,
Kingfisher,State Auditor,Cindy Byrd,REP,370305,0,6,22,28,
Kingfisher,State Auditor,Charlie Prater,REP,370305,0,11,46,57,
Kingfisher,Attorney General,Mike Hunter,REP,370305,0,5,41,46,
Kingfisher,Attorney General,Gentner Drummond,REP,370305,0,12,27,39,
Kingfisher,Superintendent of Public Instruction,Joy Hofmeister,REP,370305,0,14,34,48,
Kingfisher,Superintendent of Public Instruction,Linda Murphy,REP,370305,0,3,35,38,
Kingfisher,Commissioner of Labor,Cathy Costello,REP,370305,0,7,30,37,
Kingfisher,Commissioner of Labor,Leslie Osborn,REP,370305,0,10,37,47,
Kingfisher,Corporation Commissioner,Bob Anthony,REP,370305,0,10,35,45,
Kingfisher,Corporation Commissioner,Brian Bingman,REP,370305,0,7,33,40,
Kingfisher,Governor,Chris Powell,LIB,370305,0,0,0,0,
Kingfisher,Governor,Rex Lawhorn,LIB,370305,0,0,0,0,
Kingfisher,Corporation Commissioner,Ashley Nicole Mccray,DEM,370305,0,0,3,3,
Kingfisher,Corporation Commissioner,Blake Cummings,DEM,370305,0,0,4,4,
Kingfisher,Governor,Mick Cornett,REP,370306,0,0,3,3,
Kingfisher,Governor,Kevin Stitt,REP,370306,0,0,4,4,
Kingfisher,Lieutenant Governor,Dana Murphy,REP,370306,0,0,0,0,
Kingfisher,Lieutenant Governor,Matt Pinnell,REP,370306,0,0,6,6,
Kingfisher,State Auditor,Cindy Byrd,REP,370306,0,0,5,5,
Kingfisher,State Auditor,Charlie Prater,REP,370306,0,0,2,2,
Kingfisher,Attorney General,Mike Hunter,REP,370306,0,0,1,1,
Kingfisher,Attorney General,Gentner Drummond,REP,370306,0,0,6,6,
Kingfisher,Superintendent of Public Instruction,Joy Hofmeister,REP,370306,0,0,2,2,
Kingfisher,Superintendent of Public Instruction,Linda Murphy,REP,370306,0,0,5,5,
Kingfisher,Commissioner of Labor,Cathy Costello,REP,370306,0,0,4,4,
Kingfisher,Commissioner of Labor,Leslie Osborn,REP,370306,0,0,2,2,
Kingfisher,Corporation Commissioner,Bob Anthony,REP,370306,0,0,1,1,
Kingfisher,Corporation Commissioner,Brian Bingman,REP,370306,0,0,6,6,
Kingfisher,Governor,Chris Powell,LIB,370306,0,0,0,0,
Kingfisher,Governor,Rex Lawhorn,LIB,370306,0,0,0,0,
Kingfisher,Corporation Commissioner,Ashley Nicole Mccray,DEM,370306,0,0,0,0,
Kingfisher,Corporation Commissioner,Blake Cummings,DEM,370306,0,0,2,2,
Kiowa,Governor,Mick Cornett,REP,380001,0,10,60,70,
Kiowa,Governor,Kevin Stitt,REP,380001,4,5,63,72,
Kiowa,Lieutenant Governor,Dana Murphy,REP,380001,1,8,48,57,
Kiowa,Lieutenant Governor,Matt Pinnell,REP,380001,3,6,73,82,
Kiowa,State Auditor,Cindy Byrd,REP,380001,0,10,44,54,
Kiowa,State Auditor,Charlie Prater,REP,380001,4,5,78,87,
Kiowa,Attorney General,Mike Hunter,REP,380001,1,6,72,79,
Kiowa,Attorney General,Gentner Drummond,REP,380001,3,9,50,62,
Kiowa,Superintendent of Public Instruction,Joy Hofmeister,REP,380001,2,11,83,96,
Kiowa,Superintendent of Public Instruction,Linda Murphy,REP,380001,2,4,39,45,
Kiowa,Commissioner of Labor,Cathy Costello,REP,380001,2,6,50,58,
Kiowa,Commissioner of Labor,Leslie Osborn,REP,380001,2,9,67,78,
Kiowa,Corporation Commissioner,Bob Anthony,REP,380001,2,7,59,68,
Kiowa,Corporation Commissioner,Brian Bingman,REP,380001,2,8,60,70,
Kiowa,Governor,Chris Powell,LIB,380001,0,0,0,0,
Kiowa,Governor,Rex Lawhorn,LIB,380001,0,0,1,1,
Kiowa,Corporation Commissioner,Ashley Nicole Mccray,DEM,380001,2,0,17,19,
Kiowa,Corporation Commissioner,Blake Cummings,DEM,380001,4,2,14,20,
Kiowa,Governor,Mick Cornett,REP,380002,0,0,17,17,
Kiowa,Governor,Kevin Stitt,REP,380002,0,0,12,12,
Kiowa,Lieutenant Governor,Dana Murphy,REP,380002,0,0,12,12,
Kiowa,Lieutenant Governor,Matt Pinnell,REP,380002,0,0,16,16,
Kiowa,State Auditor,Cindy Byrd,REP,380002,0,0,11,11,
Kiowa,State Auditor,Charlie Prater,REP,380002,0,0,17,17,
Kiowa,Attorney General,Mike Hunter,REP,380002,0,0,7,7,
Kiowa,Attorney General,Gentner Drummond,REP,380002,0,0,22,22,
Kiowa,Superintendent of Public Instruction,Joy Hofmeister,REP,380002,0,0,23,23,
Kiowa,Superintendent of Public Instruction,Linda Murphy,REP,380002,0,0,6,6,
Kiowa,Commissioner of Labor,Cathy Costello,REP,380002,0,0,9,9,
Kiowa,Commissioner of Labor,Leslie Osborn,REP,380002,0,0,19,19,
Kiowa,Corporation Commissioner,Bob Anthony,REP,380002,0,0,11,11,
Kiowa,Corporation Commissioner,Brian Bingman,REP,380002,0,0,16,16,
Kiowa,Governor,Chris Powell,LIB,380002,0,0,0,0,
Kiowa,Governor,Rex Lawhorn,LIB,380002,0,0,0,0,
Kiowa,Corporation Commissioner,Ashley Nicole Mccray,DEM,380002,1,1,1,3,
Kiowa,Corporation Commissioner,Blake Cummings,DEM,380002,0,1,1,2,
Kiowa,Governor,Mick Cornett,REP,380004,0,5,32,37,
Kiowa,Governor,Kevin Stitt,REP,380004,1,3,33,37,
Kiowa,Lieutenant Governor,Dana Murphy,REP,380004,0,3,22,25,
Kiowa,Lieutenant Governor,Matt Pinnell,REP,380004,0,5,41,46,
Kiowa,State Auditor,Cindy Byrd,REP,380004,0,4,26,30,
Kiowa,State Auditor,Charlie Prater,REP,380004,0,4,38,42,
Kiowa,Attorney General,Mike Hunter,REP,380004,0,4,35,39,
Kiowa,Attorney General,Gentner Drummond,REP,380004,0,4,29,33,
Kiowa,Superintendent of Public Instruction,Joy Hofmeister,REP,380004,1,4,46,51,
Kiowa,Superintendent of Public Instruction,Linda Murphy,REP,380004,0,4,18,22,
Kiowa,Commissioner of Labor,Cathy Costello,REP,380004,0,4,33,37,
Kiowa,Commissioner of Labor,Leslie Osborn,REP,380004,0,4,30,34,
Kiowa,Corporation Commissioner,Bob Anthony,REP,380004,1,5,36,42,
Kiowa,Corporation Commissioner,Brian Bingman,REP,380004,0,3,28,31,
Kiowa,Governor,Chris Powell,LIB,380004,0,0,0,0,
Kiowa,Governor,Rex Lawhorn,LIB,380004,0,0,0,0,
Kiowa,Corporation Commissioner,Ashley Nicole Mccray,DEM,380004,1,4,10,15,
Kiowa,Corporation Commissioner,Blake Cummings,DEM,380004,1,2,15,18,
Kiowa,Governor,Mick Cornett,REP,380005,0,1,0,1,
Kiowa,Governor,Kevin Stitt,REP,380005,0,0,4,4,
Kiowa,Lieutenant Governor,Dana Murphy,REP,380005,0,0,3,3,
Kiowa,Lieutenant Governor,Matt Pinnell,REP,380005,0,1,1,2,
Kiowa,State Auditor,Cindy Byrd,REP,380005,0,1,3,4,
Kiowa,State Auditor,Charlie Prater,REP,380005,0,0,1,1,
Kiowa,Attorney General,Mike Hunter,REP,380005,0,1,3,4,
Kiowa,Attorney General,Gentner Drummond,REP,380005,0,0,1,1,
Kiowa,Superintendent of Public Instruction,Joy Hofmeister,REP,380005,0,1,2,3,
Kiowa,Superintendent of Public Instruction,Linda Murphy,REP,380005,0,0,2,2,
Kiowa,Commissioner of Labor,Cathy Costello,REP,380005,0,1,2,3,
Kiowa,Commissioner of Labor,Leslie Osborn,REP,380005,0,0,2,2,
Kiowa,Corporation Commissioner,Bob Anthony,REP,380005,0,0,0,0,
Kiowa,Corporation Commissioner,Brian Bingman,REP,380005,0,1,4,5,
Kiowa,Governor,Chris Powell,LIB,380005,0,0,0,0,
Kiowa,Governor,Rex Lawhorn,LIB,380005,0,0,0,0,
Kiowa,Corporation Commissioner,Ashley Nicole Mccray,DEM,380005,0,1,0,1,
Kiowa,Corporation Commissioner,Blake Cummings,DEM,380005,0,0,1,1,
Kiowa,Governor,Mick Cornett,REP,380006,0,1,8,9,
Kiowa,Governor,Kevin Stitt,REP,380006,3,1,15,19,
Kiowa,Lieutenant Governor,Dana Murphy,REP,380006,0,2,12,14,
Kiowa,Lieutenant Governor,Matt Pinnell,REP,380006,3,0,10,13,
Kiowa,State Auditor,Cindy Byrd,REP,380006,2,1,8,11,
Kiowa,State Auditor,Charlie Prater,REP,380006,1,1,13,15,
Kiowa,Attorney General,Mike Hunter,REP,380006,2,1,5,8,
Kiowa,Attorney General,Gentner Drummond,REP,380006,1,1,16,18,
Kiowa,Superintendent of Public Instruction,Joy Hofmeister,REP,380006,2,2,11,15,
Kiowa,Superintendent of Public Instruction,Linda Murphy,REP,380006,1,0,11,12,
Kiowa,Commissioner of Labor,Cathy Costello,REP,380006,3,1,11,15,
Kiowa,Commissioner of Labor,Leslie Osborn,REP,380006,0,1,11,12,
Kiowa,Corporation Commissioner,Bob Anthony,REP,380006,0,1,9,10,
Kiowa,Corporation Commissioner,Brian Bingman,REP,380006,3,1,13,17,
Kiowa,Governor,Chris Powell,LIB,380006,0,0,0,0,
Kiowa,Governor,Rex Lawhorn,LIB,380006,0,0,0,0,
Kiowa,Corporation Commissioner,Ashley Nicole Mccray,DEM,380006,2,0,9,11,
Kiowa,Corporation Commissioner,Blake Cummings,DEM,380006,0,0,9,9,
Kiowa,Governor,Mick Cornett,REP,380007,0,0,1,1,
Kiowa,Governor,Kevin Stitt,REP,380007,0,0,3,3,
Kiowa,Lieutenant Governor,Dana Murphy,REP,380007,0,0,3,3,
Kiowa,Lieutenant Governor,Matt Pinnell,REP,380007,0,0,1,1,
Kiowa,State Auditor,Cindy Byrd,REP,380007,0,0,4,4,
Kiowa,State Auditor,Charlie Prater,REP,380007,0,0,0,0,
Kiowa,Attorney General,Mike Hunter,REP,380007,0,0,1,1,
Kiowa,Attorney General,Gentner Drummond,REP,380007,0,0,3,3,
Kiowa,Superintendent of Public Instruction,Joy Hofmeister,REP,380007,0,0,3,3,
Kiowa,Superintendent of Public Instruction,Linda Murphy,REP,380007,0,0,1,1,
Kiowa,Commissioner of Labor,Cathy Costello,REP,380007,0,0,1,1,
Kiowa,Commissioner of Labor,Leslie Osborn,REP,380007,0,0,3,3,
Kiowa,Corporation Commissioner,Bob Anthony,REP,380007,0,0,3,3,
Kiowa,Corporation Commissioner,Brian Bingman,REP,380007,0,0,1,1,
Kiowa,Governor,Chris Powell,LIB,380007,0,0,0,0,
Kiowa,Governor,Rex Lawhorn,LIB,380007,0,0,0,0,
Kiowa,Corporation Commissioner,Ashley Nicole Mccray,DEM,380007,0,0,0,0,
Kiowa,Corporation Commissioner,Blake Cummings,DEM,380007,0,0,1,1,
Kiowa,Governor,Mick Cornett,REP,380008,1,0,15,16,
Kiowa,Governor,Kevin Stitt,REP,380008,0,2,27,29,
Kiowa,Lieutenant Governor,Dana Murphy,REP,380008,0,0,17,17,
Kiowa,Lieutenant Governor,Matt Pinnell,REP,380008,1,2,22,25,
Kiowa,State Auditor,Cindy Byrd,REP,380008,0,1,17,18,
Kiowa,State Auditor,Charlie Prater,REP,380008,1,1,20,22,
Kiowa,Attorney General,Mike Hunter,REP,380008,1,1,20,22,
Kiowa,Attorney General,Gentner Drummond,REP,380008,0,1,21,22,
Kiowa,Superintendent of Public Instruction,Joy Hofmeister,REP,380008,0,2,29,31,
Kiowa,Superintendent of Public Instruction,Linda Murphy,REP,380008,1,0,12,13,
Kiowa,Commissioner of Labor,Cathy Costello,REP,380008,1,1,18,20,
Kiowa,Commissioner of Labor,Leslie Osborn,REP,380008,0,1,20,21,
Kiowa,Corporation Commissioner,Bob Anthony,REP,380008,0,0,12,12,
Kiowa,Corporation Commissioner,Brian Bingman,REP,380008,1,2,26,29,
Kiowa,Governor,Chris Powell,LIB,380008,0,0,0,0,
Kiowa,Governor,Rex Lawhorn,LIB,380008,0,0,0,0,
Kiowa,Corporation Commissioner,Ashley Nicole Mccray,DEM,380008,0,0,4,4,
Kiowa,Corporation Commissioner,Blake Cummings,DEM,380008,1,0,7,8,
Kiowa,Governor,Mick Cornett,REP,380009,0,0,1,1,
Kiowa,Governor,Kevin Stitt,REP,380009,0,0,4,4,
Kiowa,Lieutenant Governor,Dana Murphy,REP,380009,0,0,2,2,
Kiowa,Lieutenant Governor,Matt Pinnell,REP,380009,0,0,3,3,
Kiowa,State Auditor,Cindy Byrd,REP,380009,0,0,2,2,
Kiowa,State Auditor,Charlie Prater,REP,380009,0,0,2,2,
Kiowa,Attorney General,Mike Hunter,REP,380009,0,0,3,3,
Kiowa,Attorney General,Gentner Drummond,REP,380009,0,0,2,2,
Kiowa,Superintendent of Public Instruction,Joy Hofmeister,REP,380009,0,0,3,3,
Kiowa,Superintendent of Public Instruction,Linda Murphy,REP,380009,0,0,2,2,
Kiowa,Commissioner of Labor,Cathy Costello,REP,380009,0,0,2,2,
Kiowa,Commissioner of Labor,Leslie Osborn,REP,380009,0,0,3,3,
Kiowa,Corporation Commissioner,Bob Anthony,REP,380009,0,0,1,1,
Kiowa,Corporation Commissioner,Brian Bingman,REP,380009,0,0,4,4,
Kiowa,Governor,Chris Powell,LIB,380009,0,0,0,0,
Kiowa,Governor,Rex Lawhorn,LIB,380009,0,0,0,0,
Kiowa,Corporation Commissioner,Ashley Nicole Mccray,DEM,380009,0,0,0,0,
Kiowa,Corporation Commissioner,Blake Cummings,DEM,380009,0,0,1,1,
Kiowa,Governor,Mick Cornett,REP,380010,1,0,30,31,
Kiowa,Governor,Kevin Stitt,REP,380010,2,0,48,50,
Kiowa,Lieutenant Governor,Dana Murphy,REP,380010,1,0,37,38,
Kiowa,Lieutenant Governor,Matt Pinnell,REP,380010,2,0,40,42,
Kiowa,State Auditor,Cindy Byrd,REP,380010,1,0,33,34,
Kiowa,State Auditor,Charlie Prater,REP,380010,2,0,45,47,
Kiowa,Attorney General,Mike Hunter,REP,380010,1,0,28,29,
Kiowa,Attorney General,Gentner Drummond,REP,380010,2,0,50,52,
Kiowa,Superintendent of Public Instruction,Joy Hofmeister,REP,380010,2,0,33,35,
Kiowa,Superintendent of Public Instruction,Linda Murphy,REP,380010,1,0,46,47,
Kiowa,Commissioner of Labor,Cathy Costello,REP,380010,0,0,36,36,
Kiowa,Commissioner of Labor,Leslie Osborn,REP,380010,3,0,43,46,
Kiowa,Corporation Commissioner,Bob Anthony,REP,380010,1,0,39,40,
Kiowa,Corporation Commissioner,Brian Bingman,REP,380010,2,0,40,42,
Kiowa,Governor,Chris Powell,LIB,380010,0,0,0,0,
Kiowa,Governor,Rex Lawhorn,LIB,380010,0,0,0,0,
Kiowa,Corporation Commissioner,Ashley Nicole Mccray,DEM,380010,1,2,21,24,
Kiowa,Corporation Commissioner,Blake Cummings,DEM,380010,0,0,14,14,
Kiowa,Governor,Mick Cornett,REP,380011,0,0,6,6,
Kiowa,Governor,Kevin Stitt,REP,380011,0,2,13,15,
Kiowa,Lieutenant Governor,Dana Murphy,REP,380011,0,1,9,10,
Kiowa,Lieutenant Governor,Matt Pinnell,REP,380011,0,1,9,10,
Kiowa,State Auditor,Cindy Byrd,REP,380011,0,0,8,8,
Kiowa,State Auditor,Charlie Prater,REP,380011,0,2,10,12,
Kiowa,Attorney General,Mike Hunter,REP,380011,0,2,5,7,
Kiowa,Attorney General,Gentner Drummond,REP,380011,0,0,13,13,
Kiowa,Superintendent of Public Instruction,Joy Hofmeister,REP,380011,0,1,11,12,
Kiowa,Superintendent of Public Instruction,Linda Murphy,REP,380011,0,1,7,8,
Kiowa,Commissioner of Labor,Cathy Costello,REP,380011,0,2,7,9,
Kiowa,Commissioner of Labor,Leslie Osborn,REP,380011,0,0,11,11,
Kiowa,Corporation Commissioner,Bob Anthony,REP,380011,0,0,9,9,
Kiowa,Corporation Commissioner,Brian Bingman,REP,380011,0,2,9,11,
Kiowa,Governor,Chris Powell,LIB,380011,0,0,0,0,
Kiowa,Governor,Rex Lawhorn,LIB,380011,0,0,0,0,
Kiowa,Corporation Commissioner,Ashley Nicole Mccray,DEM,380011,0,0,4,4,
Kiowa,Corporation Commissioner,Blake Cummings,DEM,380011,2,0,3,5,
Kiowa,Governor,Mick Cornett,REP,380014,0,2,26,28,
Kiowa,Governor,Kevin Stitt,REP,380014,0,0,27,27,
Kiowa,Lieutenant Governor,Dana Murphy,REP,380014,0,0,21,21,
Kiowa,Lieutenant Governor,Matt Pinnell,REP,380014,0,2,32,34,
Kiowa,State Auditor,Cindy Byrd,REP,380014,0,2,24,26,
Kiowa,State Auditor,Charlie Prater,REP,380014,0,0,29,29,
Kiowa,Attorney General,Mike Hunter,REP,380014,0,2,26,28,
Kiowa,Attorney General,Gentner Drummond,REP,380014,0,0,27,27,
Kiowa,Superintendent of Public Instruction,Joy Hofmeister,REP,380014,0,2,40,42,
Kiowa,Superintendent of Public Instruction,Linda Murphy,REP,380014,0,0,12,12,
Kiowa,Commissioner of Labor,Cathy Costello,REP,380014,0,2,22,24,
Kiowa,Commissioner of Labor,Leslie Osborn,REP,380014,0,0,31,31,
Kiowa,Corporation Commissioner,Bob Anthony,REP,380014,0,2,22,24,
Kiowa,Corporation Commissioner,Brian Bingman,REP,380014,0,0,31,31,
Kiowa,Governor,Chris Powell,LIB,380014,0,0,0,0,
Kiowa,Governor,Rex Lawhorn,LIB,380014,0,0,0,0,
Kiowa,Corporation Commissioner,Ashley Nicole Mccray,DEM,380014,1,0,12,13,
Kiowa,Corporation Commissioner,Blake Cummings,DEM,380014,1,0,24,25,
Kiowa,Governor,Mick Cornett,REP,380015,0,0,8,8,
Kiowa,Governor,Kevin Stitt,REP,380015,0,2,11,13,
Kiowa,Lieutenant Governor,Dana Murphy,REP,380015,0,0,5,5,
Kiowa,Lieutenant Governor,Matt Pinnell,REP,380015,0,2,14,16,
Kiowa,State Auditor,Cindy Byrd,REP,380015,0,0,3,3,
Kiowa,State Auditor,Charlie Prater,REP,380015,0,2,14,16,
Kiowa,Attorney General,Mike Hunter,REP,380015,0,0,5,5,
Kiowa,Attorney General,Gentner Drummond,REP,380015,0,2,14,16,
Kiowa,Superintendent of Public Instruction,Joy Hofmeister,REP,380015,0,2,10,12,
Kiowa,Superintendent of Public Instruction,Linda Murphy,REP,380015,0,0,9,9,
Kiowa,Commissioner of Labor,Cathy Costello,REP,380015,0,0,8,8,
Kiowa,Commissioner of Labor,Leslie Osborn,REP,380015,0,2,11,13,
Kiowa,Corporation Commissioner,Bob Anthony,REP,380015,0,2,8,10,
Kiowa,Corporation Commissioner,Brian Bingman,REP,380015,0,0,10,10,
Kiowa,Governor,Chris Powell,LIB,380015,0,0,0,0,
Kiowa,Governor,Rex Lawhorn,LIB,380015,0,0,0,0,
Kiowa,Corporation Commissioner,Ashley Nicole Mccray,DEM,380015,0,0,7,7,
Kiowa,Corporation Commissioner,Blake Cummings,DEM,380015,0,0,5,5,
Kiowa,Governor,Mick Cornett,REP,380016,0,0,11,11,
Kiowa,Governor,Kevin Stitt,REP,380016,0,0,9,9,
Kiowa,Lieutenant Governor,Dana Murphy,REP,380016,0,0,5,5,
Kiowa,Lieutenant Governor,Matt Pinnell,REP,380016,0,0,15,15,
Kiowa,State Auditor,Cindy Byrd,REP,380016,0,0,6,6,
Kiowa,State Auditor,Charlie Prater,REP,380016,0,0,13,13,
Kiowa,Attorney General,Mike Hunter,REP,380016,0,0,10,10,
Kiowa,Attorney General,Gentner Drummond,REP,380016,0,0,9,9,
Kiowa,Superintendent of Public Instruction,Joy Hofmeister,REP,380016,0,0,10,10,
Kiowa,Superintendent of Public Instruction,Linda Murphy,REP,380016,0,0,10,10,
Kiowa,Commissioner of Labor,Cathy Costello,REP,380016,0,0,9,9,
Kiowa,Commissioner of Labor,Leslie Osborn,REP,380016,0,0,10,10,
Kiowa,Corporation Commissioner,Bob Anthony,REP,380016,0,0,12,12,
Kiowa,Corporation Commissioner,Brian Bingman,REP,380016,0,0,7,7,
Kiowa,Governor,Chris Powell,LIB,380016,0,0,0,0,
Kiowa,Governor,Rex Lawhorn,LIB,380016,0,0,0,0,
Kiowa,Corporation Commissioner,Ashley Nicole Mccray,DEM,380016,0,0,3,3,
Kiowa,Corporation Commissioner,Blake Cummings,DEM,380016,0,0,1,1,
Kiowa,Governor,Mick Cornett,REP,380022,0,0,13,13,
Kiowa,Governor,Kevin Stitt,REP,380022,2,1,13,16,
Kiowa,Lieutenant Governor,Dana Murphy,REP,380022,2,1,16,19,
Kiowa,Lieutenant Governor,Matt Pinnell,REP,380022,0,0,10,10,
Kiowa,State Auditor,Cindy Byrd,REP,380022,1,1,12,14,
Kiowa,State Auditor,Charlie Prater,REP,380022,1,0,13,14,
Kiowa,Attorney General,Mike Hunter,REP,380022,1,1,15,17,
Kiowa,Attorney General,Gentner Drummond,REP,380022,1,0,10,11,
Kiowa,Superintendent of Public Instruction,Joy Hofmeister,REP,380022,1,1,15,17,
Kiowa,Superintendent of Public Instruction,Linda Murphy,REP,380022,1,0,11,12,
Kiowa,Commissioner of Labor,Cathy Costello,REP,380022,1,1,11,13,
Kiowa,Commissioner of Labor,Leslie Osborn,REP,380022,1,0,15,16,
Kiowa,Corporation Commissioner,Bob Anthony,REP,380022,0,1,13,14,
Kiowa,Corporation Commissioner,Brian Bingman,REP,380022,2,0,13,15,
Kiowa,Governor,Chris Powell,LIB,380022,0,0,0,0,
Kiowa,Governor,Rex Lawhorn,LIB,380022,0,0,0,0,
Kiowa,Corporation Commissioner,Ashley Nicole Mccray,DEM,380022,1,0,5,6,
Kiowa,Corporation Commissioner,Blake Cummings,DEM,380022,1,0,10,11,
Latimer,Governor,Mick Cornett,REP,390001,0,0,9,9,
Latimer,Governor,Kevin Stitt,REP,390001,1,5,20,26,
Latimer,Lieutenant Governor,Dana Murphy,REP,390001,1,2,10,13,
Latimer,Lieutenant Governor,Matt Pinnell,REP,390001,0,3,20,23,
Latimer,State Auditor,Cindy Byrd,REP,390001,0,2,8,10,
Latimer,State Auditor,Charlie Prater,REP,390001,1,3,21,25,
Latimer,Attorney General,Mike Hunter,REP,390001,1,1,11,13,
Latimer,Attorney General,Gentner Drummond,REP,390001,0,4,19,23,
Latimer,Superintendent of Public Instruction,Joy Hofmeister,REP,390001,0,2,17,19,
Latimer,Superintendent of Public Instruction,Linda Murphy,REP,390001,1,3,12,16,
Latimer,Commissioner of Labor,Cathy Costello,REP,390001,1,2,11,14,
Latimer,Commissioner of Labor,Leslie Osborn,REP,390001,0,3,18,21,
Latimer,Corporation Commissioner,Bob Anthony,REP,390001,0,2,15,17,
Latimer,Corporation Commissioner,Brian Bingman,REP,390001,1,3,15,19,
Latimer,State House,Josh Hass,REP,390001,0,1,3,4,17
Latimer,State House,Jim Grego,REP,390001,1,4,27,32,17
Latimer,Governor,Chris Powell,LIB,390001,0,0,0,0,
Latimer,Governor,Rex Lawhorn,LIB,390001,0,0,0,0,
Latimer,Corporation Commissioner,Ashley Nicole Mccray,DEM,390001,1,1,21,23,
Latimer,Corporation Commissioner,Blake Cummings,DEM,390001,0,2,40,42,
Latimer,U.S. House,Jason Nichols,DEM,390001,0,2,42,44,02
Latimer,U.S. House,Clay Padgett,DEM,390001,1,1,20,22,02
Latimer,Governor,Mick Cornett,REP,390002,0,3,6,9,
Latimer,Governor,Kevin Stitt,REP,390002,1,2,22,25,
Latimer,Lieutenant Governor,Dana Murphy,REP,390002,1,3,11,15,
Latimer,Lieutenant Governor,Matt Pinnell,REP,390002,0,3,17,20,
Latimer,State Auditor,Cindy Byrd,REP,390002,1,3,9,13,
Latimer,State Auditor,Charlie Prater,REP,390002,0,3,18,21,
Latimer,Attorney General,Mike Hunter,REP,390002,1,2,15,18,
Latimer,Attorney General,Gentner Drummond,REP,390002,0,4,12,16,
Latimer,Superintendent of Public Instruction,Joy Hofmeister,REP,390002,0,2,10,12,
Latimer,Superintendent of Public Instruction,Linda Murphy,REP,390002,1,4,18,23,
Latimer,Commissioner of Labor,Cathy Costello,REP,390002,0,6,13,19,
Latimer,Commissioner of Labor,Leslie Osborn,REP,390002,1,0,15,16,
Latimer,Corporation Commissioner,Bob Anthony,REP,390002,0,3,8,11,
Latimer,Corporation Commissioner,Brian Bingman,REP,390002,1,3,20,24,
Latimer,State House,Josh Hass,REP,390002,0,0,7,7,17
Latimer,State House,Jim Grego,REP,390002,1,6,22,29,17
Latimer,Governor,Chris Powell,LIB,390002,0,0,0,0,
Latimer,Governor,Rex Lawhorn,LIB,390002,0,0,0,0,
Latimer,Corporation Commissioner,Ashley Nicole Mccray,DEM,390002,6,3,22,31,
Latimer,Corporation Commissioner,Blake Cummings,DEM,390002,4,5,33,42,
Latimer,U.S. House,Jason Nichols,DEM,390002,8,6,33,47,02
Latimer,U.S. House,Clay Padgett,DEM,390002,2,2,22,26,02
Latimer,Governor,Mick Cornett,REP,390003,0,2,9,11,
Latimer,Governor,Kevin Stitt,REP,390003,0,2,17,19,
Latimer,Lieutenant Governor,Dana Murphy,REP,390003,0,1,8,9,
Latimer,Lieutenant Governor,Matt Pinnell,REP,390003,0,3,16,19,
Latimer,State Auditor,Cindy Byrd,REP,390003,0,1,9,10,
Latimer,State Auditor,Charlie Prater,REP,390003,0,3,15,18,
Latimer,Attorney General,Mike Hunter,REP,390003,0,1,10,11,
Latimer,Attorney General,Gentner Drummond,REP,390003,0,3,14,17,
Latimer,Superintendent of Public Instruction,Joy Hofmeister,REP,390003,0,2,10,12,
Latimer,Superintendent of Public Instruction,Linda Murphy,REP,390003,0,2,14,16,
Latimer,Commissioner of Labor,Cathy Costello,REP,390003,0,1,11,12,
Latimer,Commissioner of Labor,Leslie Osborn,REP,390003,0,3,12,15,
Latimer,Corporation Commissioner,Bob Anthony,REP,390003,0,1,14,15,
Latimer,Corporation Commissioner,Brian Bingman,REP,390003,0,3,10,13,
Latimer,State House,Josh Hass,REP,390003,0,2,4,6,17
Latimer,State House,Jim Grego,REP,390003,0,2,23,25,17
Latimer,Governor,Chris Powell,LIB,390003,0,0,0,0,
Latimer,Governor,Rex Lawhorn,LIB,390003,0,0,0,0,
Latimer,Corporation Commissioner,Ashley Nicole Mccray,DEM,390003,0,6,5,11,
Latimer,Corporation Commissioner,Blake Cummings,DEM,390003,1,9,9,19,
Latimer,U.S. House,Jason Nichols,DEM,390003,0,7,7,14,02
Latimer,U.S. House,Clay Padgett,DEM,390003,1,8,7,16,02
Latimer,Governor,Mick Cornett,REP,390004,0,0,3,3,
Latimer,Governor,Kevin Stitt,REP,390004,0,0,10,10,
Latimer,Lieutenant Governor,Dana Murphy,REP,390004,0,0,3,3,
Latimer,Lieutenant Governor,Matt Pinnell,REP,390004,1,0,7,8,
Latimer,State Auditor,Cindy Byrd,REP,390004,0,0,6,6,
Latimer,State Auditor,Charlie Prater,REP,390004,1,0,4,5,
Latimer,Attorney General,Mike Hunter,REP,390004,1,0,7,8,
Latimer,Attorney General,Gentner Drummond,REP,390004,0,0,5,5,
Latimer,Superintendent of Public Instruction,Joy Hofmeister,REP,390004,0,0,3,3,
Latimer,Superintendent of Public Instruction,Linda Murphy,REP,390004,0,0,9,9,
Latimer,Commissioner of Labor,Cathy Costello,REP,390004,0,0,7,7,
Latimer,Commissioner of Labor,Leslie Osborn,REP,390004,1,0,4,5,
Latimer,Corporation Commissioner,Bob Anthony,REP,390004,0,0,5,5,
Latimer,Corporation Commissioner,Brian Bingman,REP,390004,0,0,5,5,
Latimer,State House,Josh Hass,REP,390004,0,0,3,3,17
Latimer,State House,Jim Grego,REP,390004,1,0,10,11,17
Latimer,Governor,Chris Powell,LIB,390004,0,0,0,0,
Latimer,Governor,Rex Lawhorn,LIB,390004,0,0,0,0,
Latimer,Corporation Commissioner,Ashley Nicole Mccray,DEM,390004,1,2,11,14,
Latimer,Corporation Commissioner,Blake Cummings,DEM,390004,1,3,25,29,
Latimer,U.S. House,Jason Nichols,DEM,390004,1,3,24,28,02
Latimer,U.S. House,Clay Padgett,DEM,390004,1,2,12,15,02
Latimer,Governor,Mick Cornett,REP,390005,0,1,12,13,
Latimer,Governor,Kevin Stitt,REP,390005,1,12,38,51,
Latimer,Lieutenant Governor,Dana Murphy,REP,390005,0,3,14,17,
Latimer,Lieutenant Governor,Matt Pinnell,REP,390005,1,10,36,47,
Latimer,State Auditor,Cindy Byrd,REP,390005,0,5,20,25,
Latimer,State Auditor,Charlie Prater,REP,390005,1,8,29,38,
Latimer,Attorney General,Mike Hunter,REP,390005,0,1,22,23,
Latimer,Attorney General,Gentner Drummond,REP,390005,1,11,28,40,
Latimer,Superintendent of Public Instruction,Joy Hofmeister,REP,390005,0,11,22,33,
Latimer,Superintendent of Public Instruction,Linda Murphy,REP,390005,1,2,28,31,
Latimer,Commissioner of Labor,Cathy Costello,REP,390005,0,5,19,24,
Latimer,Commissioner of Labor,Leslie Osborn,REP,390005,1,7,29,37,
Latimer,Corporation Commissioner,Bob Anthony,REP,390005,1,3,18,22,
Latimer,Corporation Commissioner,Brian Bingman,REP,390005,0,10,32,42,
Latimer,State House,Josh Hass,REP,390005,0,1,10,11,17
Latimer,State House,Jim Grego,REP,390005,1,12,38,51,17
Latimer,Governor,Chris Powell,LIB,390005,0,0,0,0,
Latimer,Governor,Rex Lawhorn,LIB,390005,0,0,0,0,
Latimer,Corporation Commissioner,Ashley Nicole Mccray,DEM,390005,1,4,34,39,
Latimer,Corporation Commissioner,Blake Cummings,DEM,390005,0,3,35,38,
Latimer,U.S. House,Jason Nichols,DEM,390005,1,3,40,44,02
Latimer,U.S. House,Clay Padgett,DEM,390005,0,4,29,33,02
Latimer,Governor,Mick Cornett,REP,390006,0,0,2,2,
Latimer,Governor,Kevin Stitt,REP,390006,1,0,11,12,
Latimer,Lieutenant Governor,Dana Murphy,REP,390006,1,0,7,8,
Latimer,Lieutenant Governor,Matt Pinnell,REP,390006,0,0,6,6,
Latimer,State Auditor,Cindy Byrd,REP,390006,0,0,6,6,
Latimer,State Auditor,Charlie Prater,REP,390006,1,0,7,8,
Latimer,Attorney General,Mike Hunter,REP,390006,0,0,0,0,
Latimer,Attorney General,Gentner Drummond,REP,390006,1,0,13,14,
Latimer,Superintendent of Public Instruction,Joy Hofmeister,REP,390006,1,0,8,9,
Latimer,Superintendent of Public Instruction,Linda Murphy,REP,390006,0,0,5,5,
Latimer,Commissioner of Labor,Cathy Costello,REP,390006,1,0,2,3,
Latimer,Commissioner of Labor,Leslie Osborn,REP,390006,0,0,11,11,
Latimer,Corporation Commissioner,Bob Anthony,REP,390006,1,0,1,2,
Latimer,Corporation Commissioner,Brian Bingman,REP,390006,0,0,12,12,
Latimer,State House,Josh Hass,REP,390006,0,0,5,5,17
Latimer,State House,Jim Grego,REP,390006,1,0,8,9,17
Latimer,Governor,Chris Powell,LIB,390006,0,0,0,0,
Latimer,Governor,Rex Lawhorn,LIB,390006,0,0,0,0,
Latimer,Corporation Commissioner,Ashley Nicole Mccray,DEM,390006,0,1,9,10,
Latimer,Corporation Commissioner,Blake Cummings,DEM,390006,0,0,6,6,
Latimer,U.S. House,Jason Nichols,DEM,390006,0,1,9,10,02
Latimer,U.S. House,Clay Padgett,DEM,390006,0,0,6,6,02
Latimer,Governor,Mick Cornett,REP,390007,0,0,9,9,
Latimer,Governor,Kevin Stitt,REP,390007,3,0,16,19,
Latimer,Lieutenant Governor,Dana Murphy,REP,390007,0,0,17,17,
Latimer,Lieutenant Governor,Matt Pinnell,REP,390007,3,0,8,11,
Latimer,State Auditor,Cindy Byrd,REP,390007,3,0,15,18,
Latimer,State Auditor,Charlie Prater,REP,390007,0,0,9,9,
Latimer,Attorney General,Mike Hunter,REP,390007,2,0,10,12,
Latimer,Attorney General,Gentner Drummond,REP,390007,1,0,15,16,
Latimer,Superintendent of Public Instruction,Joy Hofmeister,REP,390007,3,0,9,12,
Latimer,Superintendent of Public Instruction,Linda Murphy,REP,390007,0,0,15,15,
Latimer,Commissioner of Labor,Cathy Costello,REP,390007,1,0,11,12,
Latimer,Commissioner of Labor,Leslie Osborn,REP,390007,2,0,13,15,
Latimer,Corporation Commissioner,Bob Anthony,REP,390007,0,0,9,9,
Latimer,Corporation Commissioner,Brian Bingman,REP,390007,3,0,14,17,
Latimer,State House,Josh Hass,REP,390007,1,0,8,9,17
Latimer,State House,Jim Grego,REP,390007,2,0,17,19,17
Latimer,Governor,Chris Powell,LIB,390007,0,0,0,0,
Latimer,Governor,Rex Lawhorn,LIB,390007,0,0,0,0,
Latimer,Corporation Commissioner,Ashley Nicole Mccray,DEM,390007,1,1,12,14,
Latimer,Corporation Commissioner,Blake Cummings,DEM,390007,0,0,6,6,
Latimer,U.S. House,Jason Nichols,DEM,390007,1,1,13,15,02
Latimer,U.S. House,Clay Padgett,DEM,390007,0,0,6,6,02
Latimer,Governor,Mick Cornett,REP,390008,0,0,17,17,
Latimer,Governor,Kevin Stitt,REP,390008,0,2,23,25,
Latimer,Lieutenant Governor,Dana Murphy,REP,390008,0,0,11,11,
Latimer,Lieutenant Governor,Matt Pinnell,REP,390008,0,2,25,27,
Latimer,State Auditor,Cindy Byrd,REP,390008,0,1,18,19,
Latimer,State Auditor,Charlie Prater,REP,390008,0,1,18,19,
Latimer,Attorney General,Mike Hunter,REP,390008,0,0,12,12,
Latimer,Attorney General,Gentner Drummond,REP,390008,0,2,27,29,
Latimer,Superintendent of Public Instruction,Joy Hofmeister,REP,390008,0,1,23,24,
Latimer,Superintendent of Public Instruction,Linda Murphy,REP,390008,0,1,15,16,
Latimer,Commissioner of Labor,Cathy Costello,REP,390008,0,0,9,9,
Latimer,Commissioner of Labor,Leslie Osborn,REP,390008,0,2,26,28,
Latimer,Corporation Commissioner,Bob Anthony,REP,390008,0,0,15,15,
Latimer,Corporation Commissioner,Brian Bingman,REP,390008,0,2,21,23,
Latimer,State House,Josh Hass,REP,390008,0,0,12,12,17
Latimer,State House,Jim Grego,REP,390008,0,2,27,29,17
Latimer,Governor,Chris Powell,LIB,390008,0,0,0,0,
Latimer,Governor,Rex Lawhorn,LIB,390008,0,0,0,0,
Latimer,Corporation Commissioner,Ashley Nicole Mccray,DEM,390008,0,1,21,22,
Latimer,Corporation Commissioner,Blake Cummings,DEM,390008,0,1,19,20,
Latimer,U.S. House,Jason Nichols,DEM,390008,0,2,22,24,02
Latimer,U.S. House,Clay Padgett,DEM,390008,0,0,17,17,02
Latimer,Governor,Mick Cornett,REP,390009,0,2,11,13,
Latimer,Governor,Kevin Stitt,REP,390009,0,0,19,19,
Latimer,Lieutenant Governor,Dana Murphy,REP,390009,0,2,10,12,
Latimer,Lieutenant Governor,Matt Pinnell,REP,390009,0,0,17,17,
Latimer,State Auditor,Cindy Byrd,REP,390009,0,1,10,11,
Latimer,State Auditor,Charlie Prater,REP,390009,0,1,18,19,
Latimer,Attorney General,Mike Hunter,REP,390009,0,2,14,16,
Latimer,Attorney General,Gentner Drummond,REP,390009,0,0,16,16,
Latimer,Superintendent of Public Instruction,Joy Hofmeister,REP,390009,0,0,19,19,
Latimer,Superintendent of Public Instruction,Linda Murphy,REP,390009,0,2,11,13,
Latimer,Commissioner of Labor,Cathy Costello,REP,390009,0,1,4,5,
Latimer,Commissioner of Labor,Leslie Osborn,REP,390009,0,1,24,25,
Latimer,Corporation Commissioner,Bob Anthony,REP,390009,0,0,16,16,
Latimer,Corporation Commissioner,Brian Bingman,REP,390009,0,2,12,14,
Latimer,State House,Josh Hass,REP,390009,0,2,5,7,17
Latimer,State House,Jim Grego,REP,390009,0,0,25,25,17
Latimer,Governor,Chris Powell,LIB,390009,0,0,0,0,
Latimer,Governor,Rex Lawhorn,LIB,390009,0,0,0,0,
Latimer,Corporation Commissioner,Ashley Nicole Mccray,DEM,390009,1,0,17,18,
Latimer,Corporation Commissioner,Blake Cummings,DEM,390009,1,1,22,24,
Latimer,U.S. House,Jason Nichols,DEM,390009,2,0,19,21,02
Latimer,U.S. House,Clay Padgett,DEM,390009,0,1,20,21,02
Latimer,Governor,Mick Cornett,REP,390010,0,1,9,10,
Latimer,Governor,Kevin Stitt,REP,390010,2,0,16,18,
Latimer,Lieutenant Governor,Dana Murphy,REP,390010,0,0,6,6,
Latimer,Lieutenant Governor,Matt Pinnell,REP,390010,2,1,17,20,
Latimer,State Auditor,Cindy Byrd,REP,390010,1,0,15,16,
Latimer,State Auditor,Charlie Prater,REP,390010,1,1,10,12,
Latimer,Attorney General,Mike Hunter,REP,390010,0,1,7,8,
Latimer,Attorney General,Gentner Drummond,REP,390010,2,0,18,20,
Latimer,Superintendent of Public Instruction,Joy Hofmeister,REP,390010,1,0,9,10,
Latimer,Superintendent of Public Instruction,Linda Murphy,REP,390010,1,1,16,18,
Latimer,Commissioner of Labor,Cathy Costello,REP,390010,1,0,9,10,
Latimer,Commissioner of Labor,Leslie Osborn,REP,390010,1,1,16,18,
Latimer,Corporation Commissioner,Bob Anthony,REP,390010,1,1,9,11,
Latimer,Corporation Commissioner,Brian Bingman,REP,390010,1,0,16,17,
Latimer,State House,Josh Hass,REP,390010,1,0,5,6,17
Latimer,State House,Jim Grego,REP,390010,1,1,20,22,17
Latimer,Governor,Chris Powell,LIB,390010,0,0,0,0,
Latimer,Governor,Rex Lawhorn,LIB,390010,0,0,0,0,
Latimer,Corporation Commissioner,Ashley Nicole Mccray,DEM,390010,1,2,9,12,
Latimer,Corporation Commissioner,Blake Cummings,DEM,390010,0,3,21,24,
Latimer,U.S. House,Jason Nichols,DEM,390010,0,3,14,17,02
Latimer,U.S. House,Clay Padgett,DEM,390010,1,2,16,19,02
Latimer,Governor,Mick Cornett,REP,390011,1,0,8,9,
Latimer,Governor,Kevin Stitt,REP,390011,0,1,31,32,
Latimer,Lieutenant Governor,Dana Murphy,REP,390011,1,0,9,10,
Latimer,Lieutenant Governor,Matt Pinnell,REP,390011,0,1,28,29,
Latimer,State Auditor,Cindy Byrd,REP,390011,0,0,25,25,
Latimer,State Auditor,Charlie Prater,REP,390011,1,1,11,13,
Latimer,Attorney General,Mike Hunter,REP,390011,0,0,13,13,
Latimer,Attorney General,Gentner Drummond,REP,390011,1,1,24,26,
Latimer,Superintendent of Public Instruction,Joy Hofmeister,REP,390011,0,1,12,13,
Latimer,Superintendent of Public Instruction,Linda Murphy,REP,390011,1,0,23,24,
Latimer,Commissioner of Labor,Cathy Costello,REP,390011,1,0,14,15,
Latimer,Commissioner of Labor,Leslie Osborn,REP,390011,0,1,21,22,
Latimer,Corporation Commissioner,Bob Anthony,REP,390011,0,0,16,16,
Latimer,Corporation Commissioner,Brian Bingman,REP,390011,1,1,20,22,
Latimer,State House,Josh Hass,REP,390011,0,0,10,10,17
Latimer,State House,Jim Grego,REP,390011,1,1,28,30,17
Latimer,Governor,Chris Powell,LIB,390011,0,0,0,0,
Latimer,Governor,Rex Lawhorn,LIB,390011,0,0,0,0,
Latimer,Corporation Commissioner,Ashley Nicole Mccray,DEM,390011,4,2,48,54,
Latimer,Corporation Commissioner,Blake Cummings,DEM,390011,1,3,38,42,
Latimer,U.S. House,Jason Nichols,DEM,390011,4,3,56,63,02
Latimer,U.S. House,Clay Padgett,DEM,390011,1,2,30,33,02
Latimer,Governor,Mick Cornett,REP,390012,0,0,5,5,
Latimer,Governor,Kevin Stitt,REP,390012,2,0,11,13,
Latimer,Lieutenant Governor,Dana Murphy,REP,390012,0,0,6,6,
Latimer,Lieutenant Governor,Matt Pinnell,REP,390012,2,0,9,11,
Latimer,State Auditor,Cindy Byrd,REP,390012,0,0,7,7,
Latimer,State Auditor,Charlie Prater,REP,390012,2,0,8,10,
Latimer,Attorney General,Mike Hunter,REP,390012,2,0,7,9,
Latimer,Attorney General,Gentner Drummond,REP,390012,0,0,7,7,
Latimer,Superintendent of Public Instruction,Joy Hofmeister,REP,390012,0,0,7,7,
Latimer,Superintendent of Public Instruction,Linda Murphy,REP,390012,3,0,9,12,
Latimer,Commissioner of Labor,Cathy Costello,REP,390012,0,0,4,4,
Latimer,Commissioner of Labor,Leslie Osborn,REP,390012,2,0,11,13,
Latimer,Corporation Commissioner,Bob Anthony,REP,390012,2,0,8,10,
Latimer,Corporation Commissioner,Brian Bingman,REP,390012,0,0,7,7,
Latimer,State House,Josh Hass,REP,390012,0,0,6,6,17
Latimer,State House,Jim Grego,REP,390012,3,0,10,13,17
Latimer,Governor,Chris Powell,LIB,390012,0,0,0,0,
Latimer,Governor,Rex Lawhorn,LIB,390012,0,0,0,0,
Latimer,Corporation Commissioner,Ashley Nicole Mccray,DEM,390012,0,1,11,12,
Latimer,Corporation Commissioner,Blake Cummings,DEM,390012,0,1,17,18,
Latimer,U.S. House,Jason Nichols,DEM,390012,0,0,20,20,02
Latimer,U.S. House,Clay Padgett,DEM,390012,0,2,8,10,02
Leflore,Governor,Mick Cornett,REP,400101,0,0,6,6,
Leflore,Governor,Kevin Stitt,REP,400101,2,0,8,10,
Leflore,Lieutenant Governor,Dana Murphy,REP,400101,0,0,4,4,
Leflore,Lieutenant Governor,Matt Pinnell,REP,400101,2,0,9,11,
Leflore,State Auditor,Cindy Byrd,REP,400101,2,0,6,8,
Leflore,State Auditor,Charlie Prater,REP,400101,0,0,7,7,
Leflore,Attorney General,Mike Hunter,REP,400101,0,0,6,6,
Leflore,Attorney General,Gentner Drummond,REP,400101,2,0,7,9,
Leflore,Superintendent of Public Instruction,Joy Hofmeister,REP,400101,0,0,7,7,
Leflore,Superintendent of Public Instruction,Linda Murphy,REP,400101,2,0,7,9,
Leflore,Commissioner of Labor,Cathy Costello,REP,400101,2,0,4,6,
Leflore,Commissioner of Labor,Leslie Osborn,REP,400101,0,0,9,9,
Leflore,Corporation Commissioner,Bob Anthony,REP,400101,2,0,5,7,
Leflore,Corporation Commissioner,Brian Bingman,REP,400101,0,0,8,8,
Leflore,Governor,Chris Powell,LIB,400101,0,1,0,1,
Leflore,Governor,Rex Lawhorn,LIB,400101,0,0,0,0,
Leflore,Corporation Commissioner,Ashley Nicole Mccray,DEM,400101,1,1,9,11,
Leflore,Corporation Commissioner,Blake Cummings,DEM,400101,0,1,16,17,
Leflore,U.S. House,Jason Nichols,DEM,400101,1,1,10,12,02
Leflore,U.S. House,Clay Padgett,DEM,400101,0,1,15,16,02
Leflore,Governor,Mick Cornett,REP,400102,0,0,8,8,
Leflore,Governor,Kevin Stitt,REP,400102,1,2,21,24,
Leflore,Lieutenant Governor,Dana Murphy,REP,400102,0,0,15,15,
Leflore,Lieutenant Governor,Matt Pinnell,REP,400102,1,2,14,17,
Leflore,State Auditor,Cindy Byrd,REP,400102,0,0,12,12,
Leflore,State Auditor,Charlie Prater,REP,400102,1,2,14,17,
Leflore,Attorney General,Mike Hunter,REP,400102,0,0,13,13,
Leflore,Attorney General,Gentner Drummond,REP,400102,1,2,15,18,
Leflore,Superintendent of Public Instruction,Joy Hofmeister,REP,400102,1,0,12,13,
Leflore,Superintendent of Public Instruction,Linda Murphy,REP,400102,0,2,15,17,
Leflore,Commissioner of Labor,Cathy Costello,REP,400102,1,2,15,18,
Leflore,Commissioner of Labor,Leslie Osborn,REP,400102,0,0,11,11,
Leflore,Corporation Commissioner,Bob Anthony,REP,400102,1,0,11,12,
Leflore,Corporation Commissioner,Brian Bingman,REP,400102,0,2,15,17,
Leflore,Governor,Chris Powell,LIB,400102,0,0,0,0,
Leflore,Governor,Rex Lawhorn,LIB,400102,0,0,0,0,
Leflore,Corporation Commissioner,Ashley Nicole Mccray,DEM,400102,2,0,10,12,
Leflore,Corporation Commissioner,Blake Cummings,DEM,400102,0,0,12,12,
Leflore,U.S. House,Jason Nichols,DEM,400102,2,0,5,7,02
Leflore,U.S. House,Clay Padgett,DEM,400102,0,0,18,18,02
Leflore,Governor,Mick Cornett,REP,400103,0,1,14,15,
Leflore,Governor,Kevin Stitt,REP,400103,0,0,23,23,
Leflore,Lieutenant Governor,Dana Murphy,REP,400103,0,0,10,10,
Leflore,Lieutenant Governor,Matt Pinnell,REP,400103,0,1,27,28,
Leflore,State Auditor,Cindy Byrd,REP,400103,0,0,24,24,
Leflore,State Auditor,Charlie Prater,REP,400103,0,1,12,13,
Leflore,Attorney General,Mike Hunter,REP,400103,0,1,17,18,
Leflore,Attorney General,Gentner Drummond,REP,400103,0,0,20,20,
Leflore,Superintendent of Public Instruction,Joy Hofmeister,REP,400103,0,0,19,19,
Leflore,Superintendent of Public Instruction,Linda Murphy,REP,400103,0,1,15,16,
Leflore,Commissioner of Labor,Cathy Costello,REP,400103,0,0,17,17,
Leflore,Commissioner of Labor,Leslie Osborn,REP,400103,0,1,17,18,
Leflore,Corporation Commissioner,Bob Anthony,REP,400103,0,1,17,18,
Leflore,Corporation Commissioner,Brian Bingman,REP,400103,0,0,17,17,
Leflore,Governor,Chris Powell,LIB,400103,0,0,1,1,
Leflore,Governor,Rex Lawhorn,LIB,400103,0,0,0,0,
Leflore,Corporation Commissioner,Ashley Nicole Mccray,DEM,400103,5,2,22,29,
Leflore,Corporation Commissioner,Blake Cummings,DEM,400103,0,1,18,19,
Leflore,U.S. House,Jason Nichols,DEM,400103,2,3,21,26,02
Leflore,U.S. House,Clay Padgett,DEM,400103,3,0,18,21,02
Leflore,Governor,Mick Cornett,REP,400104,0,0,6,6,
Leflore,Governor,Kevin Stitt,REP,400104,0,2,2,4,
Leflore,Lieutenant Governor,Dana Murphy,REP,400104,0,0,4,4,
Leflore,Lieutenant Governor,Matt Pinnell,REP,400104,0,2,4,6,
Leflore,State Auditor,Cindy Byrd,REP,400104,0,0,6,6,
Leflore,State Auditor,Charlie Prater,REP,400104,0,2,0,2,
Leflore,Attorney General,Mike Hunter,REP,400104,0,0,5,5,
Leflore,Attorney General,Gentner Drummond,REP,400104,0,2,3,5,
Leflore,Superintendent of Public Instruction,Joy Hofmeister,REP,400104,0,0,3,3,
Leflore,Superintendent of Public Instruction,Linda Murphy,REP,400104,0,2,5,7,
Leflore,Commissioner of Labor,Cathy Costello,REP,400104,0,0,2,2,
Leflore,Commissioner of Labor,Leslie Osborn,REP,400104,0,2,6,8,
Leflore,Corporation Commissioner,Bob Anthony,REP,400104,0,2,2,4,
Leflore,Corporation Commissioner,Brian Bingman,REP,400104,0,0,4,4,
Leflore,Governor,Chris Powell,LIB,400104,0,0,0,0,
Leflore,Governor,Rex Lawhorn,LIB,400104,0,0,0,0,
Leflore,Corporation Commissioner,Ashley Nicole Mccray,DEM,400104,0,0,10,10,
Leflore,Corporation Commissioner,Blake Cummings,DEM,400104,0,0,8,8,
Leflore,U.S. House,Jason Nichols,DEM,400104,0,0,10,10,02
Leflore,U.S. House,Clay Padgett,DEM,400104,0,0,8,8,02
Leflore,Governor,Mick Cornett,REP,400105,0,0,9,9,
Leflore,Governor,Kevin Stitt,REP,400105,0,3,33,36,
Leflore,Lieutenant Governor,Dana Murphy,REP,400105,0,0,17,17,
Leflore,Lieutenant Governor,Matt Pinnell,REP,400105,0,3,21,24,
Leflore,State Auditor,Cindy Byrd,REP,400105,0,3,16,19,
Leflore,State Auditor,Charlie Prater,REP,400105,0,0,22,22,
Leflore,Attorney General,Mike Hunter,REP,400105,0,0,14,14,
Leflore,Attorney General,Gentner Drummond,REP,400105,0,3,28,31,
Leflore,Superintendent of Public Instruction,Joy Hofmeister,REP,400105,0,3,14,17,
Leflore,Superintendent of Public Instruction,Linda Murphy,REP,400105,0,0,26,26,
Leflore,Commissioner of Labor,Cathy Costello,REP,400105,0,3,19,22,
Leflore,Commissioner of Labor,Leslie Osborn,REP,400105,0,0,19,19,
Leflore,Corporation Commissioner,Bob Anthony,REP,400105,0,3,20,23,
Leflore,Corporation Commissioner,Brian Bingman,REP,400105,0,0,19,19,
Leflore,Governor,Chris Powell,LIB,400105,0,0,0,0,
Leflore,Governor,Rex Lawhorn,LIB,400105,0,0,0,0,
Leflore,Corporation Commissioner,Ashley Nicole Mccray,DEM,400105,0,0,22,22,
Leflore,Corporation Commissioner,Blake Cummings,DEM,400105,0,0,21,21,
Leflore,U.S. House,Jason Nichols,DEM,400105,0,0,25,25,02
Leflore,U.S. House,Clay Padgett,DEM,400105,0,0,18,18,02
Leflore,Governor,Mick Cornett,REP,400106,3,0,29,32,
Leflore,Governor,Kevin Stitt,REP,400106,0,0,42,42,
Leflore,Lieutenant Governor,Dana Murphy,REP,400106,0,0,21,21,
Leflore,Lieutenant Governor,Matt Pinnell,REP,400106,3,0,48,51,
Leflore,State Auditor,Cindy Byrd,REP,400106,2,0,33,35,
Leflore,State Auditor,Charlie Prater,REP,400106,1,0,36,37,
Leflore,Attorney General,Mike Hunter,REP,400106,1,0,35,36,
Leflore,Attorney General,Gentner Drummond,REP,400106,2,0,35,37,
Leflore,Superintendent of Public Instruction,Joy Hofmeister,REP,400106,2,0,25,27,
Leflore,Superintendent of Public Instruction,Linda Murphy,REP,400106,1,0,44,45,
Leflore,Commissioner of Labor,Cathy Costello,REP,400106,0,0,23,23,
Leflore,Commissioner of Labor,Leslie Osborn,REP,400106,3,0,44,47,
Leflore,Corporation Commissioner,Bob Anthony,REP,400106,3,0,40,43,
Leflore,Corporation Commissioner,Brian Bingman,REP,400106,0,0,26,26,
Leflore,Governor,Chris Powell,LIB,400106,0,0,0,0,
Leflore,Governor,Rex Lawhorn,LIB,400106,0,0,0,0,
Leflore,Corporation Commissioner,Ashley Nicole Mccray,DEM,400106,0,0,37,37,
Leflore,Corporation Commissioner,Blake Cummings,DEM,400106,0,1,44,45,
Leflore,U.S. House,Jason Nichols,DEM,400106,0,0,56,56,02
Leflore,U.S. House,Clay Padgett,DEM,400106,0,2,27,29,02
Leflore,Governor,Mick Cornett,REP,400107,0,2,48,50,
Leflore,Governor,Kevin Stitt,REP,400107,0,0,72,72,
Leflore,Lieutenant Governor,Dana Murphy,REP,400107,0,1,42,43,
Leflore,Lieutenant Governor,Matt Pinnell,REP,400107,0,1,76,77,
Leflore,State Auditor,Cindy Byrd,REP,400107,0,0,57,57,
Leflore,State Auditor,Charlie Prater,REP,400107,0,2,56,58,
Leflore,Attorney General,Mike Hunter,REP,400107,0,0,71,71,
Leflore,Attorney General,Gentner Drummond,REP,400107,0,2,47,49,
Leflore,Superintendent of Public Instruction,Joy Hofmeister,REP,400107,0,0,40,40,
Leflore,Superintendent of Public Instruction,Linda Murphy,REP,400107,0,2,76,78,
Leflore,Commissioner of Labor,Cathy Costello,REP,400107,0,0,43,43,
Leflore,Commissioner of Labor,Leslie Osborn,REP,400107,0,2,67,69,
Leflore,Corporation Commissioner,Bob Anthony,REP,400107,0,1,59,60,
Leflore,Corporation Commissioner,Brian Bingman,REP,400107,0,1,52,53,
Leflore,Governor,Chris Powell,LIB,400107,0,0,2,2,
Leflore,Governor,Rex Lawhorn,LIB,400107,0,0,0,0,
Leflore,Corporation Commissioner,Ashley Nicole Mccray,DEM,400107,1,2,91,94,
Leflore,Corporation Commissioner,Blake Cummings,DEM,400107,0,5,71,76,
Leflore,U.S. House,Jason Nichols,DEM,400107,0,2,101,103,02
Leflore,U.S. House,Clay Padgett,DEM,400107,1,5,64,70,02
Leflore,Governor,Mick Cornett,REP,400108,0,0,13,13,
Leflore,Governor,Kevin Stitt,REP,400108,0,0,10,10,
Leflore,Lieutenant Governor,Dana Murphy,REP,400108,0,0,8,8,
Leflore,Lieutenant Governor,Matt Pinnell,REP,400108,0,0,15,15,
Leflore,State Auditor,Cindy Byrd,REP,400108,0,0,7,7,
Leflore,State Auditor,Charlie Prater,REP,400108,0,0,16,16,
Leflore,Attorney General,Mike Hunter,REP,400108,0,0,11,11,
Leflore,Attorney General,Gentner Drummond,REP,400108,0,0,12,12,
Leflore,Superintendent of Public Instruction,Joy Hofmeister,REP,400108,0,0,14,14,
Leflore,Superintendent of Public Instruction,Linda Murphy,REP,400108,0,0,8,8,
Leflore,Commissioner of Labor,Cathy Costello,REP,400108,0,0,9,9,
Leflore,Commissioner of Labor,Leslie Osborn,REP,400108,0,0,14,14,
Leflore,Corporation Commissioner,Bob Anthony,REP,400108,0,0,12,12,
Leflore,Corporation Commissioner,Brian Bingman,REP,400108,0,0,11,11,
Leflore,Governor,Chris Powell,LIB,400108,0,0,0,0,
Leflore,Governor,Rex Lawhorn,LIB,400108,0,0,0,0,
Leflore,Corporation Commissioner,Ashley Nicole Mccray,DEM,400108,0,0,10,10,
Leflore,Corporation Commissioner,Blake Cummings,DEM,400108,1,0,14,15,
Leflore,U.S. House,Jason Nichols,DEM,400108,1,0,17,18,02
Leflore,U.S. House,Clay Padgett,DEM,400108,0,0,7,7,02
Leflore,Governor,Mick Cornett,REP,400109,0,0,12,12,
Leflore,Governor,Kevin Stitt,REP,400109,1,6,28,35,
Leflore,Lieutenant Governor,Dana Murphy,REP,400109,1,0,11,12,
Leflore,Lieutenant Governor,Matt Pinnell,REP,400109,0,6,29,35,
Leflore,State Auditor,Cindy Byrd,REP,400109,1,0,23,24,
Leflore,State Auditor,Charlie Prater,REP,400109,0,6,17,23,
Leflore,Attorney General,Mike Hunter,REP,400109,1,0,13,14,
Leflore,Attorney General,Gentner Drummond,REP,400109,0,6,27,33,
Leflore,Superintendent of Public Instruction,Joy Hofmeister,REP,400109,1,2,17,20,
Leflore,Superintendent of Public Instruction,Linda Murphy,REP,400109,0,4,22,26,
Leflore,Commissioner of Labor,Cathy Costello,REP,400109,0,3,20,23,
Leflore,Commissioner of Labor,Leslie Osborn,REP,400109,1,3,20,24,
Leflore,Corporation Commissioner,Bob Anthony,REP,400109,1,1,20,22,
Leflore,Corporation Commissioner,Brian Bingman,REP,400109,0,5,17,22,
Leflore,Governor,Chris Powell,LIB,400109,0,0,0,0,
Leflore,Governor,Rex Lawhorn,LIB,400109,0,0,0,0,
Leflore,Corporation Commissioner,Ashley Nicole Mccray,DEM,400109,1,6,30,37,
Leflore,Corporation Commissioner,Blake Cummings,DEM,400109,1,1,19,21,
Leflore,U.S. House,Jason Nichols,DEM,400109,1,0,26,27,02
Leflore,U.S. House,Clay Padgett,DEM,400109,1,7,23,31,02
Leflore,Governor,Mick Cornett,REP,400110,0,1,5,6,
Leflore,Governor,Kevin Stitt,REP,400110,0,0,10,10,
Leflore,Lieutenant Governor,Dana Murphy,REP,400110,0,1,7,8,
Leflore,Lieutenant Governor,Matt Pinnell,REP,400110,0,0,7,7,
Leflore,State Auditor,Cindy Byrd,REP,400110,0,1,6,7,
Leflore,State Auditor,Charlie Prater,REP,400110,0,0,8,8,
Leflore,Attorney General,Mike Hunter,REP,400110,0,0,5,5,
Leflore,Attorney General,Gentner Drummond,REP,400110,0,1,9,10,
Leflore,Superintendent of Public Instruction,Joy Hofmeister,REP,400110,0,1,8,9,
Leflore,Superintendent of Public Instruction,Linda Murphy,REP,400110,0,0,6,6,
Leflore,Commissioner of Labor,Cathy Costello,REP,400110,0,1,7,8,
Leflore,Commissioner of Labor,Leslie Osborn,REP,400110,0,0,7,7,
Leflore,Corporation Commissioner,Bob Anthony,REP,400110,0,1,6,7,
Leflore,Corporation Commissioner,Brian Bingman,REP,400110,0,0,8,8,
Leflore,Governor,Chris Powell,LIB,400110,0,0,0,0,
Leflore,Governor,Rex Lawhorn,LIB,400110,0,0,0,0,
Leflore,Corporation Commissioner,Ashley Nicole Mccray,DEM,400110,0,1,16,17,
Leflore,Corporation Commissioner,Blake Cummings,DEM,400110,0,1,19,20,
Leflore,U.S. House,Jason Nichols,DEM,400110,0,0,19,19,02
Leflore,U.S. House,Clay Padgett,DEM,400110,0,2,17,19,02
Leflore,Governor,Mick Cornett,REP,400111,0,2,16,18,
Leflore,Governor,Kevin Stitt,REP,400111,0,1,28,29,
Leflore,Lieutenant Governor,Dana Murphy,REP,400111,0,1,18,19,
Leflore,Lieutenant Governor,Matt Pinnell,REP,400111,0,2,24,26,
Leflore,State Auditor,Cindy Byrd,REP,400111,0,2,24,26,
Leflore,State Auditor,Charlie Prater,REP,400111,0,1,18,19,
Leflore,Attorney General,Mike Hunter,REP,400111,0,1,24,25,
Leflore,Attorney General,Gentner Drummond,REP,400111,0,2,19,21,
Leflore,Superintendent of Public Instruction,Joy Hofmeister,REP,400111,0,2,24,26,
Leflore,Superintendent of Public Instruction,Linda Murphy,REP,400111,0,1,17,18,
Leflore,Commissioner of Labor,Cathy Costello,REP,400111,0,2,18,20,
Leflore,Commissioner of Labor,Leslie Osborn,REP,400111,0,1,22,23,
Leflore,Corporation Commissioner,Bob Anthony,REP,400111,0,1,18,19,
Leflore,Corporation Commissioner,Brian Bingman,REP,400111,0,2,23,25,
Leflore,Governor,Chris Powell,LIB,400111,0,0,0,0,
Leflore,Governor,Rex Lawhorn,LIB,400111,0,0,0,0,
Leflore,Corporation Commissioner,Ashley Nicole Mccray,DEM,400111,0,3,36,39,
Leflore,Corporation Commissioner,Blake Cummings,DEM,400111,0,2,25,27,
Leflore,U.S. House,Jason Nichols,DEM,400111,0,2,35,37,02
Leflore,U.S. House,Clay Padgett,DEM,400111,0,3,28,31,02
Leflore,Governor,Mick Cornett,REP,400112,0,0,4,4,
Leflore,Governor,Kevin Stitt,REP,400112,0,0,8,8,
Leflore,Lieutenant Governor,Dana Murphy,REP,400112,0,0,4,4,
Leflore,Lieutenant Governor,Matt Pinnell,REP,400112,0,0,5,5,
Leflore,State Auditor,Cindy Byrd,REP,400112,0,0,7,7,
Leflore,State Auditor,Charlie Prater,REP,400112,0,0,5,5,
Leflore,Attorney General,Mike Hunter,REP,400112,0,0,5,5,
Leflore,Attorney General,Gentner Drummond,REP,400112,0,0,6,6,
Leflore,Superintendent of Public Instruction,Joy Hofmeister,REP,400112,0,0,4,4,
Leflore,Superintendent of Public Instruction,Linda Murphy,REP,400112,0,0,5,5,
Leflore,Commissioner of Labor,Cathy Costello,REP,400112,0,0,6,6,
Leflore,Commissioner of Labor,Leslie Osborn,REP,400112,0,0,5,5,
Leflore,Corporation Commissioner,Bob Anthony,REP,400112,0,0,4,4,
Leflore,Corporation Commissioner,Brian Bingman,REP,400112,0,0,5,5,
Leflore,Governor,Chris Powell,LIB,400112,0,0,0,0,
Leflore,Governor,Rex Lawhorn,LIB,400112,0,0,0,0,
Leflore,Corporation Commissioner,Ashley Nicole Mccray,DEM,400112,0,0,6,6,
Leflore,Corporation Commissioner,Blake Cummings,DEM,400112,0,1,14,15,
Leflore,U.S. House,Jason Nichols,DEM,400112,0,0,10,10,02
Leflore,U.S. House,Clay Padgett,DEM,400112,0,1,9,10,02
Leflore,Governor,Mick Cornett,REP,400113,0,0,7,7,
Leflore,Governor,Kevin Stitt,REP,400113,2,3,17,22,
Leflore,Lieutenant Governor,Dana Murphy,REP,400113,1,0,5,6,
Leflore,Lieutenant Governor,Matt Pinnell,REP,400113,1,3,18,22,
Leflore,State Auditor,Cindy Byrd,REP,400113,2,1,8,11,
Leflore,State Auditor,Charlie Prater,REP,400113,0,2,14,16,
Leflore,Attorney General,Mike Hunter,REP,400113,0,0,12,12,
Leflore,Attorney General,Gentner Drummond,REP,400113,2,3,12,17,
Leflore,Superintendent of Public Instruction,Joy Hofmeister,REP,400113,0,0,11,11,
Leflore,Superintendent of Public Instruction,Linda Murphy,REP,400113,2,3,13,18,
Leflore,Commissioner of Labor,Cathy Costello,REP,400113,2,0,10,12,
Leflore,Commissioner of Labor,Leslie Osborn,REP,400113,0,3,14,17,
Leflore,Corporation Commissioner,Bob Anthony,REP,400113,0,2,10,12,
Leflore,Corporation Commissioner,Brian Bingman,REP,400113,2,1,14,17,
Leflore,Governor,Chris Powell,LIB,400113,0,0,0,0,
Leflore,Governor,Rex Lawhorn,LIB,400113,0,0,0,0,
Leflore,Corporation Commissioner,Ashley Nicole Mccray,DEM,400113,1,1,19,21,
Leflore,Corporation Commissioner,Blake Cummings,DEM,400113,1,1,15,17,
Leflore,U.S. House,Jason Nichols,DEM,400113,1,1,19,21,02
Leflore,U.S. House,Clay Padgett,DEM,400113,1,1,15,17,02
Leflore,Governor,Mick Cornett,REP,400114,0,0,1,1,
Leflore,Governor,Kevin Stitt,REP,400114,0,0,5,5,
Leflore,Lieutenant Governor,Dana Murphy,REP,400114,0,0,3,3,
Leflore,Lieutenant Governor,Matt Pinnell,REP,400114,0,0,4,4,
Leflore,State Auditor,Cindy Byrd,REP,400114,0,0,5,5,
Leflore,State Auditor,Charlie Prater,REP,400114,0,0,2,2,
Leflore,Attorney General,Mike Hunter,REP,400114,0,0,3,3,
Leflore,Attorney General,Gentner Drummond,REP,400114,0,0,4,4,
Leflore,Superintendent of Public Instruction,Joy Hofmeister,REP,400114,0,0,1,1,
Leflore,Superintendent of Public Instruction,Linda Murphy,REP,400114,0,0,6,6,
Leflore,Commissioner of Labor,Cathy Costello,REP,400114,0,0,4,4,
Leflore,Commissioner of Labor,Leslie Osborn,REP,400114,0,0,3,3,
Leflore,Corporation Commissioner,Bob Anthony,REP,400114,0,0,6,6,
Leflore,Corporation Commissioner,Brian Bingman,REP,400114,0,0,1,1,
Leflore,Governor,Chris Powell,LIB,400114,0,0,0,0,
Leflore,Governor,Rex Lawhorn,LIB,400114,0,0,0,0,
Leflore,Corporation Commissioner,Ashley Nicole Mccray,DEM,400114,0,0,2,2,
Leflore,Corporation Commissioner,Blake Cummings,DEM,400114,0,0,14,14,
Leflore,U.S. House,Jason Nichols,DEM,400114,0,0,10,10,02
Leflore,U.S. House,Clay Padgett,DEM,400114,0,0,4,4,02
Leflore,Governor,Mick Cornett,REP,400201,0,0,0,0,
Leflore,Governor,Kevin Stitt,REP,400201,0,0,8,8,
Leflore,Lieutenant Governor,Dana Murphy,REP,400201,0,0,2,2,
Leflore,Lieutenant Governor,Matt Pinnell,REP,400201,0,0,6,6,
Leflore,State Auditor,Cindy Byrd,REP,400201,0,0,6,6,
Leflore,State Auditor,Charlie Prater,REP,400201,0,0,2,2,
Leflore,Attorney General,Mike Hunter,REP,400201,0,0,6,6,
Leflore,Attorney General,Gentner Drummond,REP,400201,0,0,2,2,
Leflore,Superintendent of Public Instruction,Joy Hofmeister,REP,400201,0,0,2,2,
Leflore,Superintendent of Public Instruction,Linda Murphy,REP,400201,0,0,6,6,
Leflore,Commissioner of Labor,Cathy Costello,REP,400201,0,0,6,6,
Leflore,Commissioner of Labor,Leslie Osborn,REP,400201,0,0,2,2,
Leflore,Corporation Commissioner,Bob Anthony,REP,400201,0,0,4,4,
Leflore,Corporation Commissioner,Brian Bingman,REP,400201,0,0,4,4,
Leflore,Governor,Chris Powell,LIB,400201,0,0,0,0,
Leflore,Governor,Rex Lawhorn,LIB,400201,0,0,0,0,
Leflore,Corporation Commissioner,Ashley Nicole Mccray,DEM,400201,0,0,5,5,
Leflore,Corporation Commissioner,Blake Cummings,DEM,400201,0,0,2,2,
Leflore,U.S. House,Jason Nichols,DEM,400201,0,0,2,2,02
Leflore,U.S. House,Clay Padgett,DEM,400201,0,0,5,5,02
Leflore,Governor,Mick Cornett,REP,400202,0,0,6,6,
Leflore,Governor,Kevin Stitt,REP,400202,2,0,6,8,
Leflore,Lieutenant Governor,Dana Murphy,REP,400202,2,0,4,6,
Leflore,Lieutenant Governor,Matt Pinnell,REP,400202,0,0,8,8,
Leflore,State Auditor,Cindy Byrd,REP,400202,2,0,6,8,
Leflore,State Auditor,Charlie Prater,REP,400202,0,0,6,6,
Leflore,Attorney General,Mike Hunter,REP,400202,0,0,1,1,
Leflore,Attorney General,Gentner Drummond,REP,400202,2,0,11,13,
Leflore,Superintendent of Public Instruction,Joy Hofmeister,REP,400202,2,0,2,4,
Leflore,Superintendent of Public Instruction,Linda Murphy,REP,400202,0,0,10,10,
Leflore,Commissioner of Labor,Cathy Costello,REP,400202,2,0,6,8,
Leflore,Commissioner of Labor,Leslie Osborn,REP,400202,0,0,6,6,
Leflore,Corporation Commissioner,Bob Anthony,REP,400202,2,0,2,4,
Leflore,Corporation Commissioner,Brian Bingman,REP,400202,0,0,10,10,
Leflore,Governor,Chris Powell,LIB,400202,0,0,0,0,
Leflore,Governor,Rex Lawhorn,LIB,400202,0,0,0,0,
Leflore,Corporation Commissioner,Ashley Nicole Mccray,DEM,400202,0,1,4,5,
Leflore,Corporation Commissioner,Blake Cummings,DEM,400202,0,0,10,10,
Leflore,U.S. House,Jason Nichols,DEM,400202,0,1,7,8,02
Leflore,U.S. House,Clay Padgett,DEM,400202,0,0,7,7,02
Leflore,Governor,Mick Cornett,REP,400203,4,15,55,74,
Leflore,Governor,Kevin Stitt,REP,400203,1,12,83,96,
Leflore,Lieutenant Governor,Dana Murphy,REP,400203,2,17,56,75,
Leflore,Lieutenant Governor,Matt Pinnell,REP,400203,3,9,81,93,
Leflore,State Auditor,Cindy Byrd,REP,400203,2,18,78,98,
Leflore,State Auditor,Charlie Prater,REP,400203,3,9,53,65,
Leflore,Attorney General,Mike Hunter,REP,400203,2,10,63,75,
Leflore,Attorney General,Gentner Drummond,REP,400203,3,16,67,86,
Leflore,Superintendent of Public Instruction,Joy Hofmeister,REP,400203,3,15,48,66,
Leflore,Superintendent of Public Instruction,Linda Murphy,REP,400203,2,12,87,101,
Leflore,Commissioner of Labor,Cathy Costello,REP,400203,4,15,68,87,
Leflore,Commissioner of Labor,Leslie Osborn,REP,400203,1,10,60,71,
Leflore,Corporation Commissioner,Bob Anthony,REP,400203,2,18,61,81,
Leflore,Corporation Commissioner,Brian Bingman,REP,400203,3,8,66,77,
Leflore,Governor,Chris Powell,LIB,400203,0,0,0,0,
Leflore,Governor,Rex Lawhorn,LIB,400203,0,0,0,0,
Leflore,Corporation Commissioner,Ashley Nicole Mccray,DEM,400203,4,11,149,164,
Leflore,Corporation Commissioner,Blake Cummings,DEM,400203,2,13,127,142,
Leflore,U.S. House,Jason Nichols,DEM,400203,2,6,145,153,02
Leflore,U.S. House,Clay Padgett,DEM,400203,4,20,129,153,02
Leflore,Governor,Mick Cornett,REP,400204,1,4,42,47,
Leflore,Governor,Kevin Stitt,REP,400204,0,8,56,64,
Leflore,Lieutenant Governor,Dana Murphy,REP,400204,1,11,27,39,
Leflore,Lieutenant Governor,Matt Pinnell,REP,400204,0,1,68,69,
Leflore,State Auditor,Cindy Byrd,REP,400204,1,9,53,63,
Leflore,State Auditor,Charlie Prater,REP,400204,0,3,39,42,
Leflore,Attorney General,Mike Hunter,REP,400204,0,4,46,50,
Leflore,Attorney General,Gentner Drummond,REP,400204,1,8,50,59,
Leflore,Superintendent of Public Instruction,Joy Hofmeister,REP,400204,1,4,38,43,
Leflore,Superintendent of Public Instruction,Linda Murphy,REP,400204,0,8,58,66,
Leflore,Commissioner of Labor,Cathy Costello,REP,400204,1,6,43,50,
Leflore,Commissioner of Labor,Leslie Osborn,REP,400204,0,6,49,55,
Leflore,Corporation Commissioner,Bob Anthony,REP,400204,1,6,49,56,
Leflore,Corporation Commissioner,Brian Bingman,REP,400204,0,6,46,52,
Leflore,Governor,Chris Powell,LIB,400204,0,0,0,0,
Leflore,Governor,Rex Lawhorn,LIB,400204,0,0,0,0,
Leflore,Corporation Commissioner,Ashley Nicole Mccray,DEM,400204,4,5,85,94,
Leflore,Corporation Commissioner,Blake Cummings,DEM,400204,2,5,62,69,
Leflore,U.S. House,Jason Nichols,DEM,400204,5,4,74,83,02
Leflore,U.S. House,Clay Padgett,DEM,400204,1,7,78,86,02
Leflore,Governor,Mick Cornett,REP,400205,0,2,17,19,
Leflore,Governor,Kevin Stitt,REP,400205,0,0,16,16,
Leflore,Lieutenant Governor,Dana Murphy,REP,400205,0,0,19,19,
Leflore,Lieutenant Governor,Matt Pinnell,REP,400205,0,2,13,15,
Leflore,State Auditor,Cindy Byrd,REP,400205,0,1,20,21,
Leflore,State Auditor,Charlie Prater,REP,400205,0,1,11,12,
Leflore,Attorney General,Mike Hunter,REP,400205,0,2,13,15,
Leflore,Attorney General,Gentner Drummond,REP,400205,0,0,20,20,
Leflore,Superintendent of Public Instruction,Joy Hofmeister,REP,400205,0,1,16,17,
Leflore,Superintendent of Public Instruction,Linda Murphy,REP,400205,0,1,15,16,
Leflore,Commissioner of Labor,Cathy Costello,REP,400205,0,2,20,22,
Leflore,Commissioner of Labor,Leslie Osborn,REP,400205,0,0,10,10,
Leflore,Corporation Commissioner,Bob Anthony,REP,400205,0,0,14,14,
Leflore,Corporation Commissioner,Brian Bingman,REP,400205,0,2,16,18,
Leflore,Governor,Chris Powell,LIB,400205,0,0,0,0,
Leflore,Governor,Rex Lawhorn,LIB,400205,0,0,0,0,
Leflore,Corporation Commissioner,Ashley Nicole Mccray,DEM,400205,0,5,36,41,
Leflore,Corporation Commissioner,Blake Cummings,DEM,400205,0,4,34,38,
Leflore,U.S. House,Jason Nichols,DEM,400205,0,4,35,39,02
Leflore,U.S. House,Clay Padgett,DEM,400205,0,5,34,39,02
Leflore,Governor,Mick Cornett,REP,400207,2,3,32,37,
Leflore,Governor,Kevin Stitt,REP,400207,0,12,49,61,
Leflore,Lieutenant Governor,Dana Murphy,REP,400207,2,5,29,36,
Leflore,Lieutenant Governor,Matt Pinnell,REP,400207,0,10,53,63,
Leflore,State Auditor,Cindy Byrd,REP,400207,2,8,50,60,
Leflore,State Auditor,Charlie Prater,REP,400207,0,6,32,38,
Leflore,Attorney General,Mike Hunter,REP,400207,0,7,41,48,
Leflore,Attorney General,Gentner Drummond,REP,400207,2,8,41,51,
Leflore,Superintendent of Public Instruction,Joy Hofmeister,REP,400207,0,8,32,40,
Leflore,Superintendent of Public Instruction,Linda Murphy,REP,400207,2,6,50,58,
Leflore,Commissioner of Labor,Cathy Costello,REP,400207,2,9,42,53,
Leflore,Commissioner of Labor,Leslie Osborn,REP,400207,0,6,40,46,
Leflore,Corporation Commissioner,Bob Anthony,REP,400207,0,11,44,55,
Leflore,Corporation Commissioner,Brian Bingman,REP,400207,2,3,35,40,
Leflore,Governor,Chris Powell,LIB,400207,0,0,0,0,
Leflore,Governor,Rex Lawhorn,LIB,400207,0,0,0,0,
Leflore,Corporation Commissioner,Ashley Nicole Mccray,DEM,400207,0,9,79,88,
Leflore,Corporation Commissioner,Blake Cummings,DEM,400207,2,3,76,81,
Leflore,U.S. House,Jason Nichols,DEM,400207,0,2,74,76,02
Leflore,U.S. House,Clay Padgett,DEM,400207,2,10,83,95,02
Leflore,Governor,Mick Cornett,REP,400208,0,1,21,22,
Leflore,Governor,Kevin Stitt,REP,400208,0,6,33,39,
Leflore,Lieutenant Governor,Dana Murphy,REP,400208,0,2,17,19,
Leflore,Lieutenant Governor,Matt Pinnell,REP,400208,0,5,36,41,
Leflore,State Auditor,Cindy Byrd,REP,400208,0,3,33,36,
Leflore,State Auditor,Charlie Prater,REP,400208,0,3,21,24,
Leflore,Attorney General,Mike Hunter,REP,400208,0,2,31,33,
Leflore,Attorney General,Gentner Drummond,REP,400208,0,5,23,28,
Leflore,Superintendent of Public Instruction,Joy Hofmeister,REP,400208,0,3,24,27,
Leflore,Superintendent of Public Instruction,Linda Murphy,REP,400208,0,2,29,31,
Leflore,Commissioner of Labor,Cathy Costello,REP,400208,0,3,24,27,
Leflore,Commissioner of Labor,Leslie Osborn,REP,400208,0,3,28,31,
Leflore,Corporation Commissioner,Bob Anthony,REP,400208,0,4,33,37,
Leflore,Corporation Commissioner,Brian Bingman,REP,400208,0,2,20,22,
Leflore,Governor,Chris Powell,LIB,400208,0,0,0,0,
Leflore,Governor,Rex Lawhorn,LIB,400208,0,0,0,0,
Leflore,Corporation Commissioner,Ashley Nicole Mccray,DEM,400208,0,7,48,55,
Leflore,Corporation Commissioner,Blake Cummings,DEM,400208,2,9,50,61,
Leflore,U.S. House,Jason Nichols,DEM,400208,1,5,50,56,02
Leflore,U.S. House,Clay Padgett,DEM,400208,1,12,50,63,02
Leflore,Governor,Mick Cornett,REP,400210,0,2,19,21,
Leflore,Governor,Kevin Stitt,REP,400210,4,5,55,64,
Leflore,Lieutenant Governor,Dana Murphy,REP,400210,0,2,30,32,
Leflore,Lieutenant Governor,Matt Pinnell,REP,400210,4,5,43,52,
Leflore,State Auditor,Cindy Byrd,REP,400210,2,5,37,44,
Leflore,State Auditor,Charlie Prater,REP,400210,2,2,33,37,
Leflore,Attorney General,Mike Hunter,REP,400210,0,2,39,41,
Leflore,Attorney General,Gentner Drummond,REP,400210,4,5,33,42,
Leflore,Superintendent of Public Instruction,Joy Hofmeister,REP,400210,1,3,32,36,
Leflore,Superintendent of Public Instruction,Linda Murphy,REP,400210,3,5,41,49,
Leflore,Commissioner of Labor,Cathy Costello,REP,400210,3,4,29,36,
Leflore,Commissioner of Labor,Leslie Osborn,REP,400210,1,3,42,46,
Leflore,Corporation Commissioner,Bob Anthony,REP,400210,1,3,40,44,
Leflore,Corporation Commissioner,Brian Bingman,REP,400210,3,4,31,38,
Leflore,Governor,Chris Powell,LIB,400210,0,0,0,0,
Leflore,Governor,Rex Lawhorn,LIB,400210,0,0,0,0,
Leflore,Corporation Commissioner,Ashley Nicole Mccray,DEM,400210,2,10,37,49,
Leflore,Corporation Commissioner,Blake Cummings,DEM,400210,0,8,30,38,
Leflore,U.S. House,Jason Nichols,DEM,400210,2,8,35,45,02
Leflore,U.S. House,Clay Padgett,DEM,400210,0,10,33,43,02
Leflore,Governor,Mick Cornett,REP,400211,0,1,17,18,
Leflore,Governor,Kevin Stitt,REP,400211,0,0,25,25,
Leflore,Lieutenant Governor,Dana Murphy,REP,400211,0,1,17,18,
Leflore,Lieutenant Governor,Matt Pinnell,REP,400211,0,0,25,25,
Leflore,State Auditor,Cindy Byrd,REP,400211,0,1,28,29,
Leflore,State Auditor,Charlie Prater,REP,400211,0,0,14,14,
Leflore,Attorney General,Mike Hunter,REP,400211,0,1,18,19,
Leflore,Attorney General,Gentner Drummond,REP,400211,0,0,24,24,
Leflore,Superintendent of Public Instruction,Joy Hofmeister,REP,400211,0,0,15,15,
Leflore,Superintendent of Public Instruction,Linda Murphy,REP,400211,0,1,26,27,
Leflore,Commissioner of Labor,Cathy Costello,REP,400211,0,0,26,26,
Leflore,Commissioner of Labor,Leslie Osborn,REP,400211,0,1,16,17,
Leflore,Corporation Commissioner,Bob Anthony,REP,400211,0,0,25,25,
Leflore,Corporation Commissioner,Brian Bingman,REP,400211,0,1,16,17,
Leflore,Governor,Chris Powell,LIB,400211,0,0,0,0,
Leflore,Governor,Rex Lawhorn,LIB,400211,0,0,0,0,
Leflore,Corporation Commissioner,Ashley Nicole Mccray,DEM,400211,0,0,13,13,
Leflore,Corporation Commissioner,Blake Cummings,DEM,400211,0,0,31,31,
Leflore,U.S. House,Jason Nichols,DEM,400211,0,0,19,19,02
Leflore,U.S. House,Clay Padgett,DEM,400211,0,0,25,25,02
Leflore,Governor,Mick Cornett,REP,400212,1,3,33,37,
Leflore,Governor,Kevin Stitt,REP,400212,2,3,54,59,
Leflore,Lieutenant Governor,Dana Murphy,REP,400212,1,4,36,41,
Leflore,Lieutenant Governor,Matt Pinnell,REP,400212,2,2,48,52,
Leflore,State Auditor,Cindy Byrd,REP,400212,1,5,52,58,
Leflore,State Auditor,Charlie Prater,REP,400212,2,0,30,32,
Leflore,Attorney General,Mike Hunter,REP,400212,2,3,35,40,
Leflore,Attorney General,Gentner Drummond,REP,400212,1,3,48,52,
Leflore,Superintendent of Public Instruction,Joy Hofmeister,REP,400212,0,2,43,45,
Leflore,Superintendent of Public Instruction,Linda Murphy,REP,400212,3,4,42,49,
Leflore,Commissioner of Labor,Cathy Costello,REP,400212,1,4,37,42,
Leflore,Commissioner of Labor,Leslie Osborn,REP,400212,2,1,44,47,
Leflore,Corporation Commissioner,Bob Anthony,REP,400212,3,1,34,38,
Leflore,Corporation Commissioner,Brian Bingman,REP,400212,0,4,48,52,
Leflore,Governor,Chris Powell,LIB,400212,0,0,1,1,
Leflore,Governor,Rex Lawhorn,LIB,400212,0,0,0,0,
Leflore,Corporation Commissioner,Ashley Nicole Mccray,DEM,400212,2,8,50,60,
Leflore,Corporation Commissioner,Blake Cummings,DEM,400212,1,6,33,40,
Leflore,U.S. House,Jason Nichols,DEM,400212,0,5,32,37,02
Leflore,U.S. House,Clay Padgett,DEM,400212,3,11,51,65,02
Leflore,Governor,Mick Cornett,REP,400213,0,0,4,4,
Leflore,Governor,Kevin Stitt,REP,400213,0,0,1,1,
Leflore,Lieutenant Governor,Dana Murphy,REP,400213,0,0,2,2,
Leflore,Lieutenant Governor,Matt Pinnell,REP,400213,0,0,3,3,
Leflore,State Auditor,Cindy Byrd,REP,400213,0,0,4,4,
Leflore,State Auditor,Charlie Prater,REP,400213,0,0,1,1,
Leflore,Attorney General,Mike Hunter,REP,400213,0,0,3,3,
Leflore,Attorney General,Gentner Drummond,REP,400213,0,0,2,2,
Leflore,Superintendent of Public Instruction,Joy Hofmeister,REP,400213,0,0,2,2,
Leflore,Superintendent of Public Instruction,Linda Murphy,REP,400213,0,0,3,3,
Leflore,Commissioner of Labor,Cathy Costello,REP,400213,0,0,3,3,
Leflore,Commissioner of Labor,Leslie Osborn,REP,400213,0,0,2,2,
Leflore,Corporation Commissioner,Bob Anthony,REP,400213,0,0,4,4,
Leflore,Corporation Commissioner,Brian Bingman,REP,400213,0,0,1,1,
Leflore,State House,Josh Hass,REP,400213,0,0,1,1,17
Leflore,State House,Jim Grego,REP,400213,0,0,4,4,17
Leflore,Governor,Chris Powell,LIB,400213,0,0,0,0,
Leflore,Governor,Rex Lawhorn,LIB,400213,0,0,0,0,
Leflore,Corporation Commissioner,Ashley Nicole Mccray,DEM,400213,0,0,5,5,
Leflore,Corporation Commissioner,Blake Cummings,DEM,400213,0,0,9,9,
Leflore,U.S. House,Jason Nichols,DEM,400213,0,0,5,5,02
Leflore,U.S. House,Clay Padgett,DEM,400213,0,0,9,9,02
Leflore,Governor,Mick Cornett,REP,400214,0,0,1,1,
Leflore,Governor,Kevin Stitt,REP,400214,0,0,5,5,
Leflore,Lieutenant Governor,Dana Murphy,REP,400214,0,0,2,2,
Leflore,Lieutenant Governor,Matt Pinnell,REP,400214,0,0,4,4,
Leflore,State Auditor,Cindy Byrd,REP,400214,0,0,1,1,
Leflore,State Auditor,Charlie Prater,REP,400214,0,0,5,5,
Leflore,Attorney General,Mike Hunter,REP,400214,0,0,4,4,
Leflore,Attorney General,Gentner Drummond,REP,400214,0,0,2,2,
Leflore,Superintendent of Public Instruction,Joy Hofmeister,REP,400214,0,0,1,1,
Leflore,Superintendent of Public Instruction,Linda Murphy,REP,400214,0,0,5,5,
Leflore,Commissioner of Labor,Cathy Costello,REP,400214,0,0,2,2,
Leflore,Commissioner of Labor,Leslie Osborn,REP,400214,0,0,4,4,
Leflore,Corporation Commissioner,Bob Anthony,REP,400214,0,0,4,4,
Leflore,Corporation Commissioner,Brian Bingman,REP,400214,0,0,2,2,
Leflore,State House,Josh Hass,REP,400214,0,0,3,3,17
Leflore,State House,Jim Grego,REP,400214,0,0,2,2,17
Leflore,Governor,Chris Powell,LIB,400214,0,0,0,0,
Leflore,Governor,Rex Lawhorn,LIB,400214,0,0,0,0,
Leflore,Corporation Commissioner,Ashley Nicole Mccray,DEM,400214,1,1,6,8,
Leflore,Corporation Commissioner,Blake Cummings,DEM,400214,1,0,7,8,
Leflore,U.S. House,Jason Nichols,DEM,400214,0,0,4,4,02
Leflore,U.S. House,Clay Padgett,DEM,400214,2,1,9,12,02
Leflore,Governor,Mick Cornett,REP,400215,2,0,9,11,
Leflore,Governor,Kevin Stitt,REP,400215,0,2,7,9,
Leflore,Lieutenant Governor,Dana Murphy,REP,400215,0,0,6,6,
Leflore,Lieutenant Governor,Matt Pinnell,REP,400215,2,2,8,12,
Leflore,State Auditor,Cindy Byrd,REP,400215,0,0,9,9,
Leflore,State Auditor,Charlie Prater,REP,400215,0,2,5,7,
Leflore,Attorney General,Mike Hunter,REP,400215,0,0,6,6,
Leflore,Attorney General,Gentner Drummond,REP,400215,2,2,8,12,
Leflore,Superintendent of Public Instruction,Joy Hofmeister,REP,400215,0,0,7,7,
Leflore,Superintendent of Public Instruction,Linda Murphy,REP,400215,2,2,8,12,
Leflore,Commissioner of Labor,Cathy Costello,REP,400215,0,2,8,10,
Leflore,Commissioner of Labor,Leslie Osborn,REP,400215,1,0,7,8,
Leflore,Corporation Commissioner,Bob Anthony,REP,400215,2,2,7,11,
Leflore,Corporation Commissioner,Brian Bingman,REP,400215,0,0,8,8,
Leflore,State House,Josh Hass,REP,400215,0,2,12,14,17
Leflore,State House,Jim Grego,REP,400215,2,0,4,6,17
Leflore,Governor,Chris Powell,LIB,400215,0,0,0,0,
Leflore,Governor,Rex Lawhorn,LIB,400215,0,0,0,0,
Leflore,Corporation Commissioner,Ashley Nicole Mccray,DEM,400215,0,0,10,10,
Leflore,Corporation Commissioner,Blake Cummings,DEM,400215,1,1,19,21,
Leflore,U.S. House,Jason Nichols,DEM,400215,0,0,7,7,02
Leflore,U.S. House,Clay Padgett,DEM,400215,1,1,22,24,02
Leflore,Governor,Mick Cornett,REP,400301,0,0,8,8,
Leflore,Governor,Kevin Stitt,REP,400301,0,0,20,20,
Leflore,Lieutenant Governor,Dana Murphy,REP,400301,0,0,5,5,
Leflore,Lieutenant Governor,Matt Pinnell,REP,400301,0,0,24,24,
Leflore,State Auditor,Cindy Byrd,REP,400301,0,0,16,16,
Leflore,State Auditor,Charlie Prater,REP,400301,0,0,14,14,
Leflore,Attorney General,Mike Hunter,REP,400301,0,0,15,15,
Leflore,Attorney General,Gentner Drummond,REP,400301,0,0,13,13,
Leflore,Superintendent of Public Instruction,Joy Hofmeister,REP,400301,0,0,15,15,
Leflore,Superintendent of Public Instruction,Linda Murphy,REP,400301,0,0,14,14,
Leflore,Commissioner of Labor,Cathy Costello,REP,400301,0,0,12,12,
Leflore,Commissioner of Labor,Leslie Osborn,REP,400301,0,0,17,17,
Leflore,Corporation Commissioner,Bob Anthony,REP,400301,1,0,6,7,
Leflore,Corporation Commissioner,Brian Bingman,REP,400301,0,0,23,23,
Leflore,State House,Josh Hass,REP,400301,0,0,10,10,17
Leflore,State House,Jim Grego,REP,400301,1,0,20,21,17
Leflore,Governor,Chris Powell,LIB,400301,0,0,0,0,
Leflore,Governor,Rex Lawhorn,LIB,400301,0,0,0,0,
Leflore,Corporation Commissioner,Ashley Nicole Mccray,DEM,400301,0,0,41,41,
Leflore,Corporation Commissioner,Blake Cummings,DEM,400301,1,0,34,35,
Leflore,U.S. House,Jason Nichols,DEM,400301,0,0,33,33,02
Leflore,U.S. House,Clay Padgett,DEM,400301,1,0,42,43,02
Leflore,Governor,Mick Cornett,REP,400302,0,0,10,10,
Leflore,Governor,Kevin Stitt,REP,400302,2,1,25,28,
Leflore,Lieutenant Governor,Dana Murphy,REP,400302,1,0,12,13,
Leflore,Lieutenant Governor,Matt Pinnell,REP,400302,2,1,22,25,
Leflore,State Auditor,Cindy Byrd,REP,400302,1,0,16,17,
Leflore,State Auditor,Charlie Prater,REP,400302,2,1,16,19,
Leflore,Attorney General,Mike Hunter,REP,400302,0,0,13,13,
Leflore,Attorney General,Gentner Drummond,REP,400302,3,1,21,25,
Leflore,Superintendent of Public Instruction,Joy Hofmeister,REP,400302,0,0,10,10,
Leflore,Superintendent of Public Instruction,Linda Murphy,REP,400302,3,1,21,25,
Leflore,Commissioner of Labor,Cathy Costello,REP,400302,2,1,19,22,
Leflore,Commissioner of Labor,Leslie Osborn,REP,400302,1,0,14,15,
Leflore,Corporation Commissioner,Bob Anthony,REP,400302,0,1,12,13,
Leflore,Corporation Commissioner,Brian Bingman,REP,400302,3,0,21,24,
Leflore,Governor,Chris Powell,LIB,400302,0,0,0,0,
Leflore,Governor,Rex Lawhorn,LIB,400302,0,0,0,0,
Leflore,Corporation Commissioner,Ashley Nicole Mccray,DEM,400302,2,0,15,17,
Leflore,Corporation Commissioner,Blake Cummings,DEM,400302,4,0,13,17,
Leflore,U.S. House,Jason Nichols,DEM,400302,3,0,19,22,02
Leflore,U.S. House,Clay Padgett,DEM,400302,3,0,9,12,02
Leflore,Governor,Mick Cornett,REP,400303,0,0,3,3,
Leflore,Governor,Kevin Stitt,REP,400303,2,0,14,16,
Leflore,Lieutenant Governor,Dana Murphy,REP,400303,2,0,3,5,
Leflore,Lieutenant Governor,Matt Pinnell,REP,400303,0,0,14,14,
Leflore,State Auditor,Cindy Byrd,REP,400303,2,0,5,7,
Leflore,State Auditor,Charlie Prater,REP,400303,0,0,12,12,
Leflore,Attorney General,Mike Hunter,REP,400303,0,0,3,3,
Leflore,Attorney General,Gentner Drummond,REP,400303,2,0,13,15,
Leflore,Superintendent of Public Instruction,Joy Hofmeister,REP,400303,2,0,5,7,
Leflore,Superintendent of Public Instruction,Linda Murphy,REP,400303,0,0,12,12,
Leflore,Commissioner of Labor,Cathy Costello,REP,400303,1,0,3,4,
Leflore,Commissioner of Labor,Leslie Osborn,REP,400303,1,0,12,13,
Leflore,Corporation Commissioner,Bob Anthony,REP,400303,1,0,7,8,
Leflore,Corporation Commissioner,Brian Bingman,REP,400303,1,0,9,10,
Leflore,Governor,Chris Powell,LIB,400303,0,0,0,0,
Leflore,Governor,Rex Lawhorn,LIB,400303,0,0,0,0,
Leflore,Corporation Commissioner,Ashley Nicole Mccray,DEM,400303,0,0,7,7,
Leflore,Corporation Commissioner,Blake Cummings,DEM,400303,0,0,7,7,
Leflore,U.S. House,Jason Nichols,DEM,400303,0,0,7,7,02
Leflore,U.S. House,Clay Padgett,DEM,400303,0,0,7,7,02
Leflore,Governor,Mick Cornett,REP,400304,0,0,4,4,
Leflore,Governor,Kevin Stitt,REP,400304,0,0,12,12,
Leflore,Lieutenant Governor,Dana Murphy,REP,400304,0,0,8,8,
Leflore,Lieutenant Governor,Matt Pinnell,REP,400304,0,0,8,8,
Leflore,State Auditor,Cindy Byrd,REP,400304,0,0,7,7,
Leflore,State Auditor,Charlie Prater,REP,400304,0,0,8,8,
Leflore,Attorney General,Mike Hunter,REP,400304,0,0,9,9,
Leflore,Attorney General,Gentner Drummond,REP,400304,0,0,8,8,
Leflore,Superintendent of Public Instruction,Joy Hofmeister,REP,400304,0,0,5,5,
Leflore,Superintendent of Public Instruction,Linda Murphy,REP,400304,0,0,10,10,
Leflore,Commissioner of Labor,Cathy Costello,REP,400304,0,0,10,10,
Leflore,Commissioner of Labor,Leslie Osborn,REP,400304,0,0,4,4,
Leflore,Corporation Commissioner,Bob Anthony,REP,400304,0,0,4,4,
Leflore,Corporation Commissioner,Brian Bingman,REP,400304,0,0,11,11,
Leflore,Governor,Chris Powell,LIB,400304,0,0,0,0,
Leflore,Governor,Rex Lawhorn,LIB,400304,0,0,0,0,
Leflore,Corporation Commissioner,Ashley Nicole Mccray,DEM,400304,0,0,7,7,
Leflore,Corporation Commissioner,Blake Cummings,DEM,400304,0,0,8,8,
Leflore,U.S. House,Jason Nichols,DEM,400304,0,0,10,10,02
Leflore,U.S. House,Clay Padgett,DEM,400304,0,0,6,6,02
Leflore,Governor,Mick Cornett,REP,400305,0,0,2,2,
Leflore,Governor,Kevin Stitt,REP,400305,0,2,7,9,
Leflore,Lieutenant Governor,Dana Murphy,REP,400305,0,0,3,3,
Leflore,Lieutenant Governor,Matt Pinnell,REP,400305,0,2,6,8,
Leflore,State Auditor,Cindy Byrd,REP,400305,0,0,4,4,
Leflore,State Auditor,Charlie Prater,REP,400305,0,2,5,7,
Leflore,Attorney General,Mike Hunter,REP,400305,0,0,3,3,
Leflore,Attorney General,Gentner Drummond,REP,400305,0,2,7,9,
Leflore,Superintendent of Public Instruction,Joy Hofmeister,REP,400305,0,0,6,6,
Leflore,Superintendent of Public Instruction,Linda Murphy,REP,400305,0,2,3,5,
Leflore,Commissioner of Labor,Cathy Costello,REP,400305,0,0,3,3,
Leflore,Commissioner of Labor,Leslie Osborn,REP,400305,0,2,7,9,
Leflore,Corporation Commissioner,Bob Anthony,REP,400305,0,0,6,6,
Leflore,Corporation Commissioner,Brian Bingman,REP,400305,0,2,3,5,
Leflore,Governor,Chris Powell,LIB,400305,0,0,0,0,
Leflore,Governor,Rex Lawhorn,LIB,400305,0,0,0,0,
Leflore,Corporation Commissioner,Ashley Nicole Mccray,DEM,400305,0,2,2,4,
Leflore,Corporation Commissioner,Blake Cummings,DEM,400305,0,0,10,10,
Leflore,U.S. House,Jason Nichols,DEM,400305,0,1,4,5,02
Leflore,U.S. House,Clay Padgett,DEM,400305,0,1,5,6,02
Leflore,Governor,Mick Cornett,REP,400306,1,0,1,2,
Leflore,Governor,Kevin Stitt,REP,400306,1,0,15,16,
Leflore,Lieutenant Governor,Dana Murphy,REP,400306,0,0,4,4,
Leflore,Lieutenant Governor,Matt Pinnell,REP,400306,2,0,11,13,
Leflore,State Auditor,Cindy Byrd,REP,400306,0,0,8,8,
Leflore,State Auditor,Charlie Prater,REP,400306,2,0,6,8,
Leflore,Attorney General,Mike Hunter,REP,400306,0,0,7,7,
Leflore,Attorney General,Gentner Drummond,REP,400306,2,0,9,11,
Leflore,Superintendent of Public Instruction,Joy Hofmeister,REP,400306,1,0,5,6,
Leflore,Superintendent of Public Instruction,Linda Murphy,REP,400306,1,0,10,11,
Leflore,Commissioner of Labor,Cathy Costello,REP,400306,1,0,4,5,
Leflore,Commissioner of Labor,Leslie Osborn,REP,400306,1,0,9,10,
Leflore,Corporation Commissioner,Bob Anthony,REP,400306,0,0,3,3,
Leflore,Corporation Commissioner,Brian Bingman,REP,400306,2,0,12,14,
Leflore,Governor,Chris Powell,LIB,400306,0,0,0,0,
Leflore,Governor,Rex Lawhorn,LIB,400306,0,0,0,0,
Leflore,Corporation Commissioner,Ashley Nicole Mccray,DEM,400306,0,0,1,1,
Leflore,Corporation Commissioner,Blake Cummings,DEM,400306,0,0,2,2,
Leflore,U.S. House,Jason Nichols,DEM,400306,0,0,1,1,02
Leflore,U.S. House,Clay Padgett,DEM,400306,0,0,3,3,02
Leflore,Governor,Mick Cornett,REP,400309,0,0,0,0,
Leflore,Governor,Kevin Stitt,REP,400309,0,0,7,7,
Leflore,Lieutenant Governor,Dana Murphy,REP,400309,0,0,2,2,
Leflore,Lieutenant Governor,Matt Pinnell,REP,400309,0,0,5,5,
Leflore,State Auditor,Cindy Byrd,REP,400309,0,0,3,3,
Leflore,State Auditor,Charlie Prater,REP,400309,0,0,4,4,
Leflore,Attorney General,Mike Hunter,REP,400309,0,0,3,3,
Leflore,Attorney General,Gentner Drummond,REP,400309,0,0,4,4,
Leflore,Superintendent of Public Instruction,Joy Hofmeister,REP,400309,0,0,2,2,
Leflore,Superintendent of Public Instruction,Linda Murphy,REP,400309,0,0,5,5,
Leflore,Commissioner of Labor,Cathy Costello,REP,400309,0,0,2,2,
Leflore,Commissioner of Labor,Leslie Osborn,REP,400309,0,0,5,5,
Leflore,Corporation Commissioner,Bob Anthony,REP,400309,0,0,5,5,
Leflore,Corporation Commissioner,Brian Bingman,REP,400309,0,0,2,2,
Leflore,Governor,Chris Powell,LIB,400309,0,0,0,0,
Leflore,Governor,Rex Lawhorn,LIB,400309,0,0,0,0,
Leflore,Corporation Commissioner,Ashley Nicole Mccray,DEM,400309,0,0,5,5,
Leflore,Corporation Commissioner,Blake Cummings,DEM,400309,0,0,6,6,
Leflore,U.S. House,Jason Nichols,DEM,400309,0,0,2,2,02
Leflore,U.S. House,Clay Padgett,DEM,400309,0,0,9,9,02
Leflore,Governor,Mick Cornett,REP,400310,0,0,16,16,
Leflore,Governor,Kevin Stitt,REP,400310,0,1,33,34,
Leflore,Lieutenant Governor,Dana Murphy,REP,400310,0,1,16,17,
Leflore,Lieutenant Governor,Matt Pinnell,REP,400310,0,0,33,33,
Leflore,State Auditor,Cindy Byrd,REP,400310,0,0,20,20,
Leflore,State Auditor,Charlie Prater,REP,400310,0,1,28,29,
Leflore,Attorney General,Mike Hunter,REP,400310,0,1,26,27,
Leflore,Attorney General,Gentner Drummond,REP,400310,0,0,21,21,
Leflore,Superintendent of Public Instruction,Joy Hofmeister,REP,400310,0,0,19,19,
Leflore,Superintendent of Public Instruction,Linda Murphy,REP,400310,0,1,27,28,
Leflore,Commissioner of Labor,Cathy Costello,REP,400310,0,0,28,28,
Leflore,Commissioner of Labor,Leslie Osborn,REP,400310,0,1,19,20,
Leflore,Corporation Commissioner,Bob Anthony,REP,400310,0,1,31,32,
Leflore,Corporation Commissioner,Brian Bingman,REP,400310,0,0,17,17,
Leflore,Governor,Chris Powell,LIB,400310,0,0,0,0,
Leflore,Governor,Rex Lawhorn,LIB,400310,0,0,0,0,
Leflore,Corporation Commissioner,Ashley Nicole Mccray,DEM,400310,4,3,23,30,
Leflore,Corporation Commissioner,Blake Cummings,DEM,400310,2,0,22,24,
Leflore,U.S. House,Jason Nichols,DEM,400310,2,2,22,26,02
Leflore,U.S. House,Clay Padgett,DEM,400310,4,1,23,28,02
Leflore,Governor,Mick Cornett,REP,400311,0,0,8,8,
Leflore,Governor,Kevin Stitt,REP,400311,1,0,18,19,
Leflore,Lieutenant Governor,Dana Murphy,REP,400311,0,0,9,9,
Leflore,Lieutenant Governor,Matt Pinnell,REP,400311,1,0,17,18,
Leflore,State Auditor,Cindy Byrd,REP,400311,0,0,14,14,
Leflore,State Auditor,Charlie Prater,REP,400311,1,0,12,13,
Leflore,Attorney General,Mike Hunter,REP,400311,0,0,5,5,
Leflore,Attorney General,Gentner Drummond,REP,400311,1,0,21,22,
Leflore,Superintendent of Public Instruction,Joy Hofmeister,REP,400311,0,0,11,11,
Leflore,Superintendent of Public Instruction,Linda Murphy,REP,400311,1,0,13,14,
Leflore,Commissioner of Labor,Cathy Costello,REP,400311,1,0,20,21,
Leflore,Commissioner of Labor,Leslie Osborn,REP,400311,0,0,6,6,
Leflore,Corporation Commissioner,Bob Anthony,REP,400311,1,0,13,14,
Leflore,Corporation Commissioner,Brian Bingman,REP,400311,0,0,11,11,
Leflore,Governor,Chris Powell,LIB,400311,0,0,0,0,
Leflore,Governor,Rex Lawhorn,LIB,400311,0,0,0,0,
Leflore,Corporation Commissioner,Ashley Nicole Mccray,DEM,400311,0,1,17,18,
Leflore,Corporation Commissioner,Blake Cummings,DEM,400311,0,0,17,17,
Leflore,U.S. House,Jason Nichols,DEM,400311,0,0,13,13,02
Leflore,U.S. House,Clay Padgett,DEM,400311,0,1,22,23,02
Leflore,Governor,Mick Cornett,REP,400312,0,0,4,4,
Leflore,Governor,Kevin Stitt,REP,400312,0,1,15,16,
Leflore,Lieutenant Governor,Dana Murphy,REP,400312,0,0,7,7,
Leflore,Lieutenant Governor,Matt Pinnell,REP,400312,0,1,13,14,
Leflore,State Auditor,Cindy Byrd,REP,400312,0,1,13,14,
Leflore,State Auditor,Charlie Prater,REP,400312,0,0,7,7,
Leflore,Attorney General,Mike Hunter,REP,400312,0,0,11,11,
Leflore,Attorney General,Gentner Drummond,REP,400312,0,1,9,10,
Leflore,Superintendent of Public Instruction,Joy Hofmeister,REP,400312,0,0,4,4,
Leflore,Superintendent of Public Instruction,Linda Murphy,REP,400312,0,1,15,16,
Leflore,Commissioner of Labor,Cathy Costello,REP,400312,0,1,15,16,
Leflore,Commissioner of Labor,Leslie Osborn,REP,400312,0,0,4,4,
Leflore,Corporation Commissioner,Bob Anthony,REP,400312,0,1,10,11,
Leflore,Corporation Commissioner,Brian Bingman,REP,400312,0,0,9,9,
Leflore,Governor,Chris Powell,LIB,400312,0,0,0,0,
Leflore,Governor,Rex Lawhorn,LIB,400312,0,0,0,0,
Leflore,Corporation Commissioner,Ashley Nicole Mccray,DEM,400312,0,4,13,17,
Leflore,Corporation Commissioner,Blake Cummings,DEM,400312,1,0,13,14,
Leflore,U.S. House,Jason Nichols,DEM,400312,1,0,4,5,02
Leflore,U.S. House,Clay Padgett,DEM,400312,0,4,22,26,02
Lincoln,Governor,Mick Cornett,REP,410001,8,4,42,54,
Lincoln,Governor,Kevin Stitt,REP,410001,5,3,62,70,
Lincoln,Lieutenant Governor,Dana Murphy,REP,410001,9,3,42,54,
Lincoln,Lieutenant Governor,Matt Pinnell,REP,410001,4,4,60,68,
Lincoln,State Auditor,Cindy Byrd,REP,410001,7,5,52,64,
Lincoln,State Auditor,Charlie Prater,REP,410001,6,2,50,58,
Lincoln,Attorney General,Mike Hunter,REP,410001,4,4,35,43,
Lincoln,Attorney General,Gentner Drummond,REP,410001,9,3,67,79,
Lincoln,Superintendent of Public Instruction,Joy Hofmeister,REP,410001,6,3,63,72,
Lincoln,Superintendent of Public Instruction,Linda Murphy,REP,410001,7,4,41,52,
Lincoln,Commissioner of Labor,Cathy Costello,REP,410001,6,3,38,47,
Lincoln,Commissioner of Labor,Leslie Osborn,REP,410001,7,4,64,75,
Lincoln,Corporation Commissioner,Bob Anthony,REP,410001,10,6,53,69,
Lincoln,Corporation Commissioner,Brian Bingman,REP,410001,3,1,49,53,
Lincoln,Governor,Chris Powell,LIB,410001,0,0,1,1,
Lincoln,Governor,Rex Lawhorn,LIB,410001,0,0,0,0,
Lincoln,Corporation Commissioner,Ashley Nicole Mccray,DEM,410001,2,0,16,18,
Lincoln,Corporation Commissioner,Blake Cummings,DEM,410001,1,0,21,22,
Lincoln,Governor,Mick Cornett,REP,410002,2,4,85,91,
Lincoln,Governor,Kevin Stitt,REP,410002,2,3,98,103,
Lincoln,Lieutenant Governor,Dana Murphy,REP,410002,1,1,63,65,
Lincoln,Lieutenant Governor,Matt Pinnell,REP,410002,3,6,115,124,
Lincoln,State Auditor,Cindy Byrd,REP,410002,4,3,91,98,
Lincoln,State Auditor,Charlie Prater,REP,410002,0,4,87,91,
Lincoln,Attorney General,Mike Hunter,REP,410002,2,3,76,81,
Lincoln,Attorney General,Gentner Drummond,REP,410002,2,4,106,112,
Lincoln,Superintendent of Public Instruction,Joy Hofmeister,REP,410002,1,2,102,105,
Lincoln,Superintendent of Public Instruction,Linda Murphy,REP,410002,2,4,77,83,
Lincoln,Commissioner of Labor,Cathy Costello,REP,410002,2,3,64,69,
Lincoln,Commissioner of Labor,Leslie Osborn,REP,410002,2,4,111,117,
Lincoln,Corporation Commissioner,Bob Anthony,REP,410002,1,5,85,91,
Lincoln,Corporation Commissioner,Brian Bingman,REP,410002,3,2,94,99,
Lincoln,Governor,Chris Powell,LIB,410002,0,0,0,0,
Lincoln,Governor,Rex Lawhorn,LIB,410002,0,0,0,0,
Lincoln,Corporation Commissioner,Ashley Nicole Mccray,DEM,410002,2,0,25,27,
Lincoln,Corporation Commissioner,Blake Cummings,DEM,410002,0,1,22,23,
Lincoln,Governor,Mick Cornett,REP,410003,5,5,87,97,
Lincoln,Governor,Kevin Stitt,REP,410003,0,6,94,100,
Lincoln,Lieutenant Governor,Dana Murphy,REP,410003,3,2,78,83,
Lincoln,Lieutenant Governor,Matt Pinnell,REP,410003,2,10,102,114,
Lincoln,State Auditor,Cindy Byrd,REP,410003,3,3,81,87,
Lincoln,State Auditor,Charlie Prater,REP,410003,2,9,103,114,
Lincoln,Attorney General,Mike Hunter,REP,410003,3,3,89,95,
Lincoln,Attorney General,Gentner Drummond,REP,410003,2,9,91,102,
Lincoln,Superintendent of Public Instruction,Joy Hofmeister,REP,410003,3,6,96,105,
Lincoln,Superintendent of Public Instruction,Linda Murphy,REP,410003,2,6,84,92,
Lincoln,Commissioner of Labor,Cathy Costello,REP,410003,1,8,89,98,
Lincoln,Commissioner of Labor,Leslie Osborn,REP,410003,4,4,89,97,
Lincoln,Corporation Commissioner,Bob Anthony,REP,410003,2,8,113,123,
Lincoln,Corporation Commissioner,Brian Bingman,REP,410003,3,4,73,80,
Lincoln,Governor,Chris Powell,LIB,410003,0,0,0,0,
Lincoln,Governor,Rex Lawhorn,LIB,410003,0,0,1,1,
Lincoln,Corporation Commissioner,Ashley Nicole Mccray,DEM,410003,1,0,30,31,
Lincoln,Corporation Commissioner,Blake Cummings,DEM,410003,2,2,17,21,
Lincoln,Governor,Mick Cornett,REP,410004,1,0,33,34,
Lincoln,Governor,Kevin Stitt,REP,410004,3,1,82,86,
Lincoln,Lieutenant Governor,Dana Murphy,REP,410004,1,1,34,36,
Lincoln,Lieutenant Governor,Matt Pinnell,REP,410004,3,0,81,84,
Lincoln,State Auditor,Cindy Byrd,REP,410004,1,0,40,41,
Lincoln,State Auditor,Charlie Prater,REP,410004,3,1,74,78,
Lincoln,Attorney General,Mike Hunter,REP,410004,1,1,27,29,
Lincoln,Attorney General,Gentner Drummond,REP,410004,3,0,87,90,
Lincoln,Superintendent of Public Instruction,Joy Hofmeister,REP,410004,1,0,73,74,
Lincoln,Superintendent of Public Instruction,Linda Murphy,REP,410004,3,1,42,46,
Lincoln,Commissioner of Labor,Cathy Costello,REP,410004,4,1,55,60,
Lincoln,Commissioner of Labor,Leslie Osborn,REP,410004,0,0,58,58,
Lincoln,Corporation Commissioner,Bob Anthony,REP,410004,4,1,59,64,
Lincoln,Corporation Commissioner,Brian Bingman,REP,410004,0,0,54,54,
Lincoln,Governor,Chris Powell,LIB,410004,0,0,0,0,
Lincoln,Governor,Rex Lawhorn,LIB,410004,0,0,0,0,
Lincoln,Corporation Commissioner,Ashley Nicole Mccray,DEM,410004,0,0,5,5,
Lincoln,Corporation Commissioner,Blake Cummings,DEM,410004,0,0,7,7,
Lincoln,Governor,Mick Cornett,REP,410005,1,2,55,58,
Lincoln,Governor,Kevin Stitt,REP,410005,0,8,70,78,
Lincoln,Lieutenant Governor,Dana Murphy,REP,410005,1,1,50,52,
Lincoln,Lieutenant Governor,Matt Pinnell,REP,410005,0,9,75,84,
Lincoln,State Auditor,Cindy Byrd,REP,410005,0,2,48,50,
Lincoln,State Auditor,Charlie Prater,REP,410005,1,8,76,85,
Lincoln,Attorney General,Mike Hunter,REP,410005,1,5,49,55,
Lincoln,Attorney General,Gentner Drummond,REP,410005,0,5,75,80,
Lincoln,Superintendent of Public Instruction,Joy Hofmeister,REP,410005,1,2,66,69,
Lincoln,Superintendent of Public Instruction,Linda Murphy,REP,410005,0,8,60,68,
Lincoln,Commissioner of Labor,Cathy Costello,REP,410005,0,3,53,56,
Lincoln,Commissioner of Labor,Leslie Osborn,REP,410005,1,7,72,80,
Lincoln,Corporation Commissioner,Bob Anthony,REP,410005,0,6,70,76,
Lincoln,Corporation Commissioner,Brian Bingman,REP,410005,1,4,54,59,
Lincoln,Governor,Chris Powell,LIB,410005,0,0,1,1,
Lincoln,Governor,Rex Lawhorn,LIB,410005,0,0,0,0,
Lincoln,Corporation Commissioner,Ashley Nicole Mccray,DEM,410005,0,1,22,23,
Lincoln,Corporation Commissioner,Blake Cummings,DEM,410005,1,1,25,27,
Lincoln,Governor,Mick Cornett,REP,410006,1,1,34,36,
Lincoln,Governor,Kevin Stitt,REP,410006,0,1,31,32,
Lincoln,Lieutenant Governor,Dana Murphy,REP,410006,1,0,26,27,
Lincoln,Lieutenant Governor,Matt Pinnell,REP,410006,0,2,39,41,
Lincoln,State Auditor,Cindy Byrd,REP,410006,0,1,21,22,
Lincoln,State Auditor,Charlie Prater,REP,410006,1,1,43,45,
Lincoln,Attorney General,Mike Hunter,REP,410006,1,0,21,22,
Lincoln,Attorney General,Gentner Drummond,REP,410006,0,2,44,46,
Lincoln,Superintendent of Public Instruction,Joy Hofmeister,REP,410006,0,1,32,33,
Lincoln,Superintendent of Public Instruction,Linda Murphy,REP,410006,1,1,32,34,
Lincoln,Commissioner of Labor,Cathy Costello,REP,410006,0,2,27,29,
Lincoln,Commissioner of Labor,Leslie Osborn,REP,410006,1,0,37,38,
Lincoln,Corporation Commissioner,Bob Anthony,REP,410006,0,0,26,26,
Lincoln,Corporation Commissioner,Brian Bingman,REP,410006,1,2,38,41,
Lincoln,Governor,Chris Powell,LIB,410006,0,0,0,0,
Lincoln,Governor,Rex Lawhorn,LIB,410006,0,0,0,0,
Lincoln,Corporation Commissioner,Ashley Nicole Mccray,DEM,410006,0,0,8,8,
Lincoln,Corporation Commissioner,Blake Cummings,DEM,410006,0,0,9,9,
Lincoln,Governor,Mick Cornett,REP,410007,0,0,39,39,
Lincoln,Governor,Kevin Stitt,REP,410007,0,2,43,45,
Lincoln,Lieutenant Governor,Dana Murphy,REP,410007,0,0,30,30,
Lincoln,Lieutenant Governor,Matt Pinnell,REP,410007,0,2,50,52,
Lincoln,State Auditor,Cindy Byrd,REP,410007,0,0,31,31,
Lincoln,State Auditor,Charlie Prater,REP,410007,0,2,49,51,
Lincoln,Attorney General,Mike Hunter,REP,410007,0,0,34,34,
Lincoln,Attorney General,Gentner Drummond,REP,410007,0,2,47,49,
Lincoln,Superintendent of Public Instruction,Joy Hofmeister,REP,410007,0,2,41,43,
Lincoln,Superintendent of Public Instruction,Linda Murphy,REP,410007,0,0,41,41,
Lincoln,Commissioner of Labor,Cathy Costello,REP,410007,0,2,43,45,
Lincoln,Commissioner of Labor,Leslie Osborn,REP,410007,0,0,36,36,
Lincoln,Corporation Commissioner,Bob Anthony,REP,410007,0,0,46,46,
Lincoln,Corporation Commissioner,Brian Bingman,REP,410007,0,2,33,35,
Lincoln,Governor,Chris Powell,LIB,410007,0,0,0,0,
Lincoln,Governor,Rex Lawhorn,LIB,410007,0,0,0,0,
Lincoln,Corporation Commissioner,Ashley Nicole Mccray,DEM,410007,1,0,6,7,
Lincoln,Corporation Commissioner,Blake Cummings,DEM,410007,1,0,10,11,
Lincoln,Governor,Mick Cornett,REP,410008,3,3,99,105,
Lincoln,Governor,Kevin Stitt,REP,410008,5,2,134,141,
Lincoln,Lieutenant Governor,Dana Murphy,REP,410008,5,1,113,119,
Lincoln,Lieutenant Governor,Matt Pinnell,REP,410008,3,4,119,126,
Lincoln,State Auditor,Cindy Byrd,REP,410008,5,3,98,106,
Lincoln,State Auditor,Charlie Prater,REP,410008,3,1,133,137,
Lincoln,Attorney General,Mike Hunter,REP,410008,2,4,105,111,
Lincoln,Attorney General,Gentner Drummond,REP,410008,6,1,126,133,
Lincoln,Superintendent of Public Instruction,Joy Hofmeister,REP,410008,3,1,123,127,
Lincoln,Superintendent of Public Instruction,Linda Murphy,REP,410008,5,4,109,118,
Lincoln,Commissioner of Labor,Cathy Costello,REP,410008,6,3,112,121,
Lincoln,Commissioner of Labor,Leslie Osborn,REP,410008,2,2,119,123,
Lincoln,Corporation Commissioner,Bob Anthony,REP,410008,2,3,122,127,
Lincoln,Corporation Commissioner,Brian Bingman,REP,410008,6,2,108,116,
Lincoln,Governor,Chris Powell,LIB,410008,0,0,1,1,
Lincoln,Governor,Rex Lawhorn,LIB,410008,0,0,0,0,
Lincoln,Corporation Commissioner,Ashley Nicole Mccray,DEM,410008,3,1,30,34,
Lincoln,Corporation Commissioner,Blake Cummings,DEM,410008,0,2,12,14,
Lincoln,Governor,Mick Cornett,REP,410009,1,10,55,66,
Lincoln,Governor,Kevin Stitt,REP,410009,1,6,72,79,
Lincoln,Lieutenant Governor,Dana Murphy,REP,410009,2,5,52,59,
Lincoln,Lieutenant Governor,Matt Pinnell,REP,410009,0,10,69,79,
Lincoln,State Auditor,Cindy Byrd,REP,410009,1,6,61,68,
Lincoln,State Auditor,Charlie Prater,REP,410009,1,9,57,67,
Lincoln,Attorney General,Mike Hunter,REP,410009,0,7,49,56,
Lincoln,Attorney General,Gentner Drummond,REP,410009,2,9,74,85,
Lincoln,Superintendent of Public Instruction,Joy Hofmeister,REP,410009,2,9,70,81,
Lincoln,Superintendent of Public Instruction,Linda Murphy,REP,410009,0,6,54,60,
Lincoln,Commissioner of Labor,Cathy Costello,REP,410009,2,11,57,70,
Lincoln,Commissioner of Labor,Leslie Osborn,REP,410009,0,5,63,68,
Lincoln,Corporation Commissioner,Bob Anthony,REP,410009,2,8,58,68,
Lincoln,Corporation Commissioner,Brian Bingman,REP,410009,0,7,62,69,
Lincoln,Governor,Chris Powell,LIB,410009,0,0,0,0,
Lincoln,Governor,Rex Lawhorn,LIB,410009,0,0,0,0,
Lincoln,Corporation Commissioner,Ashley Nicole Mccray,DEM,410009,0,3,10,13,
Lincoln,Corporation Commissioner,Blake Cummings,DEM,410009,0,2,17,19,
Lincoln,Governor,Mick Cornett,REP,410010,5,14,110,129,
Lincoln,Governor,Kevin Stitt,REP,410010,0,20,101,121,
Lincoln,Lieutenant Governor,Dana Murphy,REP,410010,3,11,92,106,
Lincoln,Lieutenant Governor,Matt Pinnell,REP,410010,2,22,114,138,
Lincoln,State Auditor,Cindy Byrd,REP,410010,0,9,78,87,
Lincoln,State Auditor,Charlie Prater,REP,410010,5,25,124,154,
Lincoln,Attorney General,Mike Hunter,REP,410010,2,17,103,122,
Lincoln,Attorney General,Gentner Drummond,REP,410010,3,17,105,125,
Lincoln,Superintendent of Public Instruction,Joy Hofmeister,REP,410010,3,15,137,155,
Lincoln,Superintendent of Public Instruction,Linda Murphy,REP,410010,2,18,69,89,
Lincoln,Commissioner of Labor,Cathy Costello,REP,410010,1,9,89,99,
Lincoln,Commissioner of Labor,Leslie Osborn,REP,410010,4,24,115,143,
Lincoln,Corporation Commissioner,Bob Anthony,REP,410010,3,19,120,142,
Lincoln,Corporation Commissioner,Brian Bingman,REP,410010,2,15,86,103,
Lincoln,Governor,Chris Powell,LIB,410010,0,0,0,0,
Lincoln,Governor,Rex Lawhorn,LIB,410010,0,0,0,0,
Lincoln,Corporation Commissioner,Ashley Nicole Mccray,DEM,410010,1,5,25,31,
Lincoln,Corporation Commissioner,Blake Cummings,DEM,410010,0,1,22,23,
Lincoln,Governor,Mick Cornett,REP,410011,5,9,88,102,
Lincoln,Governor,Kevin Stitt,REP,410011,5,6,75,86,
Lincoln,Lieutenant Governor,Dana Murphy,REP,410011,3,6,77,86,
Lincoln,Lieutenant Governor,Matt Pinnell,REP,410011,6,9,79,94,
Lincoln,State Auditor,Cindy Byrd,REP,410011,3,5,75,83,
Lincoln,State Auditor,Charlie Prater,REP,410011,6,10,81,97,
Lincoln,Attorney General,Mike Hunter,REP,410011,4,6,67,77,
Lincoln,Attorney General,Gentner Drummond,REP,410011,5,9,92,106,
Lincoln,Superintendent of Public Instruction,Joy Hofmeister,REP,410011,5,4,99,108,
Lincoln,Superintendent of Public Instruction,Linda Murphy,REP,410011,4,11,60,75,
Lincoln,Commissioner of Labor,Cathy Costello,REP,410011,2,9,83,94,
Lincoln,Commissioner of Labor,Leslie Osborn,REP,410011,7,5,74,86,
Lincoln,Corporation Commissioner,Bob Anthony,REP,410011,5,10,85,100,
Lincoln,Corporation Commissioner,Brian Bingman,REP,410011,4,4,72,80,
Lincoln,Governor,Chris Powell,LIB,410011,0,0,0,0,
Lincoln,Governor,Rex Lawhorn,LIB,410011,0,0,0,0,
Lincoln,Corporation Commissioner,Ashley Nicole Mccray,DEM,410011,3,4,21,28,
Lincoln,Corporation Commissioner,Blake Cummings,DEM,410011,1,2,14,17,
Lincoln,Governor,Mick Cornett,REP,410012,2,11,73,86,
Lincoln,Governor,Kevin Stitt,REP,410012,2,3,43,48,
Lincoln,Lieutenant Governor,Dana Murphy,REP,410012,1,6,52,59,
Lincoln,Lieutenant Governor,Matt Pinnell,REP,410012,3,9,64,76,
Lincoln,State Auditor,Cindy Byrd,REP,410012,1,8,61,70,
Lincoln,State Auditor,Charlie Prater,REP,410012,3,7,55,65,
Lincoln,Attorney General,Mike Hunter,REP,410012,2,9,55,66,
Lincoln,Attorney General,Gentner Drummond,REP,410012,2,6,62,70,
Lincoln,Superintendent of Public Instruction,Joy Hofmeister,REP,410012,3,9,66,78,
Lincoln,Superintendent of Public Instruction,Linda Murphy,REP,410012,1,6,50,57,
Lincoln,Commissioner of Labor,Cathy Costello,REP,410012,2,8,51,61,
Lincoln,Commissioner of Labor,Leslie Osborn,REP,410012,2,7,66,75,
Lincoln,Corporation Commissioner,Bob Anthony,REP,410012,2,9,65,76,
Lincoln,Corporation Commissioner,Brian Bingman,REP,410012,2,6,51,59,
Lincoln,Governor,Chris Powell,LIB,410012,0,0,0,0,
Lincoln,Governor,Rex Lawhorn,LIB,410012,0,0,0,0,
Lincoln,Corporation Commissioner,Ashley Nicole Mccray,DEM,410012,1,1,29,31,
Lincoln,Corporation Commissioner,Blake Cummings,DEM,410012,0,2,15,17,
Lincoln,Governor,Mick Cornett,REP,410013,0,0,27,27,
Lincoln,Governor,Kevin Stitt,REP,410013,2,0,22,24,
Lincoln,Lieutenant Governor,Dana Murphy,REP,410013,2,0,21,23,
Lincoln,Lieutenant Governor,Matt Pinnell,REP,410013,0,0,31,31,
Lincoln,State Auditor,Cindy Byrd,REP,410013,2,0,19,21,
Lincoln,State Auditor,Charlie Prater,REP,410013,0,0,28,28,
Lincoln,Attorney General,Mike Hunter,REP,410013,0,0,17,17,
Lincoln,Attorney General,Gentner Drummond,REP,410013,2,0,30,32,
Lincoln,Superintendent of Public Instruction,Joy Hofmeister,REP,410013,0,0,31,31,
Lincoln,Superintendent of Public Instruction,Linda Murphy,REP,410013,2,0,16,18,
Lincoln,Commissioner of Labor,Cathy Costello,REP,410013,2,0,18,20,
Lincoln,Commissioner of Labor,Leslie Osborn,REP,410013,0,0,29,29,
Lincoln,Corporation Commissioner,Bob Anthony,REP,410013,2,0,30,32,
Lincoln,Corporation Commissioner,Brian Bingman,REP,410013,0,0,22,22,
Lincoln,Governor,Chris Powell,LIB,410013,0,0,1,1,
Lincoln,Governor,Rex Lawhorn,LIB,410013,0,0,0,0,
Lincoln,Corporation Commissioner,Ashley Nicole Mccray,DEM,410013,0,0,5,5,
Lincoln,Corporation Commissioner,Blake Cummings,DEM,410013,0,0,8,8,
Lincoln,Governor,Mick Cornett,REP,410015,7,0,78,85,
Lincoln,Governor,Kevin Stitt,REP,410015,10,0,145,155,
Lincoln,Lieutenant Governor,Dana Murphy,REP,410015,11,0,97,108,
Lincoln,Lieutenant Governor,Matt Pinnell,REP,410015,6,0,124,130,
Lincoln,State Auditor,Cindy Byrd,REP,410015,13,0,96,109,
Lincoln,State Auditor,Charlie Prater,REP,410015,4,0,124,128,
Lincoln,Attorney General,Mike Hunter,REP,410015,7,0,92,99,
Lincoln,Attorney General,Gentner Drummond,REP,410015,10,0,130,140,
Lincoln,Superintendent of Public Instruction,Joy Hofmeister,REP,410015,11,0,116,127,
Lincoln,Superintendent of Public Instruction,Linda Murphy,REP,410015,5,0,105,110,
Lincoln,Commissioner of Labor,Cathy Costello,REP,410015,4,0,119,123,
Lincoln,Commissioner of Labor,Leslie Osborn,REP,410015,13,0,99,112,
Lincoln,Corporation Commissioner,Bob Anthony,REP,410015,11,0,116,127,
Lincoln,Corporation Commissioner,Brian Bingman,REP,410015,6,0,105,111,
Lincoln,Governor,Chris Powell,LIB,410015,0,0,1,1,
Lincoln,Governor,Rex Lawhorn,LIB,410015,0,0,0,0,
Lincoln,Corporation Commissioner,Ashley Nicole Mccray,DEM,410015,4,2,34,40,
Lincoln,Corporation Commissioner,Blake Cummings,DEM,410015,2,0,31,33,
Lincoln,Governor,Mick Cornett,REP,410016,3,1,103,107,
Lincoln,Governor,Kevin Stitt,REP,410016,4,2,110,116,
Lincoln,Lieutenant Governor,Dana Murphy,REP,410016,2,0,89,91,
Lincoln,Lieutenant Governor,Matt Pinnell,REP,410016,5,3,123,131,
Lincoln,State Auditor,Cindy Byrd,REP,410016,4,2,85,91,
Lincoln,State Auditor,Charlie Prater,REP,410016,3,0,125,128,
Lincoln,Attorney General,Mike Hunter,REP,410016,3,2,90,95,
Lincoln,Attorney General,Gentner Drummond,REP,410016,4,1,123,128,
Lincoln,Superintendent of Public Instruction,Joy Hofmeister,REP,410016,3,0,109,112,
Lincoln,Superintendent of Public Instruction,Linda Murphy,REP,410016,4,3,100,107,
Lincoln,Commissioner of Labor,Cathy Costello,REP,410016,3,0,87,90,
Lincoln,Commissioner of Labor,Leslie Osborn,REP,410016,4,3,121,128,
Lincoln,Corporation Commissioner,Bob Anthony,REP,410016,4,2,107,113,
Lincoln,Corporation Commissioner,Brian Bingman,REP,410016,3,1,103,107,
Lincoln,Governor,Chris Powell,LIB,410016,0,0,0,0,
Lincoln,Governor,Rex Lawhorn,LIB,410016,0,0,0,0,
Lincoln,Corporation Commissioner,Ashley Nicole Mccray,DEM,410016,2,0,24,26,
Lincoln,Corporation Commissioner,Blake Cummings,DEM,410016,4,0,27,31,
Lincoln,Governor,Mick Cornett,REP,410017,2,2,23,27,
Lincoln,Governor,Kevin Stitt,REP,410017,2,1,26,29,
Lincoln,Lieutenant Governor,Dana Murphy,REP,410017,2,0,16,18,
Lincoln,Lieutenant Governor,Matt Pinnell,REP,410017,2,3,33,38,
Lincoln,State Auditor,Cindy Byrd,REP,410017,2,1,15,18,
Lincoln,State Auditor,Charlie Prater,REP,410017,2,2,33,37,
Lincoln,Attorney General,Mike Hunter,REP,410017,2,0,21,23,
Lincoln,Attorney General,Gentner Drummond,REP,410017,2,3,27,32,
Lincoln,Superintendent of Public Instruction,Joy Hofmeister,REP,410017,4,2,29,35,
Lincoln,Superintendent of Public Instruction,Linda Murphy,REP,410017,0,1,20,21,
Lincoln,Commissioner of Labor,Cathy Costello,REP,410017,0,2,19,21,
Lincoln,Commissioner of Labor,Leslie Osborn,REP,410017,4,1,29,34,
Lincoln,Corporation Commissioner,Bob Anthony,REP,410017,1,0,27,28,
Lincoln,Corporation Commissioner,Brian Bingman,REP,410017,3,3,22,28,
Lincoln,Governor,Chris Powell,LIB,410017,0,0,0,0,
Lincoln,Governor,Rex Lawhorn,LIB,410017,0,0,0,0,
Lincoln,Corporation Commissioner,Ashley Nicole Mccray,DEM,410017,2,0,4,6,
Lincoln,Corporation Commissioner,Blake Cummings,DEM,410017,0,2,4,6,
Lincoln,Governor,Mick Cornett,REP,410018,1,4,41,46,
Lincoln,Governor,Kevin Stitt,REP,410018,1,2,58,61,
Lincoln,Lieutenant Governor,Dana Murphy,REP,410018,0,3,36,39,
Lincoln,Lieutenant Governor,Matt Pinnell,REP,410018,2,3,57,62,
Lincoln,State Auditor,Cindy Byrd,REP,410018,1,1,42,44,
Lincoln,State Auditor,Charlie Prater,REP,410018,1,5,51,57,
Lincoln,Attorney General,Mike Hunter,REP,410018,0,2,50,52,
Lincoln,Attorney General,Gentner Drummond,REP,410018,2,4,47,53,
Lincoln,Superintendent of Public Instruction,Joy Hofmeister,REP,410018,2,5,47,54,
Lincoln,Superintendent of Public Instruction,Linda Murphy,REP,410018,0,1,47,48,
Lincoln,Commissioner of Labor,Cathy Costello,REP,410018,2,1,36,39,
Lincoln,Commissioner of Labor,Leslie Osborn,REP,410018,0,5,60,65,
Lincoln,Corporation Commissioner,Bob Anthony,REP,410018,1,3,44,48,
Lincoln,Corporation Commissioner,Brian Bingman,REP,410018,1,3,47,51,
Lincoln,Governor,Chris Powell,LIB,410018,0,0,0,0,
Lincoln,Governor,Rex Lawhorn,LIB,410018,0,0,1,1,
Lincoln,Corporation Commissioner,Ashley Nicole Mccray,DEM,410018,0,2,13,15,
Lincoln,Corporation Commissioner,Blake Cummings,DEM,410018,0,0,17,17,
Lincoln,Governor,Mick Cornett,REP,410019,3,0,71,74,
Lincoln,Governor,Kevin Stitt,REP,410019,0,2,77,79,
Lincoln,Lieutenant Governor,Dana Murphy,REP,410019,0,1,59,60,
Lincoln,Lieutenant Governor,Matt Pinnell,REP,410019,3,1,82,86,
Lincoln,State Auditor,Cindy Byrd,REP,410019,2,1,71,74,
Lincoln,State Auditor,Charlie Prater,REP,410019,1,1,71,73,
Lincoln,Attorney General,Mike Hunter,REP,410019,2,1,59,62,
Lincoln,Attorney General,Gentner Drummond,REP,410019,1,1,87,89,
Lincoln,Superintendent of Public Instruction,Joy Hofmeister,REP,410019,2,1,77,80,
Lincoln,Superintendent of Public Instruction,Linda Murphy,REP,410019,1,1,67,69,
Lincoln,Commissioner of Labor,Cathy Costello,REP,410019,2,0,67,69,
Lincoln,Commissioner of Labor,Leslie Osborn,REP,410019,1,2,75,78,
Lincoln,Corporation Commissioner,Bob Anthony,REP,410019,2,0,82,84,
Lincoln,Corporation Commissioner,Brian Bingman,REP,410019,1,2,62,65,
Lincoln,Governor,Chris Powell,LIB,410019,0,0,0,0,
Lincoln,Governor,Rex Lawhorn,LIB,410019,0,0,1,1,
Lincoln,Corporation Commissioner,Ashley Nicole Mccray,DEM,410019,3,0,10,13,
Lincoln,Corporation Commissioner,Blake Cummings,DEM,410019,0,0,21,21,
Lincoln,Governor,Mick Cornett,REP,410020,3,3,47,53,
Lincoln,Governor,Kevin Stitt,REP,410020,2,2,61,65,
Lincoln,Lieutenant Governor,Dana Murphy,REP,410020,2,1,40,43,
Lincoln,Lieutenant Governor,Matt Pinnell,REP,410020,3,4,65,72,
Lincoln,State Auditor,Cindy Byrd,REP,410020,4,0,45,49,
Lincoln,State Auditor,Charlie Prater,REP,410020,1,4,56,61,
Lincoln,Attorney General,Mike Hunter,REP,410020,4,0,45,49,
Lincoln,Attorney General,Gentner Drummond,REP,410020,1,5,61,67,
Lincoln,Superintendent of Public Instruction,Joy Hofmeister,REP,410020,4,3,51,58,
Lincoln,Superintendent of Public Instruction,Linda Murphy,REP,410020,1,2,54,57,
Lincoln,Commissioner of Labor,Cathy Costello,REP,410020,3,1,39,43,
Lincoln,Commissioner of Labor,Leslie Osborn,REP,410020,2,4,65,71,
Lincoln,Corporation Commissioner,Bob Anthony,REP,410020,3,2,45,50,
Lincoln,Corporation Commissioner,Brian Bingman,REP,410020,2,3,59,64,
Lincoln,Governor,Chris Powell,LIB,410020,0,0,0,0,
Lincoln,Governor,Rex Lawhorn,LIB,410020,0,0,0,0,
Lincoln,Corporation Commissioner,Ashley Nicole Mccray,DEM,410020,1,0,19,20,
Lincoln,Corporation Commissioner,Blake Cummings,DEM,410020,0,0,7,7,
Lincoln,Governor,Mick Cornett,REP,410021,2,0,61,63,
Lincoln,Governor,Kevin Stitt,REP,410021,6,5,106,117,
Lincoln,Lieutenant Governor,Dana Murphy,REP,410021,5,0,77,82,
Lincoln,Lieutenant Governor,Matt Pinnell,REP,410021,3,5,90,98,
Lincoln,State Auditor,Cindy Byrd,REP,410021,5,3,71,79,
Lincoln,State Auditor,Charlie Prater,REP,410021,2,2,92,96,
Lincoln,Attorney General,Mike Hunter,REP,410021,6,0,75,81,
Lincoln,Attorney General,Gentner Drummond,REP,410021,1,5,93,99,
Lincoln,Superintendent of Public Instruction,Joy Hofmeister,REP,410021,5,1,85,91,
Lincoln,Superintendent of Public Instruction,Linda Murphy,REP,410021,3,4,82,89,
Lincoln,Commissioner of Labor,Cathy Costello,REP,410021,6,3,66,75,
Lincoln,Commissioner of Labor,Leslie Osborn,REP,410021,2,2,100,104,
Lincoln,Corporation Commissioner,Bob Anthony,REP,410021,2,3,88,93,
Lincoln,Corporation Commissioner,Brian Bingman,REP,410021,6,2,79,87,
Lincoln,Governor,Chris Powell,LIB,410021,0,0,0,0,
Lincoln,Governor,Rex Lawhorn,LIB,410021,0,0,0,0,
Lincoln,Corporation Commissioner,Ashley Nicole Mccray,DEM,410021,3,1,23,27,
Lincoln,Corporation Commissioner,Blake Cummings,DEM,410021,2,0,11,13,
Lincoln,Governor,Mick Cornett,REP,410022,3,0,83,86,
Lincoln,Governor,Kevin Stitt,REP,410022,2,1,105,108,
Lincoln,Lieutenant Governor,Dana Murphy,REP,410022,2,1,68,71,
Lincoln,Lieutenant Governor,Matt Pinnell,REP,410022,3,0,120,123,
Lincoln,State Auditor,Cindy Byrd,REP,410022,2,0,70,72,
Lincoln,State Auditor,Charlie Prater,REP,410022,3,1,112,116,
Lincoln,Attorney General,Mike Hunter,REP,410022,5,0,77,82,
Lincoln,Attorney General,Gentner Drummond,REP,410022,0,1,110,111,
Lincoln,Superintendent of Public Instruction,Joy Hofmeister,REP,410022,4,1,107,112,
Lincoln,Superintendent of Public Instruction,Linda Murphy,REP,410022,1,0,78,79,
Lincoln,Commissioner of Labor,Cathy Costello,REP,410022,1,1,77,79,
Lincoln,Commissioner of Labor,Leslie Osborn,REP,410022,4,0,108,112,
Lincoln,Corporation Commissioner,Bob Anthony,REP,410022,4,0,86,90,
Lincoln,Corporation Commissioner,Brian Bingman,REP,410022,1,1,100,102,
Lincoln,Governor,Chris Powell,LIB,410022,0,0,0,0,
Lincoln,Governor,Rex Lawhorn,LIB,410022,0,0,0,0,
Lincoln,Corporation Commissioner,Ashley Nicole Mccray,DEM,410022,1,0,18,19,
Lincoln,Corporation Commissioner,Blake Cummings,DEM,410022,1,0,31,32,
Logan,Governor,Mick Cornett,REP,420101,2,5,74,81,
Logan,Governor,Kevin Stitt,REP,420101,9,4,114,127,
Logan,Lieutenant Governor,Dana Murphy,REP,420101,6,2,89,97,
Logan,Lieutenant Governor,Matt Pinnell,REP,420101,5,7,94,106,
Logan,State Auditor,Cindy Byrd,REP,420101,5,3,76,84,
Logan,State Auditor,Charlie Prater,REP,420101,6,6,102,114,
Logan,Attorney General,Mike Hunter,REP,420101,5,7,101,113,
Logan,Attorney General,Gentner Drummond,REP,420101,4,2,84,90,
Logan,Superintendent of Public Instruction,Joy Hofmeister,REP,420101,11,3,89,103,
Logan,Superintendent of Public Instruction,Linda Murphy,REP,420101,0,6,92,98,
Logan,Commissioner of Labor,Cathy Costello,REP,420101,2,4,91,97,
Logan,Commissioner of Labor,Leslie Osborn,REP,420101,9,5,91,105,
Logan,Corporation Commissioner,Bob Anthony,REP,420101,6,4,98,108,
Logan,Corporation Commissioner,Brian Bingman,REP,420101,5,5,84,94,
Logan,Governor,Chris Powell,LIB,420101,0,0,0,0,
Logan,Governor,Rex Lawhorn,LIB,420101,0,0,0,0,
Logan,Corporation Commissioner,Ashley Nicole Mccray,DEM,420101,1,1,11,13,
Logan,Corporation Commissioner,Blake Cummings,DEM,420101,0,0,7,7,
Logan,Governor,Mick Cornett,REP,420102,6,12,118,136,
Logan,Governor,Kevin Stitt,REP,420102,8,13,136,157,
Logan,Lieutenant Governor,Dana Murphy,REP,420102,6,8,114,128,
Logan,Lieutenant Governor,Matt Pinnell,REP,420102,8,17,139,164,
Logan,State Auditor,Cindy Byrd,REP,420102,5,7,110,122,
Logan,State Auditor,Charlie Prater,REP,420102,8,18,140,166,
Logan,Attorney General,Mike Hunter,REP,420102,6,21,133,160,
Logan,Attorney General,Gentner Drummond,REP,420102,8,4,119,131,
Logan,Superintendent of Public Instruction,Joy Hofmeister,REP,420102,10,18,154,182,
Logan,Superintendent of Public Instruction,Linda Murphy,REP,420102,3,7,98,108,
Logan,Commissioner of Labor,Cathy Costello,REP,420102,6,13,128,147,
Logan,Commissioner of Labor,Leslie Osborn,REP,420102,8,10,121,139,
Logan,Corporation Commissioner,Bob Anthony,REP,420102,4,19,141,164,
Logan,Corporation Commissioner,Brian Bingman,REP,420102,10,4,110,124,
Logan,Governor,Chris Powell,LIB,420102,0,0,0,0,
Logan,Governor,Rex Lawhorn,LIB,420102,0,0,0,0,
Logan,Corporation Commissioner,Ashley Nicole Mccray,DEM,420102,3,0,15,18,
Logan,Corporation Commissioner,Blake Cummings,DEM,420102,3,1,18,22,
Logan,Governor,Mick Cornett,REP,420103,27,14,339,380,
Logan,Governor,Kevin Stitt,REP,420103,22,17,296,335,
Logan,Lieutenant Governor,Dana Murphy,REP,420103,26,14,304,344,
Logan,Lieutenant Governor,Matt Pinnell,REP,420103,19,17,318,354,
Logan,State Auditor,Cindy Byrd,REP,420103,26,19,311,356,
Logan,State Auditor,Charlie Prater,REP,420103,17,12,295,324,
Logan,Attorney General,Mike Hunter,REP,420103,36,13,332,381,
Logan,Attorney General,Gentner Drummond,REP,420103,12,17,296,325,
Logan,Superintendent of Public Instruction,Joy Hofmeister,REP,420103,28,15,336,379,
Logan,Superintendent of Public Instruction,Linda Murphy,REP,420103,20,14,282,316,
Logan,Commissioner of Labor,Cathy Costello,REP,420103,29,23,327,379,
Logan,Commissioner of Labor,Leslie Osborn,REP,420103,18,7,296,321,
Logan,Corporation Commissioner,Bob Anthony,REP,420103,33,16,334,383,
Logan,Corporation Commissioner,Brian Bingman,REP,420103,14,14,271,299,
Logan,Governor,Chris Powell,LIB,420103,0,0,1,1,
Logan,Governor,Rex Lawhorn,LIB,420103,0,0,1,1,
Logan,Corporation Commissioner,Ashley Nicole Mccray,DEM,420103,21,1,37,59,
Logan,Corporation Commissioner,Blake Cummings,DEM,420103,2,0,12,14,
Logan,Governor,Mick Cornett,REP,420104,17,12,157,186,
Logan,Governor,Kevin Stitt,REP,420104,20,15,184,219,
Logan,Lieutenant Governor,Dana Murphy,REP,420104,17,11,146,174,
Logan,Lieutenant Governor,Matt Pinnell,REP,420104,19,15,192,226,
Logan,State Auditor,Cindy Byrd,REP,420104,19,11,155,185,
Logan,State Auditor,Charlie Prater,REP,420104,14,14,179,207,
Logan,Attorney General,Mike Hunter,REP,420104,18,15,167,200,
Logan,Attorney General,Gentner Drummond,REP,420104,18,11,167,196,
Logan,Superintendent of Public Instruction,Joy Hofmeister,REP,420104,17,10,166,193,
Logan,Superintendent of Public Instruction,Linda Murphy,REP,420104,19,16,166,201,
Logan,Commissioner of Labor,Cathy Costello,REP,420104,18,6,162,186,
Logan,Commissioner of Labor,Leslie Osborn,REP,420104,18,20,170,208,
Logan,Corporation Commissioner,Bob Anthony,REP,420104,17,19,176,212,
Logan,Corporation Commissioner,Brian Bingman,REP,420104,20,7,152,179,
Logan,Governor,Chris Powell,LIB,420104,0,0,0,0,
Logan,Governor,Rex Lawhorn,LIB,420104,0,0,0,0,
Logan,Corporation Commissioner,Ashley Nicole Mccray,DEM,420104,5,2,20,27,
Logan,Corporation Commissioner,Blake Cummings,DEM,420104,2,1,9,12,
Logan,Governor,Mick Cornett,REP,420105,1,8,116,125,
Logan,Governor,Kevin Stitt,REP,420105,9,17,114,140,
Logan,Lieutenant Governor,Dana Murphy,REP,420105,5,8,94,107,
Logan,Lieutenant Governor,Matt Pinnell,REP,420105,5,17,124,146,
Logan,State Auditor,Cindy Byrd,REP,420105,9,7,89,105,
Logan,State Auditor,Charlie Prater,REP,420105,1,15,131,147,
Logan,Attorney General,Mike Hunter,REP,420105,2,13,105,120,
Logan,Attorney General,Gentner Drummond,REP,420105,8,12,114,134,
Logan,Superintendent of Public Instruction,Joy Hofmeister,REP,420105,6,15,100,121,
Logan,Superintendent of Public Instruction,Linda Murphy,REP,420105,4,8,122,134,
Logan,Commissioner of Labor,Cathy Costello,REP,420105,4,12,112,128,
Logan,Commissioner of Labor,Leslie Osborn,REP,420105,6,13,110,129,
Logan,Corporation Commissioner,Bob Anthony,REP,420105,3,7,116,126,
Logan,Corporation Commissioner,Brian Bingman,REP,420105,7,16,102,125,
Logan,Governor,Chris Powell,LIB,420105,0,1,3,4,
Logan,Governor,Rex Lawhorn,LIB,420105,0,0,1,1,
Logan,Corporation Commissioner,Ashley Nicole Mccray,DEM,420105,3,2,11,16,
Logan,Corporation Commissioner,Blake Cummings,DEM,420105,1,1,7,9,
Logan,Governor,Mick Cornett,REP,420106,16,7,240,263,
Logan,Governor,Kevin Stitt,REP,420106,8,13,207,228,
Logan,Lieutenant Governor,Dana Murphy,REP,420106,18,12,221,251,
Logan,Lieutenant Governor,Matt Pinnell,REP,420106,6,8,204,218,
Logan,State Auditor,Cindy Byrd,REP,420106,13,9,202,224,
Logan,State Auditor,Charlie Prater,REP,420106,10,10,216,236,
Logan,Attorney General,Mike Hunter,REP,420106,9,12,227,248,
Logan,Attorney General,Gentner Drummond,REP,420106,14,8,198,220,
Logan,Superintendent of Public Instruction,Joy Hofmeister,REP,420106,11,11,242,264,
Logan,Superintendent of Public Instruction,Linda Murphy,REP,420106,12,9,185,206,
Logan,Commissioner of Labor,Cathy Costello,REP,420106,14,10,223,247,
Logan,Commissioner of Labor,Leslie Osborn,REP,420106,9,10,199,218,
Logan,Corporation Commissioner,Bob Anthony,REP,420106,20,13,233,266,
Logan,Corporation Commissioner,Brian Bingman,REP,420106,4,7,181,192,
Logan,Governor,Chris Powell,LIB,420106,0,0,0,0,
Logan,Governor,Rex Lawhorn,LIB,420106,0,0,1,1,
Logan,Corporation Commissioner,Ashley Nicole Mccray,DEM,420106,1,0,11,12,
Logan,Corporation Commissioner,Blake Cummings,DEM,420106,2,0,14,16,
Logan,Governor,Mick Cornett,REP,420201,0,0,18,18,
Logan,Governor,Kevin Stitt,REP,420201,0,0,16,16,
Logan,Lieutenant Governor,Dana Murphy,REP,420201,0,0,19,19,
Logan,Lieutenant Governor,Matt Pinnell,REP,420201,0,0,11,11,
Logan,State Auditor,Cindy Byrd,REP,420201,0,0,18,18,
Logan,State Auditor,Charlie Prater,REP,420201,0,0,15,15,
Logan,Attorney General,Mike Hunter,REP,420201,0,0,15,15,
Logan,Attorney General,Gentner Drummond,REP,420201,0,0,19,19,
Logan,Superintendent of Public Instruction,Joy Hofmeister,REP,420201,0,0,15,15,
Logan,Superintendent of Public Instruction,Linda Murphy,REP,420201,0,0,17,17,
Logan,Commissioner of Labor,Cathy Costello,REP,420201,0,0,15,15,
Logan,Commissioner of Labor,Leslie Osborn,REP,420201,0,0,15,15,
Logan,Corporation Commissioner,Bob Anthony,REP,420201,0,0,14,14,
Logan,Corporation Commissioner,Brian Bingman,REP,420201,0,0,18,18,
Logan,Governor,Chris Powell,LIB,420201,0,0,0,0,
Logan,Governor,Rex Lawhorn,LIB,420201,0,0,0,0,
Logan,Corporation Commissioner,Ashley Nicole Mccray,DEM,420201,0,0,8,8,
Logan,Corporation Commissioner,Blake Cummings,DEM,420201,0,0,3,3,
Logan,Governor,Mick Cornett,REP,420203,5,1,34,40,
Logan,Governor,Kevin Stitt,REP,420203,5,4,48,57,
Logan,Lieutenant Governor,Dana Murphy,REP,420203,8,0,24,32,
Logan,Lieutenant Governor,Matt Pinnell,REP,420203,4,5,56,65,
Logan,State Auditor,Cindy Byrd,REP,420203,9,2,31,42,
Logan,State Auditor,Charlie Prater,REP,420203,3,3,46,52,
Logan,Attorney General,Mike Hunter,REP,420203,5,2,34,41,
Logan,Attorney General,Gentner Drummond,REP,420203,7,3,46,56,
Logan,Superintendent of Public Instruction,Joy Hofmeister,REP,420203,4,0,32,36,
Logan,Superintendent of Public Instruction,Linda Murphy,REP,420203,7,5,48,60,
Logan,Commissioner of Labor,Cathy Costello,REP,420203,7,1,39,47,
Logan,Commissioner of Labor,Leslie Osborn,REP,420203,5,4,42,51,
Logan,Corporation Commissioner,Bob Anthony,REP,420203,10,4,40,54,
Logan,Corporation Commissioner,Brian Bingman,REP,420203,1,1,39,41,
Logan,Governor,Chris Powell,LIB,420203,0,0,1,1,
Logan,Governor,Rex Lawhorn,LIB,420203,0,0,0,0,
Logan,Corporation Commissioner,Ashley Nicole Mccray,DEM,420203,2,2,12,16,
Logan,Corporation Commissioner,Blake Cummings,DEM,420203,0,0,4,4,
Logan,Governor,Mick Cornett,REP,420204,9,19,136,164,
Logan,Governor,Kevin Stitt,REP,420204,4,14,125,143,
Logan,Lieutenant Governor,Dana Murphy,REP,420204,6,14,95,115,
Logan,Lieutenant Governor,Matt Pinnell,REP,420204,6,19,159,184,
Logan,State Auditor,Cindy Byrd,REP,420204,3,19,111,133,
Logan,State Auditor,Charlie Prater,REP,420204,9,13,134,156,
Logan,Attorney General,Mike Hunter,REP,420204,7,20,120,147,
Logan,Attorney General,Gentner Drummond,REP,420204,5,13,137,155,
Logan,Superintendent of Public Instruction,Joy Hofmeister,REP,420204,10,19,127,156,
Logan,Superintendent of Public Instruction,Linda Murphy,REP,420204,2,13,129,144,
Logan,Commissioner of Labor,Cathy Costello,REP,420204,12,21,118,151,
Logan,Commissioner of Labor,Leslie Osborn,REP,420204,1,12,137,150,
Logan,Corporation Commissioner,Bob Anthony,REP,420204,12,22,131,165,
Logan,Corporation Commissioner,Brian Bingman,REP,420204,1,10,123,134,
Logan,Governor,Chris Powell,LIB,420204,0,0,2,2,
Logan,Governor,Rex Lawhorn,LIB,420204,0,0,0,0,
Logan,Corporation Commissioner,Ashley Nicole Mccray,DEM,420204,5,7,27,39,
Logan,Corporation Commissioner,Blake Cummings,DEM,420204,1,0,13,14,
Logan,Governor,Mick Cornett,REP,420205,12,12,177,201,
Logan,Governor,Kevin Stitt,REP,420205,8,16,216,240,
Logan,Lieutenant Governor,Dana Murphy,REP,420205,10,8,161,179,
Logan,Lieutenant Governor,Matt Pinnell,REP,420205,10,19,219,248,
Logan,State Auditor,Cindy Byrd,REP,420205,10,14,171,195,
Logan,State Auditor,Charlie Prater,REP,420205,9,12,205,226,
Logan,Attorney General,Mike Hunter,REP,420205,8,15,198,221,
Logan,Attorney General,Gentner Drummond,REP,420205,11,12,190,213,
Logan,Superintendent of Public Instruction,Joy Hofmeister,REP,420205,8,13,193,214,
Logan,Superintendent of Public Instruction,Linda Murphy,REP,420205,11,14,185,210,
Logan,Commissioner of Labor,Cathy Costello,REP,420205,7,15,206,228,
Logan,Commissioner of Labor,Leslie Osborn,REP,420205,13,11,175,199,
Logan,Corporation Commissioner,Bob Anthony,REP,420205,13,21,193,227,
Logan,Corporation Commissioner,Brian Bingman,REP,420205,7,6,191,204,
Logan,Governor,Chris Powell,LIB,420205,0,0,4,4,
Logan,Governor,Rex Lawhorn,LIB,420205,1,0,1,2,
Logan,Corporation Commissioner,Ashley Nicole Mccray,DEM,420205,5,2,32,39,
Logan,Corporation Commissioner,Blake Cummings,DEM,420205,2,2,9,13,
Logan,Governor,Mick Cornett,REP,420206,5,5,113,123,
Logan,Governor,Kevin Stitt,REP,420206,15,12,154,181,
Logan,Lieutenant Governor,Dana Murphy,REP,420206,14,3,93,110,
Logan,Lieutenant Governor,Matt Pinnell,REP,420206,5,14,170,189,
Logan,State Auditor,Cindy Byrd,REP,420206,12,5,102,119,
Logan,State Auditor,Charlie Prater,REP,420206,7,12,150,169,
Logan,Attorney General,Mike Hunter,REP,420206,11,8,110,129,
Logan,Attorney General,Gentner Drummond,REP,420206,8,9,154,171,
Logan,Superintendent of Public Instruction,Joy Hofmeister,REP,420206,9,10,140,159,
Logan,Superintendent of Public Instruction,Linda Murphy,REP,420206,11,7,120,138,
Logan,Commissioner of Labor,Cathy Costello,REP,420206,9,8,142,159,
Logan,Commissioner of Labor,Leslie Osborn,REP,420206,10,9,116,135,
Logan,Corporation Commissioner,Bob Anthony,REP,420206,14,10,148,172,
Logan,Corporation Commissioner,Brian Bingman,REP,420206,5,7,113,125,
Logan,Governor,Chris Powell,LIB,420206,0,0,0,0,
Logan,Governor,Rex Lawhorn,LIB,420206,0,0,1,1,
Logan,Corporation Commissioner,Ashley Nicole Mccray,DEM,420206,3,1,26,30,
Logan,Corporation Commissioner,Blake Cummings,DEM,420206,0,0,18,18,
Logan,Governor,Mick Cornett,REP,420207,16,11,155,182,
Logan,Governor,Kevin Stitt,REP,420207,8,11,206,225,
Logan,Lieutenant Governor,Dana Murphy,REP,420207,11,7,141,159,
Logan,Lieutenant Governor,Matt Pinnell,REP,420207,13,14,212,239,
Logan,State Auditor,Cindy Byrd,REP,420207,14,9,162,185,
Logan,State Auditor,Charlie Prater,REP,420207,10,11,185,206,
Logan,Attorney General,Mike Hunter,REP,420207,10,8,172,190,
Logan,Attorney General,Gentner Drummond,REP,420207,13,14,185,212,
Logan,Superintendent of Public Instruction,Joy Hofmeister,REP,420207,14,11,185,210,
Logan,Superintendent of Public Instruction,Linda Murphy,REP,420207,9,11,167,187,
Logan,Commissioner of Labor,Cathy Costello,REP,420207,14,14,178,206,
Logan,Commissioner of Labor,Leslie Osborn,REP,420207,8,8,172,188,
Logan,Corporation Commissioner,Bob Anthony,REP,420207,15,14,184,213,
Logan,Corporation Commissioner,Brian Bingman,REP,420207,9,7,167,183,
Logan,Governor,Chris Powell,LIB,420207,0,0,0,0,
Logan,Governor,Rex Lawhorn,LIB,420207,0,0,0,0,
Logan,Corporation Commissioner,Ashley Nicole Mccray,DEM,420207,9,1,24,34,
Logan,Corporation Commissioner,Blake Cummings,DEM,420207,3,2,11,16,
Logan,Governor,Mick Cornett,REP,420301,0,1,26,27,
Logan,Governor,Kevin Stitt,REP,420301,0,3,49,52,
Logan,Lieutenant Governor,Dana Murphy,REP,420301,0,1,23,24,
Logan,Lieutenant Governor,Matt Pinnell,REP,420301,0,2,51,53,
Logan,State Auditor,Cindy Byrd,REP,420301,0,1,28,29,
Logan,State Auditor,Charlie Prater,REP,420301,0,2,45,47,
Logan,Attorney General,Mike Hunter,REP,420301,0,0,40,40,
Logan,Attorney General,Gentner Drummond,REP,420301,0,4,34,38,
Logan,Superintendent of Public Instruction,Joy Hofmeister,REP,420301,0,0,36,36,
Logan,Superintendent of Public Instruction,Linda Murphy,REP,420301,0,4,36,40,
Logan,Commissioner of Labor,Cathy Costello,REP,420301,0,2,34,36,
Logan,Commissioner of Labor,Leslie Osborn,REP,420301,0,1,39,40,
Logan,Corporation Commissioner,Bob Anthony,REP,420301,0,1,42,43,
Logan,Corporation Commissioner,Brian Bingman,REP,420301,0,3,32,35,
Logan,State House,John Pfeiffer,REP,420301,0,2,46,48,38
Logan,State House,Brian Hobbs,REP,420301,0,2,29,31,38
Logan,Governor,Chris Powell,LIB,420301,0,0,0,0,
Logan,Governor,Rex Lawhorn,LIB,420301,0,0,0,0,
Logan,Corporation Commissioner,Ashley Nicole Mccray,DEM,420301,0,0,4,4,
Logan,Corporation Commissioner,Blake Cummings,DEM,420301,0,0,3,3,
Logan,Governor,Mick Cornett,REP,420302,0,0,30,30,
Logan,Governor,Kevin Stitt,REP,420302,0,0,22,22,
Logan,Lieutenant Governor,Dana Murphy,REP,420302,0,0,31,31,
Logan,Lieutenant Governor,Matt Pinnell,REP,420302,0,0,21,21,
Logan,State Auditor,Cindy Byrd,REP,420302,0,0,21,21,
Logan,State Auditor,Charlie Prater,REP,420302,0,0,31,31,
Logan,Attorney General,Mike Hunter,REP,420302,0,0,27,27,
Logan,Attorney General,Gentner Drummond,REP,420302,0,0,25,25,
Logan,Superintendent of Public Instruction,Joy Hofmeister,REP,420302,0,0,31,31,
Logan,Superintendent of Public Instruction,Linda Murphy,REP,420302,0,0,21,21,
Logan,Commissioner of Labor,Cathy Costello,REP,420302,0,0,21,21,
Logan,Commissioner of Labor,Leslie Osborn,REP,420302,0,0,31,31,
Logan,Corporation Commissioner,Bob Anthony,REP,420302,0,0,19,19,
Logan,Corporation Commissioner,Brian Bingman,REP,420302,0,0,33,33,
Logan,State House,John Pfeiffer,REP,420302,0,0,46,46,38
Logan,State House,Brian Hobbs,REP,420302,0,0,6,6,38
Logan,Governor,Chris Powell,LIB,420302,0,0,0,0,
Logan,Governor,Rex Lawhorn,LIB,420302,0,0,0,0,
Logan,Corporation Commissioner,Ashley Nicole Mccray,DEM,420302,0,0,5,5,
Logan,Corporation Commissioner,Blake Cummings,DEM,420302,0,0,1,1,
Logan,Governor,Mick Cornett,REP,420303,2,3,165,170,
Logan,Governor,Kevin Stitt,REP,420303,6,2,210,218,
Logan,Lieutenant Governor,Dana Murphy,REP,420303,6,2,144,152,
Logan,Lieutenant Governor,Matt Pinnell,REP,420303,2,3,231,236,
Logan,State Auditor,Cindy Byrd,REP,420303,3,2,172,177,
Logan,State Auditor,Charlie Prater,REP,420303,5,3,193,201,
Logan,Attorney General,Mike Hunter,REP,420303,5,5,155,165,
Logan,Attorney General,Gentner Drummond,REP,420303,3,0,218,221,
Logan,Superintendent of Public Instruction,Joy Hofmeister,REP,420303,7,1,206,214,
Logan,Superintendent of Public Instruction,Linda Murphy,REP,420303,1,4,165,170,
Logan,Commissioner of Labor,Cathy Costello,REP,420303,7,2,175,184,
Logan,Commissioner of Labor,Leslie Osborn,REP,420303,1,3,199,203,
Logan,Corporation Commissioner,Bob Anthony,REP,420303,3,2,174,179,
Logan,Corporation Commissioner,Brian Bingman,REP,420303,5,3,200,208,
Logan,State House,John Pfeiffer,REP,420303,5,2,216,223,38
Logan,State House,Brian Hobbs,REP,420303,3,3,158,164,38
Logan,Governor,Chris Powell,LIB,420303,0,0,0,0,
Logan,Governor,Rex Lawhorn,LIB,420303,0,0,0,0,
Logan,Corporation Commissioner,Ashley Nicole Mccray,DEM,420303,0,1,18,19,
Logan,Corporation Commissioner,Blake Cummings,DEM,420303,4,2,18,24,
Logan,Governor,Mick Cornett,REP,420304,2,0,54,56,
Logan,Governor,Kevin Stitt,REP,420304,1,5,64,70,
Logan,Lieutenant Governor,Dana Murphy,REP,420304,0,3,61,64,
Logan,Lieutenant Governor,Matt Pinnell,REP,420304,3,2,55,60,
Logan,State Auditor,Cindy Byrd,REP,420304,3,4,41,48,
Logan,State Auditor,Charlie Prater,REP,420304,0,1,73,74,
Logan,Attorney General,Mike Hunter,REP,420304,1,0,49,50,
Logan,Attorney General,Gentner Drummond,REP,420304,2,5,67,74,
Logan,Superintendent of Public Instruction,Joy Hofmeister,REP,420304,1,1,69,71,
Logan,Superintendent of Public Instruction,Linda Murphy,REP,420304,2,4,47,53,
Logan,Commissioner of Labor,Cathy Costello,REP,420304,1,1,54,56,
Logan,Commissioner of Labor,Leslie Osborn,REP,420304,2,4,62,68,
Logan,Corporation Commissioner,Bob Anthony,REP,420304,2,2,62,66,
Logan,Corporation Commissioner,Brian Bingman,REP,420304,1,3,53,57,
Logan,State House,John Pfeiffer,REP,420304,2,4,74,80,38
Logan,State House,Brian Hobbs,REP,420304,1,1,43,45,38
Logan,Governor,Chris Powell,LIB,420304,0,0,0,0,
Logan,Governor,Rex Lawhorn,LIB,420304,0,0,0,0,
Logan,Corporation Commissioner,Ashley Nicole Mccray,DEM,420304,0,0,7,7,
Logan,Corporation Commissioner,Blake Cummings,DEM,420304,0,0,13,13,
Logan,Governor,Mick Cornett,REP,420305,5,10,83,98,
Logan,Governor,Kevin Stitt,REP,420305,0,15,98,113,
Logan,Lieutenant Governor,Dana Murphy,REP,420305,4,11,63,78,
Logan,Lieutenant Governor,Matt Pinnell,REP,420305,1,14,114,129,
Logan,State Auditor,Cindy Byrd,REP,420305,2,9,65,76,
Logan,State Auditor,Charlie Prater,REP,420305,3,16,111,130,
Logan,Attorney General,Mike Hunter,REP,420305,2,14,103,119,
Logan,Attorney General,Gentner Drummond,REP,420305,2,11,77,90,
Logan,Superintendent of Public Instruction,Joy Hofmeister,REP,420305,3,13,99,115,
Logan,Superintendent of Public Instruction,Linda Murphy,REP,420305,2,11,74,87,
Logan,Commissioner of Labor,Cathy Costello,REP,420305,5,11,84,100,
Logan,Commissioner of Labor,Leslie Osborn,REP,420305,0,14,96,110,
Logan,Corporation Commissioner,Bob Anthony,REP,420305,1,13,108,122,
Logan,Corporation Commissioner,Brian Bingman,REP,420305,3,12,70,85,
Logan,State House,John Pfeiffer,REP,420305,2,19,96,117,38
Logan,State House,Brian Hobbs,REP,420305,2,6,83,91,38
Logan,Governor,Chris Powell,LIB,420305,0,0,0,0,
Logan,Governor,Rex Lawhorn,LIB,420305,0,0,0,0,
Logan,Corporation Commissioner,Ashley Nicole Mccray,DEM,420305,1,4,28,33,
Logan,Corporation Commissioner,Blake Cummings,DEM,420305,0,1,11,12,
Logan,Governor,Mick Cornett,REP,420306,0,1,31,32,
Logan,Governor,Kevin Stitt,REP,420306,1,2,30,33,
Logan,Lieutenant Governor,Dana Murphy,REP,420306,0,2,27,29,
Logan,Lieutenant Governor,Matt Pinnell,REP,420306,1,1,35,37,
Logan,State Auditor,Cindy Byrd,REP,420306,1,3,20,24,
Logan,State Auditor,Charlie Prater,REP,420306,0,0,41,41,
Logan,Attorney General,Mike Hunter,REP,420306,1,1,26,28,
Logan,Attorney General,Gentner Drummond,REP,420306,0,2,36,38,
Logan,Superintendent of Public Instruction,Joy Hofmeister,REP,420306,0,1,31,32,
Logan,Superintendent of Public Instruction,Linda Murphy,REP,420306,1,2,31,34,
Logan,Commissioner of Labor,Cathy Costello,REP,420306,0,3,34,37,
Logan,Commissioner of Labor,Leslie Osborn,REP,420306,1,0,28,29,
Logan,Corporation Commissioner,Bob Anthony,REP,420306,0,3,39,42,
Logan,Corporation Commissioner,Brian Bingman,REP,420306,1,0,23,24,
Logan,Governor,Chris Powell,LIB,420306,0,0,0,0,
Logan,Governor,Rex Lawhorn,LIB,420306,0,0,0,0,
Logan,Corporation Commissioner,Ashley Nicole Mccray,DEM,420306,3,3,11,17,
Logan,Corporation Commissioner,Blake Cummings,DEM,420306,1,1,6,8,
Logan,Governor,Mick Cornett,REP,420307,7,16,106,129,
Logan,Governor,Kevin Stitt,REP,420307,7,4,84,95,
Logan,Lieutenant Governor,Dana Murphy,REP,420307,5,7,75,87,
Logan,Lieutenant Governor,Matt Pinnell,REP,420307,7,12,110,129,
Logan,State Auditor,Cindy Byrd,REP,420307,5,4,87,96,
Logan,State Auditor,Charlie Prater,REP,420307,9,14,97,120,
Logan,Attorney General,Mike Hunter,REP,420307,8,15,103,126,
Logan,Attorney General,Gentner Drummond,REP,420307,6,4,88,98,
Logan,Superintendent of Public Instruction,Joy Hofmeister,REP,420307,7,10,108,125,
Logan,Superintendent of Public Instruction,Linda Murphy,REP,420307,7,9,80,96,
Logan,Commissioner of Labor,Cathy Costello,REP,420307,5,10,97,112,
Logan,Commissioner of Labor,Leslie Osborn,REP,420307,7,10,91,108,
Logan,Corporation Commissioner,Bob Anthony,REP,420307,10,15,112,137,
Logan,Corporation Commissioner,Brian Bingman,REP,420307,4,4,77,85,
Logan,Governor,Chris Powell,LIB,420307,0,0,0,0,
Logan,Governor,Rex Lawhorn,LIB,420307,0,0,0,0,
Logan,Corporation Commissioner,Ashley Nicole Mccray,DEM,420307,0,4,22,26,
Logan,Corporation Commissioner,Blake Cummings,DEM,420307,3,1,12,16,
Logan,Governor,Mick Cornett,REP,420308,5,9,85,99,
Logan,Governor,Kevin Stitt,REP,420308,2,6,98,106,
Logan,Lieutenant Governor,Dana Murphy,REP,420308,1,7,66,74,
Logan,Lieutenant Governor,Matt Pinnell,REP,420308,6,8,113,127,
Logan,State Auditor,Cindy Byrd,REP,420308,6,12,61,79,
Logan,State Auditor,Charlie Prater,REP,420308,1,3,112,116,
Logan,Attorney General,Mike Hunter,REP,420308,2,11,88,101,
Logan,Attorney General,Gentner Drummond,REP,420308,3,4,91,98,
Logan,Superintendent of Public Instruction,Joy Hofmeister,REP,420308,3,10,117,130,
Logan,Superintendent of Public Instruction,Linda Murphy,REP,420308,4,5,63,72,
Logan,Commissioner of Labor,Cathy Costello,REP,420308,3,12,86,101,
Logan,Commissioner of Labor,Leslie Osborn,REP,420308,4,3,90,97,
Logan,Corporation Commissioner,Bob Anthony,REP,420308,5,12,94,111,
Logan,Corporation Commissioner,Brian Bingman,REP,420308,2,3,84,89,
Logan,Governor,Chris Powell,LIB,420308,1,0,0,1,
Logan,Governor,Rex Lawhorn,LIB,420308,0,0,0,0,
Logan,Corporation Commissioner,Ashley Nicole Mccray,DEM,420308,1,4,29,34,
Logan,Corporation Commissioner,Blake Cummings,DEM,420308,0,2,16,18,
Logan,Governor,Mick Cornett,REP,420309,0,1,1,2,
Logan,Governor,Kevin Stitt,REP,420309,0,0,3,3,
Logan,Lieutenant Governor,Dana Murphy,REP,420309,0,0,3,3,
Logan,Lieutenant Governor,Matt Pinnell,REP,420309,0,1,1,2,
Logan,State Auditor,Cindy Byrd,REP,420309,0,1,0,1,
Logan,State Auditor,Charlie Prater,REP,420309,0,0,4,4,
Logan,Attorney General,Mike Hunter,REP,420309,0,1,3,4,
Logan,Attorney General,Gentner Drummond,REP,420309,0,0,1,1,
Logan,Superintendent of Public Instruction,Joy Hofmeister,REP,420309,0,1,0,1,
Logan,Superintendent of Public Instruction,Linda Murphy,REP,420309,0,0,4,4,
Logan,Commissioner of Labor,Cathy Costello,REP,420309,0,0,4,4,
Logan,Commissioner of Labor,Leslie Osborn,REP,420309,0,1,0,1,
Logan,Corporation Commissioner,Bob Anthony,REP,420309,0,0,3,3,
Logan,Corporation Commissioner,Brian Bingman,REP,420309,0,1,1,2,
Logan,Governor,Chris Powell,LIB,420309,0,0,0,0,
Logan,Governor,Rex Lawhorn,LIB,420309,0,0,0,0,
Logan,Corporation Commissioner,Ashley Nicole Mccray,DEM,420309,0,0,2,2,
Logan,Corporation Commissioner,Blake Cummings,DEM,420309,0,0,0,0,
Logan,Governor,Mick Cornett,REP,420310,0,0,2,2,
Logan,Governor,Kevin Stitt,REP,420310,0,0,1,1,
Logan,Lieutenant Governor,Dana Murphy,REP,420310,0,0,2,2,
Logan,Lieutenant Governor,Matt Pinnell,REP,420310,0,0,1,1,
Logan,State Auditor,Cindy Byrd,REP,420310,0,0,2,2,
Logan,State Auditor,Charlie Prater,REP,420310,0,0,1,1,
Logan,Attorney General,Mike Hunter,REP,420310,0,0,2,2,
Logan,Attorney General,Gentner Drummond,REP,420310,0,0,1,1,
Logan,Superintendent of Public Instruction,Joy Hofmeister,REP,420310,0,0,3,3,
Logan,Superintendent of Public Instruction,Linda Murphy,REP,420310,0,0,0,0,
Logan,Commissioner of Labor,Cathy Costello,REP,420310,0,0,2,2,
Logan,Commissioner of Labor,Leslie Osborn,REP,420310,0,0,1,1,
Logan,Corporation Commissioner,Bob Anthony,REP,420310,0,0,2,2,
Logan,Corporation Commissioner,Brian Bingman,REP,420310,0,0,1,1,
Logan,Governor,Chris Powell,LIB,420310,0,0,0,0,
Logan,Governor,Rex Lawhorn,LIB,420310,0,0,0,0,
Logan,Corporation Commissioner,Ashley Nicole Mccray,DEM,420310,1,0,18,19,
Logan,Corporation Commissioner,Blake Cummings,DEM,420310,0,0,6,6,
Love,Governor,Mick Cornett,REP,430101,0,0,8,8,
Love,Governor,Kevin Stitt,REP,430101,2,3,20,25,
Love,Lieutenant Governor,Dana Murphy,REP,430101,0,0,7,7,
Love,Lieutenant Governor,Matt Pinnell,REP,430101,2,3,19,24,
Love,State Auditor,Cindy Byrd,REP,430101,0,2,14,16,
Love,State Auditor,Charlie Prater,REP,430101,2,1,12,15,
Love,Attorney General,Mike Hunter,REP,430101,1,1,12,14,
Love,Attorney General,Gentner Drummond,REP,430101,1,2,14,17,
Love,Superintendent of Public Instruction,Joy Hofmeister,REP,430101,2,0,12,14,
Love,Superintendent of Public Instruction,Linda Murphy,REP,430101,0,3,13,16,
Love,Commissioner of Labor,Cathy Costello,REP,430101,0,2,12,14,
Love,Commissioner of Labor,Leslie Osborn,REP,430101,2,1,13,16,
Love,Corporation Commissioner,Bob Anthony,REP,430101,2,1,7,10,
Love,Corporation Commissioner,Brian Bingman,REP,430101,0,2,19,21,
Love,Governor,Chris Powell,LIB,430101,0,0,0,0,
Love,Governor,Rex Lawhorn,LIB,430101,0,0,0,0,
Love,Corporation Commissioner,Ashley Nicole Mccray,DEM,430101,0,1,26,27,
Love,Corporation Commissioner,Blake Cummings,DEM,430101,1,0,29,30,
Love,U.S. House,Mary Brannon,DEM,430101,0,1,30,31,04
Love,U.S. House,Fred Gipson,DEM,430101,1,1,25,27,04
Love,Governor,Mick Cornett,REP,430102,0,0,8,8,
Love,Governor,Kevin Stitt,REP,430102,1,0,14,15,
Love,Lieutenant Governor,Dana Murphy,REP,430102,1,0,6,7,
Love,Lieutenant Governor,Matt Pinnell,REP,430102,0,0,15,15,
Love,State Auditor,Cindy Byrd,REP,430102,1,0,12,13,
Love,State Auditor,Charlie Prater,REP,430102,0,0,8,8,
Love,Attorney General,Mike Hunter,REP,430102,1,0,12,13,
Love,Attorney General,Gentner Drummond,REP,430102,0,0,10,10,
Love,Superintendent of Public Instruction,Joy Hofmeister,REP,430102,0,0,14,14,
Love,Superintendent of Public Instruction,Linda Murphy,REP,430102,1,0,6,7,
Love,Commissioner of Labor,Cathy Costello,REP,430102,0,0,9,9,
Love,Commissioner of Labor,Leslie Osborn,REP,430102,1,0,10,11,
Love,Corporation Commissioner,Bob Anthony,REP,430102,0,0,9,9,
Love,Corporation Commissioner,Brian Bingman,REP,430102,1,0,10,11,
Love,Governor,Chris Powell,LIB,430102,0,0,0,0,
Love,Governor,Rex Lawhorn,LIB,430102,0,0,0,0,
Love,Corporation Commissioner,Ashley Nicole Mccray,DEM,430102,0,2,23,25,
Love,Corporation Commissioner,Blake Cummings,DEM,430102,0,1,13,14,
Love,U.S. House,Mary Brannon,DEM,430102,0,1,22,23,04
Love,U.S. House,Fred Gipson,DEM,430102,0,1,14,15,04
Love,Governor,Mick Cornett,REP,430103,0,0,8,8,
Love,Governor,Kevin Stitt,REP,430103,0,2,22,24,
Love,Lieutenant Governor,Dana Murphy,REP,430103,0,0,11,11,
Love,Lieutenant Governor,Matt Pinnell,REP,430103,0,2,15,17,
Love,State Auditor,Cindy Byrd,REP,430103,0,2,9,11,
Love,State Auditor,Charlie Prater,REP,430103,0,0,17,17,
Love,Attorney General,Mike Hunter,REP,430103,0,0,11,11,
Love,Attorney General,Gentner Drummond,REP,430103,0,2,18,20,
Love,Superintendent of Public Instruction,Joy Hofmeister,REP,430103,0,2,11,13,
Love,Superintendent of Public Instruction,Linda Murphy,REP,430103,0,0,16,16,
Love,Commissioner of Labor,Cathy Costello,REP,430103,0,2,9,11,
Love,Commissioner of Labor,Leslie Osborn,REP,430103,0,0,16,16,
Love,Corporation Commissioner,Bob Anthony,REP,430103,0,0,15,15,
Love,Corporation Commissioner,Brian Bingman,REP,430103,0,2,13,15,
Love,Governor,Chris Powell,LIB,430103,0,0,0,0,
Love,Governor,Rex Lawhorn,LIB,430103,0,0,0,0,
Love,Corporation Commissioner,Ashley Nicole Mccray,DEM,430103,0,1,15,16,
Love,Corporation Commissioner,Blake Cummings,DEM,430103,0,1,6,7,
Love,U.S. House,Mary Brannon,DEM,430103,0,0,5,5,04
Love,U.S. House,Fred Gipson,DEM,430103,0,2,16,18,04
Love,Governor,Mick Cornett,REP,430204,1,0,3,4,
Love,Governor,Kevin Stitt,REP,430204,0,0,8,8,
Love,Lieutenant Governor,Dana Murphy,REP,430204,1,0,4,5,
Love,Lieutenant Governor,Matt Pinnell,REP,430204,0,0,6,6,
Love,State Auditor,Cindy Byrd,REP,430204,0,0,4,4,
Love,State Auditor,Charlie Prater,REP,430204,1,0,5,6,
Love,Attorney General,Mike Hunter,REP,430204,1,0,4,5,
Love,Attorney General,Gentner Drummond,REP,430204,0,0,6,6,
Love,Superintendent of Public Instruction,Joy Hofmeister,REP,430204,0,0,5,5,
Love,Superintendent of Public Instruction,Linda Murphy,REP,430204,1,0,6,7,
Love,Commissioner of Labor,Cathy Costello,REP,430204,1,0,3,4,
Love,Commissioner of Labor,Leslie Osborn,REP,430204,0,0,6,6,
Love,Corporation Commissioner,Bob Anthony,REP,430204,1,0,7,8,
Love,Corporation Commissioner,Brian Bingman,REP,430204,0,0,3,3,
Love,Governor,Chris Powell,LIB,430204,0,0,0,0,
Love,Governor,Rex Lawhorn,LIB,430204,0,0,0,0,
Love,Corporation Commissioner,Ashley Nicole Mccray,DEM,430204,2,3,23,28,
Love,Corporation Commissioner,Blake Cummings,DEM,430204,0,2,21,23,
Love,U.S. House,Mary Brannon,DEM,430204,2,0,21,23,04
Love,U.S. House,Fred Gipson,DEM,430204,0,5,23,28,04
Love,Governor,Mick Cornett,REP,430205,1,0,22,23,
Love,Governor,Kevin Stitt,REP,430205,0,0,34,34,
Love,Lieutenant Governor,Dana Murphy,REP,430205,1,0,18,19,
Love,Lieutenant Governor,Matt Pinnell,REP,430205,0,0,35,35,
Love,State Auditor,Cindy Byrd,REP,430205,1,0,25,26,
Love,State Auditor,Charlie Prater,REP,430205,0,0,28,28,
Love,Attorney General,Mike Hunter,REP,430205,0,0,20,20,
Love,Attorney General,Gentner Drummond,REP,430205,1,0,35,36,
Love,Superintendent of Public Instruction,Joy Hofmeister,REP,430205,0,0,28,28,
Love,Superintendent of Public Instruction,Linda Murphy,REP,430205,1,0,24,25,
Love,Commissioner of Labor,Cathy Costello,REP,430205,1,0,21,22,
Love,Commissioner of Labor,Leslie Osborn,REP,430205,0,0,31,31,
Love,Corporation Commissioner,Bob Anthony,REP,430205,0,0,33,33,
Love,Corporation Commissioner,Brian Bingman,REP,430205,1,0,20,21,
Love,Governor,Chris Powell,LIB,430205,0,0,0,0,
Love,Governor,Rex Lawhorn,LIB,430205,0,1,0,1,
Love,Corporation Commissioner,Ashley Nicole Mccray,DEM,430205,0,1,12,13,
Love,Corporation Commissioner,Blake Cummings,DEM,430205,0,0,14,14,
Love,U.S. House,Mary Brannon,DEM,430205,0,0,8,8,04
Love,U.S. House,Fred Gipson,DEM,430205,0,1,18,19,04
Love,Governor,Mick Cornett,REP,430206,0,0,1,1,
Love,Governor,Kevin Stitt,REP,430206,0,1,9,10,
Love,Lieutenant Governor,Dana Murphy,REP,430206,0,1,5,6,
Love,Lieutenant Governor,Matt Pinnell,REP,430206,0,0,5,5,
Love,State Auditor,Cindy Byrd,REP,430206,0,1,4,5,
Love,State Auditor,Charlie Prater,REP,430206,0,0,6,6,
Love,Attorney General,Mike Hunter,REP,430206,0,1,4,5,
Love,Attorney General,Gentner Drummond,REP,430206,0,0,6,6,
Love,Superintendent of Public Instruction,Joy Hofmeister,REP,430206,0,0,5,5,
Love,Superintendent of Public Instruction,Linda Murphy,REP,430206,0,1,5,6,
Love,Commissioner of Labor,Cathy Costello,REP,430206,0,1,3,4,
Love,Commissioner of Labor,Leslie Osborn,REP,430206,0,0,7,7,
Love,Corporation Commissioner,Bob Anthony,REP,430206,0,0,6,6,
Love,Corporation Commissioner,Brian Bingman,REP,430206,0,1,4,5,
Love,Governor,Chris Powell,LIB,430206,0,0,0,0,
Love,Governor,Rex Lawhorn,LIB,430206,0,0,0,0,
Love,Corporation Commissioner,Ashley Nicole Mccray,DEM,430206,0,1,8,9,
Love,Corporation Commissioner,Blake Cummings,DEM,430206,0,0,7,7,
Love,U.S. House,Mary Brannon,DEM,430206,0,1,8,9,04
Love,U.S. House,Fred Gipson,DEM,430206,0,0,8,8,04
Love,Governor,Mick Cornett,REP,430207,0,0,0,0,
Love,Governor,Kevin Stitt,REP,430207,0,1,1,2,
Love,Lieutenant Governor,Dana Murphy,REP,430207,0,0,0,0,
Love,Lieutenant Governor,Matt Pinnell,REP,430207,0,1,1,2,
Love,State Auditor,Cindy Byrd,REP,430207,0,0,1,1,
Love,State Auditor,Charlie Prater,REP,430207,0,1,0,1,
Love,Attorney General,Mike Hunter,REP,430207,0,0,0,0,
Love,Attorney General,Gentner Drummond,REP,430207,0,1,1,2,
Love,Superintendent of Public Instruction,Joy Hofmeister,REP,430207,0,1,0,1,
Love,Superintendent of Public Instruction,Linda Murphy,REP,430207,0,0,1,1,
Love,Commissioner of Labor,Cathy Costello,REP,430207,0,0,0,0,
Love,Commissioner of Labor,Leslie Osborn,REP,430207,0,1,1,2,
Love,Corporation Commissioner,Bob Anthony,REP,430207,0,0,1,1,
Love,Corporation Commissioner,Brian Bingman,REP,430207,0,1,0,1,
Love,Governor,Chris Powell,LIB,430207,0,0,0,0,
Love,Governor,Rex Lawhorn,LIB,430207,0,0,0,0,
Love,Corporation Commissioner,Ashley Nicole Mccray,DEM,430207,0,3,6,9,
Love,Corporation Commissioner,Blake Cummings,DEM,430207,1,0,4,5,
Love,U.S. House,Mary Brannon,DEM,430207,0,0,6,6,04
Love,U.S. House,Fred Gipson,DEM,430207,2,3,4,9,04
Love,Governor,Mick Cornett,REP,430208,0,0,0,0,
Love,Governor,Kevin Stitt,REP,430208,0,0,5,5,
Love,Lieutenant Governor,Dana Murphy,REP,430208,0,0,2,2,
Love,Lieutenant Governor,Matt Pinnell,REP,430208,0,0,3,3,
Love,State Auditor,Cindy Byrd,REP,430208,0,0,2,2,
Love,State Auditor,Charlie Prater,REP,430208,0,0,3,3,
Love,Attorney General,Mike Hunter,REP,430208,0,0,3,3,
Love,Attorney General,Gentner Drummond,REP,430208,0,0,2,2,
Love,Superintendent of Public Instruction,Joy Hofmeister,REP,430208,0,0,1,1,
Love,Superintendent of Public Instruction,Linda Murphy,REP,430208,0,0,4,4,
Love,Commissioner of Labor,Cathy Costello,REP,430208,0,0,0,0,
Love,Commissioner of Labor,Leslie Osborn,REP,430208,0,0,5,5,
Love,Corporation Commissioner,Bob Anthony,REP,430208,0,0,4,4,
Love,Corporation Commissioner,Brian Bingman,REP,430208,0,0,1,1,
Love,Governor,Chris Powell,LIB,430208,0,0,0,0,
Love,Governor,Rex Lawhorn,LIB,430208,0,0,0,0,
Love,Corporation Commissioner,Ashley Nicole Mccray,DEM,430208,0,0,2,2,
Love,Corporation Commissioner,Blake Cummings,DEM,430208,0,0,11,11,
Love,U.S. House,Mary Brannon,DEM,430208,0,0,2,2,04
Love,U.S. House,Fred Gipson,DEM,430208,0,0,10,10,04
Love,Governor,Mick Cornett,REP,430310,0,0,5,5,
Love,Governor,Kevin Stitt,REP,430310,0,1,17,18,
Love,Lieutenant Governor,Dana Murphy,REP,430310,0,1,13,14,
Love,Lieutenant Governor,Matt Pinnell,REP,430310,0,0,8,8,
Love,State Auditor,Cindy Byrd,REP,430310,0,0,5,5,
Love,State Auditor,Charlie Prater,REP,430310,0,1,14,15,
Love,Attorney General,Mike Hunter,REP,430310,0,0,12,12,
Love,Attorney General,Gentner Drummond,REP,430310,0,1,8,9,
Love,Superintendent of Public Instruction,Joy Hofmeister,REP,430310,0,0,14,14,
Love,Superintendent of Public Instruction,Linda Murphy,REP,430310,0,1,5,6,
Love,Commissioner of Labor,Cathy Costello,REP,430310,0,0,9,9,
Love,Commissioner of Labor,Leslie Osborn,REP,430310,0,1,11,12,
Love,Corporation Commissioner,Bob Anthony,REP,430310,0,1,11,12,
Love,Corporation Commissioner,Brian Bingman,REP,430310,0,0,8,8,
Love,Governor,Chris Powell,LIB,430310,0,0,0,0,
Love,Governor,Rex Lawhorn,LIB,430310,0,0,0,0,
Love,Corporation Commissioner,Ashley Nicole Mccray,DEM,430310,0,2,40,42,
Love,Corporation Commissioner,Blake Cummings,DEM,430310,1,2,42,45,
Love,U.S. House,Mary Brannon,DEM,430310,1,1,45,47,04
Love,U.S. House,Fred Gipson,DEM,430310,0,3,39,42,04
Love,Governor,Mick Cornett,REP,430311,0,2,21,23,
Love,Governor,Kevin Stitt,REP,430311,0,1,29,30,
Love,Lieutenant Governor,Dana Murphy,REP,430311,0,2,18,20,
Love,Lieutenant Governor,Matt Pinnell,REP,430311,0,1,31,32,
Love,State Auditor,Cindy Byrd,REP,430311,0,2,17,19,
Love,State Auditor,Charlie Prater,REP,430311,0,1,29,30,
Love,Attorney General,Mike Hunter,REP,430311,0,2,32,34,
Love,Attorney General,Gentner Drummond,REP,430311,0,1,15,16,
Love,Superintendent of Public Instruction,Joy Hofmeister,REP,430311,0,1,21,22,
Love,Superintendent of Public Instruction,Linda Murphy,REP,430311,0,2,25,27,
Love,Commissioner of Labor,Cathy Costello,REP,430311,0,1,21,22,
Love,Commissioner of Labor,Leslie Osborn,REP,430311,0,2,23,25,
Love,Corporation Commissioner,Bob Anthony,REP,430311,0,1,24,25,
Love,Corporation Commissioner,Brian Bingman,REP,430311,0,2,20,22,
Love,Governor,Chris Powell,LIB,430311,0,0,0,0,
Love,Governor,Rex Lawhorn,LIB,430311,0,0,0,0,
Love,Corporation Commissioner,Ashley Nicole Mccray,DEM,430311,2,3,39,44,
Love,Corporation Commissioner,Blake Cummings,DEM,430311,0,2,31,33,
Love,U.S. House,Mary Brannon,DEM,430311,2,3,34,39,04
Love,U.S. House,Fred Gipson,DEM,430311,0,2,35,37,04
Love,Governor,Mick Cornett,REP,430312,0,0,9,9,
Love,Governor,Kevin Stitt,REP,430312,0,0,25,25,
Love,Lieutenant Governor,Dana Murphy,REP,430312,0,0,13,13,
Love,Lieutenant Governor,Matt Pinnell,REP,430312,0,0,21,21,
Love,State Auditor,Cindy Byrd,REP,430312,0,0,19,19,
Love,State Auditor,Charlie Prater,REP,430312,0,0,13,13,
Love,Attorney General,Mike Hunter,REP,430312,0,0,11,11,
Love,Attorney General,Gentner Drummond,REP,430312,0,0,23,23,
Love,Superintendent of Public Instruction,Joy Hofmeister,REP,430312,0,0,22,22,
Love,Superintendent of Public Instruction,Linda Murphy,REP,430312,0,0,12,12,
Love,Commissioner of Labor,Cathy Costello,REP,430312,0,0,16,16,
Love,Commissioner of Labor,Leslie Osborn,REP,430312,0,0,15,15,
Love,Corporation Commissioner,Bob Anthony,REP,430312,0,0,9,9,
Love,Corporation Commissioner,Brian Bingman,REP,430312,0,0,23,23,
Love,Governor,Chris Powell,LIB,430312,0,0,0,0,
Love,Governor,Rex Lawhorn,LIB,430312,0,0,0,0,
Love,Corporation Commissioner,Ashley Nicole Mccray,DEM,430312,1,0,35,36,
Love,Corporation Commissioner,Blake Cummings,DEM,430312,1,3,57,61,
Love,U.S. House,Mary Brannon,DEM,430312,0,1,37,38,04
Love,U.S. House,Fred Gipson,DEM,430312,2,2,54,58,04
Love,Governor,Mick Cornett,REP,430313,0,1,4,5,
Love,Governor,Kevin Stitt,REP,430313,0,0,9,9,
Love,Lieutenant Governor,Dana Murphy,REP,430313,0,0,3,3,
Love,Lieutenant Governor,Matt Pinnell,REP,430313,0,1,11,12,
Love,State Auditor,Cindy Byrd,REP,430313,0,0,5,5,
Love,State Auditor,Charlie Prater,REP,430313,0,1,7,8,
Love,Attorney General,Mike Hunter,REP,430313,0,1,7,8,
Love,Attorney General,Gentner Drummond,REP,430313,0,0,7,7,
Love,Superintendent of Public Instruction,Joy Hofmeister,REP,430313,0,1,5,6,
Love,Superintendent of Public Instruction,Linda Murphy,REP,430313,0,0,7,7,
Love,Commissioner of Labor,Cathy Costello,REP,430313,0,1,8,9,
Love,Commissioner of Labor,Leslie Osborn,REP,430313,0,0,6,6,
Love,Corporation Commissioner,Bob Anthony,REP,430313,0,0,9,9,
Love,Corporation Commissioner,Brian Bingman,REP,430313,0,1,5,6,
Love,Governor,Chris Powell,LIB,430313,0,0,0,0,
Love,Governor,Rex Lawhorn,LIB,430313,0,0,0,0,
Love,Corporation Commissioner,Ashley Nicole Mccray,DEM,430313,0,0,20,20,
Love,Corporation Commissioner,Blake Cummings,DEM,430313,0,0,10,10,
Love,U.S. House,Mary Brannon,DEM,430313,0,0,18,18,04
Love,U.S. House,Fred Gipson,DEM,430313,0,0,11,11,04
Mcclain,Governor,Mick Cornett,REP,440001,1,1,16,18,
Mcclain,Governor,Kevin Stitt,REP,440001,0,0,28,28,
Mcclain,Lieutenant Governor,Dana Murphy,REP,440001,0,1,18,19,
Mcclain,Lieutenant Governor,Matt Pinnell,REP,440001,1,0,26,27,
Mcclain,State Auditor,Cindy Byrd,REP,440001,1,1,20,22,
Mcclain,State Auditor,Charlie Prater,REP,440001,0,0,24,24,
Mcclain,Attorney General,Mike Hunter,REP,440001,1,1,26,28,
Mcclain,Attorney General,Gentner Drummond,REP,440001,0,0,18,18,
Mcclain,Superintendent of Public Instruction,Joy Hofmeister,REP,440001,0,0,27,27,
Mcclain,Superintendent of Public Instruction,Linda Murphy,REP,440001,1,1,17,19,
Mcclain,Commissioner of Labor,Cathy Costello,REP,440001,0,1,14,15,
Mcclain,Commissioner of Labor,Leslie Osborn,REP,440001,1,0,27,28,
Mcclain,Corporation Commissioner,Bob Anthony,REP,440001,1,0,19,20,
Mcclain,Corporation Commissioner,Brian Bingman,REP,440001,0,1,24,25,
Mcclain,State House,Bobby Cleveland,REP,440001,1,0,32,33,20
Mcclain,State House,Sherrie Conley,REP,440001,0,1,12,13,20
Mcclain,Governor,Chris Powell,LIB,440001,0,0,0,0,
Mcclain,Governor,Rex Lawhorn,LIB,440001,0,0,0,0,
Mcclain,Corporation Commissioner,Ashley Nicole Mccray,DEM,440001,0,0,3,3,
Mcclain,Corporation Commissioner,Blake Cummings,DEM,440001,0,0,8,8,
Mcclain,U.S. House,Mary Brannon,DEM,440001,0,0,5,5,04
Mcclain,U.S. House,Fred Gipson,DEM,440001,0,0,6,6,04
Mcclain,Governor,Mick Cornett,REP,440002,1,0,17,18,
Mcclain,Governor,Kevin Stitt,REP,440002,2,0,36,38,
Mcclain,Lieutenant Governor,Dana Murphy,REP,440002,3,0,24,27,
Mcclain,Lieutenant Governor,Matt Pinnell,REP,440002,0,0,28,28,
Mcclain,State Auditor,Cindy Byrd,REP,440002,1,0,22,23,
Mcclain,State Auditor,Charlie Prater,REP,440002,2,0,30,32,
Mcclain,Attorney General,Mike Hunter,REP,440002,2,0,20,22,
Mcclain,Attorney General,Gentner Drummond,REP,440002,1,0,32,33,
Mcclain,Superintendent of Public Instruction,Joy Hofmeister,REP,440002,2,0,32,34,
Mcclain,Superintendent of Public Instruction,Linda Murphy,REP,440002,1,0,20,21,
Mcclain,Commissioner of Labor,Cathy Costello,REP,440002,0,0,19,19,
Mcclain,Commissioner of Labor,Leslie Osborn,REP,440002,3,0,33,36,
Mcclain,Corporation Commissioner,Bob Anthony,REP,440002,3,0,29,32,
Mcclain,Corporation Commissioner,Brian Bingman,REP,440002,0,0,23,23,
Mcclain,State House,Bobby Cleveland,REP,440002,3,0,26,29,20
Mcclain,State House,Sherrie Conley,REP,440002,0,0,26,26,20
Mcclain,Governor,Chris Powell,LIB,440002,0,0,0,0,
Mcclain,Governor,Rex Lawhorn,LIB,440002,0,0,0,0,
Mcclain,Corporation Commissioner,Ashley Nicole Mccray,DEM,440002,0,0,7,7,
Mcclain,Corporation Commissioner,Blake Cummings,DEM,440002,0,0,8,8,
Mcclain,U.S. House,Mary Brannon,DEM,440002,0,0,8,8,04
Mcclain,U.S. House,Fred Gipson,DEM,440002,0,0,7,7,04
Mcclain,Governor,Mick Cornett,REP,440003,0,0,21,21,
Mcclain,Governor,Kevin Stitt,REP,440003,0,5,32,37,
Mcclain,Lieutenant Governor,Dana Murphy,REP,440003,0,0,24,24,
Mcclain,Lieutenant Governor,Matt Pinnell,REP,440003,0,5,27,32,
Mcclain,State Auditor,Cindy Byrd,REP,440003,0,2,21,23,
Mcclain,State Auditor,Charlie Prater,REP,440003,0,3,31,34,
Mcclain,Attorney General,Mike Hunter,REP,440003,0,1,24,25,
Mcclain,Attorney General,Gentner Drummond,REP,440003,0,4,28,32,
Mcclain,Superintendent of Public Instruction,Joy Hofmeister,REP,440003,0,3,26,29,
Mcclain,Superintendent of Public Instruction,Linda Murphy,REP,440003,0,2,27,29,
Mcclain,Commissioner of Labor,Cathy Costello,REP,440003,0,2,8,10,
Mcclain,Commissioner of Labor,Leslie Osborn,REP,440003,0,3,45,48,
Mcclain,Corporation Commissioner,Bob Anthony,REP,440003,0,2,13,15,
Mcclain,Corporation Commissioner,Brian Bingman,REP,440003,0,3,38,41,
Mcclain,State House,Bobby Cleveland,REP,440003,0,3,23,26,20
Mcclain,State House,Sherrie Conley,REP,440003,0,2,30,32,20
Mcclain,Governor,Chris Powell,LIB,440003,0,0,0,0,
Mcclain,Governor,Rex Lawhorn,LIB,440003,0,0,1,1,
Mcclain,Corporation Commissioner,Ashley Nicole Mccray,DEM,440003,2,2,13,17,
Mcclain,Corporation Commissioner,Blake Cummings,DEM,440003,0,0,7,7,
Mcclain,U.S. House,Mary Brannon,DEM,440003,2,2,13,17,04
Mcclain,U.S. House,Fred Gipson,DEM,440003,0,0,7,7,04
Mcclain,Governor,Mick Cornett,REP,440004,0,1,18,19,
Mcclain,Governor,Kevin Stitt,REP,440004,1,2,42,45,
Mcclain,Lieutenant Governor,Dana Murphy,REP,440004,0,1,16,17,
Mcclain,Lieutenant Governor,Matt Pinnell,REP,440004,1,2,41,44,
Mcclain,State Auditor,Cindy Byrd,REP,440004,0,2,16,18,
Mcclain,State Auditor,Charlie Prater,REP,440004,0,1,41,42,
Mcclain,Attorney General,Mike Hunter,REP,440004,0,1,30,31,
Mcclain,Attorney General,Gentner Drummond,REP,440004,1,2,30,33,
Mcclain,Superintendent of Public Instruction,Joy Hofmeister,REP,440004,0,0,33,33,
Mcclain,Superintendent of Public Instruction,Linda Murphy,REP,440004,1,3,24,28,
Mcclain,Commissioner of Labor,Cathy Costello,REP,440004,1,3,23,27,
Mcclain,Commissioner of Labor,Leslie Osborn,REP,440004,0,0,34,34,
Mcclain,Corporation Commissioner,Bob Anthony,REP,440004,0,2,30,32,
Mcclain,Corporation Commissioner,Brian Bingman,REP,440004,1,1,26,28,
Mcclain,Governor,Chris Powell,LIB,440004,0,0,0,0,
Mcclain,Governor,Rex Lawhorn,LIB,440004,0,0,0,0,
Mcclain,Corporation Commissioner,Ashley Nicole Mccray,DEM,440004,0,0,14,14,
Mcclain,Corporation Commissioner,Blake Cummings,DEM,440004,0,0,18,18,
Mcclain,U.S. House,Mary Brannon,DEM,440004,0,0,20,20,04
Mcclain,U.S. House,Fred Gipson,DEM,440004,0,0,11,11,04
Mcclain,Governor,Mick Cornett,REP,440005,5,3,37,45,
Mcclain,Governor,Kevin Stitt,REP,440005,3,4,79,86,
Mcclain,Lieutenant Governor,Dana Murphy,REP,440005,0,4,32,36,
Mcclain,Lieutenant Governor,Matt Pinnell,REP,440005,8,3,82,93,
Mcclain,State Auditor,Cindy Byrd,REP,440005,4,5,50,59,
Mcclain,State Auditor,Charlie Prater,REP,440005,4,2,64,70,
Mcclain,Attorney General,Mike Hunter,REP,440005,5,6,48,59,
Mcclain,Attorney General,Gentner Drummond,REP,440005,3,1,66,70,
Mcclain,Superintendent of Public Instruction,Joy Hofmeister,REP,440005,6,3,52,61,
Mcclain,Superintendent of Public Instruction,Linda Murphy,REP,440005,2,4,63,69,
Mcclain,Commissioner of Labor,Cathy Costello,REP,440005,4,3,41,48,
Mcclain,Commissioner of Labor,Leslie Osborn,REP,440005,4,4,72,80,
Mcclain,Corporation Commissioner,Bob Anthony,REP,440005,4,7,49,60,
Mcclain,Corporation Commissioner,Brian Bingman,REP,440005,4,0,64,68,
Mcclain,Governor,Chris Powell,LIB,440005,0,0,0,0,
Mcclain,Governor,Rex Lawhorn,LIB,440005,0,0,2,2,
Mcclain,Corporation Commissioner,Ashley Nicole Mccray,DEM,440005,4,0,7,11,
Mcclain,Corporation Commissioner,Blake Cummings,DEM,440005,2,0,10,12,
Mcclain,U.S. House,Mary Brannon,DEM,440005,3,0,10,13,04
Mcclain,U.S. House,Fred Gipson,DEM,440005,3,0,8,11,04
Mcclain,Governor,Mick Cornett,REP,440006,3,14,91,108,
Mcclain,Governor,Kevin Stitt,REP,440006,9,14,139,162,
Mcclain,Lieutenant Governor,Dana Murphy,REP,440006,2,12,117,131,
Mcclain,Lieutenant Governor,Matt Pinnell,REP,440006,10,15,107,132,
Mcclain,State Auditor,Cindy Byrd,REP,440006,5,13,109,127,
Mcclain,State Auditor,Charlie Prater,REP,440006,7,12,110,129,
Mcclain,Attorney General,Mike Hunter,REP,440006,7,12,119,138,
Mcclain,Attorney General,Gentner Drummond,REP,440006,5,16,110,131,
Mcclain,Superintendent of Public Instruction,Joy Hofmeister,REP,440006,5,16,134,155,
Mcclain,Superintendent of Public Instruction,Linda Murphy,REP,440006,7,11,95,113,
Mcclain,Commissioner of Labor,Cathy Costello,REP,440006,7,16,86,109,
Mcclain,Commissioner of Labor,Leslie Osborn,REP,440006,5,12,139,156,
Mcclain,Corporation Commissioner,Bob Anthony,REP,440006,3,18,113,134,
Mcclain,Corporation Commissioner,Brian Bingman,REP,440006,9,10,114,133,
Mcclain,Governor,Chris Powell,LIB,440006,0,0,2,2,
Mcclain,Governor,Rex Lawhorn,LIB,440006,0,0,1,1,
Mcclain,Corporation Commissioner,Ashley Nicole Mccray,DEM,440006,3,5,37,45,
Mcclain,Corporation Commissioner,Blake Cummings,DEM,440006,1,3,41,45,
Mcclain,U.S. House,Mary Brannon,DEM,440006,3,7,52,62,04
Mcclain,U.S. House,Fred Gipson,DEM,440006,1,1,28,30,04
Mcclain,Governor,Mick Cornett,REP,440007,0,2,31,33,
Mcclain,Governor,Kevin Stitt,REP,440007,1,7,47,55,
Mcclain,Lieutenant Governor,Dana Murphy,REP,440007,0,6,34,40,
Mcclain,Lieutenant Governor,Matt Pinnell,REP,440007,1,3,40,44,
Mcclain,State Auditor,Cindy Byrd,REP,440007,1,2,34,37,
Mcclain,State Auditor,Charlie Prater,REP,440007,0,6,37,43,
Mcclain,Attorney General,Mike Hunter,REP,440007,0,3,31,34,
Mcclain,Attorney General,Gentner Drummond,REP,440007,1,6,46,53,
Mcclain,Superintendent of Public Instruction,Joy Hofmeister,REP,440007,0,6,41,47,
Mcclain,Superintendent of Public Instruction,Linda Murphy,REP,440007,1,3,35,39,
Mcclain,Commissioner of Labor,Cathy Costello,REP,440007,1,3,34,38,
Mcclain,Commissioner of Labor,Leslie Osborn,REP,440007,0,6,40,46,
Mcclain,Corporation Commissioner,Bob Anthony,REP,440007,1,4,34,39,
Mcclain,Corporation Commissioner,Brian Bingman,REP,440007,0,5,39,44,
Mcclain,Governor,Chris Powell,LIB,440007,0,0,0,0,
Mcclain,Governor,Rex Lawhorn,LIB,440007,0,0,0,0,
Mcclain,Corporation Commissioner,Ashley Nicole Mccray,DEM,440007,1,2,18,21,
Mcclain,Corporation Commissioner,Blake Cummings,DEM,440007,0,2,17,19,
Mcclain,U.S. House,Mary Brannon,DEM,440007,1,3,16,20,04
Mcclain,U.S. House,Fred Gipson,DEM,440007,0,1,19,20,04
Mcclain,Governor,Mick Cornett,REP,440008,3,0,63,66,
Mcclain,Governor,Kevin Stitt,REP,440008,3,7,99,109,
Mcclain,Lieutenant Governor,Dana Murphy,REP,440008,0,4,69,73,
Mcclain,Lieutenant Governor,Matt Pinnell,REP,440008,6,3,86,95,
Mcclain,State Auditor,Cindy Byrd,REP,440008,2,7,84,93,
Mcclain,State Auditor,Charlie Prater,REP,440008,4,0,70,74,
Mcclain,Attorney General,Mike Hunter,REP,440008,2,7,72,81,
Mcclain,Attorney General,Gentner Drummond,REP,440008,4,0,85,89,
Mcclain,Superintendent of Public Instruction,Joy Hofmeister,REP,440008,2,5,81,88,
Mcclain,Superintendent of Public Instruction,Linda Murphy,REP,440008,4,2,77,83,
Mcclain,Commissioner of Labor,Cathy Costello,REP,440008,2,2,56,60,
Mcclain,Commissioner of Labor,Leslie Osborn,REP,440008,4,5,100,109,
Mcclain,Corporation Commissioner,Bob Anthony,REP,440008,4,5,77,86,
Mcclain,Corporation Commissioner,Brian Bingman,REP,440008,2,2,78,82,
Mcclain,Governor,Chris Powell,LIB,440008,0,0,0,0,
Mcclain,Governor,Rex Lawhorn,LIB,440008,0,0,0,0,
Mcclain,Corporation Commissioner,Ashley Nicole Mccray,DEM,440008,3,0,20,23,
Mcclain,Corporation Commissioner,Blake Cummings,DEM,440008,1,0,19,20,
Mcclain,U.S. House,Mary Brannon,DEM,440008,1,0,24,25,04
Mcclain,U.S. House,Fred Gipson,DEM,440008,3,0,16,19,04
Mcclain,Governor,Mick Cornett,REP,440009,12,0,117,129,
Mcclain,Governor,Kevin Stitt,REP,440009,9,6,102,117,
Mcclain,Lieutenant Governor,Dana Murphy,REP,440009,9,0,103,112,
Mcclain,Lieutenant Governor,Matt Pinnell,REP,440009,10,6,111,127,
Mcclain,State Auditor,Cindy Byrd,REP,440009,9,4,114,127,
Mcclain,State Auditor,Charlie Prater,REP,440009,10,2,96,108,
Mcclain,Attorney General,Mike Hunter,REP,440009,9,3,106,118,
Mcclain,Attorney General,Gentner Drummond,REP,440009,11,3,109,123,
Mcclain,Superintendent of Public Instruction,Joy Hofmeister,REP,440009,10,2,126,138,
Mcclain,Superintendent of Public Instruction,Linda Murphy,REP,440009,10,4,87,101,
Mcclain,Commissioner of Labor,Cathy Costello,REP,440009,4,4,87,95,
Mcclain,Commissioner of Labor,Leslie Osborn,REP,440009,15,0,120,135,
Mcclain,Corporation Commissioner,Bob Anthony,REP,440009,15,1,92,108,
Mcclain,Corporation Commissioner,Brian Bingman,REP,440009,6,4,118,128,
Mcclain,State House,Bobby Cleveland,REP,440009,8,4,86,98,20
Mcclain,State House,Sherrie Conley,REP,440009,13,2,128,143,20
Mcclain,Governor,Chris Powell,LIB,440009,0,0,0,0,
Mcclain,Governor,Rex Lawhorn,LIB,440009,0,0,0,0,
Mcclain,Corporation Commissioner,Ashley Nicole Mccray,DEM,440009,5,0,47,52,
Mcclain,Corporation Commissioner,Blake Cummings,DEM,440009,0,0,13,13,
Mcclain,U.S. House,Mary Brannon,DEM,440009,3,0,30,33,04
Mcclain,U.S. House,Fred Gipson,DEM,440009,2,0,30,32,04
Mcclain,Governor,Mick Cornett,REP,440010,3,1,16,20,
Mcclain,Governor,Kevin Stitt,REP,440010,4,1,23,28,
Mcclain,Lieutenant Governor,Dana Murphy,REP,440010,2,1,15,18,
Mcclain,Lieutenant Governor,Matt Pinnell,REP,440010,5,1,24,30,
Mcclain,State Auditor,Cindy Byrd,REP,440010,4,2,19,25,
Mcclain,State Auditor,Charlie Prater,REP,440010,3,0,20,23,
Mcclain,Attorney General,Mike Hunter,REP,440010,2,1,16,19,
Mcclain,Attorney General,Gentner Drummond,REP,440010,4,1,23,28,
Mcclain,Superintendent of Public Instruction,Joy Hofmeister,REP,440010,4,0,20,24,
Mcclain,Superintendent of Public Instruction,Linda Murphy,REP,440010,3,2,19,24,
Mcclain,Commissioner of Labor,Cathy Costello,REP,440010,1,1,10,12,
Mcclain,Commissioner of Labor,Leslie Osborn,REP,440010,4,1,28,33,
Mcclain,Corporation Commissioner,Bob Anthony,REP,440010,4,0,20,24,
Mcclain,Corporation Commissioner,Brian Bingman,REP,440010,3,2,19,24,
Mcclain,Governor,Chris Powell,LIB,440010,0,0,0,0,
Mcclain,Governor,Rex Lawhorn,LIB,440010,0,0,0,0,
Mcclain,Corporation Commissioner,Ashley Nicole Mccray,DEM,440010,0,0,5,5,
Mcclain,Corporation Commissioner,Blake Cummings,DEM,440010,0,0,5,5,
Mcclain,U.S. House,Mary Brannon,DEM,440010,0,0,8,8,04
Mcclain,U.S. House,Fred Gipson,DEM,440010,0,0,2,2,04
Mcclain,Governor,Mick Cornett,REP,440011,0,2,34,36,
Mcclain,Governor,Kevin Stitt,REP,440011,4,3,50,57,
Mcclain,Lieutenant Governor,Dana Murphy,REP,440011,0,1,39,40,
Mcclain,Lieutenant Governor,Matt Pinnell,REP,440011,4,4,43,51,
Mcclain,State Auditor,Cindy Byrd,REP,440011,2,3,39,44,
Mcclain,State Auditor,Charlie Prater,REP,440011,2,1,44,47,
Mcclain,Attorney General,Mike Hunter,REP,440011,0,2,36,38,
Mcclain,Attorney General,Gentner Drummond,REP,440011,4,3,46,53,
Mcclain,Superintendent of Public Instruction,Joy Hofmeister,REP,440011,3,3,41,47,
Mcclain,Superintendent of Public Instruction,Linda Murphy,REP,440011,1,2,42,45,
Mcclain,Commissioner of Labor,Cathy Costello,REP,440011,2,3,34,39,
Mcclain,Commissioner of Labor,Leslie Osborn,REP,440011,2,2,47,51,
Mcclain,Corporation Commissioner,Bob Anthony,REP,440011,3,3,40,46,
Mcclain,Corporation Commissioner,Brian Bingman,REP,440011,1,2,44,47,
Mcclain,Governor,Chris Powell,LIB,440011,0,0,0,0,
Mcclain,Governor,Rex Lawhorn,LIB,440011,0,0,0,0,
Mcclain,Corporation Commissioner,Ashley Nicole Mccray,DEM,440011,1,0,4,5,
Mcclain,Corporation Commissioner,Blake Cummings,DEM,440011,0,0,8,8,
Mcclain,U.S. House,Mary Brannon,DEM,440011,0,0,6,6,04
Mcclain,U.S. House,Fred Gipson,DEM,440011,1,0,6,7,04
Mcclain,Governor,Mick Cornett,REP,440012,5,3,106,114,
Mcclain,Governor,Kevin Stitt,REP,440012,7,2,154,163,
Mcclain,Lieutenant Governor,Dana Murphy,REP,440012,3,3,90,96,
Mcclain,Lieutenant Governor,Matt Pinnell,REP,440012,8,2,164,174,
Mcclain,State Auditor,Cindy Byrd,REP,440012,7,3,108,118,
Mcclain,State Auditor,Charlie Prater,REP,440012,4,2,143,149,
Mcclain,Attorney General,Mike Hunter,REP,440012,9,2,112,123,
Mcclain,Attorney General,Gentner Drummond,REP,440012,3,3,143,149,
Mcclain,Superintendent of Public Instruction,Joy Hofmeister,REP,440012,7,1,123,131,
Mcclain,Superintendent of Public Instruction,Linda Murphy,REP,440012,3,3,132,138,
Mcclain,Commissioner of Labor,Cathy Costello,REP,440012,7,1,121,129,
Mcclain,Commissioner of Labor,Leslie Osborn,REP,440012,5,3,130,138,
Mcclain,Corporation Commissioner,Bob Anthony,REP,440012,5,2,138,145,
Mcclain,Corporation Commissioner,Brian Bingman,REP,440012,6,3,115,124,
Mcclain,Governor,Chris Powell,LIB,440012,0,0,0,0,
Mcclain,Governor,Rex Lawhorn,LIB,440012,0,0,0,0,
Mcclain,Corporation Commissioner,Ashley Nicole Mccray,DEM,440012,4,1,34,39,
Mcclain,Corporation Commissioner,Blake Cummings,DEM,440012,3,0,19,22,
Mcclain,U.S. House,Mary Brannon,DEM,440012,2,0,27,29,04
Mcclain,U.S. House,Fred Gipson,DEM,440012,5,1,26,32,04
Mcclain,Governor,Mick Cornett,REP,440013,24,3,212,239,
Mcclain,Governor,Kevin Stitt,REP,440013,26,3,279,308,
Mcclain,Lieutenant Governor,Dana Murphy,REP,440013,20,2,214,236,
Mcclain,Lieutenant Governor,Matt Pinnell,REP,440013,30,3,259,292,
Mcclain,State Auditor,Cindy Byrd,REP,440013,29,3,227,259,
Mcclain,State Auditor,Charlie Prater,REP,440013,20,3,235,258,
Mcclain,Attorney General,Mike Hunter,REP,440013,25,3,227,255,
Mcclain,Attorney General,Gentner Drummond,REP,440013,25,3,251,279,
Mcclain,Superintendent of Public Instruction,Joy Hofmeister,REP,440013,31,4,250,285,
Mcclain,Superintendent of Public Instruction,Linda Murphy,REP,440013,18,2,231,251,
Mcclain,Commissioner of Labor,Cathy Costello,REP,440013,24,3,200,227,
Mcclain,Commissioner of Labor,Leslie Osborn,REP,440013,25,3,271,299,
Mcclain,Corporation Commissioner,Bob Anthony,REP,440013,33,4,234,271,
Mcclain,Corporation Commissioner,Brian Bingman,REP,440013,16,2,240,258,
Mcclain,State House,Bobby Cleveland,REP,440013,36,2,254,292,20
Mcclain,State House,Sherrie Conley,REP,440013,14,4,235,253,20
Mcclain,Governor,Chris Powell,LIB,440013,0,0,1,1,
Mcclain,Governor,Rex Lawhorn,LIB,440013,0,0,0,0,
Mcclain,Corporation Commissioner,Ashley Nicole Mccray,DEM,440013,4,1,41,46,
Mcclain,Corporation Commissioner,Blake Cummings,DEM,440013,4,0,38,42,
Mcclain,U.S. House,Mary Brannon,DEM,440013,2,1,37,40,04
Mcclain,U.S. House,Fred Gipson,DEM,440013,6,0,42,48,04
Mcclain,Governor,Mick Cornett,REP,440014,4,2,87,93,
Mcclain,Governor,Kevin Stitt,REP,440014,6,0,100,106,
Mcclain,Lieutenant Governor,Dana Murphy,REP,440014,1,0,77,78,
Mcclain,Lieutenant Governor,Matt Pinnell,REP,440014,9,2,108,119,
Mcclain,State Auditor,Cindy Byrd,REP,440014,5,2,86,93,
Mcclain,State Auditor,Charlie Prater,REP,440014,5,0,93,98,
Mcclain,Attorney General,Mike Hunter,REP,440014,4,0,97,101,
Mcclain,Attorney General,Gentner Drummond,REP,440014,6,2,88,96,
Mcclain,Superintendent of Public Instruction,Joy Hofmeister,REP,440014,7,0,100,107,
Mcclain,Superintendent of Public Instruction,Linda Murphy,REP,440014,3,2,83,88,
Mcclain,Commissioner of Labor,Cathy Costello,REP,440014,6,0,87,93,
Mcclain,Commissioner of Labor,Leslie Osborn,REP,440014,4,2,94,100,
Mcclain,Corporation Commissioner,Bob Anthony,REP,440014,5,2,101,108,
Mcclain,Corporation Commissioner,Brian Bingman,REP,440014,5,0,82,87,
Mcclain,State House,Bobby Cleveland,REP,440014,6,2,103,111,20
Mcclain,State House,Sherrie Conley,REP,440014,4,0,85,89,20
Mcclain,Governor,Chris Powell,LIB,440014,0,0,0,0,
Mcclain,Governor,Rex Lawhorn,LIB,440014,0,0,0,0,
Mcclain,Corporation Commissioner,Ashley Nicole Mccray,DEM,440014,3,2,14,19,
Mcclain,Corporation Commissioner,Blake Cummings,DEM,440014,0,0,6,6,
Mcclain,U.S. House,Mary Brannon,DEM,440014,3,2,13,18,04
Mcclain,U.S. House,Fred Gipson,DEM,440014,0,0,7,7,04
Mcclain,Governor,Mick Cornett,REP,440015,9,0,122,131,
Mcclain,Governor,Kevin Stitt,REP,440015,6,1,130,137,
Mcclain,Lieutenant Governor,Dana Murphy,REP,440015,5,0,88,93,
Mcclain,Lieutenant Governor,Matt Pinnell,REP,440015,10,1,153,164,
Mcclain,State Auditor,Cindy Byrd,REP,440015,8,0,110,118,
Mcclain,State Auditor,Charlie Prater,REP,440015,7,1,123,131,
Mcclain,Attorney General,Mike Hunter,REP,440015,12,0,124,136,
Mcclain,Attorney General,Gentner Drummond,REP,440015,3,1,125,129,
Mcclain,Superintendent of Public Instruction,Joy Hofmeister,REP,440015,11,0,149,160,
Mcclain,Superintendent of Public Instruction,Linda Murphy,REP,440015,4,1,98,103,
Mcclain,Commissioner of Labor,Cathy Costello,REP,440015,5,0,95,100,
Mcclain,Commissioner of Labor,Leslie Osborn,REP,440015,10,1,143,154,
Mcclain,Corporation Commissioner,Bob Anthony,REP,440015,8,0,119,127,
Mcclain,Corporation Commissioner,Brian Bingman,REP,440015,7,1,124,132,
Mcclain,Governor,Chris Powell,LIB,440015,0,0,0,0,
Mcclain,Governor,Rex Lawhorn,LIB,440015,0,0,0,0,
Mcclain,Corporation Commissioner,Ashley Nicole Mccray,DEM,440015,4,0,30,34,
Mcclain,Corporation Commissioner,Blake Cummings,DEM,440015,1,0,9,10,
Mcclain,U.S. House,Mary Brannon,DEM,440015,4,0,25,29,04
Mcclain,U.S. House,Fred Gipson,DEM,440015,1,0,14,15,04
Mcclain,Governor,Mick Cornett,REP,440016,8,5,80,93,
Mcclain,Governor,Kevin Stitt,REP,440016,9,0,125,134,
Mcclain,Lieutenant Governor,Dana Murphy,REP,440016,4,1,78,83,
Mcclain,Lieutenant Governor,Matt Pinnell,REP,440016,12,4,126,142,
Mcclain,State Auditor,Cindy Byrd,REP,440016,8,4,86,98,
Mcclain,State Auditor,Charlie Prater,REP,440016,7,1,116,124,
Mcclain,Attorney General,Mike Hunter,REP,440016,7,4,97,108,
Mcclain,Attorney General,Gentner Drummond,REP,440016,8,1,108,117,
Mcclain,Superintendent of Public Instruction,Joy Hofmeister,REP,440016,9,2,103,114,
Mcclain,Superintendent of Public Instruction,Linda Murphy,REP,440016,6,3,100,109,
Mcclain,Commissioner of Labor,Cathy Costello,REP,440016,5,5,96,106,
Mcclain,Commissioner of Labor,Leslie Osborn,REP,440016,10,0,107,117,
Mcclain,Corporation Commissioner,Bob Anthony,REP,440016,8,2,94,104,
Mcclain,Corporation Commissioner,Brian Bingman,REP,440016,8,3,109,120,
Mcclain,Governor,Chris Powell,LIB,440016,0,0,0,0,
Mcclain,Governor,Rex Lawhorn,LIB,440016,0,0,0,0,
Mcclain,Corporation Commissioner,Ashley Nicole Mccray,DEM,440016,9,1,27,37,
Mcclain,Corporation Commissioner,Blake Cummings,DEM,440016,7,0,23,30,
Mcclain,U.S. House,Mary Brannon,DEM,440016,9,0,37,46,04
Mcclain,U.S. House,Fred Gipson,DEM,440016,7,1,13,21,04
Mcclain,Governor,Mick Cornett,REP,440017,0,2,19,21,
Mcclain,Governor,Kevin Stitt,REP,440017,1,1,25,27,
Mcclain,Lieutenant Governor,Dana Murphy,REP,440017,0,0,14,14,
Mcclain,Lieutenant Governor,Matt Pinnell,REP,440017,1,3,29,33,
Mcclain,State Auditor,Cindy Byrd,REP,440017,0,0,18,18,
Mcclain,State Auditor,Charlie Prater,REP,440017,1,3,24,28,
Mcclain,Attorney General,Mike Hunter,REP,440017,1,0,22,23,
Mcclain,Attorney General,Gentner Drummond,REP,440017,0,3,21,24,
Mcclain,Superintendent of Public Instruction,Joy Hofmeister,REP,440017,0,3,27,30,
Mcclain,Superintendent of Public Instruction,Linda Murphy,REP,440017,1,0,15,16,
Mcclain,Commissioner of Labor,Cathy Costello,REP,440017,0,0,11,11,
Mcclain,Commissioner of Labor,Leslie Osborn,REP,440017,1,3,31,35,
Mcclain,Corporation Commissioner,Bob Anthony,REP,440017,1,3,24,28,
Mcclain,Corporation Commissioner,Brian Bingman,REP,440017,0,0,18,18,
Mcclain,State House,Bobby Cleveland,REP,440017,1,0,23,24,20
Mcclain,State House,Sherrie Conley,REP,440017,0,3,21,24,20
Mcclain,Governor,Chris Powell,LIB,440017,0,0,0,0,
Mcclain,Governor,Rex Lawhorn,LIB,440017,0,0,0,0,
Mcclain,Corporation Commissioner,Ashley Nicole Mccray,DEM,440017,1,0,11,12,
Mcclain,Corporation Commissioner,Blake Cummings,DEM,440017,0,0,5,5,
Mcclain,U.S. House,Mary Brannon,DEM,440017,1,0,11,12,04
Mcclain,U.S. House,Fred Gipson,DEM,440017,0,0,5,5,04
Mcclain,Governor,Mick Cornett,REP,440018,3,0,66,69,
Mcclain,Governor,Kevin Stitt,REP,440018,10,0,85,95,
Mcclain,Lieutenant Governor,Dana Murphy,REP,440018,3,0,67,70,
Mcclain,Lieutenant Governor,Matt Pinnell,REP,440018,10,0,84,94,
Mcclain,State Auditor,Cindy Byrd,REP,440018,2,0,74,76,
Mcclain,State Auditor,Charlie Prater,REP,440018,10,0,77,87,
Mcclain,Attorney General,Mike Hunter,REP,440018,8,0,63,71,
Mcclain,Attorney General,Gentner Drummond,REP,440018,5,0,89,94,
Mcclain,Superintendent of Public Instruction,Joy Hofmeister,REP,440018,8,0,81,89,
Mcclain,Superintendent of Public Instruction,Linda Murphy,REP,440018,5,0,73,78,
Mcclain,Commissioner of Labor,Cathy Costello,REP,440018,5,0,66,71,
Mcclain,Commissioner of Labor,Leslie Osborn,REP,440018,8,0,83,91,
Mcclain,Corporation Commissioner,Bob Anthony,REP,440018,6,0,67,73,
Mcclain,Corporation Commissioner,Brian Bingman,REP,440018,7,0,84,91,
Mcclain,State House,Bobby Cleveland,REP,440018,6,0,80,86,20
Mcclain,State House,Sherrie Conley,REP,440018,7,0,72,79,20
Mcclain,Governor,Chris Powell,LIB,440018,0,0,0,0,
Mcclain,Governor,Rex Lawhorn,LIB,440018,0,0,0,0,
Mcclain,Corporation Commissioner,Ashley Nicole Mccray,DEM,440018,4,0,13,17,
Mcclain,Corporation Commissioner,Blake Cummings,DEM,440018,2,0,11,13,
Mcclain,U.S. House,Mary Brannon,DEM,440018,4,0,17,21,04
Mcclain,U.S. House,Fred Gipson,DEM,440018,2,0,7,9,04
Mcclain,Governor,Mick Cornett,REP,440019,5,1,70,76,
Mcclain,Governor,Kevin Stitt,REP,440019,2,2,90,94,
Mcclain,Lieutenant Governor,Dana Murphy,REP,440019,5,1,70,76,
Mcclain,Lieutenant Governor,Matt Pinnell,REP,440019,2,2,86,90,
Mcclain,State Auditor,Cindy Byrd,REP,440019,2,1,75,78,
Mcclain,State Auditor,Charlie Prater,REP,440019,5,2,79,86,
Mcclain,Attorney General,Mike Hunter,REP,440019,1,1,58,60,
Mcclain,Attorney General,Gentner Drummond,REP,440019,6,2,100,108,
Mcclain,Superintendent of Public Instruction,Joy Hofmeister,REP,440019,2,2,68,72,
Mcclain,Superintendent of Public Instruction,Linda Murphy,REP,440019,5,1,90,96,
Mcclain,Commissioner of Labor,Cathy Costello,REP,440019,4,1,62,67,
Mcclain,Commissioner of Labor,Leslie Osborn,REP,440019,3,2,96,101,
Mcclain,Corporation Commissioner,Bob Anthony,REP,440019,2,1,78,81,
Mcclain,Corporation Commissioner,Brian Bingman,REP,440019,5,2,80,87,
Mcclain,Governor,Chris Powell,LIB,440019,0,0,0,0,
Mcclain,Governor,Rex Lawhorn,LIB,440019,0,0,0,0,
Mcclain,Corporation Commissioner,Ashley Nicole Mccray,DEM,440019,6,1,10,17,
Mcclain,Corporation Commissioner,Blake Cummings,DEM,440019,2,0,15,17,
Mcclain,U.S. House,Mary Brannon,DEM,440019,6,1,12,19,04
Mcclain,U.S. House,Fred Gipson,DEM,440019,2,0,13,15,04
Mcclain,Governor,Mick Cornett,REP,440020,2,1,56,59,
Mcclain,Governor,Kevin Stitt,REP,440020,6,0,100,106,
Mcclain,Lieutenant Governor,Dana Murphy,REP,440020,3,0,70,73,
Mcclain,Lieutenant Governor,Matt Pinnell,REP,440020,6,1,83,90,
Mcclain,State Auditor,Cindy Byrd,REP,440020,5,1,79,85,
Mcclain,State Auditor,Charlie Prater,REP,440020,4,0,72,76,
Mcclain,Attorney General,Mike Hunter,REP,440020,5,0,63,68,
Mcclain,Attorney General,Gentner Drummond,REP,440020,2,1,93,96,
Mcclain,Superintendent of Public Instruction,Joy Hofmeister,REP,440020,3,1,81,85,
Mcclain,Superintendent of Public Instruction,Linda Murphy,REP,440020,6,0,74,80,
Mcclain,Commissioner of Labor,Cathy Costello,REP,440020,0,1,61,62,
Mcclain,Commissioner of Labor,Leslie Osborn,REP,440020,9,0,94,103,
Mcclain,Corporation Commissioner,Bob Anthony,REP,440020,5,1,81,87,
Mcclain,Corporation Commissioner,Brian Bingman,REP,440020,4,0,72,76,
Mcclain,State House,Bobby Cleveland,REP,440020,3,0,65,68,20
Mcclain,State House,Sherrie Conley,REP,440020,6,1,90,97,20
Mcclain,Governor,Chris Powell,LIB,440020,0,0,0,0,
Mcclain,Governor,Rex Lawhorn,LIB,440020,0,0,0,0,
Mcclain,Corporation Commissioner,Ashley Nicole Mccray,DEM,440020,0,1,19,20,
Mcclain,Corporation Commissioner,Blake Cummings,DEM,440020,0,0,14,14,
Mcclain,U.S. House,Mary Brannon,DEM,440020,0,1,19,20,04
Mcclain,U.S. House,Fred Gipson,DEM,440020,0,0,14,14,04
Mcclain,Governor,Mick Cornett,REP,440021,2,9,46,57,
Mcclain,Governor,Kevin Stitt,REP,440021,2,2,52,56,
Mcclain,Lieutenant Governor,Dana Murphy,REP,440021,1,4,41,46,
Mcclain,Lieutenant Governor,Matt Pinnell,REP,440021,3,7,58,68,
Mcclain,State Auditor,Cindy Byrd,REP,440021,1,7,39,47,
Mcclain,State Auditor,Charlie Prater,REP,440021,3,4,57,64,
Mcclain,Attorney General,Mike Hunter,REP,440021,0,8,46,54,
Mcclain,Attorney General,Gentner Drummond,REP,440021,4,3,49,56,
Mcclain,Superintendent of Public Instruction,Joy Hofmeister,REP,440021,1,8,44,53,
Mcclain,Superintendent of Public Instruction,Linda Murphy,REP,440021,3,3,55,61,
Mcclain,Commissioner of Labor,Cathy Costello,REP,440021,0,4,45,49,
Mcclain,Commissioner of Labor,Leslie Osborn,REP,440021,4,7,50,61,
Mcclain,Corporation Commissioner,Bob Anthony,REP,440021,2,10,45,57,
Mcclain,Corporation Commissioner,Brian Bingman,REP,440021,2,1,51,54,
Mcclain,Governor,Chris Powell,LIB,440021,0,0,0,0,
Mcclain,Governor,Rex Lawhorn,LIB,440021,0,0,0,0,
Mcclain,Corporation Commissioner,Ashley Nicole Mccray,DEM,440021,1,6,64,71,
Mcclain,Corporation Commissioner,Blake Cummings,DEM,440021,1,3,36,40,
Mcclain,U.S. House,Mary Brannon,DEM,440021,2,6,62,70,04
Mcclain,U.S. House,Fred Gipson,DEM,440021,0,3,39,42,04
Mcclain,Governor,Mick Cornett,REP,440023,3,8,94,105,
Mcclain,Governor,Kevin Stitt,REP,440023,4,6,101,111,
Mcclain,Lieutenant Governor,Dana Murphy,REP,440023,4,6,81,91,
Mcclain,Lieutenant Governor,Matt Pinnell,REP,440023,3,7,111,121,
Mcclain,State Auditor,Cindy Byrd,REP,440023,6,8,91,105,
Mcclain,State Auditor,Charlie Prater,REP,440023,1,5,101,107,
Mcclain,Attorney General,Mike Hunter,REP,440023,4,7,90,101,
Mcclain,Attorney General,Gentner Drummond,REP,440023,3,6,100,109,
Mcclain,Superintendent of Public Instruction,Joy Hofmeister,REP,440023,5,9,104,118,
Mcclain,Superintendent of Public Instruction,Linda Murphy,REP,440023,2,4,92,98,
Mcclain,Commissioner of Labor,Cathy Costello,REP,440023,5,8,80,93,
Mcclain,Commissioner of Labor,Leslie Osborn,REP,440023,2,6,110,118,
Mcclain,Corporation Commissioner,Bob Anthony,REP,440023,5,10,96,111,
Mcclain,Corporation Commissioner,Brian Bingman,REP,440023,2,3,93,98,
Mcclain,State House,Bobby Cleveland,REP,440023,3,9,79,91,20
Mcclain,State House,Sherrie Conley,REP,440023,4,5,119,128,20
Mcclain,Governor,Chris Powell,LIB,440023,0,0,0,0,
Mcclain,Governor,Rex Lawhorn,LIB,440023,0,0,0,0,
Mcclain,Corporation Commissioner,Ashley Nicole Mccray,DEM,440023,4,9,53,66,
Mcclain,Corporation Commissioner,Blake Cummings,DEM,440023,1,10,48,59,
Mcclain,U.S. House,Mary Brannon,DEM,440023,4,14,71,89,04
Mcclain,U.S. House,Fred Gipson,DEM,440023,1,5,32,38,04
Mcclain,Governor,Mick Cornett,REP,440024,6,8,85,99,
Mcclain,Governor,Kevin Stitt,REP,440024,3,3,99,105,
Mcclain,Lieutenant Governor,Dana Murphy,REP,440024,6,10,78,94,
Mcclain,Lieutenant Governor,Matt Pinnell,REP,440024,3,1,100,104,
Mcclain,State Auditor,Cindy Byrd,REP,440024,4,9,88,101,
Mcclain,State Auditor,Charlie Prater,REP,440024,4,2,87,93,
Mcclain,Attorney General,Mike Hunter,REP,440024,7,8,85,100,
Mcclain,Attorney General,Gentner Drummond,REP,440024,2,3,96,101,
Mcclain,Superintendent of Public Instruction,Joy Hofmeister,REP,440024,2,8,89,99,
Mcclain,Superintendent of Public Instruction,Linda Murphy,REP,440024,7,3,89,99,
Mcclain,Commissioner of Labor,Cathy Costello,REP,440024,2,5,82,89,
Mcclain,Commissioner of Labor,Leslie Osborn,REP,440024,6,6,97,109,
Mcclain,Corporation Commissioner,Bob Anthony,REP,440024,7,8,81,96,
Mcclain,Corporation Commissioner,Brian Bingman,REP,440024,2,3,96,101,
Mcclain,Governor,Chris Powell,LIB,440024,0,0,1,1,
Mcclain,Governor,Rex Lawhorn,LIB,440024,0,0,0,0,
Mcclain,Corporation Commissioner,Ashley Nicole Mccray,DEM,440024,4,5,77,86,
Mcclain,Corporation Commissioner,Blake Cummings,DEM,440024,5,3,58,66,
Mcclain,U.S. House,Mary Brannon,DEM,440024,6,5,77,88,04
Mcclain,U.S. House,Fred Gipson,DEM,440024,4,3,56,63,04
Mcclain,Governor,Mick Cornett,REP,440026,0,3,16,19,
Mcclain,Governor,Kevin Stitt,REP,440026,2,4,21,27,
Mcclain,Lieutenant Governor,Dana Murphy,REP,440026,1,5,14,20,
Mcclain,Lieutenant Governor,Matt Pinnell,REP,440026,1,2,21,24,
Mcclain,State Auditor,Cindy Byrd,REP,440026,2,6,24,32,
Mcclain,State Auditor,Charlie Prater,REP,440026,0,0,11,11,
Mcclain,Attorney General,Mike Hunter,REP,440026,2,4,20,26,
Mcclain,Attorney General,Gentner Drummond,REP,440026,0,2,15,17,
Mcclain,Superintendent of Public Instruction,Joy Hofmeister,REP,440026,1,1,24,26,
Mcclain,Superintendent of Public Instruction,Linda Murphy,REP,440026,1,6,11,18,
Mcclain,Commissioner of Labor,Cathy Costello,REP,440026,1,4,11,16,
Mcclain,Commissioner of Labor,Leslie Osborn,REP,440026,1,2,24,27,
Mcclain,Corporation Commissioner,Bob Anthony,REP,440026,1,3,15,19,
Mcclain,Corporation Commissioner,Brian Bingman,REP,440026,1,3,20,24,
Mcclain,Governor,Chris Powell,LIB,440026,0,0,0,0,
Mcclain,Governor,Rex Lawhorn,LIB,440026,0,0,0,0,
Mcclain,Corporation Commissioner,Ashley Nicole Mccray,DEM,440026,0,0,7,7,
Mcclain,Corporation Commissioner,Blake Cummings,DEM,440026,0,0,6,6,
Mcclain,U.S. House,Mary Brannon,DEM,440026,0,0,8,8,04
Mcclain,U.S. House,Fred Gipson,DEM,440026,0,0,5,5,04
Mcclain,Governor,Mick Cornett,REP,440027,0,1,58,59,
Mcclain,Governor,Kevin Stitt,REP,440027,6,0,74,80,
Mcclain,Lieutenant Governor,Dana Murphy,REP,440027,0,0,50,50,
Mcclain,Lieutenant Governor,Matt Pinnell,REP,440027,4,0,79,83,
Mcclain,State Auditor,Cindy Byrd,REP,440027,3,1,57,61,
Mcclain,State Auditor,Charlie Prater,REP,440027,1,0,66,67,
Mcclain,Attorney General,Mike Hunter,REP,440027,1,0,67,68,
Mcclain,Attorney General,Gentner Drummond,REP,440027,2,1,64,67,
Mcclain,Superintendent of Public Instruction,Joy Hofmeister,REP,440027,2,1,75,78,
Mcclain,Superintendent of Public Instruction,Linda Murphy,REP,440027,4,0,53,57,
Mcclain,Commissioner of Labor,Cathy Costello,REP,440027,2,0,50,52,
Mcclain,Commissioner of Labor,Leslie Osborn,REP,440027,2,1,75,78,
Mcclain,Corporation Commissioner,Bob Anthony,REP,440027,6,1,70,77,
Mcclain,Corporation Commissioner,Brian Bingman,REP,440027,0,0,55,55,
Mcclain,State House,Bobby Cleveland,REP,440027,5,0,71,76,20
Mcclain,State House,Sherrie Conley,REP,440027,0,1,58,59,20
Mcclain,Governor,Chris Powell,LIB,440027,0,0,0,0,
Mcclain,Governor,Rex Lawhorn,LIB,440027,0,0,0,0,
Mcclain,Corporation Commissioner,Ashley Nicole Mccray,DEM,440027,3,0,11,14,
Mcclain,Corporation Commissioner,Blake Cummings,DEM,440027,1,0,6,7,
Mcclain,U.S. House,Mary Brannon,DEM,440027,2,0,10,12,04
Mcclain,U.S. House,Fred Gipson,DEM,440027,2,0,7,9,04
Mcclain,Governor,Mick Cornett,REP,440028,3,3,55,61,
Mcclain,Governor,Kevin Stitt,REP,440028,2,0,64,66,
Mcclain,Lieutenant Governor,Dana Murphy,REP,440028,4,1,54,59,
Mcclain,Lieutenant Governor,Matt Pinnell,REP,440028,1,2,61,64,
Mcclain,State Auditor,Cindy Byrd,REP,440028,4,1,55,60,
Mcclain,State Auditor,Charlie Prater,REP,440028,1,2,59,62,
Mcclain,Attorney General,Mike Hunter,REP,440028,3,3,70,76,
Mcclain,Attorney General,Gentner Drummond,REP,440028,2,0,44,46,
Mcclain,Superintendent of Public Instruction,Joy Hofmeister,REP,440028,3,3,55,61,
Mcclain,Superintendent of Public Instruction,Linda Murphy,REP,440028,2,0,57,59,
Mcclain,Commissioner of Labor,Cathy Costello,REP,440028,2,1,50,53,
Mcclain,Commissioner of Labor,Leslie Osborn,REP,440028,3,2,62,67,
Mcclain,Corporation Commissioner,Bob Anthony,REP,440028,3,3,62,68,
Mcclain,Corporation Commissioner,Brian Bingman,REP,440028,2,0,53,55,
Mcclain,State House,Bobby Cleveland,REP,440028,2,2,62,66,20
Mcclain,State House,Sherrie Conley,REP,440028,3,1,55,59,20
Mcclain,Governor,Chris Powell,LIB,440028,0,0,2,2,
Mcclain,Governor,Rex Lawhorn,LIB,440028,0,0,0,0,
Mcclain,Corporation Commissioner,Ashley Nicole Mccray,DEM,440028,3,0,19,22,
Mcclain,Corporation Commissioner,Blake Cummings,DEM,440028,0,2,8,10,
Mcclain,U.S. House,Mary Brannon,DEM,440028,1,1,19,21,04
Mcclain,U.S. House,Fred Gipson,DEM,440028,2,1,8,11,04
Mccurtain,Governor,Mick Cornett,REP,450002,0,0,3,3,
Mccurtain,Governor,Kevin Stitt,REP,450002,0,0,10,10,
Mccurtain,Lieutenant Governor,Dana Murphy,REP,450002,0,0,10,10,
Mccurtain,Lieutenant Governor,Matt Pinnell,REP,450002,0,0,4,4,
Mccurtain,State Auditor,Cindy Byrd,REP,450002,0,0,10,10,
Mccurtain,State Auditor,Charlie Prater,REP,450002,0,0,4,4,
Mccurtain,Attorney General,Mike Hunter,REP,450002,0,0,8,8,
Mccurtain,Attorney General,Gentner Drummond,REP,450002,0,0,6,6,
Mccurtain,Superintendent of Public Instruction,Joy Hofmeister,REP,450002,0,0,7,7,
Mccurtain,Superintendent of Public Instruction,Linda Murphy,REP,450002,0,0,7,7,
Mccurtain,Commissioner of Labor,Cathy Costello,REP,450002,0,0,9,9,
Mccurtain,Commissioner of Labor,Leslie Osborn,REP,450002,0,0,5,5,
Mccurtain,Corporation Commissioner,Bob Anthony,REP,450002,0,0,10,10,
Mccurtain,Corporation Commissioner,Brian Bingman,REP,450002,0,0,4,4,
Mccurtain,Governor,Chris Powell,LIB,450002,0,0,0,0,
Mccurtain,Governor,Rex Lawhorn,LIB,450002,0,0,0,0,
Mccurtain,Corporation Commissioner,Ashley Nicole Mccray,DEM,450002,0,1,15,16,
Mccurtain,Corporation Commissioner,Blake Cummings,DEM,450002,0,0,9,9,
Mccurtain,U.S. House,Jason Nichols,DEM,450002,0,0,15,15,02
Mccurtain,U.S. House,Clay Padgett,DEM,450002,0,1,9,10,02
Mccurtain,Governor,Mick Cornett,REP,450004,2,2,20,24,
Mccurtain,Governor,Kevin Stitt,REP,450004,1,0,28,29,
Mccurtain,Lieutenant Governor,Dana Murphy,REP,450004,0,1,11,12,
Mccurtain,Lieutenant Governor,Matt Pinnell,REP,450004,3,1,37,41,
Mccurtain,State Auditor,Cindy Byrd,REP,450004,2,1,28,31,
Mccurtain,State Auditor,Charlie Prater,REP,450004,1,1,18,20,
Mccurtain,Attorney General,Mike Hunter,REP,450004,3,2,24,29,
Mccurtain,Attorney General,Gentner Drummond,REP,450004,0,0,24,24,
Mccurtain,Superintendent of Public Instruction,Joy Hofmeister,REP,450004,2,2,20,24,
Mccurtain,Superintendent of Public Instruction,Linda Murphy,REP,450004,1,0,29,30,
Mccurtain,Commissioner of Labor,Cathy Costello,REP,450004,2,1,21,24,
Mccurtain,Commissioner of Labor,Leslie Osborn,REP,450004,1,1,26,28,
Mccurtain,Corporation Commissioner,Bob Anthony,REP,450004,2,1,26,29,
Mccurtain,Corporation Commissioner,Brian Bingman,REP,450004,1,1,20,22,
Mccurtain,Governor,Chris Powell,LIB,450004,0,0,0,0,
Mccurtain,Governor,Rex Lawhorn,LIB,450004,0,0,0,0,
Mccurtain,Corporation Commissioner,Ashley Nicole Mccray,DEM,450004,0,6,48,54,
Mccurtain,Corporation Commissioner,Blake Cummings,DEM,450004,1,3,40,44,
Mccurtain,U.S. House,Jason Nichols,DEM,450004,1,6,39,46,02
Mccurtain,U.S. House,Clay Padgett,DEM,450004,1,4,51,56,02
Mccurtain,Governor,Mick Cornett,REP,450005,0,0,1,1,
Mccurtain,Governor,Kevin Stitt,REP,450005,0,0,2,2,
Mccurtain,Lieutenant Governor,Dana Murphy,REP,450005,0,0,1,1,
Mccurtain,Lieutenant Governor,Matt Pinnell,REP,450005,0,0,2,2,
Mccurtain,State Auditor,Cindy Byrd,REP,450005,0,0,2,2,
Mccurtain,State Auditor,Charlie Prater,REP,450005,0,0,1,1,
Mccurtain,Attorney General,Mike Hunter,REP,450005,0,0,1,1,
Mccurtain,Attorney General,Gentner Drummond,REP,450005,0,0,2,2,
Mccurtain,Superintendent of Public Instruction,Joy Hofmeister,REP,450005,0,0,2,2,
Mccurtain,Superintendent of Public Instruction,Linda Murphy,REP,450005,0,0,1,1,
Mccurtain,Commissioner of Labor,Cathy Costello,REP,450005,0,0,3,3,
Mccurtain,Commissioner of Labor,Leslie Osborn,REP,450005,0,0,0,0,
Mccurtain,Corporation Commissioner,Bob Anthony,REP,450005,0,0,1,1,
Mccurtain,Corporation Commissioner,Brian Bingman,REP,450005,0,0,2,2,
Mccurtain,Governor,Chris Powell,LIB,450005,0,0,0,0,
Mccurtain,Governor,Rex Lawhorn,LIB,450005,0,0,0,0,
Mccurtain,Corporation Commissioner,Ashley Nicole Mccray,DEM,450005,1,2,18,21,
Mccurtain,Corporation Commissioner,Blake Cummings,DEM,450005,0,1,16,17,
Mccurtain,U.S. House,Jason Nichols,DEM,450005,1,1,14,16,02
Mccurtain,U.S. House,Clay Padgett,DEM,450005,0,2,21,23,02
Mccurtain,Governor,Mick Cornett,REP,450006,1,1,13,15,
Mccurtain,Governor,Kevin Stitt,REP,450006,0,1,21,22,
Mccurtain,Lieutenant Governor,Dana Murphy,REP,450006,0,0,12,12,
Mccurtain,Lieutenant Governor,Matt Pinnell,REP,450006,1,3,22,26,
Mccurtain,State Auditor,Cindy Byrd,REP,450006,0,0,19,19,
Mccurtain,State Auditor,Charlie Prater,REP,450006,1,3,14,18,
Mccurtain,Attorney General,Mike Hunter,REP,450006,1,0,16,17,
Mccurtain,Attorney General,Gentner Drummond,REP,450006,0,3,18,21,
Mccurtain,Superintendent of Public Instruction,Joy Hofmeister,REP,450006,0,2,13,15,
Mccurtain,Superintendent of Public Instruction,Linda Murphy,REP,450006,1,1,20,22,
Mccurtain,Commissioner of Labor,Cathy Costello,REP,450006,1,2,20,23,
Mccurtain,Commissioner of Labor,Leslie Osborn,REP,450006,0,1,14,15,
Mccurtain,Corporation Commissioner,Bob Anthony,REP,450006,1,0,15,16,
Mccurtain,Corporation Commissioner,Brian Bingman,REP,450006,0,3,16,19,
Mccurtain,Governor,Chris Powell,LIB,450006,0,0,0,0,
Mccurtain,Governor,Rex Lawhorn,LIB,450006,0,0,0,0,
Mccurtain,Corporation Commissioner,Ashley Nicole Mccray,DEM,450006,2,5,51,58,
Mccurtain,Corporation Commissioner,Blake Cummings,DEM,450006,2,2,31,35,
Mccurtain,U.S. House,Jason Nichols,DEM,450006,2,3,52,57,02
Mccurtain,U.S. House,Clay Padgett,DEM,450006,2,4,31,37,02
Mccurtain,Governor,Mick Cornett,REP,450008,0,1,16,17,
Mccurtain,Governor,Kevin Stitt,REP,450008,4,1,22,27,
Mccurtain,Lieutenant Governor,Dana Murphy,REP,450008,1,2,15,18,
Mccurtain,Lieutenant Governor,Matt Pinnell,REP,450008,3,0,21,24,
Mccurtain,State Auditor,Cindy Byrd,REP,450008,2,0,23,25,
Mccurtain,State Auditor,Charlie Prater,REP,450008,2,1,13,16,
Mccurtain,Attorney General,Mike Hunter,REP,450008,2,1,16,19,
Mccurtain,Attorney General,Gentner Drummond,REP,450008,2,1,22,25,
Mccurtain,Superintendent of Public Instruction,Joy Hofmeister,REP,450008,2,0,15,17,
Mccurtain,Superintendent of Public Instruction,Linda Murphy,REP,450008,2,1,22,25,
Mccurtain,Commissioner of Labor,Cathy Costello,REP,450008,2,1,22,25,
Mccurtain,Commissioner of Labor,Leslie Osborn,REP,450008,2,0,14,16,
Mccurtain,Corporation Commissioner,Bob Anthony,REP,450008,2,1,20,23,
Mccurtain,Corporation Commissioner,Brian Bingman,REP,450008,2,0,16,18,
Mccurtain,Governor,Chris Powell,LIB,450008,0,0,0,0,
Mccurtain,Governor,Rex Lawhorn,LIB,450008,0,0,0,0,
Mccurtain,Corporation Commissioner,Ashley Nicole Mccray,DEM,450008,0,1,26,27,
Mccurtain,Corporation Commissioner,Blake Cummings,DEM,450008,0,1,26,27,
Mccurtain,U.S. House,Jason Nichols,DEM,450008,0,1,26,27,02
Mccurtain,U.S. House,Clay Padgett,DEM,450008,0,1,26,27,02
Mccurtain,Governor,Mick Cornett,REP,450009,0,0,9,9,
Mccurtain,Governor,Kevin Stitt,REP,450009,3,2,19,24,
Mccurtain,Lieutenant Governor,Dana Murphy,REP,450009,0,0,6,6,
Mccurtain,Lieutenant Governor,Matt Pinnell,REP,450009,3,2,22,27,
Mccurtain,State Auditor,Cindy Byrd,REP,450009,2,2,16,20,
Mccurtain,State Auditor,Charlie Prater,REP,450009,1,0,12,13,
Mccurtain,Attorney General,Mike Hunter,REP,450009,1,0,20,21,
Mccurtain,Attorney General,Gentner Drummond,REP,450009,2,2,8,12,
Mccurtain,Superintendent of Public Instruction,Joy Hofmeister,REP,450009,0,2,12,14,
Mccurtain,Superintendent of Public Instruction,Linda Murphy,REP,450009,3,0,15,18,
Mccurtain,Commissioner of Labor,Cathy Costello,REP,450009,1,2,20,23,
Mccurtain,Commissioner of Labor,Leslie Osborn,REP,450009,2,0,8,10,
Mccurtain,Corporation Commissioner,Bob Anthony,REP,450009,0,1,18,19,
Mccurtain,Corporation Commissioner,Brian Bingman,REP,450009,3,1,9,13,
Mccurtain,Governor,Chris Powell,LIB,450009,0,0,0,0,
Mccurtain,Governor,Rex Lawhorn,LIB,450009,0,0,0,0,
Mccurtain,Corporation Commissioner,Ashley Nicole Mccray,DEM,450009,1,1,22,24,
Mccurtain,Corporation Commissioner,Blake Cummings,DEM,450009,0,1,21,22,
Mccurtain,U.S. House,Jason Nichols,DEM,450009,1,1,22,24,02
Mccurtain,U.S. House,Clay Padgett,DEM,450009,0,1,20,21,02
Mccurtain,Governor,Mick Cornett,REP,450011,0,0,0,0,
Mccurtain,Governor,Kevin Stitt,REP,450011,0,1,8,9,
Mccurtain,Lieutenant Governor,Dana Murphy,REP,450011,0,0,2,2,
Mccurtain,Lieutenant Governor,Matt Pinnell,REP,450011,0,1,6,7,
Mccurtain,State Auditor,Cindy Byrd,REP,450011,0,1,2,3,
Mccurtain,State Auditor,Charlie Prater,REP,450011,0,0,6,6,
Mccurtain,Attorney General,Mike Hunter,REP,450011,0,1,1,2,
Mccurtain,Attorney General,Gentner Drummond,REP,450011,0,0,7,7,
Mccurtain,Superintendent of Public Instruction,Joy Hofmeister,REP,450011,0,0,1,1,
Mccurtain,Superintendent of Public Instruction,Linda Murphy,REP,450011,0,1,7,8,
Mccurtain,Commissioner of Labor,Cathy Costello,REP,450011,0,0,1,1,
Mccurtain,Commissioner of Labor,Leslie Osborn,REP,450011,0,1,6,7,
Mccurtain,Corporation Commissioner,Bob Anthony,REP,450011,0,0,2,2,
Mccurtain,Corporation Commissioner,Brian Bingman,REP,450011,0,1,6,7,
Mccurtain,Governor,Chris Powell,LIB,450011,0,0,0,0,
Mccurtain,Governor,Rex Lawhorn,LIB,450011,0,0,0,0,
Mccurtain,Corporation Commissioner,Ashley Nicole Mccray,DEM,450011,0,1,3,4,
Mccurtain,Corporation Commissioner,Blake Cummings,DEM,450011,0,0,12,12,
Mccurtain,U.S. House,Jason Nichols,DEM,450011,0,1,11,12,02
Mccurtain,U.S. House,Clay Padgett,DEM,450011,0,0,7,7,02
Mccurtain,Governor,Mick Cornett,REP,450012,0,0,1,1,
Mccurtain,Governor,Kevin Stitt,REP,450012,0,0,0,0,
Mccurtain,Lieutenant Governor,Dana Murphy,REP,450012,0,0,1,1,
Mccurtain,Lieutenant Governor,Matt Pinnell,REP,450012,0,0,0,0,
Mccurtain,State Auditor,Cindy Byrd,REP,450012,0,0,0,0,
Mccurtain,State Auditor,Charlie Prater,REP,450012,0,0,1,1,
Mccurtain,Attorney General,Mike Hunter,REP,450012,0,0,1,1,
Mccurtain,Attorney General,Gentner Drummond,REP,450012,0,0,0,0,
Mccurtain,Superintendent of Public Instruction,Joy Hofmeister,REP,450012,0,0,0,0,
Mccurtain,Superintendent of Public Instruction,Linda Murphy,REP,450012,0,0,1,1,
Mccurtain,Commissioner of Labor,Cathy Costello,REP,450012,0,0,0,0,
Mccurtain,Commissioner of Labor,Leslie Osborn,REP,450012,0,0,1,1,
Mccurtain,Corporation Commissioner,Bob Anthony,REP,450012,0,0,0,0,
Mccurtain,Corporation Commissioner,Brian Bingman,REP,450012,0,0,1,1,
Mccurtain,Governor,Chris Powell,LIB,450012,0,0,0,0,
Mccurtain,Governor,Rex Lawhorn,LIB,450012,0,0,0,0,
Mccurtain,Corporation Commissioner,Ashley Nicole Mccray,DEM,450012,0,0,9,9,
Mccurtain,Corporation Commissioner,Blake Cummings,DEM,450012,0,0,5,5,
Mccurtain,U.S. House,Jason Nichols,DEM,450012,0,0,13,13,02
Mccurtain,U.S. House,Clay Padgett,DEM,450012,0,0,2,2,02
Mccurtain,Governor,Mick Cornett,REP,450013,0,0,4,4,
Mccurtain,Governor,Kevin Stitt,REP,450013,2,1,7,10,
Mccurtain,Lieutenant Governor,Dana Murphy,REP,450013,1,1,3,5,
Mccurtain,Lieutenant Governor,Matt Pinnell,REP,450013,1,0,6,7,
Mccurtain,State Auditor,Cindy Byrd,REP,450013,1,1,7,9,
Mccurtain,State Auditor,Charlie Prater,REP,450013,1,0,2,3,
Mccurtain,Attorney General,Mike Hunter,REP,450013,2,1,2,5,
Mccurtain,Attorney General,Gentner Drummond,REP,450013,0,0,7,7,
Mccurtain,Superintendent of Public Instruction,Joy Hofmeister,REP,450013,0,1,3,4,
Mccurtain,Superintendent of Public Instruction,Linda Murphy,REP,450013,2,0,8,10,
Mccurtain,Commissioner of Labor,Cathy Costello,REP,450013,1,0,6,7,
Mccurtain,Commissioner of Labor,Leslie Osborn,REP,450013,1,1,3,5,
Mccurtain,Corporation Commissioner,Bob Anthony,REP,450013,0,0,8,8,
Mccurtain,Corporation Commissioner,Brian Bingman,REP,450013,2,1,1,4,
Mccurtain,Governor,Chris Powell,LIB,450013,0,0,0,0,
Mccurtain,Governor,Rex Lawhorn,LIB,450013,0,0,0,0,
Mccurtain,Corporation Commissioner,Ashley Nicole Mccray,DEM,450013,2,0,9,11,
Mccurtain,Corporation Commissioner,Blake Cummings,DEM,450013,0,2,21,23,
Mccurtain,U.S. House,Jason Nichols,DEM,450013,2,1,16,19,02
Mccurtain,U.S. House,Clay Padgett,DEM,450013,0,2,14,16,02
Mccurtain,Governor,Mick Cornett,REP,450014,0,0,1,1,
Mccurtain,Governor,Kevin Stitt,REP,450014,0,0,7,7,
Mccurtain,Lieutenant Governor,Dana Murphy,REP,450014,0,0,3,3,
Mccurtain,Lieutenant Governor,Matt Pinnell,REP,450014,0,0,5,5,
Mccurtain,State Auditor,Cindy Byrd,REP,450014,0,0,2,2,
Mccurtain,State Auditor,Charlie Prater,REP,450014,0,0,6,6,
Mccurtain,Attorney General,Mike Hunter,REP,450014,0,0,2,2,
Mccurtain,Attorney General,Gentner Drummond,REP,450014,0,0,6,6,
Mccurtain,Superintendent of Public Instruction,Joy Hofmeister,REP,450014,0,0,5,5,
Mccurtain,Superintendent of Public Instruction,Linda Murphy,REP,450014,0,0,3,3,
Mccurtain,Commissioner of Labor,Cathy Costello,REP,450014,0,0,6,6,
Mccurtain,Commissioner of Labor,Leslie Osborn,REP,450014,0,0,2,2,
Mccurtain,Corporation Commissioner,Bob Anthony,REP,450014,0,0,4,4,
Mccurtain,Corporation Commissioner,Brian Bingman,REP,450014,0,0,4,4,
Mccurtain,Governor,Chris Powell,LIB,450014,0,0,0,0,
Mccurtain,Governor,Rex Lawhorn,LIB,450014,0,0,0,0,
Mccurtain,Corporation Commissioner,Ashley Nicole Mccray,DEM,450014,0,0,5,5,
Mccurtain,Corporation Commissioner,Blake Cummings,DEM,450014,0,0,6,6,
Mccurtain,U.S. House,Jason Nichols,DEM,450014,0,0,6,6,02
Mccurtain,U.S. House,Clay Padgett,DEM,450014,0,0,5,5,02
Mccurtain,Governor,Mick Cornett,REP,450015,0,0,1,1,
Mccurtain,Governor,Kevin Stitt,REP,450015,0,0,5,5,
Mccurtain,Lieutenant Governor,Dana Murphy,REP,450015,0,0,3,3,
Mccurtain,Lieutenant Governor,Matt Pinnell,REP,450015,0,0,3,3,
Mccurtain,State Auditor,Cindy Byrd,REP,450015,0,0,5,5,
Mccurtain,State Auditor,Charlie Prater,REP,450015,0,0,1,1,
Mccurtain,Attorney General,Mike Hunter,REP,450015,0,0,3,3,
Mccurtain,Attorney General,Gentner Drummond,REP,450015,0,0,3,3,
Mccurtain,Superintendent of Public Instruction,Joy Hofmeister,REP,450015,0,0,1,1,
Mccurtain,Superintendent of Public Instruction,Linda Murphy,REP,450015,0,0,6,6,
Mccurtain,Commissioner of Labor,Cathy Costello,REP,450015,0,0,5,5,
Mccurtain,Commissioner of Labor,Leslie Osborn,REP,450015,0,0,1,1,
Mccurtain,Corporation Commissioner,Bob Anthony,REP,450015,0,0,3,3,
Mccurtain,Corporation Commissioner,Brian Bingman,REP,450015,0,0,3,3,
Mccurtain,Governor,Chris Powell,LIB,450015,0,0,0,0,
Mccurtain,Governor,Rex Lawhorn,LIB,450015,0,0,0,0,
Mccurtain,Corporation Commissioner,Ashley Nicole Mccray,DEM,450015,0,0,15,15,
Mccurtain,Corporation Commissioner,Blake Cummings,DEM,450015,0,0,9,9,
Mccurtain,U.S. House,Jason Nichols,DEM,450015,0,0,15,15,02
Mccurtain,U.S. House,Clay Padgett,DEM,450015,0,0,12,12,02
Mccurtain,Governor,Mick Cornett,REP,450017,0,0,6,6,
Mccurtain,Governor,Kevin Stitt,REP,450017,0,0,16,16,
Mccurtain,Lieutenant Governor,Dana Murphy,REP,450017,0,0,5,5,
Mccurtain,Lieutenant Governor,Matt Pinnell,REP,450017,0,0,15,15,
Mccurtain,State Auditor,Cindy Byrd,REP,450017,0,0,9,9,
Mccurtain,State Auditor,Charlie Prater,REP,450017,0,0,10,10,
Mccurtain,Attorney General,Mike Hunter,REP,450017,0,0,9,9,
Mccurtain,Attorney General,Gentner Drummond,REP,450017,0,0,13,13,
Mccurtain,Superintendent of Public Instruction,Joy Hofmeister,REP,450017,0,0,7,7,
Mccurtain,Superintendent of Public Instruction,Linda Murphy,REP,450017,0,0,14,14,
Mccurtain,Commissioner of Labor,Cathy Costello,REP,450017,0,0,12,12,
Mccurtain,Commissioner of Labor,Leslie Osborn,REP,450017,0,0,8,8,
Mccurtain,Corporation Commissioner,Bob Anthony,REP,450017,0,0,5,5,
Mccurtain,Corporation Commissioner,Brian Bingman,REP,450017,0,0,12,12,
Mccurtain,Governor,Chris Powell,LIB,450017,0,0,0,0,
Mccurtain,Governor,Rex Lawhorn,LIB,450017,0,0,0,0,
Mccurtain,Corporation Commissioner,Ashley Nicole Mccray,DEM,450017,0,0,16,16,
Mccurtain,Corporation Commissioner,Blake Cummings,DEM,450017,0,0,25,25,
Mccurtain,U.S. House,Jason Nichols,DEM,450017,0,0,32,32,02
Mccurtain,U.S. House,Clay Padgett,DEM,450017,0,0,10,10,02
Mccurtain,Governor,Mick Cornett,REP,450018,1,0,12,13,
Mccurtain,Governor,Kevin Stitt,REP,450018,1,3,17,21,
Mccurtain,Lieutenant Governor,Dana Murphy,REP,450018,1,1,15,17,
Mccurtain,Lieutenant Governor,Matt Pinnell,REP,450018,1,2,13,16,
Mccurtain,State Auditor,Cindy Byrd,REP,450018,2,3,12,17,
Mccurtain,State Auditor,Charlie Prater,REP,450018,0,0,16,16,
Mccurtain,Attorney General,Mike Hunter,REP,450018,1,3,15,19,
Mccurtain,Attorney General,Gentner Drummond,REP,450018,1,0,13,14,
Mccurtain,Superintendent of Public Instruction,Joy Hofmeister,REP,450018,1,1,16,18,
Mccurtain,Superintendent of Public Instruction,Linda Murphy,REP,450018,1,2,11,14,
Mccurtain,Commissioner of Labor,Cathy Costello,REP,450018,0,1,14,15,
Mccurtain,Commissioner of Labor,Leslie Osborn,REP,450018,2,2,13,17,
Mccurtain,Corporation Commissioner,Bob Anthony,REP,450018,1,2,13,16,
Mccurtain,Corporation Commissioner,Brian Bingman,REP,450018,1,1,14,16,
Mccurtain,Governor,Chris Powell,LIB,450018,0,0,0,0,
Mccurtain,Governor,Rex Lawhorn,LIB,450018,0,0,0,0,
Mccurtain,Corporation Commissioner,Ashley Nicole Mccray,DEM,450018,3,1,47,51,
Mccurtain,Corporation Commissioner,Blake Cummings,DEM,450018,0,2,64,66,
Mccurtain,U.S. House,Jason Nichols,DEM,450018,2,1,73,76,02
Mccurtain,U.S. House,Clay Padgett,DEM,450018,0,2,39,41,02
Mccurtain,Governor,Mick Cornett,REP,450019,0,3,14,17,
Mccurtain,Governor,Kevin Stitt,REP,450019,1,0,29,30,
Mccurtain,Lieutenant Governor,Dana Murphy,REP,450019,0,2,14,16,
Mccurtain,Lieutenant Governor,Matt Pinnell,REP,450019,1,1,29,31,
Mccurtain,State Auditor,Cindy Byrd,REP,450019,0,0,14,14,
Mccurtain,State Auditor,Charlie Prater,REP,450019,1,3,28,32,
Mccurtain,Attorney General,Mike Hunter,REP,450019,1,0,15,16,
Mccurtain,Attorney General,Gentner Drummond,REP,450019,0,3,27,30,
Mccurtain,Superintendent of Public Instruction,Joy Hofmeister,REP,450019,1,2,13,16,
Mccurtain,Superintendent of Public Instruction,Linda Murphy,REP,450019,0,1,26,27,
Mccurtain,Commissioner of Labor,Cathy Costello,REP,450019,0,0,17,17,
Mccurtain,Commissioner of Labor,Leslie Osborn,REP,450019,1,3,25,29,
Mccurtain,Corporation Commissioner,Bob Anthony,REP,450019,0,3,21,24,
Mccurtain,Corporation Commissioner,Brian Bingman,REP,450019,1,0,19,20,
Mccurtain,Governor,Chris Powell,LIB,450019,0,0,0,0,
Mccurtain,Governor,Rex Lawhorn,LIB,450019,0,0,0,0,
Mccurtain,Corporation Commissioner,Ashley Nicole Mccray,DEM,450019,0,2,22,24,
Mccurtain,Corporation Commissioner,Blake Cummings,DEM,450019,0,0,46,46,
Mccurtain,U.S. House,Jason Nichols,DEM,450019,1,2,47,50,02
Mccurtain,U.S. House,Clay Padgett,DEM,450019,0,0,19,19,02
Mccurtain,Governor,Mick Cornett,REP,450020,0,1,9,10,
Mccurtain,Governor,Kevin Stitt,REP,450020,2,5,25,32,
Mccurtain,Lieutenant Governor,Dana Murphy,REP,450020,2,4,11,17,
Mccurtain,Lieutenant Governor,Matt Pinnell,REP,450020,0,2,24,26,
Mccurtain,State Auditor,Cindy Byrd,REP,450020,0,4,22,26,
Mccurtain,State Auditor,Charlie Prater,REP,450020,2,2,15,19,
Mccurtain,Attorney General,Mike Hunter,REP,450020,0,0,10,10,
Mccurtain,Attorney General,Gentner Drummond,REP,450020,2,6,26,34,
Mccurtain,Superintendent of Public Instruction,Joy Hofmeister,REP,450020,0,4,15,19,
Mccurtain,Superintendent of Public Instruction,Linda Murphy,REP,450020,2,2,21,25,
Mccurtain,Commissioner of Labor,Cathy Costello,REP,450020,0,3,21,24,
Mccurtain,Commissioner of Labor,Leslie Osborn,REP,450020,2,3,14,19,
Mccurtain,Corporation Commissioner,Bob Anthony,REP,450020,2,3,22,27,
Mccurtain,Corporation Commissioner,Brian Bingman,REP,450020,0,3,14,17,
Mccurtain,Governor,Chris Powell,LIB,450020,0,0,0,0,
Mccurtain,Governor,Rex Lawhorn,LIB,450020,0,0,0,0,
Mccurtain,Corporation Commissioner,Ashley Nicole Mccray,DEM,450020,0,1,28,29,
Mccurtain,Corporation Commissioner,Blake Cummings,DEM,450020,0,2,21,23,
Mccurtain,U.S. House,Jason Nichols,DEM,450020,0,2,34,36,02
Mccurtain,U.S. House,Clay Padgett,DEM,450020,0,2,16,18,02
Mccurtain,Governor,Mick Cornett,REP,450022,0,0,6,6,
Mccurtain,Governor,Kevin Stitt,REP,450022,1,1,26,28,
Mccurtain,Lieutenant Governor,Dana Murphy,REP,450022,1,0,12,13,
Mccurtain,Lieutenant Governor,Matt Pinnell,REP,450022,0,1,18,19,
Mccurtain,State Auditor,Cindy Byrd,REP,450022,1,0,12,13,
Mccurtain,State Auditor,Charlie Prater,REP,450022,0,1,19,20,
Mccurtain,Attorney General,Mike Hunter,REP,450022,1,1,8,10,
Mccurtain,Attorney General,Gentner Drummond,REP,450022,0,0,23,23,
Mccurtain,Superintendent of Public Instruction,Joy Hofmeister,REP,450022,1,1,13,15,
Mccurtain,Superintendent of Public Instruction,Linda Murphy,REP,450022,0,0,19,19,
Mccurtain,Commissioner of Labor,Cathy Costello,REP,450022,0,1,20,21,
Mccurtain,Commissioner of Labor,Leslie Osborn,REP,450022,1,0,11,12,
Mccurtain,Corporation Commissioner,Bob Anthony,REP,450022,0,1,19,20,
Mccurtain,Corporation Commissioner,Brian Bingman,REP,450022,0,0,11,11,
Mccurtain,Governor,Chris Powell,LIB,450022,0,0,0,0,
Mccurtain,Governor,Rex Lawhorn,LIB,450022,0,0,0,0,
Mccurtain,Corporation Commissioner,Ashley Nicole Mccray,DEM,450022,2,2,30,34,
Mccurtain,Corporation Commissioner,Blake Cummings,DEM,450022,0,0,31,31,
Mccurtain,U.S. House,Jason Nichols,DEM,450022,2,0,38,40,02
Mccurtain,U.S. House,Clay Padgett,DEM,450022,0,2,26,28,02
Mccurtain,Governor,Mick Cornett,REP,450023,0,0,2,2,
Mccurtain,Governor,Kevin Stitt,REP,450023,0,0,13,13,
Mccurtain,Lieutenant Governor,Dana Murphy,REP,450023,0,0,8,8,
Mccurtain,Lieutenant Governor,Matt Pinnell,REP,450023,0,0,7,7,
Mccurtain,State Auditor,Cindy Byrd,REP,450023,0,0,8,8,
Mccurtain,State Auditor,Charlie Prater,REP,450023,0,0,7,7,
Mccurtain,Attorney General,Mike Hunter,REP,450023,0,0,7,7,
Mccurtain,Attorney General,Gentner Drummond,REP,450023,0,0,8,8,
Mccurtain,Superintendent of Public Instruction,Joy Hofmeister,REP,450023,0,0,4,4,
Mccurtain,Superintendent of Public Instruction,Linda Murphy,REP,450023,0,0,11,11,
Mccurtain,Commissioner of Labor,Cathy Costello,REP,450023,0,0,7,7,
Mccurtain,Commissioner of Labor,Leslie Osborn,REP,450023,0,0,7,7,
Mccurtain,Corporation Commissioner,Bob Anthony,REP,450023,0,0,5,5,
Mccurtain,Corporation Commissioner,Brian Bingman,REP,450023,0,0,10,10,
Mccurtain,Governor,Chris Powell,LIB,450023,0,0,3,3,
Mccurtain,Governor,Rex Lawhorn,LIB,450023,0,0,1,1,
Mccurtain,Corporation Commissioner,Ashley Nicole Mccray,DEM,450023,0,0,28,28,
Mccurtain,Corporation Commissioner,Blake Cummings,DEM,450023,0,1,31,32,
Mccurtain,U.S. House,Jason Nichols,DEM,450023,0,0,32,32,02
Mccurtain,U.S. House,Clay Padgett,DEM,450023,0,1,26,27,02
Mccurtain,Governor,Mick Cornett,REP,450024,0,0,1,1,
Mccurtain,Governor,Kevin Stitt,REP,450024,0,0,3,3,
Mccurtain,Lieutenant Governor,Dana Murphy,REP,450024,0,0,0,0,
Mccurtain,Lieutenant Governor,Matt Pinnell,REP,450024,0,0,4,4,
Mccurtain,State Auditor,Cindy Byrd,REP,450024,0,0,2,2,
Mccurtain,State Auditor,Charlie Prater,REP,450024,0,0,2,2,
Mccurtain,Attorney General,Mike Hunter,REP,450024,0,0,3,3,
Mccurtain,Attorney General,Gentner Drummond,REP,450024,0,0,1,1,
Mccurtain,Superintendent of Public Instruction,Joy Hofmeister,REP,450024,0,0,0,0,
Mccurtain,Superintendent of Public Instruction,Linda Murphy,REP,450024,0,0,4,4,
Mccurtain,Commissioner of Labor,Cathy Costello,REP,450024,0,0,2,2,
Mccurtain,Commissioner of Labor,Leslie Osborn,REP,450024,0,0,2,2,
Mccurtain,Corporation Commissioner,Bob Anthony,REP,450024,0,0,3,3,
Mccurtain,Corporation Commissioner,Brian Bingman,REP,450024,0,0,1,1,
Mccurtain,Governor,Chris Powell,LIB,450024,0,0,0,0,
Mccurtain,Governor,Rex Lawhorn,LIB,450024,0,0,0,0,
Mccurtain,Corporation Commissioner,Ashley Nicole Mccray,DEM,450024,4,0,23,27,
Mccurtain,Corporation Commissioner,Blake Cummings,DEM,450024,0,0,15,15,
Mccurtain,U.S. House,Jason Nichols,DEM,450024,1,0,29,30,02
Mccurtain,U.S. House,Clay Padgett,DEM,450024,3,0,10,13,02
Mccurtain,Governor,Mick Cornett,REP,450025,0,0,2,2,
Mccurtain,Governor,Kevin Stitt,REP,450025,0,0,14,14,
Mccurtain,Lieutenant Governor,Dana Murphy,REP,450025,0,0,7,7,
Mccurtain,Lieutenant Governor,Matt Pinnell,REP,450025,0,0,9,9,
Mccurtain,State Auditor,Cindy Byrd,REP,450025,0,0,7,7,
Mccurtain,State Auditor,Charlie Prater,REP,450025,0,0,8,8,
Mccurtain,Attorney General,Mike Hunter,REP,450025,0,0,9,9,
Mccurtain,Attorney General,Gentner Drummond,REP,450025,0,0,5,5,
Mccurtain,Superintendent of Public Instruction,Joy Hofmeister,REP,450025,0,0,7,7,
Mccurtain,Superintendent of Public Instruction,Linda Murphy,REP,450025,0,0,6,6,
Mccurtain,Commissioner of Labor,Cathy Costello,REP,450025,0,0,9,9,
Mccurtain,Commissioner of Labor,Leslie Osborn,REP,450025,0,0,6,6,
Mccurtain,Corporation Commissioner,Bob Anthony,REP,450025,0,0,10,10,
Mccurtain,Corporation Commissioner,Brian Bingman,REP,450025,0,0,5,5,
Mccurtain,Governor,Chris Powell,LIB,450025,0,0,0,0,
Mccurtain,Governor,Rex Lawhorn,LIB,450025,0,0,0,0,
Mccurtain,Corporation Commissioner,Ashley Nicole Mccray,DEM,450025,1,0,12,13,
Mccurtain,Corporation Commissioner,Blake Cummings,DEM,450025,1,0,18,19,
Mccurtain,U.S. House,Jason Nichols,DEM,450025,0,0,16,16,02
Mccurtain,U.S. House,Clay Padgett,DEM,450025,2,0,16,18,02
Mccurtain,Governor,Mick Cornett,REP,450026,0,0,3,3,
Mccurtain,Governor,Kevin Stitt,REP,450026,3,0,7,10,
Mccurtain,Lieutenant Governor,Dana Murphy,REP,450026,2,0,2,4,
Mccurtain,Lieutenant Governor,Matt Pinnell,REP,450026,1,0,10,11,
Mccurtain,State Auditor,Cindy Byrd,REP,450026,2,0,7,9,
Mccurtain,State Auditor,Charlie Prater,REP,450026,0,0,4,4,
Mccurtain,Attorney General,Mike Hunter,REP,450026,1,0,1,2,
Mccurtain,Attorney General,Gentner Drummond,REP,450026,2,0,9,11,
Mccurtain,Superintendent of Public Instruction,Joy Hofmeister,REP,450026,1,0,3,4,
Mccurtain,Superintendent of Public Instruction,Linda Murphy,REP,450026,2,0,7,9,
Mccurtain,Commissioner of Labor,Cathy Costello,REP,450026,1,0,7,8,
Mccurtain,Commissioner of Labor,Leslie Osborn,REP,450026,2,0,4,6,
Mccurtain,Corporation Commissioner,Bob Anthony,REP,450026,1,0,6,7,
Mccurtain,Corporation Commissioner,Brian Bingman,REP,450026,1,0,4,5,
Mccurtain,Governor,Chris Powell,LIB,450026,0,0,0,0,
Mccurtain,Governor,Rex Lawhorn,LIB,450026,0,0,0,0,
Mccurtain,Corporation Commissioner,Ashley Nicole Mccray,DEM,450026,0,0,13,13,
Mccurtain,Corporation Commissioner,Blake Cummings,DEM,450026,0,0,12,12,
Mccurtain,U.S. House,Jason Nichols,DEM,450026,0,0,14,14,02
Mccurtain,U.S. House,Clay Padgett,DEM,450026,0,0,9,9,02
Mccurtain,Governor,Mick Cornett,REP,450027,0,0,6,6,
Mccurtain,Governor,Kevin Stitt,REP,450027,1,0,6,7,
Mccurtain,Lieutenant Governor,Dana Murphy,REP,450027,0,0,5,5,
Mccurtain,Lieutenant Governor,Matt Pinnell,REP,450027,1,0,7,8,
Mccurtain,State Auditor,Cindy Byrd,REP,450027,1,0,4,5,
Mccurtain,State Auditor,Charlie Prater,REP,450027,0,0,8,8,
Mccurtain,Attorney General,Mike Hunter,REP,450027,0,0,3,3,
Mccurtain,Attorney General,Gentner Drummond,REP,450027,1,0,9,10,
Mccurtain,Superintendent of Public Instruction,Joy Hofmeister,REP,450027,0,0,5,5,
Mccurtain,Superintendent of Public Instruction,Linda Murphy,REP,450027,1,0,6,7,
Mccurtain,Commissioner of Labor,Cathy Costello,REP,450027,1,0,8,9,
Mccurtain,Commissioner of Labor,Leslie Osborn,REP,450027,0,0,3,3,
Mccurtain,Corporation Commissioner,Bob Anthony,REP,450027,1,0,5,6,
Mccurtain,Corporation Commissioner,Brian Bingman,REP,450027,0,0,6,6,
Mccurtain,Governor,Chris Powell,LIB,450027,0,0,0,0,
Mccurtain,Governor,Rex Lawhorn,LIB,450027,0,0,0,0,
Mccurtain,Corporation Commissioner,Ashley Nicole Mccray,DEM,450027,0,0,15,15,
Mccurtain,Corporation Commissioner,Blake Cummings,DEM,450027,0,0,25,25,
Mccurtain,U.S. House,Jason Nichols,DEM,450027,0,0,25,25,02
Mccurtain,U.S. House,Clay Padgett,DEM,450027,0,0,16,16,02
Mccurtain,Governor,Mick Cornett,REP,450028,0,0,2,2,
Mccurtain,Governor,Kevin Stitt,REP,450028,0,0,6,6,
Mccurtain,Lieutenant Governor,Dana Murphy,REP,450028,0,0,1,1,
Mccurtain,Lieutenant Governor,Matt Pinnell,REP,450028,0,0,7,7,
Mccurtain,State Auditor,Cindy Byrd,REP,450028,0,0,2,2,
Mccurtain,State Auditor,Charlie Prater,REP,450028,0,0,5,5,
Mccurtain,Attorney General,Mike Hunter,REP,450028,0,0,7,7,
Mccurtain,Attorney General,Gentner Drummond,REP,450028,0,0,1,1,
Mccurtain,Superintendent of Public Instruction,Joy Hofmeister,REP,450028,0,0,2,2,
Mccurtain,Superintendent of Public Instruction,Linda Murphy,REP,450028,0,0,5,5,
Mccurtain,Commissioner of Labor,Cathy Costello,REP,450028,0,0,2,2,
Mccurtain,Commissioner of Labor,Leslie Osborn,REP,450028,0,0,6,6,
Mccurtain,Corporation Commissioner,Bob Anthony,REP,450028,0,0,3,3,
Mccurtain,Corporation Commissioner,Brian Bingman,REP,450028,0,0,5,5,
Mccurtain,Governor,Chris Powell,LIB,450028,0,0,0,0,
Mccurtain,Governor,Rex Lawhorn,LIB,450028,0,0,0,0,
Mccurtain,Corporation Commissioner,Ashley Nicole Mccray,DEM,450028,0,0,10,10,
Mccurtain,Corporation Commissioner,Blake Cummings,DEM,450028,0,0,8,8,
Mccurtain,U.S. House,Jason Nichols,DEM,450028,0,0,12,12,02
Mccurtain,U.S. House,Clay Padgett,DEM,450028,0,0,7,7,02
Mccurtain,Governor,Mick Cornett,REP,450029,0,0,7,7,
Mccurtain,Governor,Kevin Stitt,REP,450029,0,0,8,8,
Mccurtain,Lieutenant Governor,Dana Murphy,REP,450029,0,0,3,3,
Mccurtain,Lieutenant Governor,Matt Pinnell,REP,450029,0,0,12,12,
Mccurtain,State Auditor,Cindy Byrd,REP,450029,0,0,10,10,
Mccurtain,State Auditor,Charlie Prater,REP,450029,0,0,5,5,
Mccurtain,Attorney General,Mike Hunter,REP,450029,0,0,7,7,
Mccurtain,Attorney General,Gentner Drummond,REP,450029,0,0,7,7,
Mccurtain,Superintendent of Public Instruction,Joy Hofmeister,REP,450029,0,0,9,9,
Mccurtain,Superintendent of Public Instruction,Linda Murphy,REP,450029,0,0,6,6,
Mccurtain,Commissioner of Labor,Cathy Costello,REP,450029,0,0,7,7,
Mccurtain,Commissioner of Labor,Leslie Osborn,REP,450029,0,0,8,8,
Mccurtain,Corporation Commissioner,Bob Anthony,REP,450029,0,0,8,8,
Mccurtain,Corporation Commissioner,Brian Bingman,REP,450029,0,0,7,7,
Mccurtain,Governor,Chris Powell,LIB,450029,0,0,0,0,
Mccurtain,Governor,Rex Lawhorn,LIB,450029,0,0,0,0,
Mccurtain,Corporation Commissioner,Ashley Nicole Mccray,DEM,450029,0,0,10,10,
Mccurtain,Corporation Commissioner,Blake Cummings,DEM,450029,0,0,8,8,
Mccurtain,U.S. House,Jason Nichols,DEM,450029,0,0,12,12,02
Mccurtain,U.S. House,Clay Padgett,DEM,450029,0,0,6,6,02
Mccurtain,Governor,Mick Cornett,REP,450031,0,0,9,9,
Mccurtain,Governor,Kevin Stitt,REP,450031,2,1,16,19,
Mccurtain,Lieutenant Governor,Dana Murphy,REP,450031,2,0,6,8,
Mccurtain,Lieutenant Governor,Matt Pinnell,REP,450031,0,1,19,20,
Mccurtain,State Auditor,Cindy Byrd,REP,450031,1,0,15,16,
Mccurtain,State Auditor,Charlie Prater,REP,450031,1,1,10,12,
Mccurtain,Attorney General,Mike Hunter,REP,450031,1,1,15,17,
Mccurtain,Attorney General,Gentner Drummond,REP,450031,1,0,10,11,
Mccurtain,Superintendent of Public Instruction,Joy Hofmeister,REP,450031,0,1,12,13,
Mccurtain,Superintendent of Public Instruction,Linda Murphy,REP,450031,2,0,13,15,
Mccurtain,Commissioner of Labor,Cathy Costello,REP,450031,2,0,9,11,
Mccurtain,Commissioner of Labor,Leslie Osborn,REP,450031,0,1,16,17,
Mccurtain,Corporation Commissioner,Bob Anthony,REP,450031,1,1,15,17,
Mccurtain,Corporation Commissioner,Brian Bingman,REP,450031,1,0,10,11,
Mccurtain,Governor,Chris Powell,LIB,450031,0,0,0,0,
Mccurtain,Governor,Rex Lawhorn,LIB,450031,0,0,1,1,
Mccurtain,Corporation Commissioner,Ashley Nicole Mccray,DEM,450031,0,0,16,16,
Mccurtain,Corporation Commissioner,Blake Cummings,DEM,450031,0,3,20,23,
Mccurtain,U.S. House,Jason Nichols,DEM,450031,0,2,25,27,02
Mccurtain,U.S. House,Clay Padgett,DEM,450031,0,1,13,14,02
Mccurtain,Governor,Mick Cornett,REP,450033,0,0,6,6,
Mccurtain,Governor,Kevin Stitt,REP,450033,0,2,7,9,
Mccurtain,Lieutenant Governor,Dana Murphy,REP,450033,0,2,6,8,
Mccurtain,Lieutenant Governor,Matt Pinnell,REP,450033,0,0,7,7,
Mccurtain,State Auditor,Cindy Byrd,REP,450033,0,2,8,10,
Mccurtain,State Auditor,Charlie Prater,REP,450033,0,0,5,5,
Mccurtain,Attorney General,Mike Hunter,REP,450033,0,0,6,6,
Mccurtain,Attorney General,Gentner Drummond,REP,450033,0,2,7,9,
Mccurtain,Superintendent of Public Instruction,Joy Hofmeister,REP,450033,0,0,8,8,
Mccurtain,Superintendent of Public Instruction,Linda Murphy,REP,450033,0,2,5,7,
Mccurtain,Commissioner of Labor,Cathy Costello,REP,450033,0,2,6,8,
Mccurtain,Commissioner of Labor,Leslie Osborn,REP,450033,0,0,6,6,
Mccurtain,Corporation Commissioner,Bob Anthony,REP,450033,0,0,9,9,
Mccurtain,Corporation Commissioner,Brian Bingman,REP,450033,0,2,4,6,
Mccurtain,Governor,Chris Powell,LIB,450033,0,0,0,0,
Mccurtain,Governor,Rex Lawhorn,LIB,450033,0,0,0,0,
Mccurtain,Corporation Commissioner,Ashley Nicole Mccray,DEM,450033,0,1,22,23,
Mccurtain,Corporation Commissioner,Blake Cummings,DEM,450033,0,1,18,19,
Mccurtain,U.S. House,Jason Nichols,DEM,450033,2,0,29,31,02
Mccurtain,U.S. House,Clay Padgett,DEM,450033,0,2,12,14,02
Mccurtain,Governor,Mick Cornett,REP,450034,0,0,12,12,
Mccurtain,Governor,Kevin Stitt,REP,450034,0,4,14,18,
Mccurtain,Lieutenant Governor,Dana Murphy,REP,450034,0,0,9,9,
Mccurtain,Lieutenant Governor,Matt Pinnell,REP,450034,0,3,16,19,
Mccurtain,State Auditor,Cindy Byrd,REP,450034,0,4,13,17,
Mccurtain,State Auditor,Charlie Prater,REP,450034,0,0,14,14,
Mccurtain,Attorney General,Mike Hunter,REP,450034,0,1,14,15,
Mccurtain,Attorney General,Gentner Drummond,REP,450034,0,2,11,13,
Mccurtain,Superintendent of Public Instruction,Joy Hofmeister,REP,450034,0,4,6,10,
Mccurtain,Superintendent of Public Instruction,Linda Murphy,REP,450034,0,0,18,18,
Mccurtain,Commissioner of Labor,Cathy Costello,REP,450034,0,3,6,9,
Mccurtain,Commissioner of Labor,Leslie Osborn,REP,450034,0,0,19,19,
Mccurtain,Corporation Commissioner,Bob Anthony,REP,450034,0,1,13,14,
Mccurtain,Corporation Commissioner,Brian Bingman,REP,450034,0,2,12,14,
Mccurtain,Governor,Chris Powell,LIB,450034,0,0,0,0,
Mccurtain,Governor,Rex Lawhorn,LIB,450034,0,0,0,0,
Mccurtain,Corporation Commissioner,Ashley Nicole Mccray,DEM,450034,0,4,65,69,
Mccurtain,Corporation Commissioner,Blake Cummings,DEM,450034,0,0,38,38,
Mccurtain,U.S. House,Jason Nichols,DEM,450034,0,3,59,62,02
Mccurtain,U.S. House,Clay Padgett,DEM,450034,0,2,47,49,02
Mccurtain,Governor,Mick Cornett,REP,450035,1,0,11,12,
Mccurtain,Governor,Kevin Stitt,REP,450035,0,0,28,28,
Mccurtain,Lieutenant Governor,Dana Murphy,REP,450035,1,0,14,15,
Mccurtain,Lieutenant Governor,Matt Pinnell,REP,450035,1,0,23,24,
Mccurtain,State Auditor,Cindy Byrd,REP,450035,2,0,21,23,
Mccurtain,State Auditor,Charlie Prater,REP,450035,0,0,17,17,
Mccurtain,Attorney General,Mike Hunter,REP,450035,1,0,21,22,
Mccurtain,Attorney General,Gentner Drummond,REP,450035,1,0,18,19,
Mccurtain,Superintendent of Public Instruction,Joy Hofmeister,REP,450035,1,0,12,13,
Mccurtain,Superintendent of Public Instruction,Linda Murphy,REP,450035,1,0,23,24,
Mccurtain,Commissioner of Labor,Cathy Costello,REP,450035,1,0,14,15,
Mccurtain,Commissioner of Labor,Leslie Osborn,REP,450035,1,0,22,23,
Mccurtain,Corporation Commissioner,Bob Anthony,REP,450035,2,0,16,18,
Mccurtain,Corporation Commissioner,Brian Bingman,REP,450035,0,0,20,20,
Mccurtain,Governor,Chris Powell,LIB,450035,0,0,2,2,
Mccurtain,Governor,Rex Lawhorn,LIB,450035,0,0,0,0,
Mccurtain,Corporation Commissioner,Ashley Nicole Mccray,DEM,450035,0,6,97,103,
Mccurtain,Corporation Commissioner,Blake Cummings,DEM,450035,2,1,80,83,
Mccurtain,U.S. House,Jason Nichols,DEM,450035,2,3,113,118,02
Mccurtain,U.S. House,Clay Padgett,DEM,450035,0,4,68,72,02
Mccurtain,Governor,Mick Cornett,REP,450036,0,1,11,12,
Mccurtain,Governor,Kevin Stitt,REP,450036,0,1,34,35,
Mccurtain,Lieutenant Governor,Dana Murphy,REP,450036,0,1,18,19,
Mccurtain,Lieutenant Governor,Matt Pinnell,REP,450036,0,1,24,25,
Mccurtain,State Auditor,Cindy Byrd,REP,450036,0,1,26,27,
Mccurtain,State Auditor,Charlie Prater,REP,450036,0,1,13,14,
Mccurtain,Attorney General,Mike Hunter,REP,450036,0,0,24,24,
Mccurtain,Attorney General,Gentner Drummond,REP,450036,0,2,18,20,
Mccurtain,Superintendent of Public Instruction,Joy Hofmeister,REP,450036,0,1,18,19,
Mccurtain,Superintendent of Public Instruction,Linda Murphy,REP,450036,0,1,23,24,
Mccurtain,Commissioner of Labor,Cathy Costello,REP,450036,0,1,16,17,
Mccurtain,Commissioner of Labor,Leslie Osborn,REP,450036,0,1,22,23,
Mccurtain,Corporation Commissioner,Bob Anthony,REP,450036,0,2,17,19,
Mccurtain,Corporation Commissioner,Brian Bingman,REP,450036,0,0,22,22,
Mccurtain,Governor,Chris Powell,LIB,450036,1,0,0,1,
Mccurtain,Governor,Rex Lawhorn,LIB,450036,0,0,0,0,
Mccurtain,Corporation Commissioner,Ashley Nicole Mccray,DEM,450036,1,0,57,58,
Mccurtain,Corporation Commissioner,Blake Cummings,DEM,450036,0,3,84,87,
Mccurtain,U.S. House,Jason Nichols,DEM,450036,0,0,72,72,02
Mccurtain,U.S. House,Clay Padgett,DEM,450036,1,3,70,74,02
Mccurtain,Governor,Mick Cornett,REP,450037,1,0,2,3,
Mccurtain,Governor,Kevin Stitt,REP,450037,0,0,9,9,
Mccurtain,Lieutenant Governor,Dana Murphy,REP,450037,1,0,4,5,
Mccurtain,Lieutenant Governor,Matt Pinnell,REP,450037,0,0,7,7,
Mccurtain,State Auditor,Cindy Byrd,REP,450037,1,0,4,5,
Mccurtain,State Auditor,Charlie Prater,REP,450037,0,0,6,6,
Mccurtain,Attorney General,Mike Hunter,REP,450037,1,0,4,5,
Mccurtain,Attorney General,Gentner Drummond,REP,450037,0,0,7,7,
Mccurtain,Superintendent of Public Instruction,Joy Hofmeister,REP,450037,0,0,2,2,
Mccurtain,Superintendent of Public Instruction,Linda Murphy,REP,450037,1,0,8,9,
Mccurtain,Commissioner of Labor,Cathy Costello,REP,450037,1,0,7,8,
Mccurtain,Commissioner of Labor,Leslie Osborn,REP,450037,0,0,3,3,
Mccurtain,Corporation Commissioner,Bob Anthony,REP,450037,1,0,7,8,
Mccurtain,Corporation Commissioner,Brian Bingman,REP,450037,0,0,3,3,
Mccurtain,Governor,Chris Powell,LIB,450037,0,0,0,0,
Mccurtain,Governor,Rex Lawhorn,LIB,450037,0,0,0,0,
Mccurtain,Corporation Commissioner,Ashley Nicole Mccray,DEM,450037,0,0,15,15,
Mccurtain,Corporation Commissioner,Blake Cummings,DEM,450037,0,0,15,15,
Mccurtain,U.S. House,Jason Nichols,DEM,450037,0,0,22,22,02
Mccurtain,U.S. House,Clay Padgett,DEM,450037,0,0,8,8,02
Mccurtain,Governor,Mick Cornett,REP,450038,0,0,7,7,
Mccurtain,Governor,Kevin Stitt,REP,450038,0,0,11,11,
Mccurtain,Lieutenant Governor,Dana Murphy,REP,450038,0,0,2,2,
Mccurtain,Lieutenant Governor,Matt Pinnell,REP,450038,0,0,15,15,
Mccurtain,State Auditor,Cindy Byrd,REP,450038,0,0,14,14,
Mccurtain,State Auditor,Charlie Prater,REP,450038,0,0,2,2,
Mccurtain,Attorney General,Mike Hunter,REP,450038,0,0,4,4,
Mccurtain,Attorney General,Gentner Drummond,REP,450038,0,0,13,13,
Mccurtain,Superintendent of Public Instruction,Joy Hofmeister,REP,450038,0,0,10,10,
Mccurtain,Superintendent of Public Instruction,Linda Murphy,REP,450038,0,0,8,8,
Mccurtain,Commissioner of Labor,Cathy Costello,REP,450038,0,0,8,8,
Mccurtain,Commissioner of Labor,Leslie Osborn,REP,450038,0,0,9,9,
Mccurtain,Corporation Commissioner,Bob Anthony,REP,450038,0,0,7,7,
Mccurtain,Corporation Commissioner,Brian Bingman,REP,450038,0,0,9,9,
Mccurtain,Governor,Chris Powell,LIB,450038,0,0,0,0,
Mccurtain,Governor,Rex Lawhorn,LIB,450038,0,0,0,0,
Mccurtain,Corporation Commissioner,Ashley Nicole Mccray,DEM,450038,0,0,26,26,
Mccurtain,Corporation Commissioner,Blake Cummings,DEM,450038,0,0,17,17,
Mccurtain,U.S. House,Jason Nichols,DEM,450038,0,0,18,18,02
Mccurtain,U.S. House,Clay Padgett,DEM,450038,0,0,25,25,02
Mcintosh,Governor,Mick Cornett,REP,460102,0,2,19,21,
Mcintosh,Governor,Kevin Stitt,REP,460102,1,0,48,49,
Mcintosh,Lieutenant Governor,Dana Murphy,REP,460102,0,2,14,16,
Mcintosh,Lieutenant Governor,Matt Pinnell,REP,460102,1,0,53,54,
Mcintosh,State Auditor,Cindy Byrd,REP,460102,0,0,33,33,
Mcintosh,State Auditor,Charlie Prater,REP,460102,1,2,33,36,
Mcintosh,Attorney General,Mike Hunter,REP,460102,1,2,32,35,
Mcintosh,Attorney General,Gentner Drummond,REP,460102,0,0,34,34,
Mcintosh,Superintendent of Public Instruction,Joy Hofmeister,REP,460102,1,1,44,46,
Mcintosh,Superintendent of Public Instruction,Linda Murphy,REP,460102,0,1,22,23,
Mcintosh,Commissioner of Labor,Cathy Costello,REP,460102,1,2,30,33,
Mcintosh,Commissioner of Labor,Leslie Osborn,REP,460102,0,0,36,36,
Mcintosh,Corporation Commissioner,Bob Anthony,REP,460102,0,1,34,35,
Mcintosh,Corporation Commissioner,Brian Bingman,REP,460102,1,1,32,34,
Mcintosh,Governor,Chris Powell,LIB,460102,0,0,0,0,
Mcintosh,Governor,Rex Lawhorn,LIB,460102,0,0,0,0,
Mcintosh,Corporation Commissioner,Ashley Nicole Mccray,DEM,460102,0,2,57,59,
Mcintosh,Corporation Commissioner,Blake Cummings,DEM,460102,0,1,45,46,
Mcintosh,U.S. House,Jason Nichols,DEM,460102,0,2,71,73,02
Mcintosh,U.S. House,Clay Padgett,DEM,460102,0,2,32,34,02
Mcintosh,Governor,Mick Cornett,REP,460103,0,2,28,30,
Mcintosh,Governor,Kevin Stitt,REP,460103,3,6,65,74,
Mcintosh,Lieutenant Governor,Dana Murphy,REP,460103,0,2,21,23,
Mcintosh,Lieutenant Governor,Matt Pinnell,REP,460103,3,6,72,81,
Mcintosh,State Auditor,Cindy Byrd,REP,460103,1,2,26,29,
Mcintosh,State Auditor,Charlie Prater,REP,460103,2,6,67,75,
Mcintosh,Attorney General,Mike Hunter,REP,460103,0,3,34,37,
Mcintosh,Attorney General,Gentner Drummond,REP,460103,3,4,59,66,
Mcintosh,Superintendent of Public Instruction,Joy Hofmeister,REP,460103,3,2,52,57,
Mcintosh,Superintendent of Public Instruction,Linda Murphy,REP,460103,0,6,41,47,
Mcintosh,Commissioner of Labor,Cathy Costello,REP,460103,0,1,25,26,
Mcintosh,Commissioner of Labor,Leslie Osborn,REP,460103,3,7,68,78,
Mcintosh,Corporation Commissioner,Bob Anthony,REP,460103,2,5,45,52,
Mcintosh,Corporation Commissioner,Brian Bingman,REP,460103,1,3,48,52,
Mcintosh,Governor,Chris Powell,LIB,460103,0,0,0,0,
Mcintosh,Governor,Rex Lawhorn,LIB,460103,0,0,0,0,
Mcintosh,Corporation Commissioner,Ashley Nicole Mccray,DEM,460103,2,3,101,106,
Mcintosh,Corporation Commissioner,Blake Cummings,DEM,460103,1,3,80,84,
Mcintosh,U.S. House,Jason Nichols,DEM,460103,2,3,134,139,02
Mcintosh,U.S. House,Clay Padgett,DEM,460103,1,4,51,56,02
Mcintosh,Governor,Mick Cornett,REP,460104,1,0,7,8,
Mcintosh,Governor,Kevin Stitt,REP,460104,0,1,38,39,
Mcintosh,Lieutenant Governor,Dana Murphy,REP,460104,1,0,9,10,
Mcintosh,Lieutenant Governor,Matt Pinnell,REP,460104,0,2,36,38,
Mcintosh,State Auditor,Cindy Byrd,REP,460104,1,0,27,28,
Mcintosh,State Auditor,Charlie Prater,REP,460104,0,2,18,20,
Mcintosh,Attorney General,Mike Hunter,REP,460104,1,0,27,28,
Mcintosh,Attorney General,Gentner Drummond,REP,460104,0,2,18,20,
Mcintosh,Superintendent of Public Instruction,Joy Hofmeister,REP,460104,0,0,21,21,
Mcintosh,Superintendent of Public Instruction,Linda Murphy,REP,460104,1,2,23,26,
Mcintosh,Commissioner of Labor,Cathy Costello,REP,460104,1,0,20,21,
Mcintosh,Commissioner of Labor,Leslie Osborn,REP,460104,0,2,25,27,
Mcintosh,Corporation Commissioner,Bob Anthony,REP,460104,0,0,29,29,
Mcintosh,Corporation Commissioner,Brian Bingman,REP,460104,1,2,15,18,
Mcintosh,Governor,Chris Powell,LIB,460104,0,0,0,0,
Mcintosh,Governor,Rex Lawhorn,LIB,460104,0,0,0,0,
Mcintosh,Corporation Commissioner,Ashley Nicole Mccray,DEM,460104,0,1,42,43,
Mcintosh,Corporation Commissioner,Blake Cummings,DEM,460104,2,5,41,48,
Mcintosh,U.S. House,Jason Nichols,DEM,460104,1,3,58,62,02
Mcintosh,U.S. House,Clay Padgett,DEM,460104,1,3,25,29,02
Mcintosh,Governor,Mick Cornett,REP,460201,1,1,33,35,
Mcintosh,Governor,Kevin Stitt,REP,460201,3,2,83,88,
Mcintosh,Lieutenant Governor,Dana Murphy,REP,460201,3,0,43,46,
Mcintosh,Lieutenant Governor,Matt Pinnell,REP,460201,1,3,73,77,
Mcintosh,State Auditor,Cindy Byrd,REP,460201,1,0,40,41,
Mcintosh,State Auditor,Charlie Prater,REP,460201,2,3,74,79,
Mcintosh,Attorney General,Mike Hunter,REP,460201,3,1,48,52,
Mcintosh,Attorney General,Gentner Drummond,REP,460201,0,2,69,71,
Mcintosh,Superintendent of Public Instruction,Joy Hofmeister,REP,460201,0,1,61,62,
Mcintosh,Superintendent of Public Instruction,Linda Murphy,REP,460201,3,2,51,56,
Mcintosh,Commissioner of Labor,Cathy Costello,REP,460201,0,1,46,47,
Mcintosh,Commissioner of Labor,Leslie Osborn,REP,460201,3,2,66,71,
Mcintosh,Corporation Commissioner,Bob Anthony,REP,460201,3,1,48,52,
Mcintosh,Corporation Commissioner,Brian Bingman,REP,460201,0,2,69,71,
Mcintosh,Governor,Chris Powell,LIB,460201,0,0,0,0,
Mcintosh,Governor,Rex Lawhorn,LIB,460201,0,0,0,0,
Mcintosh,Corporation Commissioner,Ashley Nicole Mccray,DEM,460201,2,9,75,86,
Mcintosh,Corporation Commissioner,Blake Cummings,DEM,460201,3,4,52,59,
Mcintosh,U.S. House,Jason Nichols,DEM,460201,3,5,85,93,02
Mcintosh,U.S. House,Clay Padgett,DEM,460201,2,8,41,51,02
Mcintosh,Governor,Mick Cornett,REP,460203,0,0,16,16,
Mcintosh,Governor,Kevin Stitt,REP,460203,0,1,25,26,
Mcintosh,Lieutenant Governor,Dana Murphy,REP,460203,0,0,16,16,
Mcintosh,Lieutenant Governor,Matt Pinnell,REP,460203,0,1,27,28,
Mcintosh,State Auditor,Cindy Byrd,REP,460203,0,0,12,12,
Mcintosh,State Auditor,Charlie Prater,REP,460203,0,1,30,31,
Mcintosh,Attorney General,Mike Hunter,REP,460203,0,1,16,17,
Mcintosh,Attorney General,Gentner Drummond,REP,460203,0,0,26,26,
Mcintosh,Superintendent of Public Instruction,Joy Hofmeister,REP,460203,0,0,26,26,
Mcintosh,Superintendent of Public Instruction,Linda Murphy,REP,460203,0,1,17,18,
Mcintosh,Commissioner of Labor,Cathy Costello,REP,460203,0,0,14,14,
Mcintosh,Commissioner of Labor,Leslie Osborn,REP,460203,0,1,27,28,
Mcintosh,Corporation Commissioner,Bob Anthony,REP,460203,0,0,14,14,
Mcintosh,Corporation Commissioner,Brian Bingman,REP,460203,0,1,28,29,
Mcintosh,Governor,Chris Powell,LIB,460203,0,0,1,1,
Mcintosh,Governor,Rex Lawhorn,LIB,460203,0,0,0,0,
Mcintosh,Corporation Commissioner,Ashley Nicole Mccray,DEM,460203,0,4,29,33,
Mcintosh,Corporation Commissioner,Blake Cummings,DEM,460203,0,2,23,25,
Mcintosh,U.S. House,Jason Nichols,DEM,460203,0,4,35,39,02
Mcintosh,U.S. House,Clay Padgett,DEM,460203,0,2,17,19,02
Mcintosh,Governor,Mick Cornett,REP,460205,4,3,92,99,
Mcintosh,Governor,Kevin Stitt,REP,460205,8,12,151,171,
Mcintosh,Lieutenant Governor,Dana Murphy,REP,460205,3,7,58,68,
Mcintosh,Lieutenant Governor,Matt Pinnell,REP,460205,9,8,182,199,
Mcintosh,State Auditor,Cindy Byrd,REP,460205,0,5,95,100,
Mcintosh,State Auditor,Charlie Prater,REP,460205,12,10,144,166,
Mcintosh,Attorney General,Mike Hunter,REP,460205,9,6,107,122,
Mcintosh,Attorney General,Gentner Drummond,REP,460205,3,9,131,143,
Mcintosh,Superintendent of Public Instruction,Joy Hofmeister,REP,460205,4,8,131,143,
Mcintosh,Superintendent of Public Instruction,Linda Murphy,REP,460205,7,7,112,126,
Mcintosh,Commissioner of Labor,Cathy Costello,REP,460205,10,4,99,113,
Mcintosh,Commissioner of Labor,Leslie Osborn,REP,460205,2,11,139,152,
Mcintosh,Corporation Commissioner,Bob Anthony,REP,460205,7,8,112,127,
Mcintosh,Corporation Commissioner,Brian Bingman,REP,460205,5,7,127,139,
Mcintosh,Governor,Chris Powell,LIB,460205,0,0,1,1,
Mcintosh,Governor,Rex Lawhorn,LIB,460205,0,0,0,0,
Mcintosh,Corporation Commissioner,Ashley Nicole Mccray,DEM,460205,1,4,46,51,
Mcintosh,Corporation Commissioner,Blake Cummings,DEM,460205,3,5,41,49,
Mcintosh,U.S. House,Jason Nichols,DEM,460205,3,5,45,53,02
Mcintosh,U.S. House,Clay Padgett,DEM,460205,1,4,41,46,02
Mcintosh,Governor,Mick Cornett,REP,460307,0,0,17,17,
Mcintosh,Governor,Kevin Stitt,REP,460307,2,2,26,30,
Mcintosh,Lieutenant Governor,Dana Murphy,REP,460307,0,1,11,12,
Mcintosh,Lieutenant Governor,Matt Pinnell,REP,460307,2,1,32,35,
Mcintosh,State Auditor,Cindy Byrd,REP,460307,0,0,13,13,
Mcintosh,State Auditor,Charlie Prater,REP,460307,2,1,30,33,
Mcintosh,Attorney General,Mike Hunter,REP,460307,2,1,25,28,
Mcintosh,Attorney General,Gentner Drummond,REP,460307,0,1,18,19,
Mcintosh,Superintendent of Public Instruction,Joy Hofmeister,REP,460307,2,0,21,23,
Mcintosh,Superintendent of Public Instruction,Linda Murphy,REP,460307,0,2,22,24,
Mcintosh,Commissioner of Labor,Cathy Costello,REP,460307,0,1,13,14,
Mcintosh,Commissioner of Labor,Leslie Osborn,REP,460307,2,1,30,33,
Mcintosh,Corporation Commissioner,Bob Anthony,REP,460307,2,1,17,20,
Mcintosh,Corporation Commissioner,Brian Bingman,REP,460307,0,1,26,27,
Mcintosh,Governor,Chris Powell,LIB,460307,0,0,0,0,
Mcintosh,Governor,Rex Lawhorn,LIB,460307,0,0,0,0,
Mcintosh,Corporation Commissioner,Ashley Nicole Mccray,DEM,460307,2,1,20,23,
Mcintosh,Corporation Commissioner,Blake Cummings,DEM,460307,0,1,36,37,
Mcintosh,U.S. House,Jason Nichols,DEM,460307,1,0,30,31,02
Mcintosh,U.S. House,Clay Padgett,DEM,460307,1,2,24,27,02
Mcintosh,Governor,Mick Cornett,REP,460310,3,0,1,4,
Mcintosh,Governor,Kevin Stitt,REP,460310,0,0,10,10,
Mcintosh,Lieutenant Governor,Dana Murphy,REP,460310,2,0,2,4,
Mcintosh,Lieutenant Governor,Matt Pinnell,REP,460310,1,0,8,9,
Mcintosh,State Auditor,Cindy Byrd,REP,460310,1,0,3,4,
Mcintosh,State Auditor,Charlie Prater,REP,460310,2,0,6,8,
Mcintosh,Attorney General,Mike Hunter,REP,460310,3,0,5,8,
Mcintosh,Attorney General,Gentner Drummond,REP,460310,0,0,5,5,
Mcintosh,Superintendent of Public Instruction,Joy Hofmeister,REP,460310,2,0,8,10,
Mcintosh,Superintendent of Public Instruction,Linda Murphy,REP,460310,1,0,4,5,
Mcintosh,Commissioner of Labor,Cathy Costello,REP,460310,0,0,3,3,
Mcintosh,Commissioner of Labor,Leslie Osborn,REP,460310,3,0,6,9,
Mcintosh,Corporation Commissioner,Bob Anthony,REP,460310,3,0,7,10,
Mcintosh,Corporation Commissioner,Brian Bingman,REP,460310,0,0,3,3,
Mcintosh,Governor,Chris Powell,LIB,460310,0,0,0,0,
Mcintosh,Governor,Rex Lawhorn,LIB,460310,0,0,0,0,
Mcintosh,Corporation Commissioner,Ashley Nicole Mccray,DEM,460310,0,1,10,11,
Mcintosh,Corporation Commissioner,Blake Cummings,DEM,460310,0,0,22,22,
Mcintosh,U.S. House,Jason Nichols,DEM,460310,0,0,25,25,02
Mcintosh,U.S. House,Clay Padgett,DEM,460310,0,1,8,9,02
Mcintosh,Governor,Mick Cornett,REP,460311,0,0,13,13,
Mcintosh,Governor,Kevin Stitt,REP,460311,0,0,8,8,
Mcintosh,Lieutenant Governor,Dana Murphy,REP,460311,0,0,13,13,
Mcintosh,Lieutenant Governor,Matt Pinnell,REP,460311,0,0,8,8,
Mcintosh,State Auditor,Cindy Byrd,REP,460311,0,0,9,9,
Mcintosh,State Auditor,Charlie Prater,REP,460311,0,0,12,12,
Mcintosh,Attorney General,Mike Hunter,REP,460311,0,0,8,8,
Mcintosh,Attorney General,Gentner Drummond,REP,460311,0,0,13,13,
Mcintosh,Superintendent of Public Instruction,Joy Hofmeister,REP,460311,0,0,13,13,
Mcintosh,Superintendent of Public Instruction,Linda Murphy,REP,460311,0,0,8,8,
Mcintosh,Commissioner of Labor,Cathy Costello,REP,460311,0,0,6,6,
Mcintosh,Commissioner of Labor,Leslie Osborn,REP,460311,0,0,15,15,
Mcintosh,Corporation Commissioner,Bob Anthony,REP,460311,0,0,7,7,
Mcintosh,Corporation Commissioner,Brian Bingman,REP,460311,0,0,14,14,
Mcintosh,Governor,Chris Powell,LIB,460311,0,0,0,0,
Mcintosh,Governor,Rex Lawhorn,LIB,460311,0,0,0,0,
Mcintosh,Corporation Commissioner,Ashley Nicole Mccray,DEM,460311,0,0,27,27,
Mcintosh,Corporation Commissioner,Blake Cummings,DEM,460311,0,1,21,22,
Mcintosh,U.S. House,Jason Nichols,DEM,460311,0,0,29,29,02
Mcintosh,U.S. House,Clay Padgett,DEM,460311,0,1,18,19,02
Mcintosh,Governor,Mick Cornett,REP,460312,0,0,4,4,
Mcintosh,Governor,Kevin Stitt,REP,460312,0,0,4,4,
Mcintosh,Lieutenant Governor,Dana Murphy,REP,460312,0,0,4,4,
Mcintosh,Lieutenant Governor,Matt Pinnell,REP,460312,0,0,4,4,
Mcintosh,State Auditor,Cindy Byrd,REP,460312,0,0,4,4,
Mcintosh,State Auditor,Charlie Prater,REP,460312,0,0,4,4,
Mcintosh,Attorney General,Mike Hunter,REP,460312,0,0,4,4,
Mcintosh,Attorney General,Gentner Drummond,REP,460312,0,0,4,4,
Mcintosh,Superintendent of Public Instruction,Joy Hofmeister,REP,460312,0,0,7,7,
Mcintosh,Superintendent of Public Instruction,Linda Murphy,REP,460312,0,0,1,1,
Mcintosh,Commissioner of Labor,Cathy Costello,REP,460312,0,0,5,5,
Mcintosh,Commissioner of Labor,Leslie Osborn,REP,460312,0,0,3,3,
Mcintosh,Corporation Commissioner,Bob Anthony,REP,460312,0,0,5,5,
Mcintosh,Corporation Commissioner,Brian Bingman,REP,460312,0,0,3,3,
Mcintosh,Governor,Chris Powell,LIB,460312,0,0,0,0,
Mcintosh,Governor,Rex Lawhorn,LIB,460312,0,0,0,0,
Mcintosh,Corporation Commissioner,Ashley Nicole Mccray,DEM,460312,0,0,8,8,
Mcintosh,Corporation Commissioner,Blake Cummings,DEM,460312,0,0,12,12,
Mcintosh,U.S. House,Jason Nichols,DEM,460312,0,0,14,14,02
Mcintosh,U.S. House,Clay Padgett,DEM,460312,0,0,6,6,02
Mcintosh,Governor,Mick Cornett,REP,460313,0,2,2,4,
Mcintosh,Governor,Kevin Stitt,REP,460313,0,0,13,13,
Mcintosh,Lieutenant Governor,Dana Murphy,REP,460313,0,0,4,4,
Mcintosh,Lieutenant Governor,Matt Pinnell,REP,460313,0,2,11,13,
Mcintosh,State Auditor,Cindy Byrd,REP,460313,0,2,1,3,
Mcintosh,State Auditor,Charlie Prater,REP,460313,0,0,13,13,
Mcintosh,Attorney General,Mike Hunter,REP,460313,0,0,4,4,
Mcintosh,Attorney General,Gentner Drummond,REP,460313,0,0,11,11,
Mcintosh,Superintendent of Public Instruction,Joy Hofmeister,REP,460313,0,0,7,7,
Mcintosh,Superintendent of Public Instruction,Linda Murphy,REP,460313,0,2,8,10,
Mcintosh,Commissioner of Labor,Cathy Costello,REP,460313,0,0,5,5,
Mcintosh,Commissioner of Labor,Leslie Osborn,REP,460313,0,0,9,9,
Mcintosh,Corporation Commissioner,Bob Anthony,REP,460313,0,2,10,12,
Mcintosh,Corporation Commissioner,Brian Bingman,REP,460313,0,0,5,5,
Mcintosh,Governor,Chris Powell,LIB,460313,0,0,0,0,
Mcintosh,Governor,Rex Lawhorn,LIB,460313,0,0,0,0,
Mcintosh,Corporation Commissioner,Ashley Nicole Mccray,DEM,460313,0,1,7,8,
Mcintosh,Corporation Commissioner,Blake Cummings,DEM,460313,0,0,8,8,
Mcintosh,U.S. House,Jason Nichols,DEM,460313,0,1,12,13,02
Mcintosh,U.S. House,Clay Padgett,DEM,460313,0,0,3,3,02
Mcintosh,Governor,Mick Cornett,REP,460314,4,2,33,39,
Mcintosh,Governor,Kevin Stitt,REP,460314,0,1,69,70,
Mcintosh,Lieutenant Governor,Dana Murphy,REP,460314,3,1,26,30,
Mcintosh,Lieutenant Governor,Matt Pinnell,REP,460314,1,2,76,79,
Mcintosh,State Auditor,Cindy Byrd,REP,460314,2,1,45,48,
Mcintosh,State Auditor,Charlie Prater,REP,460314,2,2,55,59,
Mcintosh,Attorney General,Mike Hunter,REP,460314,0,1,39,40,
Mcintosh,Attorney General,Gentner Drummond,REP,460314,4,2,64,70,
Mcintosh,Superintendent of Public Instruction,Joy Hofmeister,REP,460314,2,2,51,55,
Mcintosh,Superintendent of Public Instruction,Linda Murphy,REP,460314,2,1,52,55,
Mcintosh,Commissioner of Labor,Cathy Costello,REP,460314,2,0,41,43,
Mcintosh,Commissioner of Labor,Leslie Osborn,REP,460314,2,3,62,67,
Mcintosh,Corporation Commissioner,Bob Anthony,REP,460314,3,1,38,42,
Mcintosh,Corporation Commissioner,Brian Bingman,REP,460314,1,2,64,67,
Mcintosh,Governor,Chris Powell,LIB,460314,0,0,0,0,
Mcintosh,Governor,Rex Lawhorn,LIB,460314,0,0,0,0,
Mcintosh,Corporation Commissioner,Ashley Nicole Mccray,DEM,460314,1,2,37,40,
Mcintosh,Corporation Commissioner,Blake Cummings,DEM,460314,0,3,38,41,
Mcintosh,U.S. House,Jason Nichols,DEM,460314,1,3,38,42,02
Mcintosh,U.S. House,Clay Padgett,DEM,460314,0,2,35,37,02
Mcintosh,Governor,Mick Cornett,REP,460315,0,0,4,4,
Mcintosh,Governor,Kevin Stitt,REP,460315,1,0,16,17,
Mcintosh,Lieutenant Governor,Dana Murphy,REP,460315,0,0,4,4,
Mcintosh,Lieutenant Governor,Matt Pinnell,REP,460315,1,0,16,17,
Mcintosh,State Auditor,Cindy Byrd,REP,460315,0,0,5,5,
Mcintosh,State Auditor,Charlie Prater,REP,460315,1,0,15,16,
Mcintosh,Attorney General,Mike Hunter,REP,460315,1,0,11,12,
Mcintosh,Attorney General,Gentner Drummond,REP,460315,0,0,9,9,
Mcintosh,Superintendent of Public Instruction,Joy Hofmeister,REP,460315,0,0,9,9,
Mcintosh,Superintendent of Public Instruction,Linda Murphy,REP,460315,1,0,11,12,
Mcintosh,Commissioner of Labor,Cathy Costello,REP,460315,0,0,6,6,
Mcintosh,Commissioner of Labor,Leslie Osborn,REP,460315,1,0,14,15,
Mcintosh,Corporation Commissioner,Bob Anthony,REP,460315,1,0,9,10,
Mcintosh,Corporation Commissioner,Brian Bingman,REP,460315,0,0,11,11,
Mcintosh,Governor,Chris Powell,LIB,460315,0,0,0,0,
Mcintosh,Governor,Rex Lawhorn,LIB,460315,0,0,0,0,
Mcintosh,Corporation Commissioner,Ashley Nicole Mccray,DEM,460315,1,0,18,19,
Mcintosh,Corporation Commissioner,Blake Cummings,DEM,460315,2,0,22,24,
Mcintosh,U.S. House,Jason Nichols,DEM,460315,1,0,24,25,02
Mcintosh,U.S. House,Clay Padgett,DEM,460315,2,0,17,19,02
Mcintosh,Governor,Mick Cornett,REP,460316,0,0,9,9,
Mcintosh,Governor,Kevin Stitt,REP,460316,2,1,48,51,
Mcintosh,Lieutenant Governor,Dana Murphy,REP,460316,0,0,25,25,
Mcintosh,Lieutenant Governor,Matt Pinnell,REP,460316,2,1,30,33,
Mcintosh,State Auditor,Cindy Byrd,REP,460316,0,0,23,23,
Mcintosh,State Auditor,Charlie Prater,REP,460316,2,1,32,35,
Mcintosh,Attorney General,Mike Hunter,REP,460316,0,0,22,22,
Mcintosh,Attorney General,Gentner Drummond,REP,460316,2,1,34,37,
Mcintosh,Superintendent of Public Instruction,Joy Hofmeister,REP,460316,0,0,16,16,
Mcintosh,Superintendent of Public Instruction,Linda Murphy,REP,460316,2,1,38,41,
Mcintosh,Commissioner of Labor,Cathy Costello,REP,460316,2,1,24,27,
Mcintosh,Commissioner of Labor,Leslie Osborn,REP,460316,0,0,28,28,
Mcintosh,Corporation Commissioner,Bob Anthony,REP,460316,0,0,19,19,
Mcintosh,Corporation Commissioner,Brian Bingman,REP,460316,2,1,36,39,
Mcintosh,Governor,Chris Powell,LIB,460316,0,0,0,0,
Mcintosh,Governor,Rex Lawhorn,LIB,460316,0,0,0,0,
Mcintosh,Corporation Commissioner,Ashley Nicole Mccray,DEM,460316,0,0,18,18,
Mcintosh,Corporation Commissioner,Blake Cummings,DEM,460316,0,0,19,19,
Mcintosh,U.S. House,Jason Nichols,DEM,460316,0,0,21,21,02
Mcintosh,U.S. House,Clay Padgett,DEM,460316,0,0,15,15,02
Major,Governor,Mick Cornett,REP,470002,10,8,100,118,
Major,Governor,Kevin Stitt,REP,470002,6,7,172,185,
Major,Lieutenant Governor,Dana Murphy,REP,470002,8,3,139,150,
Major,Lieutenant Governor,Matt Pinnell,REP,470002,8,12,133,153,
Major,State Auditor,Cindy Byrd,REP,470002,7,9,136,152,
Major,State Auditor,Charlie Prater,REP,470002,9,7,131,147,
Major,Attorney General,Mike Hunter,REP,470002,6,9,125,140,
Major,Attorney General,Gentner Drummond,REP,470002,10,7,145,162,
Major,Superintendent of Public Instruction,Joy Hofmeister,REP,470002,5,7,172,184,
Major,Superintendent of Public Instruction,Linda Murphy,REP,470002,11,8,101,120,
Major,Commissioner of Labor,Cathy Costello,REP,470002,11,4,131,146,
Major,Commissioner of Labor,Leslie Osborn,REP,470002,5,12,137,154,
Major,Corporation Commissioner,Bob Anthony,REP,470002,10,14,165,189,
Major,Corporation Commissioner,Brian Bingman,REP,470002,6,2,108,116,
Major,Governor,Chris Powell,LIB,470002,0,0,0,0,
Major,Governor,Rex Lawhorn,LIB,470002,0,0,0,0,
Major,Corporation Commissioner,Ashley Nicole Mccray,DEM,470002,1,0,8,9,
Major,Corporation Commissioner,Blake Cummings,DEM,470002,0,1,4,5,
Major,Governor,Mick Cornett,REP,470004,1,2,16,19,
Major,Governor,Kevin Stitt,REP,470004,0,4,34,38,
Major,Lieutenant Governor,Dana Murphy,REP,470004,0,3,16,19,
Major,Lieutenant Governor,Matt Pinnell,REP,470004,1,3,34,38,
Major,State Auditor,Cindy Byrd,REP,470004,0,3,21,24,
Major,State Auditor,Charlie Prater,REP,470004,0,3,29,32,
Major,Attorney General,Mike Hunter,REP,470004,0,1,23,24,
Major,Attorney General,Gentner Drummond,REP,470004,1,5,28,34,
Major,Superintendent of Public Instruction,Joy Hofmeister,REP,470004,1,3,29,33,
Major,Superintendent of Public Instruction,Linda Murphy,REP,470004,0,3,22,25,
Major,Commissioner of Labor,Cathy Costello,REP,470004,0,2,17,19,
Major,Commissioner of Labor,Leslie Osborn,REP,470004,0,3,33,36,
Major,Corporation Commissioner,Bob Anthony,REP,470004,1,3,26,30,
Major,Corporation Commissioner,Brian Bingman,REP,470004,0,3,25,28,
Major,Governor,Chris Powell,LIB,470004,0,0,0,0,
Major,Governor,Rex Lawhorn,LIB,470004,0,0,0,0,
Major,Corporation Commissioner,Ashley Nicole Mccray,DEM,470004,2,1,7,10,
Major,Corporation Commissioner,Blake Cummings,DEM,470004,0,0,1,1,
Major,Governor,Mick Cornett,REP,470009,2,0,5,7,
Major,Governor,Kevin Stitt,REP,470009,0,0,11,11,
Major,Lieutenant Governor,Dana Murphy,REP,470009,1,0,10,11,
Major,Lieutenant Governor,Matt Pinnell,REP,470009,1,0,6,7,
Major,State Auditor,Cindy Byrd,REP,470009,0,0,7,7,
Major,State Auditor,Charlie Prater,REP,470009,1,0,9,10,
Major,Attorney General,Mike Hunter,REP,470009,2,0,5,7,
Major,Attorney General,Gentner Drummond,REP,470009,0,0,11,11,
Major,Superintendent of Public Instruction,Joy Hofmeister,REP,470009,2,0,11,13,
Major,Superintendent of Public Instruction,Linda Murphy,REP,470009,0,0,5,5,
Major,Commissioner of Labor,Cathy Costello,REP,470009,1,0,4,5,
Major,Commissioner of Labor,Leslie Osborn,REP,470009,0,0,12,12,
Major,Corporation Commissioner,Bob Anthony,REP,470009,1,0,10,11,
Major,Corporation Commissioner,Brian Bingman,REP,470009,1,0,6,7,
Major,Governor,Chris Powell,LIB,470009,0,0,0,0,
Major,Governor,Rex Lawhorn,LIB,470009,0,0,0,0,
Major,Corporation Commissioner,Ashley Nicole Mccray,DEM,470009,0,0,3,3,
Major,Corporation Commissioner,Blake Cummings,DEM,470009,0,0,1,1,
Major,Governor,Mick Cornett,REP,470010,2,2,15,19,
Major,Governor,Kevin Stitt,REP,470010,1,6,78,85,
Major,Lieutenant Governor,Dana Murphy,REP,470010,0,0,33,33,
Major,Lieutenant Governor,Matt Pinnell,REP,470010,3,8,59,70,
Major,State Auditor,Cindy Byrd,REP,470010,1,2,38,41,
Major,State Auditor,Charlie Prater,REP,470010,2,5,52,59,
Major,Attorney General,Mike Hunter,REP,470010,2,4,46,52,
Major,Attorney General,Gentner Drummond,REP,470010,1,4,47,52,
Major,Superintendent of Public Instruction,Joy Hofmeister,REP,470010,2,4,45,51,
Major,Superintendent of Public Instruction,Linda Murphy,REP,470010,1,4,48,53,
Major,Commissioner of Labor,Cathy Costello,REP,470010,0,4,44,48,
Major,Commissioner of Labor,Leslie Osborn,REP,470010,3,4,48,55,
Major,Corporation Commissioner,Bob Anthony,REP,470010,2,3,39,44,
Major,Corporation Commissioner,Brian Bingman,REP,470010,1,5,54,60,
Major,Governor,Chris Powell,LIB,470010,0,0,0,0,
Major,Governor,Rex Lawhorn,LIB,470010,0,0,0,0,
Major,Corporation Commissioner,Ashley Nicole Mccray,DEM,470010,0,0,3,3,
Major,Corporation Commissioner,Blake Cummings,DEM,470010,0,0,5,5,
Major,Governor,Mick Cornett,REP,470015,0,1,49,50,
Major,Governor,Kevin Stitt,REP,470015,0,2,41,43,
Major,Lieutenant Governor,Dana Murphy,REP,470015,0,0,36,36,
Major,Lieutenant Governor,Matt Pinnell,REP,470015,0,3,51,54,
Major,State Auditor,Cindy Byrd,REP,470015,0,1,40,41,
Major,State Auditor,Charlie Prater,REP,470015,0,2,48,50,
Major,Attorney General,Mike Hunter,REP,470015,0,0,33,33,
Major,Attorney General,Gentner Drummond,REP,470015,0,3,56,59,
Major,Superintendent of Public Instruction,Joy Hofmeister,REP,470015,0,2,47,49,
Major,Superintendent of Public Instruction,Linda Murphy,REP,470015,0,1,42,43,
Major,Commissioner of Labor,Cathy Costello,REP,470015,0,2,41,43,
Major,Commissioner of Labor,Leslie Osborn,REP,470015,0,1,44,45,
Major,Corporation Commissioner,Bob Anthony,REP,470015,0,2,46,48,
Major,Corporation Commissioner,Brian Bingman,REP,470015,0,1,44,45,
Major,Governor,Chris Powell,LIB,470015,0,0,0,0,
Major,Governor,Rex Lawhorn,LIB,470015,0,0,0,0,
Major,Corporation Commissioner,Ashley Nicole Mccray,DEM,470015,0,0,4,4,
Major,Corporation Commissioner,Blake Cummings,DEM,470015,0,0,4,4,
Major,Governor,Mick Cornett,REP,470016,1,0,12,13,
Major,Governor,Kevin Stitt,REP,470016,0,1,26,27,
Major,Lieutenant Governor,Dana Murphy,REP,470016,1,0,14,15,
Major,Lieutenant Governor,Matt Pinnell,REP,470016,0,1,24,25,
Major,State Auditor,Cindy Byrd,REP,470016,1,1,23,25,
Major,State Auditor,Charlie Prater,REP,470016,0,0,15,15,
Major,Attorney General,Mike Hunter,REP,470016,1,1,25,27,
Major,Attorney General,Gentner Drummond,REP,470016,0,0,13,13,
Major,Superintendent of Public Instruction,Joy Hofmeister,REP,470016,0,1,26,27,
Major,Superintendent of Public Instruction,Linda Murphy,REP,470016,1,0,12,13,
Major,Commissioner of Labor,Cathy Costello,REP,470016,0,0,15,15,
Major,Commissioner of Labor,Leslie Osborn,REP,470016,1,1,22,24,
Major,Corporation Commissioner,Bob Anthony,REP,470016,0,1,17,18,
Major,Corporation Commissioner,Brian Bingman,REP,470016,1,0,20,21,
Major,Governor,Chris Powell,LIB,470016,0,0,0,0,
Major,Governor,Rex Lawhorn,LIB,470016,0,0,0,0,
Major,Corporation Commissioner,Ashley Nicole Mccray,DEM,470016,0,0,2,2,
Major,Corporation Commissioner,Blake Cummings,DEM,470016,0,0,2,2,
Major,Governor,Mick Cornett,REP,470020,6,21,176,203,
Major,Governor,Kevin Stitt,REP,470020,9,24,186,219,
Major,Lieutenant Governor,Dana Murphy,REP,470020,7,17,180,204,
Major,Lieutenant Governor,Matt Pinnell,REP,470020,7,28,180,215,
Major,State Auditor,Cindy Byrd,REP,470020,7,27,172,206,
Major,State Auditor,Charlie Prater,REP,470020,7,18,178,203,
Major,Attorney General,Mike Hunter,REP,470020,11,26,201,238,
Major,Attorney General,Gentner Drummond,REP,470020,4,18,161,183,
Major,Superintendent of Public Instruction,Joy Hofmeister,REP,470020,6,23,227,256,
Major,Superintendent of Public Instruction,Linda Murphy,REP,470020,8,22,127,157,
Major,Commissioner of Labor,Cathy Costello,REP,470020,6,19,183,208,
Major,Commissioner of Labor,Leslie Osborn,REP,470020,9,26,170,205,
Major,Corporation Commissioner,Bob Anthony,REP,470020,12,24,202,238,
Major,Corporation Commissioner,Brian Bingman,REP,470020,3,21,155,179,
Major,Governor,Chris Powell,LIB,470020,0,0,0,0,
Major,Governor,Rex Lawhorn,LIB,470020,0,0,0,0,
Major,Corporation Commissioner,Ashley Nicole Mccray,DEM,470020,0,2,16,18,
Major,Corporation Commissioner,Blake Cummings,DEM,470020,0,0,10,10,
Major,Governor,Mick Cornett,REP,470022,6,15,101,122,
Major,Governor,Kevin Stitt,REP,470022,4,23,119,146,
Major,Lieutenant Governor,Dana Murphy,REP,470022,8,17,110,135,
Major,Lieutenant Governor,Matt Pinnell,REP,470022,2,21,106,129,
Major,State Auditor,Cindy Byrd,REP,470022,6,26,102,134,
Major,State Auditor,Charlie Prater,REP,470022,4,11,111,126,
Major,Attorney General,Mike Hunter,REP,470022,8,21,101,130,
Major,Attorney General,Gentner Drummond,REP,470022,2,16,115,133,
Major,Superintendent of Public Instruction,Joy Hofmeister,REP,470022,8,25,114,147,
Major,Superintendent of Public Instruction,Linda Murphy,REP,470022,2,12,102,116,
Major,Commissioner of Labor,Cathy Costello,REP,470022,2,24,114,140,
Major,Commissioner of Labor,Leslie Osborn,REP,470022,7,14,103,124,
Major,Corporation Commissioner,Bob Anthony,REP,470022,6,29,124,159,
Major,Corporation Commissioner,Brian Bingman,REP,470022,4,9,92,105,
Major,Governor,Chris Powell,LIB,470022,0,0,0,0,
Major,Governor,Rex Lawhorn,LIB,470022,0,0,0,0,
Major,Corporation Commissioner,Ashley Nicole Mccray,DEM,470022,3,1,5,9,
Major,Corporation Commissioner,Blake Cummings,DEM,470022,0,2,10,12,
Marshall,Governor,Mick Cornett,REP,480101,0,0,7,7,
Marshall,Governor,Kevin Stitt,REP,480101,1,0,40,41,
Marshall,Lieutenant Governor,Dana Murphy,REP,480101,0,0,9,9,
Marshall,Lieutenant Governor,Matt Pinnell,REP,480101,1,0,38,39,
Marshall,State Auditor,Cindy Byrd,REP,480101,0,0,29,29,
Marshall,State Auditor,Charlie Prater,REP,480101,0,0,16,16,
Marshall,Attorney General,Mike Hunter,REP,480101,1,0,16,17,
Marshall,Attorney General,Gentner Drummond,REP,480101,0,0,31,31,
Marshall,Superintendent of Public Instruction,Joy Hofmeister,REP,480101,1,0,31,32,
Marshall,Superintendent of Public Instruction,Linda Murphy,REP,480101,0,0,13,13,
Marshall,Commissioner of Labor,Cathy Costello,REP,480101,1,0,22,23,
Marshall,Commissioner of Labor,Leslie Osborn,REP,480101,0,0,22,22,
Marshall,Corporation Commissioner,Bob Anthony,REP,480101,1,0,22,23,
Marshall,Corporation Commissioner,Brian Bingman,REP,480101,0,0,23,23,
Marshall,Governor,Chris Powell,LIB,480101,0,0,0,0,
Marshall,Governor,Rex Lawhorn,LIB,480101,0,0,0,0,
Marshall,Corporation Commissioner,Ashley Nicole Mccray,DEM,480101,0,3,28,31,
Marshall,Corporation Commissioner,Blake Cummings,DEM,480101,0,5,23,28,
Marshall,U.S. House,Jason Nichols,DEM,480101,0,1,18,19,02
Marshall,U.S. House,Clay Padgett,DEM,480101,0,7,33,40,02
Marshall,Governor,Mick Cornett,REP,480102,0,0,11,11,
Marshall,Governor,Kevin Stitt,REP,480102,3,0,21,24,
Marshall,Lieutenant Governor,Dana Murphy,REP,480102,0,0,10,10,
Marshall,Lieutenant Governor,Matt Pinnell,REP,480102,3,0,20,23,
Marshall,State Auditor,Cindy Byrd,REP,480102,0,0,18,18,
Marshall,State Auditor,Charlie Prater,REP,480102,3,0,12,15,
Marshall,Attorney General,Mike Hunter,REP,480102,1,0,12,13,
Marshall,Attorney General,Gentner Drummond,REP,480102,2,0,18,20,
Marshall,Superintendent of Public Instruction,Joy Hofmeister,REP,480102,1,0,18,19,
Marshall,Superintendent of Public Instruction,Linda Murphy,REP,480102,2,0,13,15,
Marshall,Commissioner of Labor,Cathy Costello,REP,480102,0,0,16,16,
Marshall,Commissioner of Labor,Leslie Osborn,REP,480102,3,0,14,17,
Marshall,Corporation Commissioner,Bob Anthony,REP,480102,1,0,14,15,
Marshall,Corporation Commissioner,Brian Bingman,REP,480102,2,0,15,17,
Marshall,Governor,Chris Powell,LIB,480102,0,0,0,0,
Marshall,Governor,Rex Lawhorn,LIB,480102,0,0,1,1,
Marshall,Corporation Commissioner,Ashley Nicole Mccray,DEM,480102,1,1,12,14,
Marshall,Corporation Commissioner,Blake Cummings,DEM,480102,0,1,16,17,
Marshall,U.S. House,Jason Nichols,DEM,480102,1,1,9,11,02
Marshall,U.S. House,Clay Padgett,DEM,480102,0,1,19,20,02
Marshall,Governor,Mick Cornett,REP,480105,0,0,4,4,
Marshall,Governor,Kevin Stitt,REP,480105,3,0,14,17,
Marshall,Lieutenant Governor,Dana Murphy,REP,480105,0,0,3,3,
Marshall,Lieutenant Governor,Matt Pinnell,REP,480105,3,0,13,16,
Marshall,State Auditor,Cindy Byrd,REP,480105,0,0,11,11,
Marshall,State Auditor,Charlie Prater,REP,480105,3,0,5,8,
Marshall,Attorney General,Mike Hunter,REP,480105,1,0,4,5,
Marshall,Attorney General,Gentner Drummond,REP,480105,2,0,13,15,
Marshall,Superintendent of Public Instruction,Joy Hofmeister,REP,480105,2,0,7,9,
Marshall,Superintendent of Public Instruction,Linda Murphy,REP,480105,1,0,9,10,
Marshall,Commissioner of Labor,Cathy Costello,REP,480105,1,0,11,12,
Marshall,Commissioner of Labor,Leslie Osborn,REP,480105,2,0,5,7,
Marshall,Corporation Commissioner,Bob Anthony,REP,480105,2,0,12,14,
Marshall,Corporation Commissioner,Brian Bingman,REP,480105,1,0,4,5,
Marshall,Governor,Chris Powell,LIB,480105,0,0,0,0,
Marshall,Governor,Rex Lawhorn,LIB,480105,0,0,0,0,
Marshall,Corporation Commissioner,Ashley Nicole Mccray,DEM,480105,0,2,10,12,
Marshall,Corporation Commissioner,Blake Cummings,DEM,480105,1,1,10,12,
Marshall,U.S. House,Jason Nichols,DEM,480105,1,1,4,6,02
Marshall,U.S. House,Clay Padgett,DEM,480105,0,2,15,17,02
Marshall,Governor,Mick Cornett,REP,480106,0,0,8,8,
Marshall,Governor,Kevin Stitt,REP,480106,0,0,19,19,
Marshall,Lieutenant Governor,Dana Murphy,REP,480106,0,0,4,4,
Marshall,Lieutenant Governor,Matt Pinnell,REP,480106,0,0,23,23,
Marshall,State Auditor,Cindy Byrd,REP,480106,0,0,15,15,
Marshall,State Auditor,Charlie Prater,REP,480106,0,0,11,11,
Marshall,Attorney General,Mike Hunter,REP,480106,0,0,8,8,
Marshall,Attorney General,Gentner Drummond,REP,480106,0,0,18,18,
Marshall,Superintendent of Public Instruction,Joy Hofmeister,REP,480106,0,0,12,12,
Marshall,Superintendent of Public Instruction,Linda Murphy,REP,480106,0,0,12,12,
Marshall,Commissioner of Labor,Cathy Costello,REP,480106,0,0,12,12,
Marshall,Commissioner of Labor,Leslie Osborn,REP,480106,0,0,13,13,
Marshall,Corporation Commissioner,Bob Anthony,REP,480106,0,0,8,8,
Marshall,Corporation Commissioner,Brian Bingman,REP,480106,0,0,16,16,
Marshall,Governor,Chris Powell,LIB,480106,0,0,0,0,
Marshall,Governor,Rex Lawhorn,LIB,480106,0,0,0,0,
Marshall,Corporation Commissioner,Ashley Nicole Mccray,DEM,480106,0,0,8,8,
Marshall,Corporation Commissioner,Blake Cummings,DEM,480106,1,0,12,13,
Marshall,U.S. House,Jason Nichols,DEM,480106,0,0,7,7,02
Marshall,U.S. House,Clay Padgett,DEM,480106,1,0,13,14,02
Marshall,Governor,Mick Cornett,REP,480201,0,1,11,12,
Marshall,Governor,Kevin Stitt,REP,480201,0,2,25,27,
Marshall,Lieutenant Governor,Dana Murphy,REP,480201,0,0,10,10,
Marshall,Lieutenant Governor,Matt Pinnell,REP,480201,0,3,26,29,
Marshall,State Auditor,Cindy Byrd,REP,480201,0,3,24,27,
Marshall,State Auditor,Charlie Prater,REP,480201,0,1,11,12,
Marshall,Attorney General,Mike Hunter,REP,480201,0,1,25,26,
Marshall,Attorney General,Gentner Drummond,REP,480201,0,2,12,14,
Marshall,Superintendent of Public Instruction,Joy Hofmeister,REP,480201,0,0,18,18,
Marshall,Superintendent of Public Instruction,Linda Murphy,REP,480201,0,3,18,21,
Marshall,Commissioner of Labor,Cathy Costello,REP,480201,0,1,20,21,
Marshall,Commissioner of Labor,Leslie Osborn,REP,480201,0,2,16,18,
Marshall,Corporation Commissioner,Bob Anthony,REP,480201,0,1,27,28,
Marshall,Corporation Commissioner,Brian Bingman,REP,480201,0,2,8,10,
Marshall,Governor,Chris Powell,LIB,480201,0,0,0,0,
Marshall,Governor,Rex Lawhorn,LIB,480201,0,0,0,0,
Marshall,Corporation Commissioner,Ashley Nicole Mccray,DEM,480201,0,1,9,10,
Marshall,Corporation Commissioner,Blake Cummings,DEM,480201,0,0,5,5,
Marshall,U.S. House,Jason Nichols,DEM,480201,0,0,11,11,02
Marshall,U.S. House,Clay Padgett,DEM,480201,0,1,4,5,02
Marshall,Governor,Mick Cornett,REP,480202,0,2,7,9,
Marshall,Governor,Kevin Stitt,REP,480202,1,1,14,16,
Marshall,Lieutenant Governor,Dana Murphy,REP,480202,0,1,10,11,
Marshall,Lieutenant Governor,Matt Pinnell,REP,480202,1,2,11,14,
Marshall,State Auditor,Cindy Byrd,REP,480202,1,2,12,15,
Marshall,State Auditor,Charlie Prater,REP,480202,0,1,9,10,
Marshall,Attorney General,Mike Hunter,REP,480202,0,3,11,14,
Marshall,Attorney General,Gentner Drummond,REP,480202,1,0,9,10,
Marshall,Superintendent of Public Instruction,Joy Hofmeister,REP,480202,1,1,9,11,
Marshall,Superintendent of Public Instruction,Linda Murphy,REP,480202,0,2,11,13,
Marshall,Commissioner of Labor,Cathy Costello,REP,480202,0,1,14,15,
Marshall,Commissioner of Labor,Leslie Osborn,REP,480202,1,2,6,9,
Marshall,Corporation Commissioner,Bob Anthony,REP,480202,1,2,10,13,
Marshall,Corporation Commissioner,Brian Bingman,REP,480202,0,1,10,11,
Marshall,Governor,Chris Powell,LIB,480202,0,0,0,0,
Marshall,Governor,Rex Lawhorn,LIB,480202,0,0,0,0,
Marshall,Corporation Commissioner,Ashley Nicole Mccray,DEM,480202,3,1,17,21,
Marshall,Corporation Commissioner,Blake Cummings,DEM,480202,1,0,14,15,
Marshall,U.S. House,Jason Nichols,DEM,480202,3,0,14,17,02
Marshall,U.S. House,Clay Padgett,DEM,480202,2,1,16,19,02
Marshall,Governor,Mick Cornett,REP,480204,4,0,13,17,
Marshall,Governor,Kevin Stitt,REP,480204,2,5,37,44,
Marshall,Lieutenant Governor,Dana Murphy,REP,480204,1,0,10,11,
Marshall,Lieutenant Governor,Matt Pinnell,REP,480204,5,5,39,49,
Marshall,State Auditor,Cindy Byrd,REP,480204,4,4,31,39,
Marshall,State Auditor,Charlie Prater,REP,480204,2,1,17,20,
Marshall,Attorney General,Mike Hunter,REP,480204,6,3,14,23,
Marshall,Attorney General,Gentner Drummond,REP,480204,0,2,34,36,
Marshall,Superintendent of Public Instruction,Joy Hofmeister,REP,480204,4,2,27,33,
Marshall,Superintendent of Public Instruction,Linda Murphy,REP,480204,2,3,23,28,
Marshall,Commissioner of Labor,Cathy Costello,REP,480204,2,4,35,41,
Marshall,Commissioner of Labor,Leslie Osborn,REP,480204,4,1,13,18,
Marshall,Corporation Commissioner,Bob Anthony,REP,480204,3,3,20,26,
Marshall,Corporation Commissioner,Brian Bingman,REP,480204,3,2,28,33,
Marshall,Governor,Chris Powell,LIB,480204,0,0,0,0,
Marshall,Governor,Rex Lawhorn,LIB,480204,0,0,0,0,
Marshall,Corporation Commissioner,Ashley Nicole Mccray,DEM,480204,1,2,16,19,
Marshall,Corporation Commissioner,Blake Cummings,DEM,480204,0,0,17,17,
Marshall,U.S. House,Jason Nichols,DEM,480204,1,0,13,14,02
Marshall,U.S. House,Clay Padgett,DEM,480204,0,2,20,22,02
Marshall,Governor,Mick Cornett,REP,480206,0,1,11,12,
Marshall,Governor,Kevin Stitt,REP,480206,2,2,17,21,
Marshall,Lieutenant Governor,Dana Murphy,REP,480206,2,0,11,13,
Marshall,Lieutenant Governor,Matt Pinnell,REP,480206,0,3,18,21,
Marshall,State Auditor,Cindy Byrd,REP,480206,2,1,8,11,
Marshall,State Auditor,Charlie Prater,REP,480206,0,2,21,23,
Marshall,Attorney General,Mike Hunter,REP,480206,0,1,10,11,
Marshall,Attorney General,Gentner Drummond,REP,480206,2,2,18,22,
Marshall,Superintendent of Public Instruction,Joy Hofmeister,REP,480206,0,1,11,12,
Marshall,Superintendent of Public Instruction,Linda Murphy,REP,480206,1,2,17,20,
Marshall,Commissioner of Labor,Cathy Costello,REP,480206,1,0,9,10,
Marshall,Commissioner of Labor,Leslie Osborn,REP,480206,0,3,19,22,
Marshall,Corporation Commissioner,Bob Anthony,REP,480206,0,3,10,13,
Marshall,Corporation Commissioner,Brian Bingman,REP,480206,1,0,19,20,
Marshall,Governor,Chris Powell,LIB,480206,0,0,0,0,
Marshall,Governor,Rex Lawhorn,LIB,480206,0,0,0,0,
Marshall,Corporation Commissioner,Ashley Nicole Mccray,DEM,480206,0,3,14,17,
Marshall,Corporation Commissioner,Blake Cummings,DEM,480206,0,2,18,20,
Marshall,U.S. House,Jason Nichols,DEM,480206,0,2,14,16,02
Marshall,U.S. House,Clay Padgett,DEM,480206,0,3,18,21,02
Marshall,Governor,Mick Cornett,REP,480302,1,0,15,16,
Marshall,Governor,Kevin Stitt,REP,480302,0,0,34,34,
Marshall,Lieutenant Governor,Dana Murphy,REP,480302,0,0,14,14,
Marshall,Lieutenant Governor,Matt Pinnell,REP,480302,1,0,35,36,
Marshall,State Auditor,Cindy Byrd,REP,480302,0,0,24,24,
Marshall,State Auditor,Charlie Prater,REP,480302,1,0,25,26,
Marshall,Attorney General,Mike Hunter,REP,480302,1,0,27,28,
Marshall,Attorney General,Gentner Drummond,REP,480302,0,0,20,20,
Marshall,Superintendent of Public Instruction,Joy Hofmeister,REP,480302,0,0,27,27,
Marshall,Superintendent of Public Instruction,Linda Murphy,REP,480302,1,0,21,22,
Marshall,Commissioner of Labor,Cathy Costello,REP,480302,1,0,19,20,
Marshall,Commissioner of Labor,Leslie Osborn,REP,480302,0,0,29,29,
Marshall,Corporation Commissioner,Bob Anthony,REP,480302,1,0,29,30,
Marshall,Corporation Commissioner,Brian Bingman,REP,480302,0,0,20,20,
Marshall,Governor,Chris Powell,LIB,480302,0,0,0,0,
Marshall,Governor,Rex Lawhorn,LIB,480302,0,0,0,0,
Marshall,Corporation Commissioner,Ashley Nicole Mccray,DEM,480302,0,1,10,11,
Marshall,Corporation Commissioner,Blake Cummings,DEM,480302,2,2,14,18,
Marshall,U.S. House,Jason Nichols,DEM,480302,0,1,9,10,02
Marshall,U.S. House,Clay Padgett,DEM,480302,2,2,15,19,02
Marshall,Governor,Mick Cornett,REP,480303,2,2,37,41,
Marshall,Governor,Kevin Stitt,REP,480303,0,6,64,70,
Marshall,Lieutenant Governor,Dana Murphy,REP,480303,2,4,38,44,
Marshall,Lieutenant Governor,Matt Pinnell,REP,480303,0,4,64,68,
Marshall,State Auditor,Cindy Byrd,REP,480303,2,4,72,78,
Marshall,State Auditor,Charlie Prater,REP,480303,0,4,26,30,
Marshall,Attorney General,Mike Hunter,REP,480303,0,5,42,47,
Marshall,Attorney General,Gentner Drummond,REP,480303,2,3,61,66,
Marshall,Superintendent of Public Instruction,Joy Hofmeister,REP,480303,0,4,47,51,
Marshall,Superintendent of Public Instruction,Linda Murphy,REP,480303,2,4,54,60,
Marshall,Commissioner of Labor,Cathy Costello,REP,480303,2,5,51,58,
Marshall,Commissioner of Labor,Leslie Osborn,REP,480303,0,3,50,53,
Marshall,Corporation Commissioner,Bob Anthony,REP,480303,0,0,44,44,
Marshall,Corporation Commissioner,Brian Bingman,REP,480303,2,8,58,68,
Marshall,Governor,Chris Powell,LIB,480303,0,0,0,0,
Marshall,Governor,Rex Lawhorn,LIB,480303,0,0,0,0,
Marshall,Corporation Commissioner,Ashley Nicole Mccray,DEM,480303,5,1,15,21,
Marshall,Corporation Commissioner,Blake Cummings,DEM,480303,0,3,14,17,
Marshall,U.S. House,Jason Nichols,DEM,480303,2,0,12,14,02
Marshall,U.S. House,Clay Padgett,DEM,480303,3,4,17,24,02
Marshall,Governor,Mick Cornett,REP,480304,6,2,43,51,
Marshall,Governor,Kevin Stitt,REP,480304,3,4,63,70,
Marshall,Lieutenant Governor,Dana Murphy,REP,480304,4,3,39,46,
Marshall,Lieutenant Governor,Matt Pinnell,REP,480304,5,3,66,74,
Marshall,State Auditor,Cindy Byrd,REP,480304,5,1,51,57,
Marshall,State Auditor,Charlie Prater,REP,480304,4,3,49,56,
Marshall,Attorney General,Mike Hunter,REP,480304,3,1,51,55,
Marshall,Attorney General,Gentner Drummond,REP,480304,6,3,55,64,
Marshall,Superintendent of Public Instruction,Joy Hofmeister,REP,480304,5,2,48,55,
Marshall,Superintendent of Public Instruction,Linda Murphy,REP,480304,4,3,54,61,
Marshall,Commissioner of Labor,Cathy Costello,REP,480304,9,2,51,62,
Marshall,Commissioner of Labor,Leslie Osborn,REP,480304,0,2,47,49,
Marshall,Corporation Commissioner,Bob Anthony,REP,480304,5,3,49,57,
Marshall,Corporation Commissioner,Brian Bingman,REP,480304,4,2,53,59,
Marshall,Governor,Chris Powell,LIB,480304,0,0,0,0,
Marshall,Governor,Rex Lawhorn,LIB,480304,0,0,0,0,
Marshall,Corporation Commissioner,Ashley Nicole Mccray,DEM,480304,0,0,28,28,
Marshall,Corporation Commissioner,Blake Cummings,DEM,480304,0,0,21,21,
Marshall,U.S. House,Jason Nichols,DEM,480304,0,0,22,22,02
Marshall,U.S. House,Clay Padgett,DEM,480304,0,0,27,27,02
Mayes,Governor,Mick Cornett,REP,490011,0,0,38,38,
Mayes,Governor,Kevin Stitt,REP,490011,3,3,93,99,
Mayes,Lieutenant Governor,Dana Murphy,REP,490011,2,0,41,43,
Mayes,Lieutenant Governor,Matt Pinnell,REP,490011,1,3,89,93,
Mayes,State Auditor,Cindy Byrd,REP,490011,1,1,42,44,
Mayes,State Auditor,Charlie Prater,REP,490011,2,2,86,90,
Mayes,Attorney General,Mike Hunter,REP,490011,0,1,48,49,
Mayes,Attorney General,Gentner Drummond,REP,490011,3,2,82,87,
Mayes,Superintendent of Public Instruction,Joy Hofmeister,REP,490011,1,1,61,63,
Mayes,Superintendent of Public Instruction,Linda Murphy,REP,490011,2,2,68,72,
Mayes,Commissioner of Labor,Cathy Costello,REP,490011,0,2,48,50,
Mayes,Commissioner of Labor,Leslie Osborn,REP,490011,3,1,79,83,
Mayes,Corporation Commissioner,Bob Anthony,REP,490011,2,2,49,53,
Mayes,Corporation Commissioner,Brian Bingman,REP,490011,1,1,78,80,
Mayes,Governor,Chris Powell,LIB,490011,0,0,0,0,
Mayes,Governor,Rex Lawhorn,LIB,490011,0,0,2,2,
Mayes,Corporation Commissioner,Ashley Nicole Mccray,DEM,490011,4,0,28,32,
Mayes,Corporation Commissioner,Blake Cummings,DEM,490011,1,0,19,20,
Mayes,U.S. House,Jason Nichols,DEM,490011,3,0,32,35,02
Mayes,U.S. House,Clay Padgett,DEM,490011,2,0,15,17,02
Mayes,Governor,Mick Cornett,REP,490012,1,0,41,42,
Mayes,Governor,Kevin Stitt,REP,490012,2,4,59,65,
Mayes,Lieutenant Governor,Dana Murphy,REP,490012,1,3,33,37,
Mayes,Lieutenant Governor,Matt Pinnell,REP,490012,2,1,65,68,
Mayes,State Auditor,Cindy Byrd,REP,490012,3,0,38,41,
Mayes,State Auditor,Charlie Prater,REP,490012,0,4,57,61,
Mayes,Attorney General,Mike Hunter,REP,490012,1,1,37,39,
Mayes,Attorney General,Gentner Drummond,REP,490012,2,3,60,65,
Mayes,Superintendent of Public Instruction,Joy Hofmeister,REP,490012,1,0,57,58,
Mayes,Superintendent of Public Instruction,Linda Murphy,REP,490012,2,4,42,48,
Mayes,Commissioner of Labor,Cathy Costello,REP,490012,2,3,37,42,
Mayes,Commissioner of Labor,Leslie Osborn,REP,490012,1,1,58,60,
Mayes,Corporation Commissioner,Bob Anthony,REP,490012,2,1,38,41,
Mayes,Corporation Commissioner,Brian Bingman,REP,490012,1,3,58,62,
Mayes,Governor,Chris Powell,LIB,490012,0,0,1,1,
Mayes,Governor,Rex Lawhorn,LIB,490012,0,0,0,0,
Mayes,Corporation Commissioner,Ashley Nicole Mccray,DEM,490012,3,0,30,33,
Mayes,Corporation Commissioner,Blake Cummings,DEM,490012,0,4,31,35,
Mayes,U.S. House,Jason Nichols,DEM,490012,3,1,46,50,02
Mayes,U.S. House,Clay Padgett,DEM,490012,0,3,15,18,02
Mayes,Governor,Mick Cornett,REP,490014,0,0,18,18,
Mayes,Governor,Kevin Stitt,REP,490014,0,0,23,23,
Mayes,Lieutenant Governor,Dana Murphy,REP,490014,0,0,11,11,
Mayes,Lieutenant Governor,Matt Pinnell,REP,490014,0,0,29,29,
Mayes,State Auditor,Cindy Byrd,REP,490014,0,0,16,16,
Mayes,State Auditor,Charlie Prater,REP,490014,0,0,24,24,
Mayes,Attorney General,Mike Hunter,REP,490014,0,0,18,18,
Mayes,Attorney General,Gentner Drummond,REP,490014,0,0,22,22,
Mayes,Superintendent of Public Instruction,Joy Hofmeister,REP,490014,0,0,17,17,
Mayes,Superintendent of Public Instruction,Linda Murphy,REP,490014,0,0,23,23,
Mayes,Commissioner of Labor,Cathy Costello,REP,490014,0,0,12,12,
Mayes,Commissioner of Labor,Leslie Osborn,REP,490014,0,0,28,28,
Mayes,Corporation Commissioner,Bob Anthony,REP,490014,0,0,15,15,
Mayes,Corporation Commissioner,Brian Bingman,REP,490014,0,0,24,24,
Mayes,Governor,Chris Powell,LIB,490014,0,0,0,0,
Mayes,Governor,Rex Lawhorn,LIB,490014,0,0,0,0,
Mayes,Corporation Commissioner,Ashley Nicole Mccray,DEM,490014,0,0,6,6,
Mayes,Corporation Commissioner,Blake Cummings,DEM,490014,0,2,9,11,
Mayes,U.S. House,Jason Nichols,DEM,490014,0,1,9,10,02
Mayes,U.S. House,Clay Padgett,DEM,490014,0,1,6,7,02
Mayes,Governor,Mick Cornett,REP,490015,1,0,34,35,
Mayes,Governor,Kevin Stitt,REP,490015,1,11,63,75,
Mayes,Lieutenant Governor,Dana Murphy,REP,490015,0,6,33,39,
Mayes,Lieutenant Governor,Matt Pinnell,REP,490015,2,5,61,68,
Mayes,State Auditor,Cindy Byrd,REP,490015,1,4,38,43,
Mayes,State Auditor,Charlie Prater,REP,490015,1,7,55,63,
Mayes,Attorney General,Mike Hunter,REP,490015,1,3,46,50,
Mayes,Attorney General,Gentner Drummond,REP,490015,1,8,50,59,
Mayes,Superintendent of Public Instruction,Joy Hofmeister,REP,490015,1,6,52,59,
Mayes,Superintendent of Public Instruction,Linda Murphy,REP,490015,1,5,43,49,
Mayes,Commissioner of Labor,Cathy Costello,REP,490015,1,6,31,38,
Mayes,Commissioner of Labor,Leslie Osborn,REP,490015,1,5,61,67,
Mayes,Corporation Commissioner,Bob Anthony,REP,490015,0,2,50,52,
Mayes,Corporation Commissioner,Brian Bingman,REP,490015,2,9,45,56,
Mayes,Governor,Chris Powell,LIB,490015,0,0,0,0,
Mayes,Governor,Rex Lawhorn,LIB,490015,0,0,0,0,
Mayes,Corporation Commissioner,Ashley Nicole Mccray,DEM,490015,2,2,33,37,
Mayes,Corporation Commissioner,Blake Cummings,DEM,490015,0,0,31,31,
Mayes,U.S. House,Jason Nichols,DEM,490015,0,1,40,41,02
Mayes,U.S. House,Clay Padgett,DEM,490015,3,1,23,27,02
Mayes,Governor,Mick Cornett,REP,490016,2,1,30,33,
Mayes,Governor,Kevin Stitt,REP,490016,0,2,42,44,
Mayes,Lieutenant Governor,Dana Murphy,REP,490016,1,1,16,18,
Mayes,Lieutenant Governor,Matt Pinnell,REP,490016,1,2,57,60,
Mayes,State Auditor,Cindy Byrd,REP,490016,1,1,34,36,
Mayes,State Auditor,Charlie Prater,REP,490016,1,2,38,41,
Mayes,Attorney General,Mike Hunter,REP,490016,1,2,29,32,
Mayes,Attorney General,Gentner Drummond,REP,490016,1,1,44,46,
Mayes,Superintendent of Public Instruction,Joy Hofmeister,REP,490016,1,0,46,47,
Mayes,Superintendent of Public Instruction,Linda Murphy,REP,490016,1,3,27,31,
Mayes,Commissioner of Labor,Cathy Costello,REP,490016,1,1,32,34,
Mayes,Commissioner of Labor,Leslie Osborn,REP,490016,1,2,41,44,
Mayes,Corporation Commissioner,Bob Anthony,REP,490016,1,2,34,37,
Mayes,Corporation Commissioner,Brian Bingman,REP,490016,1,1,38,40,
Mayes,Governor,Chris Powell,LIB,490016,0,0,0,0,
Mayes,Governor,Rex Lawhorn,LIB,490016,0,0,0,0,
Mayes,Corporation Commissioner,Ashley Nicole Mccray,DEM,490016,2,2,5,9,
Mayes,Corporation Commissioner,Blake Cummings,DEM,490016,0,2,20,22,
Mayes,U.S. House,Jason Nichols,DEM,490016,2,4,16,22,02
Mayes,U.S. House,Clay Padgett,DEM,490016,0,0,9,9,02
Mayes,Governor,Mick Cornett,REP,490020,0,2,48,50,
Mayes,Governor,Kevin Stitt,REP,490020,4,13,121,138,
Mayes,Lieutenant Governor,Dana Murphy,REP,490020,0,3,51,54,
Mayes,Lieutenant Governor,Matt Pinnell,REP,490020,5,12,116,133,
Mayes,State Auditor,Cindy Byrd,REP,490020,0,3,77,80,
Mayes,State Auditor,Charlie Prater,REP,490020,5,10,86,101,
Mayes,Attorney General,Mike Hunter,REP,490020,2,4,57,63,
Mayes,Attorney General,Gentner Drummond,REP,490020,3,10,107,120,
Mayes,Superintendent of Public Instruction,Joy Hofmeister,REP,490020,2,6,96,104,
Mayes,Superintendent of Public Instruction,Linda Murphy,REP,490020,3,7,71,81,
Mayes,Commissioner of Labor,Cathy Costello,REP,490020,5,6,66,77,
Mayes,Commissioner of Labor,Leslie Osborn,REP,490020,0,7,99,106,
Mayes,Corporation Commissioner,Bob Anthony,REP,490020,2,4,73,79,
Mayes,Corporation Commissioner,Brian Bingman,REP,490020,3,9,93,105,
Mayes,Governor,Chris Powell,LIB,490020,0,0,1,1,
Mayes,Governor,Rex Lawhorn,LIB,490020,0,0,0,0,
Mayes,Corporation Commissioner,Ashley Nicole Mccray,DEM,490020,0,4,40,44,
Mayes,Corporation Commissioner,Blake Cummings,DEM,490020,0,8,36,44,
Mayes,U.S. House,Jason Nichols,DEM,490020,0,9,56,65,02
Mayes,U.S. House,Clay Padgett,DEM,490020,0,5,20,25,02
Mayes,Governor,Mick Cornett,REP,490021,0,0,26,26,
Mayes,Governor,Kevin Stitt,REP,490021,3,2,69,74,
Mayes,Lieutenant Governor,Dana Murphy,REP,490021,0,2,14,16,
Mayes,Lieutenant Governor,Matt Pinnell,REP,490021,3,0,79,82,
Mayes,State Auditor,Cindy Byrd,REP,490021,2,1,25,28,
Mayes,State Auditor,Charlie Prater,REP,490021,1,1,64,66,
Mayes,Attorney General,Mike Hunter,REP,490021,0,2,33,35,
Mayes,Attorney General,Gentner Drummond,REP,490021,3,0,58,61,
Mayes,Superintendent of Public Instruction,Joy Hofmeister,REP,490021,3,0,49,52,
Mayes,Superintendent of Public Instruction,Linda Murphy,REP,490021,0,2,41,43,
Mayes,Commissioner of Labor,Cathy Costello,REP,490021,1,1,31,33,
Mayes,Commissioner of Labor,Leslie Osborn,REP,490021,2,1,60,63,
Mayes,Corporation Commissioner,Bob Anthony,REP,490021,2,0,43,45,
Mayes,Corporation Commissioner,Brian Bingman,REP,490021,1,2,49,52,
Mayes,Governor,Chris Powell,LIB,490021,0,0,0,0,
Mayes,Governor,Rex Lawhorn,LIB,490021,0,0,1,1,
Mayes,Corporation Commissioner,Ashley Nicole Mccray,DEM,490021,2,0,18,20,
Mayes,Corporation Commissioner,Blake Cummings,DEM,490021,0,3,18,21,
Mayes,U.S. House,Jason Nichols,DEM,490021,1,1,31,33,02
Mayes,U.S. House,Clay Padgett,DEM,490021,1,2,5,8,02
Mayes,Governor,Mick Cornett,REP,490022,0,1,40,41,
Mayes,Governor,Kevin Stitt,REP,490022,1,0,62,63,
Mayes,Lieutenant Governor,Dana Murphy,REP,490022,0,1,29,30,
Mayes,Lieutenant Governor,Matt Pinnell,REP,490022,1,0,71,72,
Mayes,State Auditor,Cindy Byrd,REP,490022,0,0,41,41,
Mayes,State Auditor,Charlie Prater,REP,490022,1,1,58,60,
Mayes,Attorney General,Mike Hunter,REP,490022,0,1,36,37,
Mayes,Attorney General,Gentner Drummond,REP,490022,1,0,66,67,
Mayes,Superintendent of Public Instruction,Joy Hofmeister,REP,490022,1,1,50,52,
Mayes,Superintendent of Public Instruction,Linda Murphy,REP,490022,0,0,50,50,
Mayes,Commissioner of Labor,Cathy Costello,REP,490022,1,0,50,51,
Mayes,Commissioner of Labor,Leslie Osborn,REP,490022,0,1,45,46,
Mayes,Corporation Commissioner,Bob Anthony,REP,490022,1,1,46,48,
Mayes,Corporation Commissioner,Brian Bingman,REP,490022,0,0,52,52,
Mayes,Governor,Chris Powell,LIB,490022,0,0,0,0,
Mayes,Governor,Rex Lawhorn,LIB,490022,0,0,0,0,
Mayes,Corporation Commissioner,Ashley Nicole Mccray,DEM,490022,2,0,23,25,
Mayes,Corporation Commissioner,Blake Cummings,DEM,490022,0,0,19,19,
Mayes,U.S. House,Jason Nichols,DEM,490022,0,0,26,26,02
Mayes,U.S. House,Clay Padgett,DEM,490022,2,0,16,18,02
Mayes,Governor,Mick Cornett,REP,490023,1,1,46,48,
Mayes,Governor,Kevin Stitt,REP,490023,2,3,105,110,
Mayes,Lieutenant Governor,Dana Murphy,REP,490023,1,3,51,55,
Mayes,Lieutenant Governor,Matt Pinnell,REP,490023,2,1,97,100,
Mayes,State Auditor,Cindy Byrd,REP,490023,1,3,57,61,
Mayes,State Auditor,Charlie Prater,REP,490023,2,1,88,91,
Mayes,Attorney General,Mike Hunter,REP,490023,2,1,75,78,
Mayes,Attorney General,Gentner Drummond,REP,490023,1,3,76,80,
Mayes,Superintendent of Public Instruction,Joy Hofmeister,REP,490023,0,1,78,79,
Mayes,Superintendent of Public Instruction,Linda Murphy,REP,490023,2,3,70,75,
Mayes,Commissioner of Labor,Cathy Costello,REP,490023,0,1,49,50,
Mayes,Commissioner of Labor,Leslie Osborn,REP,490023,2,3,94,99,
Mayes,Corporation Commissioner,Bob Anthony,REP,490023,1,3,72,76,
Mayes,Corporation Commissioner,Brian Bingman,REP,490023,1,1,75,77,
Mayes,Governor,Chris Powell,LIB,490023,0,0,2,2,
Mayes,Governor,Rex Lawhorn,LIB,490023,0,0,0,0,
Mayes,Corporation Commissioner,Ashley Nicole Mccray,DEM,490023,2,0,30,32,
Mayes,Corporation Commissioner,Blake Cummings,DEM,490023,2,0,30,32,
Mayes,U.S. House,Jason Nichols,DEM,490023,3,0,41,44,02
Mayes,U.S. House,Clay Padgett,DEM,490023,1,0,18,19,02
Mayes,Governor,Mick Cornett,REP,490024,0,3,23,26,
Mayes,Governor,Kevin Stitt,REP,490024,1,2,78,81,
Mayes,Lieutenant Governor,Dana Murphy,REP,490024,0,3,31,34,
Mayes,Lieutenant Governor,Matt Pinnell,REP,490024,1,2,69,72,
Mayes,State Auditor,Cindy Byrd,REP,490024,0,3,32,35,
Mayes,State Auditor,Charlie Prater,REP,490024,1,2,64,67,
Mayes,Attorney General,Mike Hunter,REP,490024,0,2,28,30,
Mayes,Attorney General,Gentner Drummond,REP,490024,1,3,72,76,
Mayes,Superintendent of Public Instruction,Joy Hofmeister,REP,490024,0,1,49,50,
Mayes,Superintendent of Public Instruction,Linda Murphy,REP,490024,1,3,49,53,
Mayes,Commissioner of Labor,Cathy Costello,REP,490024,0,0,45,45,
Mayes,Commissioner of Labor,Leslie Osborn,REP,490024,1,4,52,57,
Mayes,Corporation Commissioner,Bob Anthony,REP,490024,0,3,49,52,
Mayes,Corporation Commissioner,Brian Bingman,REP,490024,1,1,49,51,
Mayes,Governor,Chris Powell,LIB,490024,0,0,0,0,
Mayes,Governor,Rex Lawhorn,LIB,490024,0,0,0,0,
Mayes,Corporation Commissioner,Ashley Nicole Mccray,DEM,490024,0,2,16,18,
Mayes,Corporation Commissioner,Blake Cummings,DEM,490024,0,0,13,13,
Mayes,U.S. House,Jason Nichols,DEM,490024,0,2,21,23,02
Mayes,U.S. House,Clay Padgett,DEM,490024,0,0,8,8,02
Mayes,Governor,Mick Cornett,REP,490025,0,0,20,20,
Mayes,Governor,Kevin Stitt,REP,490025,2,2,50,54,
Mayes,Lieutenant Governor,Dana Murphy,REP,490025,0,0,24,24,
Mayes,Lieutenant Governor,Matt Pinnell,REP,490025,2,2,45,49,
Mayes,State Auditor,Cindy Byrd,REP,490025,2,0,27,29,
Mayes,State Auditor,Charlie Prater,REP,490025,0,2,41,43,
Mayes,Attorney General,Mike Hunter,REP,490025,0,0,33,33,
Mayes,Attorney General,Gentner Drummond,REP,490025,1,2,37,40,
Mayes,Superintendent of Public Instruction,Joy Hofmeister,REP,490025,0,0,35,35,
Mayes,Superintendent of Public Instruction,Linda Murphy,REP,490025,2,2,34,38,
Mayes,Commissioner of Labor,Cathy Costello,REP,490025,1,0,36,37,
Mayes,Commissioner of Labor,Leslie Osborn,REP,490025,1,2,34,37,
Mayes,Corporation Commissioner,Bob Anthony,REP,490025,2,1,35,38,
Mayes,Corporation Commissioner,Brian Bingman,REP,490025,0,1,34,35,
Mayes,Governor,Chris Powell,LIB,490025,0,1,1,2,
Mayes,Governor,Rex Lawhorn,LIB,490025,0,0,0,0,
Mayes,Corporation Commissioner,Ashley Nicole Mccray,DEM,490025,1,0,17,18,
Mayes,Corporation Commissioner,Blake Cummings,DEM,490025,0,0,8,8,
Mayes,U.S. House,Jason Nichols,DEM,490025,0,0,19,19,02
Mayes,U.S. House,Clay Padgett,DEM,490025,1,0,6,7,02
Mayes,Governor,Mick Cornett,REP,490026,0,0,3,3,
Mayes,Governor,Kevin Stitt,REP,490026,0,1,7,8,
Mayes,Lieutenant Governor,Dana Murphy,REP,490026,0,1,3,4,
Mayes,Lieutenant Governor,Matt Pinnell,REP,490026,0,0,7,7,
Mayes,State Auditor,Cindy Byrd,REP,490026,0,1,3,4,
Mayes,State Auditor,Charlie Prater,REP,490026,0,0,7,7,
Mayes,Attorney General,Mike Hunter,REP,490026,0,0,9,9,
Mayes,Attorney General,Gentner Drummond,REP,490026,0,1,1,2,
Mayes,Superintendent of Public Instruction,Joy Hofmeister,REP,490026,0,1,6,7,
Mayes,Superintendent of Public Instruction,Linda Murphy,REP,490026,0,0,4,4,
Mayes,Commissioner of Labor,Cathy Costello,REP,490026,0,0,2,2,
Mayes,Commissioner of Labor,Leslie Osborn,REP,490026,0,1,8,9,
Mayes,Corporation Commissioner,Bob Anthony,REP,490026,0,1,6,7,
Mayes,Corporation Commissioner,Brian Bingman,REP,490026,0,0,4,4,
Mayes,Governor,Chris Powell,LIB,490026,0,0,0,0,
Mayes,Governor,Rex Lawhorn,LIB,490026,0,0,0,0,
Mayes,Corporation Commissioner,Ashley Nicole Mccray,DEM,490026,0,0,0,0,
Mayes,Corporation Commissioner,Blake Cummings,DEM,490026,0,0,1,1,
Mayes,U.S. House,Jason Nichols,DEM,490026,0,0,1,1,02
Mayes,U.S. House,Clay Padgett,DEM,490026,0,0,0,0,02
Mayes,Governor,Mick Cornett,REP,490027,0,0,2,2,
Mayes,Governor,Kevin Stitt,REP,490027,0,0,6,6,
Mayes,Lieutenant Governor,Dana Murphy,REP,490027,0,0,5,5,
Mayes,Lieutenant Governor,Matt Pinnell,REP,490027,0,0,3,3,
Mayes,State Auditor,Cindy Byrd,REP,490027,0,0,3,3,
Mayes,State Auditor,Charlie Prater,REP,490027,0,0,5,5,
Mayes,Attorney General,Mike Hunter,REP,490027,0,0,3,3,
Mayes,Attorney General,Gentner Drummond,REP,490027,0,0,5,5,
Mayes,Superintendent of Public Instruction,Joy Hofmeister,REP,490027,0,0,3,3,
Mayes,Superintendent of Public Instruction,Linda Murphy,REP,490027,0,0,5,5,
Mayes,Commissioner of Labor,Cathy Costello,REP,490027,0,0,2,2,
Mayes,Commissioner of Labor,Leslie Osborn,REP,490027,0,0,6,6,
Mayes,Corporation Commissioner,Bob Anthony,REP,490027,0,0,7,7,
Mayes,Corporation Commissioner,Brian Bingman,REP,490027,0,0,1,1,
Mayes,Governor,Chris Powell,LIB,490027,0,0,0,0,
Mayes,Governor,Rex Lawhorn,LIB,490027,0,0,0,0,
Mayes,Corporation Commissioner,Ashley Nicole Mccray,DEM,490027,0,0,2,2,
Mayes,Corporation Commissioner,Blake Cummings,DEM,490027,0,0,0,0,
Mayes,U.S. House,Jason Nichols,DEM,490027,0,0,0,0,02
Mayes,U.S. House,Clay Padgett,DEM,490027,0,0,2,2,02
Mayes,Governor,Mick Cornett,REP,490031,3,0,81,84,
Mayes,Governor,Kevin Stitt,REP,490031,3,2,102,107,
Mayes,Lieutenant Governor,Dana Murphy,REP,490031,6,1,51,58,
Mayes,Lieutenant Governor,Matt Pinnell,REP,490031,0,1,128,129,
Mayes,State Auditor,Cindy Byrd,REP,490031,5,2,71,78,
Mayes,State Auditor,Charlie Prater,REP,490031,1,0,108,109,
Mayes,Attorney General,Mike Hunter,REP,490031,4,1,75,80,
Mayes,Attorney General,Gentner Drummond,REP,490031,2,1,106,109,
Mayes,Superintendent of Public Instruction,Joy Hofmeister,REP,490031,3,0,115,118,
Mayes,Superintendent of Public Instruction,Linda Murphy,REP,490031,2,2,67,71,
Mayes,Commissioner of Labor,Cathy Costello,REP,490031,3,1,73,77,
Mayes,Commissioner of Labor,Leslie Osborn,REP,490031,3,1,102,106,
Mayes,Corporation Commissioner,Bob Anthony,REP,490031,3,0,79,82,
Mayes,Corporation Commissioner,Brian Bingman,REP,490031,3,2,99,104,
Mayes,Governor,Chris Powell,LIB,490031,0,0,0,0,
Mayes,Governor,Rex Lawhorn,LIB,490031,0,0,0,0,
Mayes,Corporation Commissioner,Ashley Nicole Mccray,DEM,490031,0,1,37,38,
Mayes,Corporation Commissioner,Blake Cummings,DEM,490031,0,1,25,26,
Mayes,U.S. House,Jason Nichols,DEM,490031,0,2,37,39,02
Mayes,U.S. House,Clay Padgett,DEM,490031,0,0,25,25,02
Mayes,Governor,Mick Cornett,REP,490034,1,0,17,18,
Mayes,Governor,Kevin Stitt,REP,490034,1,0,46,47,
Mayes,Lieutenant Governor,Dana Murphy,REP,490034,2,0,14,16,
Mayes,Lieutenant Governor,Matt Pinnell,REP,490034,0,0,49,49,
Mayes,State Auditor,Cindy Byrd,REP,490034,2,0,23,25,
Mayes,State Auditor,Charlie Prater,REP,490034,0,0,39,39,
Mayes,Attorney General,Mike Hunter,REP,490034,1,0,24,25,
Mayes,Attorney General,Gentner Drummond,REP,490034,1,0,38,39,
Mayes,Superintendent of Public Instruction,Joy Hofmeister,REP,490034,1,0,23,24,
Mayes,Superintendent of Public Instruction,Linda Murphy,REP,490034,1,0,38,39,
Mayes,Commissioner of Labor,Cathy Costello,REP,490034,2,0,23,25,
Mayes,Commissioner of Labor,Leslie Osborn,REP,490034,0,0,39,39,
Mayes,Corporation Commissioner,Bob Anthony,REP,490034,2,0,27,29,
Mayes,Corporation Commissioner,Brian Bingman,REP,490034,0,0,37,37,
Mayes,Governor,Chris Powell,LIB,490034,0,0,0,0,
Mayes,Governor,Rex Lawhorn,LIB,490034,0,0,0,0,
Mayes,Corporation Commissioner,Ashley Nicole Mccray,DEM,490034,1,0,18,19,
Mayes,Corporation Commissioner,Blake Cummings,DEM,490034,0,0,19,19,
Mayes,U.S. House,Jason Nichols,DEM,490034,1,0,22,23,02
Mayes,U.S. House,Clay Padgett,DEM,490034,0,0,15,15,02
Mayes,Governor,Mick Cornett,REP,490036,3,0,42,45,
Mayes,Governor,Kevin Stitt,REP,490036,4,0,146,150,
Mayes,Lieutenant Governor,Dana Murphy,REP,490036,2,0,60,62,
Mayes,Lieutenant Governor,Matt Pinnell,REP,490036,5,1,128,134,
Mayes,State Auditor,Cindy Byrd,REP,490036,4,1,88,93,
Mayes,State Auditor,Charlie Prater,REP,490036,4,0,98,102,
Mayes,Attorney General,Mike Hunter,REP,490036,4,0,82,86,
Mayes,Attorney General,Gentner Drummond,REP,490036,4,1,105,110,
Mayes,Superintendent of Public Instruction,Joy Hofmeister,REP,490036,4,0,94,98,
Mayes,Superintendent of Public Instruction,Linda Murphy,REP,490036,4,1,92,97,
Mayes,Commissioner of Labor,Cathy Costello,REP,490036,6,1,77,84,
Mayes,Commissioner of Labor,Leslie Osborn,REP,490036,2,0,108,110,
Mayes,Corporation Commissioner,Bob Anthony,REP,490036,4,0,81,85,
Mayes,Corporation Commissioner,Brian Bingman,REP,490036,4,1,105,110,
Mayes,Governor,Chris Powell,LIB,490036,0,0,0,0,
Mayes,Governor,Rex Lawhorn,LIB,490036,0,0,2,2,
Mayes,Corporation Commissioner,Ashley Nicole Mccray,DEM,490036,3,1,38,42,
Mayes,Corporation Commissioner,Blake Cummings,DEM,490036,2,2,58,62,
Mayes,U.S. House,Jason Nichols,DEM,490036,2,1,69,72,02
Mayes,U.S. House,Clay Padgett,DEM,490036,3,2,27,32,02
Mayes,Governor,Mick Cornett,REP,490037,0,0,26,26,
Mayes,Governor,Kevin Stitt,REP,490037,4,7,99,110,
Mayes,Lieutenant Governor,Dana Murphy,REP,490037,1,4,51,56,
Mayes,Lieutenant Governor,Matt Pinnell,REP,490037,3,3,75,81,
Mayes,State Auditor,Cindy Byrd,REP,490037,4,4,42,50,
Mayes,State Auditor,Charlie Prater,REP,490037,0,3,81,84,
Mayes,Attorney General,Mike Hunter,REP,490037,0,2,52,54,
Mayes,Attorney General,Gentner Drummond,REP,490037,4,5,73,82,
Mayes,Superintendent of Public Instruction,Joy Hofmeister,REP,490037,2,2,51,55,
Mayes,Superintendent of Public Instruction,Linda Murphy,REP,490037,2,5,74,81,
Mayes,Commissioner of Labor,Cathy Costello,REP,490037,1,3,53,57,
Mayes,Commissioner of Labor,Leslie Osborn,REP,490037,3,4,70,77,
Mayes,Corporation Commissioner,Bob Anthony,REP,490037,0,4,54,58,
Mayes,Corporation Commissioner,Brian Bingman,REP,490037,4,3,71,78,
Mayes,Governor,Chris Powell,LIB,490037,0,0,0,0,
Mayes,Governor,Rex Lawhorn,LIB,490037,0,0,0,0,
Mayes,Corporation Commissioner,Ashley Nicole Mccray,DEM,490037,0,0,20,20,
Mayes,Corporation Commissioner,Blake Cummings,DEM,490037,2,0,23,25,
Mayes,U.S. House,Jason Nichols,DEM,490037,0,0,24,24,02
Mayes,U.S. House,Clay Padgett,DEM,490037,2,0,19,21,02
Mayes,Governor,Mick Cornett,REP,490038,1,0,16,17,
Mayes,Governor,Kevin Stitt,REP,490038,0,2,38,40,
Mayes,Lieutenant Governor,Dana Murphy,REP,490038,0,1,20,21,
Mayes,Lieutenant Governor,Matt Pinnell,REP,490038,1,1,34,36,
Mayes,State Auditor,Cindy Byrd,REP,490038,0,0,15,15,
Mayes,State Auditor,Charlie Prater,REP,490038,1,2,37,40,
Mayes,Attorney General,Mike Hunter,REP,490038,0,0,22,22,
Mayes,Attorney General,Gentner Drummond,REP,490038,1,2,32,35,
Mayes,Superintendent of Public Instruction,Joy Hofmeister,REP,490038,0,1,30,31,
Mayes,Superintendent of Public Instruction,Linda Murphy,REP,490038,1,1,23,25,
Mayes,Commissioner of Labor,Cathy Costello,REP,490038,0,1,27,28,
Mayes,Commissioner of Labor,Leslie Osborn,REP,490038,1,1,24,26,
Mayes,Corporation Commissioner,Bob Anthony,REP,490038,1,2,17,20,
Mayes,Corporation Commissioner,Brian Bingman,REP,490038,0,0,34,34,
Mayes,Governor,Chris Powell,LIB,490038,0,0,0,0,
Mayes,Governor,Rex Lawhorn,LIB,490038,0,0,1,1,
Mayes,Corporation Commissioner,Ashley Nicole Mccray,DEM,490038,0,0,13,13,
Mayes,Corporation Commissioner,Blake Cummings,DEM,490038,0,2,11,13,
Mayes,U.S. House,Jason Nichols,DEM,490038,0,2,20,22,02
Mayes,U.S. House,Clay Padgett,DEM,490038,0,0,4,4,02
Mayes,Governor,Mick Cornett,REP,490039,0,2,31,33,
Mayes,Governor,Kevin Stitt,REP,490039,1,1,72,74,
Mayes,Lieutenant Governor,Dana Murphy,REP,490039,1,1,33,35,
Mayes,Lieutenant Governor,Matt Pinnell,REP,490039,0,2,70,72,
Mayes,State Auditor,Cindy Byrd,REP,490039,0,0,41,41,
Mayes,State Auditor,Charlie Prater,REP,490039,1,3,60,64,
Mayes,Attorney General,Mike Hunter,REP,490039,1,0,44,45,
Mayes,Attorney General,Gentner Drummond,REP,490039,0,3,59,62,
Mayes,Superintendent of Public Instruction,Joy Hofmeister,REP,490039,1,2,33,36,
Mayes,Superintendent of Public Instruction,Linda Murphy,REP,490039,0,1,70,71,
Mayes,Commissioner of Labor,Cathy Costello,REP,490039,0,0,46,46,
Mayes,Commissioner of Labor,Leslie Osborn,REP,490039,1,3,54,58,
Mayes,Corporation Commissioner,Bob Anthony,REP,490039,1,1,47,49,
Mayes,Corporation Commissioner,Brian Bingman,REP,490039,0,2,53,55,
Mayes,Governor,Chris Powell,LIB,490039,0,0,0,0,
Mayes,Governor,Rex Lawhorn,LIB,490039,0,0,0,0,
Mayes,Corporation Commissioner,Ashley Nicole Mccray,DEM,490039,0,2,37,39,
Mayes,Corporation Commissioner,Blake Cummings,DEM,490039,1,1,28,30,
Mayes,U.S. House,Jason Nichols,DEM,490039,0,1,45,46,02
Mayes,U.S. House,Clay Padgett,DEM,490039,1,2,20,23,02
Mayes,Governor,Mick Cornett,REP,490101,1,1,19,21,
Mayes,Governor,Kevin Stitt,REP,490101,0,2,46,48,
Mayes,Lieutenant Governor,Dana Murphy,REP,490101,0,1,21,22,
Mayes,Lieutenant Governor,Matt Pinnell,REP,490101,1,2,43,46,
Mayes,State Auditor,Cindy Byrd,REP,490101,0,1,25,26,
Mayes,State Auditor,Charlie Prater,REP,490101,1,2,39,42,
Mayes,Attorney General,Mike Hunter,REP,490101,1,2,24,27,
Mayes,Attorney General,Gentner Drummond,REP,490101,0,1,39,40,
Mayes,Superintendent of Public Instruction,Joy Hofmeister,REP,490101,1,2,31,34,
Mayes,Superintendent of Public Instruction,Linda Murphy,REP,490101,0,1,33,34,
Mayes,Commissioner of Labor,Cathy Costello,REP,490101,1,1,32,34,
Mayes,Commissioner of Labor,Leslie Osborn,REP,490101,0,2,30,32,
Mayes,Corporation Commissioner,Bob Anthony,REP,490101,1,1,28,30,
Mayes,Corporation Commissioner,Brian Bingman,REP,490101,0,2,34,36,
Mayes,Governor,Chris Powell,LIB,490101,0,0,0,0,
Mayes,Governor,Rex Lawhorn,LIB,490101,0,0,0,0,
Mayes,Corporation Commissioner,Ashley Nicole Mccray,DEM,490101,3,5,50,58,
Mayes,Corporation Commissioner,Blake Cummings,DEM,490101,3,3,31,37,
Mayes,U.S. House,Jason Nichols,DEM,490101,4,5,67,76,02
Mayes,U.S. House,Clay Padgett,DEM,490101,2,3,14,19,02
Mayes,Governor,Mick Cornett,REP,490121,1,4,59,64,
Mayes,Governor,Kevin Stitt,REP,490121,1,8,111,120,
Mayes,Lieutenant Governor,Dana Murphy,REP,490121,2,5,57,64,
Mayes,Lieutenant Governor,Matt Pinnell,REP,490121,0,7,108,115,
Mayes,State Auditor,Cindy Byrd,REP,490121,2,5,74,81,
Mayes,State Auditor,Charlie Prater,REP,490121,0,7,86,93,
Mayes,Attorney General,Mike Hunter,REP,490121,1,7,62,70,
Mayes,Attorney General,Gentner Drummond,REP,490121,1,5,102,108,
Mayes,Superintendent of Public Instruction,Joy Hofmeister,REP,490121,1,8,91,100,
Mayes,Superintendent of Public Instruction,Linda Murphy,REP,490121,1,4,74,79,
Mayes,Commissioner of Labor,Cathy Costello,REP,490121,1,7,65,73,
Mayes,Commissioner of Labor,Leslie Osborn,REP,490121,1,5,98,104,
Mayes,Corporation Commissioner,Bob Anthony,REP,490121,0,5,71,76,
Mayes,Corporation Commissioner,Brian Bingman,REP,490121,2,5,94,101,
Mayes,Governor,Chris Powell,LIB,490121,0,0,0,0,
Mayes,Governor,Rex Lawhorn,LIB,490121,0,0,0,0,
Mayes,Corporation Commissioner,Ashley Nicole Mccray,DEM,490121,1,9,68,78,
Mayes,Corporation Commissioner,Blake Cummings,DEM,490121,2,4,61,67,
Mayes,U.S. House,Jason Nichols,DEM,490121,2,9,97,108,02
Mayes,U.S. House,Clay Padgett,DEM,490121,1,5,31,37,02
Mayes,Governor,Mick Cornett,REP,490122,0,0,3,3,
Mayes,Governor,Kevin Stitt,REP,490122,0,0,15,15,
Mayes,Lieutenant Governor,Dana Murphy,REP,490122,0,0,7,7,
Mayes,Lieutenant Governor,Matt Pinnell,REP,490122,0,0,11,11,
Mayes,State Auditor,Cindy Byrd,REP,490122,0,0,5,5,
Mayes,State Auditor,Charlie Prater,REP,490122,0,0,13,13,
Mayes,Attorney General,Mike Hunter,REP,490122,0,0,6,6,
Mayes,Attorney General,Gentner Drummond,REP,490122,0,0,12,12,
Mayes,Superintendent of Public Instruction,Joy Hofmeister,REP,490122,0,0,9,9,
Mayes,Superintendent of Public Instruction,Linda Murphy,REP,490122,0,0,8,8,
Mayes,Commissioner of Labor,Cathy Costello,REP,490122,0,0,6,6,
Mayes,Commissioner of Labor,Leslie Osborn,REP,490122,0,0,11,11,
Mayes,Corporation Commissioner,Bob Anthony,REP,490122,0,0,9,9,
Mayes,Corporation Commissioner,Brian Bingman,REP,490122,0,0,8,8,
Mayes,Governor,Chris Powell,LIB,490122,0,0,0,0,
Mayes,Governor,Rex Lawhorn,LIB,490122,0,0,0,0,
Mayes,Corporation Commissioner,Ashley Nicole Mccray,DEM,490122,0,2,3,5,
Mayes,Corporation Commissioner,Blake Cummings,DEM,490122,0,0,7,7,
Mayes,U.S. House,Jason Nichols,DEM,490122,0,2,3,5,02
Mayes,U.S. House,Clay Padgett,DEM,490122,0,0,7,7,02
Mayes,Governor,Mick Cornett,REP,490130,0,3,30,33,
Mayes,Governor,Kevin Stitt,REP,490130,3,4,69,76,
Mayes,Lieutenant Governor,Dana Murphy,REP,490130,1,2,20,23,
Mayes,Lieutenant Governor,Matt Pinnell,REP,490130,2,4,78,84,
Mayes,State Auditor,Cindy Byrd,REP,490130,1,1,48,50,
Mayes,State Auditor,Charlie Prater,REP,490130,2,5,50,57,
Mayes,Attorney General,Mike Hunter,REP,490130,2,1,38,41,
Mayes,Attorney General,Gentner Drummond,REP,490130,1,6,60,67,
Mayes,Superintendent of Public Instruction,Joy Hofmeister,REP,490130,1,5,58,64,
Mayes,Superintendent of Public Instruction,Linda Murphy,REP,490130,2,2,40,44,
Mayes,Commissioner of Labor,Cathy Costello,REP,490130,3,3,43,49,
Mayes,Commissioner of Labor,Leslie Osborn,REP,490130,0,4,54,58,
Mayes,Corporation Commissioner,Bob Anthony,REP,490130,3,3,32,38,
Mayes,Corporation Commissioner,Brian Bingman,REP,490130,0,4,64,68,
Mayes,Governor,Chris Powell,LIB,490130,0,0,0,0,
Mayes,Governor,Rex Lawhorn,LIB,490130,0,0,0,0,
Mayes,Corporation Commissioner,Ashley Nicole Mccray,DEM,490130,2,1,27,30,
Mayes,Corporation Commissioner,Blake Cummings,DEM,490130,0,5,35,40,
Mayes,U.S. House,Jason Nichols,DEM,490130,2,5,30,37,02
Mayes,U.S. House,Clay Padgett,DEM,490130,1,1,32,34,02
Mayes,Governor,Mick Cornett,REP,490132,2,7,31,40,
Mayes,Governor,Kevin Stitt,REP,490132,5,4,59,68,
Mayes,Lieutenant Governor,Dana Murphy,REP,490132,4,6,24,34,
Mayes,Lieutenant Governor,Matt Pinnell,REP,490132,3,4,67,74,
Mayes,State Auditor,Cindy Byrd,REP,490132,3,8,29,40,
Mayes,State Auditor,Charlie Prater,REP,490132,4,2,58,64,
Mayes,Attorney General,Mike Hunter,REP,490132,3,6,43,52,
Mayes,Attorney General,Gentner Drummond,REP,490132,4,5,47,56,
Mayes,Superintendent of Public Instruction,Joy Hofmeister,REP,490132,2,6,48,56,
Mayes,Superintendent of Public Instruction,Linda Murphy,REP,490132,5,5,43,53,
Mayes,Commissioner of Labor,Cathy Costello,REP,490132,0,5,39,44,
Mayes,Commissioner of Labor,Leslie Osborn,REP,490132,7,5,51,63,
Mayes,Corporation Commissioner,Bob Anthony,REP,490132,5,8,46,59,
Mayes,Corporation Commissioner,Brian Bingman,REP,490132,2,3,42,47,
Mayes,Governor,Chris Powell,LIB,490132,0,0,0,0,
Mayes,Governor,Rex Lawhorn,LIB,490132,0,0,0,0,
Mayes,Corporation Commissioner,Ashley Nicole Mccray,DEM,490132,4,8,57,69,
Mayes,Corporation Commissioner,Blake Cummings,DEM,490132,2,8,59,69,
Mayes,U.S. House,Jason Nichols,DEM,490132,4,12,85,101,02
Mayes,U.S. House,Clay Padgett,DEM,490132,2,4,28,34,02
Mayes,Governor,Mick Cornett,REP,490241,4,10,97,111,
Mayes,Governor,Kevin Stitt,REP,490241,2,10,196,208,
Mayes,Lieutenant Governor,Dana Murphy,REP,490241,5,8,105,118,
Mayes,Lieutenant Governor,Matt Pinnell,REP,490241,1,11,176,188,
Mayes,State Auditor,Cindy Byrd,REP,490241,3,13,119,135,
Mayes,State Auditor,Charlie Prater,REP,490241,3,6,153,162,
Mayes,Attorney General,Mike Hunter,REP,490241,2,8,124,134,
Mayes,Attorney General,Gentner Drummond,REP,490241,4,12,161,177,
Mayes,Superintendent of Public Instruction,Joy Hofmeister,REP,490241,1,10,146,157,
Mayes,Superintendent of Public Instruction,Linda Murphy,REP,490241,5,10,135,150,
Mayes,Commissioner of Labor,Cathy Costello,REP,490241,3,10,124,137,
Mayes,Commissioner of Labor,Leslie Osborn,REP,490241,3,9,148,160,
Mayes,Corporation Commissioner,Bob Anthony,REP,490241,4,14,140,158,
Mayes,Corporation Commissioner,Brian Bingman,REP,490241,2,5,136,143,
Mayes,Governor,Chris Powell,LIB,490241,0,0,0,0,
Mayes,Governor,Rex Lawhorn,LIB,490241,0,0,0,0,
Mayes,Corporation Commissioner,Ashley Nicole Mccray,DEM,490241,5,15,120,140,
Mayes,Corporation Commissioner,Blake Cummings,DEM,490241,6,8,104,118,
Mayes,U.S. House,Jason Nichols,DEM,490241,9,13,165,187,02
Mayes,U.S. House,Clay Padgett,DEM,490241,2,11,58,71,02
Mayes,Governor,Mick Cornett,REP,490242,0,2,71,73,
Mayes,Governor,Kevin Stitt,REP,490242,0,5,93,98,
Mayes,Lieutenant Governor,Dana Murphy,REP,490242,0,3,51,54,
Mayes,Lieutenant Governor,Matt Pinnell,REP,490242,0,3,106,109,
Mayes,State Auditor,Cindy Byrd,REP,490242,0,2,60,62,
Mayes,State Auditor,Charlie Prater,REP,490242,0,4,95,99,
Mayes,Attorney General,Mike Hunter,REP,490242,0,2,61,63,
Mayes,Attorney General,Gentner Drummond,REP,490242,0,5,100,105,
Mayes,Superintendent of Public Instruction,Joy Hofmeister,REP,490242,2,5,97,104,
Mayes,Superintendent of Public Instruction,Linda Murphy,REP,490242,0,2,67,69,
Mayes,Commissioner of Labor,Cathy Costello,REP,490242,2,3,75,80,
Mayes,Commissioner of Labor,Leslie Osborn,REP,490242,0,4,82,86,
Mayes,Corporation Commissioner,Bob Anthony,REP,490242,0,4,66,70,
Mayes,Corporation Commissioner,Brian Bingman,REP,490242,2,3,86,91,
Mayes,Governor,Chris Powell,LIB,490242,0,0,0,0,
Mayes,Governor,Rex Lawhorn,LIB,490242,0,0,0,0,
Mayes,Corporation Commissioner,Ashley Nicole Mccray,DEM,490242,2,5,45,52,
Mayes,Corporation Commissioner,Blake Cummings,DEM,490242,1,2,60,63,
Mayes,U.S. House,Jason Nichols,DEM,490242,3,5,76,84,02
Mayes,U.S. House,Clay Padgett,DEM,490242,0,2,30,32,02
Mayes,Governor,Mick Cornett,REP,490311,0,0,15,15,
Mayes,Governor,Kevin Stitt,REP,490311,2,2,45,49,
Mayes,Lieutenant Governor,Dana Murphy,REP,490311,1,0,14,15,
Mayes,Lieutenant Governor,Matt Pinnell,REP,490311,1,2,45,48,
Mayes,State Auditor,Cindy Byrd,REP,490311,0,0,17,17,
Mayes,State Auditor,Charlie Prater,REP,490311,2,0,40,42,
Mayes,Attorney General,Mike Hunter,REP,490311,1,0,18,19,
Mayes,Attorney General,Gentner Drummond,REP,490311,1,2,42,45,
Mayes,Superintendent of Public Instruction,Joy Hofmeister,REP,490311,0,0,28,28,
Mayes,Superintendent of Public Instruction,Linda Murphy,REP,490311,2,2,32,36,
Mayes,Commissioner of Labor,Cathy Costello,REP,490311,1,2,24,27,
Mayes,Commissioner of Labor,Leslie Osborn,REP,490311,1,0,34,35,
Mayes,Corporation Commissioner,Bob Anthony,REP,490311,1,1,21,23,
Mayes,Corporation Commissioner,Brian Bingman,REP,490311,1,0,37,38,
Mayes,Governor,Chris Powell,LIB,490311,0,0,0,0,
Mayes,Governor,Rex Lawhorn,LIB,490311,0,0,0,0,
Mayes,Corporation Commissioner,Ashley Nicole Mccray,DEM,490311,0,1,14,15,
Mayes,Corporation Commissioner,Blake Cummings,DEM,490311,0,0,8,8,
Mayes,U.S. House,Jason Nichols,DEM,490311,0,1,15,16,02
Mayes,U.S. House,Clay Padgett,DEM,490311,0,0,8,8,02
Murray,Governor,Mick Cornett,REP,500004,4,2,49,55,
Murray,Governor,Kevin Stitt,REP,500004,0,12,79,91,
Murray,Lieutenant Governor,Dana Murphy,REP,500004,3,6,48,57,
Murray,Lieutenant Governor,Matt Pinnell,REP,500004,1,8,77,86,
Murray,State Auditor,Cindy Byrd,REP,500004,3,4,55,62,
Murray,State Auditor,Charlie Prater,REP,500004,1,10,68,79,
Murray,Attorney General,Mike Hunter,REP,500004,1,10,63,74,
Murray,Attorney General,Gentner Drummond,REP,500004,3,3,65,71,
Murray,Superintendent of Public Instruction,Joy Hofmeister,REP,500004,3,11,78,92,
Murray,Superintendent of Public Instruction,Linda Murphy,REP,500004,1,2,49,52,
Murray,Commissioner of Labor,Cathy Costello,REP,500004,0,5,47,52,
Murray,Commissioner of Labor,Leslie Osborn,REP,500004,4,8,77,89,
Murray,Corporation Commissioner,Bob Anthony,REP,500004,3,8,62,73,
Murray,Corporation Commissioner,Brian Bingman,REP,500004,1,5,63,69,
Murray,Governor,Chris Powell,LIB,500004,0,0,0,0,
Murray,Governor,Rex Lawhorn,LIB,500004,0,0,0,0,
Murray,Corporation Commissioner,Ashley Nicole Mccray,DEM,500004,0,3,35,38,
Murray,Corporation Commissioner,Blake Cummings,DEM,500004,0,0,29,29,
Murray,U.S. House,Mary Brannon,DEM,500004,0,2,37,39,04
Murray,U.S. House,Fred Gipson,DEM,500004,0,1,27,28,04
Murray,Governor,Mick Cornett,REP,500005,2,1,47,50,
Murray,Governor,Kevin Stitt,REP,500005,2,0,79,81,
Murray,Lieutenant Governor,Dana Murphy,REP,500005,4,1,39,44,
Murray,Lieutenant Governor,Matt Pinnell,REP,500005,0,0,85,85,
Murray,State Auditor,Cindy Byrd,REP,500005,1,0,47,48,
Murray,State Auditor,Charlie Prater,REP,500005,3,1,71,75,
Murray,Attorney General,Mike Hunter,REP,500005,3,1,56,60,
Murray,Attorney General,Gentner Drummond,REP,500005,1,0,66,67,
Murray,Superintendent of Public Instruction,Joy Hofmeister,REP,500005,3,1,83,87,
Murray,Superintendent of Public Instruction,Linda Murphy,REP,500005,1,0,39,40,
Murray,Commissioner of Labor,Cathy Costello,REP,500005,4,1,53,58,
Murray,Commissioner of Labor,Leslie Osborn,REP,500005,0,0,67,67,
Murray,Corporation Commissioner,Bob Anthony,REP,500005,4,0,51,55,
Murray,Corporation Commissioner,Brian Bingman,REP,500005,0,1,69,70,
Murray,Governor,Chris Powell,LIB,500005,0,0,0,0,
Murray,Governor,Rex Lawhorn,LIB,500005,0,0,0,0,
Murray,Corporation Commissioner,Ashley Nicole Mccray,DEM,500005,1,3,56,60,
Murray,Corporation Commissioner,Blake Cummings,DEM,500005,0,5,42,47,
Murray,U.S. House,Mary Brannon,DEM,500005,0,5,58,63,04
Murray,U.S. House,Fred Gipson,DEM,500005,1,3,38,42,04
Murray,Governor,Mick Cornett,REP,500007,0,0,21,21,
Murray,Governor,Kevin Stitt,REP,500007,0,0,15,15,
Murray,Lieutenant Governor,Dana Murphy,REP,500007,0,0,13,13,
Murray,Lieutenant Governor,Matt Pinnell,REP,500007,0,0,22,22,
Murray,State Auditor,Cindy Byrd,REP,500007,0,0,17,17,
Murray,State Auditor,Charlie Prater,REP,500007,0,0,19,19,
Murray,Attorney General,Mike Hunter,REP,500007,0,0,19,19,
Murray,Attorney General,Gentner Drummond,REP,500007,0,0,17,17,
Murray,Superintendent of Public Instruction,Joy Hofmeister,REP,500007,0,0,15,15,
Murray,Superintendent of Public Instruction,Linda Murphy,REP,500007,0,0,20,20,
Murray,Commissioner of Labor,Cathy Costello,REP,500007,0,0,18,18,
Murray,Commissioner of Labor,Leslie Osborn,REP,500007,0,0,17,17,
Murray,Corporation Commissioner,Bob Anthony,REP,500007,0,0,17,17,
Murray,Corporation Commissioner,Brian Bingman,REP,500007,0,0,19,19,
Murray,Governor,Chris Powell,LIB,500007,0,0,0,0,
Murray,Governor,Rex Lawhorn,LIB,500007,0,0,0,0,
Murray,Corporation Commissioner,Ashley Nicole Mccray,DEM,500007,1,0,14,15,
Murray,Corporation Commissioner,Blake Cummings,DEM,500007,0,0,17,17,
Murray,U.S. House,Mary Brannon,DEM,500007,1,0,13,14,04
Murray,U.S. House,Fred Gipson,DEM,500007,0,0,18,18,04
Murray,Governor,Mick Cornett,REP,500009,0,0,20,20,
Murray,Governor,Kevin Stitt,REP,500009,0,6,17,23,
Murray,Lieutenant Governor,Dana Murphy,REP,500009,0,0,15,15,
Murray,Lieutenant Governor,Matt Pinnell,REP,500009,0,6,22,28,
Murray,State Auditor,Cindy Byrd,REP,500009,0,4,17,21,
Murray,State Auditor,Charlie Prater,REP,500009,0,1,20,21,
Murray,Attorney General,Mike Hunter,REP,500009,0,2,21,23,
Murray,Attorney General,Gentner Drummond,REP,500009,0,4,14,18,
Murray,Superintendent of Public Instruction,Joy Hofmeister,REP,500009,0,2,15,17,
Murray,Superintendent of Public Instruction,Linda Murphy,REP,500009,0,4,20,24,
Murray,Commissioner of Labor,Cathy Costello,REP,500009,0,3,15,18,
Murray,Commissioner of Labor,Leslie Osborn,REP,500009,0,3,18,21,
Murray,Corporation Commissioner,Bob Anthony,REP,500009,0,4,19,23,
Murray,Corporation Commissioner,Brian Bingman,REP,500009,0,2,14,16,
Murray,Governor,Chris Powell,LIB,500009,0,0,0,0,
Murray,Governor,Rex Lawhorn,LIB,500009,0,0,0,0,
Murray,Corporation Commissioner,Ashley Nicole Mccray,DEM,500009,2,2,21,25,
Murray,Corporation Commissioner,Blake Cummings,DEM,500009,0,4,21,25,
Murray,U.S. House,Mary Brannon,DEM,500009,2,4,17,23,04
Murray,U.S. House,Fred Gipson,DEM,500009,0,2,24,26,04
Murray,Governor,Mick Cornett,REP,500012,2,0,26,28,
Murray,Governor,Kevin Stitt,REP,500012,0,0,17,17,
Murray,Lieutenant Governor,Dana Murphy,REP,500012,1,0,18,19,
Murray,Lieutenant Governor,Matt Pinnell,REP,500012,1,0,25,26,
Murray,State Auditor,Cindy Byrd,REP,500012,2,0,19,21,
Murray,State Auditor,Charlie Prater,REP,500012,0,0,24,24,
Murray,Attorney General,Mike Hunter,REP,500012,0,0,20,20,
Murray,Attorney General,Gentner Drummond,REP,500012,2,0,23,25,
Murray,Superintendent of Public Instruction,Joy Hofmeister,REP,500012,2,0,30,32,
Murray,Superintendent of Public Instruction,Linda Murphy,REP,500012,0,0,12,12,
Murray,Commissioner of Labor,Cathy Costello,REP,500012,1,0,16,17,
Murray,Commissioner of Labor,Leslie Osborn,REP,500012,1,0,27,28,
Murray,Corporation Commissioner,Bob Anthony,REP,500012,1,0,18,19,
Murray,Corporation Commissioner,Brian Bingman,REP,500012,1,0,25,26,
Murray,Governor,Chris Powell,LIB,500012,0,0,0,0,
Murray,Governor,Rex Lawhorn,LIB,500012,0,0,0,0,
Murray,Corporation Commissioner,Ashley Nicole Mccray,DEM,500012,0,0,6,6,
Murray,Corporation Commissioner,Blake Cummings,DEM,500012,2,0,13,15,
Murray,U.S. House,Mary Brannon,DEM,500012,0,0,6,6,04
Murray,U.S. House,Fred Gipson,DEM,500012,2,0,13,15,04
Murray,Governor,Mick Cornett,REP,500014,0,0,2,2,
Murray,Governor,Kevin Stitt,REP,500014,0,0,10,10,
Murray,Lieutenant Governor,Dana Murphy,REP,500014,0,0,1,1,
Murray,Lieutenant Governor,Matt Pinnell,REP,500014,0,0,11,11,
Murray,State Auditor,Cindy Byrd,REP,500014,0,0,7,7,
Murray,State Auditor,Charlie Prater,REP,500014,0,0,5,5,
Murray,Attorney General,Mike Hunter,REP,500014,0,0,8,8,
Murray,Attorney General,Gentner Drummond,REP,500014,0,0,4,4,
Murray,Superintendent of Public Instruction,Joy Hofmeister,REP,500014,0,0,8,8,
Murray,Superintendent of Public Instruction,Linda Murphy,REP,500014,0,0,4,4,
Murray,Commissioner of Labor,Cathy Costello,REP,500014,0,0,8,8,
Murray,Commissioner of Labor,Leslie Osborn,REP,500014,0,0,4,4,
Murray,Corporation Commissioner,Bob Anthony,REP,500014,0,0,4,4,
Murray,Corporation Commissioner,Brian Bingman,REP,500014,0,0,8,8,
Murray,Governor,Chris Powell,LIB,500014,0,0,0,0,
Murray,Governor,Rex Lawhorn,LIB,500014,0,0,1,1,
Murray,Corporation Commissioner,Ashley Nicole Mccray,DEM,500014,0,1,9,10,
Murray,Corporation Commissioner,Blake Cummings,DEM,500014,0,0,13,13,
Murray,U.S. House,Mary Brannon,DEM,500014,0,1,9,10,04
Murray,U.S. House,Fred Gipson,DEM,500014,0,0,13,13,04
Murray,Governor,Mick Cornett,REP,500015,2,3,43,48,
Murray,Governor,Kevin Stitt,REP,500015,5,3,54,62,
Murray,Lieutenant Governor,Dana Murphy,REP,500015,4,4,30,38,
Murray,Lieutenant Governor,Matt Pinnell,REP,500015,3,1,65,69,
Murray,State Auditor,Cindy Byrd,REP,500015,3,2,25,30,
Murray,State Auditor,Charlie Prater,REP,500015,4,4,70,78,
Murray,Attorney General,Mike Hunter,REP,500015,6,4,45,55,
Murray,Attorney General,Gentner Drummond,REP,500015,1,2,50,53,
Murray,Superintendent of Public Instruction,Joy Hofmeister,REP,500015,5,5,58,68,
Murray,Superintendent of Public Instruction,Linda Murphy,REP,500015,2,1,36,39,
Murray,Commissioner of Labor,Cathy Costello,REP,500015,3,6,32,41,
Murray,Commissioner of Labor,Leslie Osborn,REP,500015,4,0,60,64,
Murray,Corporation Commissioner,Bob Anthony,REP,500015,5,3,50,58,
Murray,Corporation Commissioner,Brian Bingman,REP,500015,2,3,42,47,
Murray,Governor,Chris Powell,LIB,500015,0,0,0,0,
Murray,Governor,Rex Lawhorn,LIB,500015,0,0,0,0,
Murray,Corporation Commissioner,Ashley Nicole Mccray,DEM,500015,9,9,45,63,
Murray,Corporation Commissioner,Blake Cummings,DEM,500015,2,2,45,49,
Murray,U.S. House,Mary Brannon,DEM,500015,8,11,49,68,04
Murray,U.S. House,Fred Gipson,DEM,500015,3,0,41,44,04
Murray,Governor,Mick Cornett,REP,500017,0,1,6,7,
Murray,Governor,Kevin Stitt,REP,500017,0,0,3,3,
Murray,Lieutenant Governor,Dana Murphy,REP,500017,0,0,4,4,
Murray,Lieutenant Governor,Matt Pinnell,REP,500017,0,1,5,6,
Murray,State Auditor,Cindy Byrd,REP,500017,0,1,3,4,
Murray,State Auditor,Charlie Prater,REP,500017,0,0,6,6,
Murray,Attorney General,Mike Hunter,REP,500017,0,0,4,4,
Murray,Attorney General,Gentner Drummond,REP,500017,0,1,5,6,
Murray,Superintendent of Public Instruction,Joy Hofmeister,REP,500017,0,1,4,5,
Murray,Superintendent of Public Instruction,Linda Murphy,REP,500017,0,0,5,5,
Murray,Commissioner of Labor,Cathy Costello,REP,500017,0,0,2,2,
Murray,Commissioner of Labor,Leslie Osborn,REP,500017,0,1,7,8,
Murray,Corporation Commissioner,Bob Anthony,REP,500017,0,0,5,5,
Murray,Corporation Commissioner,Brian Bingman,REP,500017,0,1,4,5,
Murray,Governor,Chris Powell,LIB,500017,0,0,0,0,
Murray,Governor,Rex Lawhorn,LIB,500017,0,0,0,0,
Murray,Corporation Commissioner,Ashley Nicole Mccray,DEM,500017,0,0,8,8,
Murray,Corporation Commissioner,Blake Cummings,DEM,500017,0,0,7,7,
Murray,U.S. House,Mary Brannon,DEM,500017,0,0,7,7,04
Murray,U.S. House,Fred Gipson,DEM,500017,0,0,8,8,04
Murray,Governor,Mick Cornett,REP,500018,0,2,18,20,
Murray,Governor,Kevin Stitt,REP,500018,1,3,35,39,
Murray,Lieutenant Governor,Dana Murphy,REP,500018,1,3,12,16,
Murray,Lieutenant Governor,Matt Pinnell,REP,500018,0,2,39,41,
Murray,State Auditor,Cindy Byrd,REP,500018,1,1,16,18,
Murray,State Auditor,Charlie Prater,REP,500018,0,4,32,36,
Murray,Attorney General,Mike Hunter,REP,500018,0,4,20,24,
Murray,Attorney General,Gentner Drummond,REP,500018,1,1,32,34,
Murray,Superintendent of Public Instruction,Joy Hofmeister,REP,500018,1,4,29,34,
Murray,Superintendent of Public Instruction,Linda Murphy,REP,500018,0,1,22,23,
Murray,Commissioner of Labor,Cathy Costello,REP,500018,0,3,25,28,
Murray,Commissioner of Labor,Leslie Osborn,REP,500018,1,2,25,28,
Murray,Corporation Commissioner,Bob Anthony,REP,500018,0,2,24,26,
Murray,Corporation Commissioner,Brian Bingman,REP,500018,1,3,27,31,
Murray,Governor,Chris Powell,LIB,500018,0,0,0,0,
Murray,Governor,Rex Lawhorn,LIB,500018,0,0,0,0,
Murray,Corporation Commissioner,Ashley Nicole Mccray,DEM,500018,0,0,21,21,
Murray,Corporation Commissioner,Blake Cummings,DEM,500018,0,0,20,20,
Murray,U.S. House,Mary Brannon,DEM,500018,0,0,18,18,04
Murray,U.S. House,Fred Gipson,DEM,500018,0,0,23,23,04
Murray,Governor,Mick Cornett,REP,500020,0,3,33,36,
Murray,Governor,Kevin Stitt,REP,500020,6,6,36,48,
Murray,Lieutenant Governor,Dana Murphy,REP,500020,1,3,25,29,
Murray,Lieutenant Governor,Matt Pinnell,REP,500020,5,6,42,53,
Murray,State Auditor,Cindy Byrd,REP,500020,2,0,29,31,
Murray,State Auditor,Charlie Prater,REP,500020,4,8,38,50,
Murray,Attorney General,Mike Hunter,REP,500020,1,5,40,46,
Murray,Attorney General,Gentner Drummond,REP,500020,5,4,28,37,
Murray,Superintendent of Public Instruction,Joy Hofmeister,REP,500020,3,8,40,51,
Murray,Superintendent of Public Instruction,Linda Murphy,REP,500020,3,1,27,31,
Murray,Commissioner of Labor,Cathy Costello,REP,500020,3,5,30,38,
Murray,Commissioner of Labor,Leslie Osborn,REP,500020,3,4,36,43,
Murray,Corporation Commissioner,Bob Anthony,REP,500020,1,5,39,45,
Murray,Corporation Commissioner,Brian Bingman,REP,500020,5,3,27,35,
Murray,Governor,Chris Powell,LIB,500020,0,0,0,0,
Murray,Governor,Rex Lawhorn,LIB,500020,0,0,0,0,
Murray,Corporation Commissioner,Ashley Nicole Mccray,DEM,500020,0,8,35,43,
Murray,Corporation Commissioner,Blake Cummings,DEM,500020,3,0,32,35,
Murray,U.S. House,Mary Brannon,DEM,500020,0,6,38,44,04
Murray,U.S. House,Fred Gipson,DEM,500020,3,2,28,33,04
Muskogee,Governor,Mick Cornett,REP,510005,1,5,36,42,
Muskogee,Governor,Kevin Stitt,REP,510005,2,4,87,93,
Muskogee,Lieutenant Governor,Dana Murphy,REP,510005,2,5,54,61,
Muskogee,Lieutenant Governor,Matt Pinnell,REP,510005,1,4,66,71,
Muskogee,State Auditor,Cindy Byrd,REP,510005,2,5,55,62,
Muskogee,State Auditor,Charlie Prater,REP,510005,1,4,65,70,
Muskogee,Attorney General,Mike Hunter,REP,510005,1,4,58,63,
Muskogee,Attorney General,Gentner Drummond,REP,510005,2,4,61,67,
Muskogee,Superintendent of Public Instruction,Joy Hofmeister,REP,510005,2,5,65,72,
Muskogee,Superintendent of Public Instruction,Linda Murphy,REP,510005,1,4,54,59,
Muskogee,Commissioner of Labor,Cathy Costello,REP,510005,1,5,44,50,
Muskogee,Commissioner of Labor,Leslie Osborn,REP,510005,2,4,73,79,
Muskogee,Corporation Commissioner,Bob Anthony,REP,510005,1,5,51,57,
Muskogee,Corporation Commissioner,Brian Bingman,REP,510005,2,4,69,75,
Muskogee,State House,George Faught,REP,510005,2,8,53,63,14
Muskogee,State House,Chris Sneed,REP,510005,1,1,71,73,14
Muskogee,Governor,Chris Powell,LIB,510005,0,0,1,1,
Muskogee,Governor,Rex Lawhorn,LIB,510005,0,0,0,0,
Muskogee,Corporation Commissioner,Ashley Nicole Mccray,DEM,510005,3,8,92,103,
Muskogee,Corporation Commissioner,Blake Cummings,DEM,510005,0,6,45,51,
Muskogee,U.S. House,Jason Nichols,DEM,510005,3,10,89,102,02
Muskogee,U.S. House,Clay Padgett,DEM,510005,0,4,48,52,02
Muskogee,Governor,Mick Cornett,REP,510007,2,13,89,104,
Muskogee,Governor,Kevin Stitt,REP,510007,2,11,174,187,
Muskogee,Lieutenant Governor,Dana Murphy,REP,510007,2,8,111,121,
Muskogee,Lieutenant Governor,Matt Pinnell,REP,510007,2,15,143,160,
Muskogee,State Auditor,Cindy Byrd,REP,510007,3,10,149,162,
Muskogee,State Auditor,Charlie Prater,REP,510007,0,13,96,109,
Muskogee,Attorney General,Mike Hunter,REP,510007,2,10,102,114,
Muskogee,Attorney General,Gentner Drummond,REP,510007,2,14,151,167,
Muskogee,Superintendent of Public Instruction,Joy Hofmeister,REP,510007,1,15,134,150,
Muskogee,Superintendent of Public Instruction,Linda Murphy,REP,510007,2,9,118,129,
Muskogee,Commissioner of Labor,Cathy Costello,REP,510007,1,11,127,139,
Muskogee,Commissioner of Labor,Leslie Osborn,REP,510007,2,13,123,138,
Muskogee,Corporation Commissioner,Bob Anthony,REP,510007,0,11,139,150,
Muskogee,Corporation Commissioner,Brian Bingman,REP,510007,3,13,112,128,
Muskogee,State House,George Faught,REP,510007,1,19,139,159,14
Muskogee,State House,Chris Sneed,REP,510007,3,5,123,131,14
Muskogee,Governor,Chris Powell,LIB,510007,0,0,0,0,
Muskogee,Governor,Rex Lawhorn,LIB,510007,0,0,0,0,
Muskogee,Corporation Commissioner,Ashley Nicole Mccray,DEM,510007,7,7,123,137,
Muskogee,Corporation Commissioner,Blake Cummings,DEM,510007,5,8,96,109,
Muskogee,U.S. House,Jason Nichols,DEM,510007,8,7,137,152,02
Muskogee,U.S. House,Clay Padgett,DEM,510007,4,8,84,96,02
Muskogee,Governor,Mick Cornett,REP,510009,2,11,104,117,
Muskogee,Governor,Kevin Stitt,REP,510009,3,17,194,214,
Muskogee,Lieutenant Governor,Dana Murphy,REP,510009,2,7,101,110,
Muskogee,Lieutenant Governor,Matt Pinnell,REP,510009,3,21,193,217,
Muskogee,State Auditor,Cindy Byrd,REP,510009,2,11,170,183,
Muskogee,State Auditor,Charlie Prater,REP,510009,1,15,121,137,
Muskogee,Attorney General,Mike Hunter,REP,510009,0,10,133,143,
Muskogee,Attorney General,Gentner Drummond,REP,510009,5,18,163,186,
Muskogee,Superintendent of Public Instruction,Joy Hofmeister,REP,510009,4,21,167,192,
Muskogee,Superintendent of Public Instruction,Linda Murphy,REP,510009,1,6,130,137,
Muskogee,Commissioner of Labor,Cathy Costello,REP,510009,1,15,154,170,
Muskogee,Commissioner of Labor,Leslie Osborn,REP,510009,1,12,139,152,
Muskogee,Corporation Commissioner,Bob Anthony,REP,510009,3,14,141,158,
Muskogee,Corporation Commissioner,Brian Bingman,REP,510009,1,14,151,166,
Muskogee,State House,George Faught,REP,510009,5,15,149,169,14
Muskogee,State House,Chris Sneed,REP,510009,0,13,151,164,14
Muskogee,Governor,Chris Powell,LIB,510009,0,0,0,0,
Muskogee,Governor,Rex Lawhorn,LIB,510009,0,0,1,1,
Muskogee,Corporation Commissioner,Ashley Nicole Mccray,DEM,510009,6,4,111,121,
Muskogee,Corporation Commissioner,Blake Cummings,DEM,510009,0,6,88,94,
Muskogee,U.S. House,Jason Nichols,DEM,510009,1,7,119,127,02
Muskogee,U.S. House,Clay Padgett,DEM,510009,5,3,80,88,02
Muskogee,Governor,Mick Cornett,REP,510011,1,0,17,18,
Muskogee,Governor,Kevin Stitt,REP,510011,0,1,43,44,
Muskogee,Lieutenant Governor,Dana Murphy,REP,510011,1,0,24,25,
Muskogee,Lieutenant Governor,Matt Pinnell,REP,510011,0,1,36,37,
Muskogee,State Auditor,Cindy Byrd,REP,510011,0,0,32,32,
Muskogee,State Auditor,Charlie Prater,REP,510011,1,1,26,28,
Muskogee,Attorney General,Mike Hunter,REP,510011,0,0,33,33,
Muskogee,Attorney General,Gentner Drummond,REP,510011,1,1,27,29,
Muskogee,Superintendent of Public Instruction,Joy Hofmeister,REP,510011,1,1,31,33,
Muskogee,Superintendent of Public Instruction,Linda Murphy,REP,510011,0,0,28,28,
Muskogee,Commissioner of Labor,Cathy Costello,REP,510011,0,0,23,23,
Muskogee,Commissioner of Labor,Leslie Osborn,REP,510011,1,1,36,38,
Muskogee,Corporation Commissioner,Bob Anthony,REP,510011,1,1,30,32,
Muskogee,Corporation Commissioner,Brian Bingman,REP,510011,0,0,28,28,
Muskogee,State House,George Faught,REP,510011,0,1,24,25,14
Muskogee,State House,Chris Sneed,REP,510011,1,0,36,37,14
Muskogee,Governor,Chris Powell,LIB,510011,0,0,0,0,
Muskogee,Governor,Rex Lawhorn,LIB,510011,0,0,0,0,
Muskogee,Corporation Commissioner,Ashley Nicole Mccray,DEM,510011,0,2,24,26,
Muskogee,Corporation Commissioner,Blake Cummings,DEM,510011,0,0,33,33,
Muskogee,U.S. House,Jason Nichols,DEM,510011,0,2,32,34,02
Muskogee,U.S. House,Clay Padgett,DEM,510011,0,0,25,25,02
Muskogee,Governor,Mick Cornett,REP,510013,0,2,41,43,
Muskogee,Governor,Kevin Stitt,REP,510013,4,4,87,95,
Muskogee,Lieutenant Governor,Dana Murphy,REP,510013,2,4,47,53,
Muskogee,Lieutenant Governor,Matt Pinnell,REP,510013,2,4,79,85,
Muskogee,State Auditor,Cindy Byrd,REP,510013,1,5,47,53,
Muskogee,State Auditor,Charlie Prater,REP,510013,3,2,77,82,
Muskogee,Attorney General,Mike Hunter,REP,510013,3,4,46,53,
Muskogee,Attorney General,Gentner Drummond,REP,510013,1,4,80,85,
Muskogee,Superintendent of Public Instruction,Joy Hofmeister,REP,510013,2,6,69,77,
Muskogee,Superintendent of Public Instruction,Linda Murphy,REP,510013,2,2,56,60,
Muskogee,Commissioner of Labor,Cathy Costello,REP,510013,3,6,60,69,
Muskogee,Commissioner of Labor,Leslie Osborn,REP,510013,1,1,65,67,
Muskogee,Corporation Commissioner,Bob Anthony,REP,510013,3,5,59,67,
Muskogee,Corporation Commissioner,Brian Bingman,REP,510013,1,3,65,69,
Muskogee,State House,George Faught,REP,510013,4,4,69,77,14
Muskogee,State House,Chris Sneed,REP,510013,0,2,61,63,14
Muskogee,Governor,Chris Powell,LIB,510013,0,0,0,0,
Muskogee,Governor,Rex Lawhorn,LIB,510013,0,0,0,0,
Muskogee,Corporation Commissioner,Ashley Nicole Mccray,DEM,510013,0,4,79,83,
Muskogee,Corporation Commissioner,Blake Cummings,DEM,510013,3,1,41,45,
Muskogee,U.S. House,Jason Nichols,DEM,510013,2,5,74,81,02
Muskogee,U.S. House,Clay Padgett,DEM,510013,1,0,46,47,02
Muskogee,Governor,Mick Cornett,REP,510017,0,1,6,7,
Muskogee,Governor,Kevin Stitt,REP,510017,0,0,20,20,
Muskogee,Lieutenant Governor,Dana Murphy,REP,510017,0,1,11,12,
Muskogee,Lieutenant Governor,Matt Pinnell,REP,510017,0,0,15,15,
Muskogee,State Auditor,Cindy Byrd,REP,510017,0,1,13,14,
Muskogee,State Auditor,Charlie Prater,REP,510017,0,0,13,13,
Muskogee,Attorney General,Mike Hunter,REP,510017,0,1,5,6,
Muskogee,Attorney General,Gentner Drummond,REP,510017,0,0,21,21,
Muskogee,Superintendent of Public Instruction,Joy Hofmeister,REP,510017,0,1,13,14,
Muskogee,Superintendent of Public Instruction,Linda Murphy,REP,510017,0,0,13,13,
Muskogee,Commissioner of Labor,Cathy Costello,REP,510017,0,1,16,17,
Muskogee,Commissioner of Labor,Leslie Osborn,REP,510017,0,0,9,9,
Muskogee,Corporation Commissioner,Bob Anthony,REP,510017,0,1,13,14,
Muskogee,Corporation Commissioner,Brian Bingman,REP,510017,0,0,13,13,
Muskogee,Governor,Chris Powell,LIB,510017,0,0,0,0,
Muskogee,Governor,Rex Lawhorn,LIB,510017,0,0,0,0,
Muskogee,Corporation Commissioner,Ashley Nicole Mccray,DEM,510017,0,3,29,32,
Muskogee,Corporation Commissioner,Blake Cummings,DEM,510017,0,0,20,20,
Muskogee,U.S. House,Jason Nichols,DEM,510017,0,1,29,30,02
Muskogee,U.S. House,Clay Padgett,DEM,510017,0,2,20,22,02
Muskogee,Governor,Mick Cornett,REP,510021,2,1,24,27,
Muskogee,Governor,Kevin Stitt,REP,510021,1,4,40,45,
Muskogee,Lieutenant Governor,Dana Murphy,REP,510021,2,1,31,34,
Muskogee,Lieutenant Governor,Matt Pinnell,REP,510021,1,4,32,37,
Muskogee,State Auditor,Cindy Byrd,REP,510021,0,2,29,31,
Muskogee,State Auditor,Charlie Prater,REP,510021,3,3,31,37,
Muskogee,Attorney General,Mike Hunter,REP,510021,2,2,25,29,
Muskogee,Attorney General,Gentner Drummond,REP,510021,1,3,38,42,
Muskogee,Superintendent of Public Instruction,Joy Hofmeister,REP,510021,1,4,33,38,
Muskogee,Superintendent of Public Instruction,Linda Murphy,REP,510021,2,1,30,33,
Muskogee,Commissioner of Labor,Cathy Costello,REP,510021,1,3,28,32,
Muskogee,Commissioner of Labor,Leslie Osborn,REP,510021,2,2,34,38,
Muskogee,Corporation Commissioner,Bob Anthony,REP,510021,1,4,34,39,
Muskogee,Corporation Commissioner,Brian Bingman,REP,510021,2,1,28,31,
Muskogee,Governor,Chris Powell,LIB,510021,0,0,0,0,
Muskogee,Governor,Rex Lawhorn,LIB,510021,0,0,0,0,
Muskogee,Corporation Commissioner,Ashley Nicole Mccray,DEM,510021,4,6,56,66,
Muskogee,Corporation Commissioner,Blake Cummings,DEM,510021,0,4,27,31,
Muskogee,U.S. House,Jason Nichols,DEM,510021,2,7,51,60,02
Muskogee,U.S. House,Clay Padgett,DEM,510021,3,3,32,38,02
Muskogee,Governor,Mick Cornett,REP,510022,4,7,53,64,
Muskogee,Governor,Kevin Stitt,REP,510022,2,5,98,105,
Muskogee,Lieutenant Governor,Dana Murphy,REP,510022,2,4,58,64,
Muskogee,Lieutenant Governor,Matt Pinnell,REP,510022,4,8,92,104,
Muskogee,State Auditor,Cindy Byrd,REP,510022,2,6,67,75,
Muskogee,State Auditor,Charlie Prater,REP,510022,4,6,81,91,
Muskogee,Attorney General,Mike Hunter,REP,510022,4,9,51,64,
Muskogee,Attorney General,Gentner Drummond,REP,510022,2,3,99,104,
Muskogee,Superintendent of Public Instruction,Joy Hofmeister,REP,510022,4,7,79,90,
Muskogee,Superintendent of Public Instruction,Linda Murphy,REP,510022,2,5,71,78,
Muskogee,Commissioner of Labor,Cathy Costello,REP,510022,3,3,73,79,
Muskogee,Commissioner of Labor,Leslie Osborn,REP,510022,3,8,76,87,
Muskogee,Corporation Commissioner,Bob Anthony,REP,510022,3,6,94,103,
Muskogee,Corporation Commissioner,Brian Bingman,REP,510022,3,6,55,64,
Muskogee,Governor,Chris Powell,LIB,510022,0,0,0,0,
Muskogee,Governor,Rex Lawhorn,LIB,510022,0,0,0,0,
Muskogee,Corporation Commissioner,Ashley Nicole Mccray,DEM,510022,6,3,67,76,
Muskogee,Corporation Commissioner,Blake Cummings,DEM,510022,2,6,51,59,
Muskogee,U.S. House,Jason Nichols,DEM,510022,4,5,70,79,02
Muskogee,U.S. House,Clay Padgett,DEM,510022,5,4,49,58,02
Muskogee,Governor,Mick Cornett,REP,510023,2,1,13,16,
Muskogee,Governor,Kevin Stitt,REP,510023,0,7,12,19,
Muskogee,Lieutenant Governor,Dana Murphy,REP,510023,1,2,14,17,
Muskogee,Lieutenant Governor,Matt Pinnell,REP,510023,1,6,12,19,
Muskogee,State Auditor,Cindy Byrd,REP,510023,1,4,11,16,
Muskogee,State Auditor,Charlie Prater,REP,510023,1,4,14,19,
Muskogee,Attorney General,Mike Hunter,REP,510023,1,3,15,19,
Muskogee,Attorney General,Gentner Drummond,REP,510023,1,5,10,16,
Muskogee,Superintendent of Public Instruction,Joy Hofmeister,REP,510023,1,7,18,26,
Muskogee,Superintendent of Public Instruction,Linda Murphy,REP,510023,1,1,7,9,
Muskogee,Commissioner of Labor,Cathy Costello,REP,510023,0,5,12,17,
Muskogee,Commissioner of Labor,Leslie Osborn,REP,510023,2,3,14,19,
Muskogee,Corporation Commissioner,Bob Anthony,REP,510023,1,3,14,18,
Muskogee,Corporation Commissioner,Brian Bingman,REP,510023,1,5,11,17,
Muskogee,Governor,Chris Powell,LIB,510023,0,0,0,0,
Muskogee,Governor,Rex Lawhorn,LIB,510023,0,0,0,0,
Muskogee,Corporation Commissioner,Ashley Nicole Mccray,DEM,510023,6,6,77,89,
Muskogee,Corporation Commissioner,Blake Cummings,DEM,510023,1,5,31,37,
Muskogee,U.S. House,Jason Nichols,DEM,510023,6,4,67,77,02
Muskogee,U.S. House,Clay Padgett,DEM,510023,1,7,42,50,02
Muskogee,Governor,Mick Cornett,REP,510028,1,3,15,19,
Muskogee,Governor,Kevin Stitt,REP,510028,0,1,34,35,
Muskogee,Lieutenant Governor,Dana Murphy,REP,510028,1,2,17,20,
Muskogee,Lieutenant Governor,Matt Pinnell,REP,510028,0,2,31,33,
Muskogee,State Auditor,Cindy Byrd,REP,510028,1,3,24,28,
Muskogee,State Auditor,Charlie Prater,REP,510028,0,1,22,23,
Muskogee,Attorney General,Mike Hunter,REP,510028,1,1,19,21,
Muskogee,Attorney General,Gentner Drummond,REP,510028,0,3,28,31,
Muskogee,Superintendent of Public Instruction,Joy Hofmeister,REP,510028,0,3,28,31,
Muskogee,Superintendent of Public Instruction,Linda Murphy,REP,510028,1,1,20,22,
Muskogee,Commissioner of Labor,Cathy Costello,REP,510028,0,2,21,23,
Muskogee,Commissioner of Labor,Leslie Osborn,REP,510028,1,2,27,30,
Muskogee,Corporation Commissioner,Bob Anthony,REP,510028,0,4,26,30,
Muskogee,Corporation Commissioner,Brian Bingman,REP,510028,1,0,22,23,
Muskogee,Governor,Chris Powell,LIB,510028,0,0,0,0,
Muskogee,Governor,Rex Lawhorn,LIB,510028,0,0,0,0,
Muskogee,Corporation Commissioner,Ashley Nicole Mccray,DEM,510028,1,5,25,31,
Muskogee,Corporation Commissioner,Blake Cummings,DEM,510028,2,0,26,28,
Muskogee,U.S. House,Jason Nichols,DEM,510028,1,5,34,40,02
Muskogee,U.S. House,Clay Padgett,DEM,510028,2,0,17,19,02
Muskogee,Governor,Mick Cornett,REP,510033,2,0,35,37,
Muskogee,Governor,Kevin Stitt,REP,510033,2,0,141,143,
Muskogee,Lieutenant Governor,Dana Murphy,REP,510033,2,0,61,63,
Muskogee,Lieutenant Governor,Matt Pinnell,REP,510033,1,0,110,111,
Muskogee,State Auditor,Cindy Byrd,REP,510033,2,0,84,86,
Muskogee,State Auditor,Charlie Prater,REP,510033,1,0,84,85,
Muskogee,Attorney General,Mike Hunter,REP,510033,1,0,69,70,
Muskogee,Attorney General,Gentner Drummond,REP,510033,2,0,104,106,
Muskogee,Superintendent of Public Instruction,Joy Hofmeister,REP,510033,3,0,73,76,
Muskogee,Superintendent of Public Instruction,Linda Murphy,REP,510033,1,0,101,102,
Muskogee,Commissioner of Labor,Cathy Costello,REP,510033,3,0,91,94,
Muskogee,Commissioner of Labor,Leslie Osborn,REP,510033,1,0,80,81,
Muskogee,Corporation Commissioner,Bob Anthony,REP,510033,3,0,83,86,
Muskogee,Corporation Commissioner,Brian Bingman,REP,510033,1,0,88,89,
Muskogee,Governor,Chris Powell,LIB,510033,0,0,0,0,
Muskogee,Governor,Rex Lawhorn,LIB,510033,0,0,0,0,
Muskogee,Corporation Commissioner,Ashley Nicole Mccray,DEM,510033,1,2,35,38,
Muskogee,Corporation Commissioner,Blake Cummings,DEM,510033,0,0,35,35,
Muskogee,U.S. House,Jason Nichols,DEM,510033,1,0,44,45,02
Muskogee,U.S. House,Clay Padgett,DEM,510033,0,2,26,28,02
Muskogee,Governor,Mick Cornett,REP,510036,0,0,2,2,
Muskogee,Governor,Kevin Stitt,REP,510036,1,0,8,9,
Muskogee,Lieutenant Governor,Dana Murphy,REP,510036,0,0,3,3,
Muskogee,Lieutenant Governor,Matt Pinnell,REP,510036,1,0,7,8,
Muskogee,State Auditor,Cindy Byrd,REP,510036,1,0,4,5,
Muskogee,State Auditor,Charlie Prater,REP,510036,0,0,6,6,
Muskogee,Attorney General,Mike Hunter,REP,510036,0,0,7,7,
Muskogee,Attorney General,Gentner Drummond,REP,510036,1,0,3,4,
Muskogee,Superintendent of Public Instruction,Joy Hofmeister,REP,510036,1,0,7,8,
Muskogee,Superintendent of Public Instruction,Linda Murphy,REP,510036,0,0,3,3,
Muskogee,Commissioner of Labor,Cathy Costello,REP,510036,1,0,2,3,
Muskogee,Commissioner of Labor,Leslie Osborn,REP,510036,0,0,8,8,
Muskogee,Corporation Commissioner,Bob Anthony,REP,510036,1,0,6,7,
Muskogee,Corporation Commissioner,Brian Bingman,REP,510036,0,0,4,4,
Muskogee,Governor,Chris Powell,LIB,510036,0,0,0,0,
Muskogee,Governor,Rex Lawhorn,LIB,510036,0,0,0,0,
Muskogee,Corporation Commissioner,Ashley Nicole Mccray,DEM,510036,0,0,30,30,
Muskogee,Corporation Commissioner,Blake Cummings,DEM,510036,0,2,9,11,
Muskogee,U.S. House,Jason Nichols,DEM,510036,0,2,27,29,02
Muskogee,U.S. House,Clay Padgett,DEM,510036,0,0,11,11,02
Muskogee,Governor,Mick Cornett,REP,510037,0,2,34,36,
Muskogee,Governor,Kevin Stitt,REP,510037,0,1,65,66,
Muskogee,Lieutenant Governor,Dana Murphy,REP,510037,0,3,31,34,
Muskogee,Lieutenant Governor,Matt Pinnell,REP,510037,0,0,67,67,
Muskogee,State Auditor,Cindy Byrd,REP,510037,0,3,49,52,
Muskogee,State Auditor,Charlie Prater,REP,510037,0,0,49,49,
Muskogee,Attorney General,Mike Hunter,REP,510037,0,3,42,45,
Muskogee,Attorney General,Gentner Drummond,REP,510037,0,0,57,57,
Muskogee,Superintendent of Public Instruction,Joy Hofmeister,REP,510037,0,0,53,53,
Muskogee,Superintendent of Public Instruction,Linda Murphy,REP,510037,0,3,44,47,
Muskogee,Commissioner of Labor,Cathy Costello,REP,510037,0,3,50,53,
Muskogee,Commissioner of Labor,Leslie Osborn,REP,510037,0,0,45,45,
Muskogee,Corporation Commissioner,Bob Anthony,REP,510037,0,2,42,44,
Muskogee,Corporation Commissioner,Brian Bingman,REP,510037,0,1,54,55,
Muskogee,Governor,Chris Powell,LIB,510037,0,0,0,0,
Muskogee,Governor,Rex Lawhorn,LIB,510037,0,0,1,1,
Muskogee,Corporation Commissioner,Ashley Nicole Mccray,DEM,510037,0,4,53,57,
Muskogee,Corporation Commissioner,Blake Cummings,DEM,510037,0,1,44,45,
Muskogee,U.S. House,Jason Nichols,DEM,510037,0,3,54,57,02
Muskogee,U.S. House,Clay Padgett,DEM,510037,0,2,41,43,02
Muskogee,Governor,Mick Cornett,REP,510038,0,9,80,89,
Muskogee,Governor,Kevin Stitt,REP,510038,3,12,157,172,
Muskogee,Lieutenant Governor,Dana Murphy,REP,510038,0,8,95,103,
Muskogee,Lieutenant Governor,Matt Pinnell,REP,510038,3,9,135,147,
Muskogee,State Auditor,Cindy Byrd,REP,510038,3,11,127,141,
Muskogee,State Auditor,Charlie Prater,REP,510038,0,6,95,101,
Muskogee,Attorney General,Mike Hunter,REP,510038,3,11,125,139,
Muskogee,Attorney General,Gentner Drummond,REP,510038,0,10,111,121,
Muskogee,Superintendent of Public Instruction,Joy Hofmeister,REP,510038,0,11,146,157,
Muskogee,Superintendent of Public Instruction,Linda Murphy,REP,510038,3,7,87,97,
Muskogee,Commissioner of Labor,Cathy Costello,REP,510038,3,13,125,141,
Muskogee,Commissioner of Labor,Leslie Osborn,REP,510038,0,5,103,108,
Muskogee,Corporation Commissioner,Bob Anthony,REP,510038,3,14,130,147,
Muskogee,Corporation Commissioner,Brian Bingman,REP,510038,0,5,100,105,
Muskogee,State House,George Faught,REP,510038,3,10,135,148,14
Muskogee,State House,Chris Sneed,REP,510038,0,11,103,114,14
Muskogee,Governor,Chris Powell,LIB,510038,0,0,0,0,
Muskogee,Governor,Rex Lawhorn,LIB,510038,0,0,0,0,
Muskogee,Corporation Commissioner,Ashley Nicole Mccray,DEM,510038,3,5,86,94,
Muskogee,Corporation Commissioner,Blake Cummings,DEM,510038,1,10,64,75,
Muskogee,U.S. House,Jason Nichols,DEM,510038,2,10,92,104,02
Muskogee,U.S. House,Clay Padgett,DEM,510038,2,7,58,67,02
Muskogee,Governor,Mick Cornett,REP,510040,0,0,36,36,
Muskogee,Governor,Kevin Stitt,REP,510040,0,3,60,63,
Muskogee,Lieutenant Governor,Dana Murphy,REP,510040,0,2,28,30,
Muskogee,Lieutenant Governor,Matt Pinnell,REP,510040,0,1,66,67,
Muskogee,State Auditor,Cindy Byrd,REP,510040,0,1,44,45,
Muskogee,State Auditor,Charlie Prater,REP,510040,0,2,50,52,
Muskogee,Attorney General,Mike Hunter,REP,510040,0,2,28,30,
Muskogee,Attorney General,Gentner Drummond,REP,510040,0,1,68,69,
Muskogee,Superintendent of Public Instruction,Joy Hofmeister,REP,510040,0,1,59,60,
Muskogee,Superintendent of Public Instruction,Linda Murphy,REP,510040,0,2,36,38,
Muskogee,Commissioner of Labor,Cathy Costello,REP,510040,0,2,38,40,
Muskogee,Commissioner of Labor,Leslie Osborn,REP,510040,0,0,56,56,
Muskogee,Corporation Commissioner,Bob Anthony,REP,510040,0,3,45,48,
Muskogee,Corporation Commissioner,Brian Bingman,REP,510040,0,0,48,48,
Muskogee,State House,George Faught,REP,510040,0,1,29,30,14
Muskogee,State House,Chris Sneed,REP,510040,0,2,68,70,14
Muskogee,Governor,Chris Powell,LIB,510040,0,0,0,0,
Muskogee,Governor,Rex Lawhorn,LIB,510040,0,0,0,0,
Muskogee,Corporation Commissioner,Ashley Nicole Mccray,DEM,510040,1,0,17,18,
Muskogee,Corporation Commissioner,Blake Cummings,DEM,510040,1,0,8,9,
Muskogee,U.S. House,Jason Nichols,DEM,510040,2,0,17,19,02
Muskogee,U.S. House,Clay Padgett,DEM,510040,0,0,8,8,02
Muskogee,Governor,Mick Cornett,REP,510041,4,11,132,147,
Muskogee,Governor,Kevin Stitt,REP,510041,10,13,216,239,
Muskogee,Lieutenant Governor,Dana Murphy,REP,510041,4,11,123,138,
Muskogee,Lieutenant Governor,Matt Pinnell,REP,510041,9,13,218,240,
Muskogee,State Auditor,Cindy Byrd,REP,510041,5,14,167,186,
Muskogee,State Auditor,Charlie Prater,REP,510041,9,8,164,181,
Muskogee,Attorney General,Mike Hunter,REP,510041,3,12,144,159,
Muskogee,Attorney General,Gentner Drummond,REP,510041,11,12,197,220,
Muskogee,Superintendent of Public Instruction,Joy Hofmeister,REP,510041,9,15,197,221,
Muskogee,Superintendent of Public Instruction,Linda Murphy,REP,510041,5,7,146,158,
Muskogee,Commissioner of Labor,Cathy Costello,REP,510041,6,12,165,183,
Muskogee,Commissioner of Labor,Leslie Osborn,REP,510041,7,11,169,187,
Muskogee,Corporation Commissioner,Bob Anthony,REP,510041,11,13,183,207,
Muskogee,Corporation Commissioner,Brian Bingman,REP,510041,3,10,151,164,
Muskogee,State House,George Faught,REP,510041,5,9,117,131,14
Muskogee,State House,Chris Sneed,REP,510041,9,15,232,256,14
Muskogee,Governor,Chris Powell,LIB,510041,0,0,0,0,
Muskogee,Governor,Rex Lawhorn,LIB,510041,0,0,0,0,
Muskogee,Corporation Commissioner,Ashley Nicole Mccray,DEM,510041,3,7,101,111,
Muskogee,Corporation Commissioner,Blake Cummings,DEM,510041,0,7,96,103,
Muskogee,U.S. House,Jason Nichols,DEM,510041,3,11,141,155,02
Muskogee,U.S. House,Clay Padgett,DEM,510041,0,4,58,62,02
Muskogee,Governor,Mick Cornett,REP,510044,0,2,18,20,
Muskogee,Governor,Kevin Stitt,REP,510044,0,1,41,42,
Muskogee,Lieutenant Governor,Dana Murphy,REP,510044,0,1,12,13,
Muskogee,Lieutenant Governor,Matt Pinnell,REP,510044,0,1,45,46,
Muskogee,State Auditor,Cindy Byrd,REP,510044,0,2,16,18,
Muskogee,State Auditor,Charlie Prater,REP,510044,0,0,39,39,
Muskogee,Attorney General,Mike Hunter,REP,510044,0,2,18,20,
Muskogee,Attorney General,Gentner Drummond,REP,510044,0,1,39,40,
Muskogee,Superintendent of Public Instruction,Joy Hofmeister,REP,510044,0,3,19,22,
Muskogee,Superintendent of Public Instruction,Linda Murphy,REP,510044,0,0,36,36,
Muskogee,Commissioner of Labor,Cathy Costello,REP,510044,0,2,26,28,
Muskogee,Commissioner of Labor,Leslie Osborn,REP,510044,0,0,28,28,
Muskogee,Corporation Commissioner,Bob Anthony,REP,510044,0,2,27,29,
Muskogee,Corporation Commissioner,Brian Bingman,REP,510044,0,1,31,32,
Muskogee,State House,George Faught,REP,510044,0,1,33,34,14
Muskogee,State House,Chris Sneed,REP,510044,0,2,25,27,14
Muskogee,Governor,Chris Powell,LIB,510044,0,0,0,0,
Muskogee,Governor,Rex Lawhorn,LIB,510044,0,0,0,0,
Muskogee,Corporation Commissioner,Ashley Nicole Mccray,DEM,510044,0,1,25,26,
Muskogee,Corporation Commissioner,Blake Cummings,DEM,510044,0,0,53,53,
Muskogee,U.S. House,Jason Nichols,DEM,510044,0,1,46,47,02
Muskogee,U.S. House,Clay Padgett,DEM,510044,0,0,33,33,02
Muskogee,Governor,Mick Cornett,REP,510045,4,3,36,43,
Muskogee,Governor,Kevin Stitt,REP,510045,0,0,66,66,
Muskogee,Lieutenant Governor,Dana Murphy,REP,510045,1,1,38,40,
Muskogee,Lieutenant Governor,Matt Pinnell,REP,510045,3,2,62,67,
Muskogee,State Auditor,Cindy Byrd,REP,510045,1,0,39,40,
Muskogee,State Auditor,Charlie Prater,REP,510045,3,3,55,61,
Muskogee,Attorney General,Mike Hunter,REP,510045,2,2,39,43,
Muskogee,Attorney General,Gentner Drummond,REP,510045,2,1,59,62,
Muskogee,Superintendent of Public Instruction,Joy Hofmeister,REP,510045,2,0,40,42,
Muskogee,Superintendent of Public Instruction,Linda Murphy,REP,510045,2,3,55,60,
Muskogee,Commissioner of Labor,Cathy Costello,REP,510045,0,0,35,35,
Muskogee,Commissioner of Labor,Leslie Osborn,REP,510045,2,3,55,60,
Muskogee,Corporation Commissioner,Bob Anthony,REP,510045,0,0,50,50,
Muskogee,Corporation Commissioner,Brian Bingman,REP,510045,4,3,43,50,
Muskogee,State House,George Faught,REP,510045,2,2,58,62,14
Muskogee,State House,Chris Sneed,REP,510045,2,1,43,46,14
Muskogee,Governor,Chris Powell,LIB,510045,0,0,0,0,
Muskogee,Governor,Rex Lawhorn,LIB,510045,0,0,0,0,
Muskogee,Corporation Commissioner,Ashley Nicole Mccray,DEM,510045,0,1,46,47,
Muskogee,Corporation Commissioner,Blake Cummings,DEM,510045,0,2,34,36,
Muskogee,U.S. House,Jason Nichols,DEM,510045,0,0,44,44,02
Muskogee,U.S. House,Clay Padgett,DEM,510045,0,3,38,41,02
Muskogee,Governor,Mick Cornett,REP,510046,0,8,60,68,
Muskogee,Governor,Kevin Stitt,REP,510046,2,4,90,96,
Muskogee,Lieutenant Governor,Dana Murphy,REP,510046,0,6,50,56,
Muskogee,Lieutenant Governor,Matt Pinnell,REP,510046,2,6,98,106,
Muskogee,State Auditor,Cindy Byrd,REP,510046,2,7,67,76,
Muskogee,State Auditor,Charlie Prater,REP,510046,0,5,77,82,
Muskogee,Attorney General,Mike Hunter,REP,510046,2,8,82,92,
Muskogee,Attorney General,Gentner Drummond,REP,510046,0,4,65,69,
Muskogee,Superintendent of Public Instruction,Joy Hofmeister,REP,510046,2,10,78,90,
Muskogee,Superintendent of Public Instruction,Linda Murphy,REP,510046,0,2,71,73,
Muskogee,Commissioner of Labor,Cathy Costello,REP,510046,0,3,68,71,
Muskogee,Commissioner of Labor,Leslie Osborn,REP,510046,2,9,79,90,
Muskogee,Corporation Commissioner,Bob Anthony,REP,510046,2,10,71,83,
Muskogee,Corporation Commissioner,Brian Bingman,REP,510046,0,2,76,78,
Muskogee,Governor,Chris Powell,LIB,510046,0,0,0,0,
Muskogee,Governor,Rex Lawhorn,LIB,510046,0,0,0,0,
Muskogee,Corporation Commissioner,Ashley Nicole Mccray,DEM,510046,6,6,50,62,
Muskogee,Corporation Commissioner,Blake Cummings,DEM,510046,2,1,48,51,
Muskogee,U.S. House,Jason Nichols,DEM,510046,5,4,49,58,02
Muskogee,U.S. House,Clay Padgett,DEM,510046,3,3,49,55,02
Muskogee,Governor,Mick Cornett,REP,510047,2,1,22,25,
Muskogee,Governor,Kevin Stitt,REP,510047,1,3,51,55,
Muskogee,Lieutenant Governor,Dana Murphy,REP,510047,3,2,26,31,
Muskogee,Lieutenant Governor,Matt Pinnell,REP,510047,0,2,46,48,
Muskogee,State Auditor,Cindy Byrd,REP,510047,3,1,32,36,
Muskogee,State Auditor,Charlie Prater,REP,510047,0,3,39,42,
Muskogee,Attorney General,Mike Hunter,REP,510047,2,1,29,32,
Muskogee,Attorney General,Gentner Drummond,REP,510047,0,3,43,46,
Muskogee,Superintendent of Public Instruction,Joy Hofmeister,REP,510047,2,2,32,36,
Muskogee,Superintendent of Public Instruction,Linda Murphy,REP,510047,1,1,40,42,
Muskogee,Commissioner of Labor,Cathy Costello,REP,510047,3,2,36,41,
Muskogee,Commissioner of Labor,Leslie Osborn,REP,510047,0,1,37,38,
Muskogee,Corporation Commissioner,Bob Anthony,REP,510047,3,4,35,42,
Muskogee,Corporation Commissioner,Brian Bingman,REP,510047,0,0,37,37,
Muskogee,Governor,Chris Powell,LIB,510047,0,0,0,0,
Muskogee,Governor,Rex Lawhorn,LIB,510047,0,0,0,0,
Muskogee,Corporation Commissioner,Ashley Nicole Mccray,DEM,510047,1,1,46,48,
Muskogee,Corporation Commissioner,Blake Cummings,DEM,510047,1,3,31,35,
Muskogee,U.S. House,Jason Nichols,DEM,510047,2,2,51,55,02
Muskogee,U.S. House,Clay Padgett,DEM,510047,0,2,26,28,02
Muskogee,Governor,Mick Cornett,REP,510049,0,1,20,21,
Muskogee,Governor,Kevin Stitt,REP,510049,0,4,16,20,
Muskogee,Lieutenant Governor,Dana Murphy,REP,510049,0,4,16,20,
Muskogee,Lieutenant Governor,Matt Pinnell,REP,510049,0,1,18,19,
Muskogee,State Auditor,Cindy Byrd,REP,510049,0,4,14,18,
Muskogee,State Auditor,Charlie Prater,REP,510049,0,1,17,18,
Muskogee,Attorney General,Mike Hunter,REP,510049,0,5,8,13,
Muskogee,Attorney General,Gentner Drummond,REP,510049,0,0,26,26,
Muskogee,Superintendent of Public Instruction,Joy Hofmeister,REP,510049,0,1,16,17,
Muskogee,Superintendent of Public Instruction,Linda Murphy,REP,510049,0,4,17,21,
Muskogee,Commissioner of Labor,Cathy Costello,REP,510049,0,3,8,11,
Muskogee,Commissioner of Labor,Leslie Osborn,REP,510049,0,1,25,26,
Muskogee,Corporation Commissioner,Bob Anthony,REP,510049,0,2,17,19,
Muskogee,Corporation Commissioner,Brian Bingman,REP,510049,0,3,17,20,
Muskogee,State House,George Faught,REP,510049,0,3,12,15,14
Muskogee,State House,Chris Sneed,REP,510049,0,2,23,25,14
Muskogee,Governor,Chris Powell,LIB,510049,0,0,0,0,
Muskogee,Governor,Rex Lawhorn,LIB,510049,0,0,0,0,
Muskogee,Corporation Commissioner,Ashley Nicole Mccray,DEM,510049,0,1,22,23,
Muskogee,Corporation Commissioner,Blake Cummings,DEM,510049,0,0,20,20,
Muskogee,U.S. House,Jason Nichols,DEM,510049,0,1,26,27,02
Muskogee,U.S. House,Clay Padgett,DEM,510049,0,0,15,15,02
Muskogee,Governor,Mick Cornett,REP,510050,0,0,5,5,
Muskogee,Governor,Kevin Stitt,REP,510050,0,0,24,24,
Muskogee,Lieutenant Governor,Dana Murphy,REP,510050,0,0,6,6,
Muskogee,Lieutenant Governor,Matt Pinnell,REP,510050,0,0,23,23,
Muskogee,State Auditor,Cindy Byrd,REP,510050,0,0,13,13,
Muskogee,State Auditor,Charlie Prater,REP,510050,0,0,14,14,
Muskogee,Attorney General,Mike Hunter,REP,510050,0,0,13,13,
Muskogee,Attorney General,Gentner Drummond,REP,510050,0,0,16,16,
Muskogee,Superintendent of Public Instruction,Joy Hofmeister,REP,510050,0,0,16,16,
Muskogee,Superintendent of Public Instruction,Linda Murphy,REP,510050,0,0,13,13,
Muskogee,Commissioner of Labor,Cathy Costello,REP,510050,0,0,10,10,
Muskogee,Commissioner of Labor,Leslie Osborn,REP,510050,0,0,19,19,
Muskogee,Corporation Commissioner,Bob Anthony,REP,510050,0,0,17,17,
Muskogee,Corporation Commissioner,Brian Bingman,REP,510050,0,0,12,12,
Muskogee,Governor,Chris Powell,LIB,510050,0,0,0,0,
Muskogee,Governor,Rex Lawhorn,LIB,510050,0,0,0,0,
Muskogee,Corporation Commissioner,Ashley Nicole Mccray,DEM,510050,0,0,17,17,
Muskogee,Corporation Commissioner,Blake Cummings,DEM,510050,0,1,7,8,
Muskogee,U.S. House,Jason Nichols,DEM,510050,0,0,15,15,02
Muskogee,U.S. House,Clay Padgett,DEM,510050,0,1,9,10,02
Muskogee,Governor,Mick Cornett,REP,510051,0,0,3,3,
Muskogee,Governor,Kevin Stitt,REP,510051,0,3,13,16,
Muskogee,Lieutenant Governor,Dana Murphy,REP,510051,0,0,4,4,
Muskogee,Lieutenant Governor,Matt Pinnell,REP,510051,0,3,12,15,
Muskogee,State Auditor,Cindy Byrd,REP,510051,0,3,9,12,
Muskogee,State Auditor,Charlie Prater,REP,510051,0,0,7,7,
Muskogee,Attorney General,Mike Hunter,REP,510051,0,0,3,3,
Muskogee,Attorney General,Gentner Drummond,REP,510051,0,3,12,15,
Muskogee,Superintendent of Public Instruction,Joy Hofmeister,REP,510051,0,0,10,10,
Muskogee,Superintendent of Public Instruction,Linda Murphy,REP,510051,0,3,6,9,
Muskogee,Commissioner of Labor,Cathy Costello,REP,510051,0,3,6,9,
Muskogee,Commissioner of Labor,Leslie Osborn,REP,510051,0,0,9,9,
Muskogee,Corporation Commissioner,Bob Anthony,REP,510051,0,0,6,6,
Muskogee,Corporation Commissioner,Brian Bingman,REP,510051,0,3,10,13,
Muskogee,Governor,Chris Powell,LIB,510051,0,0,0,0,
Muskogee,Governor,Rex Lawhorn,LIB,510051,0,0,0,0,
Muskogee,Corporation Commissioner,Ashley Nicole Mccray,DEM,510051,0,0,13,13,
Muskogee,Corporation Commissioner,Blake Cummings,DEM,510051,1,0,9,10,
Muskogee,U.S. House,Jason Nichols,DEM,510051,0,0,9,9,02
Muskogee,U.S. House,Clay Padgett,DEM,510051,1,0,13,14,02
Muskogee,Governor,Mick Cornett,REP,510052,2,0,4,6,
Muskogee,Governor,Kevin Stitt,REP,510052,0,2,20,22,
Muskogee,Lieutenant Governor,Dana Murphy,REP,510052,0,0,9,9,
Muskogee,Lieutenant Governor,Matt Pinnell,REP,510052,2,2,15,19,
Muskogee,State Auditor,Cindy Byrd,REP,510052,1,1,10,12,
Muskogee,State Auditor,Charlie Prater,REP,510052,1,1,14,16,
Muskogee,Attorney General,Mike Hunter,REP,510052,0,1,7,8,
Muskogee,Attorney General,Gentner Drummond,REP,510052,2,1,17,20,
Muskogee,Superintendent of Public Instruction,Joy Hofmeister,REP,510052,0,0,11,11,
Muskogee,Superintendent of Public Instruction,Linda Murphy,REP,510052,2,2,13,17,
Muskogee,Commissioner of Labor,Cathy Costello,REP,510052,1,1,11,13,
Muskogee,Commissioner of Labor,Leslie Osborn,REP,510052,1,1,13,15,
Muskogee,Corporation Commissioner,Bob Anthony,REP,510052,1,2,8,11,
Muskogee,Corporation Commissioner,Brian Bingman,REP,510052,1,0,16,17,
Muskogee,Governor,Chris Powell,LIB,510052,0,0,0,0,
Muskogee,Governor,Rex Lawhorn,LIB,510052,0,0,0,0,
Muskogee,Corporation Commissioner,Ashley Nicole Mccray,DEM,510052,0,2,16,18,
Muskogee,Corporation Commissioner,Blake Cummings,DEM,510052,0,0,17,17,
Muskogee,U.S. House,Jason Nichols,DEM,510052,0,1,22,23,02
Muskogee,U.S. House,Clay Padgett,DEM,510052,0,1,12,13,02
Muskogee,Governor,Mick Cornett,REP,510053,0,0,21,21,
Muskogee,Governor,Kevin Stitt,REP,510053,1,0,58,59,
Muskogee,Lieutenant Governor,Dana Murphy,REP,510053,0,0,29,29,
Muskogee,Lieutenant Governor,Matt Pinnell,REP,510053,1,0,50,51,
Muskogee,State Auditor,Cindy Byrd,REP,510053,0,0,25,25,
Muskogee,State Auditor,Charlie Prater,REP,510053,1,0,52,53,
Muskogee,Attorney General,Mike Hunter,REP,510053,1,0,29,30,
Muskogee,Attorney General,Gentner Drummond,REP,510053,0,0,49,49,
Muskogee,Superintendent of Public Instruction,Joy Hofmeister,REP,510053,0,0,46,46,
Muskogee,Superintendent of Public Instruction,Linda Murphy,REP,510053,1,0,33,34,
Muskogee,Commissioner of Labor,Cathy Costello,REP,510053,1,0,34,35,
Muskogee,Commissioner of Labor,Leslie Osborn,REP,510053,0,0,44,44,
Muskogee,Corporation Commissioner,Bob Anthony,REP,510053,0,0,32,32,
Muskogee,Corporation Commissioner,Brian Bingman,REP,510053,1,0,46,47,
Muskogee,Governor,Chris Powell,LIB,510053,0,0,0,0,
Muskogee,Governor,Rex Lawhorn,LIB,510053,0,0,0,0,
Muskogee,Corporation Commissioner,Ashley Nicole Mccray,DEM,510053,1,2,42,45,
Muskogee,Corporation Commissioner,Blake Cummings,DEM,510053,0,1,39,40,
Muskogee,U.S. House,Jason Nichols,DEM,510053,1,0,39,40,02
Muskogee,U.S. House,Clay Padgett,DEM,510053,0,2,42,44,02
Muskogee,Governor,Mick Cornett,REP,510055,3,9,77,89,
Muskogee,Governor,Kevin Stitt,REP,510055,3,11,166,180,
Muskogee,Lieutenant Governor,Dana Murphy,REP,510055,2,6,90,98,
Muskogee,Lieutenant Governor,Matt Pinnell,REP,510055,4,16,149,169,
Muskogee,State Auditor,Cindy Byrd,REP,510055,6,12,130,148,
Muskogee,State Auditor,Charlie Prater,REP,510055,0,10,105,115,
Muskogee,Attorney General,Mike Hunter,REP,510055,4,10,87,101,
Muskogee,Attorney General,Gentner Drummond,REP,510055,2,12,154,168,
Muskogee,Superintendent of Public Instruction,Joy Hofmeister,REP,510055,5,11,139,155,
Muskogee,Superintendent of Public Instruction,Linda Murphy,REP,510055,1,11,99,111,
Muskogee,Commissioner of Labor,Cathy Costello,REP,510055,5,15,101,121,
Muskogee,Commissioner of Labor,Leslie Osborn,REP,510055,1,7,133,141,
Muskogee,Corporation Commissioner,Bob Anthony,REP,510055,2,16,125,143,
Muskogee,Corporation Commissioner,Brian Bingman,REP,510055,4,6,115,125,
Muskogee,Governor,Chris Powell,LIB,510055,0,0,0,0,
Muskogee,Governor,Rex Lawhorn,LIB,510055,0,0,0,0,
Muskogee,Corporation Commissioner,Ashley Nicole Mccray,DEM,510055,2,8,100,110,
Muskogee,Corporation Commissioner,Blake Cummings,DEM,510055,3,11,62,76,
Muskogee,U.S. House,Jason Nichols,DEM,510055,5,6,96,107,02
Muskogee,U.S. House,Clay Padgett,DEM,510055,0,13,67,80,02
Muskogee,Governor,Mick Cornett,REP,510056,0,1,3,4,
Muskogee,Governor,Kevin Stitt,REP,510056,0,1,26,27,
Muskogee,Lieutenant Governor,Dana Murphy,REP,510056,0,2,7,9,
Muskogee,Lieutenant Governor,Matt Pinnell,REP,510056,0,0,22,22,
Muskogee,State Auditor,Cindy Byrd,REP,510056,0,1,19,20,
Muskogee,State Auditor,Charlie Prater,REP,510056,0,1,10,11,
Muskogee,Attorney General,Mike Hunter,REP,510056,0,1,12,13,
Muskogee,Attorney General,Gentner Drummond,REP,510056,0,1,17,18,
Muskogee,Superintendent of Public Instruction,Joy Hofmeister,REP,510056,0,1,13,14,
Muskogee,Superintendent of Public Instruction,Linda Murphy,REP,510056,0,1,16,17,
Muskogee,Commissioner of Labor,Cathy Costello,REP,510056,0,2,15,17,
Muskogee,Commissioner of Labor,Leslie Osborn,REP,510056,0,0,14,14,
Muskogee,Corporation Commissioner,Bob Anthony,REP,510056,0,1,20,21,
Muskogee,Corporation Commissioner,Brian Bingman,REP,510056,0,1,9,10,
Muskogee,Governor,Chris Powell,LIB,510056,0,0,0,0,
Muskogee,Governor,Rex Lawhorn,LIB,510056,0,0,0,0,
Muskogee,Corporation Commissioner,Ashley Nicole Mccray,DEM,510056,0,0,5,5,
Muskogee,Corporation Commissioner,Blake Cummings,DEM,510056,0,3,10,13,
Muskogee,U.S. House,Jason Nichols,DEM,510056,0,2,5,7,02
Muskogee,U.S. House,Clay Padgett,DEM,510056,0,1,10,11,02
Muskogee,Governor,Mick Cornett,REP,510057,0,0,0,0,
Muskogee,Governor,Kevin Stitt,REP,510057,0,0,2,2,
Muskogee,Lieutenant Governor,Dana Murphy,REP,510057,0,0,2,2,
Muskogee,Lieutenant Governor,Matt Pinnell,REP,510057,0,0,0,0,
Muskogee,State Auditor,Cindy Byrd,REP,510057,0,0,2,2,
Muskogee,State Auditor,Charlie Prater,REP,510057,0,0,0,0,
Muskogee,Attorney General,Mike Hunter,REP,510057,0,0,0,0,
Muskogee,Attorney General,Gentner Drummond,REP,510057,0,0,2,2,
Muskogee,Superintendent of Public Instruction,Joy Hofmeister,REP,510057,0,0,0,0,
Muskogee,Superintendent of Public Instruction,Linda Murphy,REP,510057,0,0,2,2,
Muskogee,Commissioner of Labor,Cathy Costello,REP,510057,0,0,0,0,
Muskogee,Commissioner of Labor,Leslie Osborn,REP,510057,0,0,2,2,
Muskogee,Corporation Commissioner,Bob Anthony,REP,510057,0,0,2,2,
Muskogee,Corporation Commissioner,Brian Bingman,REP,510057,0,0,0,0,
Muskogee,State House,George Faught,REP,510057,0,0,0,0,14
Muskogee,State House,Chris Sneed,REP,510057,0,0,2,2,14
Muskogee,Governor,Chris Powell,LIB,510057,0,0,0,0,
Muskogee,Governor,Rex Lawhorn,LIB,510057,0,0,0,0,
Muskogee,Corporation Commissioner,Ashley Nicole Mccray,DEM,510057,0,0,1,1,
Muskogee,Corporation Commissioner,Blake Cummings,DEM,510057,0,0,0,0,
Muskogee,U.S. House,Jason Nichols,DEM,510057,0,0,0,0,02
Muskogee,U.S. House,Clay Padgett,DEM,510057,0,0,1,1,02
Muskogee,Governor,Mick Cornett,REP,510058,0,0,25,25,
Muskogee,Governor,Kevin Stitt,REP,510058,1,0,40,41,
Muskogee,Lieutenant Governor,Dana Murphy,REP,510058,0,0,29,29,
Muskogee,Lieutenant Governor,Matt Pinnell,REP,510058,1,0,34,35,
Muskogee,State Auditor,Cindy Byrd,REP,510058,0,0,26,26,
Muskogee,State Auditor,Charlie Prater,REP,510058,1,0,33,34,
Muskogee,Attorney General,Mike Hunter,REP,510058,0,0,26,26,
Muskogee,Attorney General,Gentner Drummond,REP,510058,1,0,38,39,
Muskogee,Superintendent of Public Instruction,Joy Hofmeister,REP,510058,0,0,28,28,
Muskogee,Superintendent of Public Instruction,Linda Murphy,REP,510058,1,0,34,35,
Muskogee,Commissioner of Labor,Cathy Costello,REP,510058,0,0,29,29,
Muskogee,Commissioner of Labor,Leslie Osborn,REP,510058,1,0,33,34,
Muskogee,Corporation Commissioner,Bob Anthony,REP,510058,0,0,29,29,
Muskogee,Corporation Commissioner,Brian Bingman,REP,510058,1,0,34,35,
Muskogee,State House,George Faught,REP,510058,1,0,31,32,14
Muskogee,State House,Chris Sneed,REP,510058,0,0,31,31,14
Muskogee,Governor,Chris Powell,LIB,510058,0,0,0,0,
Muskogee,Governor,Rex Lawhorn,LIB,510058,0,0,0,0,
Muskogee,Corporation Commissioner,Ashley Nicole Mccray,DEM,510058,0,0,25,25,
Muskogee,Corporation Commissioner,Blake Cummings,DEM,510058,2,0,19,21,
Muskogee,U.S. House,Jason Nichols,DEM,510058,2,0,21,23,02
Muskogee,U.S. House,Clay Padgett,DEM,510058,0,0,24,24,02
Muskogee,Governor,Mick Cornett,REP,510059,0,0,26,26,
Muskogee,Governor,Kevin Stitt,REP,510059,1,0,40,41,
Muskogee,Lieutenant Governor,Dana Murphy,REP,510059,1,0,24,25,
Muskogee,Lieutenant Governor,Matt Pinnell,REP,510059,0,0,42,42,
Muskogee,State Auditor,Cindy Byrd,REP,510059,1,0,31,32,
Muskogee,State Auditor,Charlie Prater,REP,510059,0,0,34,34,
Muskogee,Attorney General,Mike Hunter,REP,510059,1,0,29,30,
Muskogee,Attorney General,Gentner Drummond,REP,510059,0,0,37,37,
Muskogee,Superintendent of Public Instruction,Joy Hofmeister,REP,510059,0,0,42,42,
Muskogee,Superintendent of Public Instruction,Linda Murphy,REP,510059,1,0,25,26,
Muskogee,Commissioner of Labor,Cathy Costello,REP,510059,1,0,28,29,
Muskogee,Commissioner of Labor,Leslie Osborn,REP,510059,0,0,36,36,
Muskogee,Corporation Commissioner,Bob Anthony,REP,510059,1,0,37,38,
Muskogee,Corporation Commissioner,Brian Bingman,REP,510059,0,0,27,27,
Muskogee,Governor,Chris Powell,LIB,510059,0,0,0,0,
Muskogee,Governor,Rex Lawhorn,LIB,510059,0,0,0,0,
Muskogee,Corporation Commissioner,Ashley Nicole Mccray,DEM,510059,1,1,55,57,
Muskogee,Corporation Commissioner,Blake Cummings,DEM,510059,0,1,43,44,
Muskogee,U.S. House,Jason Nichols,DEM,510059,0,1,54,55,02
Muskogee,U.S. House,Clay Padgett,DEM,510059,1,1,45,47,02
Muskogee,Governor,Mick Cornett,REP,510060,0,0,2,2,
Muskogee,Governor,Kevin Stitt,REP,510060,0,0,16,16,
Muskogee,Lieutenant Governor,Dana Murphy,REP,510060,0,0,0,0,
Muskogee,Lieutenant Governor,Matt Pinnell,REP,510060,0,0,18,18,
Muskogee,State Auditor,Cindy Byrd,REP,510060,0,0,5,5,
Muskogee,State Auditor,Charlie Prater,REP,510060,0,0,13,13,
Muskogee,Attorney General,Mike Hunter,REP,510060,0,0,6,6,
Muskogee,Attorney General,Gentner Drummond,REP,510060,0,0,12,12,
Muskogee,Superintendent of Public Instruction,Joy Hofmeister,REP,510060,0,0,11,11,
Muskogee,Superintendent of Public Instruction,Linda Murphy,REP,510060,0,0,7,7,
Muskogee,Commissioner of Labor,Cathy Costello,REP,510060,0,0,8,8,
Muskogee,Commissioner of Labor,Leslie Osborn,REP,510060,0,0,10,10,
Muskogee,Corporation Commissioner,Bob Anthony,REP,510060,0,0,8,8,
Muskogee,Corporation Commissioner,Brian Bingman,REP,510060,0,0,10,10,
Muskogee,Governor,Chris Powell,LIB,510060,0,0,0,0,
Muskogee,Governor,Rex Lawhorn,LIB,510060,0,0,0,0,
Muskogee,Corporation Commissioner,Ashley Nicole Mccray,DEM,510060,4,0,9,13,
Muskogee,Corporation Commissioner,Blake Cummings,DEM,510060,0,1,10,11,
Muskogee,U.S. House,Jason Nichols,DEM,510060,4,0,17,21,02
Muskogee,U.S. House,Clay Padgett,DEM,510060,0,1,3,4,02
Muskogee,Governor,Mick Cornett,REP,510061,0,0,11,11,
Muskogee,Governor,Kevin Stitt,REP,510061,0,0,26,26,
Muskogee,Lieutenant Governor,Dana Murphy,REP,510061,0,0,14,14,
Muskogee,Lieutenant Governor,Matt Pinnell,REP,510061,0,0,23,23,
Muskogee,State Auditor,Cindy Byrd,REP,510061,0,0,9,9,
Muskogee,State Auditor,Charlie Prater,REP,510061,0,0,27,27,
Muskogee,Attorney General,Mike Hunter,REP,510061,0,0,8,8,
Muskogee,Attorney General,Gentner Drummond,REP,510061,0,0,29,29,
Muskogee,Superintendent of Public Instruction,Joy Hofmeister,REP,510061,0,0,18,18,
Muskogee,Superintendent of Public Instruction,Linda Murphy,REP,510061,0,0,19,19,
Muskogee,Commissioner of Labor,Cathy Costello,REP,510061,0,0,10,10,
Muskogee,Commissioner of Labor,Leslie Osborn,REP,510061,0,0,27,27,
Muskogee,Corporation Commissioner,Bob Anthony,REP,510061,0,0,15,15,
Muskogee,Corporation Commissioner,Brian Bingman,REP,510061,0,0,22,22,
Muskogee,Governor,Chris Powell,LIB,510061,0,0,0,0,
Muskogee,Governor,Rex Lawhorn,LIB,510061,0,0,0,0,
Muskogee,Corporation Commissioner,Ashley Nicole Mccray,DEM,510061,0,0,35,35,
Muskogee,Corporation Commissioner,Blake Cummings,DEM,510061,0,1,25,26,
Muskogee,U.S. House,Jason Nichols,DEM,510061,0,0,37,37,02
Muskogee,U.S. House,Clay Padgett,DEM,510061,0,1,23,24,02
Muskogee,Governor,Mick Cornett,REP,510064,1,0,18,19,
Muskogee,Governor,Kevin Stitt,REP,510064,0,2,36,38,
Muskogee,Lieutenant Governor,Dana Murphy,REP,510064,1,0,26,27,
Muskogee,Lieutenant Governor,Matt Pinnell,REP,510064,0,2,27,29,
Muskogee,State Auditor,Cindy Byrd,REP,510064,1,2,24,27,
Muskogee,State Auditor,Charlie Prater,REP,510064,0,0,29,29,
Muskogee,Attorney General,Mike Hunter,REP,510064,0,0,18,18,
Muskogee,Attorney General,Gentner Drummond,REP,510064,1,2,36,39,
Muskogee,Superintendent of Public Instruction,Joy Hofmeister,REP,510064,0,0,29,29,
Muskogee,Superintendent of Public Instruction,Linda Murphy,REP,510064,1,2,24,27,
Muskogee,Commissioner of Labor,Cathy Costello,REP,510064,0,2,23,25,
Muskogee,Commissioner of Labor,Leslie Osborn,REP,510064,1,0,30,31,
Muskogee,Corporation Commissioner,Bob Anthony,REP,510064,1,2,21,24,
Muskogee,Corporation Commissioner,Brian Bingman,REP,510064,0,0,31,31,
Muskogee,Governor,Chris Powell,LIB,510064,0,0,0,0,
Muskogee,Governor,Rex Lawhorn,LIB,510064,0,0,0,0,
Muskogee,Corporation Commissioner,Ashley Nicole Mccray,DEM,510064,0,3,26,29,
Muskogee,Corporation Commissioner,Blake Cummings,DEM,510064,0,4,51,55,
Muskogee,U.S. House,Jason Nichols,DEM,510064,0,3,47,50,02
Muskogee,U.S. House,Clay Padgett,DEM,510064,0,4,31,35,02
Noble,Governor,Mick Cornett,REP,520101,3,15,90,108,
Noble,Governor,Kevin Stitt,REP,520101,0,23,67,90,
Noble,Lieutenant Governor,Dana Murphy,REP,520101,2,15,70,87,
Noble,Lieutenant Governor,Matt Pinnell,REP,520101,1,22,87,110,
Noble,State Auditor,Cindy Byrd,REP,520101,1,20,64,85,
Noble,State Auditor,Charlie Prater,REP,520101,2,18,91,111,
Noble,Attorney General,Mike Hunter,REP,520101,2,16,79,97,
Noble,Attorney General,Gentner Drummond,REP,520101,1,22,75,98,
Noble,Superintendent of Public Instruction,Joy Hofmeister,REP,520101,3,22,84,109,
Noble,Superintendent of Public Instruction,Linda Murphy,REP,520101,0,16,71,87,
Noble,Commissioner of Labor,Cathy Costello,REP,520101,0,21,61,82,
Noble,Commissioner of Labor,Leslie Osborn,REP,520101,3,17,92,112,
Noble,Corporation Commissioner,Bob Anthony,REP,520101,2,23,77,102,
Noble,Corporation Commissioner,Brian Bingman,REP,520101,1,14,80,95,
Noble,Governor,Chris Powell,LIB,520101,1,0,0,1,
Noble,Governor,Rex Lawhorn,LIB,520101,0,0,0,0,
Noble,Corporation Commissioner,Ashley Nicole Mccray,DEM,520101,0,2,11,13,
Noble,Corporation Commissioner,Blake Cummings,DEM,520101,0,4,11,15,
Noble,Governor,Mick Cornett,REP,520102,0,9,18,27,
Noble,Governor,Kevin Stitt,REP,520102,2,2,33,37,
Noble,Lieutenant Governor,Dana Murphy,REP,520102,2,5,27,34,
Noble,Lieutenant Governor,Matt Pinnell,REP,520102,0,6,23,29,
Noble,State Auditor,Cindy Byrd,REP,520102,1,4,19,24,
Noble,State Auditor,Charlie Prater,REP,520102,1,7,30,38,
Noble,Attorney General,Mike Hunter,REP,520102,1,5,19,25,
Noble,Attorney General,Gentner Drummond,REP,520102,1,6,32,39,
Noble,Superintendent of Public Instruction,Joy Hofmeister,REP,520102,1,7,27,35,
Noble,Superintendent of Public Instruction,Linda Murphy,REP,520102,1,4,24,29,
Noble,Commissioner of Labor,Cathy Costello,REP,520102,1,2,25,28,
Noble,Commissioner of Labor,Leslie Osborn,REP,520102,1,9,25,35,
Noble,Corporation Commissioner,Bob Anthony,REP,520102,0,10,26,36,
Noble,Corporation Commissioner,Brian Bingman,REP,520102,2,1,26,29,
Noble,State House,John Pfeiffer,REP,520102,2,8,40,50,38
Noble,State House,Brian Hobbs,REP,520102,0,3,12,15,38
Noble,Governor,Chris Powell,LIB,520102,0,0,0,0,
Noble,Governor,Rex Lawhorn,LIB,520102,0,0,0,0,
Noble,Corporation Commissioner,Ashley Nicole Mccray,DEM,520102,0,1,4,5,
Noble,Corporation Commissioner,Blake Cummings,DEM,520102,0,2,7,9,
Noble,Governor,Mick Cornett,REP,520103,0,0,31,31,
Noble,Governor,Kevin Stitt,REP,520103,0,0,41,41,
Noble,Lieutenant Governor,Dana Murphy,REP,520103,0,0,36,36,
Noble,Lieutenant Governor,Matt Pinnell,REP,520103,0,0,36,36,
Noble,State Auditor,Cindy Byrd,REP,520103,0,0,27,27,
Noble,State Auditor,Charlie Prater,REP,520103,0,0,41,41,
Noble,Attorney General,Mike Hunter,REP,520103,0,0,29,29,
Noble,Attorney General,Gentner Drummond,REP,520103,0,0,42,42,
Noble,Superintendent of Public Instruction,Joy Hofmeister,REP,520103,0,0,29,29,
Noble,Superintendent of Public Instruction,Linda Murphy,REP,520103,0,0,42,42,
Noble,Commissioner of Labor,Cathy Costello,REP,520103,0,0,41,41,
Noble,Commissioner of Labor,Leslie Osborn,REP,520103,0,0,31,31,
Noble,Corporation Commissioner,Bob Anthony,REP,520103,0,0,40,40,
Noble,Corporation Commissioner,Brian Bingman,REP,520103,0,0,32,32,
Noble,State House,John Pfeiffer,REP,520103,0,0,47,47,38
Noble,State House,Brian Hobbs,REP,520103,0,0,24,24,38
Noble,Governor,Chris Powell,LIB,520103,0,0,0,0,
Noble,Governor,Rex Lawhorn,LIB,520103,0,0,1,1,
Noble,Corporation Commissioner,Ashley Nicole Mccray,DEM,520103,0,0,11,11,
Noble,Corporation Commissioner,Blake Cummings,DEM,520103,0,1,11,12,
Noble,Governor,Mick Cornett,REP,520104,1,1,27,29,
Noble,Governor,Kevin Stitt,REP,520104,0,2,38,40,
Noble,Lieutenant Governor,Dana Murphy,REP,520104,0,1,27,28,
Noble,Lieutenant Governor,Matt Pinnell,REP,520104,1,2,36,39,
Noble,State Auditor,Cindy Byrd,REP,520104,0,2,23,25,
Noble,State Auditor,Charlie Prater,REP,520104,1,1,40,42,
Noble,Attorney General,Mike Hunter,REP,520104,1,3,22,26,
Noble,Attorney General,Gentner Drummond,REP,520104,0,0,41,41,
Noble,Superintendent of Public Instruction,Joy Hofmeister,REP,520104,1,3,34,38,
Noble,Superintendent of Public Instruction,Linda Murphy,REP,520104,0,0,28,28,
Noble,Commissioner of Labor,Cathy Costello,REP,520104,0,0,34,34,
Noble,Commissioner of Labor,Leslie Osborn,REP,520104,1,3,29,33,
Noble,Corporation Commissioner,Bob Anthony,REP,520104,0,0,28,28,
Noble,Corporation Commissioner,Brian Bingman,REP,520104,1,3,35,39,
Noble,State House,John Pfeiffer,REP,520104,0,3,34,37,38
Noble,State House,Brian Hobbs,REP,520104,1,0,31,32,38
Noble,Governor,Chris Powell,LIB,520104,0,0,0,0,
Noble,Governor,Rex Lawhorn,LIB,520104,0,0,0,0,
Noble,Corporation Commissioner,Ashley Nicole Mccray,DEM,520104,0,0,5,5,
Noble,Corporation Commissioner,Blake Cummings,DEM,520104,0,0,10,10,
Noble,Governor,Mick Cornett,REP,520105,0,0,18,18,
Noble,Governor,Kevin Stitt,REP,520105,1,1,17,19,
Noble,Lieutenant Governor,Dana Murphy,REP,520105,0,1,20,21,
Noble,Lieutenant Governor,Matt Pinnell,REP,520105,1,0,15,16,
Noble,State Auditor,Cindy Byrd,REP,520105,0,1,16,17,
Noble,State Auditor,Charlie Prater,REP,520105,1,0,18,19,
Noble,Attorney General,Mike Hunter,REP,520105,1,0,7,8,
Noble,Attorney General,Gentner Drummond,REP,520105,0,1,29,30,
Noble,Superintendent of Public Instruction,Joy Hofmeister,REP,520105,0,1,25,26,
Noble,Superintendent of Public Instruction,Linda Murphy,REP,520105,1,0,11,12,
Noble,Commissioner of Labor,Cathy Costello,REP,520105,0,1,18,19,
Noble,Commissioner of Labor,Leslie Osborn,REP,520105,1,0,14,15,
Noble,Corporation Commissioner,Bob Anthony,REP,520105,1,1,16,18,
Noble,Corporation Commissioner,Brian Bingman,REP,520105,0,0,20,20,
Noble,State House,John Pfeiffer,REP,520105,0,1,24,25,38
Noble,State House,Brian Hobbs,REP,520105,1,0,12,13,38
Noble,Governor,Chris Powell,LIB,520105,0,0,0,0,
Noble,Governor,Rex Lawhorn,LIB,520105,0,0,0,0,
Noble,Corporation Commissioner,Ashley Nicole Mccray,DEM,520105,0,0,9,9,
Noble,Corporation Commissioner,Blake Cummings,DEM,520105,0,0,2,2,
Noble,Governor,Mick Cornett,REP,520106,0,1,22,23,
Noble,Governor,Kevin Stitt,REP,520106,0,1,14,15,
Noble,Lieutenant Governor,Dana Murphy,REP,520106,0,0,14,14,
Noble,Lieutenant Governor,Matt Pinnell,REP,520106,0,2,22,24,
Noble,State Auditor,Cindy Byrd,REP,520106,0,0,12,12,
Noble,State Auditor,Charlie Prater,REP,520106,0,2,23,25,
Noble,Attorney General,Mike Hunter,REP,520106,0,0,18,18,
Noble,Attorney General,Gentner Drummond,REP,520106,0,2,18,20,
Noble,Superintendent of Public Instruction,Joy Hofmeister,REP,520106,0,1,14,15,
Noble,Superintendent of Public Instruction,Linda Murphy,REP,520106,0,1,20,21,
Noble,Commissioner of Labor,Cathy Costello,REP,520106,0,0,11,11,
Noble,Commissioner of Labor,Leslie Osborn,REP,520106,0,2,25,27,
Noble,Corporation Commissioner,Bob Anthony,REP,520106,0,1,16,17,
Noble,Corporation Commissioner,Brian Bingman,REP,520106,0,1,19,20,
Noble,State House,John Pfeiffer,REP,520106,0,2,25,27,38
Noble,State House,Brian Hobbs,REP,520106,0,0,10,10,38
Noble,Governor,Chris Powell,LIB,520106,0,0,0,0,
Noble,Governor,Rex Lawhorn,LIB,520106,0,0,0,0,
Noble,Corporation Commissioner,Ashley Nicole Mccray,DEM,520106,0,0,2,2,
Noble,Corporation Commissioner,Blake Cummings,DEM,520106,0,0,2,2,
Noble,Governor,Mick Cornett,REP,520201,0,17,71,88,
Noble,Governor,Kevin Stitt,REP,520201,0,12,55,67,
Noble,Lieutenant Governor,Dana Murphy,REP,520201,0,15,56,71,
Noble,Lieutenant Governor,Matt Pinnell,REP,520201,0,15,70,85,
Noble,State Auditor,Cindy Byrd,REP,520201,0,19,56,75,
Noble,State Auditor,Charlie Prater,REP,520201,0,11,69,80,
Noble,Attorney General,Mike Hunter,REP,520201,0,14,59,73,
Noble,Attorney General,Gentner Drummond,REP,520201,0,15,68,83,
Noble,Superintendent of Public Instruction,Joy Hofmeister,REP,520201,0,21,66,87,
Noble,Superintendent of Public Instruction,Linda Murphy,REP,520201,0,9,59,68,
Noble,Commissioner of Labor,Cathy Costello,REP,520201,0,9,50,59,
Noble,Commissioner of Labor,Leslie Osborn,REP,520201,0,21,76,97,
Noble,Corporation Commissioner,Bob Anthony,REP,520201,0,16,66,82,
Noble,Corporation Commissioner,Brian Bingman,REP,520201,0,14,60,74,
Noble,Governor,Chris Powell,LIB,520201,0,0,0,0,
Noble,Governor,Rex Lawhorn,LIB,520201,0,0,1,1,
Noble,Corporation Commissioner,Ashley Nicole Mccray,DEM,520201,2,6,15,23,
Noble,Corporation Commissioner,Blake Cummings,DEM,520201,0,4,18,22,
Noble,Governor,Mick Cornett,REP,520202,6,4,32,42,
Noble,Governor,Kevin Stitt,REP,520202,3,9,30,42,
Noble,Lieutenant Governor,Dana Murphy,REP,520202,6,9,20,35,
Noble,Lieutenant Governor,Matt Pinnell,REP,520202,3,4,42,49,
Noble,State Auditor,Cindy Byrd,REP,520202,5,9,27,41,
Noble,State Auditor,Charlie Prater,REP,520202,4,4,35,43,
Noble,Attorney General,Mike Hunter,REP,520202,1,8,25,34,
Noble,Attorney General,Gentner Drummond,REP,520202,8,4,37,49,
Noble,Superintendent of Public Instruction,Joy Hofmeister,REP,520202,6,8,30,44,
Noble,Superintendent of Public Instruction,Linda Murphy,REP,520202,3,5,32,40,
Noble,Commissioner of Labor,Cathy Costello,REP,520202,6,3,35,44,
Noble,Commissioner of Labor,Leslie Osborn,REP,520202,3,10,27,40,
Noble,Corporation Commissioner,Bob Anthony,REP,520202,3,5,28,36,
Noble,Corporation Commissioner,Brian Bingman,REP,520202,6,8,33,47,
Noble,State House,John Pfeiffer,REP,520202,3,11,36,50,38
Noble,State House,Brian Hobbs,REP,520202,6,2,26,34,38
Noble,Governor,Chris Powell,LIB,520202,0,0,0,0,
Noble,Governor,Rex Lawhorn,LIB,520202,0,0,2,2,
Noble,Corporation Commissioner,Ashley Nicole Mccray,DEM,520202,3,4,9,16,
Noble,Corporation Commissioner,Blake Cummings,DEM,520202,1,1,9,11,
Noble,Governor,Mick Cornett,REP,520203,1,13,35,49,
Noble,Governor,Kevin Stitt,REP,520203,0,2,25,27,
Noble,Lieutenant Governor,Dana Murphy,REP,520203,0,9,21,30,
Noble,Lieutenant Governor,Matt Pinnell,REP,520203,1,5,39,45,
Noble,State Auditor,Cindy Byrd,REP,520203,1,8,21,30,
Noble,State Auditor,Charlie Prater,REP,520203,0,7,39,46,
Noble,Attorney General,Mike Hunter,REP,520203,1,8,24,33,
Noble,Attorney General,Gentner Drummond,REP,520203,0,6,36,42,
Noble,Superintendent of Public Instruction,Joy Hofmeister,REP,520203,1,2,27,30,
Noble,Superintendent of Public Instruction,Linda Murphy,REP,520203,0,12,32,44,
Noble,Commissioner of Labor,Cathy Costello,REP,520203,0,7,19,26,
Noble,Commissioner of Labor,Leslie Osborn,REP,520203,1,7,38,46,
Noble,Corporation Commissioner,Bob Anthony,REP,520203,1,5,26,32,
Noble,Corporation Commissioner,Brian Bingman,REP,520203,0,10,34,44,
Noble,Governor,Chris Powell,LIB,520203,0,0,1,1,
Noble,Governor,Rex Lawhorn,LIB,520203,0,0,0,0,
Noble,Corporation Commissioner,Ashley Nicole Mccray,DEM,520203,0,3,7,10,
Noble,Corporation Commissioner,Blake Cummings,DEM,520203,0,1,10,11,
Noble,Governor,Mick Cornett,REP,520301,3,14,61,78,
Noble,Governor,Kevin Stitt,REP,520301,0,17,61,78,
Noble,Lieutenant Governor,Dana Murphy,REP,520301,3,17,53,73,
Noble,Lieutenant Governor,Matt Pinnell,REP,520301,0,13,66,79,
Noble,State Auditor,Cindy Byrd,REP,520301,2,16,48,66,
Noble,State Auditor,Charlie Prater,REP,520301,1,15,69,85,
Noble,Attorney General,Mike Hunter,REP,520301,1,11,44,56,
Noble,Attorney General,Gentner Drummond,REP,520301,2,20,76,98,
Noble,Superintendent of Public Instruction,Joy Hofmeister,REP,520301,1,21,61,83,
Noble,Superintendent of Public Instruction,Linda Murphy,REP,520301,2,10,56,68,
Noble,Commissioner of Labor,Cathy Costello,REP,520301,0,14,47,61,
Noble,Commissioner of Labor,Leslie Osborn,REP,520301,3,16,73,92,
Noble,Corporation Commissioner,Bob Anthony,REP,520301,0,14,54,68,
Noble,Corporation Commissioner,Brian Bingman,REP,520301,3,16,64,83,
Noble,State House,John Pfeiffer,REP,520301,3,23,100,126,38
Noble,State House,Brian Hobbs,REP,520301,0,8,21,29,38
Noble,Governor,Chris Powell,LIB,520301,0,0,0,0,
Noble,Governor,Rex Lawhorn,LIB,520301,0,0,0,0,
Noble,Corporation Commissioner,Ashley Nicole Mccray,DEM,520301,0,5,15,20,
Noble,Corporation Commissioner,Blake Cummings,DEM,520301,0,4,7,11,
Noble,Governor,Mick Cornett,REP,520305,3,6,123,132,
Noble,Governor,Kevin Stitt,REP,520305,4,2,94,100,
Noble,Lieutenant Governor,Dana Murphy,REP,520305,3,2,76,81,
Noble,Lieutenant Governor,Matt Pinnell,REP,520305,4,6,134,144,
Noble,State Auditor,Cindy Byrd,REP,520305,7,3,85,95,
Noble,State Auditor,Charlie Prater,REP,520305,0,5,123,128,
Noble,Attorney General,Mike Hunter,REP,520305,5,3,81,89,
Noble,Attorney General,Gentner Drummond,REP,520305,2,4,135,141,
Noble,Superintendent of Public Instruction,Joy Hofmeister,REP,520305,5,2,111,118,
Noble,Superintendent of Public Instruction,Linda Murphy,REP,520305,2,6,102,110,
Noble,Commissioner of Labor,Cathy Costello,REP,520305,3,4,77,84,
Noble,Commissioner of Labor,Leslie Osborn,REP,520305,4,4,131,139,
Noble,Corporation Commissioner,Bob Anthony,REP,520305,4,2,92,98,
Noble,Corporation Commissioner,Brian Bingman,REP,520305,3,6,122,131,
Noble,Governor,Chris Powell,LIB,520305,0,0,0,0,
Noble,Governor,Rex Lawhorn,LIB,520305,0,0,0,0,
Noble,Corporation Commissioner,Ashley Nicole Mccray,DEM,520305,2,0,28,30,
Noble,Corporation Commissioner,Blake Cummings,DEM,520305,2,1,21,24,
Noble,Governor,Mick Cornett,REP,520307,6,27,63,96,
Noble,Governor,Kevin Stitt,REP,520307,3,19,71,93,
Noble,Lieutenant Governor,Dana Murphy,REP,520307,5,22,52,79,
Noble,Lieutenant Governor,Matt Pinnell,REP,520307,4,24,81,109,
Noble,State Auditor,Cindy Byrd,REP,520307,4,22,54,80,
Noble,State Auditor,Charlie Prater,REP,520307,5,23,78,106,
Noble,Attorney General,Mike Hunter,REP,520307,5,20,51,76,
Noble,Attorney General,Gentner Drummond,REP,520307,4,25,82,111,
Noble,Superintendent of Public Instruction,Joy Hofmeister,REP,520307,4,29,76,109,
Noble,Superintendent of Public Instruction,Linda Murphy,REP,520307,5,16,57,78,
Noble,Commissioner of Labor,Cathy Costello,REP,520307,6,18,52,76,
Noble,Commissioner of Labor,Leslie Osborn,REP,520307,3,26,80,109,
Noble,Corporation Commissioner,Bob Anthony,REP,520307,4,23,54,81,
Noble,Corporation Commissioner,Brian Bingman,REP,520307,5,22,77,104,
Noble,Governor,Chris Powell,LIB,520307,0,0,0,0,
Noble,Governor,Rex Lawhorn,LIB,520307,0,0,0,0,
Noble,Corporation Commissioner,Ashley Nicole Mccray,DEM,520307,0,3,9,12,
Noble,Corporation Commissioner,Blake Cummings,DEM,520307,1,3,2,6,
Nowata,Governor,Mick Cornett,REP,530101,3,5,43,51,
Nowata,Governor,Kevin Stitt,REP,530101,2,2,53,57,
Nowata,Lieutenant Governor,Dana Murphy,REP,530101,1,1,41,43,
Nowata,Lieutenant Governor,Matt Pinnell,REP,530101,4,6,54,64,
Nowata,State Auditor,Cindy Byrd,REP,530101,0,2,49,51,
Nowata,State Auditor,Charlie Prater,REP,530101,4,2,42,48,
Nowata,Attorney General,Mike Hunter,REP,530101,5,2,39,46,
Nowata,Attorney General,Gentner Drummond,REP,530101,0,5,57,62,
Nowata,Superintendent of Public Instruction,Joy Hofmeister,REP,530101,3,3,64,70,
Nowata,Superintendent of Public Instruction,Linda Murphy,REP,530101,1,3,32,36,
Nowata,Commissioner of Labor,Cathy Costello,REP,530101,2,5,37,44,
Nowata,Commissioner of Labor,Leslie Osborn,REP,530101,2,2,58,62,
Nowata,Corporation Commissioner,Bob Anthony,REP,530101,0,2,60,62,
Nowata,Corporation Commissioner,Brian Bingman,REP,530101,4,5,34,43,
Nowata,State House,Travis Dunlap,REP,530101,1,4,41,46,10
Nowata,State House,Judd Strom,REP,530101,3,3,54,60,10
Nowata,Governor,Chris Powell,LIB,530101,0,0,0,0,
Nowata,Governor,Rex Lawhorn,LIB,530101,0,0,0,0,
Nowata,Corporation Commissioner,Ashley Nicole Mccray,DEM,530101,1,7,12,20,
Nowata,Corporation Commissioner,Blake Cummings,DEM,530101,1,5,16,22,
Nowata,U.S. House,Jason Nichols,DEM,530101,1,4,14,19,02
Nowata,U.S. House,Clay Padgett,DEM,530101,1,8,14,23,02
Nowata,Governor,Mick Cornett,REP,530102,5,5,45,55,
Nowata,Governor,Kevin Stitt,REP,530102,5,11,79,95,
Nowata,Lieutenant Governor,Dana Murphy,REP,530102,7,4,51,62,
Nowata,Lieutenant Governor,Matt Pinnell,REP,530102,3,12,69,84,
Nowata,State Auditor,Cindy Byrd,REP,530102,6,7,56,69,
Nowata,State Auditor,Charlie Prater,REP,530102,3,9,61,73,
Nowata,Attorney General,Mike Hunter,REP,530102,3,7,38,48,
Nowata,Attorney General,Gentner Drummond,REP,530102,7,9,83,99,
Nowata,Superintendent of Public Instruction,Joy Hofmeister,REP,530102,5,8,83,96,
Nowata,Superintendent of Public Instruction,Linda Murphy,REP,530102,5,8,40,53,
Nowata,Commissioner of Labor,Cathy Costello,REP,530102,5,10,51,66,
Nowata,Commissioner of Labor,Leslie Osborn,REP,530102,5,6,67,78,
Nowata,Corporation Commissioner,Bob Anthony,REP,530102,8,12,60,80,
Nowata,Corporation Commissioner,Brian Bingman,REP,530102,1,4,59,64,
Nowata,State House,Travis Dunlap,REP,530102,4,10,47,61,10
Nowata,State House,Judd Strom,REP,530102,6,6,73,85,10
Nowata,Governor,Chris Powell,LIB,530102,0,0,2,2,
Nowata,Governor,Rex Lawhorn,LIB,530102,0,0,2,2,
Nowata,Corporation Commissioner,Ashley Nicole Mccray,DEM,530102,2,4,28,34,
Nowata,Corporation Commissioner,Blake Cummings,DEM,530102,2,5,24,31,
Nowata,U.S. House,Jason Nichols,DEM,530102,3,4,26,33,02
Nowata,U.S. House,Clay Padgett,DEM,530102,1,6,26,33,02
Nowata,Governor,Mick Cornett,REP,530103,0,3,16,19,
Nowata,Governor,Kevin Stitt,REP,530103,0,5,35,40,
Nowata,Lieutenant Governor,Dana Murphy,REP,530103,0,4,14,18,
Nowata,Lieutenant Governor,Matt Pinnell,REP,530103,0,4,36,40,
Nowata,State Auditor,Cindy Byrd,REP,530103,0,5,23,28,
Nowata,State Auditor,Charlie Prater,REP,530103,0,3,28,31,
Nowata,Attorney General,Mike Hunter,REP,530103,0,2,22,24,
Nowata,Attorney General,Gentner Drummond,REP,530103,0,6,29,35,
Nowata,Superintendent of Public Instruction,Joy Hofmeister,REP,530103,0,5,34,39,
Nowata,Superintendent of Public Instruction,Linda Murphy,REP,530103,0,3,18,21,
Nowata,Commissioner of Labor,Cathy Costello,REP,530103,0,4,21,25,
Nowata,Commissioner of Labor,Leslie Osborn,REP,530103,0,3,28,31,
Nowata,Corporation Commissioner,Bob Anthony,REP,530103,0,4,16,20,
Nowata,Corporation Commissioner,Brian Bingman,REP,530103,0,4,35,39,
Nowata,State House,Travis Dunlap,REP,530103,0,5,21,26,10
Nowata,State House,Judd Strom,REP,530103,0,3,31,34,10
Nowata,Governor,Chris Powell,LIB,530103,0,0,0,0,
Nowata,Governor,Rex Lawhorn,LIB,530103,0,0,0,0,
Nowata,Corporation Commissioner,Ashley Nicole Mccray,DEM,530103,0,0,12,12,
Nowata,Corporation Commissioner,Blake Cummings,DEM,530103,0,0,18,18,
Nowata,U.S. House,Jason Nichols,DEM,530103,0,0,16,16,02
Nowata,U.S. House,Clay Padgett,DEM,530103,0,0,14,14,02
Nowata,Governor,Mick Cornett,REP,530201,3,0,18,21,
Nowata,Governor,Kevin Stitt,REP,530201,3,0,37,40,
Nowata,Lieutenant Governor,Dana Murphy,REP,530201,5,0,13,18,
Nowata,Lieutenant Governor,Matt Pinnell,REP,530201,1,0,41,42,
Nowata,State Auditor,Cindy Byrd,REP,530201,4,0,25,29,
Nowata,State Auditor,Charlie Prater,REP,530201,2,0,28,30,
Nowata,Attorney General,Mike Hunter,REP,530201,6,0,23,29,
Nowata,Attorney General,Gentner Drummond,REP,530201,0,0,31,31,
Nowata,Superintendent of Public Instruction,Joy Hofmeister,REP,530201,5,0,29,34,
Nowata,Superintendent of Public Instruction,Linda Murphy,REP,530201,1,0,25,26,
Nowata,Commissioner of Labor,Cathy Costello,REP,530201,1,0,14,15,
Nowata,Commissioner of Labor,Leslie Osborn,REP,530201,5,0,40,45,
Nowata,Corporation Commissioner,Bob Anthony,REP,530201,4,0,20,24,
Nowata,Corporation Commissioner,Brian Bingman,REP,530201,2,0,34,36,
Nowata,State House,Travis Dunlap,REP,530201,4,0,25,29,10
Nowata,State House,Judd Strom,REP,530201,2,0,30,32,10
Nowata,Governor,Chris Powell,LIB,530201,0,0,0,0,
Nowata,Governor,Rex Lawhorn,LIB,530201,0,0,0,0,
Nowata,Corporation Commissioner,Ashley Nicole Mccray,DEM,530201,3,1,12,16,
Nowata,Corporation Commissioner,Blake Cummings,DEM,530201,1,1,7,9,
Nowata,U.S. House,Jason Nichols,DEM,530201,2,1,12,15,02
Nowata,U.S. House,Clay Padgett,DEM,530201,2,1,7,10,02
Nowata,Governor,Mick Cornett,REP,530202,0,5,46,51,
Nowata,Governor,Kevin Stitt,REP,530202,3,10,45,58,
Nowata,Lieutenant Governor,Dana Murphy,REP,530202,1,6,31,38,
Nowata,Lieutenant Governor,Matt Pinnell,REP,530202,2,9,58,69,
Nowata,State Auditor,Cindy Byrd,REP,530202,3,10,42,55,
Nowata,State Auditor,Charlie Prater,REP,530202,0,4,45,49,
Nowata,Attorney General,Mike Hunter,REP,530202,2,4,35,41,
Nowata,Attorney General,Gentner Drummond,REP,530202,1,11,56,68,
Nowata,Superintendent of Public Instruction,Joy Hofmeister,REP,530202,2,5,61,68,
Nowata,Superintendent of Public Instruction,Linda Murphy,REP,530202,1,10,28,39,
Nowata,Commissioner of Labor,Cathy Costello,REP,530202,1,9,36,46,
Nowata,Commissioner of Labor,Leslie Osborn,REP,530202,2,5,54,61,
Nowata,Corporation Commissioner,Bob Anthony,REP,530202,1,10,44,55,
Nowata,Corporation Commissioner,Brian Bingman,REP,530202,2,5,45,52,
Nowata,State House,Travis Dunlap,REP,530202,0,5,27,32,10
Nowata,State House,Judd Strom,REP,530202,3,10,64,77,10
Nowata,Governor,Chris Powell,LIB,530202,0,0,0,0,
Nowata,Governor,Rex Lawhorn,LIB,530202,0,0,0,0,
Nowata,Corporation Commissioner,Ashley Nicole Mccray,DEM,530202,0,2,11,13,
Nowata,Corporation Commissioner,Blake Cummings,DEM,530202,0,3,11,14,
Nowata,U.S. House,Jason Nichols,DEM,530202,0,4,12,16,02
Nowata,U.S. House,Clay Padgett,DEM,530202,0,1,10,11,02
Nowata,Governor,Mick Cornett,REP,530203,0,5,69,74,
Nowata,Governor,Kevin Stitt,REP,530203,2,6,77,85,
Nowata,Lieutenant Governor,Dana Murphy,REP,530203,1,5,77,83,
Nowata,Lieutenant Governor,Matt Pinnell,REP,530203,1,7,68,76,
Nowata,State Auditor,Cindy Byrd,REP,530203,1,7,72,80,
Nowata,State Auditor,Charlie Prater,REP,530203,0,5,71,76,
Nowata,Attorney General,Mike Hunter,REP,530203,2,4,63,69,
Nowata,Attorney General,Gentner Drummond,REP,530203,0,7,84,91,
Nowata,Superintendent of Public Instruction,Joy Hofmeister,REP,530203,0,7,94,101,
Nowata,Superintendent of Public Instruction,Linda Murphy,REP,530203,2,5,52,59,
Nowata,Commissioner of Labor,Cathy Costello,REP,530203,2,4,50,56,
Nowata,Commissioner of Labor,Leslie Osborn,REP,530203,0,8,93,101,
Nowata,Corporation Commissioner,Bob Anthony,REP,530203,1,9,84,94,
Nowata,Corporation Commissioner,Brian Bingman,REP,530203,1,3,60,64,
Nowata,State House,Travis Dunlap,REP,530203,1,5,57,63,10
Nowata,State House,Judd Strom,REP,530203,1,7,89,97,10
Nowata,Governor,Chris Powell,LIB,530203,0,0,1,1,
Nowata,Governor,Rex Lawhorn,LIB,530203,0,0,1,1,
Nowata,Corporation Commissioner,Ashley Nicole Mccray,DEM,530203,0,6,29,35,
Nowata,Corporation Commissioner,Blake Cummings,DEM,530203,0,3,20,23,
Nowata,U.S. House,Jason Nichols,DEM,530203,0,7,30,37,02
Nowata,U.S. House,Clay Padgett,DEM,530203,0,2,19,21,02
Nowata,Governor,Mick Cornett,REP,530204,0,0,17,17,
Nowata,Governor,Kevin Stitt,REP,530204,1,1,37,39,
Nowata,Lieutenant Governor,Dana Murphy,REP,530204,0,0,12,12,
Nowata,Lieutenant Governor,Matt Pinnell,REP,530204,1,1,42,44,
Nowata,State Auditor,Cindy Byrd,REP,530204,1,0,24,25,
Nowata,State Auditor,Charlie Prater,REP,530204,0,1,30,31,
Nowata,Attorney General,Mike Hunter,REP,530204,0,1,26,27,
Nowata,Attorney General,Gentner Drummond,REP,530204,1,0,30,31,
Nowata,Superintendent of Public Instruction,Joy Hofmeister,REP,530204,1,0,28,29,
Nowata,Superintendent of Public Instruction,Linda Murphy,REP,530204,0,0,25,25,
Nowata,Commissioner of Labor,Cathy Costello,REP,530204,0,0,17,17,
Nowata,Commissioner of Labor,Leslie Osborn,REP,530204,1,0,37,38,
Nowata,Corporation Commissioner,Bob Anthony,REP,530204,1,1,27,29,
Nowata,Corporation Commissioner,Brian Bingman,REP,530204,0,0,26,26,
Nowata,State House,Travis Dunlap,REP,530204,1,1,24,26,10
Nowata,State House,Judd Strom,REP,530204,0,0,31,31,10
Nowata,Governor,Chris Powell,LIB,530204,0,0,1,1,
Nowata,Governor,Rex Lawhorn,LIB,530204,0,0,1,1,
Nowata,Corporation Commissioner,Ashley Nicole Mccray,DEM,530204,0,0,11,11,
Nowata,Corporation Commissioner,Blake Cummings,DEM,530204,0,0,13,13,
Nowata,U.S. House,Jason Nichols,DEM,530204,0,0,8,8,02
Nowata,U.S. House,Clay Padgett,DEM,530204,0,0,16,16,02
Nowata,Governor,Mick Cornett,REP,530301,0,4,43,47,
Nowata,Governor,Kevin Stitt,REP,530301,2,0,93,95,
Nowata,Lieutenant Governor,Dana Murphy,REP,530301,2,3,40,45,
Nowata,Lieutenant Governor,Matt Pinnell,REP,530301,0,1,92,93,
Nowata,State Auditor,Cindy Byrd,REP,530301,2,2,63,67,
Nowata,State Auditor,Charlie Prater,REP,530301,0,2,68,70,
Nowata,Attorney General,Mike Hunter,REP,530301,0,1,44,45,
Nowata,Attorney General,Gentner Drummond,REP,530301,2,3,87,92,
Nowata,Superintendent of Public Instruction,Joy Hofmeister,REP,530301,2,3,69,74,
Nowata,Superintendent of Public Instruction,Linda Murphy,REP,530301,0,1,64,65,
Nowata,Commissioner of Labor,Cathy Costello,REP,530301,0,4,57,61,
Nowata,Commissioner of Labor,Leslie Osborn,REP,530301,2,0,73,75,
Nowata,Corporation Commissioner,Bob Anthony,REP,530301,0,2,41,43,
Nowata,Corporation Commissioner,Brian Bingman,REP,530301,2,2,87,91,
Nowata,State House,Travis Dunlap,REP,530301,2,1,53,56,10
Nowata,State House,Judd Strom,REP,530301,0,3,80,83,10
Nowata,Governor,Chris Powell,LIB,530301,0,0,0,0,
Nowata,Governor,Rex Lawhorn,LIB,530301,0,0,0,0,
Nowata,Corporation Commissioner,Ashley Nicole Mccray,DEM,530301,4,0,26,30,
Nowata,Corporation Commissioner,Blake Cummings,DEM,530301,1,0,32,33,
Nowata,U.S. House,Jason Nichols,DEM,530301,1,0,33,34,02
Nowata,U.S. House,Clay Padgett,DEM,530301,4,0,24,28,02
Nowata,Governor,Mick Cornett,REP,530302,0,0,24,24,
Nowata,Governor,Kevin Stitt,REP,530302,1,6,25,32,
Nowata,Lieutenant Governor,Dana Murphy,REP,530302,0,2,19,21,
Nowata,Lieutenant Governor,Matt Pinnell,REP,530302,1,4,30,35,
Nowata,State Auditor,Cindy Byrd,REP,530302,1,2,24,27,
Nowata,State Auditor,Charlie Prater,REP,530302,0,4,23,27,
Nowata,Attorney General,Mike Hunter,REP,530302,1,3,17,21,
Nowata,Attorney General,Gentner Drummond,REP,530302,0,3,32,35,
Nowata,Superintendent of Public Instruction,Joy Hofmeister,REP,530302,0,1,36,37,
Nowata,Superintendent of Public Instruction,Linda Murphy,REP,530302,1,5,13,19,
Nowata,Commissioner of Labor,Cathy Costello,REP,530302,1,3,16,20,
Nowata,Commissioner of Labor,Leslie Osborn,REP,530302,0,3,32,35,
Nowata,Corporation Commissioner,Bob Anthony,REP,530302,1,0,19,20,
Nowata,Corporation Commissioner,Brian Bingman,REP,530302,0,6,30,36,
Nowata,State House,Travis Dunlap,REP,530302,1,3,20,24,10
Nowata,State House,Judd Strom,REP,530302,0,3,29,32,10
Nowata,Governor,Chris Powell,LIB,530302,0,0,1,1,
Nowata,Governor,Rex Lawhorn,LIB,530302,0,0,0,0,
Nowata,Corporation Commissioner,Ashley Nicole Mccray,DEM,530302,1,4,17,22,
Nowata,Corporation Commissioner,Blake Cummings,DEM,530302,0,3,10,13,
Nowata,U.S. House,Jason Nichols,DEM,530302,1,5,16,22,02
Nowata,U.S. House,Clay Padgett,DEM,530302,0,2,11,13,02
Nowata,Governor,Mick Cornett,REP,530303,0,0,18,18,
Nowata,Governor,Kevin Stitt,REP,530303,0,0,38,38,
Nowata,Lieutenant Governor,Dana Murphy,REP,530303,0,0,21,21,
Nowata,Lieutenant Governor,Matt Pinnell,REP,530303,0,0,34,34,
Nowata,State Auditor,Cindy Byrd,REP,530303,0,0,22,22,
Nowata,State Auditor,Charlie Prater,REP,530303,0,0,33,33,
Nowata,Attorney General,Mike Hunter,REP,530303,0,0,19,19,
Nowata,Attorney General,Gentner Drummond,REP,530303,0,0,36,36,
Nowata,Superintendent of Public Instruction,Joy Hofmeister,REP,530303,0,0,35,35,
Nowata,Superintendent of Public Instruction,Linda Murphy,REP,530303,0,0,21,21,
Nowata,Commissioner of Labor,Cathy Costello,REP,530303,0,0,26,26,
Nowata,Commissioner of Labor,Leslie Osborn,REP,530303,0,0,29,29,
Nowata,Corporation Commissioner,Bob Anthony,REP,530303,0,0,19,19,
Nowata,Corporation Commissioner,Brian Bingman,REP,530303,0,0,36,36,
Nowata,State House,Travis Dunlap,REP,530303,0,0,26,26,10
Nowata,State House,Judd Strom,REP,530303,0,0,30,30,10
Nowata,Governor,Chris Powell,LIB,530303,0,0,0,0,
Nowata,Governor,Rex Lawhorn,LIB,530303,0,0,0,0,
Nowata,Corporation Commissioner,Ashley Nicole Mccray,DEM,530303,0,0,16,16,
Nowata,Corporation Commissioner,Blake Cummings,DEM,530303,0,0,15,15,
Nowata,U.S. House,Jason Nichols,DEM,530303,0,0,20,20,02
Nowata,U.S. House,Clay Padgett,DEM,530303,0,0,11,11,02
Nowata,Governor,Mick Cornett,REP,530304,0,0,9,9,
Nowata,Governor,Kevin Stitt,REP,530304,2,0,10,12,
Nowata,Lieutenant Governor,Dana Murphy,REP,530304,0,0,4,4,
Nowata,Lieutenant Governor,Matt Pinnell,REP,530304,2,0,14,16,
Nowata,State Auditor,Cindy Byrd,REP,530304,2,0,9,11,
Nowata,State Auditor,Charlie Prater,REP,530304,0,0,10,10,
Nowata,Attorney General,Mike Hunter,REP,530304,0,0,13,13,
Nowata,Attorney General,Gentner Drummond,REP,530304,2,0,7,9,
Nowata,Superintendent of Public Instruction,Joy Hofmeister,REP,530304,1,0,11,12,
Nowata,Superintendent of Public Instruction,Linda Murphy,REP,530304,1,0,9,10,
Nowata,Commissioner of Labor,Cathy Costello,REP,530304,2,0,9,11,
Nowata,Commissioner of Labor,Leslie Osborn,REP,530304,0,0,8,8,
Nowata,Corporation Commissioner,Bob Anthony,REP,530304,1,0,6,7,
Nowata,Corporation Commissioner,Brian Bingman,REP,530304,1,0,12,13,
Nowata,State House,Travis Dunlap,REP,530304,1,0,6,7,10
Nowata,State House,Judd Strom,REP,530304,1,0,13,14,10
Nowata,Governor,Chris Powell,LIB,530304,0,0,0,0,
Nowata,Governor,Rex Lawhorn,LIB,530304,0,0,0,0,
Nowata,Corporation Commissioner,Ashley Nicole Mccray,DEM,530304,0,3,5,8,
Nowata,Corporation Commissioner,Blake Cummings,DEM,530304,1,0,11,12,
Nowata,U.S. House,Jason Nichols,DEM,530304,1,3,10,14,02
Nowata,U.S. House,Clay Padgett,DEM,530304,0,0,6,6,02
Okfuskee,Governor,Mick Cornett,REP,540101,0,2,66,68,
Okfuskee,Governor,Kevin Stitt,REP,540101,1,1,96,98,
Okfuskee,Lieutenant Governor,Dana Murphy,REP,540101,0,2,45,47,
Okfuskee,Lieutenant Governor,Matt Pinnell,REP,540101,1,1,112,114,
Okfuskee,State Auditor,Cindy Byrd,REP,540101,0,1,62,63,
Okfuskee,State Auditor,Charlie Prater,REP,540101,1,2,91,94,
Okfuskee,Attorney General,Mike Hunter,REP,540101,0,2,81,83,
Okfuskee,Attorney General,Gentner Drummond,REP,540101,1,1,79,81,
Okfuskee,Superintendent of Public Instruction,Joy Hofmeister,REP,540101,0,1,83,84,
Okfuskee,Superintendent of Public Instruction,Linda Murphy,REP,540101,1,2,76,79,
Okfuskee,Commissioner of Labor,Cathy Costello,REP,540101,1,1,65,67,
Okfuskee,Commissioner of Labor,Leslie Osborn,REP,540101,0,2,92,94,
Okfuskee,Corporation Commissioner,Bob Anthony,REP,540101,0,2,80,82,
Okfuskee,Corporation Commissioner,Brian Bingman,REP,540101,1,1,77,79,
Okfuskee,Governor,Chris Powell,LIB,540101,0,0,0,0,
Okfuskee,Governor,Rex Lawhorn,LIB,540101,0,1,0,1,
Okfuskee,Corporation Commissioner,Ashley Nicole Mccray,DEM,540101,3,2,35,40,
Okfuskee,Corporation Commissioner,Blake Cummings,DEM,540101,0,2,62,64,
Okfuskee,U.S. House,Jason Nichols,DEM,540101,2,1,60,63,02
Okfuskee,U.S. House,Clay Padgett,DEM,540101,1,3,39,43,02
Okfuskee,Governor,Mick Cornett,REP,540102,0,1,1,2,
Okfuskee,Governor,Kevin Stitt,REP,540102,3,0,4,7,
Okfuskee,Lieutenant Governor,Dana Murphy,REP,540102,0,1,0,1,
Okfuskee,Lieutenant Governor,Matt Pinnell,REP,540102,3,0,5,8,
Okfuskee,State Auditor,Cindy Byrd,REP,540102,3,1,2,6,
Okfuskee,State Auditor,Charlie Prater,REP,540102,0,0,3,3,
Okfuskee,Attorney General,Mike Hunter,REP,540102,0,0,4,4,
Okfuskee,Attorney General,Gentner Drummond,REP,540102,3,1,1,5,
Okfuskee,Superintendent of Public Instruction,Joy Hofmeister,REP,540102,3,1,3,7,
Okfuskee,Superintendent of Public Instruction,Linda Murphy,REP,540102,0,0,2,2,
Okfuskee,Commissioner of Labor,Cathy Costello,REP,540102,3,0,3,6,
Okfuskee,Commissioner of Labor,Leslie Osborn,REP,540102,0,1,2,3,
Okfuskee,Corporation Commissioner,Bob Anthony,REP,540102,0,1,5,6,
Okfuskee,Corporation Commissioner,Brian Bingman,REP,540102,3,0,0,3,
Okfuskee,Governor,Chris Powell,LIB,540102,0,0,0,0,
Okfuskee,Governor,Rex Lawhorn,LIB,540102,0,0,0,0,
Okfuskee,Corporation Commissioner,Ashley Nicole Mccray,DEM,540102,1,5,27,33,
Okfuskee,Corporation Commissioner,Blake Cummings,DEM,540102,3,1,7,11,
Okfuskee,U.S. House,Jason Nichols,DEM,540102,2,3,20,25,02
Okfuskee,U.S. House,Clay Padgett,DEM,540102,2,3,15,20,02
Okfuskee,Governor,Mick Cornett,REP,540103,0,1,6,7,
Okfuskee,Governor,Kevin Stitt,REP,540103,1,1,7,9,
Okfuskee,Lieutenant Governor,Dana Murphy,REP,540103,0,0,4,4,
Okfuskee,Lieutenant Governor,Matt Pinnell,REP,540103,1,2,8,11,
Okfuskee,State Auditor,Cindy Byrd,REP,540103,1,1,5,7,
Okfuskee,State Auditor,Charlie Prater,REP,540103,0,1,6,7,
Okfuskee,Attorney General,Mike Hunter,REP,540103,1,2,5,8,
Okfuskee,Attorney General,Gentner Drummond,REP,540103,0,0,8,8,
Okfuskee,Superintendent of Public Instruction,Joy Hofmeister,REP,540103,0,2,7,9,
Okfuskee,Superintendent of Public Instruction,Linda Murphy,REP,540103,1,0,6,7,
Okfuskee,Commissioner of Labor,Cathy Costello,REP,540103,0,1,4,5,
Okfuskee,Commissioner of Labor,Leslie Osborn,REP,540103,1,1,8,10,
Okfuskee,Corporation Commissioner,Bob Anthony,REP,540103,0,1,11,12,
Okfuskee,Corporation Commissioner,Brian Bingman,REP,540103,1,1,1,3,
Okfuskee,Governor,Chris Powell,LIB,540103,0,0,0,0,
Okfuskee,Governor,Rex Lawhorn,LIB,540103,0,0,0,0,
Okfuskee,Corporation Commissioner,Ashley Nicole Mccray,DEM,540103,0,0,14,14,
Okfuskee,Corporation Commissioner,Blake Cummings,DEM,540103,0,0,8,8,
Okfuskee,U.S. House,Jason Nichols,DEM,540103,0,0,17,17,02
Okfuskee,U.S. House,Clay Padgett,DEM,540103,0,0,5,5,02
Okfuskee,Governor,Mick Cornett,REP,540105,0,1,7,8,
Okfuskee,Governor,Kevin Stitt,REP,540105,1,0,12,13,
Okfuskee,Lieutenant Governor,Dana Murphy,REP,540105,0,0,5,5,
Okfuskee,Lieutenant Governor,Matt Pinnell,REP,540105,1,1,15,17,
Okfuskee,State Auditor,Cindy Byrd,REP,540105,0,0,8,8,
Okfuskee,State Auditor,Charlie Prater,REP,540105,1,1,12,14,
Okfuskee,Attorney General,Mike Hunter,REP,540105,1,0,10,11,
Okfuskee,Attorney General,Gentner Drummond,REP,540105,0,1,10,11,
Okfuskee,Superintendent of Public Instruction,Joy Hofmeister,REP,540105,0,1,3,4,
Okfuskee,Superintendent of Public Instruction,Linda Murphy,REP,540105,1,0,17,18,
Okfuskee,Commissioner of Labor,Cathy Costello,REP,540105,0,0,7,7,
Okfuskee,Commissioner of Labor,Leslie Osborn,REP,540105,1,1,13,15,
Okfuskee,Corporation Commissioner,Bob Anthony,REP,540105,1,1,7,9,
Okfuskee,Corporation Commissioner,Brian Bingman,REP,540105,0,0,12,12,
Okfuskee,Governor,Chris Powell,LIB,540105,0,0,1,1,
Okfuskee,Governor,Rex Lawhorn,LIB,540105,0,0,0,0,
Okfuskee,Corporation Commissioner,Ashley Nicole Mccray,DEM,540105,0,2,10,12,
Okfuskee,Corporation Commissioner,Blake Cummings,DEM,540105,1,5,10,16,
Okfuskee,U.S. House,Jason Nichols,DEM,540105,1,6,8,15,02
Okfuskee,U.S. House,Clay Padgett,DEM,540105,0,1,12,13,02
Okfuskee,Governor,Mick Cornett,REP,540206,3,0,18,21,
Okfuskee,Governor,Kevin Stitt,REP,540206,1,3,24,28,
Okfuskee,Lieutenant Governor,Dana Murphy,REP,540206,3,0,14,17,
Okfuskee,Lieutenant Governor,Matt Pinnell,REP,540206,1,3,27,31,
Okfuskee,State Auditor,Cindy Byrd,REP,540206,2,3,19,24,
Okfuskee,State Auditor,Charlie Prater,REP,540206,2,0,22,24,
Okfuskee,Attorney General,Mike Hunter,REP,540206,2,2,12,16,
Okfuskee,Attorney General,Gentner Drummond,REP,540206,1,1,29,31,
Okfuskee,Superintendent of Public Instruction,Joy Hofmeister,REP,540206,3,2,25,30,
Okfuskee,Superintendent of Public Instruction,Linda Murphy,REP,540206,1,1,17,19,
Okfuskee,Commissioner of Labor,Cathy Costello,REP,540206,3,2,15,20,
Okfuskee,Commissioner of Labor,Leslie Osborn,REP,540206,1,1,26,28,
Okfuskee,Corporation Commissioner,Bob Anthony,REP,540206,2,2,19,23,
Okfuskee,Corporation Commissioner,Brian Bingman,REP,540206,2,1,22,25,
Okfuskee,Governor,Chris Powell,LIB,540206,0,0,1,1,
Okfuskee,Governor,Rex Lawhorn,LIB,540206,0,0,0,0,
Okfuskee,Corporation Commissioner,Ashley Nicole Mccray,DEM,540206,2,1,7,10,
Okfuskee,Corporation Commissioner,Blake Cummings,DEM,540206,2,1,23,26,
Okfuskee,U.S. House,Jason Nichols,DEM,540206,2,0,17,19,02
Okfuskee,U.S. House,Clay Padgett,DEM,540206,2,2,14,18,02
Okfuskee,Governor,Mick Cornett,REP,540207,0,2,13,15,
Okfuskee,Governor,Kevin Stitt,REP,540207,2,1,12,15,
Okfuskee,Lieutenant Governor,Dana Murphy,REP,540207,0,2,12,14,
Okfuskee,Lieutenant Governor,Matt Pinnell,REP,540207,2,1,13,16,
Okfuskee,State Auditor,Cindy Byrd,REP,540207,1,3,11,15,
Okfuskee,State Auditor,Charlie Prater,REP,540207,1,0,11,12,
Okfuskee,Attorney General,Mike Hunter,REP,540207,0,1,10,11,
Okfuskee,Attorney General,Gentner Drummond,REP,540207,2,2,14,18,
Okfuskee,Superintendent of Public Instruction,Joy Hofmeister,REP,540207,0,2,19,21,
Okfuskee,Superintendent of Public Instruction,Linda Murphy,REP,540207,2,1,6,9,
Okfuskee,Commissioner of Labor,Cathy Costello,REP,540207,1,1,10,12,
Okfuskee,Commissioner of Labor,Leslie Osborn,REP,540207,1,2,13,16,
Okfuskee,Corporation Commissioner,Bob Anthony,REP,540207,0,2,12,14,
Okfuskee,Corporation Commissioner,Brian Bingman,REP,540207,2,1,12,15,
Okfuskee,Governor,Chris Powell,LIB,540207,0,0,0,0,
Okfuskee,Governor,Rex Lawhorn,LIB,540207,0,0,0,0,
Okfuskee,Corporation Commissioner,Ashley Nicole Mccray,DEM,540207,0,1,3,4,
Okfuskee,Corporation Commissioner,Blake Cummings,DEM,540207,0,0,8,8,
Okfuskee,U.S. House,Jason Nichols,DEM,540207,0,1,4,5,02
Okfuskee,U.S. House,Clay Padgett,DEM,540207,0,0,7,7,02
Okfuskee,Governor,Mick Cornett,REP,540208,1,5,30,36,
Okfuskee,Governor,Kevin Stitt,REP,540208,3,6,14,23,
Okfuskee,Lieutenant Governor,Dana Murphy,REP,540208,1,2,14,17,
Okfuskee,Lieutenant Governor,Matt Pinnell,REP,540208,3,9,29,41,
Okfuskee,State Auditor,Cindy Byrd,REP,540208,1,7,12,20,
Okfuskee,State Auditor,Charlie Prater,REP,540208,3,4,31,38,
Okfuskee,Attorney General,Mike Hunter,REP,540208,1,6,20,27,
Okfuskee,Attorney General,Gentner Drummond,REP,540208,3,5,24,32,
Okfuskee,Superintendent of Public Instruction,Joy Hofmeister,REP,540208,3,5,28,36,
Okfuskee,Superintendent of Public Instruction,Linda Murphy,REP,540208,1,6,16,23,
Okfuskee,Commissioner of Labor,Cathy Costello,REP,540208,2,3,13,18,
Okfuskee,Commissioner of Labor,Leslie Osborn,REP,540208,2,8,31,41,
Okfuskee,Corporation Commissioner,Bob Anthony,REP,540208,3,5,12,20,
Okfuskee,Corporation Commissioner,Brian Bingman,REP,540208,1,6,32,39,
Okfuskee,Governor,Chris Powell,LIB,540208,0,0,0,0,
Okfuskee,Governor,Rex Lawhorn,LIB,540208,0,0,0,0,
Okfuskee,Corporation Commissioner,Ashley Nicole Mccray,DEM,540208,1,4,11,16,
Okfuskee,Corporation Commissioner,Blake Cummings,DEM,540208,2,2,15,19,
Okfuskee,U.S. House,Jason Nichols,DEM,540208,1,5,19,25,02
Okfuskee,U.S. House,Clay Padgett,DEM,540208,2,1,8,11,02
Okfuskee,Governor,Mick Cornett,REP,540209,0,13,23,36,
Okfuskee,Governor,Kevin Stitt,REP,540209,2,4,40,46,
Okfuskee,Lieutenant Governor,Dana Murphy,REP,540209,2,7,22,31,
Okfuskee,Lieutenant Governor,Matt Pinnell,REP,540209,0,10,39,49,
Okfuskee,State Auditor,Cindy Byrd,REP,540209,1,6,29,36,
Okfuskee,State Auditor,Charlie Prater,REP,540209,1,11,31,43,
Okfuskee,Attorney General,Mike Hunter,REP,540209,2,11,32,45,
Okfuskee,Attorney General,Gentner Drummond,REP,540209,0,6,31,37,
Okfuskee,Superintendent of Public Instruction,Joy Hofmeister,REP,540209,1,11,39,51,
Okfuskee,Superintendent of Public Instruction,Linda Murphy,REP,540209,1,6,21,28,
Okfuskee,Commissioner of Labor,Cathy Costello,REP,540209,1,5,33,39,
Okfuskee,Commissioner of Labor,Leslie Osborn,REP,540209,1,12,29,42,
Okfuskee,Corporation Commissioner,Bob Anthony,REP,540209,1,12,31,44,
Okfuskee,Corporation Commissioner,Brian Bingman,REP,540209,1,5,29,35,
Okfuskee,Governor,Chris Powell,LIB,540209,0,0,0,0,
Okfuskee,Governor,Rex Lawhorn,LIB,540209,0,0,0,0,
Okfuskee,Corporation Commissioner,Ashley Nicole Mccray,DEM,540209,4,5,29,38,
Okfuskee,Corporation Commissioner,Blake Cummings,DEM,540209,1,7,48,56,
Okfuskee,U.S. House,Jason Nichols,DEM,540209,3,7,44,54,02
Okfuskee,U.S. House,Clay Padgett,DEM,540209,2,5,33,40,02
Okfuskee,Governor,Mick Cornett,REP,540210,0,0,13,13,
Okfuskee,Governor,Kevin Stitt,REP,540210,2,2,16,20,
Okfuskee,Lieutenant Governor,Dana Murphy,REP,540210,0,0,7,7,
Okfuskee,Lieutenant Governor,Matt Pinnell,REP,540210,2,2,22,26,
Okfuskee,State Auditor,Cindy Byrd,REP,540210,0,1,16,17,
Okfuskee,State Auditor,Charlie Prater,REP,540210,2,1,13,16,
Okfuskee,Attorney General,Mike Hunter,REP,540210,2,2,11,15,
Okfuskee,Attorney General,Gentner Drummond,REP,540210,0,0,18,18,
Okfuskee,Superintendent of Public Instruction,Joy Hofmeister,REP,540210,2,0,17,19,
Okfuskee,Superintendent of Public Instruction,Linda Murphy,REP,540210,0,2,12,14,
Okfuskee,Commissioner of Labor,Cathy Costello,REP,540210,2,1,7,10,
Okfuskee,Commissioner of Labor,Leslie Osborn,REP,540210,0,1,22,23,
Okfuskee,Corporation Commissioner,Bob Anthony,REP,540210,0,1,15,16,
Okfuskee,Corporation Commissioner,Brian Bingman,REP,540210,2,1,14,17,
Okfuskee,Governor,Chris Powell,LIB,540210,0,0,0,0,
Okfuskee,Governor,Rex Lawhorn,LIB,540210,0,0,0,0,
Okfuskee,Corporation Commissioner,Ashley Nicole Mccray,DEM,540210,0,1,7,8,
Okfuskee,Corporation Commissioner,Blake Cummings,DEM,540210,0,1,10,11,
Okfuskee,U.S. House,Jason Nichols,DEM,540210,0,1,8,9,02
Okfuskee,U.S. House,Clay Padgett,DEM,540210,0,1,9,10,02
Okfuskee,Governor,Mick Cornett,REP,540311,0,2,15,17,
Okfuskee,Governor,Kevin Stitt,REP,540311,1,1,27,29,
Okfuskee,Lieutenant Governor,Dana Murphy,REP,540311,0,0,19,19,
Okfuskee,Lieutenant Governor,Matt Pinnell,REP,540311,1,3,23,27,
Okfuskee,State Auditor,Cindy Byrd,REP,540311,1,1,16,18,
Okfuskee,State Auditor,Charlie Prater,REP,540311,0,3,26,29,
Okfuskee,Attorney General,Mike Hunter,REP,540311,0,0,20,20,
Okfuskee,Attorney General,Gentner Drummond,REP,540311,1,4,22,27,
Okfuskee,Superintendent of Public Instruction,Joy Hofmeister,REP,540311,0,2,20,22,
Okfuskee,Superintendent of Public Instruction,Linda Murphy,REP,540311,1,2,22,25,
Okfuskee,Commissioner of Labor,Cathy Costello,REP,540311,1,3,24,28,
Okfuskee,Commissioner of Labor,Leslie Osborn,REP,540311,0,1,18,19,
Okfuskee,Corporation Commissioner,Bob Anthony,REP,540311,0,3,24,27,
Okfuskee,Corporation Commissioner,Brian Bingman,REP,540311,1,1,18,20,
Okfuskee,Governor,Chris Powell,LIB,540311,0,0,0,0,
Okfuskee,Governor,Rex Lawhorn,LIB,540311,0,0,0,0,
Okfuskee,Corporation Commissioner,Ashley Nicole Mccray,DEM,540311,2,3,16,21,
Okfuskee,Corporation Commissioner,Blake Cummings,DEM,540311,0,0,17,17,
Okfuskee,U.S. House,Jason Nichols,DEM,540311,2,1,21,24,02
Okfuskee,U.S. House,Clay Padgett,DEM,540311,0,2,11,13,02
Okfuskee,Governor,Mick Cornett,REP,540312,0,0,14,14,
Okfuskee,Governor,Kevin Stitt,REP,540312,0,5,24,29,
Okfuskee,Lieutenant Governor,Dana Murphy,REP,540312,0,0,14,14,
Okfuskee,Lieutenant Governor,Matt Pinnell,REP,540312,0,5,23,28,
Okfuskee,State Auditor,Cindy Byrd,REP,540312,0,2,11,13,
Okfuskee,State Auditor,Charlie Prater,REP,540312,0,3,25,28,
Okfuskee,Attorney General,Mike Hunter,REP,540312,0,1,16,17,
Okfuskee,Attorney General,Gentner Drummond,REP,540312,0,4,22,26,
Okfuskee,Superintendent of Public Instruction,Joy Hofmeister,REP,540312,0,4,17,21,
Okfuskee,Superintendent of Public Instruction,Linda Murphy,REP,540312,0,1,21,22,
Okfuskee,Commissioner of Labor,Cathy Costello,REP,540312,0,2,15,17,
Okfuskee,Commissioner of Labor,Leslie Osborn,REP,540312,0,3,21,24,
Okfuskee,Corporation Commissioner,Bob Anthony,REP,540312,0,2,13,15,
Okfuskee,Corporation Commissioner,Brian Bingman,REP,540312,0,3,22,25,
Okfuskee,Governor,Chris Powell,LIB,540312,0,0,0,0,
Okfuskee,Governor,Rex Lawhorn,LIB,540312,0,0,1,1,
Okfuskee,Corporation Commissioner,Ashley Nicole Mccray,DEM,540312,1,0,13,14,
Okfuskee,Corporation Commissioner,Blake Cummings,DEM,540312,0,0,15,15,
Okfuskee,U.S. House,Jason Nichols,DEM,540312,1,0,12,13,02
Okfuskee,U.S. House,Clay Padgett,DEM,540312,0,0,17,17,02
Okfuskee,Governor,Mick Cornett,REP,540313,0,0,0,0,
Okfuskee,Governor,Kevin Stitt,REP,540313,0,0,3,3,
Okfuskee,Lieutenant Governor,Dana Murphy,REP,540313,0,0,1,1,
Okfuskee,Lieutenant Governor,Matt Pinnell,REP,540313,0,0,2,2,
Okfuskee,State Auditor,Cindy Byrd,REP,540313,0,0,1,1,
Okfuskee,State Auditor,Charlie Prater,REP,540313,0,0,2,2,
Okfuskee,Attorney General,Mike Hunter,REP,540313,0,0,1,1,
Okfuskee,Attorney General,Gentner Drummond,REP,540313,0,0,2,2,
Okfuskee,Superintendent of Public Instruction,Joy Hofmeister,REP,540313,0,0,2,2,
Okfuskee,Superintendent of Public Instruction,Linda Murphy,REP,540313,0,0,1,1,
Okfuskee,Commissioner of Labor,Cathy Costello,REP,540313,0,0,2,2,
Okfuskee,Commissioner of Labor,Leslie Osborn,REP,540313,0,0,1,1,
Okfuskee,Corporation Commissioner,Bob Anthony,REP,540313,0,0,1,1,
Okfuskee,Corporation Commissioner,Brian Bingman,REP,540313,0,0,2,2,
Okfuskee,Governor,Chris Powell,LIB,540313,0,0,0,0,
Okfuskee,Governor,Rex Lawhorn,LIB,540313,0,0,0,0,
Okfuskee,Corporation Commissioner,Ashley Nicole Mccray,DEM,540313,0,0,3,3,
Okfuskee,Corporation Commissioner,Blake Cummings,DEM,540313,0,0,12,12,
Okfuskee,U.S. House,Jason Nichols,DEM,540313,0,0,9,9,02
Okfuskee,U.S. House,Clay Padgett,DEM,540313,0,0,6,6,02
Okfuskee,Governor,Mick Cornett,REP,540314,1,5,6,12,
Okfuskee,Governor,Kevin Stitt,REP,540314,1,1,7,9,
Okfuskee,Lieutenant Governor,Dana Murphy,REP,540314,1,4,6,11,
Okfuskee,Lieutenant Governor,Matt Pinnell,REP,540314,1,2,7,10,
Okfuskee,State Auditor,Cindy Byrd,REP,540314,0,4,8,12,
Okfuskee,State Auditor,Charlie Prater,REP,540314,2,2,5,9,
Okfuskee,Attorney General,Mike Hunter,REP,540314,1,5,8,14,
Okfuskee,Attorney General,Gentner Drummond,REP,540314,1,1,5,7,
Okfuskee,Superintendent of Public Instruction,Joy Hofmeister,REP,540314,1,3,8,12,
Okfuskee,Superintendent of Public Instruction,Linda Murphy,REP,540314,1,3,5,9,
Okfuskee,Commissioner of Labor,Cathy Costello,REP,540314,0,3,6,9,
Okfuskee,Commissioner of Labor,Leslie Osborn,REP,540314,2,3,7,12,
Okfuskee,Corporation Commissioner,Bob Anthony,REP,540314,1,2,5,8,
Okfuskee,Corporation Commissioner,Brian Bingman,REP,540314,1,4,8,13,
Okfuskee,Governor,Chris Powell,LIB,540314,0,0,0,0,
Okfuskee,Governor,Rex Lawhorn,LIB,540314,0,0,0,0,
Okfuskee,Corporation Commissioner,Ashley Nicole Mccray,DEM,540314,3,4,14,21,
Okfuskee,Corporation Commissioner,Blake Cummings,DEM,540314,1,1,16,18,
Okfuskee,U.S. House,Jason Nichols,DEM,540314,2,4,19,25,02
Okfuskee,U.S. House,Clay Padgett,DEM,540314,2,1,11,14,02
Oklahoma,Governor,Mick Cornett,REP,550001,0,0,64,64,
Oklahoma,Governor,Kevin Stitt,REP,550001,0,0,72,72,
Oklahoma,Lieutenant Governor,Dana Murphy,REP,550001,0,0,61,61,
Oklahoma,Lieutenant Governor,Matt Pinnell,REP,550001,0,0,74,74,
Oklahoma,State Auditor,Cindy Byrd,REP,550001,0,0,59,59,
Oklahoma,State Auditor,Charlie Prater,REP,550001,0,0,75,75,
Oklahoma,Attorney General,Mike Hunter,REP,550001,0,0,69,69,
Oklahoma,Attorney General,Gentner Drummond,REP,550001,0,0,65,65,
Oklahoma,Superintendent of Public Instruction,Joy Hofmeister,REP,550001,0,0,72,72,
Oklahoma,Superintendent of Public Instruction,Linda Murphy,REP,550001,0,0,63,63,
Oklahoma,Commissioner of Labor,Cathy Costello,REP,550001,0,0,70,70,
Oklahoma,Commissioner of Labor,Leslie Osborn,REP,550001,0,0,65,65,
Oklahoma,Corporation Commissioner,Bob Anthony,REP,550001,0,0,64,64,
Oklahoma,Corporation Commissioner,Brian Bingman,REP,550001,0,0,71,71,
Oklahoma,State Senate,Lori Callahan,REP,550001,0,0,56,56,30
Oklahoma,State Senate,John Symcox,REP,550001,0,0,77,77,30
Oklahoma,Governor,Chris Powell,LIB,550001,0,0,0,0,
Oklahoma,Governor,Rex Lawhorn,LIB,550001,0,0,0,0,
Oklahoma,Corporation Commissioner,Ashley Nicole Mccray,DEM,550001,0,0,51,51,
Oklahoma,Corporation Commissioner,Blake Cummings,DEM,550001,0,0,14,14,
Oklahoma,U.S. House,Kendra Horn,DEM,550001,0,0,40,40,05
Oklahoma,U.S. House,Tom Guild,DEM,550001,0,0,26,26,05
Oklahoma,Governor,Mick Cornett,REP,550002,0,0,90,90,
Oklahoma,Governor,Kevin Stitt,REP,550002,0,0,109,109,
Oklahoma,Lieutenant Governor,Dana Murphy,REP,550002,0,0,89,89,
Oklahoma,Lieutenant Governor,Matt Pinnell,REP,550002,0,0,110,110,
Oklahoma,State Auditor,Cindy Byrd,REP,550002,0,0,91,91,
Oklahoma,State Auditor,Charlie Prater,REP,550002,0,0,101,101,
Oklahoma,Attorney General,Mike Hunter,REP,550002,0,0,114,114,
Oklahoma,Attorney General,Gentner Drummond,REP,550002,0,0,82,82,
Oklahoma,Superintendent of Public Instruction,Joy Hofmeister,REP,550002,0,0,118,118,
Oklahoma,Superintendent of Public Instruction,Linda Murphy,REP,550002,0,0,78,78,
Oklahoma,Commissioner of Labor,Cathy Costello,REP,550002,0,0,107,107,
Oklahoma,Commissioner of Labor,Leslie Osborn,REP,550002,0,0,85,85,
Oklahoma,Corporation Commissioner,Bob Anthony,REP,550002,0,0,121,121,
Oklahoma,Corporation Commissioner,Brian Bingman,REP,550002,0,0,76,76,
Oklahoma,State Senate,Lori Callahan,REP,550002,0,0,106,106,30
Oklahoma,State Senate,John Symcox,REP,550002,0,0,92,92,30
Oklahoma,Governor,Chris Powell,LIB,550002,0,0,1,1,
Oklahoma,Governor,Rex Lawhorn,LIB,550002,0,0,0,0,
Oklahoma,Corporation Commissioner,Ashley Nicole Mccray,DEM,550002,0,0,41,41,
Oklahoma,Corporation Commissioner,Blake Cummings,DEM,550002,0,0,13,13,
Oklahoma,U.S. House,Kendra Horn,DEM,550002,0,0,40,40,05
Oklahoma,U.S. House,Tom Guild,DEM,550002,0,0,13,13,05
Oklahoma,Governor,Mick Cornett,REP,550003,0,0,152,152,
Oklahoma,Governor,Kevin Stitt,REP,550003,0,0,146,146,
Oklahoma,Lieutenant Governor,Dana Murphy,REP,550003,0,0,118,118,
Oklahoma,Lieutenant Governor,Matt Pinnell,REP,550003,0,0,172,172,
Oklahoma,State Auditor,Cindy Byrd,REP,550003,0,0,138,138,
Oklahoma,State Auditor,Charlie Prater,REP,550003,0,0,149,149,
Oklahoma,Attorney General,Mike Hunter,REP,550003,0,0,158,158,
Oklahoma,Attorney General,Gentner Drummond,REP,550003,0,0,131,131,
Oklahoma,Superintendent of Public Instruction,Joy Hofmeister,REP,550003,0,0,185,185,
Oklahoma,Superintendent of Public Instruction,Linda Murphy,REP,550003,0,0,106,106,
Oklahoma,Commissioner of Labor,Cathy Costello,REP,550003,0,0,135,135,
Oklahoma,Commissioner of Labor,Leslie Osborn,REP,550003,0,0,162,162,
Oklahoma,Corporation Commissioner,Bob Anthony,REP,550003,0,0,166,166,
Oklahoma,Corporation Commissioner,Brian Bingman,REP,550003,0,0,127,127,
Oklahoma,State Senate,Lori Callahan,REP,550003,0,0,126,126,30
Oklahoma,State Senate,John Symcox,REP,550003,0,0,170,170,30
Oklahoma,Governor,Chris Powell,LIB,550003,0,0,0,0,
Oklahoma,Governor,Rex Lawhorn,LIB,550003,0,0,0,0,
Oklahoma,Corporation Commissioner,Ashley Nicole Mccray,DEM,550003,0,0,50,50,
Oklahoma,Corporation Commissioner,Blake Cummings,DEM,550003,0,0,24,24,
Oklahoma,U.S. House,Kendra Horn,DEM,550003,0,0,56,56,05
Oklahoma,U.S. House,Tom Guild,DEM,550003,0,0,18,18,05
Oklahoma,Governor,Mick Cornett,REP,550004,0,0,176,176,
Oklahoma,Governor,Kevin Stitt,REP,550004,0,0,157,157,
Oklahoma,Lieutenant Governor,Dana Murphy,REP,550004,0,0,162,162,
Oklahoma,Lieutenant Governor,Matt Pinnell,REP,550004,0,0,165,165,
Oklahoma,State Auditor,Cindy Byrd,REP,550004,0,0,161,161,
Oklahoma,State Auditor,Charlie Prater,REP,550004,0,0,158,158,
Oklahoma,Attorney General,Mike Hunter,REP,550004,0,0,193,193,
Oklahoma,Attorney General,Gentner Drummond,REP,550004,0,0,132,132,
Oklahoma,Superintendent of Public Instruction,Joy Hofmeister,REP,550004,0,0,199,199,
Oklahoma,Superintendent of Public Instruction,Linda Murphy,REP,550004,0,0,125,125,
Oklahoma,Commissioner of Labor,Cathy Costello,REP,550004,0,0,161,161,
Oklahoma,Commissioner of Labor,Leslie Osborn,REP,550004,0,0,156,156,
Oklahoma,Corporation Commissioner,Bob Anthony,REP,550004,0,0,199,199,
Oklahoma,Corporation Commissioner,Brian Bingman,REP,550004,0,0,124,124,
Oklahoma,State Senate,Lori Callahan,REP,550004,0,0,140,140,30
Oklahoma,State Senate,John Symcox,REP,550004,0,0,191,191,30
Oklahoma,Governor,Chris Powell,LIB,550004,0,0,0,0,
Oklahoma,Governor,Rex Lawhorn,LIB,550004,0,0,2,2,
Oklahoma,Corporation Commissioner,Ashley Nicole Mccray,DEM,550004,0,0,59,59,
Oklahoma,Corporation Commissioner,Blake Cummings,DEM,550004,0,0,21,21,
Oklahoma,U.S. House,Kendra Horn,DEM,550004,0,0,58,58,05
Oklahoma,U.S. House,Tom Guild,DEM,550004,0,0,23,23,05
Oklahoma,Governor,Mick Cornett,REP,550005,0,0,109,109,
Oklahoma,Governor,Kevin Stitt,REP,550005,0,0,107,107,
Oklahoma,Lieutenant Governor,Dana Murphy,REP,550005,0,0,88,88,
Oklahoma,Lieutenant Governor,Matt Pinnell,REP,550005,0,0,119,119,
Oklahoma,State Auditor,Cindy Byrd,REP,550005,0,0,106,106,
Oklahoma,State Auditor,Charlie Prater,REP,550005,0,0,105,105,
Oklahoma,Attorney General,Mike Hunter,REP,550005,0,0,126,126,
Oklahoma,Attorney General,Gentner Drummond,REP,550005,0,0,85,85,
Oklahoma,Superintendent of Public Instruction,Joy Hofmeister,REP,550005,0,0,129,129,
Oklahoma,Superintendent of Public Instruction,Linda Murphy,REP,550005,0,0,80,80,
Oklahoma,Commissioner of Labor,Cathy Costello,REP,550005,0,0,92,92,
Oklahoma,Commissioner of Labor,Leslie Osborn,REP,550005,0,0,115,115,
Oklahoma,Corporation Commissioner,Bob Anthony,REP,550005,0,0,119,119,
Oklahoma,Corporation Commissioner,Brian Bingman,REP,550005,0,0,86,86,
Oklahoma,Governor,Chris Powell,LIB,550005,0,0,0,0,
Oklahoma,Governor,Rex Lawhorn,LIB,550005,0,0,3,3,
Oklahoma,Corporation Commissioner,Ashley Nicole Mccray,DEM,550005,0,0,66,66,
Oklahoma,Corporation Commissioner,Blake Cummings,DEM,550005,0,0,20,20,
Oklahoma,U.S. House,Kendra Horn,DEM,550005,0,0,55,55,05
Oklahoma,U.S. House,Tom Guild,DEM,550005,0,0,31,31,05
Oklahoma,Governor,Mick Cornett,REP,550006,0,0,83,83,
Oklahoma,Governor,Kevin Stitt,REP,550006,0,0,75,75,
Oklahoma,Lieutenant Governor,Dana Murphy,REP,550006,0,0,64,64,
Oklahoma,Lieutenant Governor,Matt Pinnell,REP,550006,0,0,87,87,
Oklahoma,State Auditor,Cindy Byrd,REP,550006,0,0,73,73,
Oklahoma,State Auditor,Charlie Prater,REP,550006,0,0,75,75,
Oklahoma,Attorney General,Mike Hunter,REP,550006,0,0,80,80,
Oklahoma,Attorney General,Gentner Drummond,REP,550006,0,0,73,73,
Oklahoma,Superintendent of Public Instruction,Joy Hofmeister,REP,550006,0,0,81,81,
Oklahoma,Superintendent of Public Instruction,Linda Murphy,REP,550006,0,0,72,72,
Oklahoma,Commissioner of Labor,Cathy Costello,REP,550006,0,0,78,78,
Oklahoma,Commissioner of Labor,Leslie Osborn,REP,550006,0,0,77,77,
Oklahoma,Corporation Commissioner,Bob Anthony,REP,550006,0,0,79,79,
Oklahoma,Corporation Commissioner,Brian Bingman,REP,550006,0,0,75,75,
Oklahoma,State Senate,Lori Callahan,REP,550006,0,0,65,65,30
Oklahoma,State Senate,John Symcox,REP,550006,0,0,83,83,30
Oklahoma,Governor,Chris Powell,LIB,550006,0,0,2,2,
Oklahoma,Governor,Rex Lawhorn,LIB,550006,0,0,0,0,
Oklahoma,Corporation Commissioner,Ashley Nicole Mccray,DEM,550006,0,0,38,38,
Oklahoma,Corporation Commissioner,Blake Cummings,DEM,550006,0,0,9,9,
Oklahoma,U.S. House,Kendra Horn,DEM,550006,0,0,35,35,05
Oklahoma,U.S. House,Tom Guild,DEM,550006,0,0,13,13,05
Oklahoma,Governor,Mick Cornett,REP,550007,0,0,174,174,
Oklahoma,Governor,Kevin Stitt,REP,550007,0,0,143,143,
Oklahoma,Lieutenant Governor,Dana Murphy,REP,550007,0,0,129,129,
Oklahoma,Lieutenant Governor,Matt Pinnell,REP,550007,0,0,180,180,
Oklahoma,State Auditor,Cindy Byrd,REP,550007,0,0,155,155,
Oklahoma,State Auditor,Charlie Prater,REP,550007,0,0,144,144,
Oklahoma,Attorney General,Mike Hunter,REP,550007,0,0,211,211,
Oklahoma,Attorney General,Gentner Drummond,REP,550007,0,0,97,97,
Oklahoma,Superintendent of Public Instruction,Joy Hofmeister,REP,550007,0,0,196,196,
Oklahoma,Superintendent of Public Instruction,Linda Murphy,REP,550007,0,0,114,114,
Oklahoma,Commissioner of Labor,Cathy Costello,REP,550007,0,0,156,156,
Oklahoma,Commissioner of Labor,Leslie Osborn,REP,550007,0,0,151,151,
Oklahoma,Corporation Commissioner,Bob Anthony,REP,550007,0,0,210,210,
Oklahoma,Corporation Commissioner,Brian Bingman,REP,550007,0,0,99,99,
Oklahoma,Governor,Chris Powell,LIB,550007,0,0,0,0,
Oklahoma,Governor,Rex Lawhorn,LIB,550007,0,0,0,0,
Oklahoma,Corporation Commissioner,Ashley Nicole Mccray,DEM,550007,0,0,55,55,
Oklahoma,Corporation Commissioner,Blake Cummings,DEM,550007,0,0,24,24,
Oklahoma,U.S. House,Kendra Horn,DEM,550007,0,0,58,58,05
Oklahoma,U.S. House,Tom Guild,DEM,550007,0,0,22,22,05
Oklahoma,Governor,Mick Cornett,REP,550008,0,0,117,117,
Oklahoma,Governor,Kevin Stitt,REP,550008,0,0,76,76,
Oklahoma,Lieutenant Governor,Dana Murphy,REP,550008,0,0,90,90,
Oklahoma,Lieutenant Governor,Matt Pinnell,REP,550008,0,0,90,90,
Oklahoma,State Auditor,Cindy Byrd,REP,550008,0,0,78,78,
Oklahoma,State Auditor,Charlie Prater,REP,550008,0,0,96,96,
Oklahoma,Attorney General,Mike Hunter,REP,550008,0,0,115,115,
Oklahoma,Attorney General,Gentner Drummond,REP,550008,0,0,69,69,
Oklahoma,Superintendent of Public Instruction,Joy Hofmeister,REP,550008,0,0,122,122,
Oklahoma,Superintendent of Public Instruction,Linda Murphy,REP,550008,0,0,61,61,
Oklahoma,Commissioner of Labor,Cathy Costello,REP,550008,0,0,85,85,
Oklahoma,Commissioner of Labor,Leslie Osborn,REP,550008,0,0,96,96,
Oklahoma,Corporation Commissioner,Bob Anthony,REP,550008,0,0,122,122,
Oklahoma,Corporation Commissioner,Brian Bingman,REP,550008,0,0,66,66,
Oklahoma,State Senate,Lori Callahan,REP,550008,0,0,67,67,30
Oklahoma,State Senate,John Symcox,REP,550008,0,0,114,114,30
Oklahoma,Governor,Chris Powell,LIB,550008,0,0,0,0,
Oklahoma,Governor,Rex Lawhorn,LIB,550008,0,0,0,0,
Oklahoma,Corporation Commissioner,Ashley Nicole Mccray,DEM,550008,0,0,18,18,
Oklahoma,Corporation Commissioner,Blake Cummings,DEM,550008,0,0,14,14,
Oklahoma,U.S. House,Kendra Horn,DEM,550008,0,0,19,19,05
Oklahoma,U.S. House,Tom Guild,DEM,550008,0,0,12,12,05
Oklahoma,Governor,Mick Cornett,REP,550009,0,0,100,100,
Oklahoma,Governor,Kevin Stitt,REP,550009,0,0,86,86,
Oklahoma,Lieutenant Governor,Dana Murphy,REP,550009,0,0,91,91,
Oklahoma,Lieutenant Governor,Matt Pinnell,REP,550009,0,0,93,93,
Oklahoma,State Auditor,Cindy Byrd,REP,550009,0,0,102,102,
Oklahoma,State Auditor,Charlie Prater,REP,550009,0,0,79,79,
Oklahoma,Attorney General,Mike Hunter,REP,550009,0,0,97,97,
Oklahoma,Attorney General,Gentner Drummond,REP,550009,0,0,82,82,
Oklahoma,Superintendent of Public Instruction,Joy Hofmeister,REP,550009,0,0,109,109,
Oklahoma,Superintendent of Public Instruction,Linda Murphy,REP,550009,0,0,71,71,
Oklahoma,Commissioner of Labor,Cathy Costello,REP,550009,0,0,88,88,
Oklahoma,Commissioner of Labor,Leslie Osborn,REP,550009,0,0,91,91,
Oklahoma,Corporation Commissioner,Bob Anthony,REP,550009,0,0,111,111,
Oklahoma,Corporation Commissioner,Brian Bingman,REP,550009,0,0,72,72,
Oklahoma,State Senate,Lori Callahan,REP,550009,0,0,86,86,30
Oklahoma,State Senate,John Symcox,REP,550009,0,0,97,97,30
Oklahoma,State House,Julie Roach,REP,550009,0,0,49,49,10
Oklahoma,State House,Marilyn Stark,REP,550009,0,0,129,129,10
Oklahoma,Governor,Chris Powell,LIB,550009,0,0,1,1,
Oklahoma,Governor,Rex Lawhorn,LIB,550009,0,0,0,0,
Oklahoma,Corporation Commissioner,Ashley Nicole Mccray,DEM,550009,0,0,21,21,
Oklahoma,Corporation Commissioner,Blake Cummings,DEM,550009,0,0,6,6,
Oklahoma,U.S. House,Kendra Horn,DEM,550009,0,0,18,18,05
Oklahoma,U.S. House,Tom Guild,DEM,550009,0,0,9,9,05
Oklahoma,Governor,Mick Cornett,REP,550010,0,0,67,67,
Oklahoma,Governor,Kevin Stitt,REP,550010,0,0,51,51,
Oklahoma,Lieutenant Governor,Dana Murphy,REP,550010,0,0,44,44,
Oklahoma,Lieutenant Governor,Matt Pinnell,REP,550010,0,0,70,70,
Oklahoma,State Auditor,Cindy Byrd,REP,550010,0,0,60,60,
Oklahoma,State Auditor,Charlie Prater,REP,550010,0,0,47,47,
Oklahoma,Attorney General,Mike Hunter,REP,550010,0,0,60,60,
Oklahoma,Attorney General,Gentner Drummond,REP,550010,0,0,56,56,
Oklahoma,Superintendent of Public Instruction,Joy Hofmeister,REP,550010,0,0,68,68,
Oklahoma,Superintendent of Public Instruction,Linda Murphy,REP,550010,0,0,48,48,
Oklahoma,Commissioner of Labor,Cathy Costello,REP,550010,0,0,61,61,
Oklahoma,Commissioner of Labor,Leslie Osborn,REP,550010,0,0,51,51,
Oklahoma,Corporation Commissioner,Bob Anthony,REP,550010,0,0,67,67,
Oklahoma,Corporation Commissioner,Brian Bingman,REP,550010,0,0,47,47,
Oklahoma,State Senate,Lori Callahan,REP,550010,0,0,43,43,30
Oklahoma,State Senate,John Symcox,REP,550010,0,0,73,73,30
Oklahoma,Governor,Chris Powell,LIB,550010,0,0,0,0,
Oklahoma,Governor,Rex Lawhorn,LIB,550010,0,0,0,0,
Oklahoma,Corporation Commissioner,Ashley Nicole Mccray,DEM,550010,0,0,27,27,
Oklahoma,Corporation Commissioner,Blake Cummings,DEM,550010,0,0,6,6,
Oklahoma,U.S. House,Kendra Horn,DEM,550010,0,0,28,28,05
Oklahoma,U.S. House,Tom Guild,DEM,550010,0,0,5,5,05
Oklahoma,Governor,Mick Cornett,REP,550011,0,0,74,74,
Oklahoma,Governor,Kevin Stitt,REP,550011,0,0,80,80,
Oklahoma,Lieutenant Governor,Dana Murphy,REP,550011,0,0,66,66,
Oklahoma,Lieutenant Governor,Matt Pinnell,REP,550011,0,0,84,84,
Oklahoma,State Auditor,Cindy Byrd,REP,550011,0,0,84,84,
Oklahoma,State Auditor,Charlie Prater,REP,550011,0,0,67,67,
Oklahoma,Attorney General,Mike Hunter,REP,550011,0,0,91,91,
Oklahoma,Attorney General,Gentner Drummond,REP,550011,0,0,61,61,
Oklahoma,Superintendent of Public Instruction,Joy Hofmeister,REP,550011,0,0,82,82,
Oklahoma,Superintendent of Public Instruction,Linda Murphy,REP,550011,0,0,70,70,
Oklahoma,Commissioner of Labor,Cathy Costello,REP,550011,0,0,69,69,
Oklahoma,Commissioner of Labor,Leslie Osborn,REP,550011,0,0,82,82,
Oklahoma,Corporation Commissioner,Bob Anthony,REP,550011,0,0,70,70,
Oklahoma,Corporation Commissioner,Brian Bingman,REP,550011,0,0,80,80,
Oklahoma,Governor,Chris Powell,LIB,550011,0,0,0,0,
Oklahoma,Governor,Rex Lawhorn,LIB,550011,0,0,0,0,
Oklahoma,Corporation Commissioner,Ashley Nicole Mccray,DEM,550011,0,0,56,56,
Oklahoma,Corporation Commissioner,Blake Cummings,DEM,550011,0,0,14,14,
Oklahoma,U.S. House,Kendra Horn,DEM,550011,0,0,59,59,05
Oklahoma,U.S. House,Tom Guild,DEM,550011,0,0,14,14,05
Oklahoma,Governor,Mick Cornett,REP,550012,0,0,175,175,
Oklahoma,Governor,Kevin Stitt,REP,550012,0,0,127,127,
Oklahoma,Lieutenant Governor,Dana Murphy,REP,550012,0,0,132,132,
Oklahoma,Lieutenant Governor,Matt Pinnell,REP,550012,0,0,156,156,
Oklahoma,State Auditor,Cindy Byrd,REP,550012,0,0,135,135,
Oklahoma,State Auditor,Charlie Prater,REP,550012,0,0,144,144,
Oklahoma,Attorney General,Mike Hunter,REP,550012,0,0,181,181,
Oklahoma,Attorney General,Gentner Drummond,REP,550012,0,0,107,107,
Oklahoma,Superintendent of Public Instruction,Joy Hofmeister,REP,550012,0,0,178,178,
Oklahoma,Superintendent of Public Instruction,Linda Murphy,REP,550012,0,0,112,112,
Oklahoma,Commissioner of Labor,Cathy Costello,REP,550012,0,0,154,154,
Oklahoma,Commissioner of Labor,Leslie Osborn,REP,550012,0,0,133,133,
Oklahoma,Corporation Commissioner,Bob Anthony,REP,550012,0,0,176,176,
Oklahoma,Corporation Commissioner,Brian Bingman,REP,550012,0,0,117,117,
Oklahoma,Governor,Chris Powell,LIB,550012,0,0,0,0,
Oklahoma,Governor,Rex Lawhorn,LIB,550012,0,0,2,2,
Oklahoma,Corporation Commissioner,Ashley Nicole Mccray,DEM,550012,0,0,102,102,
Oklahoma,Corporation Commissioner,Blake Cummings,DEM,550012,0,0,33,33,
Oklahoma,U.S. House,Kendra Horn,DEM,550012,0,0,110,110,05
Oklahoma,U.S. House,Tom Guild,DEM,550012,0,0,25,25,05
Oklahoma,Governor,Mick Cornett,REP,550013,0,0,120,120,
Oklahoma,Governor,Kevin Stitt,REP,550013,0,0,103,103,
Oklahoma,Lieutenant Governor,Dana Murphy,REP,550013,0,0,95,95,
Oklahoma,Lieutenant Governor,Matt Pinnell,REP,550013,0,0,123,123,
Oklahoma,State Auditor,Cindy Byrd,REP,550013,0,0,94,94,
Oklahoma,State Auditor,Charlie Prater,REP,550013,0,0,118,118,
Oklahoma,Attorney General,Mike Hunter,REP,550013,0,0,139,139,
Oklahoma,Attorney General,Gentner Drummond,REP,550013,0,0,78,78,
Oklahoma,Superintendent of Public Instruction,Joy Hofmeister,REP,550013,0,0,117,117,
Oklahoma,Superintendent of Public Instruction,Linda Murphy,REP,550013,0,0,93,93,
Oklahoma,Commissioner of Labor,Cathy Costello,REP,550013,0,0,121,121,
Oklahoma,Commissioner of Labor,Leslie Osborn,REP,550013,0,0,89,89,
Oklahoma,Corporation Commissioner,Bob Anthony,REP,550013,0,0,112,112,
Oklahoma,Corporation Commissioner,Brian Bingman,REP,550013,0,0,99,99,
Oklahoma,State Senate,Lori Callahan,REP,550013,0,0,68,68,30
Oklahoma,State Senate,John Symcox,REP,550013,0,0,148,148,30
Oklahoma,State House,Julie Roach,REP,550013,0,0,67,67,10
Oklahoma,State House,Marilyn Stark,REP,550013,0,0,141,141,10
Oklahoma,Governor,Chris Powell,LIB,550013,0,0,1,1,
Oklahoma,Governor,Rex Lawhorn,LIB,550013,0,0,0,0,
Oklahoma,Corporation Commissioner,Ashley Nicole Mccray,DEM,550013,0,0,35,35,
Oklahoma,Corporation Commissioner,Blake Cummings,DEM,550013,0,0,14,14,
Oklahoma,U.S. House,Kendra Horn,DEM,550013,0,0,34,34,05
Oklahoma,U.S. House,Tom Guild,DEM,550013,0,0,18,18,05
Oklahoma,Governor,Mick Cornett,REP,550014,0,0,109,109,
Oklahoma,Governor,Kevin Stitt,REP,550014,0,0,86,86,
Oklahoma,Lieutenant Governor,Dana Murphy,REP,550014,0,0,87,87,
Oklahoma,Lieutenant Governor,Matt Pinnell,REP,550014,0,0,104,104,
Oklahoma,State Auditor,Cindy Byrd,REP,550014,0,0,95,95,
Oklahoma,State Auditor,Charlie Prater,REP,550014,0,0,91,91,
Oklahoma,Attorney General,Mike Hunter,REP,550014,0,0,104,104,
Oklahoma,Attorney General,Gentner Drummond,REP,550014,0,0,85,85,
Oklahoma,Superintendent of Public Instruction,Joy Hofmeister,REP,550014,0,0,119,119,
Oklahoma,Superintendent of Public Instruction,Linda Murphy,REP,550014,0,0,71,71,
Oklahoma,Commissioner of Labor,Cathy Costello,REP,550014,0,0,79,79,
Oklahoma,Commissioner of Labor,Leslie Osborn,REP,550014,0,0,110,110,
Oklahoma,Corporation Commissioner,Bob Anthony,REP,550014,0,0,106,106,
Oklahoma,Corporation Commissioner,Brian Bingman,REP,550014,0,0,82,82,
Oklahoma,State Senate,Lori Callahan,REP,550014,0,0,85,85,30
Oklahoma,State Senate,John Symcox,REP,550014,0,0,103,103,30
Oklahoma,Governor,Chris Powell,LIB,550014,0,0,0,0,
Oklahoma,Governor,Rex Lawhorn,LIB,550014,0,0,0,0,
Oklahoma,Corporation Commissioner,Ashley Nicole Mccray,DEM,550014,0,0,65,65,
Oklahoma,Corporation Commissioner,Blake Cummings,DEM,550014,0,0,19,19,
Oklahoma,U.S. House,Kendra Horn,DEM,550014,0,0,70,70,05
Oklahoma,U.S. House,Tom Guild,DEM,550014,0,0,15,15,05
Oklahoma,Governor,Mick Cornett,REP,550015,0,0,137,137,
Oklahoma,Governor,Kevin Stitt,REP,550015,0,0,117,117,
Oklahoma,Lieutenant Governor,Dana Murphy,REP,550015,0,0,102,102,
Oklahoma,Lieutenant Governor,Matt Pinnell,REP,550015,0,0,141,141,
Oklahoma,State Auditor,Cindy Byrd,REP,550015,0,0,106,106,
Oklahoma,State Auditor,Charlie Prater,REP,550015,0,0,130,130,
Oklahoma,Attorney General,Mike Hunter,REP,550015,0,0,160,160,
Oklahoma,Attorney General,Gentner Drummond,REP,550015,0,0,86,86,
Oklahoma,Superintendent of Public Instruction,Joy Hofmeister,REP,550015,0,0,140,140,
Oklahoma,Superintendent of Public Instruction,Linda Murphy,REP,550015,0,0,105,105,
Oklahoma,Commissioner of Labor,Cathy Costello,REP,550015,0,0,113,113,
Oklahoma,Commissioner of Labor,Leslie Osborn,REP,550015,0,0,132,132,
Oklahoma,Corporation Commissioner,Bob Anthony,REP,550015,0,0,149,149,
Oklahoma,Corporation Commissioner,Brian Bingman,REP,550015,0,0,93,93,
Oklahoma,Governor,Chris Powell,LIB,550015,0,0,1,1,
Oklahoma,Governor,Rex Lawhorn,LIB,550015,0,0,1,1,
Oklahoma,Corporation Commissioner,Ashley Nicole Mccray,DEM,550015,0,0,124,124,
Oklahoma,Corporation Commissioner,Blake Cummings,DEM,550015,0,0,25,25,
Oklahoma,U.S. House,Kendra Horn,DEM,550015,0,0,131,131,05
Oklahoma,U.S. House,Tom Guild,DEM,550015,0,0,19,19,05
Oklahoma,Governor,Mick Cornett,REP,550016,0,0,53,53,
Oklahoma,Governor,Kevin Stitt,REP,550016,0,0,19,19,
Oklahoma,Lieutenant Governor,Dana Murphy,REP,550016,0,0,29,29,
Oklahoma,Lieutenant Governor,Matt Pinnell,REP,550016,0,0,37,37,
Oklahoma,State Auditor,Cindy Byrd,REP,550016,0,0,37,37,
Oklahoma,State Auditor,Charlie Prater,REP,550016,0,0,28,28,
Oklahoma,Attorney General,Mike Hunter,REP,550016,0,0,47,47,
Oklahoma,Attorney General,Gentner Drummond,REP,550016,0,0,24,24,
Oklahoma,Superintendent of Public Instruction,Joy Hofmeister,REP,550016,0,0,49,49,
Oklahoma,Superintendent of Public Instruction,Linda Murphy,REP,550016,0,0,21,21,
Oklahoma,Commissioner of Labor,Cathy Costello,REP,550016,0,0,30,30,
Oklahoma,Commissioner of Labor,Leslie Osborn,REP,550016,0,0,38,38,
Oklahoma,Corporation Commissioner,Bob Anthony,REP,550016,0,0,45,45,
Oklahoma,Corporation Commissioner,Brian Bingman,REP,550016,0,0,25,25,
Oklahoma,Governor,Chris Powell,LIB,550016,0,0,0,0,
Oklahoma,Governor,Rex Lawhorn,LIB,550016,0,0,0,0,
Oklahoma,Corporation Commissioner,Ashley Nicole Mccray,DEM,550016,0,0,17,17,
Oklahoma,Corporation Commissioner,Blake Cummings,DEM,550016,0,0,5,5,
Oklahoma,U.S. House,Kendra Horn,DEM,550016,0,0,19,19,05
Oklahoma,U.S. House,Tom Guild,DEM,550016,0,0,2,2,05
Oklahoma,Governor,Mick Cornett,REP,550017,0,0,0,0,
Oklahoma,Governor,Kevin Stitt,REP,550017,0,0,0,0,
Oklahoma,Lieutenant Governor,Dana Murphy,REP,550017,0,0,0,0,
Oklahoma,Lieutenant Governor,Matt Pinnell,REP,550017,0,0,0,0,
Oklahoma,State Auditor,Cindy Byrd,REP,550017,0,0,0,0,
Oklahoma,State Auditor,Charlie Prater,REP,550017,0,0,0,0,
Oklahoma,Attorney General,Mike Hunter,REP,550017,0,0,0,0,
Oklahoma,Attorney General,Gentner Drummond,REP,550017,0,0,0,0,
Oklahoma,Superintendent of Public Instruction,Joy Hofmeister,REP,550017,0,0,0,0,
Oklahoma,Superintendent of Public Instruction,Linda Murphy,REP,550017,0,0,0,0,
Oklahoma,Commissioner of Labor,Cathy Costello,REP,550017,0,0,0,0,
Oklahoma,Commissioner of Labor,Leslie Osborn,REP,550017,0,0,0,0,
Oklahoma,Corporation Commissioner,Bob Anthony,REP,550017,0,0,0,0,
Oklahoma,Corporation Commissioner,Brian Bingman,REP,550017,0,0,0,0,
Oklahoma,State Senate,Lori Callahan,REP,550017,0,0,0,0,30
Oklahoma,State Senate,John Symcox,REP,550017,0,0,0,0,30
Oklahoma,Governor,Chris Powell,LIB,550017,0,0,0,0,
Oklahoma,Governor,Rex Lawhorn,LIB,550017,0,0,0,0,
Oklahoma,Corporation Commissioner,Ashley Nicole Mccray,DEM,550017,0,0,0,0,
Oklahoma,Corporation Commissioner,Blake Cummings,DEM,550017,0,0,0,0,
Oklahoma,U.S. House,Kendra Horn,DEM,550017,0,0,0,0,05
Oklahoma,U.S. House,Tom Guild,DEM,550017,0,0,0,0,05
Oklahoma,Governor,Mick Cornett,REP,550018,0,0,55,55,
Oklahoma,Governor,Kevin Stitt,REP,550018,0,0,42,42,
Oklahoma,Lieutenant Governor,Dana Murphy,REP,550018,0,0,22,22,
Oklahoma,Lieutenant Governor,Matt Pinnell,REP,550018,0,0,72,72,
Oklahoma,State Auditor,Cindy Byrd,REP,550018,0,0,37,37,
Oklahoma,State Auditor,Charlie Prater,REP,550018,0,0,59,59,
Oklahoma,Attorney General,Mike Hunter,REP,550018,0,0,42,42,
Oklahoma,Attorney General,Gentner Drummond,REP,550018,0,0,54,54,
Oklahoma,Superintendent of Public Instruction,Joy Hofmeister,REP,550018,0,0,57,57,
Oklahoma,Superintendent of Public Instruction,Linda Murphy,REP,550018,0,0,39,39,
Oklahoma,Commissioner of Labor,Cathy Costello,REP,550018,0,0,40,40,
Oklahoma,Commissioner of Labor,Leslie Osborn,REP,550018,0,0,55,55,
Oklahoma,Corporation Commissioner,Bob Anthony,REP,550018,0,0,46,46,
Oklahoma,Corporation Commissioner,Brian Bingman,REP,550018,0,0,48,48,
Oklahoma,Governor,Chris Powell,LIB,550018,0,0,0,0,
Oklahoma,Governor,Rex Lawhorn,LIB,550018,0,0,0,0,
Oklahoma,Corporation Commissioner,Ashley Nicole Mccray,DEM,550018,0,0,16,16,
Oklahoma,Corporation Commissioner,Blake Cummings,DEM,550018,0,0,6,6,
Oklahoma,U.S. House,Kendra Horn,DEM,550018,0,0,19,19,05
Oklahoma,U.S. House,Tom Guild,DEM,550018,0,0,2,2,05
Oklahoma,Governor,Mick Cornett,REP,550019,0,0,135,135,
Oklahoma,Governor,Kevin Stitt,REP,550019,0,0,115,115,
Oklahoma,Lieutenant Governor,Dana Murphy,REP,550019,0,0,117,117,
Oklahoma,Lieutenant Governor,Matt Pinnell,REP,550019,0,0,130,130,
Oklahoma,State Auditor,Cindy Byrd,REP,550019,0,0,114,114,
Oklahoma,State Auditor,Charlie Prater,REP,550019,0,0,125,125,
Oklahoma,Attorney General,Mike Hunter,REP,550019,0,0,125,125,
Oklahoma,Attorney General,Gentner Drummond,REP,550019,0,0,121,121,
Oklahoma,Superintendent of Public Instruction,Joy Hofmeister,REP,550019,0,0,130,130,
Oklahoma,Superintendent of Public Instruction,Linda Murphy,REP,550019,0,0,109,109,
Oklahoma,Commissioner of Labor,Cathy Costello,REP,550019,0,0,100,100,
Oklahoma,Commissioner of Labor,Leslie Osborn,REP,550019,0,0,142,142,
Oklahoma,Corporation Commissioner,Bob Anthony,REP,550019,0,0,128,128,
Oklahoma,Corporation Commissioner,Brian Bingman,REP,550019,0,0,115,115,
Oklahoma,Governor,Chris Powell,LIB,550019,0,0,1,1,
Oklahoma,Governor,Rex Lawhorn,LIB,550019,0,0,2,2,
Oklahoma,Corporation Commissioner,Ashley Nicole Mccray,DEM,550019,0,0,33,33,
Oklahoma,Corporation Commissioner,Blake Cummings,DEM,550019,0,0,17,17,
Oklahoma,U.S. House,Kendra Horn,DEM,550019,0,0,31,31,05
Oklahoma,U.S. House,Tom Guild,DEM,550019,0,0,19,19,05
Oklahoma,Governor,Mick Cornett,REP,550020,0,0,184,184,
Oklahoma,Governor,Kevin Stitt,REP,550020,0,0,190,190,
Oklahoma,Lieutenant Governor,Dana Murphy,REP,550020,0,0,158,158,
Oklahoma,Lieutenant Governor,Matt Pinnell,REP,550020,0,0,209,209,
Oklahoma,State Auditor,Cindy Byrd,REP,550020,0,0,178,178,
Oklahoma,State Auditor,Charlie Prater,REP,550020,0,0,179,179,
Oklahoma,Attorney General,Mike Hunter,REP,550020,0,0,177,177,
Oklahoma,Attorney General,Gentner Drummond,REP,550020,0,0,191,191,
Oklahoma,Superintendent of Public Instruction,Joy Hofmeister,REP,550020,0,0,210,210,
Oklahoma,Superintendent of Public Instruction,Linda Murphy,REP,550020,0,0,155,155,
Oklahoma,Commissioner of Labor,Cathy Costello,REP,550020,0,0,169,169,
Oklahoma,Commissioner of Labor,Leslie Osborn,REP,550020,0,0,190,190,
Oklahoma,Corporation Commissioner,Bob Anthony,REP,550020,0,0,190,190,
Oklahoma,Corporation Commissioner,Brian Bingman,REP,550020,0,0,173,173,
Oklahoma,Governor,Chris Powell,LIB,550020,0,0,1,1,
Oklahoma,Governor,Rex Lawhorn,LIB,550020,0,0,0,0,
Oklahoma,Corporation Commissioner,Ashley Nicole Mccray,DEM,550020,0,0,39,39,
Oklahoma,Corporation Commissioner,Blake Cummings,DEM,550020,0,0,20,20,
Oklahoma,U.S. House,Kendra Horn,DEM,550020,0,0,46,46,05
Oklahoma,U.S. House,Tom Guild,DEM,550020,0,0,13,13,05
Oklahoma,Governor,Mick Cornett,REP,550021,0,0,226,226,
Oklahoma,Governor,Kevin Stitt,REP,550021,0,0,251,251,
Oklahoma,Lieutenant Governor,Dana Murphy,REP,550021,0,0,189,189,
Oklahoma,Lieutenant Governor,Matt Pinnell,REP,550021,0,0,268,268,
Oklahoma,State Auditor,Cindy Byrd,REP,550021,0,0,210,210,
Oklahoma,State Auditor,Charlie Prater,REP,550021,0,0,234,234,
Oklahoma,Attorney General,Mike Hunter,REP,550021,0,0,230,230,
Oklahoma,Attorney General,Gentner Drummond,REP,550021,0,0,234,234,
Oklahoma,Superintendent of Public Instruction,Joy Hofmeister,REP,550021,0,0,267,267,
Oklahoma,Superintendent of Public Instruction,Linda Murphy,REP,550021,0,0,196,196,
Oklahoma,Commissioner of Labor,Cathy Costello,REP,550021,0,0,205,205,
Oklahoma,Commissioner of Labor,Leslie Osborn,REP,550021,0,0,250,250,
Oklahoma,Corporation Commissioner,Bob Anthony,REP,550021,0,0,249,249,
Oklahoma,Corporation Commissioner,Brian Bingman,REP,550021,0,0,202,202,
Oklahoma,State House,Tess Teague,REP,550021,0,0,209,209,10
Oklahoma,State House,Robert Manger,REP,550021,0,0,262,262,10
Oklahoma,Governor,Chris Powell,LIB,550021,0,0,1,1,
Oklahoma,Governor,Rex Lawhorn,LIB,550021,0,0,0,0,
Oklahoma,Corporation Commissioner,Ashley Nicole Mccray,DEM,550021,0,0,70,70,
Oklahoma,Corporation Commissioner,Blake Cummings,DEM,550021,0,0,26,26,
Oklahoma,U.S. House,Kendra Horn,DEM,550021,0,0,73,73,05
Oklahoma,U.S. House,Tom Guild,DEM,550021,0,0,22,22,05
Oklahoma,State House,Madeline Scott,DEM,550021,0,0,48,48,10
Oklahoma,State House,John Carpenter,DEM,550021,0,0,49,49,10
Oklahoma,Governor,Mick Cornett,REP,550022,0,0,91,91,
Oklahoma,Governor,Kevin Stitt,REP,550022,0,0,136,136,
Oklahoma,Lieutenant Governor,Dana Murphy,REP,550022,0,0,84,84,
Oklahoma,Lieutenant Governor,Matt Pinnell,REP,550022,0,0,137,137,
Oklahoma,State Auditor,Cindy Byrd,REP,550022,0,0,108,108,
Oklahoma,State Auditor,Charlie Prater,REP,550022,0,0,114,114,
Oklahoma,Attorney General,Mike Hunter,REP,550022,0,0,123,123,
Oklahoma,Attorney General,Gentner Drummond,REP,550022,0,0,99,99,
Oklahoma,Superintendent of Public Instruction,Joy Hofmeister,REP,550022,0,0,115,115,
Oklahoma,Superintendent of Public Instruction,Linda Murphy,REP,550022,0,0,108,108,
Oklahoma,Commissioner of Labor,Cathy Costello,REP,550022,0,0,116,116,
Oklahoma,Commissioner of Labor,Leslie Osborn,REP,550022,0,0,105,105,
Oklahoma,Corporation Commissioner,Bob Anthony,REP,550022,0,0,131,131,
Oklahoma,Corporation Commissioner,Brian Bingman,REP,550022,0,0,92,92,
Oklahoma,State House,Tess Teague,REP,550022,0,0,104,104,10
Oklahoma,State House,Robert Manger,REP,550022,0,0,118,118,10
Oklahoma,Governor,Chris Powell,LIB,550022,0,0,0,0,
Oklahoma,Governor,Rex Lawhorn,LIB,550022,0,0,0,0,
Oklahoma,Corporation Commissioner,Ashley Nicole Mccray,DEM,550022,0,0,31,31,
Oklahoma,Corporation Commissioner,Blake Cummings,DEM,550022,0,0,12,12,
Oklahoma,U.S. House,Mary Brannon,DEM,550022,0,0,29,29,04
Oklahoma,U.S. House,Fred Gipson,DEM,550022,0,0,15,15,04
Oklahoma,State House,Madeline Scott,DEM,550022,0,0,18,18,10
Oklahoma,State House,John Carpenter,DEM,550022,0,0,27,27,10
Oklahoma,Governor,Mick Cornett,REP,550023,0,0,168,168,
Oklahoma,Governor,Kevin Stitt,REP,550023,0,0,174,174,
Oklahoma,Lieutenant Governor,Dana Murphy,REP,550023,0,0,166,166,
Oklahoma,Lieutenant Governor,Matt Pinnell,REP,550023,0,0,169,169,
Oklahoma,State Auditor,Cindy Byrd,REP,550023,0,0,172,172,
Oklahoma,State Auditor,Charlie Prater,REP,550023,0,0,162,162,
Oklahoma,Attorney General,Mike Hunter,REP,550023,0,0,158,158,
Oklahoma,Attorney General,Gentner Drummond,REP,550023,0,0,173,173,
Oklahoma,Superintendent of Public Instruction,Joy Hofmeister,REP,550023,0,0,204,204,
Oklahoma,Superintendent of Public Instruction,Linda Murphy,REP,550023,0,0,128,128,
Oklahoma,Commissioner of Labor,Cathy Costello,REP,550023,0,0,152,152,
Oklahoma,Commissioner of Labor,Leslie Osborn,REP,550023,0,0,183,183,
Oklahoma,Corporation Commissioner,Bob Anthony,REP,550023,0,0,175,175,
Oklahoma,Corporation Commissioner,Brian Bingman,REP,550023,0,0,158,158,
Oklahoma,State House,Tess Teague,REP,550023,0,0,142,142,10
Oklahoma,State House,Robert Manger,REP,550023,0,0,197,197,10
Oklahoma,Governor,Chris Powell,LIB,550023,0,0,2,2,
Oklahoma,Governor,Rex Lawhorn,LIB,550023,0,0,0,0,
Oklahoma,Corporation Commissioner,Ashley Nicole Mccray,DEM,550023,0,0,54,54,
Oklahoma,Corporation Commissioner,Blake Cummings,DEM,550023,0,0,41,41,
Oklahoma,U.S. House,Mary Brannon,DEM,550023,0,0,52,52,04
Oklahoma,U.S. House,Fred Gipson,DEM,550023,0,0,44,44,04
Oklahoma,State House,Madeline Scott,DEM,550023,0,0,44,44,10
Oklahoma,State House,John Carpenter,DEM,550023,0,0,53,53,10
Oklahoma,Governor,Mick Cornett,REP,550024,0,0,11,11,
Oklahoma,Governor,Kevin Stitt,REP,550024,0,0,16,16,
Oklahoma,Lieutenant Governor,Dana Murphy,REP,550024,0,0,11,11,
Oklahoma,Lieutenant Governor,Matt Pinnell,REP,550024,0,0,16,16,
Oklahoma,State Auditor,Cindy Byrd,REP,550024,0,0,15,15,
Oklahoma,State Auditor,Charlie Prater,REP,550024,0,0,12,12,
Oklahoma,Attorney General,Mike Hunter,REP,550024,0,0,11,11,
Oklahoma,Attorney General,Gentner Drummond,REP,550024,0,0,16,16,
Oklahoma,Superintendent of Public Instruction,Joy Hofmeister,REP,550024,0,0,17,17,
Oklahoma,Superintendent of Public Instruction,Linda Murphy,REP,550024,0,0,10,10,
Oklahoma,Commissioner of Labor,Cathy Costello,REP,550024,0,0,16,16,
Oklahoma,Commissioner of Labor,Leslie Osborn,REP,550024,0,0,10,10,
Oklahoma,Corporation Commissioner,Bob Anthony,REP,550024,0,0,16,16,
Oklahoma,Corporation Commissioner,Brian Bingman,REP,550024,0,0,11,11,
Oklahoma,Governor,Chris Powell,LIB,550024,0,0,0,0,
Oklahoma,Governor,Rex Lawhorn,LIB,550024,0,0,0,0,
Oklahoma,Corporation Commissioner,Ashley Nicole Mccray,DEM,550024,0,0,1,1,
Oklahoma,Corporation Commissioner,Blake Cummings,DEM,550024,0,0,2,2,
Oklahoma,U.S. House,Kendra Horn,DEM,550024,0,0,2,2,05
Oklahoma,U.S. House,Tom Guild,DEM,550024,0,0,1,1,05
Oklahoma,Governor,Mick Cornett,REP,550025,0,0,21,21,
Oklahoma,Governor,Kevin Stitt,REP,550025,0,0,22,22,
Oklahoma,Lieutenant Governor,Dana Murphy,REP,550025,0,0,20,20,
Oklahoma,Lieutenant Governor,Matt Pinnell,REP,550025,0,0,21,21,
Oklahoma,State Auditor,Cindy Byrd,REP,550025,0,0,15,15,
Oklahoma,State Auditor,Charlie Prater,REP,550025,0,0,23,23,
Oklahoma,Attorney General,Mike Hunter,REP,550025,0,0,14,14,
Oklahoma,Attorney General,Gentner Drummond,REP,550025,0,0,27,27,
Oklahoma,Superintendent of Public Instruction,Joy Hofmeister,REP,550025,0,0,22,22,
Oklahoma,Superintendent of Public Instruction,Linda Murphy,REP,550025,0,0,19,19,
Oklahoma,Commissioner of Labor,Cathy Costello,REP,550025,0,0,12,12,
Oklahoma,Commissioner of Labor,Leslie Osborn,REP,550025,0,0,29,29,
Oklahoma,Corporation Commissioner,Bob Anthony,REP,550025,0,0,17,17,
Oklahoma,Corporation Commissioner,Brian Bingman,REP,550025,0,0,22,22,
Oklahoma,Governor,Chris Powell,LIB,550025,0,0,1,1,
Oklahoma,Governor,Rex Lawhorn,LIB,550025,0,0,1,1,
Oklahoma,Corporation Commissioner,Ashley Nicole Mccray,DEM,550025,0,0,29,29,
Oklahoma,Corporation Commissioner,Blake Cummings,DEM,550025,0,0,9,9,
Oklahoma,U.S. House,Kendra Horn,DEM,550025,0,0,27,27,05
Oklahoma,U.S. House,Tom Guild,DEM,550025,0,0,11,11,05
Oklahoma,Governor,Mick Cornett,REP,550026,0,0,78,78,
Oklahoma,Governor,Kevin Stitt,REP,550026,0,0,108,108,
Oklahoma,Lieutenant Governor,Dana Murphy,REP,550026,0,0,63,63,
Oklahoma,Lieutenant Governor,Matt Pinnell,REP,550026,0,0,116,116,
Oklahoma,State Auditor,Cindy Byrd,REP,550026,0,0,70,70,
Oklahoma,State Auditor,Charlie Prater,REP,550026,0,0,104,104,
Oklahoma,Attorney General,Mike Hunter,REP,550026,0,0,85,85,
Oklahoma,Attorney General,Gentner Drummond,REP,550026,0,0,95,95,
Oklahoma,Superintendent of Public Instruction,Joy Hofmeister,REP,550026,0,0,97,97,
Oklahoma,Superintendent of Public Instruction,Linda Murphy,REP,550026,0,0,81,81,
Oklahoma,Commissioner of Labor,Cathy Costello,REP,550026,0,0,79,79,
Oklahoma,Commissioner of Labor,Leslie Osborn,REP,550026,0,0,97,97,
Oklahoma,Corporation Commissioner,Bob Anthony,REP,550026,0,0,100,100,
Oklahoma,Corporation Commissioner,Brian Bingman,REP,550026,0,0,80,80,
Oklahoma,State House,Tess Teague,REP,550026,0,0,74,74,10
Oklahoma,State House,Robert Manger,REP,550026,0,0,109,109,10
Oklahoma,Governor,Chris Powell,LIB,550026,0,0,0,0,
Oklahoma,Governor,Rex Lawhorn,LIB,550026,0,0,0,0,
Oklahoma,Corporation Commissioner,Ashley Nicole Mccray,DEM,550026,0,0,30,30,
Oklahoma,Corporation Commissioner,Blake Cummings,DEM,550026,0,0,27,27,
Oklahoma,U.S. House,Mary Brannon,DEM,550026,0,0,35,35,04
Oklahoma,U.S. House,Fred Gipson,DEM,550026,0,0,21,21,04
Oklahoma,State House,Madeline Scott,DEM,550026,0,0,19,19,10
Oklahoma,State House,John Carpenter,DEM,550026,0,0,39,39,10
Oklahoma,Governor,Mick Cornett,REP,550027,0,0,8,8,
Oklahoma,Governor,Kevin Stitt,REP,550027,0,0,15,15,
Oklahoma,Lieutenant Governor,Dana Murphy,REP,550027,0,0,7,7,
Oklahoma,Lieutenant Governor,Matt Pinnell,REP,550027,0,0,16,16,
Oklahoma,State Auditor,Cindy Byrd,REP,550027,0,0,6,6,
Oklahoma,State Auditor,Charlie Prater,REP,550027,0,0,17,17,
Oklahoma,Attorney General,Mike Hunter,REP,550027,0,0,14,14,
Oklahoma,Attorney General,Gentner Drummond,REP,550027,0,0,9,9,
Oklahoma,Superintendent of Public Instruction,Joy Hofmeister,REP,550027,0,0,12,12,
Oklahoma,Superintendent of Public Instruction,Linda Murphy,REP,550027,0,0,11,11,
Oklahoma,Commissioner of Labor,Cathy Costello,REP,550027,0,0,13,13,
Oklahoma,Commissioner of Labor,Leslie Osborn,REP,550027,0,0,9,9,
Oklahoma,Corporation Commissioner,Bob Anthony,REP,550027,0,0,14,14,
Oklahoma,Corporation Commissioner,Brian Bingman,REP,550027,0,0,9,9,
Oklahoma,State House,Tess Teague,REP,550027,0,0,9,9,10
Oklahoma,State House,Robert Manger,REP,550027,0,0,14,14,10
Oklahoma,Governor,Chris Powell,LIB,550027,0,0,0,0,
Oklahoma,Governor,Rex Lawhorn,LIB,550027,0,0,0,0,
Oklahoma,Corporation Commissioner,Ashley Nicole Mccray,DEM,550027,0,0,6,6,
Oklahoma,Corporation Commissioner,Blake Cummings,DEM,550027,0,0,2,2,
Oklahoma,U.S. House,Mary Brannon,DEM,550027,0,0,3,3,04
Oklahoma,U.S. House,Fred Gipson,DEM,550027,0,0,5,5,04
Oklahoma,State House,Madeline Scott,DEM,550027,0,0,3,3,10
Oklahoma,State House,John Carpenter,DEM,550027,0,0,5,5,10
Oklahoma,Governor,Mick Cornett,REP,550028,0,0,60,60,
Oklahoma,Governor,Kevin Stitt,REP,550028,0,0,42,42,
Oklahoma,Lieutenant Governor,Dana Murphy,REP,550028,0,0,42,42,
Oklahoma,Lieutenant Governor,Matt Pinnell,REP,550028,0,0,57,57,
Oklahoma,State Auditor,Cindy Byrd,REP,550028,0,0,52,52,
Oklahoma,State Auditor,Charlie Prater,REP,550028,0,0,47,47,
Oklahoma,Attorney General,Mike Hunter,REP,550028,0,0,64,64,
Oklahoma,Attorney General,Gentner Drummond,REP,550028,0,0,38,38,
Oklahoma,Superintendent of Public Instruction,Joy Hofmeister,REP,550028,0,0,58,58,
Oklahoma,Superintendent of Public Instruction,Linda Murphy,REP,550028,0,0,41,41,
Oklahoma,Commissioner of Labor,Cathy Costello,REP,550028,0,0,40,40,
Oklahoma,Commissioner of Labor,Leslie Osborn,REP,550028,0,0,60,60,
Oklahoma,Corporation Commissioner,Bob Anthony,REP,550028,0,0,61,61,
Oklahoma,Corporation Commissioner,Brian Bingman,REP,550028,0,0,40,40,
Oklahoma,Governor,Chris Powell,LIB,550028,0,0,0,0,
Oklahoma,Governor,Rex Lawhorn,LIB,550028,0,0,3,3,
Oklahoma,Corporation Commissioner,Ashley Nicole Mccray,DEM,550028,0,0,61,61,
Oklahoma,Corporation Commissioner,Blake Cummings,DEM,550028,0,0,19,19,
Oklahoma,U.S. House,Kendra Horn,DEM,550028,0,0,57,57,05
Oklahoma,U.S. House,Tom Guild,DEM,550028,0,0,24,24,05
Oklahoma,Governor,Mick Cornett,REP,550029,0,0,77,77,
Oklahoma,Governor,Kevin Stitt,REP,550029,0,0,118,118,
Oklahoma,Lieutenant Governor,Dana Murphy,REP,550029,0,0,72,72,
Oklahoma,Lieutenant Governor,Matt Pinnell,REP,550029,0,0,124,124,
Oklahoma,State Auditor,Cindy Byrd,REP,550029,0,0,92,92,
Oklahoma,State Auditor,Charlie Prater,REP,550029,0,0,101,101,
Oklahoma,Attorney General,Mike Hunter,REP,550029,0,0,81,81,
Oklahoma,Attorney General,Gentner Drummond,REP,550029,0,0,112,112,
Oklahoma,Superintendent of Public Instruction,Joy Hofmeister,REP,550029,0,0,92,92,
Oklahoma,Superintendent of Public Instruction,Linda Murphy,REP,550029,0,0,103,103,
Oklahoma,Commissioner of Labor,Cathy Costello,REP,550029,0,0,82,82,
Oklahoma,Commissioner of Labor,Leslie Osborn,REP,550029,0,0,112,112,
Oklahoma,Corporation Commissioner,Bob Anthony,REP,550029,0,0,99,99,
Oklahoma,Corporation Commissioner,Brian Bingman,REP,550029,0,0,95,95,
Oklahoma,Governor,Chris Powell,LIB,550029,0,0,2,2,
Oklahoma,Governor,Rex Lawhorn,LIB,550029,0,0,2,2,
Oklahoma,Corporation Commissioner,Ashley Nicole Mccray,DEM,550029,0,0,61,61,
Oklahoma,Corporation Commissioner,Blake Cummings,DEM,550029,0,0,27,27,
Oklahoma,U.S. House,Kendra Horn,DEM,550029,0,0,54,54,05
Oklahoma,U.S. House,Tom Guild,DEM,550029,0,0,35,35,05
Oklahoma,Governor,Mick Cornett,REP,550030,0,0,65,65,
Oklahoma,Governor,Kevin Stitt,REP,550030,0,0,68,68,
Oklahoma,Lieutenant Governor,Dana Murphy,REP,550030,0,0,59,59,
Oklahoma,Lieutenant Governor,Matt Pinnell,REP,550030,0,0,75,75,
Oklahoma,State Auditor,Cindy Byrd,REP,550030,0,0,60,60,
Oklahoma,State Auditor,Charlie Prater,REP,550030,0,0,71,71,
Oklahoma,Attorney General,Mike Hunter,REP,550030,0,0,60,60,
Oklahoma,Attorney General,Gentner Drummond,REP,550030,0,0,74,74,
Oklahoma,Superintendent of Public Instruction,Joy Hofmeister,REP,550030,0,0,68,68,
Oklahoma,Superintendent of Public Instruction,Linda Murphy,REP,550030,0,0,64,64,
Oklahoma,Commissioner of Labor,Cathy Costello,REP,550030,0,0,68,68,
Oklahoma,Commissioner of Labor,Leslie Osborn,REP,550030,0,0,61,61,
Oklahoma,Corporation Commissioner,Bob Anthony,REP,550030,0,0,67,67,
Oklahoma,Corporation Commissioner,Brian Bingman,REP,550030,0,0,64,64,
Oklahoma,Governor,Chris Powell,LIB,550030,0,0,0,0,
Oklahoma,Governor,Rex Lawhorn,LIB,550030,0,0,0,0,
Oklahoma,Corporation Commissioner,Ashley Nicole Mccray,DEM,550030,0,0,79,79,
Oklahoma,Corporation Commissioner,Blake Cummings,DEM,550030,0,0,24,24,
Oklahoma,U.S. House,Kendra Horn,DEM,550030,0,0,69,69,05
Oklahoma,U.S. House,Tom Guild,DEM,550030,0,0,36,36,05
Oklahoma,Governor,Mick Cornett,REP,550031,0,0,127,127,
Oklahoma,Governor,Kevin Stitt,REP,550031,0,0,83,83,
Oklahoma,Lieutenant Governor,Dana Murphy,REP,550031,0,0,91,91,
Oklahoma,Lieutenant Governor,Matt Pinnell,REP,550031,0,0,113,113,
Oklahoma,State Auditor,Cindy Byrd,REP,550031,0,0,94,94,
Oklahoma,State Auditor,Charlie Prater,REP,550031,0,0,106,106,
Oklahoma,Attorney General,Mike Hunter,REP,550031,0,0,109,109,
Oklahoma,Attorney General,Gentner Drummond,REP,550031,0,0,95,95,
Oklahoma,Superintendent of Public Instruction,Joy Hofmeister,REP,550031,0,0,115,115,
Oklahoma,Superintendent of Public Instruction,Linda Murphy,REP,550031,0,0,91,91,
Oklahoma,Commissioner of Labor,Cathy Costello,REP,550031,0,0,80,80,
Oklahoma,Commissioner of Labor,Leslie Osborn,REP,550031,0,0,120,120,
Oklahoma,Corporation Commissioner,Bob Anthony,REP,550031,0,0,121,121,
Oklahoma,Corporation Commissioner,Brian Bingman,REP,550031,0,0,77,77,
Oklahoma,Governor,Chris Powell,LIB,550031,0,0,1,1,
Oklahoma,Governor,Rex Lawhorn,LIB,550031,0,0,1,1,
Oklahoma,Corporation Commissioner,Ashley Nicole Mccray,DEM,550031,0,0,78,78,
Oklahoma,Corporation Commissioner,Blake Cummings,DEM,550031,0,0,28,28,
Oklahoma,U.S. House,Kendra Horn,DEM,550031,0,0,71,71,05
Oklahoma,U.S. House,Tom Guild,DEM,550031,0,0,35,35,05
Oklahoma,Governor,Mick Cornett,REP,550032,0,0,69,69,
Oklahoma,Governor,Kevin Stitt,REP,550032,0,0,77,77,
Oklahoma,Lieutenant Governor,Dana Murphy,REP,550032,0,0,67,67,
Oklahoma,Lieutenant Governor,Matt Pinnell,REP,550032,0,0,78,78,
Oklahoma,State Auditor,Cindy Byrd,REP,550032,0,0,70,70,
Oklahoma,State Auditor,Charlie Prater,REP,550032,0,0,75,75,
Oklahoma,Attorney General,Mike Hunter,REP,550032,0,0,73,73,
Oklahoma,Attorney General,Gentner Drummond,REP,550032,0,0,72,72,
Oklahoma,Superintendent of Public Instruction,Joy Hofmeister,REP,550032,0,0,89,89,
Oklahoma,Superintendent of Public Instruction,Linda Murphy,REP,550032,0,0,54,54,
Oklahoma,Commissioner of Labor,Cathy Costello,REP,550032,0,0,71,71,
Oklahoma,Commissioner of Labor,Leslie Osborn,REP,550032,0,0,74,74,
Oklahoma,Corporation Commissioner,Bob Anthony,REP,550032,0,0,74,74,
Oklahoma,Corporation Commissioner,Brian Bingman,REP,550032,0,0,70,70,
Oklahoma,Governor,Chris Powell,LIB,550032,0,0,2,2,
Oklahoma,Governor,Rex Lawhorn,LIB,550032,0,0,0,0,
Oklahoma,Corporation Commissioner,Ashley Nicole Mccray,DEM,550032,0,0,35,35,
Oklahoma,Corporation Commissioner,Blake Cummings,DEM,550032,0,0,26,26,
Oklahoma,U.S. House,Kendra Horn,DEM,550032,0,0,29,29,05
Oklahoma,U.S. House,Tom Guild,DEM,550032,0,0,31,31,05
Oklahoma,Governor,Mick Cornett,REP,550033,0,0,157,157,
Oklahoma,Governor,Kevin Stitt,REP,550033,0,0,146,146,
Oklahoma,Lieutenant Governor,Dana Murphy,REP,550033,0,0,125,125,
Oklahoma,Lieutenant Governor,Matt Pinnell,REP,550033,0,0,170,170,
Oklahoma,State Auditor,Cindy Byrd,REP,550033,0,0,148,148,
Oklahoma,State Auditor,Charlie Prater,REP,550033,0,0,139,139,
Oklahoma,Attorney General,Mike Hunter,REP,550033,0,0,168,168,
Oklahoma,Attorney General,Gentner Drummond,REP,550033,0,0,125,125,
Oklahoma,Superintendent of Public Instruction,Joy Hofmeister,REP,550033,0,0,162,162,
Oklahoma,Superintendent of Public Instruction,Linda Murphy,REP,550033,0,0,129,129,
Oklahoma,Commissioner of Labor,Cathy Costello,REP,550033,0,0,130,130,
Oklahoma,Commissioner of Labor,Leslie Osborn,REP,550033,0,0,159,159,
Oklahoma,Corporation Commissioner,Bob Anthony,REP,550033,0,0,185,185,
Oklahoma,Corporation Commissioner,Brian Bingman,REP,550033,0,0,105,105,
Oklahoma,Governor,Chris Powell,LIB,550033,0,0,1,1,
Oklahoma,Governor,Rex Lawhorn,LIB,550033,0,0,1,1,
Oklahoma,Corporation Commissioner,Ashley Nicole Mccray,DEM,550033,0,0,97,97,
Oklahoma,Corporation Commissioner,Blake Cummings,DEM,550033,0,0,35,35,
Oklahoma,U.S. House,Kendra Horn,DEM,550033,0,0,83,83,05
Oklahoma,U.S. House,Tom Guild,DEM,550033,0,0,46,46,05
Oklahoma,Governor,Mick Cornett,REP,550034,0,0,154,154,
Oklahoma,Governor,Kevin Stitt,REP,550034,0,0,133,133,
Oklahoma,Lieutenant Governor,Dana Murphy,REP,550034,0,0,128,128,
Oklahoma,Lieutenant Governor,Matt Pinnell,REP,550034,0,0,143,143,
Oklahoma,State Auditor,Cindy Byrd,REP,550034,0,0,123,123,
Oklahoma,State Auditor,Charlie Prater,REP,550034,0,0,135,135,
Oklahoma,Attorney General,Mike Hunter,REP,550034,0,0,163,163,
Oklahoma,Attorney General,Gentner Drummond,REP,550034,0,0,116,116,
Oklahoma,Superintendent of Public Instruction,Joy Hofmeister,REP,550034,0,0,171,171,
Oklahoma,Superintendent of Public Instruction,Linda Murphy,REP,550034,0,0,101,101,
Oklahoma,Commissioner of Labor,Cathy Costello,REP,550034,0,0,136,136,
Oklahoma,Commissioner of Labor,Leslie Osborn,REP,550034,0,0,130,130,
Oklahoma,Corporation Commissioner,Bob Anthony,REP,550034,0,0,146,146,
Oklahoma,Corporation Commissioner,Brian Bingman,REP,550034,0,0,123,123,
Oklahoma,Governor,Chris Powell,LIB,550034,0,0,0,0,
Oklahoma,Governor,Rex Lawhorn,LIB,550034,0,0,0,0,
Oklahoma,Corporation Commissioner,Ashley Nicole Mccray,DEM,550034,0,0,19,19,
Oklahoma,Corporation Commissioner,Blake Cummings,DEM,550034,0,0,9,9,
Oklahoma,U.S. House,Kendra Horn,DEM,550034,0,0,22,22,05
Oklahoma,U.S. House,Tom Guild,DEM,550034,0,0,6,6,05
Oklahoma,Governor,Mick Cornett,REP,550035,0,0,320,320,
Oklahoma,Governor,Kevin Stitt,REP,550035,0,0,213,213,
Oklahoma,Lieutenant Governor,Dana Murphy,REP,550035,0,0,225,225,
Oklahoma,Lieutenant Governor,Matt Pinnell,REP,550035,0,0,294,294,
Oklahoma,State Auditor,Cindy Byrd,REP,550035,0,0,266,266,
Oklahoma,State Auditor,Charlie Prater,REP,550035,0,0,237,237,
Oklahoma,Attorney General,Mike Hunter,REP,550035,0,0,342,342,
Oklahoma,Attorney General,Gentner Drummond,REP,550035,0,0,179,179,
Oklahoma,Superintendent of Public Instruction,Joy Hofmeister,REP,550035,0,0,294,294,
Oklahoma,Superintendent of Public Instruction,Linda Murphy,REP,550035,0,0,219,219,
Oklahoma,Commissioner of Labor,Cathy Costello,REP,550035,0,0,242,242,
Oklahoma,Commissioner of Labor,Leslie Osborn,REP,550035,0,0,263,263,
Oklahoma,Corporation Commissioner,Bob Anthony,REP,550035,0,0,284,284,
Oklahoma,Corporation Commissioner,Brian Bingman,REP,550035,0,0,219,219,
Oklahoma,State House,Nicole Miller,REP,550035,0,0,325,325,82
Oklahoma,State House,Brad Martin,REP,550035,0,0,191,191,82
Oklahoma,Governor,Chris Powell,LIB,550035,0,0,3,3,
Oklahoma,Governor,Rex Lawhorn,LIB,550035,0,0,0,0,
Oklahoma,Corporation Commissioner,Ashley Nicole Mccray,DEM,550035,0,0,80,80,
Oklahoma,Corporation Commissioner,Blake Cummings,DEM,550035,0,0,19,19,
Oklahoma,U.S. House,Kendra Horn,DEM,550035,0,0,79,79,05
Oklahoma,U.S. House,Tom Guild,DEM,550035,0,0,20,20,05
Oklahoma,Governor,Mick Cornett,REP,550036,0,0,266,266,
Oklahoma,Governor,Kevin Stitt,REP,550036,0,0,162,162,
Oklahoma,Lieutenant Governor,Dana Murphy,REP,550036,0,0,204,204,
Oklahoma,Lieutenant Governor,Matt Pinnell,REP,550036,0,0,212,212,
Oklahoma,State Auditor,Cindy Byrd,REP,550036,0,0,200,200,
Oklahoma,State Auditor,Charlie Prater,REP,550036,0,0,199,199,
Oklahoma,Attorney General,Mike Hunter,REP,550036,0,0,261,261,
Oklahoma,Attorney General,Gentner Drummond,REP,550036,0,0,144,144,
Oklahoma,Superintendent of Public Instruction,Joy Hofmeister,REP,550036,0,0,240,240,
Oklahoma,Superintendent of Public Instruction,Linda Murphy,REP,550036,0,0,174,174,
Oklahoma,Commissioner of Labor,Cathy Costello,REP,550036,0,0,219,219,
Oklahoma,Commissioner of Labor,Leslie Osborn,REP,550036,0,0,191,191,
Oklahoma,Corporation Commissioner,Bob Anthony,REP,550036,0,0,224,224,
Oklahoma,Corporation Commissioner,Brian Bingman,REP,550036,0,0,179,179,
Oklahoma,Governor,Chris Powell,LIB,550036,0,0,0,0,
Oklahoma,Governor,Rex Lawhorn,LIB,550036,0,0,0,0,
Oklahoma,Corporation Commissioner,Ashley Nicole Mccray,DEM,550036,0,0,56,56,
Oklahoma,Corporation Commissioner,Blake Cummings,DEM,550036,0,0,16,16,
Oklahoma,U.S. House,Kendra Horn,DEM,550036,0,0,61,61,05
Oklahoma,U.S. House,Tom Guild,DEM,550036,0,0,12,12,05
Oklahoma,Governor,Mick Cornett,REP,550037,0,0,230,230,
Oklahoma,Governor,Kevin Stitt,REP,550037,0,0,138,138,
Oklahoma,Lieutenant Governor,Dana Murphy,REP,550037,0,0,167,167,
Oklahoma,Lieutenant Governor,Matt Pinnell,REP,550037,0,0,197,197,
Oklahoma,State Auditor,Cindy Byrd,REP,550037,0,0,177,177,
Oklahoma,State Auditor,Charlie Prater,REP,550037,0,0,178,178,
Oklahoma,Attorney General,Mike Hunter,REP,550037,0,0,227,227,
Oklahoma,Attorney General,Gentner Drummond,REP,550037,0,0,138,138,
Oklahoma,Superintendent of Public Instruction,Joy Hofmeister,REP,550037,0,0,214,214,
Oklahoma,Superintendent of Public Instruction,Linda Murphy,REP,550037,0,0,146,146,
Oklahoma,Commissioner of Labor,Cathy Costello,REP,550037,0,0,181,181,
Oklahoma,Commissioner of Labor,Leslie Osborn,REP,550037,0,0,177,177,
Oklahoma,Corporation Commissioner,Bob Anthony,REP,550037,0,0,216,216,
Oklahoma,Corporation Commissioner,Brian Bingman,REP,550037,0,0,146,146,
Oklahoma,Governor,Chris Powell,LIB,550037,0,0,2,2,
Oklahoma,Governor,Rex Lawhorn,LIB,550037,0,0,0,0,
Oklahoma,Corporation Commissioner,Ashley Nicole Mccray,DEM,550037,0,0,68,68,
Oklahoma,Corporation Commissioner,Blake Cummings,DEM,550037,0,0,21,21,
Oklahoma,U.S. House,Kendra Horn,DEM,550037,0,0,69,69,05
Oklahoma,U.S. House,Tom Guild,DEM,550037,0,0,20,20,05
Oklahoma,Governor,Mick Cornett,REP,550038,0,0,142,142,
Oklahoma,Governor,Kevin Stitt,REP,550038,0,0,99,99,
Oklahoma,Lieutenant Governor,Dana Murphy,REP,550038,0,0,101,101,
Oklahoma,Lieutenant Governor,Matt Pinnell,REP,550038,0,0,134,134,
Oklahoma,State Auditor,Cindy Byrd,REP,550038,0,0,120,120,
Oklahoma,State Auditor,Charlie Prater,REP,550038,0,0,110,110,
Oklahoma,Attorney General,Mike Hunter,REP,550038,0,0,133,133,
Oklahoma,Attorney General,Gentner Drummond,REP,550038,0,0,102,102,
Oklahoma,Superintendent of Public Instruction,Joy Hofmeister,REP,550038,0,0,133,133,
Oklahoma,Superintendent of Public Instruction,Linda Murphy,REP,550038,0,0,100,100,
Oklahoma,Commissioner of Labor,Cathy Costello,REP,550038,0,0,127,127,
Oklahoma,Commissioner of Labor,Leslie Osborn,REP,550038,0,0,106,106,
Oklahoma,Corporation Commissioner,Bob Anthony,REP,550038,0,0,115,115,
Oklahoma,Corporation Commissioner,Brian Bingman,REP,550038,0,0,121,121,
Oklahoma,Governor,Chris Powell,LIB,550038,0,0,5,5,
Oklahoma,Governor,Rex Lawhorn,LIB,550038,0,0,0,0,
Oklahoma,Corporation Commissioner,Ashley Nicole Mccray,DEM,550038,0,0,76,76,
Oklahoma,Corporation Commissioner,Blake Cummings,DEM,550038,0,0,17,17,
Oklahoma,U.S. House,Kendra Horn,DEM,550038,0,0,71,71,05
Oklahoma,U.S. House,Tom Guild,DEM,550038,0,0,22,22,05
Oklahoma,Governor,Mick Cornett,REP,550039,0,0,186,186,
Oklahoma,Governor,Kevin Stitt,REP,550039,0,0,122,122,
Oklahoma,Lieutenant Governor,Dana Murphy,REP,550039,0,0,148,148,
Oklahoma,Lieutenant Governor,Matt Pinnell,REP,550039,0,0,160,160,
Oklahoma,State Auditor,Cindy Byrd,REP,550039,0,0,149,149,
Oklahoma,State Auditor,Charlie Prater,REP,550039,0,0,150,150,
Oklahoma,Attorney General,Mike Hunter,REP,550039,0,0,174,174,
Oklahoma,Attorney General,Gentner Drummond,REP,550039,0,0,132,132,
Oklahoma,Superintendent of Public Instruction,Joy Hofmeister,REP,550039,0,0,189,189,
Oklahoma,Superintendent of Public Instruction,Linda Murphy,REP,550039,0,0,114,114,
Oklahoma,Commissioner of Labor,Cathy Costello,REP,550039,0,0,142,142,
Oklahoma,Commissioner of Labor,Leslie Osborn,REP,550039,0,0,160,160,
Oklahoma,Corporation Commissioner,Bob Anthony,REP,550039,0,0,178,178,
Oklahoma,Corporation Commissioner,Brian Bingman,REP,550039,0,0,125,125,
Oklahoma,Governor,Chris Powell,LIB,550039,0,0,1,1,
Oklahoma,Governor,Rex Lawhorn,LIB,550039,0,0,1,1,
Oklahoma,Corporation Commissioner,Ashley Nicole Mccray,DEM,550039,0,0,86,86,
Oklahoma,Corporation Commissioner,Blake Cummings,DEM,550039,0,0,14,14,
Oklahoma,U.S. House,Kendra Horn,DEM,550039,0,0,86,86,05
Oklahoma,U.S. House,Tom Guild,DEM,550039,0,0,15,15,05
Oklahoma,Governor,Mick Cornett,REP,550040,0,0,228,228,
Oklahoma,Governor,Kevin Stitt,REP,550040,0,0,121,121,
Oklahoma,Lieutenant Governor,Dana Murphy,REP,550040,0,0,148,148,
Oklahoma,Lieutenant Governor,Matt Pinnell,REP,550040,0,0,187,187,
Oklahoma,State Auditor,Cindy Byrd,REP,550040,0,0,158,158,
Oklahoma,State Auditor,Charlie Prater,REP,550040,0,0,168,168,
Oklahoma,Attorney General,Mike Hunter,REP,550040,0,0,205,205,
Oklahoma,Attorney General,Gentner Drummond,REP,550040,0,0,136,136,
Oklahoma,Superintendent of Public Instruction,Joy Hofmeister,REP,550040,0,0,199,199,
Oklahoma,Superintendent of Public Instruction,Linda Murphy,REP,550040,0,0,142,142,
Oklahoma,Commissioner of Labor,Cathy Costello,REP,550040,0,0,159,159,
Oklahoma,Commissioner of Labor,Leslie Osborn,REP,550040,0,0,173,173,
Oklahoma,Corporation Commissioner,Bob Anthony,REP,550040,0,0,199,199,
Oklahoma,Corporation Commissioner,Brian Bingman,REP,550040,0,0,130,130,
Oklahoma,Governor,Chris Powell,LIB,550040,0,0,0,0,
Oklahoma,Governor,Rex Lawhorn,LIB,550040,0,0,0,0,
Oklahoma,Corporation Commissioner,Ashley Nicole Mccray,DEM,550040,0,0,67,67,
Oklahoma,Corporation Commissioner,Blake Cummings,DEM,550040,0,0,25,25,
Oklahoma,U.S. House,Kendra Horn,DEM,550040,0,0,82,82,05
Oklahoma,U.S. House,Tom Guild,DEM,550040,0,0,11,11,05
Oklahoma,Governor,Mick Cornett,REP,550041,0,0,168,168,
Oklahoma,Governor,Kevin Stitt,REP,550041,0,0,127,127,
Oklahoma,Lieutenant Governor,Dana Murphy,REP,550041,0,0,113,113,
Oklahoma,Lieutenant Governor,Matt Pinnell,REP,550041,0,0,174,174,
Oklahoma,State Auditor,Cindy Byrd,REP,550041,0,0,150,150,
Oklahoma,State Auditor,Charlie Prater,REP,550041,0,0,131,131,
Oklahoma,Attorney General,Mike Hunter,REP,550041,0,0,143,143,
Oklahoma,Attorney General,Gentner Drummond,REP,550041,0,0,142,142,
Oklahoma,Superintendent of Public Instruction,Joy Hofmeister,REP,550041,0,0,150,150,
Oklahoma,Superintendent of Public Instruction,Linda Murphy,REP,550041,0,0,129,129,
Oklahoma,Commissioner of Labor,Cathy Costello,REP,550041,0,0,154,154,
Oklahoma,Commissioner of Labor,Leslie Osborn,REP,550041,0,0,126,126,
Oklahoma,Corporation Commissioner,Bob Anthony,REP,550041,0,0,150,150,
Oklahoma,Corporation Commissioner,Brian Bingman,REP,550041,0,0,129,129,
Oklahoma,Governor,Chris Powell,LIB,550041,0,0,2,2,
Oklahoma,Governor,Rex Lawhorn,LIB,550041,0,0,2,2,
Oklahoma,Corporation Commissioner,Ashley Nicole Mccray,DEM,550041,0,0,60,60,
Oklahoma,Corporation Commissioner,Blake Cummings,DEM,550041,0,0,24,24,
Oklahoma,U.S. House,Kendra Horn,DEM,550041,0,0,66,66,05
Oklahoma,U.S. House,Tom Guild,DEM,550041,0,0,19,19,05
Oklahoma,Governor,Mick Cornett,REP,550042,0,0,258,258,
Oklahoma,Governor,Kevin Stitt,REP,550042,0,0,181,181,
Oklahoma,Lieutenant Governor,Dana Murphy,REP,550042,0,0,190,190,
Oklahoma,Lieutenant Governor,Matt Pinnell,REP,550042,0,0,240,240,
Oklahoma,State Auditor,Cindy Byrd,REP,550042,0,0,174,174,
Oklahoma,State Auditor,Charlie Prater,REP,550042,0,0,238,238,
Oklahoma,Attorney General,Mike Hunter,REP,550042,0,0,249,249,
Oklahoma,Attorney General,Gentner Drummond,REP,550042,0,0,179,179,
Oklahoma,Superintendent of Public Instruction,Joy Hofmeister,REP,550042,0,0,260,260,
Oklahoma,Superintendent of Public Instruction,Linda Murphy,REP,550042,0,0,167,167,
Oklahoma,Commissioner of Labor,Cathy Costello,REP,550042,0,0,201,201,
Oklahoma,Commissioner of Labor,Leslie Osborn,REP,550042,0,0,219,219,
Oklahoma,Corporation Commissioner,Bob Anthony,REP,550042,0,0,232,232,
Oklahoma,Corporation Commissioner,Brian Bingman,REP,550042,0,0,189,189,
Oklahoma,Governor,Chris Powell,LIB,550042,0,0,1,1,
Oklahoma,Governor,Rex Lawhorn,LIB,550042,0,0,0,0,
Oklahoma,Corporation Commissioner,Ashley Nicole Mccray,DEM,550042,0,0,56,56,
Oklahoma,Corporation Commissioner,Blake Cummings,DEM,550042,0,0,23,23,
Oklahoma,U.S. House,Kendra Horn,DEM,550042,0,0,69,69,05
Oklahoma,U.S. House,Tom Guild,DEM,550042,0,0,11,11,05
Oklahoma,Governor,Mick Cornett,REP,550043,0,0,458,458,
Oklahoma,Governor,Kevin Stitt,REP,550043,0,0,282,282,
Oklahoma,Lieutenant Governor,Dana Murphy,REP,550043,0,0,332,332,
Oklahoma,Lieutenant Governor,Matt Pinnell,REP,550043,0,0,377,377,
Oklahoma,State Auditor,Cindy Byrd,REP,550043,0,0,313,313,
Oklahoma,State Auditor,Charlie Prater,REP,550043,0,0,369,369,
Oklahoma,Attorney General,Mike Hunter,REP,550043,0,0,475,475,
Oklahoma,Attorney General,Gentner Drummond,REP,550043,0,0,240,240,
Oklahoma,Superintendent of Public Instruction,Joy Hofmeister,REP,550043,0,0,417,417,
Oklahoma,Superintendent of Public Instruction,Linda Murphy,REP,550043,0,0,293,293,
Oklahoma,Commissioner of Labor,Cathy Costello,REP,550043,0,0,372,372,
Oklahoma,Commissioner of Labor,Leslie Osborn,REP,550043,0,0,337,337,
Oklahoma,Corporation Commissioner,Bob Anthony,REP,550043,0,0,378,378,
Oklahoma,Corporation Commissioner,Brian Bingman,REP,550043,0,0,320,320,
Oklahoma,Governor,Chris Powell,LIB,550043,0,0,0,0,
Oklahoma,Governor,Rex Lawhorn,LIB,550043,0,0,0,0,
Oklahoma,Corporation Commissioner,Ashley Nicole Mccray,DEM,550043,0,0,64,64,
Oklahoma,Corporation Commissioner,Blake Cummings,DEM,550043,0,0,13,13,
Oklahoma,U.S. House,Kendra Horn,DEM,550043,0,0,66,66,05
Oklahoma,U.S. House,Tom Guild,DEM,550043,0,0,12,12,05
Oklahoma,Governor,Mick Cornett,REP,550044,0,0,306,306,
Oklahoma,Governor,Kevin Stitt,REP,550044,0,0,211,211,
Oklahoma,Lieutenant Governor,Dana Murphy,REP,550044,0,0,250,250,
Oklahoma,Lieutenant Governor,Matt Pinnell,REP,550044,0,0,256,256,
Oklahoma,State Auditor,Cindy Byrd,REP,550044,0,0,238,238,
Oklahoma,State Auditor,Charlie Prater,REP,550044,0,0,248,248,
Oklahoma,Attorney General,Mike Hunter,REP,550044,0,0,321,321,
Oklahoma,Attorney General,Gentner Drummond,REP,550044,0,0,180,180,
Oklahoma,Superintendent of Public Instruction,Joy Hofmeister,REP,550044,0,0,303,303,
Oklahoma,Superintendent of Public Instruction,Linda Murphy,REP,550044,0,0,201,201,
Oklahoma,Commissioner of Labor,Cathy Costello,REP,550044,0,0,252,252,
Oklahoma,Commissioner of Labor,Leslie Osborn,REP,550044,0,0,242,242,
Oklahoma,Corporation Commissioner,Bob Anthony,REP,550044,0,0,261,261,
Oklahoma,Corporation Commissioner,Brian Bingman,REP,550044,0,0,232,232,
Oklahoma,Governor,Chris Powell,LIB,550044,0,0,1,1,
Oklahoma,Governor,Rex Lawhorn,LIB,550044,0,0,1,1,
Oklahoma,Corporation Commissioner,Ashley Nicole Mccray,DEM,550044,0,0,100,100,
Oklahoma,Corporation Commissioner,Blake Cummings,DEM,550044,0,0,18,18,
Oklahoma,U.S. House,Kendra Horn,DEM,550044,0,0,102,102,05
Oklahoma,U.S. House,Tom Guild,DEM,550044,0,0,17,17,05
Oklahoma,Governor,Mick Cornett,REP,550045,0,0,386,386,
Oklahoma,Governor,Kevin Stitt,REP,550045,0,0,249,249,
Oklahoma,Lieutenant Governor,Dana Murphy,REP,550045,0,0,298,298,
Oklahoma,Lieutenant Governor,Matt Pinnell,REP,550045,0,0,318,318,
Oklahoma,State Auditor,Cindy Byrd,REP,550045,0,0,272,272,
Oklahoma,State Auditor,Charlie Prater,REP,550045,0,0,318,318,
Oklahoma,Attorney General,Mike Hunter,REP,550045,0,0,415,415,
Oklahoma,Attorney General,Gentner Drummond,REP,550045,0,0,204,204,
Oklahoma,Superintendent of Public Instruction,Joy Hofmeister,REP,550045,0,0,378,378,
Oklahoma,Superintendent of Public Instruction,Linda Murphy,REP,550045,0,0,222,222,
Oklahoma,Commissioner of Labor,Cathy Costello,REP,550045,0,0,308,308,
Oklahoma,Commissioner of Labor,Leslie Osborn,REP,550045,0,0,293,293,
Oklahoma,Corporation Commissioner,Bob Anthony,REP,550045,0,0,332,332,
Oklahoma,Corporation Commissioner,Brian Bingman,REP,550045,0,0,272,272,
Oklahoma,Governor,Chris Powell,LIB,550045,0,0,1,1,
Oklahoma,Governor,Rex Lawhorn,LIB,550045,0,0,0,0,
Oklahoma,Corporation Commissioner,Ashley Nicole Mccray,DEM,550045,0,0,87,87,
Oklahoma,Corporation Commissioner,Blake Cummings,DEM,550045,0,0,31,31,
Oklahoma,U.S. House,Kendra Horn,DEM,550045,0,0,98,98,05
Oklahoma,U.S. House,Tom Guild,DEM,550045,0,0,20,20,05
Oklahoma,Governor,Mick Cornett,REP,550046,0,0,63,63,
Oklahoma,Governor,Kevin Stitt,REP,550046,0,0,61,61,
Oklahoma,Lieutenant Governor,Dana Murphy,REP,550046,0,0,55,55,
Oklahoma,Lieutenant Governor,Matt Pinnell,REP,550046,0,0,66,66,
Oklahoma,State Auditor,Cindy Byrd,REP,550046,0,0,51,51,
Oklahoma,State Auditor,Charlie Prater,REP,550046,0,0,71,71,
Oklahoma,Attorney General,Mike Hunter,REP,550046,0,0,78,78,
Oklahoma,Attorney General,Gentner Drummond,REP,550046,0,0,46,46,
Oklahoma,Superintendent of Public Instruction,Joy Hofmeister,REP,550046,0,0,75,75,
Oklahoma,Superintendent of Public Instruction,Linda Murphy,REP,550046,0,0,47,47,
Oklahoma,Commissioner of Labor,Cathy Costello,REP,550046,0,0,81,81,
Oklahoma,Commissioner of Labor,Leslie Osborn,REP,550046,0,0,41,41,
Oklahoma,Corporation Commissioner,Bob Anthony,REP,550046,0,0,67,67,
Oklahoma,Corporation Commissioner,Brian Bingman,REP,550046,0,0,52,52,
Oklahoma,Governor,Chris Powell,LIB,550046,0,0,0,0,
Oklahoma,Governor,Rex Lawhorn,LIB,550046,0,0,0,0,
Oklahoma,Corporation Commissioner,Ashley Nicole Mccray,DEM,550046,0,0,36,36,
Oklahoma,Corporation Commissioner,Blake Cummings,DEM,550046,0,0,13,13,
Oklahoma,U.S. House,Kendra Horn,DEM,550046,0,0,37,37,05
Oklahoma,U.S. House,Tom Guild,DEM,550046,0,0,13,13,05
Oklahoma,Governor,Mick Cornett,REP,550047,0,0,65,65,
Oklahoma,Governor,Kevin Stitt,REP,550047,0,0,54,54,
Oklahoma,Lieutenant Governor,Dana Murphy,REP,550047,0,0,47,47,
Oklahoma,Lieutenant Governor,Matt Pinnell,REP,550047,0,0,70,70,
Oklahoma,State Auditor,Cindy Byrd,REP,550047,0,0,51,51,
Oklahoma,State Auditor,Charlie Prater,REP,550047,0,0,64,64,
Oklahoma,Attorney General,Mike Hunter,REP,550047,0,0,72,72,
Oklahoma,Attorney General,Gentner Drummond,REP,550047,0,0,44,44,
Oklahoma,Superintendent of Public Instruction,Joy Hofmeister,REP,550047,0,0,62,62,
Oklahoma,Superintendent of Public Instruction,Linda Murphy,REP,550047,0,0,54,54,
Oklahoma,Commissioner of Labor,Cathy Costello,REP,550047,0,0,58,58,
Oklahoma,Commissioner of Labor,Leslie Osborn,REP,550047,0,0,58,58,
Oklahoma,Corporation Commissioner,Bob Anthony,REP,550047,0,0,56,56,
Oklahoma,Corporation Commissioner,Brian Bingman,REP,550047,0,0,59,59,
Oklahoma,Governor,Chris Powell,LIB,550047,0,0,1,1,
Oklahoma,Governor,Rex Lawhorn,LIB,550047,0,0,1,1,
Oklahoma,Corporation Commissioner,Ashley Nicole Mccray,DEM,550047,0,0,53,53,
Oklahoma,Corporation Commissioner,Blake Cummings,DEM,550047,0,0,16,16,
Oklahoma,U.S. House,Kendra Horn,DEM,550047,0,0,45,45,05
Oklahoma,U.S. House,Tom Guild,DEM,550047,0,0,24,24,05
Oklahoma,Governor,Mick Cornett,REP,550048,0,0,92,92,
Oklahoma,Governor,Kevin Stitt,REP,550048,0,0,79,79,
Oklahoma,Lieutenant Governor,Dana Murphy,REP,550048,0,0,72,72,
Oklahoma,Lieutenant Governor,Matt Pinnell,REP,550048,0,0,96,96,
Oklahoma,State Auditor,Cindy Byrd,REP,550048,0,0,72,72,
Oklahoma,State Auditor,Charlie Prater,REP,550048,0,0,97,97,
Oklahoma,Attorney General,Mike Hunter,REP,550048,0,0,87,87,
Oklahoma,Attorney General,Gentner Drummond,REP,550048,0,0,81,81,
Oklahoma,Superintendent of Public Instruction,Joy Hofmeister,REP,550048,0,0,106,106,
Oklahoma,Superintendent of Public Instruction,Linda Murphy,REP,550048,0,0,63,63,
Oklahoma,Commissioner of Labor,Cathy Costello,REP,550048,0,0,83,83,
Oklahoma,Commissioner of Labor,Leslie Osborn,REP,550048,0,0,85,85,
Oklahoma,Corporation Commissioner,Bob Anthony,REP,550048,0,0,103,103,
Oklahoma,Corporation Commissioner,Brian Bingman,REP,550048,0,0,64,64,
Oklahoma,Governor,Chris Powell,LIB,550048,0,0,0,0,
Oklahoma,Governor,Rex Lawhorn,LIB,550048,0,0,0,0,
Oklahoma,Corporation Commissioner,Ashley Nicole Mccray,DEM,550048,0,0,51,51,
Oklahoma,Corporation Commissioner,Blake Cummings,DEM,550048,0,0,13,13,
Oklahoma,U.S. House,Kendra Horn,DEM,550048,0,0,47,47,05
Oklahoma,U.S. House,Tom Guild,DEM,550048,0,0,17,17,05
Oklahoma,Governor,Mick Cornett,REP,550049,0,0,72,72,
Oklahoma,Governor,Kevin Stitt,REP,550049,0,0,54,54,
Oklahoma,Lieutenant Governor,Dana Murphy,REP,550049,0,0,62,62,
Oklahoma,Lieutenant Governor,Matt Pinnell,REP,550049,0,0,63,63,
Oklahoma,State Auditor,Cindy Byrd,REP,550049,0,0,59,59,
Oklahoma,State Auditor,Charlie Prater,REP,550049,0,0,60,60,
Oklahoma,Attorney General,Mike Hunter,REP,550049,0,0,70,70,
Oklahoma,Attorney General,Gentner Drummond,REP,550049,0,0,53,53,
Oklahoma,Superintendent of Public Instruction,Joy Hofmeister,REP,550049,0,0,64,64,
Oklahoma,Superintendent of Public Instruction,Linda Murphy,REP,550049,0,0,58,58,
Oklahoma,Commissioner of Labor,Cathy Costello,REP,550049,0,0,56,56,
Oklahoma,Commissioner of Labor,Leslie Osborn,REP,550049,0,0,65,65,
Oklahoma,Corporation Commissioner,Bob Anthony,REP,550049,0,0,62,62,
Oklahoma,Corporation Commissioner,Brian Bingman,REP,550049,0,0,60,60,
Oklahoma,Governor,Chris Powell,LIB,550049,0,0,0,0,
Oklahoma,Governor,Rex Lawhorn,LIB,550049,0,0,0,0,
Oklahoma,Corporation Commissioner,Ashley Nicole Mccray,DEM,550049,0,0,36,36,
Oklahoma,Corporation Commissioner,Blake Cummings,DEM,550049,0,0,13,13,
Oklahoma,U.S. House,Kendra Horn,DEM,550049,0,0,36,36,05
Oklahoma,U.S. House,Tom Guild,DEM,550049,0,0,13,13,05
Oklahoma,Governor,Mick Cornett,REP,550050,0,0,0,0,
Oklahoma,Governor,Kevin Stitt,REP,550050,0,0,0,0,
Oklahoma,Lieutenant Governor,Dana Murphy,REP,550050,0,0,0,0,
Oklahoma,Lieutenant Governor,Matt Pinnell,REP,550050,0,0,0,0,
Oklahoma,State Auditor,Cindy Byrd,REP,550050,0,0,0,0,
Oklahoma,State Auditor,Charlie Prater,REP,550050,0,0,0,0,
Oklahoma,Attorney General,Mike Hunter,REP,550050,0,0,0,0,
Oklahoma,Attorney General,Gentner Drummond,REP,550050,0,0,0,0,
Oklahoma,Superintendent of Public Instruction,Joy Hofmeister,REP,550050,0,0,0,0,
Oklahoma,Superintendent of Public Instruction,Linda Murphy,REP,550050,0,0,0,0,
Oklahoma,Commissioner of Labor,Cathy Costello,REP,550050,0,0,0,0,
Oklahoma,Commissioner of Labor,Leslie Osborn,REP,550050,0,0,0,0,
Oklahoma,Corporation Commissioner,Bob Anthony,REP,550050,0,0,0,0,
Oklahoma,Corporation Commissioner,Brian Bingman,REP,550050,0,0,0,0,
Oklahoma,Governor,Chris Powell,LIB,550050,0,0,0,0,
Oklahoma,Governor,Rex Lawhorn,LIB,550050,0,0,0,0,
Oklahoma,Corporation Commissioner,Ashley Nicole Mccray,DEM,550050,0,0,3,3,
Oklahoma,Corporation Commissioner,Blake Cummings,DEM,550050,0,0,0,0,
Oklahoma,U.S. House,Kendra Horn,DEM,550050,0,0,3,3,05
Oklahoma,U.S. House,Tom Guild,DEM,550050,0,0,0,0,05
Oklahoma,Governor,Mick Cornett,REP,550051,0,0,113,113,
Oklahoma,Governor,Kevin Stitt,REP,550051,0,0,75,75,
Oklahoma,Lieutenant Governor,Dana Murphy,REP,550051,0,0,91,91,
Oklahoma,Lieutenant Governor,Matt Pinnell,REP,550051,0,0,92,92,
Oklahoma,State Auditor,Cindy Byrd,REP,550051,0,0,95,95,
Oklahoma,State Auditor,Charlie Prater,REP,550051,0,0,83,83,
Oklahoma,Attorney General,Mike Hunter,REP,550051,0,0,104,104,
Oklahoma,Attorney General,Gentner Drummond,REP,550051,0,0,79,79,
Oklahoma,Superintendent of Public Instruction,Joy Hofmeister,REP,550051,0,0,104,104,
Oklahoma,Superintendent of Public Instruction,Linda Murphy,REP,550051,0,0,74,74,
Oklahoma,Commissioner of Labor,Cathy Costello,REP,550051,0,0,72,72,
Oklahoma,Commissioner of Labor,Leslie Osborn,REP,550051,0,0,105,105,
Oklahoma,Corporation Commissioner,Bob Anthony,REP,550051,0,0,99,99,
Oklahoma,Corporation Commissioner,Brian Bingman,REP,550051,0,0,79,79,
Oklahoma,Governor,Chris Powell,LIB,550051,0,0,1,1,
Oklahoma,Governor,Rex Lawhorn,LIB,550051,0,0,0,0,
Oklahoma,Corporation Commissioner,Ashley Nicole Mccray,DEM,550051,0,0,60,60,
Oklahoma,Corporation Commissioner,Blake Cummings,DEM,550051,0,0,14,14,
Oklahoma,U.S. House,Kendra Horn,DEM,550051,0,0,57,57,05
Oklahoma,U.S. House,Tom Guild,DEM,550051,0,0,18,18,05
Oklahoma,Governor,Mick Cornett,REP,550052,0,0,185,185,
Oklahoma,Governor,Kevin Stitt,REP,550052,0,0,137,137,
Oklahoma,Lieutenant Governor,Dana Murphy,REP,550052,0,0,126,126,
Oklahoma,Lieutenant Governor,Matt Pinnell,REP,550052,0,0,181,181,
Oklahoma,State Auditor,Cindy Byrd,REP,550052,0,0,119,119,
Oklahoma,State Auditor,Charlie Prater,REP,550052,0,0,180,180,
Oklahoma,Attorney General,Mike Hunter,REP,550052,0,0,187,187,
Oklahoma,Attorney General,Gentner Drummond,REP,550052,0,0,125,125,
Oklahoma,Superintendent of Public Instruction,Joy Hofmeister,REP,550052,0,0,193,193,
Oklahoma,Superintendent of Public Instruction,Linda Murphy,REP,550052,0,0,119,119,
Oklahoma,Commissioner of Labor,Cathy Costello,REP,550052,0,0,141,141,
Oklahoma,Commissioner of Labor,Leslie Osborn,REP,550052,0,0,161,161,
Oklahoma,Corporation Commissioner,Bob Anthony,REP,550052,0,0,182,182,
Oklahoma,Corporation Commissioner,Brian Bingman,REP,550052,0,0,122,122,
Oklahoma,Governor,Chris Powell,LIB,550052,0,0,0,0,
Oklahoma,Governor,Rex Lawhorn,LIB,550052,0,0,0,0,
Oklahoma,Corporation Commissioner,Ashley Nicole Mccray,DEM,550052,0,0,59,59,
Oklahoma,Corporation Commissioner,Blake Cummings,DEM,550052,0,0,13,13,
Oklahoma,U.S. House,Kendra Horn,DEM,550052,0,0,61,61,05
Oklahoma,U.S. House,Tom Guild,DEM,550052,0,0,14,14,05
Oklahoma,Governor,Mick Cornett,REP,550053,0,0,137,137,
Oklahoma,Governor,Kevin Stitt,REP,550053,0,0,115,115,
Oklahoma,Lieutenant Governor,Dana Murphy,REP,550053,0,0,111,111,
Oklahoma,Lieutenant Governor,Matt Pinnell,REP,550053,0,0,130,130,
Oklahoma,State Auditor,Cindy Byrd,REP,550053,0,0,105,105,
Oklahoma,State Auditor,Charlie Prater,REP,550053,0,0,127,127,
Oklahoma,Attorney General,Mike Hunter,REP,550053,0,0,122,122,
Oklahoma,Attorney General,Gentner Drummond,REP,550053,0,0,120,120,
Oklahoma,Superintendent of Public Instruction,Joy Hofmeister,REP,550053,0,0,146,146,
Oklahoma,Superintendent of Public Instruction,Linda Murphy,REP,550053,0,0,94,94,
Oklahoma,Commissioner of Labor,Cathy Costello,REP,550053,0,0,130,130,
Oklahoma,Commissioner of Labor,Leslie Osborn,REP,550053,0,0,111,111,
Oklahoma,Corporation Commissioner,Bob Anthony,REP,550053,0,0,138,138,
Oklahoma,Corporation Commissioner,Brian Bingman,REP,550053,0,0,100,100,
Oklahoma,Governor,Chris Powell,LIB,550053,0,0,1,1,
Oklahoma,Governor,Rex Lawhorn,LIB,550053,0,0,0,0,
Oklahoma,Corporation Commissioner,Ashley Nicole Mccray,DEM,550053,0,0,62,62,
Oklahoma,Corporation Commissioner,Blake Cummings,DEM,550053,0,0,15,15,
Oklahoma,U.S. House,Kendra Horn,DEM,550053,0,0,65,65,05
Oklahoma,U.S. House,Tom Guild,DEM,550053,0,0,13,13,05
Oklahoma,Governor,Mick Cornett,REP,550054,0,0,195,195,
Oklahoma,Governor,Kevin Stitt,REP,550054,0,0,143,143,
Oklahoma,Lieutenant Governor,Dana Murphy,REP,550054,0,0,148,148,
Oklahoma,Lieutenant Governor,Matt Pinnell,REP,550054,0,0,177,177,
Oklahoma,State Auditor,Cindy Byrd,REP,550054,0,0,137,137,
Oklahoma,State Auditor,Charlie Prater,REP,550054,0,0,186,186,
Oklahoma,Attorney General,Mike Hunter,REP,550054,0,0,190,190,
Oklahoma,Attorney General,Gentner Drummond,REP,550054,0,0,146,146,
Oklahoma,Superintendent of Public Instruction,Joy Hofmeister,REP,550054,0,0,206,206,
Oklahoma,Superintendent of Public Instruction,Linda Murphy,REP,550054,0,0,126,126,
Oklahoma,Commissioner of Labor,Cathy Costello,REP,550054,0,0,158,158,
Oklahoma,Commissioner of Labor,Leslie Osborn,REP,550054,0,0,163,163,
Oklahoma,Corporation Commissioner,Bob Anthony,REP,550054,0,0,205,205,
Oklahoma,Corporation Commissioner,Brian Bingman,REP,550054,0,0,117,117,
Oklahoma,Governor,Chris Powell,LIB,550054,0,0,1,1,
Oklahoma,Governor,Rex Lawhorn,LIB,550054,0,0,0,0,
Oklahoma,Corporation Commissioner,Ashley Nicole Mccray,DEM,550054,0,0,71,71,
Oklahoma,Corporation Commissioner,Blake Cummings,DEM,550054,0,0,11,11,
Oklahoma,U.S. House,Kendra Horn,DEM,550054,0,0,69,69,05
Oklahoma,U.S. House,Tom Guild,DEM,550054,0,0,13,13,05
Oklahoma,Governor,Mick Cornett,REP,550055,0,0,182,182,
Oklahoma,Governor,Kevin Stitt,REP,550055,0,0,131,131,
Oklahoma,Lieutenant Governor,Dana Murphy,REP,550055,0,0,130,130,
Oklahoma,Lieutenant Governor,Matt Pinnell,REP,550055,0,0,164,164,
Oklahoma,State Auditor,Cindy Byrd,REP,550055,0,0,128,128,
Oklahoma,State Auditor,Charlie Prater,REP,550055,0,0,162,162,
Oklahoma,Attorney General,Mike Hunter,REP,550055,0,0,194,194,
Oklahoma,Attorney General,Gentner Drummond,REP,550055,0,0,108,108,
Oklahoma,Superintendent of Public Instruction,Joy Hofmeister,REP,550055,0,0,174,174,
Oklahoma,Superintendent of Public Instruction,Linda Murphy,REP,550055,0,0,126,126,
Oklahoma,Commissioner of Labor,Cathy Costello,REP,550055,0,0,153,153,
Oklahoma,Commissioner of Labor,Leslie Osborn,REP,550055,0,0,146,146,
Oklahoma,Corporation Commissioner,Bob Anthony,REP,550055,0,0,179,179,
Oklahoma,Corporation Commissioner,Brian Bingman,REP,550055,0,0,115,115,
Oklahoma,Governor,Chris Powell,LIB,550055,0,0,0,0,
Oklahoma,Governor,Rex Lawhorn,LIB,550055,0,0,0,0,
Oklahoma,Corporation Commissioner,Ashley Nicole Mccray,DEM,550055,0,0,91,91,
Oklahoma,Corporation Commissioner,Blake Cummings,DEM,550055,0,0,13,13,
Oklahoma,U.S. House,Kendra Horn,DEM,550055,0,0,97,97,05
Oklahoma,U.S. House,Tom Guild,DEM,550055,0,0,10,10,05
Oklahoma,Governor,Mick Cornett,REP,550056,0,0,224,224,
Oklahoma,Governor,Kevin Stitt,REP,550056,0,0,116,116,
Oklahoma,Lieutenant Governor,Dana Murphy,REP,550056,0,0,161,161,
Oklahoma,Lieutenant Governor,Matt Pinnell,REP,550056,0,0,169,169,
Oklahoma,State Auditor,Cindy Byrd,REP,550056,0,0,139,139,
Oklahoma,State Auditor,Charlie Prater,REP,550056,0,0,174,174,
Oklahoma,Attorney General,Mike Hunter,REP,550056,0,0,232,232,
Oklahoma,Attorney General,Gentner Drummond,REP,550056,0,0,96,96,
Oklahoma,Superintendent of Public Instruction,Joy Hofmeister,REP,550056,0,0,181,181,
Oklahoma,Superintendent of Public Instruction,Linda Murphy,REP,550056,0,0,146,146,
Oklahoma,Commissioner of Labor,Cathy Costello,REP,550056,0,0,148,148,
Oklahoma,Commissioner of Labor,Leslie Osborn,REP,550056,0,0,174,174,
Oklahoma,Corporation Commissioner,Bob Anthony,REP,550056,0,0,196,196,
Oklahoma,Corporation Commissioner,Brian Bingman,REP,550056,0,0,123,123,
Oklahoma,Governor,Chris Powell,LIB,550056,0,0,1,1,
Oklahoma,Governor,Rex Lawhorn,LIB,550056,0,0,0,0,
Oklahoma,Corporation Commissioner,Ashley Nicole Mccray,DEM,550056,0,0,59,59,
Oklahoma,Corporation Commissioner,Blake Cummings,DEM,550056,0,0,24,24,
Oklahoma,U.S. House,Kendra Horn,DEM,550056,0,0,68,68,05
Oklahoma,U.S. House,Tom Guild,DEM,550056,0,0,18,18,05
Oklahoma,Governor,Mick Cornett,REP,550057,0,0,152,152,
Oklahoma,Governor,Kevin Stitt,REP,550057,0,0,103,103,
Oklahoma,Lieutenant Governor,Dana Murphy,REP,550057,0,0,114,114,
Oklahoma,Lieutenant Governor,Matt Pinnell,REP,550057,0,0,136,136,
Oklahoma,State Auditor,Cindy Byrd,REP,550057,0,0,116,116,
Oklahoma,State Auditor,Charlie Prater,REP,550057,0,0,128,128,
Oklahoma,Attorney General,Mike Hunter,REP,550057,0,0,160,160,
Oklahoma,Attorney General,Gentner Drummond,REP,550057,0,0,91,91,
Oklahoma,Superintendent of Public Instruction,Joy Hofmeister,REP,550057,0,0,138,138,
Oklahoma,Superintendent of Public Instruction,Linda Murphy,REP,550057,0,0,112,112,
Oklahoma,Commissioner of Labor,Cathy Costello,REP,550057,0,0,134,134,
Oklahoma,Commissioner of Labor,Leslie Osborn,REP,550057,0,0,111,111,
Oklahoma,Corporation Commissioner,Bob Anthony,REP,550057,0,0,153,153,
Oklahoma,Corporation Commissioner,Brian Bingman,REP,550057,0,0,94,94,
Oklahoma,Governor,Chris Powell,LIB,550057,0,0,0,0,
Oklahoma,Governor,Rex Lawhorn,LIB,550057,0,0,0,0,
Oklahoma,Corporation Commissioner,Ashley Nicole Mccray,DEM,550057,0,0,54,54,
Oklahoma,Corporation Commissioner,Blake Cummings,DEM,550057,0,0,9,9,
Oklahoma,U.S. House,Kendra Horn,DEM,550057,0,0,48,48,05
Oklahoma,U.S. House,Tom Guild,DEM,550057,0,0,17,17,05
Oklahoma,Governor,Mick Cornett,REP,550058,0,0,541,541,
Oklahoma,Governor,Kevin Stitt,REP,550058,0,0,308,308,
Oklahoma,Lieutenant Governor,Dana Murphy,REP,550058,0,0,393,393,
Oklahoma,Lieutenant Governor,Matt Pinnell,REP,550058,0,0,430,430,
Oklahoma,State Auditor,Cindy Byrd,REP,550058,0,0,372,372,
Oklahoma,State Auditor,Charlie Prater,REP,550058,0,0,410,410,
Oklahoma,Attorney General,Mike Hunter,REP,550058,0,0,564,564,
Oklahoma,Attorney General,Gentner Drummond,REP,550058,0,0,262,262,
Oklahoma,Superintendent of Public Instruction,Joy Hofmeister,REP,550058,0,0,509,509,
Oklahoma,Superintendent of Public Instruction,Linda Murphy,REP,550058,0,0,303,303,
Oklahoma,Commissioner of Labor,Cathy Costello,REP,550058,0,0,418,418,
Oklahoma,Commissioner of Labor,Leslie Osborn,REP,550058,0,0,397,397,
Oklahoma,Corporation Commissioner,Bob Anthony,REP,550058,0,0,462,462,
Oklahoma,Corporation Commissioner,Brian Bingman,REP,550058,0,0,344,344,
Oklahoma,Governor,Chris Powell,LIB,550058,0,0,0,0,
Oklahoma,Governor,Rex Lawhorn,LIB,550058,0,0,0,0,
Oklahoma,Corporation Commissioner,Ashley Nicole Mccray,DEM,550058,0,0,97,97,
Oklahoma,Corporation Commissioner,Blake Cummings,DEM,550058,0,0,22,22,
Oklahoma,U.S. House,Kendra Horn,DEM,550058,0,0,104,104,05
Oklahoma,U.S. House,Tom Guild,DEM,550058,0,0,19,19,05
Oklahoma,Governor,Mick Cornett,REP,550059,0,0,289,289,
Oklahoma,Governor,Kevin Stitt,REP,550059,0,0,233,233,
Oklahoma,Lieutenant Governor,Dana Murphy,REP,550059,0,0,239,239,
Oklahoma,Lieutenant Governor,Matt Pinnell,REP,550059,0,0,269,269,
Oklahoma,State Auditor,Cindy Byrd,REP,550059,0,0,248,248,
Oklahoma,State Auditor,Charlie Prater,REP,550059,0,0,236,236,
Oklahoma,Attorney General,Mike Hunter,REP,550059,0,0,316,316,
Oklahoma,Attorney General,Gentner Drummond,REP,550059,0,0,184,184,
Oklahoma,Superintendent of Public Instruction,Joy Hofmeister,REP,550059,0,0,277,277,
Oklahoma,Superintendent of Public Instruction,Linda Murphy,REP,550059,0,0,219,219,
Oklahoma,Commissioner of Labor,Cathy Costello,REP,550059,0,0,260,260,
Oklahoma,Commissioner of Labor,Leslie Osborn,REP,550059,0,0,242,242,
Oklahoma,Corporation Commissioner,Bob Anthony,REP,550059,0,0,293,293,
Oklahoma,Corporation Commissioner,Brian Bingman,REP,550059,0,0,200,200,
Oklahoma,Governor,Chris Powell,LIB,550059,0,0,0,0,
Oklahoma,Governor,Rex Lawhorn,LIB,550059,0,0,0,0,
Oklahoma,Corporation Commissioner,Ashley Nicole Mccray,DEM,550059,0,0,54,54,
Oklahoma,Corporation Commissioner,Blake Cummings,DEM,550059,0,0,15,15,
Oklahoma,U.S. House,Kendra Horn,DEM,550059,0,0,59,59,05
Oklahoma,U.S. House,Tom Guild,DEM,550059,0,0,10,10,05
Oklahoma,Governor,Mick Cornett,REP,550060,0,0,407,407,
Oklahoma,Governor,Kevin Stitt,REP,550060,0,0,252,252,
Oklahoma,Lieutenant Governor,Dana Murphy,REP,550060,0,0,311,311,
Oklahoma,Lieutenant Governor,Matt Pinnell,REP,550060,0,0,327,327,
Oklahoma,State Auditor,Cindy Byrd,REP,550060,0,0,285,285,
Oklahoma,State Auditor,Charlie Prater,REP,550060,0,0,325,325,
Oklahoma,Attorney General,Mike Hunter,REP,550060,0,0,413,413,
Oklahoma,Attorney General,Gentner Drummond,REP,550060,0,0,228,228,
Oklahoma,Superintendent of Public Instruction,Joy Hofmeister,REP,550060,0,0,367,367,
Oklahoma,Superintendent of Public Instruction,Linda Murphy,REP,550060,0,0,253,253,
Oklahoma,Commissioner of Labor,Cathy Costello,REP,550060,0,0,307,307,
Oklahoma,Commissioner of Labor,Leslie Osborn,REP,550060,0,0,320,320,
Oklahoma,Corporation Commissioner,Bob Anthony,REP,550060,0,0,379,379,
Oklahoma,Corporation Commissioner,Brian Bingman,REP,550060,0,0,242,242,
Oklahoma,Governor,Chris Powell,LIB,550060,0,0,4,4,
Oklahoma,Governor,Rex Lawhorn,LIB,550060,0,0,0,0,
Oklahoma,Corporation Commissioner,Ashley Nicole Mccray,DEM,550060,0,0,95,95,
Oklahoma,Corporation Commissioner,Blake Cummings,DEM,550060,0,0,27,27,
Oklahoma,U.S. House,Kendra Horn,DEM,550060,0,0,100,100,05
Oklahoma,U.S. House,Tom Guild,DEM,550060,0,0,21,21,05
Oklahoma,Governor,Mick Cornett,REP,550061,0,0,415,415,
Oklahoma,Governor,Kevin Stitt,REP,550061,0,0,234,234,
Oklahoma,Lieutenant Governor,Dana Murphy,REP,550061,0,0,298,298,
Oklahoma,Lieutenant Governor,Matt Pinnell,REP,550061,0,0,332,332,
Oklahoma,State Auditor,Cindy Byrd,REP,550061,0,0,298,298,
Oklahoma,State Auditor,Charlie Prater,REP,550061,0,0,301,301,
Oklahoma,Attorney General,Mike Hunter,REP,550061,0,0,435,435,
Oklahoma,Attorney General,Gentner Drummond,REP,550061,0,0,196,196,
Oklahoma,Superintendent of Public Instruction,Joy Hofmeister,REP,550061,0,0,384,384,
Oklahoma,Superintendent of Public Instruction,Linda Murphy,REP,550061,0,0,241,241,
Oklahoma,Commissioner of Labor,Cathy Costello,REP,550061,0,0,316,316,
Oklahoma,Commissioner of Labor,Leslie Osborn,REP,550061,0,0,309,309,
Oklahoma,Corporation Commissioner,Bob Anthony,REP,550061,0,0,386,386,
Oklahoma,Corporation Commissioner,Brian Bingman,REP,550061,0,0,233,233,
Oklahoma,Governor,Chris Powell,LIB,550061,0,0,2,2,
Oklahoma,Governor,Rex Lawhorn,LIB,550061,0,0,0,0,
Oklahoma,Corporation Commissioner,Ashley Nicole Mccray,DEM,550061,0,0,85,85,
Oklahoma,Corporation Commissioner,Blake Cummings,DEM,550061,0,0,22,22,
Oklahoma,U.S. House,Kendra Horn,DEM,550061,0,0,99,99,05
Oklahoma,U.S. House,Tom Guild,DEM,550061,0,0,10,10,05
Oklahoma,Governor,Mick Cornett,REP,550062,0,0,397,397,
Oklahoma,Governor,Kevin Stitt,REP,550062,0,0,253,253,
Oklahoma,Lieutenant Governor,Dana Murphy,REP,550062,0,0,311,311,
Oklahoma,Lieutenant Governor,Matt Pinnell,REP,550062,0,0,319,319,
Oklahoma,State Auditor,Cindy Byrd,REP,550062,0,0,267,267,
Oklahoma,State Auditor,Charlie Prater,REP,550062,0,0,334,334,
Oklahoma,Attorney General,Mike Hunter,REP,550062,0,0,411,411,
Oklahoma,Attorney General,Gentner Drummond,REP,550062,0,0,215,215,
Oklahoma,Superintendent of Public Instruction,Joy Hofmeister,REP,550062,0,0,392,392,
Oklahoma,Superintendent of Public Instruction,Linda Murphy,REP,550062,0,0,239,239,
Oklahoma,Commissioner of Labor,Cathy Costello,REP,550062,0,0,307,307,
Oklahoma,Commissioner of Labor,Leslie Osborn,REP,550062,0,0,311,311,
Oklahoma,Corporation Commissioner,Bob Anthony,REP,550062,0,0,395,395,
Oklahoma,Corporation Commissioner,Brian Bingman,REP,550062,0,0,222,222,
Oklahoma,Governor,Chris Powell,LIB,550062,0,0,0,0,
Oklahoma,Governor,Rex Lawhorn,LIB,550062,0,0,0,0,
Oklahoma,Corporation Commissioner,Ashley Nicole Mccray,DEM,550062,0,0,122,122,
Oklahoma,Corporation Commissioner,Blake Cummings,DEM,550062,0,0,42,42,
Oklahoma,U.S. House,Kendra Horn,DEM,550062,0,0,146,146,05
Oklahoma,U.S. House,Tom Guild,DEM,550062,0,0,20,20,05
Oklahoma,Governor,Mick Cornett,REP,550063,0,0,166,166,
Oklahoma,Governor,Kevin Stitt,REP,550063,0,0,115,115,
Oklahoma,Lieutenant Governor,Dana Murphy,REP,550063,0,0,130,130,
Oklahoma,Lieutenant Governor,Matt Pinnell,REP,550063,0,0,143,143,
Oklahoma,State Auditor,Cindy Byrd,REP,550063,0,0,105,105,
Oklahoma,State Auditor,Charlie Prater,REP,550063,0,0,154,154,
Oklahoma,Attorney General,Mike Hunter,REP,550063,0,0,168,168,
Oklahoma,Attorney General,Gentner Drummond,REP,550063,0,0,104,104,
Oklahoma,Superintendent of Public Instruction,Joy Hofmeister,REP,550063,0,0,148,148,
Oklahoma,Superintendent of Public Instruction,Linda Murphy,REP,550063,0,0,119,119,
Oklahoma,Commissioner of Labor,Cathy Costello,REP,550063,0,0,137,137,
Oklahoma,Commissioner of Labor,Leslie Osborn,REP,550063,0,0,130,130,
Oklahoma,Corporation Commissioner,Bob Anthony,REP,550063,0,0,161,161,
Oklahoma,Corporation Commissioner,Brian Bingman,REP,550063,0,0,105,105,
Oklahoma,Governor,Chris Powell,LIB,550063,0,0,0,0,
Oklahoma,Governor,Rex Lawhorn,LIB,550063,0,0,0,0,
Oklahoma,Corporation Commissioner,Ashley Nicole Mccray,DEM,550063,0,0,32,32,
Oklahoma,Corporation Commissioner,Blake Cummings,DEM,550063,0,0,11,11,
Oklahoma,U.S. House,Kendra Horn,DEM,550063,0,0,31,31,05
Oklahoma,U.S. House,Tom Guild,DEM,550063,0,0,12,12,05
Oklahoma,Governor,Mick Cornett,REP,550064,0,0,351,351,
Oklahoma,Governor,Kevin Stitt,REP,550064,0,0,283,283,
Oklahoma,Lieutenant Governor,Dana Murphy,REP,550064,0,0,251,251,
Oklahoma,Lieutenant Governor,Matt Pinnell,REP,550064,0,0,362,362,
Oklahoma,State Auditor,Cindy Byrd,REP,550064,0,0,292,292,
Oklahoma,State Auditor,Charlie Prater,REP,550064,0,0,299,299,
Oklahoma,Attorney General,Mike Hunter,REP,550064,0,0,375,375,
Oklahoma,Attorney General,Gentner Drummond,REP,550064,0,0,245,245,
Oklahoma,Superintendent of Public Instruction,Joy Hofmeister,REP,550064,0,0,358,358,
Oklahoma,Superintendent of Public Instruction,Linda Murphy,REP,550064,0,0,255,255,
Oklahoma,Commissioner of Labor,Cathy Costello,REP,550064,0,0,267,267,
Oklahoma,Commissioner of Labor,Leslie Osborn,REP,550064,0,0,343,343,
Oklahoma,Corporation Commissioner,Bob Anthony,REP,550064,0,0,348,348,
Oklahoma,Corporation Commissioner,Brian Bingman,REP,550064,0,0,263,263,
Oklahoma,Governor,Chris Powell,LIB,550064,0,0,0,0,
Oklahoma,Governor,Rex Lawhorn,LIB,550064,0,0,2,2,
Oklahoma,Corporation Commissioner,Ashley Nicole Mccray,DEM,550064,0,0,76,76,
Oklahoma,Corporation Commissioner,Blake Cummings,DEM,550064,0,0,15,15,
Oklahoma,U.S. House,Kendra Horn,DEM,550064,0,0,82,82,05
Oklahoma,U.S. House,Tom Guild,DEM,550064,0,0,9,9,05
Oklahoma,Governor,Mick Cornett,REP,550065,0,0,182,182,
Oklahoma,Governor,Kevin Stitt,REP,550065,0,0,161,161,
Oklahoma,Lieutenant Governor,Dana Murphy,REP,550065,0,0,156,156,
Oklahoma,Lieutenant Governor,Matt Pinnell,REP,550065,0,0,177,177,
Oklahoma,State Auditor,Cindy Byrd,REP,550065,0,0,160,160,
Oklahoma,State Auditor,Charlie Prater,REP,550065,0,0,163,163,
Oklahoma,Attorney General,Mike Hunter,REP,550065,0,0,201,201,
Oklahoma,Attorney General,Gentner Drummond,REP,550065,0,0,135,135,
Oklahoma,Superintendent of Public Instruction,Joy Hofmeister,REP,550065,0,0,166,166,
Oklahoma,Superintendent of Public Instruction,Linda Murphy,REP,550065,0,0,162,162,
Oklahoma,Commissioner of Labor,Cathy Costello,REP,550065,0,0,162,162,
Oklahoma,Commissioner of Labor,Leslie Osborn,REP,550065,0,0,162,162,
Oklahoma,Corporation Commissioner,Bob Anthony,REP,550065,0,0,159,159,
Oklahoma,Corporation Commissioner,Brian Bingman,REP,550065,0,0,169,169,
Oklahoma,Governor,Chris Powell,LIB,550065,0,0,0,0,
Oklahoma,Governor,Rex Lawhorn,LIB,550065,0,0,0,0,
Oklahoma,Corporation Commissioner,Ashley Nicole Mccray,DEM,550065,0,0,53,53,
Oklahoma,Corporation Commissioner,Blake Cummings,DEM,550065,0,0,24,24,
Oklahoma,U.S. House,Kendra Horn,DEM,550065,0,0,57,57,05
Oklahoma,U.S. House,Tom Guild,DEM,550065,0,0,21,21,05
Oklahoma,Governor,Mick Cornett,REP,550066,0,0,51,51,
Oklahoma,Governor,Kevin Stitt,REP,550066,0,0,43,43,
Oklahoma,Lieutenant Governor,Dana Murphy,REP,550066,0,0,37,37,
Oklahoma,Lieutenant Governor,Matt Pinnell,REP,550066,0,0,54,54,
Oklahoma,State Auditor,Cindy Byrd,REP,550066,0,0,47,47,
Oklahoma,State Auditor,Charlie Prater,REP,550066,0,0,43,43,
Oklahoma,Attorney General,Mike Hunter,REP,550066,0,0,55,55,
Oklahoma,Attorney General,Gentner Drummond,REP,550066,0,0,38,38,
Oklahoma,Superintendent of Public Instruction,Joy Hofmeister,REP,550066,0,0,53,53,
Oklahoma,Superintendent of Public Instruction,Linda Murphy,REP,550066,0,0,39,39,
Oklahoma,Commissioner of Labor,Cathy Costello,REP,550066,0,0,40,40,
Oklahoma,Commissioner of Labor,Leslie Osborn,REP,550066,0,0,49,49,
Oklahoma,Corporation Commissioner,Bob Anthony,REP,550066,0,0,64,64,
Oklahoma,Corporation Commissioner,Brian Bingman,REP,550066,0,0,27,27,
Oklahoma,Governor,Chris Powell,LIB,550066,0,0,0,0,
Oklahoma,Governor,Rex Lawhorn,LIB,550066,0,0,0,0,
Oklahoma,Corporation Commissioner,Ashley Nicole Mccray,DEM,550066,0,0,254,254,
Oklahoma,Corporation Commissioner,Blake Cummings,DEM,550066,0,0,72,72,
Oklahoma,U.S. House,Kendra Horn,DEM,550066,0,0,228,228,05
Oklahoma,U.S. House,Tom Guild,DEM,550066,0,0,108,108,05
Oklahoma,Governor,Mick Cornett,REP,550067,0,0,157,157,
Oklahoma,Governor,Kevin Stitt,REP,550067,0,0,192,192,
Oklahoma,Lieutenant Governor,Dana Murphy,REP,550067,0,0,140,140,
Oklahoma,Lieutenant Governor,Matt Pinnell,REP,550067,0,0,202,202,
Oklahoma,State Auditor,Cindy Byrd,REP,550067,0,0,162,162,
Oklahoma,State Auditor,Charlie Prater,REP,550067,0,0,171,171,
Oklahoma,Attorney General,Mike Hunter,REP,550067,0,0,167,167,
Oklahoma,Attorney General,Gentner Drummond,REP,550067,0,0,175,175,
Oklahoma,Superintendent of Public Instruction,Joy Hofmeister,REP,550067,0,0,180,180,
Oklahoma,Superintendent of Public Instruction,Linda Murphy,REP,550067,0,0,163,163,
Oklahoma,Commissioner of Labor,Cathy Costello,REP,550067,0,0,143,143,
Oklahoma,Commissioner of Labor,Leslie Osborn,REP,550067,0,0,195,195,
Oklahoma,Corporation Commissioner,Bob Anthony,REP,550067,0,0,182,182,
Oklahoma,Corporation Commissioner,Brian Bingman,REP,550067,0,0,161,161,
Oklahoma,State House,Tess Teague,REP,550067,0,0,173,173,10
Oklahoma,State House,Robert Manger,REP,550067,0,0,169,169,10
Oklahoma,Governor,Chris Powell,LIB,550067,0,0,1,1,
Oklahoma,Governor,Rex Lawhorn,LIB,550067,0,0,1,1,
Oklahoma,Corporation Commissioner,Ashley Nicole Mccray,DEM,550067,0,0,58,58,
Oklahoma,Corporation Commissioner,Blake Cummings,DEM,550067,0,0,25,25,
Oklahoma,U.S. House,Kendra Horn,DEM,550067,0,0,63,63,05
Oklahoma,U.S. House,Tom Guild,DEM,550067,0,0,23,23,05
Oklahoma,State House,Madeline Scott,DEM,550067,0,0,54,54,10
Oklahoma,State House,John Carpenter,DEM,550067,0,0,32,32,10
Oklahoma,Governor,Mick Cornett,REP,550068,0,0,99,99,
Oklahoma,Governor,Kevin Stitt,REP,550068,0,0,118,118,
Oklahoma,Lieutenant Governor,Dana Murphy,REP,550068,0,0,74,74,
Oklahoma,Lieutenant Governor,Matt Pinnell,REP,550068,0,0,139,139,
Oklahoma,State Auditor,Cindy Byrd,REP,550068,0,0,103,103,
Oklahoma,State Auditor,Charlie Prater,REP,550068,0,0,108,108,
Oklahoma,Attorney General,Mike Hunter,REP,550068,0,0,100,100,
Oklahoma,Attorney General,Gentner Drummond,REP,550068,0,0,115,115,
Oklahoma,Superintendent of Public Instruction,Joy Hofmeister,REP,550068,0,0,98,98,
Oklahoma,Superintendent of Public Instruction,Linda Murphy,REP,550068,0,0,120,120,
Oklahoma,Commissioner of Labor,Cathy Costello,REP,550068,0,0,92,92,
Oklahoma,Commissioner of Labor,Leslie Osborn,REP,550068,0,0,123,123,
Oklahoma,Corporation Commissioner,Bob Anthony,REP,550068,0,0,100,100,
Oklahoma,Corporation Commissioner,Brian Bingman,REP,550068,0,0,111,111,
Oklahoma,Governor,Chris Powell,LIB,550068,0,0,0,0,
Oklahoma,Governor,Rex Lawhorn,LIB,550068,0,0,1,1,
Oklahoma,Corporation Commissioner,Ashley Nicole Mccray,DEM,550068,0,0,20,20,
Oklahoma,Corporation Commissioner,Blake Cummings,DEM,550068,0,0,19,19,
Oklahoma,U.S. House,Kendra Horn,DEM,550068,0,0,19,19,05
Oklahoma,U.S. House,Tom Guild,DEM,550068,0,0,19,19,05
Oklahoma,Governor,Mick Cornett,REP,550069,0,0,118,118,
Oklahoma,Governor,Kevin Stitt,REP,550069,0,0,144,144,
Oklahoma,Lieutenant Governor,Dana Murphy,REP,550069,0,0,93,93,
Oklahoma,Lieutenant Governor,Matt Pinnell,REP,550069,0,0,165,165,
Oklahoma,State Auditor,Cindy Byrd,REP,550069,0,0,103,103,
Oklahoma,State Auditor,Charlie Prater,REP,550069,0,0,146,146,
Oklahoma,Attorney General,Mike Hunter,REP,550069,0,0,139,139,
Oklahoma,Attorney General,Gentner Drummond,REP,550069,0,0,117,117,
Oklahoma,Superintendent of Public Instruction,Joy Hofmeister,REP,550069,0,0,137,137,
Oklahoma,Superintendent of Public Instruction,Linda Murphy,REP,550069,0,0,115,115,
Oklahoma,Commissioner of Labor,Cathy Costello,REP,550069,0,0,115,115,
Oklahoma,Commissioner of Labor,Leslie Osborn,REP,550069,0,0,132,132,
Oklahoma,Corporation Commissioner,Bob Anthony,REP,550069,0,0,133,133,
Oklahoma,Corporation Commissioner,Brian Bingman,REP,550069,0,0,122,122,
Oklahoma,Governor,Chris Powell,LIB,550069,0,0,0,0,
Oklahoma,Governor,Rex Lawhorn,LIB,550069,0,0,0,0,
Oklahoma,Corporation Commissioner,Ashley Nicole Mccray,DEM,550069,0,0,40,40,
Oklahoma,Corporation Commissioner,Blake Cummings,DEM,550069,0,0,18,18,
Oklahoma,U.S. House,Kendra Horn,DEM,550069,0,0,42,42,05
Oklahoma,U.S. House,Tom Guild,DEM,550069,0,0,16,16,05
Oklahoma,Governor,Mick Cornett,REP,550070,0,0,114,114,
Oklahoma,Governor,Kevin Stitt,REP,550070,0,0,94,94,
Oklahoma,Lieutenant Governor,Dana Murphy,REP,550070,0,0,103,103,
Oklahoma,Lieutenant Governor,Matt Pinnell,REP,550070,0,0,102,102,
Oklahoma,State Auditor,Cindy Byrd,REP,550070,0,0,81,81,
Oklahoma,State Auditor,Charlie Prater,REP,550070,0,0,120,120,
Oklahoma,Attorney General,Mike Hunter,REP,550070,0,0,106,106,
Oklahoma,Attorney General,Gentner Drummond,REP,550070,0,0,100,100,
Oklahoma,Superintendent of Public Instruction,Joy Hofmeister,REP,550070,0,0,120,120,
Oklahoma,Superintendent of Public Instruction,Linda Murphy,REP,550070,0,0,84,84,
Oklahoma,Commissioner of Labor,Cathy Costello,REP,550070,0,0,79,79,
Oklahoma,Commissioner of Labor,Leslie Osborn,REP,550070,0,0,119,119,
Oklahoma,Corporation Commissioner,Bob Anthony,REP,550070,0,0,95,95,
Oklahoma,Corporation Commissioner,Brian Bingman,REP,550070,0,0,108,108,
Oklahoma,Governor,Chris Powell,LIB,550070,0,0,0,0,
Oklahoma,Governor,Rex Lawhorn,LIB,550070,0,0,1,1,
Oklahoma,Corporation Commissioner,Ashley Nicole Mccray,DEM,550070,0,0,28,28,
Oklahoma,Corporation Commissioner,Blake Cummings,DEM,550070,0,0,15,15,
Oklahoma,U.S. House,Kendra Horn,DEM,550070,0,0,26,26,05
Oklahoma,U.S. House,Tom Guild,DEM,550070,0,0,17,17,05
Oklahoma,Governor,Mick Cornett,REP,550071,0,0,125,125,
Oklahoma,Governor,Kevin Stitt,REP,550071,0,0,184,184,
Oklahoma,Lieutenant Governor,Dana Murphy,REP,550071,0,0,119,119,
Oklahoma,Lieutenant Governor,Matt Pinnell,REP,550071,0,0,183,183,
Oklahoma,State Auditor,Cindy Byrd,REP,550071,0,0,136,136,
Oklahoma,State Auditor,Charlie Prater,REP,550071,0,0,163,163,
Oklahoma,Attorney General,Mike Hunter,REP,550071,0,0,141,141,
Oklahoma,Attorney General,Gentner Drummond,REP,550071,0,0,166,166,
Oklahoma,Superintendent of Public Instruction,Joy Hofmeister,REP,550071,0,0,165,165,
Oklahoma,Superintendent of Public Instruction,Linda Murphy,REP,550071,0,0,139,139,
Oklahoma,Commissioner of Labor,Cathy Costello,REP,550071,0,0,119,119,
Oklahoma,Commissioner of Labor,Leslie Osborn,REP,550071,0,0,182,182,
Oklahoma,Corporation Commissioner,Bob Anthony,REP,550071,0,0,144,144,
Oklahoma,Corporation Commissioner,Brian Bingman,REP,550071,0,0,158,158,
Oklahoma,Governor,Chris Powell,LIB,550071,0,0,0,0,
Oklahoma,Governor,Rex Lawhorn,LIB,550071,0,0,0,0,
Oklahoma,Corporation Commissioner,Ashley Nicole Mccray,DEM,550071,0,0,39,39,
Oklahoma,Corporation Commissioner,Blake Cummings,DEM,550071,0,0,11,11,
Oklahoma,U.S. House,Kendra Horn,DEM,550071,0,0,33,33,05
Oklahoma,U.S. House,Tom Guild,DEM,550071,0,0,17,17,05
Oklahoma,Governor,Mick Cornett,REP,550072,0,0,84,84,
Oklahoma,Governor,Kevin Stitt,REP,550072,0,0,92,92,
Oklahoma,Lieutenant Governor,Dana Murphy,REP,550072,0,0,71,71,
Oklahoma,Lieutenant Governor,Matt Pinnell,REP,550072,0,0,105,105,
Oklahoma,State Auditor,Cindy Byrd,REP,550072,0,0,78,78,
Oklahoma,State Auditor,Charlie Prater,REP,550072,0,0,93,93,
Oklahoma,Attorney General,Mike Hunter,REP,550072,0,0,95,95,
Oklahoma,Attorney General,Gentner Drummond,REP,550072,0,0,80,80,
Oklahoma,Superintendent of Public Instruction,Joy Hofmeister,REP,550072,0,0,84,84,
Oklahoma,Superintendent of Public Instruction,Linda Murphy,REP,550072,0,0,92,92,
Oklahoma,Commissioner of Labor,Cathy Costello,REP,550072,0,0,70,70,
Oklahoma,Commissioner of Labor,Leslie Osborn,REP,550072,0,0,104,104,
Oklahoma,Corporation Commissioner,Bob Anthony,REP,550072,0,0,83,83,
Oklahoma,Corporation Commissioner,Brian Bingman,REP,550072,0,0,92,92,
Oklahoma,Governor,Chris Powell,LIB,550072,0,0,0,0,
Oklahoma,Governor,Rex Lawhorn,LIB,550072,0,0,1,1,
Oklahoma,Corporation Commissioner,Ashley Nicole Mccray,DEM,550072,0,0,36,36,
Oklahoma,Corporation Commissioner,Blake Cummings,DEM,550072,0,0,19,19,
Oklahoma,U.S. House,Kendra Horn,DEM,550072,0,0,44,44,05
Oklahoma,U.S. House,Tom Guild,DEM,550072,0,0,13,13,05
Oklahoma,Governor,Mick Cornett,REP,550073,0,0,16,16,
Oklahoma,Governor,Kevin Stitt,REP,550073,0,0,25,25,
Oklahoma,Lieutenant Governor,Dana Murphy,REP,550073,0,0,22,22,
Oklahoma,Lieutenant Governor,Matt Pinnell,REP,550073,0,0,19,19,
Oklahoma,State Auditor,Cindy Byrd,REP,550073,0,0,18,18,
Oklahoma,State Auditor,Charlie Prater,REP,550073,0,0,20,20,
Oklahoma,Attorney General,Mike Hunter,REP,550073,0,0,19,19,
Oklahoma,Attorney General,Gentner Drummond,REP,550073,0,0,22,22,
Oklahoma,Superintendent of Public Instruction,Joy Hofmeister,REP,550073,0,0,17,17,
Oklahoma,Superintendent of Public Instruction,Linda Murphy,REP,550073,0,0,23,23,
Oklahoma,Commissioner of Labor,Cathy Costello,REP,550073,0,0,14,14,
Oklahoma,Commissioner of Labor,Leslie Osborn,REP,550073,0,0,26,26,
Oklahoma,Corporation Commissioner,Bob Anthony,REP,550073,0,0,22,22,
Oklahoma,Corporation Commissioner,Brian Bingman,REP,550073,0,0,19,19,
Oklahoma,Governor,Chris Powell,LIB,550073,0,0,0,0,
Oklahoma,Governor,Rex Lawhorn,LIB,550073,0,0,0,0,
Oklahoma,Corporation Commissioner,Ashley Nicole Mccray,DEM,550073,0,0,14,14,
Oklahoma,Corporation Commissioner,Blake Cummings,DEM,550073,0,0,9,9,
Oklahoma,U.S. House,Kendra Horn,DEM,550073,0,0,8,8,05
Oklahoma,U.S. House,Tom Guild,DEM,550073,0,0,15,15,05
Oklahoma,Governor,Mick Cornett,REP,550074,0,0,6,6,
Oklahoma,Governor,Kevin Stitt,REP,550074,0,0,6,6,
Oklahoma,Lieutenant Governor,Dana Murphy,REP,550074,0,0,4,4,
Oklahoma,Lieutenant Governor,Matt Pinnell,REP,550074,0,0,8,8,
Oklahoma,State Auditor,Cindy Byrd,REP,550074,0,0,3,3,
Oklahoma,State Auditor,Charlie Prater,REP,550074,0,0,10,10,
Oklahoma,Attorney General,Mike Hunter,REP,550074,0,0,7,7,
Oklahoma,Attorney General,Gentner Drummond,REP,550074,0,0,5,5,
Oklahoma,Superintendent of Public Instruction,Joy Hofmeister,REP,550074,0,0,8,8,
Oklahoma,Superintendent of Public Instruction,Linda Murphy,REP,550074,0,0,4,4,
Oklahoma,Commissioner of Labor,Cathy Costello,REP,550074,0,0,7,7,
Oklahoma,Commissioner of Labor,Leslie Osborn,REP,550074,0,0,5,5,
Oklahoma,Corporation Commissioner,Bob Anthony,REP,550074,0,0,9,9,
Oklahoma,Corporation Commissioner,Brian Bingman,REP,550074,0,0,3,3,
Oklahoma,Governor,Chris Powell,LIB,550074,0,0,0,0,
Oklahoma,Governor,Rex Lawhorn,LIB,550074,0,0,0,0,
Oklahoma,Corporation Commissioner,Ashley Nicole Mccray,DEM,550074,0,0,51,51,
Oklahoma,Corporation Commissioner,Blake Cummings,DEM,550074,0,0,10,10,
Oklahoma,U.S. House,Kendra Horn,DEM,550074,0,0,46,46,05
Oklahoma,U.S. House,Tom Guild,DEM,550074,0,0,15,15,05
Oklahoma,Governor,Mick Cornett,REP,550075,0,0,35,35,
Oklahoma,Governor,Kevin Stitt,REP,550075,0,0,45,45,
Oklahoma,Lieutenant Governor,Dana Murphy,REP,550075,0,0,29,29,
Oklahoma,Lieutenant Governor,Matt Pinnell,REP,550075,0,0,49,49,
Oklahoma,State Auditor,Cindy Byrd,REP,550075,0,0,27,27,
Oklahoma,State Auditor,Charlie Prater,REP,550075,0,0,50,50,
Oklahoma,Attorney General,Mike Hunter,REP,550075,0,0,39,39,
Oklahoma,Attorney General,Gentner Drummond,REP,550075,0,0,38,38,
Oklahoma,Superintendent of Public Instruction,Joy Hofmeister,REP,550075,0,0,44,44,
Oklahoma,Superintendent of Public Instruction,Linda Murphy,REP,550075,0,0,34,34,
Oklahoma,Commissioner of Labor,Cathy Costello,REP,550075,0,0,31,31,
Oklahoma,Commissioner of Labor,Leslie Osborn,REP,550075,0,0,45,45,
Oklahoma,Corporation Commissioner,Bob Anthony,REP,550075,0,0,38,38,
Oklahoma,Corporation Commissioner,Brian Bingman,REP,550075,0,0,39,39,
Oklahoma,Governor,Chris Powell,LIB,550075,0,0,0,0,
Oklahoma,Governor,Rex Lawhorn,LIB,550075,0,0,0,0,
Oklahoma,Corporation Commissioner,Ashley Nicole Mccray,DEM,550075,0,0,161,161,
Oklahoma,Corporation Commissioner,Blake Cummings,DEM,550075,0,0,54,54,
Oklahoma,U.S. House,Kendra Horn,DEM,550075,0,0,178,178,05
Oklahoma,U.S. House,Tom Guild,DEM,550075,0,0,40,40,05
Oklahoma,Governor,Mick Cornett,REP,550076,0,0,95,95,
Oklahoma,Governor,Kevin Stitt,REP,550076,0,0,98,98,
Oklahoma,Lieutenant Governor,Dana Murphy,REP,550076,0,0,78,78,
Oklahoma,Lieutenant Governor,Matt Pinnell,REP,550076,0,0,114,114,
Oklahoma,State Auditor,Cindy Byrd,REP,550076,0,0,93,93,
Oklahoma,State Auditor,Charlie Prater,REP,550076,0,0,97,97,
Oklahoma,Attorney General,Mike Hunter,REP,550076,0,0,88,88,
Oklahoma,Attorney General,Gentner Drummond,REP,550076,0,0,100,100,
Oklahoma,Superintendent of Public Instruction,Joy Hofmeister,REP,550076,0,0,111,111,
Oklahoma,Superintendent of Public Instruction,Linda Murphy,REP,550076,0,0,81,81,
Oklahoma,Commissioner of Labor,Cathy Costello,REP,550076,0,0,61,61,
Oklahoma,Commissioner of Labor,Leslie Osborn,REP,550076,0,0,127,127,
Oklahoma,Corporation Commissioner,Bob Anthony,REP,550076,0,0,88,88,
Oklahoma,Corporation Commissioner,Brian Bingman,REP,550076,0,0,101,101,
Oklahoma,Governor,Chris Powell,LIB,550076,0,0,1,1,
Oklahoma,Governor,Rex Lawhorn,LIB,550076,0,0,0,0,
Oklahoma,Corporation Commissioner,Ashley Nicole Mccray,DEM,550076,0,0,47,47,
Oklahoma,Corporation Commissioner,Blake Cummings,DEM,550076,0,0,24,24,
Oklahoma,U.S. House,Kendra Horn,DEM,550076,0,0,43,43,05
Oklahoma,U.S. House,Tom Guild,DEM,550076,0,0,28,28,05
Oklahoma,Governor,Mick Cornett,REP,550077,0,0,42,42,
Oklahoma,Governor,Kevin Stitt,REP,550077,0,0,41,41,
Oklahoma,Lieutenant Governor,Dana Murphy,REP,550077,0,0,39,39,
Oklahoma,Lieutenant Governor,Matt Pinnell,REP,550077,0,0,44,44,
Oklahoma,State Auditor,Cindy Byrd,REP,550077,0,0,34,34,
Oklahoma,State Auditor,Charlie Prater,REP,550077,0,0,49,49,
Oklahoma,Attorney General,Mike Hunter,REP,550077,0,0,42,42,
Oklahoma,Attorney General,Gentner Drummond,REP,550077,0,0,39,39,
Oklahoma,Superintendent of Public Instruction,Joy Hofmeister,REP,550077,0,0,45,45,
Oklahoma,Superintendent of Public Instruction,Linda Murphy,REP,550077,0,0,38,38,
Oklahoma,Commissioner of Labor,Cathy Costello,REP,550077,0,0,32,32,
Oklahoma,Commissioner of Labor,Leslie Osborn,REP,550077,0,0,49,49,
Oklahoma,Corporation Commissioner,Bob Anthony,REP,550077,0,0,51,51,
Oklahoma,Corporation Commissioner,Brian Bingman,REP,550077,0,0,31,31,
Oklahoma,Governor,Chris Powell,LIB,550077,0,0,4,4,
Oklahoma,Governor,Rex Lawhorn,LIB,550077,0,0,0,0,
Oklahoma,Corporation Commissioner,Ashley Nicole Mccray,DEM,550077,0,0,172,172,
Oklahoma,Corporation Commissioner,Blake Cummings,DEM,550077,0,0,53,53,
Oklahoma,U.S. House,Kendra Horn,DEM,550077,0,0,174,174,05
Oklahoma,U.S. House,Tom Guild,DEM,550077,0,0,54,54,05
Oklahoma,Governor,Mick Cornett,REP,550078,0,0,16,16,
Oklahoma,Governor,Kevin Stitt,REP,550078,0,0,23,23,
Oklahoma,Lieutenant Governor,Dana Murphy,REP,550078,0,0,21,21,
Oklahoma,Lieutenant Governor,Matt Pinnell,REP,550078,0,0,19,19,
Oklahoma,State Auditor,Cindy Byrd,REP,550078,0,0,18,18,
Oklahoma,State Auditor,Charlie Prater,REP,550078,0,0,20,20,
Oklahoma,Attorney General,Mike Hunter,REP,550078,0,0,16,16,
Oklahoma,Attorney General,Gentner Drummond,REP,550078,0,0,24,24,
Oklahoma,Superintendent of Public Instruction,Joy Hofmeister,REP,550078,0,0,21,21,
Oklahoma,Superintendent of Public Instruction,Linda Murphy,REP,550078,0,0,16,16,
Oklahoma,Commissioner of Labor,Cathy Costello,REP,550078,0,0,21,21,
Oklahoma,Commissioner of Labor,Leslie Osborn,REP,550078,0,0,15,15,
Oklahoma,Corporation Commissioner,Bob Anthony,REP,550078,0,0,12,12,
Oklahoma,Corporation Commissioner,Brian Bingman,REP,550078,0,0,26,26,
Oklahoma,Governor,Chris Powell,LIB,550078,0,0,1,1,
Oklahoma,Governor,Rex Lawhorn,LIB,550078,0,0,0,0,
Oklahoma,Corporation Commissioner,Ashley Nicole Mccray,DEM,550078,0,0,115,115,
Oklahoma,Corporation Commissioner,Blake Cummings,DEM,550078,0,0,30,30,
Oklahoma,U.S. House,Kendra Horn,DEM,550078,0,0,112,112,05
Oklahoma,U.S. House,Tom Guild,DEM,550078,0,0,33,33,05
Oklahoma,Governor,Mick Cornett,REP,550079,0,0,29,29,
Oklahoma,Governor,Kevin Stitt,REP,550079,0,0,29,29,
Oklahoma,Lieutenant Governor,Dana Murphy,REP,550079,0,0,31,31,
Oklahoma,Lieutenant Governor,Matt Pinnell,REP,550079,0,0,27,27,
Oklahoma,State Auditor,Cindy Byrd,REP,550079,0,0,30,30,
Oklahoma,State Auditor,Charlie Prater,REP,550079,0,0,26,26,
Oklahoma,Attorney General,Mike Hunter,REP,550079,0,0,33,33,
Oklahoma,Attorney General,Gentner Drummond,REP,550079,0,0,24,24,
Oklahoma,Superintendent of Public Instruction,Joy Hofmeister,REP,550079,0,0,35,35,
Oklahoma,Superintendent of Public Instruction,Linda Murphy,REP,550079,0,0,20,20,
Oklahoma,Commissioner of Labor,Cathy Costello,REP,550079,0,0,28,28,
Oklahoma,Commissioner of Labor,Leslie Osborn,REP,550079,0,0,28,28,
Oklahoma,Corporation Commissioner,Bob Anthony,REP,550079,0,0,32,32,
Oklahoma,Corporation Commissioner,Brian Bingman,REP,550079,0,0,25,25,
Oklahoma,Governor,Chris Powell,LIB,550079,0,0,0,0,
Oklahoma,Governor,Rex Lawhorn,LIB,550079,0,0,0,0,
Oklahoma,Corporation Commissioner,Ashley Nicole Mccray,DEM,550079,0,0,130,130,
Oklahoma,Corporation Commissioner,Blake Cummings,DEM,550079,0,0,43,43,
Oklahoma,U.S. House,Kendra Horn,DEM,550079,0,0,115,115,05
Oklahoma,U.S. House,Tom Guild,DEM,550079,0,0,58,58,05
Oklahoma,Governor,Mick Cornett,REP,550080,0,0,220,220,
Oklahoma,Governor,Kevin Stitt,REP,550080,0,0,171,171,
Oklahoma,Lieutenant Governor,Dana Murphy,REP,550080,0,0,166,166,
Oklahoma,Lieutenant Governor,Matt Pinnell,REP,550080,0,0,216,216,
Oklahoma,State Auditor,Cindy Byrd,REP,550080,0,0,172,172,
Oklahoma,State Auditor,Charlie Prater,REP,550080,0,0,204,204,
Oklahoma,Attorney General,Mike Hunter,REP,550080,0,0,226,226,
Oklahoma,Attorney General,Gentner Drummond,REP,550080,0,0,159,159,
Oklahoma,Superintendent of Public Instruction,Joy Hofmeister,REP,550080,0,0,226,226,
Oklahoma,Superintendent of Public Instruction,Linda Murphy,REP,550080,0,0,153,153,
Oklahoma,Commissioner of Labor,Cathy Costello,REP,550080,0,0,174,174,
Oklahoma,Commissioner of Labor,Leslie Osborn,REP,550080,0,0,204,204,
Oklahoma,Corporation Commissioner,Bob Anthony,REP,550080,0,0,228,228,
Oklahoma,Corporation Commissioner,Brian Bingman,REP,550080,0,0,152,152,
Oklahoma,Governor,Chris Powell,LIB,550080,0,0,0,0,
Oklahoma,Governor,Rex Lawhorn,LIB,550080,0,0,1,1,
Oklahoma,Corporation Commissioner,Ashley Nicole Mccray,DEM,550080,0,0,177,177,
Oklahoma,Corporation Commissioner,Blake Cummings,DEM,550080,0,0,67,67,
Oklahoma,U.S. House,Mary Brannon,DEM,550080,0,0,174,174,04
Oklahoma,U.S. House,Fred Gipson,DEM,550080,0,0,69,69,04
Oklahoma,Governor,Mick Cornett,REP,550081,0,0,75,75,
Oklahoma,Governor,Kevin Stitt,REP,550081,0,0,77,77,
Oklahoma,Lieutenant Governor,Dana Murphy,REP,550081,0,0,64,64,
Oklahoma,Lieutenant Governor,Matt Pinnell,REP,550081,0,0,85,85,
Oklahoma,State Auditor,Cindy Byrd,REP,550081,0,0,64,64,
Oklahoma,State Auditor,Charlie Prater,REP,550081,0,0,79,79,
Oklahoma,Attorney General,Mike Hunter,REP,550081,0,0,69,69,
Oklahoma,Attorney General,Gentner Drummond,REP,550081,0,0,81,81,
Oklahoma,Superintendent of Public Instruction,Joy Hofmeister,REP,550081,0,0,65,65,
Oklahoma,Superintendent of Public Instruction,Linda Murphy,REP,550081,0,0,84,84,
Oklahoma,Commissioner of Labor,Cathy Costello,REP,550081,0,0,75,75,
Oklahoma,Commissioner of Labor,Leslie Osborn,REP,550081,0,0,71,71,
Oklahoma,Corporation Commissioner,Bob Anthony,REP,550081,0,0,69,69,
Oklahoma,Corporation Commissioner,Brian Bingman,REP,550081,0,0,78,78,
Oklahoma,Governor,Chris Powell,LIB,550081,0,0,0,0,
Oklahoma,Governor,Rex Lawhorn,LIB,550081,0,0,3,3,
Oklahoma,Corporation Commissioner,Ashley Nicole Mccray,DEM,550081,0,0,90,90,
Oklahoma,Corporation Commissioner,Blake Cummings,DEM,550081,0,0,26,26,
Oklahoma,U.S. House,Mary Brannon,DEM,550081,0,0,86,86,04
Oklahoma,U.S. House,Fred Gipson,DEM,550081,0,0,30,30,04
Oklahoma,Governor,Mick Cornett,REP,550082,0,0,41,41,
Oklahoma,Governor,Kevin Stitt,REP,550082,0,0,37,37,
Oklahoma,Lieutenant Governor,Dana Murphy,REP,550082,0,0,24,24,
Oklahoma,Lieutenant Governor,Matt Pinnell,REP,550082,0,0,50,50,
Oklahoma,State Auditor,Cindy Byrd,REP,550082,0,0,30,30,
Oklahoma,State Auditor,Charlie Prater,REP,550082,0,0,42,42,
Oklahoma,Attorney General,Mike Hunter,REP,550082,0,0,23,23,
Oklahoma,Attorney General,Gentner Drummond,REP,550082,0,0,51,51,
Oklahoma,Superintendent of Public Instruction,Joy Hofmeister,REP,550082,0,0,31,31,
Oklahoma,Superintendent of Public Instruction,Linda Murphy,REP,550082,0,0,44,44,
Oklahoma,Commissioner of Labor,Cathy Costello,REP,550082,0,0,35,35,
Oklahoma,Commissioner of Labor,Leslie Osborn,REP,550082,0,0,40,40,
Oklahoma,Corporation Commissioner,Bob Anthony,REP,550082,0,0,43,43,
Oklahoma,Corporation Commissioner,Brian Bingman,REP,550082,0,0,29,29,
Oklahoma,Governor,Chris Powell,LIB,550082,0,0,0,0,
Oklahoma,Governor,Rex Lawhorn,LIB,550082,0,0,0,0,
Oklahoma,Corporation Commissioner,Ashley Nicole Mccray,DEM,550082,0,0,38,38,
Oklahoma,Corporation Commissioner,Blake Cummings,DEM,550082,0,0,9,9,
Oklahoma,U.S. House,Mary Brannon,DEM,550082,0,0,33,33,04
Oklahoma,U.S. House,Fred Gipson,DEM,550082,0,0,14,14,04
Oklahoma,Governor,Mick Cornett,REP,550083,0,0,89,89,
Oklahoma,Governor,Kevin Stitt,REP,550083,0,0,78,78,
Oklahoma,Lieutenant Governor,Dana Murphy,REP,550083,0,0,65,65,
Oklahoma,Lieutenant Governor,Matt Pinnell,REP,550083,0,0,95,95,
Oklahoma,State Auditor,Cindy Byrd,REP,550083,0,0,68,68,
Oklahoma,State Auditor,Charlie Prater,REP,550083,0,0,84,84,
Oklahoma,Attorney General,Mike Hunter,REP,550083,0,0,87,87,
Oklahoma,Attorney General,Gentner Drummond,REP,550083,0,0,70,70,
Oklahoma,Superintendent of Public Instruction,Joy Hofmeister,REP,550083,0,0,64,64,
Oklahoma,Superintendent of Public Instruction,Linda Murphy,REP,550083,0,0,91,91,
Oklahoma,Commissioner of Labor,Cathy Costello,REP,550083,0,0,74,74,
Oklahoma,Commissioner of Labor,Leslie Osborn,REP,550083,0,0,82,82,
Oklahoma,Corporation Commissioner,Bob Anthony,REP,550083,0,0,81,81,
Oklahoma,Corporation Commissioner,Brian Bingman,REP,550083,0,0,77,77,
Oklahoma,Governor,Chris Powell,LIB,550083,0,0,0,0,
Oklahoma,Governor,Rex Lawhorn,LIB,550083,0,0,1,1,
Oklahoma,Corporation Commissioner,Ashley Nicole Mccray,DEM,550083,0,0,94,94,
Oklahoma,Corporation Commissioner,Blake Cummings,DEM,550083,0,0,29,29,
Oklahoma,U.S. House,Mary Brannon,DEM,550083,0,0,97,97,04
Oklahoma,U.S. House,Fred Gipson,DEM,550083,0,0,25,25,04
Oklahoma,Governor,Mick Cornett,REP,550084,0,0,57,57,
Oklahoma,Governor,Kevin Stitt,REP,550084,0,0,55,55,
Oklahoma,Lieutenant Governor,Dana Murphy,REP,550084,0,0,48,48,
Oklahoma,Lieutenant Governor,Matt Pinnell,REP,550084,0,0,63,63,
Oklahoma,State Auditor,Cindy Byrd,REP,550084,0,0,44,44,
Oklahoma,State Auditor,Charlie Prater,REP,550084,0,0,61,61,
Oklahoma,Attorney General,Mike Hunter,REP,550084,0,0,55,55,
Oklahoma,Attorney General,Gentner Drummond,REP,550084,0,0,55,55,
Oklahoma,Superintendent of Public Instruction,Joy Hofmeister,REP,550084,0,0,57,57,
Oklahoma,Superintendent of Public Instruction,Linda Murphy,REP,550084,0,0,51,51,
Oklahoma,Commissioner of Labor,Cathy Costello,REP,550084,0,0,40,40,
Oklahoma,Commissioner of Labor,Leslie Osborn,REP,550084,0,0,65,65,
Oklahoma,Corporation Commissioner,Bob Anthony,REP,550084,0,0,57,57,
Oklahoma,Corporation Commissioner,Brian Bingman,REP,550084,0,0,51,51,
Oklahoma,Governor,Chris Powell,LIB,550084,0,0,1,1,
Oklahoma,Governor,Rex Lawhorn,LIB,550084,0,0,0,0,
Oklahoma,Corporation Commissioner,Ashley Nicole Mccray,DEM,550084,0,0,71,71,
Oklahoma,Corporation Commissioner,Blake Cummings,DEM,550084,0,0,33,33,
Oklahoma,U.S. House,Mary Brannon,DEM,550084,0,0,70,70,04
Oklahoma,U.S. House,Fred Gipson,DEM,550084,0,0,31,31,04
Oklahoma,Governor,Mick Cornett,REP,550085,0,0,93,93,
Oklahoma,Governor,Kevin Stitt,REP,550085,0,0,73,73,
Oklahoma,Lieutenant Governor,Dana Murphy,REP,550085,0,0,63,63,
Oklahoma,Lieutenant Governor,Matt Pinnell,REP,550085,0,0,99,99,
Oklahoma,State Auditor,Cindy Byrd,REP,550085,0,0,70,70,
Oklahoma,State Auditor,Charlie Prater,REP,550085,0,0,90,90,
Oklahoma,Attorney General,Mike Hunter,REP,550085,0,0,81,81,
Oklahoma,Attorney General,Gentner Drummond,REP,550085,0,0,81,81,
Oklahoma,Superintendent of Public Instruction,Joy Hofmeister,REP,550085,0,0,90,90,
Oklahoma,Superintendent of Public Instruction,Linda Murphy,REP,550085,0,0,71,71,
Oklahoma,Commissioner of Labor,Cathy Costello,REP,550085,0,0,68,68,
Oklahoma,Commissioner of Labor,Leslie Osborn,REP,550085,0,0,92,92,
Oklahoma,Corporation Commissioner,Bob Anthony,REP,550085,0,0,84,84,
Oklahoma,Corporation Commissioner,Brian Bingman,REP,550085,0,0,76,76,
Oklahoma,Governor,Chris Powell,LIB,550085,0,0,0,0,
Oklahoma,Governor,Rex Lawhorn,LIB,550085,0,0,0,0,
Oklahoma,Corporation Commissioner,Ashley Nicole Mccray,DEM,550085,0,0,100,100,
Oklahoma,Corporation Commissioner,Blake Cummings,DEM,550085,0,0,36,36,
Oklahoma,U.S. House,Mary Brannon,DEM,550085,0,0,98,98,04
Oklahoma,U.S. House,Fred Gipson,DEM,550085,0,0,36,36,04
Oklahoma,Governor,Mick Cornett,REP,550086,0,0,198,198,
Oklahoma,Governor,Kevin Stitt,REP,550086,0,0,113,113,
Oklahoma,Lieutenant Governor,Dana Murphy,REP,550086,0,0,141,141,
Oklahoma,Lieutenant Governor,Matt Pinnell,REP,550086,0,0,163,163,
Oklahoma,State Auditor,Cindy Byrd,REP,550086,0,0,124,124,
Oklahoma,State Auditor,Charlie Prater,REP,550086,0,0,180,180,
Oklahoma,Attorney General,Mike Hunter,REP,550086,0,0,196,196,
Oklahoma,Attorney General,Gentner Drummond,REP,550086,0,0,115,115,
Oklahoma,Superintendent of Public Instruction,Joy Hofmeister,REP,550086,0,0,172,172,
Oklahoma,Superintendent of Public Instruction,Linda Murphy,REP,550086,0,0,138,138,
Oklahoma,Commissioner of Labor,Cathy Costello,REP,550086,0,0,164,164,
Oklahoma,Commissioner of Labor,Leslie Osborn,REP,550086,0,0,140,140,
Oklahoma,Corporation Commissioner,Bob Anthony,REP,550086,0,0,186,186,
Oklahoma,Corporation Commissioner,Brian Bingman,REP,550086,0,0,119,119,
Oklahoma,Governor,Chris Powell,LIB,550086,0,0,4,4,
Oklahoma,Governor,Rex Lawhorn,LIB,550086,0,0,1,1,
Oklahoma,Corporation Commissioner,Ashley Nicole Mccray,DEM,550086,0,0,122,122,
Oklahoma,Corporation Commissioner,Blake Cummings,DEM,550086,0,0,57,57,
Oklahoma,U.S. House,Mary Brannon,DEM,550086,0,0,132,132,04
Oklahoma,U.S. House,Fred Gipson,DEM,550086,0,0,49,49,04
Oklahoma,Governor,Mick Cornett,REP,550087,0,0,39,39,
Oklahoma,Governor,Kevin Stitt,REP,550087,0,0,39,39,
Oklahoma,Lieutenant Governor,Dana Murphy,REP,550087,0,0,25,25,
Oklahoma,Lieutenant Governor,Matt Pinnell,REP,550087,0,0,51,51,
Oklahoma,State Auditor,Cindy Byrd,REP,550087,0,0,34,34,
Oklahoma,State Auditor,Charlie Prater,REP,550087,0,0,40,40,
Oklahoma,Attorney General,Mike Hunter,REP,550087,0,0,33,33,
Oklahoma,Attorney General,Gentner Drummond,REP,550087,0,0,42,42,
Oklahoma,Superintendent of Public Instruction,Joy Hofmeister,REP,550087,0,0,34,34,
Oklahoma,Superintendent of Public Instruction,Linda Murphy,REP,550087,0,0,41,41,
Oklahoma,Commissioner of Labor,Cathy Costello,REP,550087,0,0,46,46,
Oklahoma,Commissioner of Labor,Leslie Osborn,REP,550087,0,0,29,29,
Oklahoma,Corporation Commissioner,Bob Anthony,REP,550087,0,0,43,43,
Oklahoma,Corporation Commissioner,Brian Bingman,REP,550087,0,0,30,30,
Oklahoma,Governor,Chris Powell,LIB,550087,0,0,1,1,
Oklahoma,Governor,Rex Lawhorn,LIB,550087,0,0,0,0,
Oklahoma,Corporation Commissioner,Ashley Nicole Mccray,DEM,550087,0,0,59,59,
Oklahoma,Corporation Commissioner,Blake Cummings,DEM,550087,0,0,19,19,
Oklahoma,U.S. House,Mary Brannon,DEM,550087,0,0,57,57,04
Oklahoma,U.S. House,Fred Gipson,DEM,550087,0,0,20,20,04
Oklahoma,Governor,Mick Cornett,REP,550088,0,0,21,21,
Oklahoma,Governor,Kevin Stitt,REP,550088,0,0,19,19,
Oklahoma,Lieutenant Governor,Dana Murphy,REP,550088,0,0,15,15,
Oklahoma,Lieutenant Governor,Matt Pinnell,REP,550088,0,0,26,26,
Oklahoma,State Auditor,Cindy Byrd,REP,550088,0,0,19,19,
Oklahoma,State Auditor,Charlie Prater,REP,550088,0,0,21,21,
Oklahoma,Attorney General,Mike Hunter,REP,550088,0,0,18,18,
Oklahoma,Attorney General,Gentner Drummond,REP,550088,0,0,18,18,
Oklahoma,Superintendent of Public Instruction,Joy Hofmeister,REP,550088,0,0,21,21,
Oklahoma,Superintendent of Public Instruction,Linda Murphy,REP,550088,0,0,18,18,
Oklahoma,Commissioner of Labor,Cathy Costello,REP,550088,0,0,16,16,
Oklahoma,Commissioner of Labor,Leslie Osborn,REP,550088,0,0,23,23,
Oklahoma,Corporation Commissioner,Bob Anthony,REP,550088,0,0,27,27,
Oklahoma,Corporation Commissioner,Brian Bingman,REP,550088,0,0,11,11,
Oklahoma,State House,Tess Teague,REP,550088,0,0,22,22,10
Oklahoma,State House,Robert Manger,REP,550088,0,0,19,19,10
Oklahoma,Governor,Chris Powell,LIB,550088,0,0,0,0,
Oklahoma,Governor,Rex Lawhorn,LIB,550088,0,0,0,0,
Oklahoma,Corporation Commissioner,Ashley Nicole Mccray,DEM,550088,0,0,44,44,
Oklahoma,Corporation Commissioner,Blake Cummings,DEM,550088,0,0,8,8,
Oklahoma,U.S. House,Mary Brannon,DEM,550088,0,0,37,37,04
Oklahoma,U.S. House,Fred Gipson,DEM,550088,0,0,15,15,04
Oklahoma,State House,Madeline Scott,DEM,550088,0,0,30,30,10
Oklahoma,State House,John Carpenter,DEM,550088,0,0,22,22,10
Oklahoma,Governor,Mick Cornett,REP,550089,0,0,11,11,
Oklahoma,Governor,Kevin Stitt,REP,550089,0,0,44,44,
Oklahoma,Lieutenant Governor,Dana Murphy,REP,550089,0,0,24,24,
Oklahoma,Lieutenant Governor,Matt Pinnell,REP,550089,0,0,31,31,
Oklahoma,State Auditor,Cindy Byrd,REP,550089,0,0,20,20,
Oklahoma,State Auditor,Charlie Prater,REP,550089,0,0,32,32,
Oklahoma,Attorney General,Mike Hunter,REP,550089,0,0,21,21,
Oklahoma,Attorney General,Gentner Drummond,REP,550089,0,0,34,34,
Oklahoma,Superintendent of Public Instruction,Joy Hofmeister,REP,550089,0,0,29,29,
Oklahoma,Superintendent of Public Instruction,Linda Murphy,REP,550089,0,0,25,25,
Oklahoma,Commissioner of Labor,Cathy Costello,REP,550089,0,0,27,27,
Oklahoma,Commissioner of Labor,Leslie Osborn,REP,550089,0,0,25,25,
Oklahoma,Corporation Commissioner,Bob Anthony,REP,550089,0,0,27,27,
Oklahoma,Corporation Commissioner,Brian Bingman,REP,550089,0,0,25,25,
Oklahoma,Governor,Chris Powell,LIB,550089,0,0,0,0,
Oklahoma,Governor,Rex Lawhorn,LIB,550089,0,0,0,0,
Oklahoma,Corporation Commissioner,Ashley Nicole Mccray,DEM,550089,0,0,106,106,
Oklahoma,Corporation Commissioner,Blake Cummings,DEM,550089,0,0,43,43,
Oklahoma,U.S. House,Kendra Horn,DEM,550089,0,0,109,109,05
Oklahoma,U.S. House,Tom Guild,DEM,550089,0,0,43,43,05
Oklahoma,Governor,Mick Cornett,REP,550090,0,0,14,14,
Oklahoma,Governor,Kevin Stitt,REP,550090,0,0,8,8,
Oklahoma,Lieutenant Governor,Dana Murphy,REP,550090,0,0,12,12,
Oklahoma,Lieutenant Governor,Matt Pinnell,REP,550090,0,0,9,9,
Oklahoma,State Auditor,Cindy Byrd,REP,550090,0,0,13,13,
Oklahoma,State Auditor,Charlie Prater,REP,550090,0,0,9,9,
Oklahoma,Attorney General,Mike Hunter,REP,550090,0,0,12,12,
Oklahoma,Attorney General,Gentner Drummond,REP,550090,0,0,10,10,
Oklahoma,Superintendent of Public Instruction,Joy Hofmeister,REP,550090,0,0,13,13,
Oklahoma,Superintendent of Public Instruction,Linda Murphy,REP,550090,0,0,9,9,
Oklahoma,Commissioner of Labor,Cathy Costello,REP,550090,0,0,12,12,
Oklahoma,Commissioner of Labor,Leslie Osborn,REP,550090,0,0,10,10,
Oklahoma,Corporation Commissioner,Bob Anthony,REP,550090,0,0,11,11,
Oklahoma,Corporation Commissioner,Brian Bingman,REP,550090,0,0,11,11,
Oklahoma,State House,Tess Teague,REP,550090,0,0,14,14,10
Oklahoma,State House,Robert Manger,REP,550090,0,0,8,8,10
Oklahoma,Governor,Chris Powell,LIB,550090,0,0,0,0,
Oklahoma,Governor,Rex Lawhorn,LIB,550090,0,0,0,0,
Oklahoma,Corporation Commissioner,Ashley Nicole Mccray,DEM,550090,0,0,11,11,
Oklahoma,Corporation Commissioner,Blake Cummings,DEM,550090,0,0,9,9,
Oklahoma,U.S. House,Kendra Horn,DEM,550090,0,0,13,13,05
Oklahoma,U.S. House,Tom Guild,DEM,550090,0,0,8,8,05
Oklahoma,State House,Madeline Scott,DEM,550090,0,0,7,7,10
Oklahoma,State House,John Carpenter,DEM,550090,0,0,14,14,10
Oklahoma,Governor,Mick Cornett,REP,550091,0,0,15,15,
Oklahoma,Governor,Kevin Stitt,REP,550091,0,0,23,23,
Oklahoma,Lieutenant Governor,Dana Murphy,REP,550091,0,0,13,13,
Oklahoma,Lieutenant Governor,Matt Pinnell,REP,550091,0,0,25,25,
Oklahoma,State Auditor,Cindy Byrd,REP,550091,0,0,19,19,
Oklahoma,State Auditor,Charlie Prater,REP,550091,0,0,19,19,
Oklahoma,Attorney General,Mike Hunter,REP,550091,0,0,15,15,
Oklahoma,Attorney General,Gentner Drummond,REP,550091,0,0,23,23,
Oklahoma,Superintendent of Public Instruction,Joy Hofmeister,REP,550091,0,0,23,23,
Oklahoma,Superintendent of Public Instruction,Linda Murphy,REP,550091,0,0,16,16,
Oklahoma,Commissioner of Labor,Cathy Costello,REP,550091,0,0,21,21,
Oklahoma,Commissioner of Labor,Leslie Osborn,REP,550091,0,0,17,17,
Oklahoma,Corporation Commissioner,Bob Anthony,REP,550091,0,0,22,22,
Oklahoma,Corporation Commissioner,Brian Bingman,REP,550091,0,0,16,16,
Oklahoma,State House,Tess Teague,REP,550091,0,0,22,22,10
Oklahoma,State House,Robert Manger,REP,550091,0,0,17,17,10
Oklahoma,Governor,Chris Powell,LIB,550091,0,0,1,1,
Oklahoma,Governor,Rex Lawhorn,LIB,550091,0,0,0,0,
Oklahoma,Corporation Commissioner,Ashley Nicole Mccray,DEM,550091,0,0,16,16,
Oklahoma,Corporation Commissioner,Blake Cummings,DEM,550091,0,0,14,14,
Oklahoma,U.S. House,Mary Brannon,DEM,550091,0,0,19,19,04
Oklahoma,U.S. House,Fred Gipson,DEM,550091,0,0,11,11,04
Oklahoma,State House,Madeline Scott,DEM,550091,0,0,12,12,10
Oklahoma,State House,John Carpenter,DEM,550091,0,0,18,18,10
Oklahoma,Governor,Mick Cornett,REP,550092,0,0,159,159,
Oklahoma,Governor,Kevin Stitt,REP,550092,0,0,132,132,
Oklahoma,Lieutenant Governor,Dana Murphy,REP,550092,0,0,136,136,
Oklahoma,Lieutenant Governor,Matt Pinnell,REP,550092,0,0,148,148,
Oklahoma,State Auditor,Cindy Byrd,REP,550092,0,0,129,129,
Oklahoma,State Auditor,Charlie Prater,REP,550092,0,0,148,148,
Oklahoma,Attorney General,Mike Hunter,REP,550092,0,0,152,152,
Oklahoma,Attorney General,Gentner Drummond,REP,550092,0,0,135,135,
Oklahoma,Superintendent of Public Instruction,Joy Hofmeister,REP,550092,0,0,171,171,
Oklahoma,Superintendent of Public Instruction,Linda Murphy,REP,550092,0,0,111,111,
Oklahoma,Commissioner of Labor,Cathy Costello,REP,550092,0,0,128,128,
Oklahoma,Commissioner of Labor,Leslie Osborn,REP,550092,0,0,153,153,
Oklahoma,Corporation Commissioner,Bob Anthony,REP,550092,0,0,171,171,
Oklahoma,Corporation Commissioner,Brian Bingman,REP,550092,0,0,108,108,
Oklahoma,State House,Tess Teague,REP,550092,0,0,146,146,10
Oklahoma,State House,Robert Manger,REP,550092,0,0,140,140,10
Oklahoma,Governor,Chris Powell,LIB,550092,0,0,2,2,
Oklahoma,Governor,Rex Lawhorn,LIB,550092,0,0,0,0,
Oklahoma,Corporation Commissioner,Ashley Nicole Mccray,DEM,550092,0,0,182,182,
Oklahoma,Corporation Commissioner,Blake Cummings,DEM,550092,0,0,83,83,
Oklahoma,U.S. House,Mary Brannon,DEM,550092,0,0,193,193,04
Oklahoma,U.S. House,Fred Gipson,DEM,550092,0,0,69,69,04
Oklahoma,State House,Madeline Scott,DEM,550092,0,0,139,139,10
Oklahoma,State House,John Carpenter,DEM,550092,0,0,131,131,10
Oklahoma,Governor,Mick Cornett,REP,550093,0,0,148,148,
Oklahoma,Governor,Kevin Stitt,REP,550093,0,0,116,116,
Oklahoma,Lieutenant Governor,Dana Murphy,REP,550093,0,0,109,109,
Oklahoma,Lieutenant Governor,Matt Pinnell,REP,550093,0,0,145,145,
Oklahoma,State Auditor,Cindy Byrd,REP,550093,0,0,100,100,
Oklahoma,State Auditor,Charlie Prater,REP,550093,0,0,140,140,
Oklahoma,Attorney General,Mike Hunter,REP,550093,0,0,134,134,
Oklahoma,Attorney General,Gentner Drummond,REP,550093,0,0,119,119,
Oklahoma,Superintendent of Public Instruction,Joy Hofmeister,REP,550093,0,0,151,151,
Oklahoma,Superintendent of Public Instruction,Linda Murphy,REP,550093,0,0,97,97,
Oklahoma,Commissioner of Labor,Cathy Costello,REP,550093,0,0,103,103,
Oklahoma,Commissioner of Labor,Leslie Osborn,REP,550093,0,0,146,146,
Oklahoma,Corporation Commissioner,Bob Anthony,REP,550093,0,0,149,149,
Oklahoma,Corporation Commissioner,Brian Bingman,REP,550093,0,0,100,100,
Oklahoma,State House,Tess Teague,REP,550093,0,0,96,96,10
Oklahoma,State House,Robert Manger,REP,550093,0,0,165,165,10
Oklahoma,Governor,Chris Powell,LIB,550093,0,0,0,0,
Oklahoma,Governor,Rex Lawhorn,LIB,550093,0,0,1,1,
Oklahoma,Corporation Commissioner,Ashley Nicole Mccray,DEM,550093,0,0,60,60,
Oklahoma,Corporation Commissioner,Blake Cummings,DEM,550093,0,0,24,24,
Oklahoma,U.S. House,Mary Brannon,DEM,550093,0,0,62,62,04
Oklahoma,U.S. House,Fred Gipson,DEM,550093,0,0,24,24,04
Oklahoma,State House,Madeline Scott,DEM,550093,0,0,38,38,10
Oklahoma,State House,John Carpenter,DEM,550093,0,0,52,52,10
Oklahoma,Governor,Mick Cornett,REP,550094,0,0,178,178,
Oklahoma,Governor,Kevin Stitt,REP,550094,0,0,145,145,
Oklahoma,Lieutenant Governor,Dana Murphy,REP,550094,0,0,141,141,
Oklahoma,Lieutenant Governor,Matt Pinnell,REP,550094,0,0,173,173,
Oklahoma,State Auditor,Cindy Byrd,REP,550094,0,0,148,148,
Oklahoma,State Auditor,Charlie Prater,REP,550094,0,0,153,153,
Oklahoma,Attorney General,Mike Hunter,REP,550094,0,0,180,180,
Oklahoma,Attorney General,Gentner Drummond,REP,550094,0,0,132,132,
Oklahoma,Superintendent of Public Instruction,Joy Hofmeister,REP,550094,0,0,175,175,
Oklahoma,Superintendent of Public Instruction,Linda Murphy,REP,550094,0,0,136,136,
Oklahoma,Commissioner of Labor,Cathy Costello,REP,550094,0,0,141,141,
Oklahoma,Commissioner of Labor,Leslie Osborn,REP,550094,0,0,161,161,
Oklahoma,Corporation Commissioner,Bob Anthony,REP,550094,0,0,165,165,
Oklahoma,Corporation Commissioner,Brian Bingman,REP,550094,0,0,144,144,
Oklahoma,State House,Tess Teague,REP,550094,0,0,124,124,10
Oklahoma,State House,Robert Manger,REP,550094,0,0,192,192,10
Oklahoma,Governor,Chris Powell,LIB,550094,0,0,2,2,
Oklahoma,Governor,Rex Lawhorn,LIB,550094,0,0,0,0,
Oklahoma,Corporation Commissioner,Ashley Nicole Mccray,DEM,550094,0,0,100,100,
Oklahoma,Corporation Commissioner,Blake Cummings,DEM,550094,0,0,56,56,
Oklahoma,U.S. House,Mary Brannon,DEM,550094,0,0,101,101,04
Oklahoma,U.S. House,Fred Gipson,DEM,550094,0,0,55,55,04
Oklahoma,State House,Madeline Scott,DEM,550094,0,0,58,58,10
Oklahoma,State House,John Carpenter,DEM,550094,0,0,103,103,10
Oklahoma,Governor,Mick Cornett,REP,550095,0,0,139,139,
Oklahoma,Governor,Kevin Stitt,REP,550095,0,0,132,132,
Oklahoma,Lieutenant Governor,Dana Murphy,REP,550095,0,0,124,124,
Oklahoma,Lieutenant Governor,Matt Pinnell,REP,550095,0,0,132,132,
Oklahoma,State Auditor,Cindy Byrd,REP,550095,0,0,110,110,
Oklahoma,State Auditor,Charlie Prater,REP,550095,0,0,132,132,
Oklahoma,Attorney General,Mike Hunter,REP,550095,0,0,123,123,
Oklahoma,Attorney General,Gentner Drummond,REP,550095,0,0,128,128,
Oklahoma,Superintendent of Public Instruction,Joy Hofmeister,REP,550095,0,0,141,141,
Oklahoma,Superintendent of Public Instruction,Linda Murphy,REP,550095,0,0,117,117,
Oklahoma,Commissioner of Labor,Cathy Costello,REP,550095,0,0,122,122,
Oklahoma,Commissioner of Labor,Leslie Osborn,REP,550095,0,0,122,122,
Oklahoma,Corporation Commissioner,Bob Anthony,REP,550095,0,0,153,153,
Oklahoma,Corporation Commissioner,Brian Bingman,REP,550095,0,0,94,94,
Oklahoma,State House,Tess Teague,REP,550095,0,0,102,102,10
Oklahoma,State House,Robert Manger,REP,550095,0,0,162,162,10
Oklahoma,Governor,Chris Powell,LIB,550095,0,0,2,2,
Oklahoma,Governor,Rex Lawhorn,LIB,550095,0,0,0,0,
Oklahoma,Corporation Commissioner,Ashley Nicole Mccray,DEM,550095,0,0,103,103,
Oklahoma,Corporation Commissioner,Blake Cummings,DEM,550095,0,0,49,49,
Oklahoma,U.S. House,Mary Brannon,DEM,550095,0,0,106,106,04
Oklahoma,U.S. House,Fred Gipson,DEM,550095,0,0,47,47,04
Oklahoma,State House,Madeline Scott,DEM,550095,0,0,70,70,10
Oklahoma,State House,John Carpenter,DEM,550095,0,0,89,89,10
Oklahoma,Governor,Mick Cornett,REP,550096,0,0,147,147,
Oklahoma,Governor,Kevin Stitt,REP,550096,0,0,95,95,
Oklahoma,Lieutenant Governor,Dana Murphy,REP,550096,0,0,123,123,
Oklahoma,Lieutenant Governor,Matt Pinnell,REP,550096,0,0,111,111,
Oklahoma,State Auditor,Cindy Byrd,REP,550096,0,0,118,118,
Oklahoma,State Auditor,Charlie Prater,REP,550096,0,0,105,105,
Oklahoma,Attorney General,Mike Hunter,REP,550096,0,0,122,122,
Oklahoma,Attorney General,Gentner Drummond,REP,550096,0,0,108,108,
Oklahoma,Superintendent of Public Instruction,Joy Hofmeister,REP,550096,0,0,128,128,
Oklahoma,Superintendent of Public Instruction,Linda Murphy,REP,550096,0,0,108,108,
Oklahoma,Commissioner of Labor,Cathy Costello,REP,550096,0,0,129,129,
Oklahoma,Commissioner of Labor,Leslie Osborn,REP,550096,0,0,102,102,
Oklahoma,Corporation Commissioner,Bob Anthony,REP,550096,0,0,120,120,
Oklahoma,Corporation Commissioner,Brian Bingman,REP,550096,0,0,111,111,
Oklahoma,State House,Tess Teague,REP,550096,0,0,121,121,10
Oklahoma,State House,Robert Manger,REP,550096,0,0,114,114,10
Oklahoma,Governor,Chris Powell,LIB,550096,0,0,0,0,
Oklahoma,Governor,Rex Lawhorn,LIB,550096,0,0,0,0,
Oklahoma,Corporation Commissioner,Ashley Nicole Mccray,DEM,550096,0,0,96,96,
Oklahoma,Corporation Commissioner,Blake Cummings,DEM,550096,0,0,50,50,
Oklahoma,U.S. House,Mary Brannon,DEM,550096,0,0,110,110,04
Oklahoma,U.S. House,Fred Gipson,DEM,550096,0,0,36,36,04
Oklahoma,State House,Madeline Scott,DEM,550096,0,0,73,73,10
Oklahoma,State House,John Carpenter,DEM,550096,0,0,73,73,10
Oklahoma,Governor,Mick Cornett,REP,550097,0,0,102,102,
Oklahoma,Governor,Kevin Stitt,REP,550097,0,0,94,94,
Oklahoma,Lieutenant Governor,Dana Murphy,REP,550097,0,0,81,81,
Oklahoma,Lieutenant Governor,Matt Pinnell,REP,550097,0,0,108,108,
Oklahoma,State Auditor,Cindy Byrd,REP,550097,0,0,72,72,
Oklahoma,State Auditor,Charlie Prater,REP,550097,0,0,111,111,
Oklahoma,Attorney General,Mike Hunter,REP,550097,0,0,121,121,
Oklahoma,Attorney General,Gentner Drummond,REP,550097,0,0,71,71,
Oklahoma,Superintendent of Public Instruction,Joy Hofmeister,REP,550097,0,0,94,94,
Oklahoma,Superintendent of Public Instruction,Linda Murphy,REP,550097,0,0,96,96,
Oklahoma,Commissioner of Labor,Cathy Costello,REP,550097,0,0,71,71,
Oklahoma,Commissioner of Labor,Leslie Osborn,REP,550097,0,0,116,116,
Oklahoma,Corporation Commissioner,Bob Anthony,REP,550097,0,0,104,104,
Oklahoma,Corporation Commissioner,Brian Bingman,REP,550097,0,0,88,88,
Oklahoma,State House,Tess Teague,REP,550097,0,0,82,82,10
Oklahoma,State House,Robert Manger,REP,550097,0,0,110,110,10
Oklahoma,Governor,Chris Powell,LIB,550097,0,0,0,0,
Oklahoma,Governor,Rex Lawhorn,LIB,550097,0,0,0,0,
Oklahoma,Corporation Commissioner,Ashley Nicole Mccray,DEM,550097,0,0,114,114,
Oklahoma,Corporation Commissioner,Blake Cummings,DEM,550097,0,0,48,48,
Oklahoma,U.S. House,Mary Brannon,DEM,550097,0,0,117,117,04
Oklahoma,U.S. House,Fred Gipson,DEM,550097,0,0,44,44,04
Oklahoma,State House,Madeline Scott,DEM,550097,0,0,114,114,10
Oklahoma,State House,John Carpenter,DEM,550097,0,0,52,52,10
Oklahoma,Governor,Mick Cornett,REP,550098,0,0,279,279,
Oklahoma,Governor,Kevin Stitt,REP,550098,0,0,228,228,
Oklahoma,Lieutenant Governor,Dana Murphy,REP,550098,0,0,240,240,
Oklahoma,Lieutenant Governor,Matt Pinnell,REP,550098,0,0,243,243,
Oklahoma,State Auditor,Cindy Byrd,REP,550098,0,0,218,218,
Oklahoma,State Auditor,Charlie Prater,REP,550098,0,0,246,246,
Oklahoma,Attorney General,Mike Hunter,REP,550098,0,0,259,259,
Oklahoma,Attorney General,Gentner Drummond,REP,550098,0,0,226,226,
Oklahoma,Superintendent of Public Instruction,Joy Hofmeister,REP,550098,0,0,293,293,
Oklahoma,Superintendent of Public Instruction,Linda Murphy,REP,550098,0,0,193,193,
Oklahoma,Commissioner of Labor,Cathy Costello,REP,550098,0,0,212,212,
Oklahoma,Commissioner of Labor,Leslie Osborn,REP,550098,0,0,261,261,
Oklahoma,Corporation Commissioner,Bob Anthony,REP,550098,0,0,264,264,
Oklahoma,Corporation Commissioner,Brian Bingman,REP,550098,0,0,215,215,
Oklahoma,State House,Tess Teague,REP,550098,0,0,201,201,10
Oklahoma,State House,Robert Manger,REP,550098,0,0,299,299,10
Oklahoma,Governor,Chris Powell,LIB,550098,0,0,0,0,
Oklahoma,Governor,Rex Lawhorn,LIB,550098,0,0,0,0,
Oklahoma,Corporation Commissioner,Ashley Nicole Mccray,DEM,550098,0,0,112,112,
Oklahoma,Corporation Commissioner,Blake Cummings,DEM,550098,0,0,56,56,
Oklahoma,U.S. House,Mary Brannon,DEM,550098,0,0,121,121,04
Oklahoma,U.S. House,Fred Gipson,DEM,550098,0,0,45,45,04
Oklahoma,State House,Madeline Scott,DEM,550098,0,0,80,80,10
Oklahoma,State House,John Carpenter,DEM,550098,0,0,89,89,10
Oklahoma,Governor,Mick Cornett,REP,550099,0,0,251,251,
Oklahoma,Governor,Kevin Stitt,REP,550099,0,0,127,127,
Oklahoma,Lieutenant Governor,Dana Murphy,REP,550099,0,0,172,172,
Oklahoma,Lieutenant Governor,Matt Pinnell,REP,550099,0,0,184,184,
Oklahoma,State Auditor,Cindy Byrd,REP,550099,0,0,182,182,
Oklahoma,State Auditor,Charlie Prater,REP,550099,0,0,153,153,
Oklahoma,Attorney General,Mike Hunter,REP,550099,0,0,240,240,
Oklahoma,Attorney General,Gentner Drummond,REP,550099,0,0,119,119,
Oklahoma,Superintendent of Public Instruction,Joy Hofmeister,REP,550099,0,0,218,218,
Oklahoma,Superintendent of Public Instruction,Linda Murphy,REP,550099,0,0,132,132,
Oklahoma,Commissioner of Labor,Cathy Costello,REP,550099,0,0,161,161,
Oklahoma,Commissioner of Labor,Leslie Osborn,REP,550099,0,0,184,184,
Oklahoma,Corporation Commissioner,Bob Anthony,REP,550099,0,0,243,243,
Oklahoma,Corporation Commissioner,Brian Bingman,REP,550099,0,0,121,121,
Oklahoma,Governor,Chris Powell,LIB,550099,0,0,1,1,
Oklahoma,Governor,Rex Lawhorn,LIB,550099,0,0,0,0,
Oklahoma,Corporation Commissioner,Ashley Nicole Mccray,DEM,550099,0,0,101,101,
Oklahoma,Corporation Commissioner,Blake Cummings,DEM,550099,0,0,34,34,
Oklahoma,U.S. House,Kendra Horn,DEM,550099,0,0,123,123,05
Oklahoma,U.S. House,Tom Guild,DEM,550099,0,0,14,14,05
Oklahoma,Governor,Mick Cornett,REP,550100,0,0,322,322,
Oklahoma,Governor,Kevin Stitt,REP,550100,0,0,157,157,
Oklahoma,Lieutenant Governor,Dana Murphy,REP,550100,0,0,223,223,
Oklahoma,Lieutenant Governor,Matt Pinnell,REP,550100,0,0,237,237,
Oklahoma,State Auditor,Cindy Byrd,REP,550100,0,0,204,204,
Oklahoma,State Auditor,Charlie Prater,REP,550100,0,0,212,212,
Oklahoma,Attorney General,Mike Hunter,REP,550100,0,0,344,344,
Oklahoma,Attorney General,Gentner Drummond,REP,550100,0,0,115,115,
Oklahoma,Superintendent of Public Instruction,Joy Hofmeister,REP,550100,0,0,285,285,
Oklahoma,Superintendent of Public Instruction,Linda Murphy,REP,550100,0,0,160,160,
Oklahoma,Commissioner of Labor,Cathy Costello,REP,550100,0,0,250,250,
Oklahoma,Commissioner of Labor,Leslie Osborn,REP,550100,0,0,196,196,
Oklahoma,Corporation Commissioner,Bob Anthony,REP,550100,0,0,310,310,
Oklahoma,Corporation Commissioner,Brian Bingman,REP,550100,0,0,146,146,
Oklahoma,Governor,Chris Powell,LIB,550100,0,0,2,2,
Oklahoma,Governor,Rex Lawhorn,LIB,550100,0,0,0,0,
Oklahoma,Corporation Commissioner,Ashley Nicole Mccray,DEM,550100,0,0,84,84,
Oklahoma,Corporation Commissioner,Blake Cummings,DEM,550100,0,0,20,20,
Oklahoma,U.S. House,Kendra Horn,DEM,550100,0,0,97,97,05
Oklahoma,U.S. House,Tom Guild,DEM,550100,0,0,9,9,05
Oklahoma,Governor,Mick Cornett,REP,550101,0,0,162,162,
Oklahoma,Governor,Kevin Stitt,REP,550101,0,0,75,75,
Oklahoma,Lieutenant Governor,Dana Murphy,REP,550101,0,0,110,110,
Oklahoma,Lieutenant Governor,Matt Pinnell,REP,550101,0,0,114,114,
Oklahoma,State Auditor,Cindy Byrd,REP,550101,0,0,105,105,
Oklahoma,State Auditor,Charlie Prater,REP,550101,0,0,106,106,
Oklahoma,Attorney General,Mike Hunter,REP,550101,0,0,173,173,
Oklahoma,Attorney General,Gentner Drummond,REP,550101,0,0,58,58,
Oklahoma,Superintendent of Public Instruction,Joy Hofmeister,REP,550101,0,0,132,132,
Oklahoma,Superintendent of Public Instruction,Linda Murphy,REP,550101,0,0,90,90,
Oklahoma,Commissioner of Labor,Cathy Costello,REP,550101,0,0,120,120,
Oklahoma,Commissioner of Labor,Leslie Osborn,REP,550101,0,0,103,103,
Oklahoma,Corporation Commissioner,Bob Anthony,REP,550101,0,0,157,157,
Oklahoma,Corporation Commissioner,Brian Bingman,REP,550101,0,0,74,74,
Oklahoma,Governor,Chris Powell,LIB,550101,0,0,0,0,
Oklahoma,Governor,Rex Lawhorn,LIB,550101,0,0,0,0,
Oklahoma,Corporation Commissioner,Ashley Nicole Mccray,DEM,550101,0,0,20,20,
Oklahoma,Corporation Commissioner,Blake Cummings,DEM,550101,0,0,11,11,
Oklahoma,U.S. House,Kendra Horn,DEM,550101,0,0,32,32,05
Oklahoma,U.S. House,Tom Guild,DEM,550101,0,0,3,3,05
Oklahoma,Governor,Mick Cornett,REP,550102,0,0,287,287,
Oklahoma,Governor,Kevin Stitt,REP,550102,0,0,139,139,
Oklahoma,Lieutenant Governor,Dana Murphy,REP,550102,0,0,177,177,
Oklahoma,Lieutenant Governor,Matt Pinnell,REP,550102,0,0,233,233,
Oklahoma,State Auditor,Cindy Byrd,REP,550102,0,0,198,198,
Oklahoma,State Auditor,Charlie Prater,REP,550102,0,0,183,183,
Oklahoma,Attorney General,Mike Hunter,REP,550102,0,0,283,283,
Oklahoma,Attorney General,Gentner Drummond,REP,550102,0,0,128,128,
Oklahoma,Superintendent of Public Instruction,Joy Hofmeister,REP,550102,0,0,243,243,
Oklahoma,Superintendent of Public Instruction,Linda Murphy,REP,550102,0,0,158,158,
Oklahoma,Commissioner of Labor,Cathy Costello,REP,550102,0,0,213,213,
Oklahoma,Commissioner of Labor,Leslie Osborn,REP,550102,0,0,186,186,
Oklahoma,Corporation Commissioner,Bob Anthony,REP,550102,0,0,266,266,
Oklahoma,Corporation Commissioner,Brian Bingman,REP,550102,0,0,143,143,
Oklahoma,Governor,Chris Powell,LIB,550102,0,0,1,1,
Oklahoma,Governor,Rex Lawhorn,LIB,550102,0,0,0,0,
Oklahoma,Corporation Commissioner,Ashley Nicole Mccray,DEM,550102,0,0,109,109,
Oklahoma,Corporation Commissioner,Blake Cummings,DEM,550102,0,0,25,25,
Oklahoma,U.S. House,Kendra Horn,DEM,550102,0,0,125,125,05
Oklahoma,U.S. House,Tom Guild,DEM,550102,0,0,11,11,05
Oklahoma,Governor,Mick Cornett,REP,550103,0,0,103,103,
Oklahoma,Governor,Kevin Stitt,REP,550103,0,0,60,60,
Oklahoma,Lieutenant Governor,Dana Murphy,REP,550103,0,0,57,57,
Oklahoma,Lieutenant Governor,Matt Pinnell,REP,550103,0,0,102,102,
Oklahoma,State Auditor,Cindy Byrd,REP,550103,0,0,71,71,
Oklahoma,State Auditor,Charlie Prater,REP,550103,0,0,80,80,
Oklahoma,Attorney General,Mike Hunter,REP,550103,0,0,91,91,
Oklahoma,Attorney General,Gentner Drummond,REP,550103,0,0,64,64,
Oklahoma,Superintendent of Public Instruction,Joy Hofmeister,REP,550103,0,0,90,90,
Oklahoma,Superintendent of Public Instruction,Linda Murphy,REP,550103,0,0,63,63,
Oklahoma,Commissioner of Labor,Cathy Costello,REP,550103,0,0,72,72,
Oklahoma,Commissioner of Labor,Leslie Osborn,REP,550103,0,0,81,81,
Oklahoma,Corporation Commissioner,Bob Anthony,REP,550103,0,0,91,91,
Oklahoma,Corporation Commissioner,Brian Bingman,REP,550103,0,0,64,64,
Oklahoma,Governor,Chris Powell,LIB,550103,0,0,0,0,
Oklahoma,Governor,Rex Lawhorn,LIB,550103,0,0,0,0,
Oklahoma,Corporation Commissioner,Ashley Nicole Mccray,DEM,550103,0,0,79,79,
Oklahoma,Corporation Commissioner,Blake Cummings,DEM,550103,0,0,29,29,
Oklahoma,U.S. House,Kendra Horn,DEM,550103,0,0,80,80,05
Oklahoma,U.S. House,Tom Guild,DEM,550103,0,0,29,29,05
Oklahoma,Governor,Mick Cornett,REP,550104,0,0,90,90,
Oklahoma,Governor,Kevin Stitt,REP,550104,0,0,48,48,
Oklahoma,Lieutenant Governor,Dana Murphy,REP,550104,0,0,64,64,
Oklahoma,Lieutenant Governor,Matt Pinnell,REP,550104,0,0,67,67,
Oklahoma,State Auditor,Cindy Byrd,REP,550104,0,0,64,64,
Oklahoma,State Auditor,Charlie Prater,REP,550104,0,0,66,66,
Oklahoma,Attorney General,Mike Hunter,REP,550104,0,0,77,77,
Oklahoma,Attorney General,Gentner Drummond,REP,550104,0,0,54,54,
Oklahoma,Superintendent of Public Instruction,Joy Hofmeister,REP,550104,0,0,75,75,
Oklahoma,Superintendent of Public Instruction,Linda Murphy,REP,550104,0,0,55,55,
Oklahoma,Commissioner of Labor,Cathy Costello,REP,550104,0,0,63,63,
Oklahoma,Commissioner of Labor,Leslie Osborn,REP,550104,0,0,69,69,
Oklahoma,Corporation Commissioner,Bob Anthony,REP,550104,0,0,69,69,
Oklahoma,Corporation Commissioner,Brian Bingman,REP,550104,0,0,61,61,
Oklahoma,State Senate,Lori Callahan,REP,550104,0,0,51,51,30
Oklahoma,State Senate,John Symcox,REP,550104,0,0,81,81,30
Oklahoma,Governor,Chris Powell,LIB,550104,0,0,0,0,
Oklahoma,Governor,Rex Lawhorn,LIB,550104,0,0,0,0,
Oklahoma,Corporation Commissioner,Ashley Nicole Mccray,DEM,550104,0,0,70,70,
Oklahoma,Corporation Commissioner,Blake Cummings,DEM,550104,0,0,26,26,
Oklahoma,U.S. House,Kendra Horn,DEM,550104,0,0,79,79,05
Oklahoma,U.S. House,Tom Guild,DEM,550104,0,0,17,17,05
Oklahoma,Governor,Mick Cornett,REP,550105,0,0,195,195,
Oklahoma,Governor,Kevin Stitt,REP,550105,0,0,106,106,
Oklahoma,Lieutenant Governor,Dana Murphy,REP,550105,0,0,140,140,
Oklahoma,Lieutenant Governor,Matt Pinnell,REP,550105,0,0,149,149,
Oklahoma,State Auditor,Cindy Byrd,REP,550105,0,0,154,154,
Oklahoma,State Auditor,Charlie Prater,REP,550105,0,0,127,127,
Oklahoma,Attorney General,Mike Hunter,REP,550105,0,0,201,201,
Oklahoma,Attorney General,Gentner Drummond,REP,550105,0,0,96,96,
Oklahoma,Superintendent of Public Instruction,Joy Hofmeister,REP,550105,0,0,180,180,
Oklahoma,Superintendent of Public Instruction,Linda Murphy,REP,550105,0,0,113,113,
Oklahoma,Commissioner of Labor,Cathy Costello,REP,550105,0,0,151,151,
Oklahoma,Commissioner of Labor,Leslie Osborn,REP,550105,0,0,136,136,
Oklahoma,Corporation Commissioner,Bob Anthony,REP,550105,0,0,174,174,
Oklahoma,Corporation Commissioner,Brian Bingman,REP,550105,0,0,113,113,
Oklahoma,State Senate,Lori Callahan,REP,550105,0,0,91,91,30
Oklahoma,State Senate,John Symcox,REP,550105,0,0,195,195,30
Oklahoma,Governor,Chris Powell,LIB,550105,0,0,1,1,
Oklahoma,Governor,Rex Lawhorn,LIB,550105,0,0,0,0,
Oklahoma,Corporation Commissioner,Ashley Nicole Mccray,DEM,550105,0,0,90,90,
Oklahoma,Corporation Commissioner,Blake Cummings,DEM,550105,0,0,28,28,
Oklahoma,U.S. House,Kendra Horn,DEM,550105,0,0,105,105,05
Oklahoma,U.S. House,Tom Guild,DEM,550105,0,0,14,14,05
Oklahoma,Governor,Mick Cornett,REP,550106,0,0,225,225,
Oklahoma,Governor,Kevin Stitt,REP,550106,0,0,132,132,
Oklahoma,Lieutenant Governor,Dana Murphy,REP,550106,0,0,166,166,
Oklahoma,Lieutenant Governor,Matt Pinnell,REP,550106,0,0,182,182,
Oklahoma,State Auditor,Cindy Byrd,REP,550106,0,0,192,192,
Oklahoma,State Auditor,Charlie Prater,REP,550106,0,0,146,146,
Oklahoma,Attorney General,Mike Hunter,REP,550106,0,0,230,230,
Oklahoma,Attorney General,Gentner Drummond,REP,550106,0,0,119,119,
Oklahoma,Superintendent of Public Instruction,Joy Hofmeister,REP,550106,0,0,201,201,
Oklahoma,Superintendent of Public Instruction,Linda Murphy,REP,550106,0,0,146,146,
Oklahoma,Commissioner of Labor,Cathy Costello,REP,550106,0,0,180,180,
Oklahoma,Commissioner of Labor,Leslie Osborn,REP,550106,0,0,166,166,
Oklahoma,Corporation Commissioner,Bob Anthony,REP,550106,0,0,208,208,
Oklahoma,Corporation Commissioner,Brian Bingman,REP,550106,0,0,136,136,
Oklahoma,State Senate,Lori Callahan,REP,550106,0,0,123,123,30
Oklahoma,State Senate,John Symcox,REP,550106,0,0,220,220,30
Oklahoma,Governor,Chris Powell,LIB,550106,0,0,0,0,
Oklahoma,Governor,Rex Lawhorn,LIB,550106,0,0,0,0,
Oklahoma,Corporation Commissioner,Ashley Nicole Mccray,DEM,550106,0,0,98,98,
Oklahoma,Corporation Commissioner,Blake Cummings,DEM,550106,0,0,41,41,
Oklahoma,U.S. House,Kendra Horn,DEM,550106,0,0,107,107,05
Oklahoma,U.S. House,Tom Guild,DEM,550106,0,0,32,32,05
Oklahoma,Governor,Mick Cornett,REP,550107,0,0,37,37,
Oklahoma,Governor,Kevin Stitt,REP,550107,0,0,57,57,
Oklahoma,Lieutenant Governor,Dana Murphy,REP,550107,0,0,41,41,
Oklahoma,Lieutenant Governor,Matt Pinnell,REP,550107,0,0,52,52,
Oklahoma,State Auditor,Cindy Byrd,REP,550107,0,0,48,48,
Oklahoma,State Auditor,Charlie Prater,REP,550107,0,0,45,45,
Oklahoma,Attorney General,Mike Hunter,REP,550107,0,0,43,43,
Oklahoma,Attorney General,Gentner Drummond,REP,550107,0,0,52,52,
Oklahoma,Superintendent of Public Instruction,Joy Hofmeister,REP,550107,0,0,47,47,
Oklahoma,Superintendent of Public Instruction,Linda Murphy,REP,550107,0,0,47,47,
Oklahoma,Commissioner of Labor,Cathy Costello,REP,550107,0,0,43,43,
Oklahoma,Commissioner of Labor,Leslie Osborn,REP,550107,0,0,49,49,
Oklahoma,Corporation Commissioner,Bob Anthony,REP,550107,0,0,47,47,
Oklahoma,Corporation Commissioner,Brian Bingman,REP,550107,0,0,45,45,
Oklahoma,Governor,Chris Powell,LIB,550107,0,0,0,0,
Oklahoma,Governor,Rex Lawhorn,LIB,550107,0,0,0,0,
Oklahoma,Corporation Commissioner,Ashley Nicole Mccray,DEM,550107,0,0,21,21,
Oklahoma,Corporation Commissioner,Blake Cummings,DEM,550107,0,0,9,9,
Oklahoma,U.S. House,Kendra Horn,DEM,550107,0,0,17,17,05
Oklahoma,U.S. House,Tom Guild,DEM,550107,0,0,13,13,05
Oklahoma,Governor,Mick Cornett,REP,550108,0,0,44,44,
Oklahoma,Governor,Kevin Stitt,REP,550108,0,0,66,66,
Oklahoma,Lieutenant Governor,Dana Murphy,REP,550108,0,0,50,50,
Oklahoma,Lieutenant Governor,Matt Pinnell,REP,550108,0,0,58,58,
Oklahoma,State Auditor,Cindy Byrd,REP,550108,0,0,46,46,
Oklahoma,State Auditor,Charlie Prater,REP,550108,0,0,55,55,
Oklahoma,Attorney General,Mike Hunter,REP,550108,0,0,45,45,
Oklahoma,Attorney General,Gentner Drummond,REP,550108,0,0,65,65,
Oklahoma,Superintendent of Public Instruction,Joy Hofmeister,REP,550108,0,0,54,54,
Oklahoma,Superintendent of Public Instruction,Linda Murphy,REP,550108,0,0,49,49,
Oklahoma,Commissioner of Labor,Cathy Costello,REP,550108,0,0,58,58,
Oklahoma,Commissioner of Labor,Leslie Osborn,REP,550108,0,0,48,48,
Oklahoma,Corporation Commissioner,Bob Anthony,REP,550108,0,0,70,70,
Oklahoma,Corporation Commissioner,Brian Bingman,REP,550108,0,0,36,36,
Oklahoma,Governor,Chris Powell,LIB,550108,0,0,0,0,
Oklahoma,Governor,Rex Lawhorn,LIB,550108,0,0,0,0,
Oklahoma,Corporation Commissioner,Ashley Nicole Mccray,DEM,550108,0,0,18,18,
Oklahoma,Corporation Commissioner,Blake Cummings,DEM,550108,0,0,10,10,
Oklahoma,U.S. House,Kendra Horn,DEM,550108,0,0,23,23,05
Oklahoma,U.S. House,Tom Guild,DEM,550108,0,0,6,6,05
Oklahoma,Governor,Mick Cornett,REP,550109,0,0,323,323,
Oklahoma,Governor,Kevin Stitt,REP,550109,0,0,225,225,
Oklahoma,Lieutenant Governor,Dana Murphy,REP,550109,0,0,262,262,
Oklahoma,Lieutenant Governor,Matt Pinnell,REP,550109,0,0,267,267,
Oklahoma,State Auditor,Cindy Byrd,REP,550109,0,0,253,253,
Oklahoma,State Auditor,Charlie Prater,REP,550109,0,0,240,240,
Oklahoma,Attorney General,Mike Hunter,REP,550109,0,0,350,350,
Oklahoma,Attorney General,Gentner Drummond,REP,550109,0,0,177,177,
Oklahoma,Superintendent of Public Instruction,Joy Hofmeister,REP,550109,0,0,318,318,
Oklahoma,Superintendent of Public Instruction,Linda Murphy,REP,550109,0,0,196,196,
Oklahoma,Commissioner of Labor,Cathy Costello,REP,550109,0,0,253,253,
Oklahoma,Commissioner of Labor,Leslie Osborn,REP,550109,0,0,264,264,
Oklahoma,Corporation Commissioner,Bob Anthony,REP,550109,0,0,317,317,
Oklahoma,Corporation Commissioner,Brian Bingman,REP,550109,0,0,193,193,
Oklahoma,Governor,Chris Powell,LIB,550109,0,0,2,2,
Oklahoma,Governor,Rex Lawhorn,LIB,550109,0,0,1,1,
Oklahoma,Corporation Commissioner,Ashley Nicole Mccray,DEM,550109,0,0,123,123,
Oklahoma,Corporation Commissioner,Blake Cummings,DEM,550109,0,0,37,37,
Oklahoma,U.S. House,Kendra Horn,DEM,550109,0,0,126,126,05
Oklahoma,U.S. House,Tom Guild,DEM,550109,0,0,40,40,05
Oklahoma,Governor,Mick Cornett,REP,550110,0,0,99,99,
Oklahoma,Governor,Kevin Stitt,REP,550110,0,0,49,49,
Oklahoma,Lieutenant Governor,Dana Murphy,REP,550110,0,0,75,75,
Oklahoma,Lieutenant Governor,Matt Pinnell,REP,550110,0,0,67,67,
Oklahoma,State Auditor,Cindy Byrd,REP,550110,0,0,59,59,
Oklahoma,State Auditor,Charlie Prater,REP,550110,0,0,80,80,
Oklahoma,Attorney General,Mike Hunter,REP,550110,0,0,95,95,
Oklahoma,Attorney General,Gentner Drummond,REP,550110,0,0,48,48,
Oklahoma,Superintendent of Public Instruction,Joy Hofmeister,REP,550110,0,0,79,79,
Oklahoma,Superintendent of Public Instruction,Linda Murphy,REP,550110,0,0,61,61,
Oklahoma,Commissioner of Labor,Cathy Costello,REP,550110,0,0,72,72,
Oklahoma,Commissioner of Labor,Leslie Osborn,REP,550110,0,0,69,69,
Oklahoma,Corporation Commissioner,Bob Anthony,REP,550110,0,0,86,86,
Oklahoma,Corporation Commissioner,Brian Bingman,REP,550110,0,0,54,54,
Oklahoma,Governor,Chris Powell,LIB,550110,0,0,0,0,
Oklahoma,Governor,Rex Lawhorn,LIB,550110,0,0,2,2,
Oklahoma,Corporation Commissioner,Ashley Nicole Mccray,DEM,550110,0,0,21,21,
Oklahoma,Corporation Commissioner,Blake Cummings,DEM,550110,0,0,9,9,
Oklahoma,U.S. House,Kendra Horn,DEM,550110,0,0,28,28,05
Oklahoma,U.S. House,Tom Guild,DEM,550110,0,0,4,4,05
Oklahoma,Governor,Mick Cornett,REP,550111,0,0,325,325,
Oklahoma,Governor,Kevin Stitt,REP,550111,0,0,190,190,
Oklahoma,Lieutenant Governor,Dana Murphy,REP,550111,0,0,222,222,
Oklahoma,Lieutenant Governor,Matt Pinnell,REP,550111,0,0,274,274,
Oklahoma,State Auditor,Cindy Byrd,REP,550111,0,0,240,240,
Oklahoma,State Auditor,Charlie Prater,REP,550111,0,0,236,236,
Oklahoma,Attorney General,Mike Hunter,REP,550111,0,0,329,329,
Oklahoma,Attorney General,Gentner Drummond,REP,550111,0,0,172,172,
Oklahoma,Superintendent of Public Instruction,Joy Hofmeister,REP,550111,0,0,322,322,
Oklahoma,Superintendent of Public Instruction,Linda Murphy,REP,550111,0,0,177,177,
Oklahoma,Commissioner of Labor,Cathy Costello,REP,550111,0,0,233,233,
Oklahoma,Commissioner of Labor,Leslie Osborn,REP,550111,0,0,257,257,
Oklahoma,Corporation Commissioner,Bob Anthony,REP,550111,0,0,308,308,
Oklahoma,Corporation Commissioner,Brian Bingman,REP,550111,0,0,182,182,
Oklahoma,Governor,Chris Powell,LIB,550111,0,0,0,0,
Oklahoma,Governor,Rex Lawhorn,LIB,550111,0,0,0,0,
Oklahoma,Corporation Commissioner,Ashley Nicole Mccray,DEM,550111,0,0,117,117,
Oklahoma,Corporation Commissioner,Blake Cummings,DEM,550111,0,0,35,35,
Oklahoma,U.S. House,Kendra Horn,DEM,550111,0,0,128,128,05
Oklahoma,U.S. House,Tom Guild,DEM,550111,0,0,28,28,05
Oklahoma,Governor,Mick Cornett,REP,550112,0,0,24,24,
Oklahoma,Governor,Kevin Stitt,REP,550112,0,0,31,31,
Oklahoma,Lieutenant Governor,Dana Murphy,REP,550112,0,0,24,24,
Oklahoma,Lieutenant Governor,Matt Pinnell,REP,550112,0,0,30,30,
Oklahoma,State Auditor,Cindy Byrd,REP,550112,0,0,22,22,
Oklahoma,State Auditor,Charlie Prater,REP,550112,0,0,31,31,
Oklahoma,Attorney General,Mike Hunter,REP,550112,0,0,34,34,
Oklahoma,Attorney General,Gentner Drummond,REP,550112,0,0,19,19,
Oklahoma,Superintendent of Public Instruction,Joy Hofmeister,REP,550112,0,0,30,30,
Oklahoma,Superintendent of Public Instruction,Linda Murphy,REP,550112,0,0,23,23,
Oklahoma,Commissioner of Labor,Cathy Costello,REP,550112,0,0,36,36,
Oklahoma,Commissioner of Labor,Leslie Osborn,REP,550112,0,0,16,16,
Oklahoma,Corporation Commissioner,Bob Anthony,REP,550112,0,0,31,31,
Oklahoma,Corporation Commissioner,Brian Bingman,REP,550112,0,0,21,21,
Oklahoma,Governor,Chris Powell,LIB,550112,0,0,0,0,
Oklahoma,Governor,Rex Lawhorn,LIB,550112,0,0,0,0,
Oklahoma,Corporation Commissioner,Ashley Nicole Mccray,DEM,550112,0,0,10,10,
Oklahoma,Corporation Commissioner,Blake Cummings,DEM,550112,0,0,3,3,
Oklahoma,U.S. House,Kendra Horn,DEM,550112,0,0,11,11,05
Oklahoma,U.S. House,Tom Guild,DEM,550112,0,0,2,2,05
Oklahoma,Governor,Mick Cornett,REP,550113,0,0,40,40,
Oklahoma,Governor,Kevin Stitt,REP,550113,0,0,32,32,
Oklahoma,Lieutenant Governor,Dana Murphy,REP,550113,0,0,31,31,
Oklahoma,Lieutenant Governor,Matt Pinnell,REP,550113,0,0,40,40,
Oklahoma,State Auditor,Cindy Byrd,REP,550113,0,0,32,32,
Oklahoma,State Auditor,Charlie Prater,REP,550113,0,0,39,39,
Oklahoma,Attorney General,Mike Hunter,REP,550113,0,0,34,34,
Oklahoma,Attorney General,Gentner Drummond,REP,550113,0,0,39,39,
Oklahoma,Superintendent of Public Instruction,Joy Hofmeister,REP,550113,0,0,36,36,
Oklahoma,Superintendent of Public Instruction,Linda Murphy,REP,550113,0,0,32,32,
Oklahoma,Commissioner of Labor,Cathy Costello,REP,550113,0,0,37,37,
Oklahoma,Commissioner of Labor,Leslie Osborn,REP,550113,0,0,35,35,
Oklahoma,Corporation Commissioner,Bob Anthony,REP,550113,0,0,38,38,
Oklahoma,Corporation Commissioner,Brian Bingman,REP,550113,0,0,33,33,
Oklahoma,Governor,Chris Powell,LIB,550113,0,0,0,0,
Oklahoma,Governor,Rex Lawhorn,LIB,550113,0,0,0,0,
Oklahoma,Corporation Commissioner,Ashley Nicole Mccray,DEM,550113,0,0,29,29,
Oklahoma,Corporation Commissioner,Blake Cummings,DEM,550113,0,0,11,11,
Oklahoma,U.S. House,Kendra Horn,DEM,550113,0,0,32,32,05
Oklahoma,U.S. House,Tom Guild,DEM,550113,0,0,9,9,05
Oklahoma,Governor,Mick Cornett,REP,550114,0,0,9,9,
Oklahoma,Governor,Kevin Stitt,REP,550114,0,0,11,11,
Oklahoma,Lieutenant Governor,Dana Murphy,REP,550114,0,0,13,13,
Oklahoma,Lieutenant Governor,Matt Pinnell,REP,550114,0,0,7,7,
Oklahoma,State Auditor,Cindy Byrd,REP,550114,0,0,9,9,
Oklahoma,State Auditor,Charlie Prater,REP,550114,0,0,9,9,
Oklahoma,Attorney General,Mike Hunter,REP,550114,0,0,16,16,
Oklahoma,Attorney General,Gentner Drummond,REP,550114,0,0,4,4,
Oklahoma,Superintendent of Public Instruction,Joy Hofmeister,REP,550114,0,0,10,10,
Oklahoma,Superintendent of Public Instruction,Linda Murphy,REP,550114,0,0,8,8,
Oklahoma,Commissioner of Labor,Cathy Costello,REP,550114,0,0,11,11,
Oklahoma,Commissioner of Labor,Leslie Osborn,REP,550114,0,0,9,9,
Oklahoma,Corporation Commissioner,Bob Anthony,REP,550114,0,0,16,16,
Oklahoma,Corporation Commissioner,Brian Bingman,REP,550114,0,0,4,4,
Oklahoma,Governor,Chris Powell,LIB,550114,0,0,0,0,
Oklahoma,Governor,Rex Lawhorn,LIB,550114,0,0,0,0,
Oklahoma,Corporation Commissioner,Ashley Nicole Mccray,DEM,550114,0,0,296,296,
Oklahoma,Corporation Commissioner,Blake Cummings,DEM,550114,0,0,57,57,
Oklahoma,U.S. House,Kendra Horn,DEM,550114,0,0,263,263,05
Oklahoma,U.S. House,Tom Guild,DEM,550114,0,0,96,96,05
Oklahoma,Governor,Mick Cornett,REP,550115,0,0,12,12,
Oklahoma,Governor,Kevin Stitt,REP,550115,0,0,4,4,
Oklahoma,Lieutenant Governor,Dana Murphy,REP,550115,0,0,7,7,
Oklahoma,Lieutenant Governor,Matt Pinnell,REP,550115,0,0,9,9,
Oklahoma,State Auditor,Cindy Byrd,REP,550115,0,0,11,11,
Oklahoma,State Auditor,Charlie Prater,REP,550115,0,0,5,5,
Oklahoma,Attorney General,Mike Hunter,REP,550115,0,0,8,8,
Oklahoma,Attorney General,Gentner Drummond,REP,550115,0,0,8,8,
Oklahoma,Superintendent of Public Instruction,Joy Hofmeister,REP,550115,0,0,6,6,
Oklahoma,Superintendent of Public Instruction,Linda Murphy,REP,550115,0,0,10,10,
Oklahoma,Commissioner of Labor,Cathy Costello,REP,550115,0,0,6,6,
Oklahoma,Commissioner of Labor,Leslie Osborn,REP,550115,0,0,10,10,
Oklahoma,Corporation Commissioner,Bob Anthony,REP,550115,0,0,9,9,
Oklahoma,Corporation Commissioner,Brian Bingman,REP,550115,0,0,6,6,
Oklahoma,Governor,Chris Powell,LIB,550115,0,0,1,1,
Oklahoma,Governor,Rex Lawhorn,LIB,550115,0,0,0,0,
Oklahoma,Corporation Commissioner,Ashley Nicole Mccray,DEM,550115,0,0,332,332,
Oklahoma,Corporation Commissioner,Blake Cummings,DEM,550115,0,0,65,65,
Oklahoma,U.S. House,Kendra Horn,DEM,550115,0,0,284,284,05
Oklahoma,U.S. House,Tom Guild,DEM,550115,0,0,114,114,05
Oklahoma,Governor,Mick Cornett,REP,550116,0,0,45,45,
Oklahoma,Governor,Kevin Stitt,REP,550116,0,0,19,19,
Oklahoma,Lieutenant Governor,Dana Murphy,REP,550116,0,0,36,36,
Oklahoma,Lieutenant Governor,Matt Pinnell,REP,550116,0,0,27,27,
Oklahoma,State Auditor,Cindy Byrd,REP,550116,0,0,32,32,
Oklahoma,State Auditor,Charlie Prater,REP,550116,0,0,29,29,
Oklahoma,Attorney General,Mike Hunter,REP,550116,0,0,36,36,
Oklahoma,Attorney General,Gentner Drummond,REP,550116,0,0,27,27,
Oklahoma,Superintendent of Public Instruction,Joy Hofmeister,REP,550116,0,0,32,32,
Oklahoma,Superintendent of Public Instruction,Linda Murphy,REP,550116,0,0,31,31,
Oklahoma,Commissioner of Labor,Cathy Costello,REP,550116,0,0,31,31,
Oklahoma,Commissioner of Labor,Leslie Osborn,REP,550116,0,0,30,30,
Oklahoma,Corporation Commissioner,Bob Anthony,REP,550116,0,0,31,31,
Oklahoma,Corporation Commissioner,Brian Bingman,REP,550116,0,0,29,29,
Oklahoma,Governor,Chris Powell,LIB,550116,0,0,0,0,
Oklahoma,Governor,Rex Lawhorn,LIB,550116,0,0,0,0,
Oklahoma,Corporation Commissioner,Ashley Nicole Mccray,DEM,550116,0,0,56,56,
Oklahoma,Corporation Commissioner,Blake Cummings,DEM,550116,0,0,13,13,
Oklahoma,U.S. House,Kendra Horn,DEM,550116,0,0,56,56,05
Oklahoma,U.S. House,Tom Guild,DEM,550116,0,0,13,13,05
Oklahoma,State House,Ajay Pittman,DEM,550116,0,0,35,35,99
Oklahoma,State House,Nkem House,DEM,550116,0,0,34,34,99
Oklahoma,Governor,Mick Cornett,REP,550117,0,0,21,21,
Oklahoma,Governor,Kevin Stitt,REP,550117,0,0,20,20,
Oklahoma,Lieutenant Governor,Dana Murphy,REP,550117,0,0,23,23,
Oklahoma,Lieutenant Governor,Matt Pinnell,REP,550117,0,0,19,19,
Oklahoma,State Auditor,Cindy Byrd,REP,550117,0,0,22,22,
Oklahoma,State Auditor,Charlie Prater,REP,550117,0,0,20,20,
Oklahoma,Attorney General,Mike Hunter,REP,550117,0,0,20,20,
Oklahoma,Attorney General,Gentner Drummond,REP,550117,0,0,21,21,
Oklahoma,Superintendent of Public Instruction,Joy Hofmeister,REP,550117,0,0,21,21,
Oklahoma,Superintendent of Public Instruction,Linda Murphy,REP,550117,0,0,20,20,
Oklahoma,Commissioner of Labor,Cathy Costello,REP,550117,0,0,20,20,
Oklahoma,Commissioner of Labor,Leslie Osborn,REP,550117,0,0,21,21,
Oklahoma,Corporation Commissioner,Bob Anthony,REP,550117,0,0,26,26,
Oklahoma,Corporation Commissioner,Brian Bingman,REP,550117,0,0,16,16,
Oklahoma,Governor,Chris Powell,LIB,550117,0,0,1,1,
Oklahoma,Governor,Rex Lawhorn,LIB,550117,0,0,0,0,
Oklahoma,Corporation Commissioner,Ashley Nicole Mccray,DEM,550117,0,0,347,347,
Oklahoma,Corporation Commissioner,Blake Cummings,DEM,550117,0,0,81,81,
Oklahoma,U.S. House,Kendra Horn,DEM,550117,0,0,300,300,05
Oklahoma,U.S. House,Tom Guild,DEM,550117,0,0,135,135,05
Oklahoma,Governor,Mick Cornett,REP,550118,0,0,34,34,
Oklahoma,Governor,Kevin Stitt,REP,550118,0,0,36,36,
Oklahoma,Lieutenant Governor,Dana Murphy,REP,550118,0,0,29,29,
Oklahoma,Lieutenant Governor,Matt Pinnell,REP,550118,0,0,41,41,
Oklahoma,State Auditor,Cindy Byrd,REP,550118,0,0,34,34,
Oklahoma,State Auditor,Charlie Prater,REP,550118,0,0,35,35,
Oklahoma,Attorney General,Mike Hunter,REP,550118,0,0,45,45,
Oklahoma,Attorney General,Gentner Drummond,REP,550118,0,0,26,26,
Oklahoma,Superintendent of Public Instruction,Joy Hofmeister,REP,550118,0,0,31,31,
Oklahoma,Superintendent of Public Instruction,Linda Murphy,REP,550118,0,0,39,39,
Oklahoma,Commissioner of Labor,Cathy Costello,REP,550118,0,0,37,37,
Oklahoma,Commissioner of Labor,Leslie Osborn,REP,550118,0,0,33,33,
Oklahoma,Corporation Commissioner,Bob Anthony,REP,550118,0,0,40,40,
Oklahoma,Corporation Commissioner,Brian Bingman,REP,550118,0,0,30,30,
Oklahoma,Governor,Chris Powell,LIB,550118,0,0,3,3,
Oklahoma,Governor,Rex Lawhorn,LIB,550118,0,0,1,1,
Oklahoma,Corporation Commissioner,Ashley Nicole Mccray,DEM,550118,0,0,186,186,
Oklahoma,Corporation Commissioner,Blake Cummings,DEM,550118,0,0,63,63,
Oklahoma,U.S. House,Kendra Horn,DEM,550118,0,0,185,185,05
Oklahoma,U.S. House,Tom Guild,DEM,550118,0,0,70,70,05
Oklahoma,State House,Ajay Pittman,DEM,550118,0,0,152,152,99
Oklahoma,State House,Nkem House,DEM,550118,0,0,103,103,99
Oklahoma,Governor,Mick Cornett,REP,550119,0,0,44,44,
Oklahoma,Governor,Kevin Stitt,REP,550119,0,0,21,21,
Oklahoma,Lieutenant Governor,Dana Murphy,REP,550119,0,0,22,22,
Oklahoma,Lieutenant Governor,Matt Pinnell,REP,550119,0,0,42,42,
Oklahoma,State Auditor,Cindy Byrd,REP,550119,0,0,34,34,
Oklahoma,State Auditor,Charlie Prater,REP,550119,0,0,26,26,
Oklahoma,Attorney General,Mike Hunter,REP,550119,0,0,47,47,
Oklahoma,Attorney General,Gentner Drummond,REP,550119,0,0,17,17,
Oklahoma,Superintendent of Public Instruction,Joy Hofmeister,REP,550119,0,0,35,35,
Oklahoma,Superintendent of Public Instruction,Linda Murphy,REP,550119,0,0,26,26,
Oklahoma,Commissioner of Labor,Cathy Costello,REP,550119,0,0,30,30,
Oklahoma,Commissioner of Labor,Leslie Osborn,REP,550119,0,0,32,32,
Oklahoma,Corporation Commissioner,Bob Anthony,REP,550119,0,0,44,44,
Oklahoma,Corporation Commissioner,Brian Bingman,REP,550119,0,0,19,19,
Oklahoma,Governor,Chris Powell,LIB,550119,0,0,0,0,
Oklahoma,Governor,Rex Lawhorn,LIB,550119,0,0,0,0,
Oklahoma,Corporation Commissioner,Ashley Nicole Mccray,DEM,550119,0,0,26,26,
Oklahoma,Corporation Commissioner,Blake Cummings,DEM,550119,0,0,5,5,
Oklahoma,U.S. House,Kendra Horn,DEM,550119,0,0,29,29,05
Oklahoma,U.S. House,Tom Guild,DEM,550119,0,0,4,4,05
Oklahoma,Governor,Mick Cornett,REP,550120,0,0,31,31,
Oklahoma,Governor,Kevin Stitt,REP,550120,0,0,32,32,
Oklahoma,Lieutenant Governor,Dana Murphy,REP,550120,0,0,29,29,
Oklahoma,Lieutenant Governor,Matt Pinnell,REP,550120,0,0,33,33,
Oklahoma,State Auditor,Cindy Byrd,REP,550120,0,0,29,29,
Oklahoma,State Auditor,Charlie Prater,REP,550120,0,0,32,32,
Oklahoma,Attorney General,Mike Hunter,REP,550120,0,0,34,34,
Oklahoma,Attorney General,Gentner Drummond,REP,550120,0,0,27,27,
Oklahoma,Superintendent of Public Instruction,Joy Hofmeister,REP,550120,0,0,34,34,
Oklahoma,Superintendent of Public Instruction,Linda Murphy,REP,550120,0,0,24,24,
Oklahoma,Commissioner of Labor,Cathy Costello,REP,550120,0,0,29,29,
Oklahoma,Commissioner of Labor,Leslie Osborn,REP,550120,0,0,32,32,
Oklahoma,Corporation Commissioner,Bob Anthony,REP,550120,0,0,33,33,
Oklahoma,Corporation Commissioner,Brian Bingman,REP,550120,0,0,28,28,
Oklahoma,Governor,Chris Powell,LIB,550120,0,0,1,1,
Oklahoma,Governor,Rex Lawhorn,LIB,550120,0,0,1,1,
Oklahoma,Corporation Commissioner,Ashley Nicole Mccray,DEM,550120,0,0,144,144,
Oklahoma,Corporation Commissioner,Blake Cummings,DEM,550120,0,0,38,38,
Oklahoma,U.S. House,Kendra Horn,DEM,550120,0,0,131,131,05
Oklahoma,U.S. House,Tom Guild,DEM,550120,0,0,54,54,05
Oklahoma,State House,Ajay Pittman,DEM,550120,0,0,98,98,99
Oklahoma,State House,Nkem House,DEM,550120,0,0,87,87,99
Oklahoma,Governor,Mick Cornett,REP,550121,0,0,40,40,
Oklahoma,Governor,Kevin Stitt,REP,550121,0,0,31,31,
Oklahoma,Lieutenant Governor,Dana Murphy,REP,550121,0,0,28,28,
Oklahoma,Lieutenant Governor,Matt Pinnell,REP,550121,0,0,39,39,
Oklahoma,State Auditor,Cindy Byrd,REP,550121,0,0,34,34,
Oklahoma,State Auditor,Charlie Prater,REP,550121,0,0,32,32,
Oklahoma,Attorney General,Mike Hunter,REP,550121,0,0,40,40,
Oklahoma,Attorney General,Gentner Drummond,REP,550121,0,0,28,28,
Oklahoma,Superintendent of Public Instruction,Joy Hofmeister,REP,550121,0,0,36,36,
Oklahoma,Superintendent of Public Instruction,Linda Murphy,REP,550121,0,0,28,28,
Oklahoma,Commissioner of Labor,Cathy Costello,REP,550121,0,0,41,41,
Oklahoma,Commissioner of Labor,Leslie Osborn,REP,550121,0,0,26,26,
Oklahoma,Corporation Commissioner,Bob Anthony,REP,550121,0,0,31,31,
Oklahoma,Corporation Commissioner,Brian Bingman,REP,550121,0,0,35,35,
Oklahoma,Governor,Chris Powell,LIB,550121,0,0,0,0,
Oklahoma,Governor,Rex Lawhorn,LIB,550121,0,0,1,1,
Oklahoma,Corporation Commissioner,Ashley Nicole Mccray,DEM,550121,0,0,249,249,
Oklahoma,Corporation Commissioner,Blake Cummings,DEM,550121,0,0,46,46,
Oklahoma,U.S. House,Kendra Horn,DEM,550121,0,0,231,231,05
Oklahoma,U.S. House,Tom Guild,DEM,550121,0,0,67,67,05
Oklahoma,State House,Ajay Pittman,DEM,550121,0,0,173,173,99
Oklahoma,State House,Nkem House,DEM,550121,0,0,127,127,99
Oklahoma,Governor,Mick Cornett,REP,550122,0,0,63,63,
Oklahoma,Governor,Kevin Stitt,REP,550122,0,0,37,37,
Oklahoma,Lieutenant Governor,Dana Murphy,REP,550122,0,0,47,47,
Oklahoma,Lieutenant Governor,Matt Pinnell,REP,550122,0,0,50,50,
Oklahoma,State Auditor,Cindy Byrd,REP,550122,0,0,44,44,
Oklahoma,State Auditor,Charlie Prater,REP,550122,0,0,50,50,
Oklahoma,Attorney General,Mike Hunter,REP,550122,0,0,63,63,
Oklahoma,Attorney General,Gentner Drummond,REP,550122,0,0,33,33,
Oklahoma,Superintendent of Public Instruction,Joy Hofmeister,REP,550122,0,0,57,57,
Oklahoma,Superintendent of Public Instruction,Linda Murphy,REP,550122,0,0,40,40,
Oklahoma,Commissioner of Labor,Cathy Costello,REP,550122,0,0,48,48,
Oklahoma,Commissioner of Labor,Leslie Osborn,REP,550122,0,0,46,46,
Oklahoma,Corporation Commissioner,Bob Anthony,REP,550122,0,0,62,62,
Oklahoma,Corporation Commissioner,Brian Bingman,REP,550122,0,0,32,32,
Oklahoma,Governor,Chris Powell,LIB,550122,0,0,0,0,
Oklahoma,Governor,Rex Lawhorn,LIB,550122,0,0,0,0,
Oklahoma,Corporation Commissioner,Ashley Nicole Mccray,DEM,550122,0,0,146,146,
Oklahoma,Corporation Commissioner,Blake Cummings,DEM,550122,0,0,25,25,
Oklahoma,U.S. House,Kendra Horn,DEM,550122,0,0,136,136,05
Oklahoma,U.S. House,Tom Guild,DEM,550122,0,0,37,37,05
Oklahoma,State House,Ajay Pittman,DEM,550122,0,0,96,96,99
Oklahoma,State House,Nkem House,DEM,550122,0,0,77,77,99
Oklahoma,Governor,Mick Cornett,REP,550123,0,0,73,73,
Oklahoma,Governor,Kevin Stitt,REP,550123,0,0,53,53,
Oklahoma,Lieutenant Governor,Dana Murphy,REP,550123,0,0,49,49,
Oklahoma,Lieutenant Governor,Matt Pinnell,REP,550123,0,0,72,72,
Oklahoma,State Auditor,Cindy Byrd,REP,550123,0,0,64,64,
Oklahoma,State Auditor,Charlie Prater,REP,550123,0,0,53,53,
Oklahoma,Attorney General,Mike Hunter,REP,550123,0,0,62,62,
Oklahoma,Attorney General,Gentner Drummond,REP,550123,0,0,58,58,
Oklahoma,Superintendent of Public Instruction,Joy Hofmeister,REP,550123,0,0,74,74,
Oklahoma,Superintendent of Public Instruction,Linda Murphy,REP,550123,0,0,49,49,
Oklahoma,Commissioner of Labor,Cathy Costello,REP,550123,0,0,73,73,
Oklahoma,Commissioner of Labor,Leslie Osborn,REP,550123,0,0,48,48,
Oklahoma,Corporation Commissioner,Bob Anthony,REP,550123,0,0,67,67,
Oklahoma,Corporation Commissioner,Brian Bingman,REP,550123,0,0,51,51,
Oklahoma,Governor,Chris Powell,LIB,550123,0,0,0,0,
Oklahoma,Governor,Rex Lawhorn,LIB,550123,0,0,0,0,
Oklahoma,Corporation Commissioner,Ashley Nicole Mccray,DEM,550123,0,0,208,208,
Oklahoma,Corporation Commissioner,Blake Cummings,DEM,550123,0,0,66,66,
Oklahoma,U.S. House,Kendra Horn,DEM,550123,0,0,197,197,05
Oklahoma,U.S. House,Tom Guild,DEM,550123,0,0,82,82,05
Oklahoma,State House,Ajay Pittman,DEM,550123,0,0,169,169,99
Oklahoma,State House,Nkem House,DEM,550123,0,0,109,109,99
Oklahoma,Governor,Mick Cornett,REP,550124,0,0,101,101,
Oklahoma,Governor,Kevin Stitt,REP,550124,0,0,82,82,
Oklahoma,Lieutenant Governor,Dana Murphy,REP,550124,0,0,57,57,
Oklahoma,Lieutenant Governor,Matt Pinnell,REP,550124,0,0,116,116,
Oklahoma,State Auditor,Cindy Byrd,REP,550124,0,0,75,75,
Oklahoma,State Auditor,Charlie Prater,REP,550124,0,0,99,99,
Oklahoma,Attorney General,Mike Hunter,REP,550124,0,0,106,106,
Oklahoma,Attorney General,Gentner Drummond,REP,550124,0,0,75,75,
Oklahoma,Superintendent of Public Instruction,Joy Hofmeister,REP,550124,0,0,95,95,
Oklahoma,Superintendent of Public Instruction,Linda Murphy,REP,550124,0,0,81,81,
Oklahoma,Commissioner of Labor,Cathy Costello,REP,550124,0,0,87,87,
Oklahoma,Commissioner of Labor,Leslie Osborn,REP,550124,0,0,89,89,
Oklahoma,Corporation Commissioner,Bob Anthony,REP,550124,0,0,106,106,
Oklahoma,Corporation Commissioner,Brian Bingman,REP,550124,0,0,73,73,
Oklahoma,Governor,Chris Powell,LIB,550124,0,0,0,0,
Oklahoma,Governor,Rex Lawhorn,LIB,550124,0,0,0,0,
Oklahoma,Corporation Commissioner,Ashley Nicole Mccray,DEM,550124,0,0,93,93,
Oklahoma,Corporation Commissioner,Blake Cummings,DEM,550124,0,0,31,31,
Oklahoma,U.S. House,Kendra Horn,DEM,550124,0,0,89,89,05
Oklahoma,U.S. House,Tom Guild,DEM,550124,0,0,38,38,05
Oklahoma,Governor,Mick Cornett,REP,550125,0,0,20,20,
Oklahoma,Governor,Kevin Stitt,REP,550125,0,0,11,11,
Oklahoma,Lieutenant Governor,Dana Murphy,REP,550125,0,0,10,10,
Oklahoma,Lieutenant Governor,Matt Pinnell,REP,550125,0,0,21,21,
Oklahoma,State Auditor,Cindy Byrd,REP,550125,0,0,15,15,
Oklahoma,State Auditor,Charlie Prater,REP,550125,0,0,16,16,
Oklahoma,Attorney General,Mike Hunter,REP,550125,0,0,26,26,
Oklahoma,Attorney General,Gentner Drummond,REP,550125,0,0,5,5,
Oklahoma,Superintendent of Public Instruction,Joy Hofmeister,REP,550125,0,0,11,11,
Oklahoma,Superintendent of Public Instruction,Linda Murphy,REP,550125,0,0,20,20,
Oklahoma,Commissioner of Labor,Cathy Costello,REP,550125,0,0,18,18,
Oklahoma,Commissioner of Labor,Leslie Osborn,REP,550125,0,0,13,13,
Oklahoma,Corporation Commissioner,Bob Anthony,REP,550125,0,0,13,13,
Oklahoma,Corporation Commissioner,Brian Bingman,REP,550125,0,0,18,18,
Oklahoma,Governor,Chris Powell,LIB,550125,0,0,0,0,
Oklahoma,Governor,Rex Lawhorn,LIB,550125,0,0,0,0,
Oklahoma,Corporation Commissioner,Ashley Nicole Mccray,DEM,550125,0,0,39,39,
Oklahoma,Corporation Commissioner,Blake Cummings,DEM,550125,0,0,16,16,
Oklahoma,U.S. House,Kendra Horn,DEM,550125,0,0,42,42,05
Oklahoma,U.S. House,Tom Guild,DEM,550125,0,0,14,14,05
Oklahoma,State House,Ajay Pittman,DEM,550125,0,0,27,27,99
Oklahoma,State House,Nkem House,DEM,550125,0,0,30,30,99
Oklahoma,Governor,Mick Cornett,REP,550126,0,0,62,62,
Oklahoma,Governor,Kevin Stitt,REP,550126,0,0,47,47,
Oklahoma,Lieutenant Governor,Dana Murphy,REP,550126,0,0,49,49,
Oklahoma,Lieutenant Governor,Matt Pinnell,REP,550126,0,0,60,60,
Oklahoma,State Auditor,Cindy Byrd,REP,550126,0,0,50,50,
Oklahoma,State Auditor,Charlie Prater,REP,550126,0,0,56,56,
Oklahoma,Attorney General,Mike Hunter,REP,550126,0,0,77,77,
Oklahoma,Attorney General,Gentner Drummond,REP,550126,0,0,30,30,
Oklahoma,Superintendent of Public Instruction,Joy Hofmeister,REP,550126,0,0,60,60,
Oklahoma,Superintendent of Public Instruction,Linda Murphy,REP,550126,0,0,46,46,
Oklahoma,Commissioner of Labor,Cathy Costello,REP,550126,0,0,56,56,
Oklahoma,Commissioner of Labor,Leslie Osborn,REP,550126,0,0,49,49,
Oklahoma,Corporation Commissioner,Bob Anthony,REP,550126,0,0,60,60,
Oklahoma,Corporation Commissioner,Brian Bingman,REP,550126,0,0,46,46,
Oklahoma,Governor,Chris Powell,LIB,550126,0,0,0,0,
Oklahoma,Governor,Rex Lawhorn,LIB,550126,0,0,0,0,
Oklahoma,Corporation Commissioner,Ashley Nicole Mccray,DEM,550126,0,0,67,67,
Oklahoma,Corporation Commissioner,Blake Cummings,DEM,550126,0,0,27,27,
Oklahoma,U.S. House,Kendra Horn,DEM,550126,0,0,73,73,05
Oklahoma,U.S. House,Tom Guild,DEM,550126,0,0,22,22,05
Oklahoma,Governor,Mick Cornett,REP,550127,0,0,210,210,
Oklahoma,Governor,Kevin Stitt,REP,550127,0,0,148,148,
Oklahoma,Lieutenant Governor,Dana Murphy,REP,550127,0,0,183,183,
Oklahoma,Lieutenant Governor,Matt Pinnell,REP,550127,0,0,170,170,
Oklahoma,State Auditor,Cindy Byrd,REP,550127,0,0,132,132,
Oklahoma,State Auditor,Charlie Prater,REP,550127,0,0,206,206,
Oklahoma,Attorney General,Mike Hunter,REP,550127,0,0,231,231,
Oklahoma,Attorney General,Gentner Drummond,REP,550127,0,0,116,116,
Oklahoma,Superintendent of Public Instruction,Joy Hofmeister,REP,550127,0,0,215,215,
Oklahoma,Superintendent of Public Instruction,Linda Murphy,REP,550127,0,0,128,128,
Oklahoma,Commissioner of Labor,Cathy Costello,REP,550127,0,0,160,160,
Oklahoma,Commissioner of Labor,Leslie Osborn,REP,550127,0,0,178,178,
Oklahoma,Corporation Commissioner,Bob Anthony,REP,550127,0,0,204,204,
Oklahoma,Corporation Commissioner,Brian Bingman,REP,550127,0,0,142,142,
Oklahoma,Governor,Chris Powell,LIB,550127,0,0,0,0,
Oklahoma,Governor,Rex Lawhorn,LIB,550127,0,0,1,1,
Oklahoma,Corporation Commissioner,Ashley Nicole Mccray,DEM,550127,0,0,74,74,
Oklahoma,Corporation Commissioner,Blake Cummings,DEM,550127,0,0,20,20,
Oklahoma,U.S. House,Kendra Horn,DEM,550127,0,0,77,77,05
Oklahoma,U.S. House,Tom Guild,DEM,550127,0,0,20,20,05
Oklahoma,Governor,Mick Cornett,REP,550128,0,0,166,166,
Oklahoma,Governor,Kevin Stitt,REP,550128,0,0,101,101,
Oklahoma,Lieutenant Governor,Dana Murphy,REP,550128,0,0,123,123,
Oklahoma,Lieutenant Governor,Matt Pinnell,REP,550128,0,0,134,134,
Oklahoma,State Auditor,Cindy Byrd,REP,550128,0,0,107,107,
Oklahoma,State Auditor,Charlie Prater,REP,550128,0,0,141,141,
Oklahoma,Attorney General,Mike Hunter,REP,550128,0,0,163,163,
Oklahoma,Attorney General,Gentner Drummond,REP,550128,0,0,93,93,
Oklahoma,Superintendent of Public Instruction,Joy Hofmeister,REP,550128,0,0,148,148,
Oklahoma,Superintendent of Public Instruction,Linda Murphy,REP,550128,0,0,108,108,
Oklahoma,Commissioner of Labor,Cathy Costello,REP,550128,0,0,130,130,
Oklahoma,Commissioner of Labor,Leslie Osborn,REP,550128,0,0,128,128,
Oklahoma,Corporation Commissioner,Bob Anthony,REP,550128,0,0,150,150,
Oklahoma,Corporation Commissioner,Brian Bingman,REP,550128,0,0,106,106,
Oklahoma,Governor,Chris Powell,LIB,550128,0,0,0,0,
Oklahoma,Governor,Rex Lawhorn,LIB,550128,0,0,0,0,
Oklahoma,Corporation Commissioner,Ashley Nicole Mccray,DEM,550128,0,0,74,74,
Oklahoma,Corporation Commissioner,Blake Cummings,DEM,550128,0,0,25,25,
Oklahoma,U.S. House,Kendra Horn,DEM,550128,0,0,76,76,05
Oklahoma,U.S. House,Tom Guild,DEM,550128,0,0,22,22,05
Oklahoma,Governor,Mick Cornett,REP,550129,0,0,95,95,
Oklahoma,Governor,Kevin Stitt,REP,550129,0,0,58,58,
Oklahoma,Lieutenant Governor,Dana Murphy,REP,550129,0,0,70,70,
Oklahoma,Lieutenant Governor,Matt Pinnell,REP,550129,0,0,76,76,
Oklahoma,State Auditor,Cindy Byrd,REP,550129,0,0,76,76,
Oklahoma,State Auditor,Charlie Prater,REP,550129,0,0,64,64,
Oklahoma,Attorney General,Mike Hunter,REP,550129,0,0,100,100,
Oklahoma,Attorney General,Gentner Drummond,REP,550129,0,0,51,51,
Oklahoma,Superintendent of Public Instruction,Joy Hofmeister,REP,550129,0,0,86,86,
Oklahoma,Superintendent of Public Instruction,Linda Murphy,REP,550129,0,0,55,55,
Oklahoma,Commissioner of Labor,Cathy Costello,REP,550129,0,0,86,86,
Oklahoma,Commissioner of Labor,Leslie Osborn,REP,550129,0,0,56,56,
Oklahoma,Corporation Commissioner,Bob Anthony,REP,550129,0,0,97,97,
Oklahoma,Corporation Commissioner,Brian Bingman,REP,550129,0,0,50,50,
Oklahoma,Governor,Chris Powell,LIB,550129,0,0,0,0,
Oklahoma,Governor,Rex Lawhorn,LIB,550129,0,0,0,0,
Oklahoma,Corporation Commissioner,Ashley Nicole Mccray,DEM,550129,0,0,42,42,
Oklahoma,Corporation Commissioner,Blake Cummings,DEM,550129,0,0,12,12,
Oklahoma,U.S. House,Kendra Horn,DEM,550129,0,0,40,40,05
Oklahoma,U.S. House,Tom Guild,DEM,550129,0,0,15,15,05
Oklahoma,Governor,Mick Cornett,REP,550130,0,0,270,270,
Oklahoma,Governor,Kevin Stitt,REP,550130,0,0,167,167,
Oklahoma,Lieutenant Governor,Dana Murphy,REP,550130,0,0,193,193,
Oklahoma,Lieutenant Governor,Matt Pinnell,REP,550130,0,0,235,235,
Oklahoma,State Auditor,Cindy Byrd,REP,550130,0,0,199,199,
Oklahoma,State Auditor,Charlie Prater,REP,550130,0,0,217,217,
Oklahoma,Attorney General,Mike Hunter,REP,550130,0,0,277,277,
Oklahoma,Attorney General,Gentner Drummond,REP,550130,0,0,155,155,
Oklahoma,Superintendent of Public Instruction,Joy Hofmeister,REP,550130,0,0,257,257,
Oklahoma,Superintendent of Public Instruction,Linda Murphy,REP,550130,0,0,176,176,
Oklahoma,Commissioner of Labor,Cathy Costello,REP,550130,0,0,205,205,
Oklahoma,Commissioner of Labor,Leslie Osborn,REP,550130,0,0,219,219,
Oklahoma,Corporation Commissioner,Bob Anthony,REP,550130,0,0,235,235,
Oklahoma,Corporation Commissioner,Brian Bingman,REP,550130,0,0,185,185,
Oklahoma,Governor,Chris Powell,LIB,550130,0,0,0,0,
Oklahoma,Governor,Rex Lawhorn,LIB,550130,0,0,1,1,
Oklahoma,Corporation Commissioner,Ashley Nicole Mccray,DEM,550130,0,0,103,103,
Oklahoma,Corporation Commissioner,Blake Cummings,DEM,550130,0,0,28,28,
Oklahoma,U.S. House,Kendra Horn,DEM,550130,0,0,103,103,05
Oklahoma,U.S. House,Tom Guild,DEM,550130,0,0,30,30,05
Oklahoma,Governor,Mick Cornett,REP,550131,0,0,179,179,
Oklahoma,Governor,Kevin Stitt,REP,550131,0,0,92,92,
Oklahoma,Lieutenant Governor,Dana Murphy,REP,550131,0,0,120,120,
Oklahoma,Lieutenant Governor,Matt Pinnell,REP,550131,0,0,142,142,
Oklahoma,State Auditor,Cindy Byrd,REP,550131,0,0,113,113,
Oklahoma,State Auditor,Charlie Prater,REP,550131,0,0,141,141,
Oklahoma,Attorney General,Mike Hunter,REP,550131,0,0,191,191,
Oklahoma,Attorney General,Gentner Drummond,REP,550131,0,0,75,75,
Oklahoma,Superintendent of Public Instruction,Joy Hofmeister,REP,550131,0,0,156,156,
Oklahoma,Superintendent of Public Instruction,Linda Murphy,REP,550131,0,0,102,102,
Oklahoma,Commissioner of Labor,Cathy Costello,REP,550131,0,0,125,125,
Oklahoma,Commissioner of Labor,Leslie Osborn,REP,550131,0,0,133,133,
Oklahoma,Corporation Commissioner,Bob Anthony,REP,550131,0,0,159,159,
Oklahoma,Corporation Commissioner,Brian Bingman,REP,550131,0,0,100,100,
Oklahoma,Governor,Chris Powell,LIB,550131,0,0,0,0,
Oklahoma,Governor,Rex Lawhorn,LIB,550131,0,0,1,1,
Oklahoma,Corporation Commissioner,Ashley Nicole Mccray,DEM,550131,0,0,49,49,
Oklahoma,Corporation Commissioner,Blake Cummings,DEM,550131,0,0,11,11,
Oklahoma,U.S. House,Kendra Horn,DEM,550131,0,0,53,53,05
Oklahoma,U.S. House,Tom Guild,DEM,550131,0,0,8,8,05
Oklahoma,Governor,Mick Cornett,REP,550132,0,0,149,149,
Oklahoma,Governor,Kevin Stitt,REP,550132,0,0,114,114,
Oklahoma,Lieutenant Governor,Dana Murphy,REP,550132,0,0,115,115,
Oklahoma,Lieutenant Governor,Matt Pinnell,REP,550132,0,0,143,143,
Oklahoma,State Auditor,Cindy Byrd,REP,550132,0,0,142,142,
Oklahoma,State Auditor,Charlie Prater,REP,550132,0,0,106,106,
Oklahoma,Attorney General,Mike Hunter,REP,550132,0,0,149,149,
Oklahoma,Attorney General,Gentner Drummond,REP,550132,0,0,105,105,
Oklahoma,Superintendent of Public Instruction,Joy Hofmeister,REP,550132,0,0,144,144,
Oklahoma,Superintendent of Public Instruction,Linda Murphy,REP,550132,0,0,112,112,
Oklahoma,Commissioner of Labor,Cathy Costello,REP,550132,0,0,132,132,
Oklahoma,Commissioner of Labor,Leslie Osborn,REP,550132,0,0,120,120,
Oklahoma,Corporation Commissioner,Bob Anthony,REP,550132,0,0,150,150,
Oklahoma,Corporation Commissioner,Brian Bingman,REP,550132,0,0,104,104,
Oklahoma,Governor,Chris Powell,LIB,550132,0,0,0,0,
Oklahoma,Governor,Rex Lawhorn,LIB,550132,0,0,0,0,
Oklahoma,Corporation Commissioner,Ashley Nicole Mccray,DEM,550132,0,0,44,44,
Oklahoma,Corporation Commissioner,Blake Cummings,DEM,550132,0,0,20,20,
Oklahoma,U.S. House,Kendra Horn,DEM,550132,0,0,54,54,05
Oklahoma,U.S. House,Tom Guild,DEM,550132,0,0,12,12,05
Oklahoma,Governor,Mick Cornett,REP,550133,0,0,170,170,
Oklahoma,Governor,Kevin Stitt,REP,550133,0,0,78,78,
Oklahoma,Lieutenant Governor,Dana Murphy,REP,550133,0,0,107,107,
Oklahoma,Lieutenant Governor,Matt Pinnell,REP,550133,0,0,135,135,
Oklahoma,State Auditor,Cindy Byrd,REP,550133,0,0,128,128,
Oklahoma,State Auditor,Charlie Prater,REP,550133,0,0,104,104,
Oklahoma,Attorney General,Mike Hunter,REP,550133,0,0,151,151,
Oklahoma,Attorney General,Gentner Drummond,REP,550133,0,0,90,90,
Oklahoma,Superintendent of Public Instruction,Joy Hofmeister,REP,550133,0,0,142,142,
Oklahoma,Superintendent of Public Instruction,Linda Murphy,REP,550133,0,0,100,100,
Oklahoma,Commissioner of Labor,Cathy Costello,REP,550133,0,0,109,109,
Oklahoma,Commissioner of Labor,Leslie Osborn,REP,550133,0,0,126,126,
Oklahoma,Corporation Commissioner,Bob Anthony,REP,550133,0,0,141,141,
Oklahoma,Corporation Commissioner,Brian Bingman,REP,550133,0,0,97,97,
Oklahoma,Governor,Chris Powell,LIB,550133,0,0,1,1,
Oklahoma,Governor,Rex Lawhorn,LIB,550133,0,0,0,0,
Oklahoma,Corporation Commissioner,Ashley Nicole Mccray,DEM,550133,0,0,78,78,
Oklahoma,Corporation Commissioner,Blake Cummings,DEM,550133,0,0,24,24,
Oklahoma,U.S. House,Kendra Horn,DEM,550133,0,0,78,78,05
Oklahoma,U.S. House,Tom Guild,DEM,550133,0,0,29,29,05
Oklahoma,Governor,Mick Cornett,REP,550134,0,0,309,309,
Oklahoma,Governor,Kevin Stitt,REP,550134,0,0,230,230,
Oklahoma,Lieutenant Governor,Dana Murphy,REP,550134,0,0,252,252,
Oklahoma,Lieutenant Governor,Matt Pinnell,REP,550134,0,0,266,266,
Oklahoma,State Auditor,Cindy Byrd,REP,550134,0,0,242,242,
Oklahoma,State Auditor,Charlie Prater,REP,550134,0,0,259,259,
Oklahoma,Attorney General,Mike Hunter,REP,550134,0,0,309,309,
Oklahoma,Attorney General,Gentner Drummond,REP,550134,0,0,210,210,
Oklahoma,Superintendent of Public Instruction,Joy Hofmeister,REP,550134,0,0,311,311,
Oklahoma,Superintendent of Public Instruction,Linda Murphy,REP,550134,0,0,209,209,
Oklahoma,Commissioner of Labor,Cathy Costello,REP,550134,0,0,251,251,
Oklahoma,Commissioner of Labor,Leslie Osborn,REP,550134,0,0,266,266,
Oklahoma,Corporation Commissioner,Bob Anthony,REP,550134,0,0,277,277,
Oklahoma,Corporation Commissioner,Brian Bingman,REP,550134,0,0,234,234,
Oklahoma,State House,Nicole Miller,REP,550134,0,0,330,330,82
Oklahoma,State House,Brad Martin,REP,550134,0,0,191,191,82
Oklahoma,Governor,Chris Powell,LIB,550134,0,0,4,4,
Oklahoma,Governor,Rex Lawhorn,LIB,550134,0,0,0,0,
Oklahoma,Corporation Commissioner,Ashley Nicole Mccray,DEM,550134,0,0,116,116,
Oklahoma,Corporation Commissioner,Blake Cummings,DEM,550134,0,0,20,20,
Oklahoma,U.S. House,Kendra Horn,DEM,550134,0,0,115,115,05
Oklahoma,U.S. House,Tom Guild,DEM,550134,0,0,22,22,05
Oklahoma,Governor,Mick Cornett,REP,550135,0,0,87,87,
Oklahoma,Governor,Kevin Stitt,REP,550135,0,0,46,46,
Oklahoma,Lieutenant Governor,Dana Murphy,REP,550135,0,0,69,69,
Oklahoma,Lieutenant Governor,Matt Pinnell,REP,550135,0,0,61,61,
Oklahoma,State Auditor,Cindy Byrd,REP,550135,0,0,65,65,
Oklahoma,State Auditor,Charlie Prater,REP,550135,0,0,60,60,
Oklahoma,Attorney General,Mike Hunter,REP,550135,0,0,77,77,
Oklahoma,Attorney General,Gentner Drummond,REP,550135,0,0,48,48,
Oklahoma,Superintendent of Public Instruction,Joy Hofmeister,REP,550135,0,0,79,79,
Oklahoma,Superintendent of Public Instruction,Linda Murphy,REP,550135,0,0,53,53,
Oklahoma,Commissioner of Labor,Cathy Costello,REP,550135,0,0,56,56,
Oklahoma,Commissioner of Labor,Leslie Osborn,REP,550135,0,0,68,68,
Oklahoma,Corporation Commissioner,Bob Anthony,REP,550135,0,0,58,58,
Oklahoma,Corporation Commissioner,Brian Bingman,REP,550135,0,0,65,65,
Oklahoma,State House,Nicole Miller,REP,550135,0,0,95,95,82
Oklahoma,State House,Brad Martin,REP,550135,0,0,35,35,82
Oklahoma,Governor,Chris Powell,LIB,550135,0,0,1,1,
Oklahoma,Governor,Rex Lawhorn,LIB,550135,0,0,0,0,
Oklahoma,Corporation Commissioner,Ashley Nicole Mccray,DEM,550135,0,0,43,43,
Oklahoma,Corporation Commissioner,Blake Cummings,DEM,550135,0,0,7,7,
Oklahoma,U.S. House,Kendra Horn,DEM,550135,0,0,46,46,05
Oklahoma,U.S. House,Tom Guild,DEM,550135,0,0,4,4,05
Oklahoma,Governor,Mick Cornett,REP,550136,0,0,369,369,
Oklahoma,Governor,Kevin Stitt,REP,550136,0,0,209,209,
Oklahoma,Lieutenant Governor,Dana Murphy,REP,550136,0,0,272,272,
Oklahoma,Lieutenant Governor,Matt Pinnell,REP,550136,0,0,283,283,
Oklahoma,State Auditor,Cindy Byrd,REP,550136,0,0,266,266,
Oklahoma,State Auditor,Charlie Prater,REP,550136,0,0,264,264,
Oklahoma,Attorney General,Mike Hunter,REP,550136,0,0,358,358,
Oklahoma,Attorney General,Gentner Drummond,REP,550136,0,0,202,202,
Oklahoma,Superintendent of Public Instruction,Joy Hofmeister,REP,550136,0,0,339,339,
Oklahoma,Superintendent of Public Instruction,Linda Murphy,REP,550136,0,0,217,217,
Oklahoma,Commissioner of Labor,Cathy Costello,REP,550136,0,0,252,252,
Oklahoma,Commissioner of Labor,Leslie Osborn,REP,550136,0,0,295,295,
Oklahoma,Corporation Commissioner,Bob Anthony,REP,550136,0,0,323,323,
Oklahoma,Corporation Commissioner,Brian Bingman,REP,550136,0,0,218,218,
Oklahoma,State House,Nicole Miller,REP,550136,0,0,330,330,82
Oklahoma,State House,Brad Martin,REP,550136,0,0,222,222,82
Oklahoma,Governor,Chris Powell,LIB,550136,0,0,1,1,
Oklahoma,Governor,Rex Lawhorn,LIB,550136,0,0,0,0,
Oklahoma,Corporation Commissioner,Ashley Nicole Mccray,DEM,550136,0,0,126,126,
Oklahoma,Corporation Commissioner,Blake Cummings,DEM,550136,0,0,26,26,
Oklahoma,U.S. House,Kendra Horn,DEM,550136,0,0,116,116,05
Oklahoma,U.S. House,Tom Guild,DEM,550136,0,0,37,37,05
Oklahoma,Governor,Mick Cornett,REP,550137,0,0,379,379,
Oklahoma,Governor,Kevin Stitt,REP,550137,0,0,281,281,
Oklahoma,Lieutenant Governor,Dana Murphy,REP,550137,0,0,291,291,
Oklahoma,Lieutenant Governor,Matt Pinnell,REP,550137,0,0,343,343,
Oklahoma,State Auditor,Cindy Byrd,REP,550137,0,0,333,333,
Oklahoma,State Auditor,Charlie Prater,REP,550137,0,0,269,269,
Oklahoma,Attorney General,Mike Hunter,REP,550137,0,0,413,413,
Oklahoma,Attorney General,Gentner Drummond,REP,550137,0,0,215,215,
Oklahoma,Superintendent of Public Instruction,Joy Hofmeister,REP,550137,0,0,388,388,
Oklahoma,Superintendent of Public Instruction,Linda Murphy,REP,550137,0,0,249,249,
Oklahoma,Commissioner of Labor,Cathy Costello,REP,550137,0,0,322,322,
Oklahoma,Commissioner of Labor,Leslie Osborn,REP,550137,0,0,295,295,
Oklahoma,Corporation Commissioner,Bob Anthony,REP,550137,0,0,332,332,
Oklahoma,Corporation Commissioner,Brian Bingman,REP,550137,0,0,285,285,
Oklahoma,State House,Nicole Miller,REP,550137,0,0,299,299,82
Oklahoma,State House,Brad Martin,REP,550137,0,0,352,352,82
Oklahoma,Governor,Chris Powell,LIB,550137,0,0,0,0,
Oklahoma,Governor,Rex Lawhorn,LIB,550137,0,0,3,3,
Oklahoma,Corporation Commissioner,Ashley Nicole Mccray,DEM,550137,0,0,51,51,
Oklahoma,Corporation Commissioner,Blake Cummings,DEM,550137,0,0,19,19,
Oklahoma,U.S. House,Kendra Horn,DEM,550137,0,0,57,57,05
Oklahoma,U.S. House,Tom Guild,DEM,550137,0,0,14,14,05
Oklahoma,Governor,Mick Cornett,REP,550138,0,0,97,97,
Oklahoma,Governor,Kevin Stitt,REP,550138,0,0,110,110,
Oklahoma,Lieutenant Governor,Dana Murphy,REP,550138,0,0,97,97,
Oklahoma,Lieutenant Governor,Matt Pinnell,REP,550138,0,0,103,103,
Oklahoma,State Auditor,Cindy Byrd,REP,550138,0,0,81,81,
Oklahoma,State Auditor,Charlie Prater,REP,550138,0,0,115,115,
Oklahoma,Attorney General,Mike Hunter,REP,550138,0,0,126,126,
Oklahoma,Attorney General,Gentner Drummond,REP,550138,0,0,73,73,
Oklahoma,Superintendent of Public Instruction,Joy Hofmeister,REP,550138,0,0,116,116,
Oklahoma,Superintendent of Public Instruction,Linda Murphy,REP,550138,0,0,85,85,
Oklahoma,Commissioner of Labor,Cathy Costello,REP,550138,0,0,98,98,
Oklahoma,Commissioner of Labor,Leslie Osborn,REP,550138,0,0,101,101,
Oklahoma,Corporation Commissioner,Bob Anthony,REP,550138,0,0,104,104,
Oklahoma,Corporation Commissioner,Brian Bingman,REP,550138,0,0,93,93,
Oklahoma,State House,Roxanne Pollard,REP,550138,0,0,72,72,41
Oklahoma,State House,Denise Crosswhite Hader,REP,550138,0,0,121,121,41
Oklahoma,Governor,Chris Powell,LIB,550138,0,0,0,0,
Oklahoma,Governor,Rex Lawhorn,LIB,550138,0,0,0,0,
Oklahoma,Corporation Commissioner,Ashley Nicole Mccray,DEM,550138,0,0,15,15,
Oklahoma,Corporation Commissioner,Blake Cummings,DEM,550138,0,0,5,5,
Oklahoma,U.S. House,Kendra Horn,DEM,550138,0,0,17,17,05
Oklahoma,U.S. House,Tom Guild,DEM,550138,0,0,3,3,05
Oklahoma,State House,Sara Peterson,DEM,550138,0,0,4,4,41
Oklahoma,State House,Jennie Scott,DEM,550138,0,0,15,15,41
Oklahoma,Governor,Mick Cornett,REP,550139,0,0,522,522,
Oklahoma,Governor,Kevin Stitt,REP,550139,0,0,270,270,
Oklahoma,Lieutenant Governor,Dana Murphy,REP,550139,0,0,376,376,
Oklahoma,Lieutenant Governor,Matt Pinnell,REP,550139,0,0,379,379,
Oklahoma,State Auditor,Cindy Byrd,REP,550139,0,0,376,376,
Oklahoma,State Auditor,Charlie Prater,REP,550139,0,0,339,339,
Oklahoma,Attorney General,Mike Hunter,REP,550139,0,0,470,470,
Oklahoma,Attorney General,Gentner Drummond,REP,550139,0,0,288,288,
Oklahoma,Superintendent of Public Instruction,Joy Hofmeister,REP,550139,0,0,473,473,
Oklahoma,Superintendent of Public Instruction,Linda Murphy,REP,550139,0,0,286,286,
Oklahoma,Commissioner of Labor,Cathy Costello,REP,550139,0,0,360,360,
Oklahoma,Commissioner of Labor,Leslie Osborn,REP,550139,0,0,388,388,
Oklahoma,Corporation Commissioner,Bob Anthony,REP,550139,0,0,422,422,
Oklahoma,Corporation Commissioner,Brian Bingman,REP,550139,0,0,315,315,
Oklahoma,State House,Nicole Miller,REP,550139,0,0,536,536,82
Oklahoma,State House,Brad Martin,REP,550139,0,0,234,234,82
Oklahoma,Governor,Chris Powell,LIB,550139,0,0,1,1,
Oklahoma,Governor,Rex Lawhorn,LIB,550139,0,0,0,0,
Oklahoma,Corporation Commissioner,Ashley Nicole Mccray,DEM,550139,0,0,120,120,
Oklahoma,Corporation Commissioner,Blake Cummings,DEM,550139,0,0,38,38,
Oklahoma,U.S. House,Kendra Horn,DEM,550139,0,0,127,127,05
Oklahoma,U.S. House,Tom Guild,DEM,550139,0,0,31,31,05
Oklahoma,Governor,Mick Cornett,REP,550140,0,0,216,216,
Oklahoma,Governor,Kevin Stitt,REP,550140,0,0,110,110,
Oklahoma,Lieutenant Governor,Dana Murphy,REP,550140,0,0,184,184,
Oklahoma,Lieutenant Governor,Matt Pinnell,REP,550140,0,0,128,128,
Oklahoma,State Auditor,Cindy Byrd,REP,550140,0,0,162,162,
Oklahoma,State Auditor,Charlie Prater,REP,550140,0,0,127,127,
Oklahoma,Attorney General,Mike Hunter,REP,550140,0,0,225,225,
Oklahoma,Attorney General,Gentner Drummond,REP,550140,0,0,89,89,
Oklahoma,Superintendent of Public Instruction,Joy Hofmeister,REP,550140,0,0,188,188,
Oklahoma,Superintendent of Public Instruction,Linda Murphy,REP,550140,0,0,111,111,
Oklahoma,Commissioner of Labor,Cathy Costello,REP,550140,0,0,160,160,
Oklahoma,Commissioner of Labor,Leslie Osborn,REP,550140,0,0,142,142,
Oklahoma,Corporation Commissioner,Bob Anthony,REP,550140,0,0,194,194,
Oklahoma,Corporation Commissioner,Brian Bingman,REP,550140,0,0,106,106,
Oklahoma,State House,Nicole Miller,REP,550140,0,0,158,158,82
Oklahoma,State House,Brad Martin,REP,550140,0,0,146,146,82
Oklahoma,Governor,Chris Powell,LIB,550140,0,0,0,0,
Oklahoma,Governor,Rex Lawhorn,LIB,550140,0,0,0,0,
Oklahoma,Corporation Commissioner,Ashley Nicole Mccray,DEM,550140,0,0,35,35,
Oklahoma,Corporation Commissioner,Blake Cummings,DEM,550140,0,0,12,12,
Oklahoma,U.S. House,Kendra Horn,DEM,550140,0,0,34,34,05
Oklahoma,U.S. House,Tom Guild,DEM,550140,0,0,13,13,05
Oklahoma,Governor,Mick Cornett,REP,550141,0,0,360,360,
Oklahoma,Governor,Kevin Stitt,REP,550141,0,0,220,220,
Oklahoma,Lieutenant Governor,Dana Murphy,REP,550141,0,0,278,278,
Oklahoma,Lieutenant Governor,Matt Pinnell,REP,550141,0,0,278,278,
Oklahoma,State Auditor,Cindy Byrd,REP,550141,0,0,296,296,
Oklahoma,State Auditor,Charlie Prater,REP,550141,0,0,245,245,
Oklahoma,Attorney General,Mike Hunter,REP,550141,0,0,360,360,
Oklahoma,Attorney General,Gentner Drummond,REP,550141,0,0,200,200,
Oklahoma,Superintendent of Public Instruction,Joy Hofmeister,REP,550141,0,0,335,335,
Oklahoma,Superintendent of Public Instruction,Linda Murphy,REP,550141,0,0,226,226,
Oklahoma,Commissioner of Labor,Cathy Costello,REP,550141,0,0,272,272,
Oklahoma,Commissioner of Labor,Leslie Osborn,REP,550141,0,0,286,286,
Oklahoma,Corporation Commissioner,Bob Anthony,REP,550141,0,0,340,340,
Oklahoma,Corporation Commissioner,Brian Bingman,REP,550141,0,0,214,214,
Oklahoma,State House,Roxanne Pollard,REP,550141,0,0,181,181,41
Oklahoma,State House,Denise Crosswhite Hader,REP,550141,0,0,358,358,41
Oklahoma,Governor,Chris Powell,LIB,550141,0,0,0,0,
Oklahoma,Governor,Rex Lawhorn,LIB,550141,0,0,0,0,
Oklahoma,Corporation Commissioner,Ashley Nicole Mccray,DEM,550141,0,0,87,87,
Oklahoma,Corporation Commissioner,Blake Cummings,DEM,550141,0,0,32,32,
Oklahoma,U.S. House,Kendra Horn,DEM,550141,0,0,92,92,05
Oklahoma,U.S. House,Tom Guild,DEM,550141,0,0,29,29,05
Oklahoma,State House,Sara Peterson,DEM,550141,0,0,59,59,41
Oklahoma,State House,Jennie Scott,DEM,550141,0,0,62,62,41
Oklahoma,Governor,Mick Cornett,REP,550142,0,0,231,231,
Oklahoma,Governor,Kevin Stitt,REP,550142,0,0,177,177,
Oklahoma,Lieutenant Governor,Dana Murphy,REP,550142,0,0,214,214,
Oklahoma,Lieutenant Governor,Matt Pinnell,REP,550142,0,0,182,182,
Oklahoma,State Auditor,Cindy Byrd,REP,550142,0,0,214,214,
Oklahoma,State Auditor,Charlie Prater,REP,550142,0,0,169,169,
Oklahoma,Attorney General,Mike Hunter,REP,550142,0,0,238,238,
Oklahoma,Attorney General,Gentner Drummond,REP,550142,0,0,159,159,
Oklahoma,Superintendent of Public Instruction,Joy Hofmeister,REP,550142,0,0,234,234,
Oklahoma,Superintendent of Public Instruction,Linda Murphy,REP,550142,0,0,157,157,
Oklahoma,Commissioner of Labor,Cathy Costello,REP,550142,0,0,184,184,
Oklahoma,Commissioner of Labor,Leslie Osborn,REP,550142,0,0,201,201,
Oklahoma,Corporation Commissioner,Bob Anthony,REP,550142,0,0,238,238,
Oklahoma,Corporation Commissioner,Brian Bingman,REP,550142,0,0,150,150,
Oklahoma,State House,Nicole Miller,REP,550142,0,0,235,235,82
Oklahoma,State House,Brad Martin,REP,550142,0,0,164,164,82
Oklahoma,Governor,Chris Powell,LIB,550142,0,0,0,0,
Oklahoma,Governor,Rex Lawhorn,LIB,550142,0,0,0,0,
Oklahoma,Corporation Commissioner,Ashley Nicole Mccray,DEM,550142,0,0,146,146,
Oklahoma,Corporation Commissioner,Blake Cummings,DEM,550142,0,0,32,32,
Oklahoma,U.S. House,Kendra Horn,DEM,550142,0,0,134,134,05
Oklahoma,U.S. House,Tom Guild,DEM,550142,0,0,46,46,05
Oklahoma,Governor,Mick Cornett,REP,550143,0,0,212,212,
Oklahoma,Governor,Kevin Stitt,REP,550143,0,0,158,158,
Oklahoma,Lieutenant Governor,Dana Murphy,REP,550143,0,0,177,177,
Oklahoma,Lieutenant Governor,Matt Pinnell,REP,550143,0,0,188,188,
Oklahoma,State Auditor,Cindy Byrd,REP,550143,0,0,177,177,
Oklahoma,State Auditor,Charlie Prater,REP,550143,0,0,165,165,
Oklahoma,Attorney General,Mike Hunter,REP,550143,0,0,281,281,
Oklahoma,Attorney General,Gentner Drummond,REP,550143,0,0,81,81,
Oklahoma,Superintendent of Public Instruction,Joy Hofmeister,REP,550143,0,0,213,213,
Oklahoma,Superintendent of Public Instruction,Linda Murphy,REP,550143,0,0,144,144,
Oklahoma,Commissioner of Labor,Cathy Costello,REP,550143,0,0,167,167,
Oklahoma,Commissioner of Labor,Leslie Osborn,REP,550143,0,0,181,181,
Oklahoma,Corporation Commissioner,Bob Anthony,REP,550143,0,0,254,254,
Oklahoma,Corporation Commissioner,Brian Bingman,REP,550143,0,0,108,108,
Oklahoma,State House,Nicole Miller,REP,550143,0,0,179,179,82
Oklahoma,State House,Brad Martin,REP,550143,0,0,182,182,82
Oklahoma,Governor,Chris Powell,LIB,550143,0,0,0,0,
Oklahoma,Governor,Rex Lawhorn,LIB,550143,0,0,1,1,
Oklahoma,Corporation Commissioner,Ashley Nicole Mccray,DEM,550143,0,0,50,50,
Oklahoma,Corporation Commissioner,Blake Cummings,DEM,550143,0,0,15,15,
Oklahoma,U.S. House,Kendra Horn,DEM,550143,0,0,53,53,05
Oklahoma,U.S. House,Tom Guild,DEM,550143,0,0,12,12,05
Oklahoma,Governor,Mick Cornett,REP,550144,0,0,232,232,
Oklahoma,Governor,Kevin Stitt,REP,550144,0,0,147,147,
Oklahoma,Lieutenant Governor,Dana Murphy,REP,550144,0,0,192,192,
Oklahoma,Lieutenant Governor,Matt Pinnell,REP,550144,0,0,178,178,
Oklahoma,State Auditor,Cindy Byrd,REP,550144,0,0,193,193,
Oklahoma,State Auditor,Charlie Prater,REP,550144,0,0,164,164,
Oklahoma,Attorney General,Mike Hunter,REP,550144,0,0,237,237,
Oklahoma,Attorney General,Gentner Drummond,REP,550144,0,0,136,136,
Oklahoma,Superintendent of Public Instruction,Joy Hofmeister,REP,550144,0,0,241,241,
Oklahoma,Superintendent of Public Instruction,Linda Murphy,REP,550144,0,0,131,131,
Oklahoma,Commissioner of Labor,Cathy Costello,REP,550144,0,0,175,175,
Oklahoma,Commissioner of Labor,Leslie Osborn,REP,550144,0,0,192,192,
Oklahoma,Corporation Commissioner,Bob Anthony,REP,550144,0,0,224,224,
Oklahoma,Corporation Commissioner,Brian Bingman,REP,550144,0,0,143,143,
Oklahoma,State House,Nicole Miller,REP,550144,0,0,198,198,82
Oklahoma,State House,Brad Martin,REP,550144,0,0,170,170,82
Oklahoma,Governor,Chris Powell,LIB,550144,0,0,0,0,
Oklahoma,Governor,Rex Lawhorn,LIB,550144,0,0,0,0,
Oklahoma,Corporation Commissioner,Ashley Nicole Mccray,DEM,550144,0,0,54,54,
Oklahoma,Corporation Commissioner,Blake Cummings,DEM,550144,0,0,19,19,
Oklahoma,U.S. House,Kendra Horn,DEM,550144,0,0,60,60,05
Oklahoma,U.S. House,Tom Guild,DEM,550144,0,0,15,15,05
Oklahoma,Governor,Mick Cornett,REP,550145,0,0,306,306,
Oklahoma,Governor,Kevin Stitt,REP,550145,0,0,108,108,
Oklahoma,Lieutenant Governor,Dana Murphy,REP,550145,0,0,177,177,
Oklahoma,Lieutenant Governor,Matt Pinnell,REP,550145,0,0,219,219,
Oklahoma,State Auditor,Cindy Byrd,REP,550145,0,0,192,192,
Oklahoma,State Auditor,Charlie Prater,REP,550145,0,0,176,176,
Oklahoma,Attorney General,Mike Hunter,REP,550145,0,0,299,299,
Oklahoma,Attorney General,Gentner Drummond,REP,550145,0,0,102,102,
Oklahoma,Superintendent of Public Instruction,Joy Hofmeister,REP,550145,0,0,245,245,
Oklahoma,Superintendent of Public Instruction,Linda Murphy,REP,550145,0,0,151,151,
Oklahoma,Commissioner of Labor,Cathy Costello,REP,550145,0,0,201,201,
Oklahoma,Commissioner of Labor,Leslie Osborn,REP,550145,0,0,194,194,
Oklahoma,Corporation Commissioner,Bob Anthony,REP,550145,0,0,247,247,
Oklahoma,Corporation Commissioner,Brian Bingman,REP,550145,0,0,150,150,
Oklahoma,State Senate,Lori Callahan,REP,550145,0,0,111,111,30
Oklahoma,State Senate,John Symcox,REP,550145,0,0,272,272,30
Oklahoma,Governor,Chris Powell,LIB,550145,0,0,0,0,
Oklahoma,Governor,Rex Lawhorn,LIB,550145,0,0,0,0,
Oklahoma,Corporation Commissioner,Ashley Nicole Mccray,DEM,550145,0,0,50,50,
Oklahoma,Corporation Commissioner,Blake Cummings,DEM,550145,0,0,18,18,
Oklahoma,U.S. House,Kendra Horn,DEM,550145,0,0,57,57,05
Oklahoma,U.S. House,Tom Guild,DEM,550145,0,0,13,13,05
Oklahoma,Governor,Mick Cornett,REP,550146,0,0,319,319,
Oklahoma,Governor,Kevin Stitt,REP,550146,0,0,178,178,
Oklahoma,Lieutenant Governor,Dana Murphy,REP,550146,0,0,218,218,
Oklahoma,Lieutenant Governor,Matt Pinnell,REP,550146,0,0,263,263,
Oklahoma,State Auditor,Cindy Byrd,REP,550146,0,0,231,231,
Oklahoma,State Auditor,Charlie Prater,REP,550146,0,0,231,231,
Oklahoma,Attorney General,Mike Hunter,REP,550146,0,0,346,346,
Oklahoma,Attorney General,Gentner Drummond,REP,550146,0,0,131,131,
Oklahoma,Superintendent of Public Instruction,Joy Hofmeister,REP,550146,0,0,283,283,
Oklahoma,Superintendent of Public Instruction,Linda Murphy,REP,550146,0,0,194,194,
Oklahoma,Commissioner of Labor,Cathy Costello,REP,550146,0,0,242,242,
Oklahoma,Commissioner of Labor,Leslie Osborn,REP,550146,0,0,233,233,
Oklahoma,Corporation Commissioner,Bob Anthony,REP,550146,0,0,313,313,
Oklahoma,Corporation Commissioner,Brian Bingman,REP,550146,0,0,162,162,
Oklahoma,State Senate,Lori Callahan,REP,550146,0,0,158,158,30
Oklahoma,State Senate,John Symcox,REP,550146,0,0,317,317,30
Oklahoma,Governor,Chris Powell,LIB,550146,0,0,1,1,
Oklahoma,Governor,Rex Lawhorn,LIB,550146,0,0,0,0,
Oklahoma,Corporation Commissioner,Ashley Nicole Mccray,DEM,550146,0,0,105,105,
Oklahoma,Corporation Commissioner,Blake Cummings,DEM,550146,0,0,32,32,
Oklahoma,U.S. House,Kendra Horn,DEM,550146,0,0,111,111,05
Oklahoma,U.S. House,Tom Guild,DEM,550146,0,0,27,27,05
Oklahoma,Governor,Mick Cornett,REP,550147,0,0,102,102,
Oklahoma,Governor,Kevin Stitt,REP,550147,0,0,61,61,
Oklahoma,Lieutenant Governor,Dana Murphy,REP,550147,0,0,67,67,
Oklahoma,Lieutenant Governor,Matt Pinnell,REP,550147,0,0,93,93,
Oklahoma,State Auditor,Cindy Byrd,REP,550147,0,0,85,85,
Oklahoma,State Auditor,Charlie Prater,REP,550147,0,0,68,68,
Oklahoma,Attorney General,Mike Hunter,REP,550147,0,0,105,105,
Oklahoma,Attorney General,Gentner Drummond,REP,550147,0,0,55,55,
Oklahoma,Superintendent of Public Instruction,Joy Hofmeister,REP,550147,0,0,77,77,
Oklahoma,Superintendent of Public Instruction,Linda Murphy,REP,550147,0,0,79,79,
Oklahoma,Commissioner of Labor,Cathy Costello,REP,550147,0,0,82,82,
Oklahoma,Commissioner of Labor,Leslie Osborn,REP,550147,0,0,77,77,
Oklahoma,Corporation Commissioner,Bob Anthony,REP,550147,0,0,91,91,
Oklahoma,Corporation Commissioner,Brian Bingman,REP,550147,0,0,68,68,
Oklahoma,Governor,Chris Powell,LIB,550147,0,0,0,0,
Oklahoma,Governor,Rex Lawhorn,LIB,550147,0,0,1,1,
Oklahoma,Corporation Commissioner,Ashley Nicole Mccray,DEM,550147,0,0,30,30,
Oklahoma,Corporation Commissioner,Blake Cummings,DEM,550147,0,0,11,11,
Oklahoma,U.S. House,Kendra Horn,DEM,550147,0,0,33,33,05
Oklahoma,U.S. House,Tom Guild,DEM,550147,0,0,9,9,05
Oklahoma,Governor,Mick Cornett,REP,550148,0,0,278,278,
Oklahoma,Governor,Kevin Stitt,REP,550148,0,0,213,213,
Oklahoma,Lieutenant Governor,Dana Murphy,REP,550148,0,0,230,230,
Oklahoma,Lieutenant Governor,Matt Pinnell,REP,550148,0,0,250,250,
Oklahoma,State Auditor,Cindy Byrd,REP,550148,0,0,232,232,
Oklahoma,State Auditor,Charlie Prater,REP,550148,0,0,233,233,
Oklahoma,Attorney General,Mike Hunter,REP,550148,0,0,301,301,
Oklahoma,Attorney General,Gentner Drummond,REP,550148,0,0,182,182,
Oklahoma,Superintendent of Public Instruction,Joy Hofmeister,REP,550148,0,0,297,297,
Oklahoma,Superintendent of Public Instruction,Linda Murphy,REP,550148,0,0,181,181,
Oklahoma,Commissioner of Labor,Cathy Costello,REP,550148,0,0,221,221,
Oklahoma,Commissioner of Labor,Leslie Osborn,REP,550148,0,0,252,252,
Oklahoma,Corporation Commissioner,Bob Anthony,REP,550148,0,0,281,281,
Oklahoma,Corporation Commissioner,Brian Bingman,REP,550148,0,0,192,192,
Oklahoma,State House,Nicole Miller,REP,550148,0,0,246,246,82
Oklahoma,State House,Brad Martin,REP,550148,0,0,240,240,82
Oklahoma,Governor,Chris Powell,LIB,550148,0,0,1,1,
Oklahoma,Governor,Rex Lawhorn,LIB,550148,0,0,1,1,
Oklahoma,Corporation Commissioner,Ashley Nicole Mccray,DEM,550148,0,0,118,118,
Oklahoma,Corporation Commissioner,Blake Cummings,DEM,550148,0,0,40,40,
Oklahoma,U.S. House,Kendra Horn,DEM,550148,0,0,133,133,05
Oklahoma,U.S. House,Tom Guild,DEM,550148,0,0,30,30,05
Oklahoma,Governor,Mick Cornett,REP,550149,0,0,383,383,
Oklahoma,Governor,Kevin Stitt,REP,550149,0,0,200,200,
Oklahoma,Lieutenant Governor,Dana Murphy,REP,550149,0,0,270,270,
Oklahoma,Lieutenant Governor,Matt Pinnell,REP,550149,0,0,292,292,
Oklahoma,State Auditor,Cindy Byrd,REP,550149,0,0,280,280,
Oklahoma,State Auditor,Charlie Prater,REP,550149,0,0,256,256,
Oklahoma,Attorney General,Mike Hunter,REP,550149,0,0,415,415,
Oklahoma,Attorney General,Gentner Drummond,REP,550149,0,0,156,156,
Oklahoma,Superintendent of Public Instruction,Joy Hofmeister,REP,550149,0,0,377,377,
Oklahoma,Superintendent of Public Instruction,Linda Murphy,REP,550149,0,0,180,180,
Oklahoma,Commissioner of Labor,Cathy Costello,REP,550149,0,0,256,256,
Oklahoma,Commissioner of Labor,Leslie Osborn,REP,550149,0,0,304,304,
Oklahoma,Corporation Commissioner,Bob Anthony,REP,550149,0,0,364,364,
Oklahoma,Corporation Commissioner,Brian Bingman,REP,550149,0,0,203,203,
Oklahoma,State House,Nicole Miller,REP,550149,0,0,299,299,82
Oklahoma,State House,Brad Martin,REP,550149,0,0,271,271,82
Oklahoma,Governor,Chris Powell,LIB,550149,0,0,2,2,
Oklahoma,Governor,Rex Lawhorn,LIB,550149,0,0,0,0,
Oklahoma,Corporation Commissioner,Ashley Nicole Mccray,DEM,550149,0,0,74,74,
Oklahoma,Corporation Commissioner,Blake Cummings,DEM,550149,0,0,21,21,
Oklahoma,U.S. House,Kendra Horn,DEM,550149,0,0,79,79,05
Oklahoma,U.S. House,Tom Guild,DEM,550149,0,0,17,17,05
Oklahoma,Governor,Mick Cornett,REP,550150,0,0,298,298,
Oklahoma,Governor,Kevin Stitt,REP,550150,0,0,174,174,
Oklahoma,Lieutenant Governor,Dana Murphy,REP,550150,0,0,236,236,
Oklahoma,Lieutenant Governor,Matt Pinnell,REP,550150,0,0,222,222,
Oklahoma,State Auditor,Cindy Byrd,REP,550150,0,0,219,219,
Oklahoma,State Auditor,Charlie Prater,REP,550150,0,0,215,215,
Oklahoma,Attorney General,Mike Hunter,REP,550150,0,0,277,277,
Oklahoma,Attorney General,Gentner Drummond,REP,550150,0,0,181,181,
Oklahoma,Superintendent of Public Instruction,Joy Hofmeister,REP,550150,0,0,268,268,
Oklahoma,Superintendent of Public Instruction,Linda Murphy,REP,550150,0,0,187,187,
Oklahoma,Commissioner of Labor,Cathy Costello,REP,550150,0,0,216,216,
Oklahoma,Commissioner of Labor,Leslie Osborn,REP,550150,0,0,235,235,
Oklahoma,Corporation Commissioner,Bob Anthony,REP,550150,0,0,268,268,
Oklahoma,Corporation Commissioner,Brian Bingman,REP,550150,0,0,189,189,
Oklahoma,State House,Julie Roach,REP,550150,0,0,194,194,10
Oklahoma,State House,Marilyn Stark,REP,550150,0,0,234,234,10
Oklahoma,Governor,Chris Powell,LIB,550150,0,0,0,0,
Oklahoma,Governor,Rex Lawhorn,LIB,550150,0,0,0,0,
Oklahoma,Corporation Commissioner,Ashley Nicole Mccray,DEM,550150,0,0,89,89,
Oklahoma,Corporation Commissioner,Blake Cummings,DEM,550150,0,0,25,25,
Oklahoma,U.S. House,Kendra Horn,DEM,550150,0,0,91,91,05
Oklahoma,U.S. House,Tom Guild,DEM,550150,0,0,22,22,05
Oklahoma,Governor,Mick Cornett,REP,550151,0,0,249,249,
Oklahoma,Governor,Kevin Stitt,REP,550151,0,0,226,226,
Oklahoma,Lieutenant Governor,Dana Murphy,REP,550151,0,0,228,228,
Oklahoma,Lieutenant Governor,Matt Pinnell,REP,550151,0,0,240,240,
Oklahoma,State Auditor,Cindy Byrd,REP,550151,0,0,259,259,
Oklahoma,State Auditor,Charlie Prater,REP,550151,0,0,200,200,
Oklahoma,Attorney General,Mike Hunter,REP,550151,0,0,284,284,
Oklahoma,Attorney General,Gentner Drummond,REP,550151,0,0,182,182,
Oklahoma,Superintendent of Public Instruction,Joy Hofmeister,REP,550151,0,0,258,258,
Oklahoma,Superintendent of Public Instruction,Linda Murphy,REP,550151,0,0,205,205,
Oklahoma,Commissioner of Labor,Cathy Costello,REP,550151,0,0,221,221,
Oklahoma,Commissioner of Labor,Leslie Osborn,REP,550151,0,0,242,242,
Oklahoma,Corporation Commissioner,Bob Anthony,REP,550151,0,0,283,283,
Oklahoma,Corporation Commissioner,Brian Bingman,REP,550151,0,0,181,181,
Oklahoma,State House,Julie Roach,REP,550151,0,0,236,236,10
Oklahoma,State House,Marilyn Stark,REP,550151,0,0,221,221,10
Oklahoma,Governor,Chris Powell,LIB,550151,0,0,2,2,
Oklahoma,Governor,Rex Lawhorn,LIB,550151,0,0,0,0,
Oklahoma,Corporation Commissioner,Ashley Nicole Mccray,DEM,550151,0,0,106,106,
Oklahoma,Corporation Commissioner,Blake Cummings,DEM,550151,0,0,28,28,
Oklahoma,U.S. House,Kendra Horn,DEM,550151,0,0,108,108,05
Oklahoma,U.S. House,Tom Guild,DEM,550151,0,0,27,27,05
Oklahoma,Governor,Mick Cornett,REP,550152,0,0,270,270,
Oklahoma,Governor,Kevin Stitt,REP,550152,0,0,176,176,
Oklahoma,Lieutenant Governor,Dana Murphy,REP,550152,0,0,184,184,
Oklahoma,Lieutenant Governor,Matt Pinnell,REP,550152,0,0,249,249,
Oklahoma,State Auditor,Cindy Byrd,REP,550152,0,0,234,234,
Oklahoma,State Auditor,Charlie Prater,REP,550152,0,0,190,190,
Oklahoma,Attorney General,Mike Hunter,REP,550152,0,0,277,277,
Oklahoma,Attorney General,Gentner Drummond,REP,550152,0,0,158,158,
Oklahoma,Superintendent of Public Instruction,Joy Hofmeister,REP,550152,0,0,250,250,
Oklahoma,Superintendent of Public Instruction,Linda Murphy,REP,550152,0,0,187,187,
Oklahoma,Commissioner of Labor,Cathy Costello,REP,550152,0,0,224,224,
Oklahoma,Commissioner of Labor,Leslie Osborn,REP,550152,0,0,206,206,
Oklahoma,Corporation Commissioner,Bob Anthony,REP,550152,0,0,270,270,
Oklahoma,Corporation Commissioner,Brian Bingman,REP,550152,0,0,164,164,
Oklahoma,State House,Julie Roach,REP,550152,0,0,227,227,10
Oklahoma,State House,Marilyn Stark,REP,550152,0,0,195,195,10
Oklahoma,Governor,Chris Powell,LIB,550152,0,0,0,0,
Oklahoma,Governor,Rex Lawhorn,LIB,550152,0,0,0,0,
Oklahoma,Corporation Commissioner,Ashley Nicole Mccray,DEM,550152,0,0,97,97,
Oklahoma,Corporation Commissioner,Blake Cummings,DEM,550152,0,0,21,21,
Oklahoma,U.S. House,Kendra Horn,DEM,550152,0,0,94,94,05
Oklahoma,U.S. House,Tom Guild,DEM,550152,0,0,25,25,05
Oklahoma,Governor,Mick Cornett,REP,550153,0,0,295,295,
Oklahoma,Governor,Kevin Stitt,REP,550153,0,0,218,218,
Oklahoma,Lieutenant Governor,Dana Murphy,REP,550153,0,0,229,229,
Oklahoma,Lieutenant Governor,Matt Pinnell,REP,550153,0,0,268,268,
Oklahoma,State Auditor,Cindy Byrd,REP,550153,0,0,251,251,
Oklahoma,State Auditor,Charlie Prater,REP,550153,0,0,233,233,
Oklahoma,Attorney General,Mike Hunter,REP,550153,0,0,318,318,
Oklahoma,Attorney General,Gentner Drummond,REP,550153,0,0,177,177,
Oklahoma,Superintendent of Public Instruction,Joy Hofmeister,REP,550153,0,0,309,309,
Oklahoma,Superintendent of Public Instruction,Linda Murphy,REP,550153,0,0,189,189,
Oklahoma,Commissioner of Labor,Cathy Costello,REP,550153,0,0,242,242,
Oklahoma,Commissioner of Labor,Leslie Osborn,REP,550153,0,0,242,242,
Oklahoma,Corporation Commissioner,Bob Anthony,REP,550153,0,0,287,287,
Oklahoma,Corporation Commissioner,Brian Bingman,REP,550153,0,0,215,215,
Oklahoma,State House,Julie Roach,REP,550153,0,0,247,247,10
Oklahoma,State House,Marilyn Stark,REP,550153,0,0,234,234,10
Oklahoma,Governor,Chris Powell,LIB,550153,0,0,3,3,
Oklahoma,Governor,Rex Lawhorn,LIB,550153,0,0,0,0,
Oklahoma,Corporation Commissioner,Ashley Nicole Mccray,DEM,550153,0,0,116,116,
Oklahoma,Corporation Commissioner,Blake Cummings,DEM,550153,0,0,35,35,
Oklahoma,U.S. House,Kendra Horn,DEM,550153,0,0,125,125,05
Oklahoma,U.S. House,Tom Guild,DEM,550153,0,0,27,27,05
Oklahoma,Governor,Mick Cornett,REP,550154,0,0,320,320,
Oklahoma,Governor,Kevin Stitt,REP,550154,0,0,217,217,
Oklahoma,Lieutenant Governor,Dana Murphy,REP,550154,0,0,238,238,
Oklahoma,Lieutenant Governor,Matt Pinnell,REP,550154,0,0,282,282,
Oklahoma,State Auditor,Cindy Byrd,REP,550154,0,0,259,259,
Oklahoma,State Auditor,Charlie Prater,REP,550154,0,0,248,248,
Oklahoma,Attorney General,Mike Hunter,REP,550154,0,0,322,322,
Oklahoma,Attorney General,Gentner Drummond,REP,550154,0,0,200,200,
Oklahoma,Superintendent of Public Instruction,Joy Hofmeister,REP,550154,0,0,317,317,
Oklahoma,Superintendent of Public Instruction,Linda Murphy,REP,550154,0,0,199,199,
Oklahoma,Commissioner of Labor,Cathy Costello,REP,550154,0,0,240,240,
Oklahoma,Commissioner of Labor,Leslie Osborn,REP,550154,0,0,275,275,
Oklahoma,Corporation Commissioner,Bob Anthony,REP,550154,0,0,319,319,
Oklahoma,Corporation Commissioner,Brian Bingman,REP,550154,0,0,199,199,
Oklahoma,Governor,Chris Powell,LIB,550154,0,0,0,0,
Oklahoma,Governor,Rex Lawhorn,LIB,550154,0,0,0,0,
Oklahoma,Corporation Commissioner,Ashley Nicole Mccray,DEM,550154,0,0,131,131,
Oklahoma,Corporation Commissioner,Blake Cummings,DEM,550154,0,0,47,47,
Oklahoma,U.S. House,Kendra Horn,DEM,550154,0,0,153,153,05
Oklahoma,U.S. House,Tom Guild,DEM,550154,0,0,27,27,05
Oklahoma,Governor,Mick Cornett,REP,550155,0,0,88,88,
Oklahoma,Governor,Kevin Stitt,REP,550155,0,0,53,53,
Oklahoma,Lieutenant Governor,Dana Murphy,REP,550155,0,0,59,59,
Oklahoma,Lieutenant Governor,Matt Pinnell,REP,550155,0,0,76,76,
Oklahoma,State Auditor,Cindy Byrd,REP,550155,0,0,74,74,
Oklahoma,State Auditor,Charlie Prater,REP,550155,0,0,59,59,
Oklahoma,Attorney General,Mike Hunter,REP,550155,0,0,93,93,
Oklahoma,Attorney General,Gentner Drummond,REP,550155,0,0,42,42,
Oklahoma,Superintendent of Public Instruction,Joy Hofmeister,REP,550155,0,0,73,73,
Oklahoma,Superintendent of Public Instruction,Linda Murphy,REP,550155,0,0,63,63,
Oklahoma,Commissioner of Labor,Cathy Costello,REP,550155,0,0,60,60,
Oklahoma,Commissioner of Labor,Leslie Osborn,REP,550155,0,0,73,73,
Oklahoma,Corporation Commissioner,Bob Anthony,REP,550155,0,0,92,92,
Oklahoma,Corporation Commissioner,Brian Bingman,REP,550155,0,0,44,44,
Oklahoma,State Senate,Lori Callahan,REP,550155,0,0,47,47,30
Oklahoma,State Senate,John Symcox,REP,550155,0,0,89,89,30
Oklahoma,Governor,Chris Powell,LIB,550155,0,0,0,0,
Oklahoma,Governor,Rex Lawhorn,LIB,550155,0,0,1,1,
Oklahoma,Corporation Commissioner,Ashley Nicole Mccray,DEM,550155,0,0,28,28,
Oklahoma,Corporation Commissioner,Blake Cummings,DEM,550155,0,0,14,14,
Oklahoma,U.S. House,Kendra Horn,DEM,550155,0,0,28,28,05
Oklahoma,U.S. House,Tom Guild,DEM,550155,0,0,16,16,05
Oklahoma,Governor,Mick Cornett,REP,550156,0,0,221,221,
Oklahoma,Governor,Kevin Stitt,REP,550156,0,0,135,135,
Oklahoma,Lieutenant Governor,Dana Murphy,REP,550156,0,0,154,154,
Oklahoma,Lieutenant Governor,Matt Pinnell,REP,550156,0,0,189,189,
Oklahoma,State Auditor,Cindy Byrd,REP,550156,0,0,183,183,
Oklahoma,State Auditor,Charlie Prater,REP,550156,0,0,143,143,
Oklahoma,Attorney General,Mike Hunter,REP,550156,0,0,185,185,
Oklahoma,Attorney General,Gentner Drummond,REP,550156,0,0,151,151,
Oklahoma,Superintendent of Public Instruction,Joy Hofmeister,REP,550156,0,0,193,193,
Oklahoma,Superintendent of Public Instruction,Linda Murphy,REP,550156,0,0,146,146,
Oklahoma,Commissioner of Labor,Cathy Costello,REP,550156,0,0,153,153,
Oklahoma,Commissioner of Labor,Leslie Osborn,REP,550156,0,0,183,183,
Oklahoma,Corporation Commissioner,Bob Anthony,REP,550156,0,0,211,211,
Oklahoma,Corporation Commissioner,Brian Bingman,REP,550156,0,0,130,130,
Oklahoma,State Senate,Lori Callahan,REP,550156,0,0,140,140,30
Oklahoma,State Senate,John Symcox,REP,550156,0,0,202,202,30
Oklahoma,Governor,Chris Powell,LIB,550156,0,0,0,0,
Oklahoma,Governor,Rex Lawhorn,LIB,550156,0,0,1,1,
Oklahoma,Corporation Commissioner,Ashley Nicole Mccray,DEM,550156,0,0,134,134,
Oklahoma,Corporation Commissioner,Blake Cummings,DEM,550156,0,0,32,32,
Oklahoma,U.S. House,Kendra Horn,DEM,550156,0,0,134,134,05
Oklahoma,U.S. House,Tom Guild,DEM,550156,0,0,31,31,05
Oklahoma,Governor,Mick Cornett,REP,550157,0,0,0,0,
Oklahoma,Governor,Kevin Stitt,REP,550157,0,0,1,1,
Oklahoma,Lieutenant Governor,Dana Murphy,REP,550157,0,0,0,0,
Oklahoma,Lieutenant Governor,Matt Pinnell,REP,550157,0,0,1,1,
Oklahoma,State Auditor,Cindy Byrd,REP,550157,0,0,1,1,
Oklahoma,State Auditor,Charlie Prater,REP,550157,0,0,0,0,
Oklahoma,Attorney General,Mike Hunter,REP,550157,0,0,0,0,
Oklahoma,Attorney General,Gentner Drummond,REP,550157,0,0,1,1,
Oklahoma,Superintendent of Public Instruction,Joy Hofmeister,REP,550157,0,0,1,1,
Oklahoma,Superintendent of Public Instruction,Linda Murphy,REP,550157,0,0,0,0,
Oklahoma,Commissioner of Labor,Cathy Costello,REP,550157,0,0,1,1,
Oklahoma,Commissioner of Labor,Leslie Osborn,REP,550157,0,0,0,0,
Oklahoma,Corporation Commissioner,Bob Anthony,REP,550157,0,0,1,1,
Oklahoma,Corporation Commissioner,Brian Bingman,REP,550157,0,0,0,0,
Oklahoma,State Senate,Lori Callahan,REP,550157,0,0,0,0,30
Oklahoma,State Senate,John Symcox,REP,550157,0,0,1,1,30
Oklahoma,State House,Julie Roach,REP,550157,0,0,0,0,10
Oklahoma,State House,Marilyn Stark,REP,550157,0,0,1,1,10
Oklahoma,Governor,Chris Powell,LIB,550157,0,0,0,0,
Oklahoma,Governor,Rex Lawhorn,LIB,550157,0,0,0,0,
Oklahoma,Corporation Commissioner,Ashley Nicole Mccray,DEM,550157,0,0,4,4,
Oklahoma,Corporation Commissioner,Blake Cummings,DEM,550157,0,0,0,0,
Oklahoma,U.S. House,Kendra Horn,DEM,550157,0,0,3,3,05
Oklahoma,U.S. House,Tom Guild,DEM,550157,0,0,1,1,05
Oklahoma,Governor,Mick Cornett,REP,550158,0,0,141,141,
Oklahoma,Governor,Kevin Stitt,REP,550158,0,0,122,122,
Oklahoma,Lieutenant Governor,Dana Murphy,REP,550158,0,0,123,123,
Oklahoma,Lieutenant Governor,Matt Pinnell,REP,550158,0,0,136,136,
Oklahoma,State Auditor,Cindy Byrd,REP,550158,0,0,129,129,
Oklahoma,State Auditor,Charlie Prater,REP,550158,0,0,122,122,
Oklahoma,Attorney General,Mike Hunter,REP,550158,0,0,156,156,
Oklahoma,Attorney General,Gentner Drummond,REP,550158,0,0,102,102,
Oklahoma,Superintendent of Public Instruction,Joy Hofmeister,REP,550158,0,0,135,135,
Oklahoma,Superintendent of Public Instruction,Linda Murphy,REP,550158,0,0,116,116,
Oklahoma,Commissioner of Labor,Cathy Costello,REP,550158,0,0,124,124,
Oklahoma,Commissioner of Labor,Leslie Osborn,REP,550158,0,0,128,128,
Oklahoma,Corporation Commissioner,Bob Anthony,REP,550158,0,0,140,140,
Oklahoma,Corporation Commissioner,Brian Bingman,REP,550158,0,0,115,115,
Oklahoma,State House,Julie Roach,REP,550158,0,0,128,128,10
Oklahoma,State House,Marilyn Stark,REP,550158,0,0,125,125,10
Oklahoma,Governor,Chris Powell,LIB,550158,0,0,1,1,
Oklahoma,Governor,Rex Lawhorn,LIB,550158,0,0,0,0,
Oklahoma,Corporation Commissioner,Ashley Nicole Mccray,DEM,550158,0,0,60,60,
Oklahoma,Corporation Commissioner,Blake Cummings,DEM,550158,0,0,24,24,
Oklahoma,U.S. House,Kendra Horn,DEM,550158,0,0,60,60,05
Oklahoma,U.S. House,Tom Guild,DEM,550158,0,0,24,24,05
Oklahoma,Governor,Mick Cornett,REP,550159,0,0,187,187,
Oklahoma,Governor,Kevin Stitt,REP,550159,0,0,126,126,
Oklahoma,Lieutenant Governor,Dana Murphy,REP,550159,0,0,125,125,
Oklahoma,Lieutenant Governor,Matt Pinnell,REP,550159,0,0,175,175,
Oklahoma,State Auditor,Cindy Byrd,REP,550159,0,0,163,163,
Oklahoma,State Auditor,Charlie Prater,REP,550159,0,0,132,132,
Oklahoma,Attorney General,Mike Hunter,REP,550159,0,0,176,176,
Oklahoma,Attorney General,Gentner Drummond,REP,550159,0,0,134,134,
Oklahoma,Superintendent of Public Instruction,Joy Hofmeister,REP,550159,0,0,175,175,
Oklahoma,Superintendent of Public Instruction,Linda Murphy,REP,550159,0,0,128,128,
Oklahoma,Commissioner of Labor,Cathy Costello,REP,550159,0,0,155,155,
Oklahoma,Commissioner of Labor,Leslie Osborn,REP,550159,0,0,152,152,
Oklahoma,Corporation Commissioner,Bob Anthony,REP,550159,0,0,171,171,
Oklahoma,Corporation Commissioner,Brian Bingman,REP,550159,0,0,127,127,
Oklahoma,State House,Julie Roach,REP,550159,0,0,152,152,10
Oklahoma,State House,Marilyn Stark,REP,550159,0,0,143,143,10
Oklahoma,Governor,Chris Powell,LIB,550159,0,0,1,1,
Oklahoma,Governor,Rex Lawhorn,LIB,550159,0,0,1,1,
Oklahoma,Corporation Commissioner,Ashley Nicole Mccray,DEM,550159,0,0,74,74,
Oklahoma,Corporation Commissioner,Blake Cummings,DEM,550159,0,0,34,34,
Oklahoma,U.S. House,Kendra Horn,DEM,550159,0,0,83,83,05
Oklahoma,U.S. House,Tom Guild,DEM,550159,0,0,25,25,05
Oklahoma,Governor,Mick Cornett,REP,550160,0,0,298,298,
Oklahoma,Governor,Kevin Stitt,REP,550160,0,0,215,215,
Oklahoma,Lieutenant Governor,Dana Murphy,REP,550160,0,0,234,234,
Oklahoma,Lieutenant Governor,Matt Pinnell,REP,550160,0,0,268,268,
Oklahoma,State Auditor,Cindy Byrd,REP,550160,0,0,250,250,
Oklahoma,State Auditor,Charlie Prater,REP,550160,0,0,227,227,
Oklahoma,Attorney General,Mike Hunter,REP,550160,0,0,326,326,
Oklahoma,Attorney General,Gentner Drummond,REP,550160,0,0,174,174,
Oklahoma,Superintendent of Public Instruction,Joy Hofmeister,REP,550160,0,0,335,335,
Oklahoma,Superintendent of Public Instruction,Linda Murphy,REP,550160,0,0,166,166,
Oklahoma,Commissioner of Labor,Cathy Costello,REP,550160,0,0,243,243,
Oklahoma,Commissioner of Labor,Leslie Osborn,REP,550160,0,0,250,250,
Oklahoma,Corporation Commissioner,Bob Anthony,REP,550160,0,0,320,320,
Oklahoma,Corporation Commissioner,Brian Bingman,REP,550160,0,0,174,174,
Oklahoma,State House,Julie Roach,REP,550160,0,0,215,215,10
Oklahoma,State House,Marilyn Stark,REP,550160,0,0,267,267,10
Oklahoma,Governor,Chris Powell,LIB,550160,0,0,1,1,
Oklahoma,Governor,Rex Lawhorn,LIB,550160,0,0,1,1,
Oklahoma,Corporation Commissioner,Ashley Nicole Mccray,DEM,550160,0,0,62,62,
Oklahoma,Corporation Commissioner,Blake Cummings,DEM,550160,0,0,18,18,
Oklahoma,U.S. House,Kendra Horn,DEM,550160,0,0,58,58,05
Oklahoma,U.S. House,Tom Guild,DEM,550160,0,0,22,22,05
Oklahoma,Governor,Mick Cornett,REP,550161,0,0,90,90,
Oklahoma,Governor,Kevin Stitt,REP,550161,0,0,44,44,
Oklahoma,Lieutenant Governor,Dana Murphy,REP,550161,0,0,62,62,
Oklahoma,Lieutenant Governor,Matt Pinnell,REP,550161,0,0,70,70,
Oklahoma,State Auditor,Cindy Byrd,REP,550161,0,0,71,71,
Oklahoma,State Auditor,Charlie Prater,REP,550161,0,0,59,59,
Oklahoma,Attorney General,Mike Hunter,REP,550161,0,0,76,76,
Oklahoma,Attorney General,Gentner Drummond,REP,550161,0,0,57,57,
Oklahoma,Superintendent of Public Instruction,Joy Hofmeister,REP,550161,0,0,84,84,
Oklahoma,Superintendent of Public Instruction,Linda Murphy,REP,550161,0,0,49,49,
Oklahoma,Commissioner of Labor,Cathy Costello,REP,550161,0,0,59,59,
Oklahoma,Commissioner of Labor,Leslie Osborn,REP,550161,0,0,72,72,
Oklahoma,Corporation Commissioner,Bob Anthony,REP,550161,0,0,83,83,
Oklahoma,Corporation Commissioner,Brian Bingman,REP,550161,0,0,51,51,
Oklahoma,State Senate,Lori Callahan,REP,550161,0,0,61,61,30
Oklahoma,State Senate,John Symcox,REP,550161,0,0,72,72,30
Oklahoma,State House,Julie Roach,REP,550161,0,0,43,43,10
Oklahoma,State House,Marilyn Stark,REP,550161,0,0,84,84,10
Oklahoma,Governor,Chris Powell,LIB,550161,0,0,2,2,
Oklahoma,Governor,Rex Lawhorn,LIB,550161,0,0,1,1,
Oklahoma,Corporation Commissioner,Ashley Nicole Mccray,DEM,550161,0,0,60,60,
Oklahoma,Corporation Commissioner,Blake Cummings,DEM,550161,0,0,14,14,
Oklahoma,U.S. House,Kendra Horn,DEM,550161,0,0,56,56,05
Oklahoma,U.S. House,Tom Guild,DEM,550161,0,0,19,19,05
Oklahoma,Governor,Mick Cornett,REP,550162,0,0,117,117,
Oklahoma,Governor,Kevin Stitt,REP,550162,0,0,122,122,
Oklahoma,Lieutenant Governor,Dana Murphy,REP,550162,0,0,118,118,
Oklahoma,Lieutenant Governor,Matt Pinnell,REP,550162,0,0,117,117,
Oklahoma,State Auditor,Cindy Byrd,REP,550162,0,0,113,113,
Oklahoma,State Auditor,Charlie Prater,REP,550162,0,0,115,115,
Oklahoma,Attorney General,Mike Hunter,REP,550162,0,0,139,139,
Oklahoma,Attorney General,Gentner Drummond,REP,550162,0,0,94,94,
Oklahoma,Superintendent of Public Instruction,Joy Hofmeister,REP,550162,0,0,127,127,
Oklahoma,Superintendent of Public Instruction,Linda Murphy,REP,550162,0,0,107,107,
Oklahoma,Commissioner of Labor,Cathy Costello,REP,550162,0,0,107,107,
Oklahoma,Commissioner of Labor,Leslie Osborn,REP,550162,0,0,121,121,
Oklahoma,Corporation Commissioner,Bob Anthony,REP,550162,0,0,141,141,
Oklahoma,Corporation Commissioner,Brian Bingman,REP,550162,0,0,91,91,
Oklahoma,State Senate,Lori Callahan,REP,550162,0,0,105,105,30
Oklahoma,State Senate,John Symcox,REP,550162,0,0,127,127,30
Oklahoma,Governor,Chris Powell,LIB,550162,0,0,0,0,
Oklahoma,Governor,Rex Lawhorn,LIB,550162,0,0,0,0,
Oklahoma,Corporation Commissioner,Ashley Nicole Mccray,DEM,550162,0,0,54,54,
Oklahoma,Corporation Commissioner,Blake Cummings,DEM,550162,0,0,14,14,
Oklahoma,U.S. House,Kendra Horn,DEM,550162,0,0,48,48,05
Oklahoma,U.S. House,Tom Guild,DEM,550162,0,0,22,22,05
Oklahoma,Governor,Mick Cornett,REP,550163,0,0,67,67,
Oklahoma,Governor,Kevin Stitt,REP,550163,0,0,103,103,
Oklahoma,Lieutenant Governor,Dana Murphy,REP,550163,0,0,70,70,
Oklahoma,Lieutenant Governor,Matt Pinnell,REP,550163,0,0,95,95,
Oklahoma,State Auditor,Cindy Byrd,REP,550163,0,0,69,69,
Oklahoma,State Auditor,Charlie Prater,REP,550163,0,0,92,92,
Oklahoma,Attorney General,Mike Hunter,REP,550163,0,0,84,84,
Oklahoma,Attorney General,Gentner Drummond,REP,550163,0,0,78,78,
Oklahoma,Superintendent of Public Instruction,Joy Hofmeister,REP,550163,0,0,80,80,
Oklahoma,Superintendent of Public Instruction,Linda Murphy,REP,550163,0,0,86,86,
Oklahoma,Commissioner of Labor,Cathy Costello,REP,550163,0,0,75,75,
Oklahoma,Commissioner of Labor,Leslie Osborn,REP,550163,0,0,86,86,
Oklahoma,Corporation Commissioner,Bob Anthony,REP,550163,0,0,93,93,
Oklahoma,Corporation Commissioner,Brian Bingman,REP,550163,0,0,70,70,
Oklahoma,State Senate,Lori Callahan,REP,550163,0,0,76,76,30
Oklahoma,State Senate,John Symcox,REP,550163,0,0,84,84,30
Oklahoma,Governor,Chris Powell,LIB,550163,0,0,1,1,
Oklahoma,Governor,Rex Lawhorn,LIB,550163,0,0,0,0,
Oklahoma,Corporation Commissioner,Ashley Nicole Mccray,DEM,550163,0,0,64,64,
Oklahoma,Corporation Commissioner,Blake Cummings,DEM,550163,0,0,22,22,
Oklahoma,U.S. House,Kendra Horn,DEM,550163,0,0,57,57,05
Oklahoma,U.S. House,Tom Guild,DEM,550163,0,0,29,29,05
Oklahoma,Governor,Mick Cornett,REP,550164,0,0,78,78,
Oklahoma,Governor,Kevin Stitt,REP,550164,0,0,56,56,
Oklahoma,Lieutenant Governor,Dana Murphy,REP,550164,0,0,48,48,
Oklahoma,Lieutenant Governor,Matt Pinnell,REP,550164,0,0,82,82,
Oklahoma,State Auditor,Cindy Byrd,REP,550164,0,0,59,59,
Oklahoma,State Auditor,Charlie Prater,REP,550164,0,0,67,67,
Oklahoma,Attorney General,Mike Hunter,REP,550164,0,0,80,80,
Oklahoma,Attorney General,Gentner Drummond,REP,550164,0,0,51,51,
Oklahoma,Superintendent of Public Instruction,Joy Hofmeister,REP,550164,0,0,71,71,
Oklahoma,Superintendent of Public Instruction,Linda Murphy,REP,550164,0,0,60,60,
Oklahoma,Commissioner of Labor,Cathy Costello,REP,550164,0,0,51,51,
Oklahoma,Commissioner of Labor,Leslie Osborn,REP,550164,0,0,77,77,
Oklahoma,Corporation Commissioner,Bob Anthony,REP,550164,0,0,68,68,
Oklahoma,Corporation Commissioner,Brian Bingman,REP,550164,0,0,61,61,
Oklahoma,Governor,Chris Powell,LIB,550164,0,0,0,0,
Oklahoma,Governor,Rex Lawhorn,LIB,550164,0,0,0,0,
Oklahoma,Corporation Commissioner,Ashley Nicole Mccray,DEM,550164,0,0,21,21,
Oklahoma,Corporation Commissioner,Blake Cummings,DEM,550164,0,0,4,4,
Oklahoma,U.S. House,Kendra Horn,DEM,550164,0,0,17,17,05
Oklahoma,U.S. House,Tom Guild,DEM,550164,0,0,8,8,05
Oklahoma,Governor,Mick Cornett,REP,550165,0,0,136,136,
Oklahoma,Governor,Kevin Stitt,REP,550165,0,0,181,181,
Oklahoma,Lieutenant Governor,Dana Murphy,REP,550165,0,0,127,127,
Oklahoma,Lieutenant Governor,Matt Pinnell,REP,550165,0,0,186,186,
Oklahoma,State Auditor,Cindy Byrd,REP,550165,0,0,155,155,
Oklahoma,State Auditor,Charlie Prater,REP,550165,0,0,154,154,
Oklahoma,Attorney General,Mike Hunter,REP,550165,0,0,172,172,
Oklahoma,Attorney General,Gentner Drummond,REP,550165,0,0,139,139,
Oklahoma,Superintendent of Public Instruction,Joy Hofmeister,REP,550165,0,0,170,170,
Oklahoma,Superintendent of Public Instruction,Linda Murphy,REP,550165,0,0,144,144,
Oklahoma,Commissioner of Labor,Cathy Costello,REP,550165,0,0,115,115,
Oklahoma,Commissioner of Labor,Leslie Osborn,REP,550165,0,0,195,195,
Oklahoma,Corporation Commissioner,Bob Anthony,REP,550165,0,0,162,162,
Oklahoma,Corporation Commissioner,Brian Bingman,REP,550165,0,0,147,147,
Oklahoma,Governor,Chris Powell,LIB,550165,0,0,0,0,
Oklahoma,Governor,Rex Lawhorn,LIB,550165,0,0,1,1,
Oklahoma,Corporation Commissioner,Ashley Nicole Mccray,DEM,550165,0,0,27,27,
Oklahoma,Corporation Commissioner,Blake Cummings,DEM,550165,0,0,24,24,
Oklahoma,U.S. House,Kendra Horn,DEM,550165,0,0,33,33,05
Oklahoma,U.S. House,Tom Guild,DEM,550165,0,0,19,19,05
Oklahoma,Governor,Mick Cornett,REP,550166,0,0,35,35,
Oklahoma,Governor,Kevin Stitt,REP,550166,0,0,23,23,
Oklahoma,Lieutenant Governor,Dana Murphy,REP,550166,0,0,24,24,
Oklahoma,Lieutenant Governor,Matt Pinnell,REP,550166,0,0,34,34,
Oklahoma,State Auditor,Cindy Byrd,REP,550166,0,0,27,27,
Oklahoma,State Auditor,Charlie Prater,REP,550166,0,0,29,29,
Oklahoma,Attorney General,Mike Hunter,REP,550166,0,0,34,34,
Oklahoma,Attorney General,Gentner Drummond,REP,550166,0,0,23,23,
Oklahoma,Superintendent of Public Instruction,Joy Hofmeister,REP,550166,0,0,30,30,
Oklahoma,Superintendent of Public Instruction,Linda Murphy,REP,550166,0,0,26,26,
Oklahoma,Commissioner of Labor,Cathy Costello,REP,550166,0,0,23,23,
Oklahoma,Commissioner of Labor,Leslie Osborn,REP,550166,0,0,34,34,
Oklahoma,Corporation Commissioner,Bob Anthony,REP,550166,0,0,33,33,
Oklahoma,Corporation Commissioner,Brian Bingman,REP,550166,0,0,25,25,
Oklahoma,Governor,Chris Powell,LIB,550166,0,0,0,0,
Oklahoma,Governor,Rex Lawhorn,LIB,550166,0,0,0,0,
Oklahoma,Corporation Commissioner,Ashley Nicole Mccray,DEM,550166,0,0,10,10,
Oklahoma,Corporation Commissioner,Blake Cummings,DEM,550166,0,0,8,8,
Oklahoma,U.S. House,Kendra Horn,DEM,550166,0,0,10,10,05
Oklahoma,U.S. House,Tom Guild,DEM,550166,0,0,7,7,05
Oklahoma,Governor,Mick Cornett,REP,550167,0,0,28,28,
Oklahoma,Governor,Kevin Stitt,REP,550167,0,0,28,28,
Oklahoma,Lieutenant Governor,Dana Murphy,REP,550167,0,0,22,22,
Oklahoma,Lieutenant Governor,Matt Pinnell,REP,550167,0,0,34,34,
Oklahoma,State Auditor,Cindy Byrd,REP,550167,0,0,16,16,
Oklahoma,State Auditor,Charlie Prater,REP,550167,0,0,36,36,
Oklahoma,Attorney General,Mike Hunter,REP,550167,0,0,27,27,
Oklahoma,Attorney General,Gentner Drummond,REP,550167,0,0,28,28,
Oklahoma,Superintendent of Public Instruction,Joy Hofmeister,REP,550167,0,0,32,32,
Oklahoma,Superintendent of Public Instruction,Linda Murphy,REP,550167,0,0,21,21,
Oklahoma,Commissioner of Labor,Cathy Costello,REP,550167,0,0,27,27,
Oklahoma,Commissioner of Labor,Leslie Osborn,REP,550167,0,0,26,26,
Oklahoma,Corporation Commissioner,Bob Anthony,REP,550167,0,0,33,33,
Oklahoma,Corporation Commissioner,Brian Bingman,REP,550167,0,0,23,23,
Oklahoma,Governor,Chris Powell,LIB,550167,0,0,0,0,
Oklahoma,Governor,Rex Lawhorn,LIB,550167,0,0,1,1,
Oklahoma,Corporation Commissioner,Ashley Nicole Mccray,DEM,550167,0,0,12,12,
Oklahoma,Corporation Commissioner,Blake Cummings,DEM,550167,0,0,11,11,
Oklahoma,U.S. House,Kendra Horn,DEM,550167,0,0,11,11,05
Oklahoma,U.S. House,Tom Guild,DEM,550167,0,0,12,12,05
Oklahoma,Governor,Mick Cornett,REP,550168,0,0,15,15,
Oklahoma,Governor,Kevin Stitt,REP,550168,0,0,24,24,
Oklahoma,Lieutenant Governor,Dana Murphy,REP,550168,0,0,12,12,
Oklahoma,Lieutenant Governor,Matt Pinnell,REP,550168,0,0,27,27,
Oklahoma,State Auditor,Cindy Byrd,REP,550168,0,0,19,19,
Oklahoma,State Auditor,Charlie Prater,REP,550168,0,0,20,20,
Oklahoma,Attorney General,Mike Hunter,REP,550168,0,0,11,11,
Oklahoma,Attorney General,Gentner Drummond,REP,550168,0,0,27,27,
Oklahoma,Superintendent of Public Instruction,Joy Hofmeister,REP,550168,0,0,21,21,
Oklahoma,Superintendent of Public Instruction,Linda Murphy,REP,550168,0,0,17,17,
Oklahoma,Commissioner of Labor,Cathy Costello,REP,550168,0,0,16,16,
Oklahoma,Commissioner of Labor,Leslie Osborn,REP,550168,0,0,23,23,
Oklahoma,Corporation Commissioner,Bob Anthony,REP,550168,0,0,25,25,
Oklahoma,Corporation Commissioner,Brian Bingman,REP,550168,0,0,14,14,
Oklahoma,State Senate,Lori Callahan,REP,550168,0,0,12,12,30
Oklahoma,State Senate,John Symcox,REP,550168,0,0,27,27,30
Oklahoma,Governor,Chris Powell,LIB,550168,0,0,0,0,
Oklahoma,Governor,Rex Lawhorn,LIB,550168,0,0,0,0,
Oklahoma,Corporation Commissioner,Ashley Nicole Mccray,DEM,550168,0,0,14,14,
Oklahoma,Corporation Commissioner,Blake Cummings,DEM,550168,0,0,9,9,
Oklahoma,U.S. House,Kendra Horn,DEM,550168,0,0,18,18,05
Oklahoma,U.S. House,Tom Guild,DEM,550168,0,0,5,5,05
Oklahoma,Governor,Mick Cornett,REP,550169,0,0,85,85,
Oklahoma,Governor,Kevin Stitt,REP,550169,0,0,78,78,
Oklahoma,Lieutenant Governor,Dana Murphy,REP,550169,0,0,70,70,
Oklahoma,Lieutenant Governor,Matt Pinnell,REP,550169,0,0,90,90,
Oklahoma,State Auditor,Cindy Byrd,REP,550169,0,0,70,70,
Oklahoma,State Auditor,Charlie Prater,REP,550169,0,0,87,87,
Oklahoma,Attorney General,Mike Hunter,REP,550169,0,0,104,104,
Oklahoma,Attorney General,Gentner Drummond,REP,550169,0,0,55,55,
Oklahoma,Superintendent of Public Instruction,Joy Hofmeister,REP,550169,0,0,88,88,
Oklahoma,Superintendent of Public Instruction,Linda Murphy,REP,550169,0,0,73,73,
Oklahoma,Commissioner of Labor,Cathy Costello,REP,550169,0,0,80,80,
Oklahoma,Commissioner of Labor,Leslie Osborn,REP,550169,0,0,81,81,
Oklahoma,Corporation Commissioner,Bob Anthony,REP,550169,0,0,100,100,
Oklahoma,Corporation Commissioner,Brian Bingman,REP,550169,0,0,58,58,
Oklahoma,State Senate,Lori Callahan,REP,550169,0,0,51,51,30
Oklahoma,State Senate,John Symcox,REP,550169,0,0,111,111,30
Oklahoma,Governor,Chris Powell,LIB,550169,0,0,0,0,
Oklahoma,Governor,Rex Lawhorn,LIB,550169,0,0,0,0,
Oklahoma,Corporation Commissioner,Ashley Nicole Mccray,DEM,550169,0,0,57,57,
Oklahoma,Corporation Commissioner,Blake Cummings,DEM,550169,0,0,8,8,
Oklahoma,U.S. House,Kendra Horn,DEM,550169,0,0,48,48,05
Oklahoma,U.S. House,Tom Guild,DEM,550169,0,0,17,17,05
Oklahoma,Governor,Mick Cornett,REP,550170,0,0,55,55,
Oklahoma,Governor,Kevin Stitt,REP,550170,0,0,61,61,
Oklahoma,Lieutenant Governor,Dana Murphy,REP,550170,0,0,45,45,
Oklahoma,Lieutenant Governor,Matt Pinnell,REP,550170,0,0,71,71,
Oklahoma,State Auditor,Cindy Byrd,REP,550170,0,0,59,59,
Oklahoma,State Auditor,Charlie Prater,REP,550170,0,0,55,55,
Oklahoma,Attorney General,Mike Hunter,REP,550170,0,0,75,75,
Oklahoma,Attorney General,Gentner Drummond,REP,550170,0,0,41,41,
Oklahoma,Superintendent of Public Instruction,Joy Hofmeister,REP,550170,0,0,54,54,
Oklahoma,Superintendent of Public Instruction,Linda Murphy,REP,550170,0,0,61,61,
Oklahoma,Commissioner of Labor,Cathy Costello,REP,550170,0,0,54,54,
Oklahoma,Commissioner of Labor,Leslie Osborn,REP,550170,0,0,62,62,
Oklahoma,Corporation Commissioner,Bob Anthony,REP,550170,0,0,67,67,
Oklahoma,Corporation Commissioner,Brian Bingman,REP,550170,0,0,49,49,
Oklahoma,State Senate,Lori Callahan,REP,550170,0,0,48,48,30
Oklahoma,State Senate,John Symcox,REP,550170,0,0,66,66,30
Oklahoma,Governor,Chris Powell,LIB,550170,0,0,0,0,
Oklahoma,Governor,Rex Lawhorn,LIB,550170,0,0,0,0,
Oklahoma,Corporation Commissioner,Ashley Nicole Mccray,DEM,550170,0,0,48,48,
Oklahoma,Corporation Commissioner,Blake Cummings,DEM,550170,0,0,14,14,
Oklahoma,U.S. House,Kendra Horn,DEM,550170,0,0,42,42,05
Oklahoma,U.S. House,Tom Guild,DEM,550170,0,0,20,20,05
Oklahoma,Governor,Mick Cornett,REP,550171,0,0,78,78,
Oklahoma,Governor,Kevin Stitt,REP,550171,0,0,62,62,
Oklahoma,Lieutenant Governor,Dana Murphy,REP,550171,0,0,62,62,
Oklahoma,Lieutenant Governor,Matt Pinnell,REP,550171,0,0,71,71,
Oklahoma,State Auditor,Cindy Byrd,REP,550171,0,0,67,67,
Oklahoma,State Auditor,Charlie Prater,REP,550171,0,0,60,60,
Oklahoma,Attorney General,Mike Hunter,REP,550171,0,0,77,77,
Oklahoma,Attorney General,Gentner Drummond,REP,550171,0,0,58,58,
Oklahoma,Superintendent of Public Instruction,Joy Hofmeister,REP,550171,0,0,67,67,
Oklahoma,Superintendent of Public Instruction,Linda Murphy,REP,550171,0,0,65,65,
Oklahoma,Commissioner of Labor,Cathy Costello,REP,550171,0,0,60,60,
Oklahoma,Commissioner of Labor,Leslie Osborn,REP,550171,0,0,71,71,
Oklahoma,Corporation Commissioner,Bob Anthony,REP,550171,0,0,75,75,
Oklahoma,Corporation Commissioner,Brian Bingman,REP,550171,0,0,58,58,
Oklahoma,State Senate,Lori Callahan,REP,550171,0,0,58,58,30
Oklahoma,State Senate,John Symcox,REP,550171,0,0,74,74,30
Oklahoma,Governor,Chris Powell,LIB,550171,0,0,0,0,
Oklahoma,Governor,Rex Lawhorn,LIB,550171,0,0,0,0,
Oklahoma,Corporation Commissioner,Ashley Nicole Mccray,DEM,550171,0,0,120,120,
Oklahoma,Corporation Commissioner,Blake Cummings,DEM,550171,0,0,16,16,
Oklahoma,U.S. House,Kendra Horn,DEM,550171,0,0,108,108,05
Oklahoma,U.S. House,Tom Guild,DEM,550171,0,0,30,30,05
Oklahoma,Governor,Mick Cornett,REP,550172,0,0,111,111,
Oklahoma,Governor,Kevin Stitt,REP,550172,0,0,91,91,
Oklahoma,Lieutenant Governor,Dana Murphy,REP,550172,0,0,86,86,
Oklahoma,Lieutenant Governor,Matt Pinnell,REP,550172,0,0,110,110,
Oklahoma,State Auditor,Cindy Byrd,REP,550172,0,0,95,95,
Oklahoma,State Auditor,Charlie Prater,REP,550172,0,0,96,96,
Oklahoma,Attorney General,Mike Hunter,REP,550172,0,0,96,96,
Oklahoma,Attorney General,Gentner Drummond,REP,550172,0,0,98,98,
Oklahoma,Superintendent of Public Instruction,Joy Hofmeister,REP,550172,0,0,98,98,
Oklahoma,Superintendent of Public Instruction,Linda Murphy,REP,550172,0,0,93,93,
Oklahoma,Commissioner of Labor,Cathy Costello,REP,550172,0,0,93,93,
Oklahoma,Commissioner of Labor,Leslie Osborn,REP,550172,0,0,106,106,
Oklahoma,Corporation Commissioner,Bob Anthony,REP,550172,0,0,125,125,
Oklahoma,Corporation Commissioner,Brian Bingman,REP,550172,0,0,68,68,
Oklahoma,Governor,Chris Powell,LIB,550172,0,0,0,0,
Oklahoma,Governor,Rex Lawhorn,LIB,550172,0,0,0,0,
Oklahoma,Corporation Commissioner,Ashley Nicole Mccray,DEM,550172,0,0,87,87,
Oklahoma,Corporation Commissioner,Blake Cummings,DEM,550172,0,0,33,33,
Oklahoma,U.S. House,Kendra Horn,DEM,550172,0,0,88,88,05
Oklahoma,U.S. House,Tom Guild,DEM,550172,0,0,35,35,05
Oklahoma,Governor,Mick Cornett,REP,550173,0,0,176,176,
Oklahoma,Governor,Kevin Stitt,REP,550173,0,0,133,133,
Oklahoma,Lieutenant Governor,Dana Murphy,REP,550173,0,0,133,133,
Oklahoma,Lieutenant Governor,Matt Pinnell,REP,550173,0,0,167,167,
Oklahoma,State Auditor,Cindy Byrd,REP,550173,0,0,146,146,
Oklahoma,State Auditor,Charlie Prater,REP,550173,0,0,151,151,
Oklahoma,Attorney General,Mike Hunter,REP,550173,0,0,186,186,
Oklahoma,Attorney General,Gentner Drummond,REP,550173,0,0,113,113,
Oklahoma,Superintendent of Public Instruction,Joy Hofmeister,REP,550173,0,0,174,174,
Oklahoma,Superintendent of Public Instruction,Linda Murphy,REP,550173,0,0,127,127,
Oklahoma,Commissioner of Labor,Cathy Costello,REP,550173,0,0,162,162,
Oklahoma,Commissioner of Labor,Leslie Osborn,REP,550173,0,0,134,134,
Oklahoma,Corporation Commissioner,Bob Anthony,REP,550173,0,0,193,193,
Oklahoma,Corporation Commissioner,Brian Bingman,REP,550173,0,0,110,110,
Oklahoma,Governor,Chris Powell,LIB,550173,0,0,1,1,
Oklahoma,Governor,Rex Lawhorn,LIB,550173,0,0,0,0,
Oklahoma,Corporation Commissioner,Ashley Nicole Mccray,DEM,550173,0,0,98,98,
Oklahoma,Corporation Commissioner,Blake Cummings,DEM,550173,0,0,33,33,
Oklahoma,U.S. House,Kendra Horn,DEM,550173,0,0,97,97,05
Oklahoma,U.S. House,Tom Guild,DEM,550173,0,0,35,35,05
Oklahoma,Governor,Mick Cornett,REP,550174,0,0,100,100,
Oklahoma,Governor,Kevin Stitt,REP,550174,0,0,60,60,
Oklahoma,Lieutenant Governor,Dana Murphy,REP,550174,0,0,79,79,
Oklahoma,Lieutenant Governor,Matt Pinnell,REP,550174,0,0,78,78,
Oklahoma,State Auditor,Cindy Byrd,REP,550174,0,0,69,69,
Oklahoma,State Auditor,Charlie Prater,REP,550174,0,0,86,86,
Oklahoma,Attorney General,Mike Hunter,REP,550174,0,0,103,103,
Oklahoma,Attorney General,Gentner Drummond,REP,550174,0,0,56,56,
Oklahoma,Superintendent of Public Instruction,Joy Hofmeister,REP,550174,0,0,88,88,
Oklahoma,Superintendent of Public Instruction,Linda Murphy,REP,550174,0,0,66,66,
Oklahoma,Commissioner of Labor,Cathy Costello,REP,550174,0,0,75,75,
Oklahoma,Commissioner of Labor,Leslie Osborn,REP,550174,0,0,79,79,
Oklahoma,Corporation Commissioner,Bob Anthony,REP,550174,0,0,108,108,
Oklahoma,Corporation Commissioner,Brian Bingman,REP,550174,0,0,49,49,
Oklahoma,Governor,Chris Powell,LIB,550174,0,0,0,0,
Oklahoma,Governor,Rex Lawhorn,LIB,550174,0,0,0,0,
Oklahoma,Corporation Commissioner,Ashley Nicole Mccray,DEM,550174,0,0,54,54,
Oklahoma,Corporation Commissioner,Blake Cummings,DEM,550174,0,0,15,15,
Oklahoma,U.S. House,Kendra Horn,DEM,550174,0,0,58,58,05
Oklahoma,U.S. House,Tom Guild,DEM,550174,0,0,12,12,05
Oklahoma,Governor,Mick Cornett,REP,550175,0,0,46,46,
Oklahoma,Governor,Kevin Stitt,REP,550175,0,0,34,34,
Oklahoma,Lieutenant Governor,Dana Murphy,REP,550175,0,0,35,35,
Oklahoma,Lieutenant Governor,Matt Pinnell,REP,550175,0,0,42,42,
Oklahoma,State Auditor,Cindy Byrd,REP,550175,0,0,33,33,
Oklahoma,State Auditor,Charlie Prater,REP,550175,0,0,43,43,
Oklahoma,Attorney General,Mike Hunter,REP,550175,0,0,45,45,
Oklahoma,Attorney General,Gentner Drummond,REP,550175,0,0,33,33,
Oklahoma,Superintendent of Public Instruction,Joy Hofmeister,REP,550175,0,0,43,43,
Oklahoma,Superintendent of Public Instruction,Linda Murphy,REP,550175,0,0,34,34,
Oklahoma,Commissioner of Labor,Cathy Costello,REP,550175,0,0,38,38,
Oklahoma,Commissioner of Labor,Leslie Osborn,REP,550175,0,0,39,39,
Oklahoma,Corporation Commissioner,Bob Anthony,REP,550175,0,0,38,38,
Oklahoma,Corporation Commissioner,Brian Bingman,REP,550175,0,0,39,39,
Oklahoma,Governor,Chris Powell,LIB,550175,0,0,0,0,
Oklahoma,Governor,Rex Lawhorn,LIB,550175,0,0,0,0,
Oklahoma,Corporation Commissioner,Ashley Nicole Mccray,DEM,550175,0,0,32,32,
Oklahoma,Corporation Commissioner,Blake Cummings,DEM,550175,0,0,6,6,
Oklahoma,U.S. House,Kendra Horn,DEM,550175,0,0,27,27,05
Oklahoma,U.S. House,Tom Guild,DEM,550175,0,0,11,11,05
Oklahoma,Governor,Mick Cornett,REP,550176,0,0,143,143,
Oklahoma,Governor,Kevin Stitt,REP,550176,0,0,109,109,
Oklahoma,Lieutenant Governor,Dana Murphy,REP,550176,0,0,114,114,
Oklahoma,Lieutenant Governor,Matt Pinnell,REP,550176,0,0,136,136,
Oklahoma,State Auditor,Cindy Byrd,REP,550176,0,0,116,116,
Oklahoma,State Auditor,Charlie Prater,REP,550176,0,0,128,128,
Oklahoma,Attorney General,Mike Hunter,REP,550176,0,0,150,150,
Oklahoma,Attorney General,Gentner Drummond,REP,550176,0,0,103,103,
Oklahoma,Superintendent of Public Instruction,Joy Hofmeister,REP,550176,0,0,147,147,
Oklahoma,Superintendent of Public Instruction,Linda Murphy,REP,550176,0,0,100,100,
Oklahoma,Commissioner of Labor,Cathy Costello,REP,550176,0,0,114,114,
Oklahoma,Commissioner of Labor,Leslie Osborn,REP,550176,0,0,134,134,
Oklahoma,Corporation Commissioner,Bob Anthony,REP,550176,0,0,149,149,
Oklahoma,Corporation Commissioner,Brian Bingman,REP,550176,0,0,102,102,
Oklahoma,Governor,Chris Powell,LIB,550176,0,0,1,1,
Oklahoma,Governor,Rex Lawhorn,LIB,550176,0,0,0,0,
Oklahoma,Corporation Commissioner,Ashley Nicole Mccray,DEM,550176,0,0,87,87,
Oklahoma,Corporation Commissioner,Blake Cummings,DEM,550176,0,0,22,22,
Oklahoma,U.S. House,Kendra Horn,DEM,550176,0,0,90,90,05
Oklahoma,U.S. House,Tom Guild,DEM,550176,0,0,22,22,05
Oklahoma,Governor,Mick Cornett,REP,550177,0,0,144,144,
Oklahoma,Governor,Kevin Stitt,REP,550177,0,0,99,99,
Oklahoma,Lieutenant Governor,Dana Murphy,REP,550177,0,0,109,109,
Oklahoma,Lieutenant Governor,Matt Pinnell,REP,550177,0,0,124,124,
Oklahoma,State Auditor,Cindy Byrd,REP,550177,0,0,116,116,
Oklahoma,State Auditor,Charlie Prater,REP,550177,0,0,105,105,
Oklahoma,Attorney General,Mike Hunter,REP,550177,0,0,147,147,
Oklahoma,Attorney General,Gentner Drummond,REP,550177,0,0,87,87,
Oklahoma,Superintendent of Public Instruction,Joy Hofmeister,REP,550177,0,0,144,144,
Oklahoma,Superintendent of Public Instruction,Linda Murphy,REP,550177,0,0,92,92,
Oklahoma,Commissioner of Labor,Cathy Costello,REP,550177,0,0,113,113,
Oklahoma,Commissioner of Labor,Leslie Osborn,REP,550177,0,0,123,123,
Oklahoma,Corporation Commissioner,Bob Anthony,REP,550177,0,0,126,126,
Oklahoma,Corporation Commissioner,Brian Bingman,REP,550177,0,0,107,107,
Oklahoma,Governor,Chris Powell,LIB,550177,0,0,0,0,
Oklahoma,Governor,Rex Lawhorn,LIB,550177,0,0,0,0,
Oklahoma,Corporation Commissioner,Ashley Nicole Mccray,DEM,550177,0,0,115,115,
Oklahoma,Corporation Commissioner,Blake Cummings,DEM,550177,0,0,23,23,
Oklahoma,U.S. House,Kendra Horn,DEM,550177,0,0,114,114,05
Oklahoma,U.S. House,Tom Guild,DEM,550177,0,0,24,24,05
Oklahoma,Governor,Mick Cornett,REP,550178,0,0,109,109,
Oklahoma,Governor,Kevin Stitt,REP,550178,0,0,79,79,
Oklahoma,Lieutenant Governor,Dana Murphy,REP,550178,0,0,81,81,
Oklahoma,Lieutenant Governor,Matt Pinnell,REP,550178,0,0,98,98,
Oklahoma,State Auditor,Cindy Byrd,REP,550178,0,0,80,80,
Oklahoma,State Auditor,Charlie Prater,REP,550178,0,0,96,96,
Oklahoma,Attorney General,Mike Hunter,REP,550178,0,0,107,107,
Oklahoma,Attorney General,Gentner Drummond,REP,550178,0,0,69,69,
Oklahoma,Superintendent of Public Instruction,Joy Hofmeister,REP,550178,0,0,98,98,
Oklahoma,Superintendent of Public Instruction,Linda Murphy,REP,550178,0,0,84,84,
Oklahoma,Commissioner of Labor,Cathy Costello,REP,550178,0,0,89,89,
Oklahoma,Commissioner of Labor,Leslie Osborn,REP,550178,0,0,86,86,
Oklahoma,Corporation Commissioner,Bob Anthony,REP,550178,0,0,108,108,
Oklahoma,Corporation Commissioner,Brian Bingman,REP,550178,0,0,72,72,
Oklahoma,Governor,Chris Powell,LIB,550178,0,0,0,0,
Oklahoma,Governor,Rex Lawhorn,LIB,550178,0,0,0,0,
Oklahoma,Corporation Commissioner,Ashley Nicole Mccray,DEM,550178,0,0,93,93,
Oklahoma,Corporation Commissioner,Blake Cummings,DEM,550178,0,0,20,20,
Oklahoma,U.S. House,Kendra Horn,DEM,550178,0,0,98,98,05
Oklahoma,U.S. House,Tom Guild,DEM,550178,0,0,17,17,05
Oklahoma,Governor,Mick Cornett,REP,550179,0,0,198,198,
Oklahoma,Governor,Kevin Stitt,REP,550179,0,0,114,114,
Oklahoma,Lieutenant Governor,Dana Murphy,REP,550179,0,0,136,136,
Oklahoma,Lieutenant Governor,Matt Pinnell,REP,550179,0,0,163,163,
Oklahoma,State Auditor,Cindy Byrd,REP,550179,0,0,168,168,
Oklahoma,State Auditor,Charlie Prater,REP,550179,0,0,122,122,
Oklahoma,Attorney General,Mike Hunter,REP,550179,0,0,196,196,
Oklahoma,Attorney General,Gentner Drummond,REP,550179,0,0,102,102,
Oklahoma,Superintendent of Public Instruction,Joy Hofmeister,REP,550179,0,0,183,183,
Oklahoma,Superintendent of Public Instruction,Linda Murphy,REP,550179,0,0,117,117,
Oklahoma,Commissioner of Labor,Cathy Costello,REP,550179,0,0,167,167,
Oklahoma,Commissioner of Labor,Leslie Osborn,REP,550179,0,0,131,131,
Oklahoma,Corporation Commissioner,Bob Anthony,REP,550179,0,0,200,200,
Oklahoma,Corporation Commissioner,Brian Bingman,REP,550179,0,0,101,101,
Oklahoma,Governor,Chris Powell,LIB,550179,0,0,1,1,
Oklahoma,Governor,Rex Lawhorn,LIB,550179,0,0,0,0,
Oklahoma,Corporation Commissioner,Ashley Nicole Mccray,DEM,550179,0,0,123,123,
Oklahoma,Corporation Commissioner,Blake Cummings,DEM,550179,0,0,40,40,
Oklahoma,U.S. House,Kendra Horn,DEM,550179,0,0,146,146,05
Oklahoma,U.S. House,Tom Guild,DEM,550179,0,0,21,21,05
Oklahoma,Governor,Mick Cornett,REP,550180,0,0,109,109,
Oklahoma,Governor,Kevin Stitt,REP,550180,0,0,69,69,
Oklahoma,Lieutenant Governor,Dana Murphy,REP,550180,0,0,63,63,
Oklahoma,Lieutenant Governor,Matt Pinnell,REP,550180,0,0,108,108,
Oklahoma,State Auditor,Cindy Byrd,REP,550180,0,0,94,94,
Oklahoma,State Auditor,Charlie Prater,REP,550180,0,0,70,70,
Oklahoma,Attorney General,Mike Hunter,REP,550180,0,0,100,100,
Oklahoma,Attorney General,Gentner Drummond,REP,550180,0,0,71,71,
Oklahoma,Superintendent of Public Instruction,Joy Hofmeister,REP,550180,0,0,86,86,
Oklahoma,Superintendent of Public Instruction,Linda Murphy,REP,550180,0,0,86,86,
Oklahoma,Commissioner of Labor,Cathy Costello,REP,550180,0,0,81,81,
Oklahoma,Commissioner of Labor,Leslie Osborn,REP,550180,0,0,88,88,
Oklahoma,Corporation Commissioner,Bob Anthony,REP,550180,0,0,96,96,
Oklahoma,Corporation Commissioner,Brian Bingman,REP,550180,0,0,73,73,
Oklahoma,Governor,Chris Powell,LIB,550180,0,0,2,2,
Oklahoma,Governor,Rex Lawhorn,LIB,550180,0,0,0,0,
Oklahoma,Corporation Commissioner,Ashley Nicole Mccray,DEM,550180,0,0,88,88,
Oklahoma,Corporation Commissioner,Blake Cummings,DEM,550180,0,0,19,19,
Oklahoma,U.S. House,Kendra Horn,DEM,550180,0,0,99,99,05
Oklahoma,U.S. House,Tom Guild,DEM,550180,0,0,10,10,05
Oklahoma,Governor,Mick Cornett,REP,550181,0,0,76,76,
Oklahoma,Governor,Kevin Stitt,REP,550181,0,0,47,47,
Oklahoma,Lieutenant Governor,Dana Murphy,REP,550181,0,0,56,56,
Oklahoma,Lieutenant Governor,Matt Pinnell,REP,550181,0,0,64,64,
Oklahoma,State Auditor,Cindy Byrd,REP,550181,0,0,64,64,
Oklahoma,State Auditor,Charlie Prater,REP,550181,0,0,52,52,
Oklahoma,Attorney General,Mike Hunter,REP,550181,0,0,71,71,
Oklahoma,Attorney General,Gentner Drummond,REP,550181,0,0,49,49,
Oklahoma,Superintendent of Public Instruction,Joy Hofmeister,REP,550181,0,0,56,56,
Oklahoma,Superintendent of Public Instruction,Linda Murphy,REP,550181,0,0,59,59,
Oklahoma,Commissioner of Labor,Cathy Costello,REP,550181,0,0,50,50,
Oklahoma,Commissioner of Labor,Leslie Osborn,REP,550181,0,0,65,65,
Oklahoma,Corporation Commissioner,Bob Anthony,REP,550181,0,0,73,73,
Oklahoma,Corporation Commissioner,Brian Bingman,REP,550181,0,0,45,45,
Oklahoma,Governor,Chris Powell,LIB,550181,0,0,2,2,
Oklahoma,Governor,Rex Lawhorn,LIB,550181,0,0,0,0,
Oklahoma,Corporation Commissioner,Ashley Nicole Mccray,DEM,550181,0,0,59,59,
Oklahoma,Corporation Commissioner,Blake Cummings,DEM,550181,0,0,9,9,
Oklahoma,U.S. House,Kendra Horn,DEM,550181,0,0,64,64,05
Oklahoma,U.S. House,Tom Guild,DEM,550181,0,0,5,5,05
Oklahoma,Governor,Mick Cornett,REP,550182,0,0,28,28,
Oklahoma,Governor,Kevin Stitt,REP,550182,0,0,27,27,
Oklahoma,Lieutenant Governor,Dana Murphy,REP,550182,0,0,26,26,
Oklahoma,Lieutenant Governor,Matt Pinnell,REP,550182,0,0,26,26,
Oklahoma,State Auditor,Cindy Byrd,REP,550182,0,0,22,22,
Oklahoma,State Auditor,Charlie Prater,REP,550182,0,0,29,29,
Oklahoma,Attorney General,Mike Hunter,REP,550182,0,0,33,33,
Oklahoma,Attorney General,Gentner Drummond,REP,550182,0,0,21,21,
Oklahoma,Superintendent of Public Instruction,Joy Hofmeister,REP,550182,0,0,24,24,
Oklahoma,Superintendent of Public Instruction,Linda Murphy,REP,550182,0,0,29,29,
Oklahoma,Commissioner of Labor,Cathy Costello,REP,550182,0,0,27,27,
Oklahoma,Commissioner of Labor,Leslie Osborn,REP,550182,0,0,28,28,
Oklahoma,Corporation Commissioner,Bob Anthony,REP,550182,0,0,35,35,
Oklahoma,Corporation Commissioner,Brian Bingman,REP,550182,0,0,19,19,
Oklahoma,Governor,Chris Powell,LIB,550182,0,0,1,1,
Oklahoma,Governor,Rex Lawhorn,LIB,550182,0,0,1,1,
Oklahoma,Corporation Commissioner,Ashley Nicole Mccray,DEM,550182,0,0,48,48,
Oklahoma,Corporation Commissioner,Blake Cummings,DEM,550182,0,0,20,20,
Oklahoma,U.S. House,Kendra Horn,DEM,550182,0,0,56,56,05
Oklahoma,U.S. House,Tom Guild,DEM,550182,0,0,12,12,05
Oklahoma,Governor,Mick Cornett,REP,550183,0,0,107,107,
Oklahoma,Governor,Kevin Stitt,REP,550183,0,0,84,84,
Oklahoma,Lieutenant Governor,Dana Murphy,REP,550183,0,0,80,80,
Oklahoma,Lieutenant Governor,Matt Pinnell,REP,550183,0,0,107,107,
Oklahoma,State Auditor,Cindy Byrd,REP,550183,0,0,86,86,
Oklahoma,State Auditor,Charlie Prater,REP,550183,0,0,94,94,
Oklahoma,Attorney General,Mike Hunter,REP,550183,0,0,127,127,
Oklahoma,Attorney General,Gentner Drummond,REP,550183,0,0,58,58,
Oklahoma,Superintendent of Public Instruction,Joy Hofmeister,REP,550183,0,0,113,113,
Oklahoma,Superintendent of Public Instruction,Linda Murphy,REP,550183,0,0,73,73,
Oklahoma,Commissioner of Labor,Cathy Costello,REP,550183,0,0,94,94,
Oklahoma,Commissioner of Labor,Leslie Osborn,REP,550183,0,0,87,87,
Oklahoma,Corporation Commissioner,Bob Anthony,REP,550183,0,0,98,98,
Oklahoma,Corporation Commissioner,Brian Bingman,REP,550183,0,0,86,86,
Oklahoma,Governor,Chris Powell,LIB,550183,0,0,5,5,
Oklahoma,Governor,Rex Lawhorn,LIB,550183,0,0,0,0,
Oklahoma,Corporation Commissioner,Ashley Nicole Mccray,DEM,550183,0,0,120,120,
Oklahoma,Corporation Commissioner,Blake Cummings,DEM,550183,0,0,25,25,
Oklahoma,U.S. House,Kendra Horn,DEM,550183,0,0,127,127,05
Oklahoma,U.S. House,Tom Guild,DEM,550183,0,0,25,25,05
Oklahoma,Governor,Mick Cornett,REP,550184,0,0,76,76,
Oklahoma,Governor,Kevin Stitt,REP,550184,0,0,80,80,
Oklahoma,Lieutenant Governor,Dana Murphy,REP,550184,0,0,70,70,
Oklahoma,Lieutenant Governor,Matt Pinnell,REP,550184,0,0,84,84,
Oklahoma,State Auditor,Cindy Byrd,REP,550184,0,0,75,75,
Oklahoma,State Auditor,Charlie Prater,REP,550184,0,0,74,74,
Oklahoma,Attorney General,Mike Hunter,REP,550184,0,0,91,91,
Oklahoma,Attorney General,Gentner Drummond,REP,550184,0,0,64,64,
Oklahoma,Superintendent of Public Instruction,Joy Hofmeister,REP,550184,0,0,78,78,
Oklahoma,Superintendent of Public Instruction,Linda Murphy,REP,550184,0,0,76,76,
Oklahoma,Commissioner of Labor,Cathy Costello,REP,550184,0,0,74,74,
Oklahoma,Commissioner of Labor,Leslie Osborn,REP,550184,0,0,81,81,
Oklahoma,Corporation Commissioner,Bob Anthony,REP,550184,0,0,92,92,
Oklahoma,Corporation Commissioner,Brian Bingman,REP,550184,0,0,61,61,
Oklahoma,Governor,Chris Powell,LIB,550184,0,0,0,0,
Oklahoma,Governor,Rex Lawhorn,LIB,550184,0,0,1,1,
Oklahoma,Corporation Commissioner,Ashley Nicole Mccray,DEM,550184,0,0,125,125,
Oklahoma,Corporation Commissioner,Blake Cummings,DEM,550184,0,0,30,30,
Oklahoma,U.S. House,Kendra Horn,DEM,550184,0,0,130,130,05
Oklahoma,U.S. House,Tom Guild,DEM,550184,0,0,26,26,05
Oklahoma,Governor,Mick Cornett,REP,550185,0,0,19,19,
Oklahoma,Governor,Kevin Stitt,REP,550185,0,0,32,32,
Oklahoma,Lieutenant Governor,Dana Murphy,REP,550185,0,0,24,24,
Oklahoma,Lieutenant Governor,Matt Pinnell,REP,550185,0,0,25,25,
Oklahoma,State Auditor,Cindy Byrd,REP,550185,0,0,29,29,
Oklahoma,State Auditor,Charlie Prater,REP,550185,0,0,18,18,
Oklahoma,Attorney General,Mike Hunter,REP,550185,0,0,27,27,
Oklahoma,Attorney General,Gentner Drummond,REP,550185,0,0,22,22,
Oklahoma,Superintendent of Public Instruction,Joy Hofmeister,REP,550185,0,0,26,26,
Oklahoma,Superintendent of Public Instruction,Linda Murphy,REP,550185,0,0,24,24,
Oklahoma,Commissioner of Labor,Cathy Costello,REP,550185,0,0,23,23,
Oklahoma,Commissioner of Labor,Leslie Osborn,REP,550185,0,0,27,27,
Oklahoma,Corporation Commissioner,Bob Anthony,REP,550185,0,0,28,28,
Oklahoma,Corporation Commissioner,Brian Bingman,REP,550185,0,0,22,22,
Oklahoma,Governor,Chris Powell,LIB,550185,0,0,0,0,
Oklahoma,Governor,Rex Lawhorn,LIB,550185,0,0,0,0,
Oklahoma,Corporation Commissioner,Ashley Nicole Mccray,DEM,550185,0,0,46,46,
Oklahoma,Corporation Commissioner,Blake Cummings,DEM,550185,0,0,15,15,
Oklahoma,U.S. House,Kendra Horn,DEM,550185,0,0,53,53,05
Oklahoma,U.S. House,Tom Guild,DEM,550185,0,0,10,10,05
Oklahoma,Governor,Mick Cornett,REP,550186,0,0,75,75,
Oklahoma,Governor,Kevin Stitt,REP,550186,0,0,32,32,
Oklahoma,Lieutenant Governor,Dana Murphy,REP,550186,0,0,41,41,
Oklahoma,Lieutenant Governor,Matt Pinnell,REP,550186,0,0,61,61,
Oklahoma,State Auditor,Cindy Byrd,REP,550186,0,0,50,50,
Oklahoma,State Auditor,Charlie Prater,REP,550186,0,0,50,50,
Oklahoma,Attorney General,Mike Hunter,REP,550186,0,0,66,66,
Oklahoma,Attorney General,Gentner Drummond,REP,550186,0,0,37,37,
Oklahoma,Superintendent of Public Instruction,Joy Hofmeister,REP,550186,0,0,58,58,
Oklahoma,Superintendent of Public Instruction,Linda Murphy,REP,550186,0,0,43,43,
Oklahoma,Commissioner of Labor,Cathy Costello,REP,550186,0,0,46,46,
Oklahoma,Commissioner of Labor,Leslie Osborn,REP,550186,0,0,57,57,
Oklahoma,Corporation Commissioner,Bob Anthony,REP,550186,0,0,60,60,
Oklahoma,Corporation Commissioner,Brian Bingman,REP,550186,0,0,40,40,
Oklahoma,State Senate,Lori Callahan,REP,550186,0,0,33,33,30
Oklahoma,State Senate,John Symcox,REP,550186,0,0,69,69,30
Oklahoma,Governor,Chris Powell,LIB,550186,0,0,0,0,
Oklahoma,Governor,Rex Lawhorn,LIB,550186,0,0,0,0,
Oklahoma,Corporation Commissioner,Ashley Nicole Mccray,DEM,550186,0,0,85,85,
Oklahoma,Corporation Commissioner,Blake Cummings,DEM,550186,0,0,23,23,
Oklahoma,U.S. House,Kendra Horn,DEM,550186,0,0,101,101,05
Oklahoma,U.S. House,Tom Guild,DEM,550186,0,0,9,9,05
Oklahoma,Governor,Mick Cornett,REP,550187,0,0,5,5,
Oklahoma,Governor,Kevin Stitt,REP,550187,0,0,8,8,
Oklahoma,Lieutenant Governor,Dana Murphy,REP,550187,0,0,5,5,
Oklahoma,Lieutenant Governor,Matt Pinnell,REP,550187,0,0,8,8,
Oklahoma,State Auditor,Cindy Byrd,REP,550187,0,0,5,5,
Oklahoma,State Auditor,Charlie Prater,REP,550187,0,0,8,8,
Oklahoma,Attorney General,Mike Hunter,REP,550187,0,0,9,9,
Oklahoma,Attorney General,Gentner Drummond,REP,550187,0,0,4,4,
Oklahoma,Superintendent of Public Instruction,Joy Hofmeister,REP,550187,0,0,4,4,
Oklahoma,Superintendent of Public Instruction,Linda Murphy,REP,550187,0,0,9,9,
Oklahoma,Commissioner of Labor,Cathy Costello,REP,550187,0,0,6,6,
Oklahoma,Commissioner of Labor,Leslie Osborn,REP,550187,0,0,7,7,
Oklahoma,Corporation Commissioner,Bob Anthony,REP,550187,0,0,8,8,
Oklahoma,Corporation Commissioner,Brian Bingman,REP,550187,0,0,5,5,
Oklahoma,State Senate,Lori Callahan,REP,550187,0,0,4,4,30
Oklahoma,State Senate,John Symcox,REP,550187,0,0,9,9,30
Oklahoma,Governor,Chris Powell,LIB,550187,0,0,0,0,
Oklahoma,Governor,Rex Lawhorn,LIB,550187,0,0,0,0,
Oklahoma,Corporation Commissioner,Ashley Nicole Mccray,DEM,550187,0,0,12,12,
Oklahoma,Corporation Commissioner,Blake Cummings,DEM,550187,0,0,5,5,
Oklahoma,U.S. House,Kendra Horn,DEM,550187,0,0,9,9,05
Oklahoma,U.S. House,Tom Guild,DEM,550187,0,0,8,8,05
Oklahoma,Governor,Mick Cornett,REP,550188,0,0,0,0,
Oklahoma,Governor,Kevin Stitt,REP,550188,0,0,0,0,
Oklahoma,Lieutenant Governor,Dana Murphy,REP,550188,0,0,0,0,
Oklahoma,Lieutenant Governor,Matt Pinnell,REP,550188,0,0,0,0,
Oklahoma,State Auditor,Cindy Byrd,REP,550188,0,0,0,0,
Oklahoma,State Auditor,Charlie Prater,REP,550188,0,0,0,0,
Oklahoma,Attorney General,Mike Hunter,REP,550188,0,0,0,0,
Oklahoma,Attorney General,Gentner Drummond,REP,550188,0,0,0,0,
Oklahoma,Superintendent of Public Instruction,Joy Hofmeister,REP,550188,0,0,0,0,
Oklahoma,Superintendent of Public Instruction,Linda Murphy,REP,550188,0,0,0,0,
Oklahoma,Commissioner of Labor,Cathy Costello,REP,550188,0,0,0,0,
Oklahoma,Commissioner of Labor,Leslie Osborn,REP,550188,0,0,0,0,
Oklahoma,Corporation Commissioner,Bob Anthony,REP,550188,0,0,0,0,
Oklahoma,Corporation Commissioner,Brian Bingman,REP,550188,0,0,0,0,
Oklahoma,Governor,Chris Powell,LIB,550188,0,0,0,0,
Oklahoma,Governor,Rex Lawhorn,LIB,550188,0,0,0,0,
Oklahoma,Corporation Commissioner,Ashley Nicole Mccray,DEM,550188,0,0,1,1,
Oklahoma,Corporation Commissioner,Blake Cummings,DEM,550188,0,0,0,0,
Oklahoma,U.S. House,Kendra Horn,DEM,550188,0,0,1,1,05
Oklahoma,U.S. House,Tom Guild,DEM,550188,0,0,0,0,05
Oklahoma,Governor,Mick Cornett,REP,550189,0,0,3,3,
Oklahoma,Governor,Kevin Stitt,REP,550189,0,0,9,9,
Oklahoma,Lieutenant Governor,Dana Murphy,REP,550189,0,0,8,8,
Oklahoma,Lieutenant Governor,Matt Pinnell,REP,550189,0,0,4,4,
Oklahoma,State Auditor,Cindy Byrd,REP,550189,0,0,6,6,
Oklahoma,State Auditor,Charlie Prater,REP,550189,0,0,5,5,
Oklahoma,Attorney General,Mike Hunter,REP,550189,0,0,7,7,
Oklahoma,Attorney General,Gentner Drummond,REP,550189,0,0,5,5,
Oklahoma,Superintendent of Public Instruction,Joy Hofmeister,REP,550189,0,0,7,7,
Oklahoma,Superintendent of Public Instruction,Linda Murphy,REP,550189,0,0,5,5,
Oklahoma,Commissioner of Labor,Cathy Costello,REP,550189,0,0,6,6,
Oklahoma,Commissioner of Labor,Leslie Osborn,REP,550189,0,0,6,6,
Oklahoma,Corporation Commissioner,Bob Anthony,REP,550189,0,0,9,9,
Oklahoma,Corporation Commissioner,Brian Bingman,REP,550189,0,0,3,3,
Oklahoma,Governor,Chris Powell,LIB,550189,0,0,0,0,
Oklahoma,Governor,Rex Lawhorn,LIB,550189,0,0,0,0,
Oklahoma,Corporation Commissioner,Ashley Nicole Mccray,DEM,550189,0,0,8,8,
Oklahoma,Corporation Commissioner,Blake Cummings,DEM,550189,0,0,3,3,
Oklahoma,U.S. House,Kendra Horn,DEM,550189,0,0,6,6,05
Oklahoma,U.S. House,Tom Guild,DEM,550189,0,0,4,4,05
Oklahoma,Governor,Mick Cornett,REP,550190,0,0,18,18,
Oklahoma,Governor,Kevin Stitt,REP,550190,0,0,15,15,
Oklahoma,Lieutenant Governor,Dana Murphy,REP,550190,0,0,11,11,
Oklahoma,Lieutenant Governor,Matt Pinnell,REP,550190,0,0,20,20,
Oklahoma,State Auditor,Cindy Byrd,REP,550190,0,0,10,10,
Oklahoma,State Auditor,Charlie Prater,REP,550190,0,0,19,19,
Oklahoma,Attorney General,Mike Hunter,REP,550190,0,0,15,15,
Oklahoma,Attorney General,Gentner Drummond,REP,550190,0,0,16,16,
Oklahoma,Superintendent of Public Instruction,Joy Hofmeister,REP,550190,0,0,18,18,
Oklahoma,Superintendent of Public Instruction,Linda Murphy,REP,550190,0,0,12,12,
Oklahoma,Commissioner of Labor,Cathy Costello,REP,550190,0,0,12,12,
Oklahoma,Commissioner of Labor,Leslie Osborn,REP,550190,0,0,16,16,
Oklahoma,Corporation Commissioner,Bob Anthony,REP,550190,0,0,15,15,
Oklahoma,Corporation Commissioner,Brian Bingman,REP,550190,0,0,17,17,
Oklahoma,Governor,Chris Powell,LIB,550190,0,0,0,0,
Oklahoma,Governor,Rex Lawhorn,LIB,550190,0,0,0,0,
Oklahoma,Corporation Commissioner,Ashley Nicole Mccray,DEM,550190,0,0,42,42,
Oklahoma,Corporation Commissioner,Blake Cummings,DEM,550190,0,0,6,6,
Oklahoma,U.S. House,Kendra Horn,DEM,550190,0,0,37,37,05
Oklahoma,U.S. House,Tom Guild,DEM,550190,0,0,12,12,05
Oklahoma,Governor,Mick Cornett,REP,550191,0,0,33,33,
Oklahoma,Governor,Kevin Stitt,REP,550191,0,0,21,21,
Oklahoma,Lieutenant Governor,Dana Murphy,REP,550191,0,0,24,24,
Oklahoma,Lieutenant Governor,Matt Pinnell,REP,550191,0,0,29,29,
Oklahoma,State Auditor,Cindy Byrd,REP,550191,0,0,30,30,
Oklahoma,State Auditor,Charlie Prater,REP,550191,0,0,20,20,
Oklahoma,Attorney General,Mike Hunter,REP,550191,0,0,29,29,
Oklahoma,Attorney General,Gentner Drummond,REP,550191,0,0,23,23,
Oklahoma,Superintendent of Public Instruction,Joy Hofmeister,REP,550191,0,0,28,28,
Oklahoma,Superintendent of Public Instruction,Linda Murphy,REP,550191,0,0,24,24,
Oklahoma,Commissioner of Labor,Cathy Costello,REP,550191,0,0,27,27,
Oklahoma,Commissioner of Labor,Leslie Osborn,REP,550191,0,0,24,24,
Oklahoma,Corporation Commissioner,Bob Anthony,REP,550191,0,0,33,33,
Oklahoma,Corporation Commissioner,Brian Bingman,REP,550191,0,0,18,18,
Oklahoma,Governor,Chris Powell,LIB,550191,0,0,2,2,
Oklahoma,Governor,Rex Lawhorn,LIB,550191,0,0,0,0,
Oklahoma,Corporation Commissioner,Ashley Nicole Mccray,DEM,550191,0,0,100,100,
Oklahoma,Corporation Commissioner,Blake Cummings,DEM,550191,0,0,16,16,
Oklahoma,U.S. House,Kendra Horn,DEM,550191,0,0,98,98,05
Oklahoma,U.S. House,Tom Guild,DEM,550191,0,0,18,18,05
Oklahoma,Governor,Mick Cornett,REP,550192,0,0,99,99,
Oklahoma,Governor,Kevin Stitt,REP,550192,0,0,48,48,
Oklahoma,Lieutenant Governor,Dana Murphy,REP,550192,0,0,69,69,
Oklahoma,Lieutenant Governor,Matt Pinnell,REP,550192,0,0,73,73,
Oklahoma,State Auditor,Cindy Byrd,REP,550192,0,0,80,80,
Oklahoma,State Auditor,Charlie Prater,REP,550192,0,0,57,57,
Oklahoma,Attorney General,Mike Hunter,REP,550192,0,0,81,81,
Oklahoma,Attorney General,Gentner Drummond,REP,550192,0,0,58,58,
Oklahoma,Superintendent of Public Instruction,Joy Hofmeister,REP,550192,0,0,73,73,
Oklahoma,Superintendent of Public Instruction,Linda Murphy,REP,550192,0,0,67,67,
Oklahoma,Commissioner of Labor,Cathy Costello,REP,550192,0,0,64,64,
Oklahoma,Commissioner of Labor,Leslie Osborn,REP,550192,0,0,74,74,
Oklahoma,Corporation Commissioner,Bob Anthony,REP,550192,0,0,83,83,
Oklahoma,Corporation Commissioner,Brian Bingman,REP,550192,0,0,55,55,
Oklahoma,State Senate,Lori Callahan,REP,550192,0,0,79,79,30
Oklahoma,State Senate,John Symcox,REP,550192,0,0,60,60,30
Oklahoma,Governor,Chris Powell,LIB,550192,0,0,3,3,
Oklahoma,Governor,Rex Lawhorn,LIB,550192,0,0,0,0,
Oklahoma,Corporation Commissioner,Ashley Nicole Mccray,DEM,550192,0,0,230,230,
Oklahoma,Corporation Commissioner,Blake Cummings,DEM,550192,0,0,26,26,
Oklahoma,U.S. House,Kendra Horn,DEM,550192,0,0,242,242,05
Oklahoma,U.S. House,Tom Guild,DEM,550192,0,0,23,23,05
Oklahoma,Governor,Mick Cornett,REP,550193,0,0,81,81,
Oklahoma,Governor,Kevin Stitt,REP,550193,0,0,44,44,
Oklahoma,Lieutenant Governor,Dana Murphy,REP,550193,0,0,62,62,
Oklahoma,Lieutenant Governor,Matt Pinnell,REP,550193,0,0,56,56,
Oklahoma,State Auditor,Cindy Byrd,REP,550193,0,0,54,54,
Oklahoma,State Auditor,Charlie Prater,REP,550193,0,0,57,57,
Oklahoma,Attorney General,Mike Hunter,REP,550193,0,0,78,78,
Oklahoma,Attorney General,Gentner Drummond,REP,550193,0,0,37,37,
Oklahoma,Superintendent of Public Instruction,Joy Hofmeister,REP,550193,0,0,72,72,
Oklahoma,Superintendent of Public Instruction,Linda Murphy,REP,550193,0,0,44,44,
Oklahoma,Commissioner of Labor,Cathy Costello,REP,550193,0,0,57,57,
Oklahoma,Commissioner of Labor,Leslie Osborn,REP,550193,0,0,60,60,
Oklahoma,Corporation Commissioner,Bob Anthony,REP,550193,0,0,68,68,
Oklahoma,Corporation Commissioner,Brian Bingman,REP,550193,0,0,46,46,
Oklahoma,State Senate,Lori Callahan,REP,550193,0,0,50,50,30
Oklahoma,State Senate,John Symcox,REP,550193,0,0,68,68,30
Oklahoma,Governor,Chris Powell,LIB,550193,0,0,0,0,
Oklahoma,Governor,Rex Lawhorn,LIB,550193,0,0,0,0,
Oklahoma,Corporation Commissioner,Ashley Nicole Mccray,DEM,550193,0,0,138,138,
Oklahoma,Corporation Commissioner,Blake Cummings,DEM,550193,0,0,23,23,
Oklahoma,U.S. House,Kendra Horn,DEM,550193,0,0,147,147,05
Oklahoma,U.S. House,Tom Guild,DEM,550193,0,0,20,20,05
Oklahoma,Governor,Mick Cornett,REP,550194,0,0,55,55,
Oklahoma,Governor,Kevin Stitt,REP,550194,0,0,41,41,
Oklahoma,Lieutenant Governor,Dana Murphy,REP,550194,0,0,42,42,
Oklahoma,Lieutenant Governor,Matt Pinnell,REP,550194,0,0,47,47,
Oklahoma,State Auditor,Cindy Byrd,REP,550194,0,0,40,40,
Oklahoma,State Auditor,Charlie Prater,REP,550194,0,0,46,46,
Oklahoma,Attorney General,Mike Hunter,REP,550194,0,0,53,53,
Oklahoma,Attorney General,Gentner Drummond,REP,550194,0,0,39,39,
Oklahoma,Superintendent of Public Instruction,Joy Hofmeister,REP,550194,0,0,47,47,
Oklahoma,Superintendent of Public Instruction,Linda Murphy,REP,550194,0,0,47,47,
Oklahoma,Commissioner of Labor,Cathy Costello,REP,550194,0,0,45,45,
Oklahoma,Commissioner of Labor,Leslie Osborn,REP,550194,0,0,48,48,
Oklahoma,Corporation Commissioner,Bob Anthony,REP,550194,0,0,51,51,
Oklahoma,Corporation Commissioner,Brian Bingman,REP,550194,0,0,36,36,
Oklahoma,Governor,Chris Powell,LIB,550194,0,0,0,0,
Oklahoma,Governor,Rex Lawhorn,LIB,550194,0,0,0,0,
Oklahoma,Corporation Commissioner,Ashley Nicole Mccray,DEM,550194,0,0,112,112,
Oklahoma,Corporation Commissioner,Blake Cummings,DEM,550194,0,0,24,24,
Oklahoma,U.S. House,Kendra Horn,DEM,550194,0,0,120,120,05
Oklahoma,U.S. House,Tom Guild,DEM,550194,0,0,18,18,05
Oklahoma,Governor,Mick Cornett,REP,550195,0,0,150,150,
Oklahoma,Governor,Kevin Stitt,REP,550195,0,0,93,93,
Oklahoma,Lieutenant Governor,Dana Murphy,REP,550195,0,0,115,115,
Oklahoma,Lieutenant Governor,Matt Pinnell,REP,550195,0,0,118,118,
Oklahoma,State Auditor,Cindy Byrd,REP,550195,0,0,125,125,
Oklahoma,State Auditor,Charlie Prater,REP,550195,0,0,99,99,
Oklahoma,Attorney General,Mike Hunter,REP,550195,0,0,141,141,
Oklahoma,Attorney General,Gentner Drummond,REP,550195,0,0,87,87,
Oklahoma,Superintendent of Public Instruction,Joy Hofmeister,REP,550195,0,0,135,135,
Oklahoma,Superintendent of Public Instruction,Linda Murphy,REP,550195,0,0,96,96,
Oklahoma,Commissioner of Labor,Cathy Costello,REP,550195,0,0,120,120,
Oklahoma,Commissioner of Labor,Leslie Osborn,REP,550195,0,0,108,108,
Oklahoma,Corporation Commissioner,Bob Anthony,REP,550195,0,0,128,128,
Oklahoma,Corporation Commissioner,Brian Bingman,REP,550195,0,0,103,103,
Oklahoma,Governor,Chris Powell,LIB,550195,0,0,0,0,
Oklahoma,Governor,Rex Lawhorn,LIB,550195,0,0,2,2,
Oklahoma,Corporation Commissioner,Ashley Nicole Mccray,DEM,550195,0,0,195,195,
Oklahoma,Corporation Commissioner,Blake Cummings,DEM,550195,0,0,53,53,
Oklahoma,U.S. House,Kendra Horn,DEM,550195,0,0,217,217,05
Oklahoma,U.S. House,Tom Guild,DEM,550195,0,0,35,35,05
Oklahoma,Governor,Mick Cornett,REP,550196,0,0,306,306,
Oklahoma,Governor,Kevin Stitt,REP,550196,0,0,172,172,
Oklahoma,Lieutenant Governor,Dana Murphy,REP,550196,0,0,211,211,
Oklahoma,Lieutenant Governor,Matt Pinnell,REP,550196,0,0,256,256,
Oklahoma,State Auditor,Cindy Byrd,REP,550196,0,0,246,246,
Oklahoma,State Auditor,Charlie Prater,REP,550196,0,0,189,189,
Oklahoma,Attorney General,Mike Hunter,REP,550196,0,0,329,329,
Oklahoma,Attorney General,Gentner Drummond,REP,550196,0,0,132,132,
Oklahoma,Superintendent of Public Instruction,Joy Hofmeister,REP,550196,0,0,289,289,
Oklahoma,Superintendent of Public Instruction,Linda Murphy,REP,550196,0,0,168,168,
Oklahoma,Commissioner of Labor,Cathy Costello,REP,550196,0,0,237,237,
Oklahoma,Commissioner of Labor,Leslie Osborn,REP,550196,0,0,214,214,
Oklahoma,Corporation Commissioner,Bob Anthony,REP,550196,0,0,305,305,
Oklahoma,Corporation Commissioner,Brian Bingman,REP,550196,0,0,162,162,
Oklahoma,Governor,Chris Powell,LIB,550196,0,0,0,0,
Oklahoma,Governor,Rex Lawhorn,LIB,550196,0,0,0,0,
Oklahoma,Corporation Commissioner,Ashley Nicole Mccray,DEM,550196,0,0,206,206,
Oklahoma,Corporation Commissioner,Blake Cummings,DEM,550196,0,0,46,46,
Oklahoma,U.S. House,Kendra Horn,DEM,550196,0,0,240,240,05
Oklahoma,U.S. House,Tom Guild,DEM,550196,0,0,22,22,05
Oklahoma,Governor,Mick Cornett,REP,550197,0,0,71,71,
Oklahoma,Governor,Kevin Stitt,REP,550197,0,0,43,43,
Oklahoma,Lieutenant Governor,Dana Murphy,REP,550197,0,0,57,57,
Oklahoma,Lieutenant Governor,Matt Pinnell,REP,550197,0,0,55,55,
Oklahoma,State Auditor,Cindy Byrd,REP,550197,0,0,70,70,
Oklahoma,State Auditor,Charlie Prater,REP,550197,0,0,41,41,
Oklahoma,Attorney General,Mike Hunter,REP,550197,0,0,64,64,
Oklahoma,Attorney General,Gentner Drummond,REP,550197,0,0,46,46,
Oklahoma,Superintendent of Public Instruction,Joy Hofmeister,REP,550197,0,0,62,62,
Oklahoma,Superintendent of Public Instruction,Linda Murphy,REP,550197,0,0,47,47,
Oklahoma,Commissioner of Labor,Cathy Costello,REP,550197,0,0,53,53,
Oklahoma,Commissioner of Labor,Leslie Osborn,REP,550197,0,0,56,56,
Oklahoma,Corporation Commissioner,Bob Anthony,REP,550197,0,0,64,64,
Oklahoma,Corporation Commissioner,Brian Bingman,REP,550197,0,0,45,45,
Oklahoma,Governor,Chris Powell,LIB,550197,0,0,0,0,
Oklahoma,Governor,Rex Lawhorn,LIB,550197,0,0,1,1,
Oklahoma,Corporation Commissioner,Ashley Nicole Mccray,DEM,550197,0,0,180,180,
Oklahoma,Corporation Commissioner,Blake Cummings,DEM,550197,0,0,47,47,
Oklahoma,U.S. House,Kendra Horn,DEM,550197,0,0,198,198,05
Oklahoma,U.S. House,Tom Guild,DEM,550197,0,0,29,29,05
Oklahoma,Governor,Mick Cornett,REP,550198,0,0,89,89,
Oklahoma,Governor,Kevin Stitt,REP,550198,0,0,38,38,
Oklahoma,Lieutenant Governor,Dana Murphy,REP,550198,0,0,67,67,
Oklahoma,Lieutenant Governor,Matt Pinnell,REP,550198,0,0,55,55,
Oklahoma,State Auditor,Cindy Byrd,REP,550198,0,0,66,66,
Oklahoma,State Auditor,Charlie Prater,REP,550198,0,0,51,51,
Oklahoma,Attorney General,Mike Hunter,REP,550198,0,0,75,75,
Oklahoma,Attorney General,Gentner Drummond,REP,550198,0,0,47,47,
Oklahoma,Superintendent of Public Instruction,Joy Hofmeister,REP,550198,0,0,72,72,
Oklahoma,Superintendent of Public Instruction,Linda Murphy,REP,550198,0,0,48,48,
Oklahoma,Commissioner of Labor,Cathy Costello,REP,550198,0,0,52,52,
Oklahoma,Commissioner of Labor,Leslie Osborn,REP,550198,0,0,70,70,
Oklahoma,Corporation Commissioner,Bob Anthony,REP,550198,0,0,73,73,
Oklahoma,Corporation Commissioner,Brian Bingman,REP,550198,0,0,48,48,
Oklahoma,Governor,Chris Powell,LIB,550198,0,0,1,1,
Oklahoma,Governor,Rex Lawhorn,LIB,550198,0,0,0,0,
Oklahoma,Corporation Commissioner,Ashley Nicole Mccray,DEM,550198,0,0,174,174,
Oklahoma,Corporation Commissioner,Blake Cummings,DEM,550198,0,0,24,24,
Oklahoma,U.S. House,Kendra Horn,DEM,550198,0,0,180,180,05
Oklahoma,U.S. House,Tom Guild,DEM,550198,0,0,25,25,05
Oklahoma,Governor,Mick Cornett,REP,550199,0,0,144,144,
Oklahoma,Governor,Kevin Stitt,REP,550199,0,0,43,43,
Oklahoma,Lieutenant Governor,Dana Murphy,REP,550199,0,0,83,83,
Oklahoma,Lieutenant Governor,Matt Pinnell,REP,550199,0,0,99,99,
Oklahoma,State Auditor,Cindy Byrd,REP,550199,0,0,87,87,
Oklahoma,State Auditor,Charlie Prater,REP,550199,0,0,78,78,
Oklahoma,Attorney General,Mike Hunter,REP,550199,0,0,129,129,
Oklahoma,Attorney General,Gentner Drummond,REP,550199,0,0,47,47,
Oklahoma,Superintendent of Public Instruction,Joy Hofmeister,REP,550199,0,0,115,115,
Oklahoma,Superintendent of Public Instruction,Linda Murphy,REP,550199,0,0,64,64,
Oklahoma,Commissioner of Labor,Cathy Costello,REP,550199,0,0,81,81,
Oklahoma,Commissioner of Labor,Leslie Osborn,REP,550199,0,0,93,93,
Oklahoma,Corporation Commissioner,Bob Anthony,REP,550199,0,0,102,102,
Oklahoma,Corporation Commissioner,Brian Bingman,REP,550199,0,0,70,70,
Oklahoma,Governor,Chris Powell,LIB,550199,0,0,0,0,
Oklahoma,Governor,Rex Lawhorn,LIB,550199,0,0,1,1,
Oklahoma,Corporation Commissioner,Ashley Nicole Mccray,DEM,550199,0,0,150,150,
Oklahoma,Corporation Commissioner,Blake Cummings,DEM,550199,0,0,48,48,
Oklahoma,U.S. House,Kendra Horn,DEM,550199,0,0,177,177,05
Oklahoma,U.S. House,Tom Guild,DEM,550199,0,0,26,26,05
Oklahoma,Governor,Mick Cornett,REP,550200,0,0,115,115,
Oklahoma,Governor,Kevin Stitt,REP,550200,0,0,49,49,
Oklahoma,Lieutenant Governor,Dana Murphy,REP,550200,0,0,75,75,
Oklahoma,Lieutenant Governor,Matt Pinnell,REP,550200,0,0,80,80,
Oklahoma,State Auditor,Cindy Byrd,REP,550200,0,0,90,90,
Oklahoma,State Auditor,Charlie Prater,REP,550200,0,0,55,55,
Oklahoma,Attorney General,Mike Hunter,REP,550200,0,0,95,95,
Oklahoma,Attorney General,Gentner Drummond,REP,550200,0,0,60,60,
Oklahoma,Superintendent of Public Instruction,Joy Hofmeister,REP,550200,0,0,96,96,
Oklahoma,Superintendent of Public Instruction,Linda Murphy,REP,550200,0,0,63,63,
Oklahoma,Commissioner of Labor,Cathy Costello,REP,550200,0,0,68,68,
Oklahoma,Commissioner of Labor,Leslie Osborn,REP,550200,0,0,81,81,
Oklahoma,Corporation Commissioner,Bob Anthony,REP,550200,0,0,84,84,
Oklahoma,Corporation Commissioner,Brian Bingman,REP,550200,0,0,69,69,
Oklahoma,Governor,Chris Powell,LIB,550200,0,0,1,1,
Oklahoma,Governor,Rex Lawhorn,LIB,550200,0,0,0,0,
Oklahoma,Corporation Commissioner,Ashley Nicole Mccray,DEM,550200,0,0,289,289,
Oklahoma,Corporation Commissioner,Blake Cummings,DEM,550200,0,0,38,38,
Oklahoma,U.S. House,Kendra Horn,DEM,550200,0,0,312,312,05
Oklahoma,U.S. House,Tom Guild,DEM,550200,0,0,16,16,05
Oklahoma,Governor,Mick Cornett,REP,550201,0,0,51,51,
Oklahoma,Governor,Kevin Stitt,REP,550201,0,0,32,32,
Oklahoma,Lieutenant Governor,Dana Murphy,REP,550201,0,0,33,33,
Oklahoma,Lieutenant Governor,Matt Pinnell,REP,550201,0,0,45,45,
Oklahoma,State Auditor,Cindy Byrd,REP,550201,0,0,43,43,
Oklahoma,State Auditor,Charlie Prater,REP,550201,0,0,32,32,
Oklahoma,Attorney General,Mike Hunter,REP,550201,0,0,37,37,
Oklahoma,Attorney General,Gentner Drummond,REP,550201,0,0,41,41,
Oklahoma,Superintendent of Public Instruction,Joy Hofmeister,REP,550201,0,0,43,43,
Oklahoma,Superintendent of Public Instruction,Linda Murphy,REP,550201,0,0,38,38,
Oklahoma,Commissioner of Labor,Cathy Costello,REP,550201,0,0,39,39,
Oklahoma,Commissioner of Labor,Leslie Osborn,REP,550201,0,0,42,42,
Oklahoma,Corporation Commissioner,Bob Anthony,REP,550201,0,0,52,52,
Oklahoma,Corporation Commissioner,Brian Bingman,REP,550201,0,0,28,28,
Oklahoma,Governor,Chris Powell,LIB,550201,0,0,0,0,
Oklahoma,Governor,Rex Lawhorn,LIB,550201,0,0,0,0,
Oklahoma,Corporation Commissioner,Ashley Nicole Mccray,DEM,550201,0,0,114,114,
Oklahoma,Corporation Commissioner,Blake Cummings,DEM,550201,0,0,21,21,
Oklahoma,U.S. House,Kendra Horn,DEM,550201,0,0,118,118,05
Oklahoma,U.S. House,Tom Guild,DEM,550201,0,0,19,19,05
Oklahoma,Governor,Mick Cornett,REP,550202,0,0,60,60,
Oklahoma,Governor,Kevin Stitt,REP,550202,0,0,34,34,
Oklahoma,Lieutenant Governor,Dana Murphy,REP,550202,0,0,40,40,
Oklahoma,Lieutenant Governor,Matt Pinnell,REP,550202,0,0,48,48,
Oklahoma,State Auditor,Cindy Byrd,REP,550202,0,0,48,48,
Oklahoma,State Auditor,Charlie Prater,REP,550202,0,0,40,40,
Oklahoma,Attorney General,Mike Hunter,REP,550202,0,0,62,62,
Oklahoma,Attorney General,Gentner Drummond,REP,550202,0,0,27,27,
Oklahoma,Superintendent of Public Instruction,Joy Hofmeister,REP,550202,0,0,47,47,
Oklahoma,Superintendent of Public Instruction,Linda Murphy,REP,550202,0,0,46,46,
Oklahoma,Commissioner of Labor,Cathy Costello,REP,550202,0,0,46,46,
Oklahoma,Commissioner of Labor,Leslie Osborn,REP,550202,0,0,40,40,
Oklahoma,Corporation Commissioner,Bob Anthony,REP,550202,0,0,57,57,
Oklahoma,Corporation Commissioner,Brian Bingman,REP,550202,0,0,31,31,
Oklahoma,Governor,Chris Powell,LIB,550202,0,0,0,0,
Oklahoma,Governor,Rex Lawhorn,LIB,550202,0,0,0,0,
Oklahoma,Corporation Commissioner,Ashley Nicole Mccray,DEM,550202,0,0,118,118,
Oklahoma,Corporation Commissioner,Blake Cummings,DEM,550202,0,0,19,19,
Oklahoma,U.S. House,Kendra Horn,DEM,550202,0,0,128,128,05
Oklahoma,U.S. House,Tom Guild,DEM,550202,0,0,9,9,05
Oklahoma,Governor,Mick Cornett,REP,550203,0,0,47,47,
Oklahoma,Governor,Kevin Stitt,REP,550203,0,0,27,27,
Oklahoma,Lieutenant Governor,Dana Murphy,REP,550203,0,0,21,21,
Oklahoma,Lieutenant Governor,Matt Pinnell,REP,550203,0,0,48,48,
Oklahoma,State Auditor,Cindy Byrd,REP,550203,0,0,33,33,
Oklahoma,State Auditor,Charlie Prater,REP,550203,0,0,34,34,
Oklahoma,Attorney General,Mike Hunter,REP,550203,0,0,45,45,
Oklahoma,Attorney General,Gentner Drummond,REP,550203,0,0,27,27,
Oklahoma,Superintendent of Public Instruction,Joy Hofmeister,REP,550203,0,0,37,37,
Oklahoma,Superintendent of Public Instruction,Linda Murphy,REP,550203,0,0,33,33,
Oklahoma,Commissioner of Labor,Cathy Costello,REP,550203,0,0,33,33,
Oklahoma,Commissioner of Labor,Leslie Osborn,REP,550203,0,0,37,37,
Oklahoma,Corporation Commissioner,Bob Anthony,REP,550203,0,0,37,37,
Oklahoma,Corporation Commissioner,Brian Bingman,REP,550203,0,0,30,30,
Oklahoma,Governor,Chris Powell,LIB,550203,0,0,2,2,
Oklahoma,Governor,Rex Lawhorn,LIB,550203,0,0,0,0,
Oklahoma,Corporation Commissioner,Ashley Nicole Mccray,DEM,550203,0,0,101,101,
Oklahoma,Corporation Commissioner,Blake Cummings,DEM,550203,0,0,8,8,
Oklahoma,U.S. House,Kendra Horn,DEM,550203,0,0,90,90,05
Oklahoma,U.S. House,Tom Guild,DEM,550203,0,0,24,24,05
Oklahoma,Governor,Mick Cornett,REP,550204,0,0,204,204,
Oklahoma,Governor,Kevin Stitt,REP,550204,0,0,73,73,
Oklahoma,Lieutenant Governor,Dana Murphy,REP,550204,0,0,126,126,
Oklahoma,Lieutenant Governor,Matt Pinnell,REP,550204,0,0,125,125,
Oklahoma,State Auditor,Cindy Byrd,REP,550204,0,0,143,143,
Oklahoma,State Auditor,Charlie Prater,REP,550204,0,0,91,91,
Oklahoma,Attorney General,Mike Hunter,REP,550204,0,0,191,191,
Oklahoma,Attorney General,Gentner Drummond,REP,550204,0,0,67,67,
Oklahoma,Superintendent of Public Instruction,Joy Hofmeister,REP,550204,0,0,152,152,
Oklahoma,Superintendent of Public Instruction,Linda Murphy,REP,550204,0,0,104,104,
Oklahoma,Commissioner of Labor,Cathy Costello,REP,550204,0,0,135,135,
Oklahoma,Commissioner of Labor,Leslie Osborn,REP,550204,0,0,123,123,
Oklahoma,Corporation Commissioner,Bob Anthony,REP,550204,0,0,173,173,
Oklahoma,Corporation Commissioner,Brian Bingman,REP,550204,0,0,86,86,
Oklahoma,Governor,Chris Powell,LIB,550204,0,0,3,3,
Oklahoma,Governor,Rex Lawhorn,LIB,550204,0,0,0,0,
Oklahoma,Corporation Commissioner,Ashley Nicole Mccray,DEM,550204,0,0,343,343,
Oklahoma,Corporation Commissioner,Blake Cummings,DEM,550204,0,0,78,78,
Oklahoma,U.S. House,Kendra Horn,DEM,550204,0,0,398,398,05
Oklahoma,U.S. House,Tom Guild,DEM,550204,0,0,38,38,05
Oklahoma,Governor,Mick Cornett,REP,550205,0,0,91,91,
Oklahoma,Governor,Kevin Stitt,REP,550205,0,0,26,26,
Oklahoma,Lieutenant Governor,Dana Murphy,REP,550205,0,0,43,43,
Oklahoma,Lieutenant Governor,Matt Pinnell,REP,550205,0,0,66,66,
Oklahoma,State Auditor,Cindy Byrd,REP,550205,0,0,53,53,
Oklahoma,State Auditor,Charlie Prater,REP,550205,0,0,51,51,
Oklahoma,Attorney General,Mike Hunter,REP,550205,0,0,71,71,
Oklahoma,Attorney General,Gentner Drummond,REP,550205,0,0,41,41,
Oklahoma,Superintendent of Public Instruction,Joy Hofmeister,REP,550205,0,0,72,72,
Oklahoma,Superintendent of Public Instruction,Linda Murphy,REP,550205,0,0,39,39,
Oklahoma,Commissioner of Labor,Cathy Costello,REP,550205,0,0,46,46,
Oklahoma,Commissioner of Labor,Leslie Osborn,REP,550205,0,0,57,57,
Oklahoma,Corporation Commissioner,Bob Anthony,REP,550205,0,0,60,60,
Oklahoma,Corporation Commissioner,Brian Bingman,REP,550205,0,0,46,46,
Oklahoma,Governor,Chris Powell,LIB,550205,0,0,1,1,
Oklahoma,Governor,Rex Lawhorn,LIB,550205,0,0,2,2,
Oklahoma,Corporation Commissioner,Ashley Nicole Mccray,DEM,550205,0,0,94,94,
Oklahoma,Corporation Commissioner,Blake Cummings,DEM,550205,0,0,23,23,
Oklahoma,U.S. House,Kendra Horn,DEM,550205,0,0,104,104,05
Oklahoma,U.S. House,Tom Guild,DEM,550205,0,0,15,15,05
Oklahoma,Governor,Mick Cornett,REP,550206,0,0,15,15,
Oklahoma,Governor,Kevin Stitt,REP,550206,0,0,14,14,
Oklahoma,Lieutenant Governor,Dana Murphy,REP,550206,0,0,9,9,
Oklahoma,Lieutenant Governor,Matt Pinnell,REP,550206,0,0,19,19,
Oklahoma,State Auditor,Cindy Byrd,REP,550206,0,0,13,13,
Oklahoma,State Auditor,Charlie Prater,REP,550206,0,0,16,16,
Oklahoma,Attorney General,Mike Hunter,REP,550206,0,0,14,14,
Oklahoma,Attorney General,Gentner Drummond,REP,550206,0,0,15,15,
Oklahoma,Superintendent of Public Instruction,Joy Hofmeister,REP,550206,0,0,12,12,
Oklahoma,Superintendent of Public Instruction,Linda Murphy,REP,550206,0,0,17,17,
Oklahoma,Commissioner of Labor,Cathy Costello,REP,550206,0,0,17,17,
Oklahoma,Commissioner of Labor,Leslie Osborn,REP,550206,0,0,12,12,
Oklahoma,Corporation Commissioner,Bob Anthony,REP,550206,0,0,15,15,
Oklahoma,Corporation Commissioner,Brian Bingman,REP,550206,0,0,14,14,
Oklahoma,Governor,Chris Powell,LIB,550206,0,0,0,0,
Oklahoma,Governor,Rex Lawhorn,LIB,550206,0,0,0,0,
Oklahoma,Corporation Commissioner,Ashley Nicole Mccray,DEM,550206,0,0,25,25,
Oklahoma,Corporation Commissioner,Blake Cummings,DEM,550206,0,0,21,21,
Oklahoma,U.S. House,Kendra Horn,DEM,550206,0,0,26,26,05
Oklahoma,U.S. House,Tom Guild,DEM,550206,0,0,18,18,05
Oklahoma,Governor,Mick Cornett,REP,550207,0,0,33,33,
Oklahoma,Governor,Kevin Stitt,REP,550207,0,0,49,49,
Oklahoma,Lieutenant Governor,Dana Murphy,REP,550207,0,0,32,32,
Oklahoma,Lieutenant Governor,Matt Pinnell,REP,550207,0,0,49,49,
Oklahoma,State Auditor,Cindy Byrd,REP,550207,0,0,33,33,
Oklahoma,State Auditor,Charlie Prater,REP,550207,0,0,44,44,
Oklahoma,Attorney General,Mike Hunter,REP,550207,0,0,36,36,
Oklahoma,Attorney General,Gentner Drummond,REP,550207,0,0,45,45,
Oklahoma,Superintendent of Public Instruction,Joy Hofmeister,REP,550207,0,0,44,44,
Oklahoma,Superintendent of Public Instruction,Linda Murphy,REP,550207,0,0,35,35,
Oklahoma,Commissioner of Labor,Cathy Costello,REP,550207,0,0,35,35,
Oklahoma,Commissioner of Labor,Leslie Osborn,REP,550207,0,0,44,44,
Oklahoma,Corporation Commissioner,Bob Anthony,REP,550207,0,0,48,48,
Oklahoma,Corporation Commissioner,Brian Bingman,REP,550207,0,0,32,32,
Oklahoma,Governor,Chris Powell,LIB,550207,0,0,0,0,
Oklahoma,Governor,Rex Lawhorn,LIB,550207,0,0,0,0,
Oklahoma,Corporation Commissioner,Ashley Nicole Mccray,DEM,550207,0,0,25,25,
Oklahoma,Corporation Commissioner,Blake Cummings,DEM,550207,0,0,12,12,
Oklahoma,U.S. House,Kendra Horn,DEM,550207,0,0,24,24,05
Oklahoma,U.S. House,Tom Guild,DEM,550207,0,0,13,13,05
Oklahoma,Governor,Mick Cornett,REP,550208,0,0,1,1,
Oklahoma,Governor,Kevin Stitt,REP,550208,0,0,1,1,
Oklahoma,Lieutenant Governor,Dana Murphy,REP,550208,0,0,0,0,
Oklahoma,Lieutenant Governor,Matt Pinnell,REP,550208,0,0,2,2,
Oklahoma,State Auditor,Cindy Byrd,REP,550208,0,0,1,1,
Oklahoma,State Auditor,Charlie Prater,REP,550208,0,0,0,0,
Oklahoma,Attorney General,Mike Hunter,REP,550208,0,0,1,1,
Oklahoma,Attorney General,Gentner Drummond,REP,550208,0,0,1,1,
Oklahoma,Superintendent of Public Instruction,Joy Hofmeister,REP,550208,0,0,1,1,
Oklahoma,Superintendent of Public Instruction,Linda Murphy,REP,550208,0,0,0,0,
Oklahoma,Commissioner of Labor,Cathy Costello,REP,550208,0,0,0,0,
Oklahoma,Commissioner of Labor,Leslie Osborn,REP,550208,0,0,2,2,
Oklahoma,Corporation Commissioner,Bob Anthony,REP,550208,0,0,0,0,
Oklahoma,Corporation Commissioner,Brian Bingman,REP,550208,0,0,1,1,
Oklahoma,Governor,Chris Powell,LIB,550208,0,0,0,0,
Oklahoma,Governor,Rex Lawhorn,LIB,550208,0,0,0,0,
Oklahoma,Corporation Commissioner,Ashley Nicole Mccray,DEM,550208,0,0,1,1,
Oklahoma,Corporation Commissioner,Blake Cummings,DEM,550208,0,0,1,1,
Oklahoma,U.S. House,Kendra Horn,DEM,550208,0,0,1,1,05
Oklahoma,U.S. House,Tom Guild,DEM,550208,0,0,1,1,05
Oklahoma,Governor,Mick Cornett,REP,550209,0,0,22,22,
Oklahoma,Governor,Kevin Stitt,REP,550209,0,0,38,38,
Oklahoma,Lieutenant Governor,Dana Murphy,REP,550209,0,0,23,23,
Oklahoma,Lieutenant Governor,Matt Pinnell,REP,550209,0,0,35,35,
Oklahoma,State Auditor,Cindy Byrd,REP,550209,0,0,26,26,
Oklahoma,State Auditor,Charlie Prater,REP,550209,0,0,32,32,
Oklahoma,Attorney General,Mike Hunter,REP,550209,0,0,35,35,
Oklahoma,Attorney General,Gentner Drummond,REP,550209,0,0,24,24,
Oklahoma,Superintendent of Public Instruction,Joy Hofmeister,REP,550209,0,0,36,36,
Oklahoma,Superintendent of Public Instruction,Linda Murphy,REP,550209,0,0,24,24,
Oklahoma,Commissioner of Labor,Cathy Costello,REP,550209,0,0,31,31,
Oklahoma,Commissioner of Labor,Leslie Osborn,REP,550209,0,0,28,28,
Oklahoma,Corporation Commissioner,Bob Anthony,REP,550209,0,0,38,38,
Oklahoma,Corporation Commissioner,Brian Bingman,REP,550209,0,0,21,21,
Oklahoma,Governor,Chris Powell,LIB,550209,0,0,0,0,
Oklahoma,Governor,Rex Lawhorn,LIB,550209,0,0,1,1,
Oklahoma,Corporation Commissioner,Ashley Nicole Mccray,DEM,550209,0,0,22,22,
Oklahoma,Corporation Commissioner,Blake Cummings,DEM,550209,0,0,12,12,
Oklahoma,U.S. House,Kendra Horn,DEM,550209,0,0,21,21,05
Oklahoma,U.S. House,Tom Guild,DEM,550209,0,0,13,13,05
Oklahoma,Governor,Mick Cornett,REP,550210,0,0,27,27,
Oklahoma,Governor,Kevin Stitt,REP,550210,0,0,27,27,
Oklahoma,Lieutenant Governor,Dana Murphy,REP,550210,0,0,16,16,
Oklahoma,Lieutenant Governor,Matt Pinnell,REP,550210,0,0,34,34,
Oklahoma,State Auditor,Cindy Byrd,REP,550210,0,0,23,23,
Oklahoma,State Auditor,Charlie Prater,REP,550210,0,0,27,27,
Oklahoma,Attorney General,Mike Hunter,REP,550210,0,0,34,34,
Oklahoma,Attorney General,Gentner Drummond,REP,550210,0,0,19,19,
Oklahoma,Superintendent of Public Instruction,Joy Hofmeister,REP,550210,0,0,32,32,
Oklahoma,Superintendent of Public Instruction,Linda Murphy,REP,550210,0,0,19,19,
Oklahoma,Commissioner of Labor,Cathy Costello,REP,550210,0,0,23,23,
Oklahoma,Commissioner of Labor,Leslie Osborn,REP,550210,0,0,28,28,
Oklahoma,Corporation Commissioner,Bob Anthony,REP,550210,0,0,36,36,
Oklahoma,Corporation Commissioner,Brian Bingman,REP,550210,0,0,15,15,
Oklahoma,Governor,Chris Powell,LIB,550210,0,0,0,0,
Oklahoma,Governor,Rex Lawhorn,LIB,550210,0,0,1,1,
Oklahoma,Corporation Commissioner,Ashley Nicole Mccray,DEM,550210,0,0,30,30,
Oklahoma,Corporation Commissioner,Blake Cummings,DEM,550210,0,0,11,11,
Oklahoma,U.S. House,Kendra Horn,DEM,550210,0,0,31,31,05
Oklahoma,U.S. House,Tom Guild,DEM,550210,0,0,10,10,05
Oklahoma,Governor,Mick Cornett,REP,550211,0,0,27,27,
Oklahoma,Governor,Kevin Stitt,REP,550211,0,0,29,29,
Oklahoma,Lieutenant Governor,Dana Murphy,REP,550211,0,0,28,28,
Oklahoma,Lieutenant Governor,Matt Pinnell,REP,550211,0,0,28,28,
Oklahoma,State Auditor,Cindy Byrd,REP,550211,0,0,23,23,
Oklahoma,State Auditor,Charlie Prater,REP,550211,0,0,33,33,
Oklahoma,Attorney General,Mike Hunter,REP,550211,0,0,30,30,
Oklahoma,Attorney General,Gentner Drummond,REP,550211,0,0,25,25,
Oklahoma,Superintendent of Public Instruction,Joy Hofmeister,REP,550211,0,0,27,27,
Oklahoma,Superintendent of Public Instruction,Linda Murphy,REP,550211,0,0,28,28,
Oklahoma,Commissioner of Labor,Cathy Costello,REP,550211,0,0,26,26,
Oklahoma,Commissioner of Labor,Leslie Osborn,REP,550211,0,0,28,28,
Oklahoma,Corporation Commissioner,Bob Anthony,REP,550211,0,0,27,27,
Oklahoma,Corporation Commissioner,Brian Bingman,REP,550211,0,0,29,29,
Oklahoma,Governor,Chris Powell,LIB,550211,0,0,0,0,
Oklahoma,Governor,Rex Lawhorn,LIB,550211,0,0,0,0,
Oklahoma,Corporation Commissioner,Ashley Nicole Mccray,DEM,550211,0,0,18,18,
Oklahoma,Corporation Commissioner,Blake Cummings,DEM,550211,0,0,12,12,
Oklahoma,U.S. House,Kendra Horn,DEM,550211,0,0,23,23,05
Oklahoma,U.S. House,Tom Guild,DEM,550211,0,0,9,9,05
Oklahoma,Governor,Mick Cornett,REP,550212,0,0,27,27,
Oklahoma,Governor,Kevin Stitt,REP,550212,0,0,29,29,
Oklahoma,Lieutenant Governor,Dana Murphy,REP,550212,0,0,27,27,
Oklahoma,Lieutenant Governor,Matt Pinnell,REP,550212,0,0,28,28,
Oklahoma,State Auditor,Cindy Byrd,REP,550212,0,0,26,26,
Oklahoma,State Auditor,Charlie Prater,REP,550212,0,0,28,28,
Oklahoma,Attorney General,Mike Hunter,REP,550212,0,0,34,34,
Oklahoma,Attorney General,Gentner Drummond,REP,550212,0,0,20,20,
Oklahoma,Superintendent of Public Instruction,Joy Hofmeister,REP,550212,0,0,31,31,
Oklahoma,Superintendent of Public Instruction,Linda Murphy,REP,550212,0,0,24,24,
Oklahoma,Commissioner of Labor,Cathy Costello,REP,550212,0,0,32,32,
Oklahoma,Commissioner of Labor,Leslie Osborn,REP,550212,0,0,23,23,
Oklahoma,Corporation Commissioner,Bob Anthony,REP,550212,0,0,34,34,
Oklahoma,Corporation Commissioner,Brian Bingman,REP,550212,0,0,18,18,
Oklahoma,Governor,Chris Powell,LIB,550212,0,0,0,0,
Oklahoma,Governor,Rex Lawhorn,LIB,550212,0,0,0,0,
Oklahoma,Corporation Commissioner,Ashley Nicole Mccray,DEM,550212,0,0,17,17,
Oklahoma,Corporation Commissioner,Blake Cummings,DEM,550212,0,0,16,16,
Oklahoma,U.S. House,Kendra Horn,DEM,550212,0,0,18,18,05
Oklahoma,U.S. House,Tom Guild,DEM,550212,0,0,15,15,05
Oklahoma,Governor,Mick Cornett,REP,550213,0,0,14,14,
Oklahoma,Governor,Kevin Stitt,REP,550213,0,0,7,7,
Oklahoma,Lieutenant Governor,Dana Murphy,REP,550213,0,0,8,8,
Oklahoma,Lieutenant Governor,Matt Pinnell,REP,550213,0,0,13,13,
Oklahoma,State Auditor,Cindy Byrd,REP,550213,0,0,8,8,
Oklahoma,State Auditor,Charlie Prater,REP,550213,0,0,13,13,
Oklahoma,Attorney General,Mike Hunter,REP,550213,0,0,6,6,
Oklahoma,Attorney General,Gentner Drummond,REP,550213,0,0,15,15,
Oklahoma,Superintendent of Public Instruction,Joy Hofmeister,REP,550213,0,0,9,9,
Oklahoma,Superintendent of Public Instruction,Linda Murphy,REP,550213,0,0,12,12,
Oklahoma,Commissioner of Labor,Cathy Costello,REP,550213,0,0,4,4,
Oklahoma,Commissioner of Labor,Leslie Osborn,REP,550213,0,0,15,15,
Oklahoma,Corporation Commissioner,Bob Anthony,REP,550213,0,0,11,11,
Oklahoma,Corporation Commissioner,Brian Bingman,REP,550213,0,0,10,10,
Oklahoma,Governor,Chris Powell,LIB,550213,0,0,0,0,
Oklahoma,Governor,Rex Lawhorn,LIB,550213,0,0,0,0,
Oklahoma,Corporation Commissioner,Ashley Nicole Mccray,DEM,550213,0,0,15,15,
Oklahoma,Corporation Commissioner,Blake Cummings,DEM,550213,0,0,5,5,
Oklahoma,U.S. House,Kendra Horn,DEM,550213,0,0,12,12,05
Oklahoma,U.S. House,Tom Guild,DEM,550213,0,0,9,9,05
Oklahoma,Governor,Mick Cornett,REP,550214,0,0,25,25,
Oklahoma,Governor,Kevin Stitt,REP,550214,0,0,32,32,
Oklahoma,Lieutenant Governor,Dana Murphy,REP,550214,0,0,23,23,
Oklahoma,Lieutenant Governor,Matt Pinnell,REP,550214,0,0,34,34,
Oklahoma,State Auditor,Cindy Byrd,REP,550214,0,0,23,23,
Oklahoma,State Auditor,Charlie Prater,REP,550214,0,0,34,34,
Oklahoma,Attorney General,Mike Hunter,REP,550214,0,0,24,24,
Oklahoma,Attorney General,Gentner Drummond,REP,550214,0,0,32,32,
Oklahoma,Superintendent of Public Instruction,Joy Hofmeister,REP,550214,0,0,30,30,
Oklahoma,Superintendent of Public Instruction,Linda Murphy,REP,550214,0,0,28,28,
Oklahoma,Commissioner of Labor,Cathy Costello,REP,550214,0,0,17,17,
Oklahoma,Commissioner of Labor,Leslie Osborn,REP,550214,0,0,38,38,
Oklahoma,Corporation Commissioner,Bob Anthony,REP,550214,0,0,33,33,
Oklahoma,Corporation Commissioner,Brian Bingman,REP,550214,0,0,23,23,
Oklahoma,Governor,Chris Powell,LIB,550214,0,0,0,0,
Oklahoma,Governor,Rex Lawhorn,LIB,550214,0,0,0,0,
Oklahoma,Corporation Commissioner,Ashley Nicole Mccray,DEM,550214,0,0,14,14,
Oklahoma,Corporation Commissioner,Blake Cummings,DEM,550214,0,0,9,9,
Oklahoma,U.S. House,Kendra Horn,DEM,550214,0,0,17,17,05
Oklahoma,U.S. House,Tom Guild,DEM,550214,0,0,6,6,05
Oklahoma,Governor,Mick Cornett,REP,550215,0,0,25,25,
Oklahoma,Governor,Kevin Stitt,REP,550215,0,0,39,39,
Oklahoma,Lieutenant Governor,Dana Murphy,REP,550215,0,0,24,24,
Oklahoma,Lieutenant Governor,Matt Pinnell,REP,550215,0,0,40,40,
Oklahoma,State Auditor,Cindy Byrd,REP,550215,0,0,21,21,
Oklahoma,State Auditor,Charlie Prater,REP,550215,0,0,42,42,
Oklahoma,Attorney General,Mike Hunter,REP,550215,0,0,31,31,
Oklahoma,Attorney General,Gentner Drummond,REP,550215,0,0,33,33,
Oklahoma,Superintendent of Public Instruction,Joy Hofmeister,REP,550215,0,0,28,28,
Oklahoma,Superintendent of Public Instruction,Linda Murphy,REP,550215,0,0,36,36,
Oklahoma,Commissioner of Labor,Cathy Costello,REP,550215,0,0,24,24,
Oklahoma,Commissioner of Labor,Leslie Osborn,REP,550215,0,0,40,40,
Oklahoma,Corporation Commissioner,Bob Anthony,REP,550215,0,0,34,34,
Oklahoma,Corporation Commissioner,Brian Bingman,REP,550215,0,0,30,30,
Oklahoma,Governor,Chris Powell,LIB,550215,0,0,0,0,
Oklahoma,Governor,Rex Lawhorn,LIB,550215,0,0,0,0,
Oklahoma,Corporation Commissioner,Ashley Nicole Mccray,DEM,550215,0,0,29,29,
Oklahoma,Corporation Commissioner,Blake Cummings,DEM,550215,0,0,22,22,
Oklahoma,U.S. House,Kendra Horn,DEM,550215,0,0,24,24,05
Oklahoma,U.S. House,Tom Guild,DEM,550215,0,0,27,27,05
Oklahoma,Governor,Mick Cornett,REP,550216,0,0,0,0,
Oklahoma,Governor,Kevin Stitt,REP,550216,0,0,2,2,
Oklahoma,Lieutenant Governor,Dana Murphy,REP,550216,0,0,1,1,
Oklahoma,Lieutenant Governor,Matt Pinnell,REP,550216,0,0,1,1,
Oklahoma,State Auditor,Cindy Byrd,REP,550216,0,0,0,0,
Oklahoma,State Auditor,Charlie Prater,REP,550216,0,0,2,2,
Oklahoma,Attorney General,Mike Hunter,REP,550216,0,0,0,0,
Oklahoma,Attorney General,Gentner Drummond,REP,550216,0,0,2,2,
Oklahoma,Superintendent of Public Instruction,Joy Hofmeister,REP,550216,0,0,1,1,
Oklahoma,Superintendent of Public Instruction,Linda Murphy,REP,550216,0,0,1,1,
Oklahoma,Commissioner of Labor,Cathy Costello,REP,550216,0,0,0,0,
Oklahoma,Commissioner of Labor,Leslie Osborn,REP,550216,0,0,2,2,
Oklahoma,Corporation Commissioner,Bob Anthony,REP,550216,0,0,2,2,
Oklahoma,Corporation Commissioner,Brian Bingman,REP,550216,0,0,0,0,
Oklahoma,Governor,Chris Powell,LIB,550216,0,0,0,0,
Oklahoma,Governor,Rex Lawhorn,LIB,550216,0,0,0,0,
Oklahoma,Corporation Commissioner,Ashley Nicole Mccray,DEM,550216,0,0,1,1,
Oklahoma,Corporation Commissioner,Blake Cummings,DEM,550216,0,0,0,0,
Oklahoma,U.S. House,Kendra Horn,DEM,550216,0,0,1,1,05
Oklahoma,U.S. House,Tom Guild,DEM,550216,0,0,0,0,05
Oklahoma,Governor,Mick Cornett,REP,550217,0,0,38,38,
Oklahoma,Governor,Kevin Stitt,REP,550217,0,0,59,59,
Oklahoma,Lieutenant Governor,Dana Murphy,REP,550217,0,0,34,34,
Oklahoma,Lieutenant Governor,Matt Pinnell,REP,550217,0,0,62,62,
Oklahoma,State Auditor,Cindy Byrd,REP,550217,0,0,40,40,
Oklahoma,State Auditor,Charlie Prater,REP,550217,0,0,55,55,
Oklahoma,Attorney General,Mike Hunter,REP,550217,0,0,52,52,
Oklahoma,Attorney General,Gentner Drummond,REP,550217,0,0,43,43,
Oklahoma,Superintendent of Public Instruction,Joy Hofmeister,REP,550217,0,0,47,47,
Oklahoma,Superintendent of Public Instruction,Linda Murphy,REP,550217,0,0,50,50,
Oklahoma,Commissioner of Labor,Cathy Costello,REP,550217,0,0,47,47,
Oklahoma,Commissioner of Labor,Leslie Osborn,REP,550217,0,0,48,48,
Oklahoma,Corporation Commissioner,Bob Anthony,REP,550217,0,0,49,49,
Oklahoma,Corporation Commissioner,Brian Bingman,REP,550217,0,0,47,47,
Oklahoma,Governor,Chris Powell,LIB,550217,0,0,0,0,
Oklahoma,Governor,Rex Lawhorn,LIB,550217,0,0,0,0,
Oklahoma,Corporation Commissioner,Ashley Nicole Mccray,DEM,550217,0,0,30,30,
Oklahoma,Corporation Commissioner,Blake Cummings,DEM,550217,0,0,12,12,
Oklahoma,U.S. House,Kendra Horn,DEM,550217,0,0,26,26,05
Oklahoma,U.S. House,Tom Guild,DEM,550217,0,0,17,17,05
Oklahoma,Governor,Mick Cornett,REP,550218,0,0,66,66,
Oklahoma,Governor,Kevin Stitt,REP,550218,0,0,88,88,
Oklahoma,Lieutenant Governor,Dana Murphy,REP,550218,0,0,54,54,
Oklahoma,Lieutenant Governor,Matt Pinnell,REP,550218,0,0,99,99,
Oklahoma,State Auditor,Cindy Byrd,REP,550218,0,0,58,58,
Oklahoma,State Auditor,Charlie Prater,REP,550218,0,0,90,90,
Oklahoma,Attorney General,Mike Hunter,REP,550218,0,0,84,84,
Oklahoma,Attorney General,Gentner Drummond,REP,550218,0,0,68,68,
Oklahoma,Superintendent of Public Instruction,Joy Hofmeister,REP,550218,0,0,85,85,
Oklahoma,Superintendent of Public Instruction,Linda Murphy,REP,550218,0,0,69,69,
Oklahoma,Commissioner of Labor,Cathy Costello,REP,550218,0,0,73,73,
Oklahoma,Commissioner of Labor,Leslie Osborn,REP,550218,0,0,78,78,
Oklahoma,Corporation Commissioner,Bob Anthony,REP,550218,0,0,72,72,
Oklahoma,Corporation Commissioner,Brian Bingman,REP,550218,0,0,80,80,
Oklahoma,Governor,Chris Powell,LIB,550218,0,0,0,0,
Oklahoma,Governor,Rex Lawhorn,LIB,550218,0,0,1,1,
Oklahoma,Corporation Commissioner,Ashley Nicole Mccray,DEM,550218,0,0,40,40,
Oklahoma,Corporation Commissioner,Blake Cummings,DEM,550218,0,0,20,20,
Oklahoma,U.S. House,Kendra Horn,DEM,550218,0,0,36,36,05
Oklahoma,U.S. House,Tom Guild,DEM,550218,0,0,25,25,05
Oklahoma,Governor,Mick Cornett,REP,550219,0,0,30,30,
Oklahoma,Governor,Kevin Stitt,REP,550219,0,0,24,24,
Oklahoma,Lieutenant Governor,Dana Murphy,REP,550219,0,0,22,22,
Oklahoma,Lieutenant Governor,Matt Pinnell,REP,550219,0,0,32,32,
Oklahoma,State Auditor,Cindy Byrd,REP,550219,0,0,22,22,
Oklahoma,State Auditor,Charlie Prater,REP,550219,0,0,31,31,
Oklahoma,Attorney General,Mike Hunter,REP,550219,0,0,29,29,
Oklahoma,Attorney General,Gentner Drummond,REP,550219,0,0,25,25,
Oklahoma,Superintendent of Public Instruction,Joy Hofmeister,REP,550219,0,0,27,27,
Oklahoma,Superintendent of Public Instruction,Linda Murphy,REP,550219,0,0,26,26,
Oklahoma,Commissioner of Labor,Cathy Costello,REP,550219,0,0,23,23,
Oklahoma,Commissioner of Labor,Leslie Osborn,REP,550219,0,0,30,30,
Oklahoma,Corporation Commissioner,Bob Anthony,REP,550219,0,0,38,38,
Oklahoma,Corporation Commissioner,Brian Bingman,REP,550219,0,0,15,15,
Oklahoma,Governor,Chris Powell,LIB,550219,0,0,0,0,
Oklahoma,Governor,Rex Lawhorn,LIB,550219,0,0,0,0,
Oklahoma,Corporation Commissioner,Ashley Nicole Mccray,DEM,550219,0,0,32,32,
Oklahoma,Corporation Commissioner,Blake Cummings,DEM,550219,0,0,9,9,
Oklahoma,U.S. House,Kendra Horn,DEM,550219,0,0,31,31,05
Oklahoma,U.S. House,Tom Guild,DEM,550219,0,0,10,10,05
Oklahoma,Governor,Mick Cornett,REP,550220,0,0,59,59,
Oklahoma,Governor,Kevin Stitt,REP,550220,0,0,61,61,
Oklahoma,Lieutenant Governor,Dana Murphy,REP,550220,0,0,47,47,
Oklahoma,Lieutenant Governor,Matt Pinnell,REP,550220,0,0,71,71,
Oklahoma,State Auditor,Cindy Byrd,REP,550220,0,0,50,50,
Oklahoma,State Auditor,Charlie Prater,REP,550220,0,0,62,62,
Oklahoma,Attorney General,Mike Hunter,REP,550220,0,0,63,63,
Oklahoma,Attorney General,Gentner Drummond,REP,550220,0,0,55,55,
Oklahoma,Superintendent of Public Instruction,Joy Hofmeister,REP,550220,0,0,62,62,
Oklahoma,Superintendent of Public Instruction,Linda Murphy,REP,550220,0,0,55,55,
Oklahoma,Commissioner of Labor,Cathy Costello,REP,550220,0,0,54,54,
Oklahoma,Commissioner of Labor,Leslie Osborn,REP,550220,0,0,64,64,
Oklahoma,Corporation Commissioner,Bob Anthony,REP,550220,0,0,63,63,
Oklahoma,Corporation Commissioner,Brian Bingman,REP,550220,0,0,57,57,
Oklahoma,Governor,Chris Powell,LIB,550220,0,0,0,0,
Oklahoma,Governor,Rex Lawhorn,LIB,550220,0,0,0,0,
Oklahoma,Corporation Commissioner,Ashley Nicole Mccray,DEM,550220,0,0,36,36,
Oklahoma,Corporation Commissioner,Blake Cummings,DEM,550220,0,0,15,15,
Oklahoma,U.S. House,Kendra Horn,DEM,550220,0,0,32,32,05
Oklahoma,U.S. House,Tom Guild,DEM,550220,0,0,19,19,05
Oklahoma,Governor,Mick Cornett,REP,550221,0,0,84,84,
Oklahoma,Governor,Kevin Stitt,REP,550221,0,0,106,106,
Oklahoma,Lieutenant Governor,Dana Murphy,REP,550221,0,0,67,67,
Oklahoma,Lieutenant Governor,Matt Pinnell,REP,550221,0,0,124,124,
Oklahoma,State Auditor,Cindy Byrd,REP,550221,0,0,86,86,
Oklahoma,State Auditor,Charlie Prater,REP,550221,0,0,102,102,
Oklahoma,Attorney General,Mike Hunter,REP,550221,0,0,107,107,
Oklahoma,Attorney General,Gentner Drummond,REP,550221,0,0,83,83,
Oklahoma,Superintendent of Public Instruction,Joy Hofmeister,REP,550221,0,0,103,103,
Oklahoma,Superintendent of Public Instruction,Linda Murphy,REP,550221,0,0,85,85,
Oklahoma,Commissioner of Labor,Cathy Costello,REP,550221,0,0,78,78,
Oklahoma,Commissioner of Labor,Leslie Osborn,REP,550221,0,0,113,113,
Oklahoma,Corporation Commissioner,Bob Anthony,REP,550221,0,0,114,114,
Oklahoma,Corporation Commissioner,Brian Bingman,REP,550221,0,0,75,75,
Oklahoma,Governor,Chris Powell,LIB,550221,0,0,1,1,
Oklahoma,Governor,Rex Lawhorn,LIB,550221,0,0,1,1,
Oklahoma,Corporation Commissioner,Ashley Nicole Mccray,DEM,550221,0,0,51,51,
Oklahoma,Corporation Commissioner,Blake Cummings,DEM,550221,0,0,26,26,
Oklahoma,U.S. House,Kendra Horn,DEM,550221,0,0,49,49,05
Oklahoma,U.S. House,Tom Guild,DEM,550221,0,0,27,27,05
Oklahoma,Governor,Mick Cornett,REP,550222,0,0,40,40,
Oklahoma,Governor,Kevin Stitt,REP,550222,0,0,50,50,
Oklahoma,Lieutenant Governor,Dana Murphy,REP,550222,0,0,39,39,
Oklahoma,Lieutenant Governor,Matt Pinnell,REP,550222,0,0,46,46,
Oklahoma,State Auditor,Cindy Byrd,REP,550222,0,0,42,42,
Oklahoma,State Auditor,Charlie Prater,REP,550222,0,0,43,43,
Oklahoma,Attorney General,Mike Hunter,REP,550222,0,0,42,42,
Oklahoma,Attorney General,Gentner Drummond,REP,550222,0,0,46,46,
Oklahoma,Superintendent of Public Instruction,Joy Hofmeister,REP,550222,0,0,47,47,
Oklahoma,Superintendent of Public Instruction,Linda Murphy,REP,550222,0,0,38,38,
Oklahoma,Commissioner of Labor,Cathy Costello,REP,550222,0,0,40,40,
Oklahoma,Commissioner of Labor,Leslie Osborn,REP,550222,0,0,44,44,
Oklahoma,Corporation Commissioner,Bob Anthony,REP,550222,0,0,45,45,
Oklahoma,Corporation Commissioner,Brian Bingman,REP,550222,0,0,42,42,
Oklahoma,Governor,Chris Powell,LIB,550222,0,0,0,0,
Oklahoma,Governor,Rex Lawhorn,LIB,550222,0,0,0,0,
Oklahoma,Corporation Commissioner,Ashley Nicole Mccray,DEM,550222,0,0,34,34,
Oklahoma,Corporation Commissioner,Blake Cummings,DEM,550222,0,0,12,12,
Oklahoma,U.S. House,Kendra Horn,DEM,550222,0,0,36,36,05
Oklahoma,U.S. House,Tom Guild,DEM,550222,0,0,12,12,05
Oklahoma,Governor,Mick Cornett,REP,550223,0,0,27,27,
Oklahoma,Governor,Kevin Stitt,REP,550223,0,0,29,29,
Oklahoma,Lieutenant Governor,Dana Murphy,REP,550223,0,0,24,24,
Oklahoma,Lieutenant Governor,Matt Pinnell,REP,550223,0,0,32,32,
Oklahoma,State Auditor,Cindy Byrd,REP,550223,0,0,26,26,
Oklahoma,State Auditor,Charlie Prater,REP,550223,0,0,30,30,
Oklahoma,Attorney General,Mike Hunter,REP,550223,0,0,27,27,
Oklahoma,Attorney General,Gentner Drummond,REP,550223,0,0,30,30,
Oklahoma,Superintendent of Public Instruction,Joy Hofmeister,REP,550223,0,0,28,28,
Oklahoma,Superintendent of Public Instruction,Linda Murphy,REP,550223,0,0,27,27,
Oklahoma,Commissioner of Labor,Cathy Costello,REP,550223,0,0,25,25,
Oklahoma,Commissioner of Labor,Leslie Osborn,REP,550223,0,0,31,31,
Oklahoma,Corporation Commissioner,Bob Anthony,REP,550223,0,0,31,31,
Oklahoma,Corporation Commissioner,Brian Bingman,REP,550223,0,0,24,24,
Oklahoma,Governor,Chris Powell,LIB,550223,0,0,1,1,
Oklahoma,Governor,Rex Lawhorn,LIB,550223,0,0,0,0,
Oklahoma,Corporation Commissioner,Ashley Nicole Mccray,DEM,550223,0,0,31,31,
Oklahoma,Corporation Commissioner,Blake Cummings,DEM,550223,0,0,16,16,
Oklahoma,U.S. House,Kendra Horn,DEM,550223,0,0,31,31,05
Oklahoma,U.S. House,Tom Guild,DEM,550223,0,0,16,16,05
Oklahoma,Governor,Mick Cornett,REP,550224,0,0,28,28,
Oklahoma,Governor,Kevin Stitt,REP,550224,0,0,43,43,
Oklahoma,Lieutenant Governor,Dana Murphy,REP,550224,0,0,31,31,
Oklahoma,Lieutenant Governor,Matt Pinnell,REP,550224,0,0,39,39,
Oklahoma,State Auditor,Cindy Byrd,REP,550224,0,0,29,29,
Oklahoma,State Auditor,Charlie Prater,REP,550224,0,0,42,42,
Oklahoma,Attorney General,Mike Hunter,REP,550224,0,0,39,39,
Oklahoma,Attorney General,Gentner Drummond,REP,550224,0,0,31,31,
Oklahoma,Superintendent of Public Instruction,Joy Hofmeister,REP,550224,0,0,22,22,
Oklahoma,Superintendent of Public Instruction,Linda Murphy,REP,550224,0,0,47,47,
Oklahoma,Commissioner of Labor,Cathy Costello,REP,550224,0,0,26,26,
Oklahoma,Commissioner of Labor,Leslie Osborn,REP,550224,0,0,42,42,
Oklahoma,Corporation Commissioner,Bob Anthony,REP,550224,0,0,41,41,
Oklahoma,Corporation Commissioner,Brian Bingman,REP,550224,0,0,29,29,
Oklahoma,Governor,Chris Powell,LIB,550224,0,0,0,0,
Oklahoma,Governor,Rex Lawhorn,LIB,550224,0,0,0,0,
Oklahoma,Corporation Commissioner,Ashley Nicole Mccray,DEM,550224,0,0,45,45,
Oklahoma,Corporation Commissioner,Blake Cummings,DEM,550224,0,0,18,18,
Oklahoma,U.S. House,Kendra Horn,DEM,550224,0,0,35,35,05
Oklahoma,U.S. House,Tom Guild,DEM,550224,0,0,27,27,05
Oklahoma,Governor,Mick Cornett,REP,550225,0,0,7,7,
Oklahoma,Governor,Kevin Stitt,REP,550225,0,0,8,8,
Oklahoma,Lieutenant Governor,Dana Murphy,REP,550225,0,0,5,5,
Oklahoma,Lieutenant Governor,Matt Pinnell,REP,550225,0,0,10,10,
Oklahoma,State Auditor,Cindy Byrd,REP,550225,0,0,9,9,
Oklahoma,State Auditor,Charlie Prater,REP,550225,0,0,5,5,
Oklahoma,Attorney General,Mike Hunter,REP,550225,0,0,8,8,
Oklahoma,Attorney General,Gentner Drummond,REP,550225,0,0,6,6,
Oklahoma,Superintendent of Public Instruction,Joy Hofmeister,REP,550225,0,0,7,7,
Oklahoma,Superintendent of Public Instruction,Linda Murphy,REP,550225,0,0,8,8,
Oklahoma,Commissioner of Labor,Cathy Costello,REP,550225,0,0,3,3,
Oklahoma,Commissioner of Labor,Leslie Osborn,REP,550225,0,0,12,12,
Oklahoma,Corporation Commissioner,Bob Anthony,REP,550225,0,0,8,8,
Oklahoma,Corporation Commissioner,Brian Bingman,REP,550225,0,0,7,7,
Oklahoma,Governor,Chris Powell,LIB,550225,0,0,0,0,
Oklahoma,Governor,Rex Lawhorn,LIB,550225,0,0,0,0,
Oklahoma,Corporation Commissioner,Ashley Nicole Mccray,DEM,550225,0,0,6,6,
Oklahoma,Corporation Commissioner,Blake Cummings,DEM,550225,0,0,3,3,
Oklahoma,U.S. House,Kendra Horn,DEM,550225,0,0,7,7,05
Oklahoma,U.S. House,Tom Guild,DEM,550225,0,0,2,2,05
Oklahoma,Governor,Mick Cornett,REP,550226,0,0,41,41,
Oklahoma,Governor,Kevin Stitt,REP,550226,0,0,60,60,
Oklahoma,Lieutenant Governor,Dana Murphy,REP,550226,0,0,39,39,
Oklahoma,Lieutenant Governor,Matt Pinnell,REP,550226,0,0,62,62,
Oklahoma,State Auditor,Cindy Byrd,REP,550226,0,0,42,42,
Oklahoma,State Auditor,Charlie Prater,REP,550226,0,0,55,55,
Oklahoma,Attorney General,Mike Hunter,REP,550226,0,0,49,49,
Oklahoma,Attorney General,Gentner Drummond,REP,550226,0,0,53,53,
Oklahoma,Superintendent of Public Instruction,Joy Hofmeister,REP,550226,0,0,49,49,
Oklahoma,Superintendent of Public Instruction,Linda Murphy,REP,550226,0,0,53,53,
Oklahoma,Commissioner of Labor,Cathy Costello,REP,550226,0,0,51,51,
Oklahoma,Commissioner of Labor,Leslie Osborn,REP,550226,0,0,47,47,
Oklahoma,Corporation Commissioner,Bob Anthony,REP,550226,0,0,57,57,
Oklahoma,Corporation Commissioner,Brian Bingman,REP,550226,0,0,45,45,
Oklahoma,Governor,Chris Powell,LIB,550226,0,0,0,0,
Oklahoma,Governor,Rex Lawhorn,LIB,550226,0,0,0,0,
Oklahoma,Corporation Commissioner,Ashley Nicole Mccray,DEM,550226,0,0,36,36,
Oklahoma,Corporation Commissioner,Blake Cummings,DEM,550226,0,0,17,17,
Oklahoma,U.S. House,Kendra Horn,DEM,550226,0,0,33,33,05
Oklahoma,U.S. House,Tom Guild,DEM,550226,0,0,20,20,05
Oklahoma,Governor,Mick Cornett,REP,550227,0,0,36,36,
Oklahoma,Governor,Kevin Stitt,REP,550227,0,0,37,37,
Oklahoma,Lieutenant Governor,Dana Murphy,REP,550227,0,0,29,29,
Oklahoma,Lieutenant Governor,Matt Pinnell,REP,550227,0,0,42,42,
Oklahoma,State Auditor,Cindy Byrd,REP,550227,0,0,30,30,
Oklahoma,State Auditor,Charlie Prater,REP,550227,0,0,39,39,
Oklahoma,Attorney General,Mike Hunter,REP,550227,0,0,30,30,
Oklahoma,Attorney General,Gentner Drummond,REP,550227,0,0,39,39,
Oklahoma,Superintendent of Public Instruction,Joy Hofmeister,REP,550227,0,0,34,34,
Oklahoma,Superintendent of Public Instruction,Linda Murphy,REP,550227,0,0,38,38,
Oklahoma,Commissioner of Labor,Cathy Costello,REP,550227,0,0,31,31,
Oklahoma,Commissioner of Labor,Leslie Osborn,REP,550227,0,0,36,36,
Oklahoma,Corporation Commissioner,Bob Anthony,REP,550227,0,0,37,37,
Oklahoma,Corporation Commissioner,Brian Bingman,REP,550227,0,0,32,32,
Oklahoma,Governor,Chris Powell,LIB,550227,0,0,0,0,
Oklahoma,Governor,Rex Lawhorn,LIB,550227,0,0,0,0,
Oklahoma,Corporation Commissioner,Ashley Nicole Mccray,DEM,550227,0,0,20,20,
Oklahoma,Corporation Commissioner,Blake Cummings,DEM,550227,0,0,14,14,
Oklahoma,U.S. House,Kendra Horn,DEM,550227,0,0,23,23,05
Oklahoma,U.S. House,Tom Guild,DEM,550227,0,0,12,12,05
Oklahoma,Governor,Mick Cornett,REP,550228,0,0,31,31,
Oklahoma,Governor,Kevin Stitt,REP,550228,0,0,42,42,
Oklahoma,Lieutenant Governor,Dana Murphy,REP,550228,0,0,36,36,
Oklahoma,Lieutenant Governor,Matt Pinnell,REP,550228,0,0,34,34,
Oklahoma,State Auditor,Cindy Byrd,REP,550228,0,0,37,37,
Oklahoma,State Auditor,Charlie Prater,REP,550228,0,0,33,33,
Oklahoma,Attorney General,Mike Hunter,REP,550228,0,0,40,40,
Oklahoma,Attorney General,Gentner Drummond,REP,550228,0,0,31,31,
Oklahoma,Superintendent of Public Instruction,Joy Hofmeister,REP,550228,0,0,32,32,
Oklahoma,Superintendent of Public Instruction,Linda Murphy,REP,550228,0,0,40,40,
Oklahoma,Commissioner of Labor,Cathy Costello,REP,550228,0,0,37,37,
Oklahoma,Commissioner of Labor,Leslie Osborn,REP,550228,0,0,33,33,
Oklahoma,Corporation Commissioner,Bob Anthony,REP,550228,0,0,41,41,
Oklahoma,Corporation Commissioner,Brian Bingman,REP,550228,0,0,28,28,
Oklahoma,Governor,Chris Powell,LIB,550228,0,0,1,1,
Oklahoma,Governor,Rex Lawhorn,LIB,550228,0,0,0,0,
Oklahoma,Corporation Commissioner,Ashley Nicole Mccray,DEM,550228,0,0,24,24,
Oklahoma,Corporation Commissioner,Blake Cummings,DEM,550228,0,0,10,10,
Oklahoma,U.S. House,Kendra Horn,DEM,550228,0,0,23,23,05
Oklahoma,U.S. House,Tom Guild,DEM,550228,0,0,11,11,05
Oklahoma,Governor,Mick Cornett,REP,550229,0,0,62,62,
Oklahoma,Governor,Kevin Stitt,REP,550229,0,0,61,61,
Oklahoma,Lieutenant Governor,Dana Murphy,REP,550229,0,0,51,51,
Oklahoma,Lieutenant Governor,Matt Pinnell,REP,550229,0,0,69,69,
Oklahoma,State Auditor,Cindy Byrd,REP,550229,0,0,51,51,
Oklahoma,State Auditor,Charlie Prater,REP,550229,0,0,65,65,
Oklahoma,Attorney General,Mike Hunter,REP,550229,0,0,71,71,
Oklahoma,Attorney General,Gentner Drummond,REP,550229,0,0,49,49,
Oklahoma,Superintendent of Public Instruction,Joy Hofmeister,REP,550229,0,0,67,67,
Oklahoma,Superintendent of Public Instruction,Linda Murphy,REP,550229,0,0,52,52,
Oklahoma,Commissioner of Labor,Cathy Costello,REP,550229,0,0,58,58,
Oklahoma,Commissioner of Labor,Leslie Osborn,REP,550229,0,0,59,59,
Oklahoma,Corporation Commissioner,Bob Anthony,REP,550229,0,0,68,68,
Oklahoma,Corporation Commissioner,Brian Bingman,REP,550229,0,0,52,52,
Oklahoma,Governor,Chris Powell,LIB,550229,0,0,0,0,
Oklahoma,Governor,Rex Lawhorn,LIB,550229,0,0,0,0,
Oklahoma,Corporation Commissioner,Ashley Nicole Mccray,DEM,550229,0,0,35,35,
Oklahoma,Corporation Commissioner,Blake Cummings,DEM,550229,0,0,20,20,
Oklahoma,U.S. House,Kendra Horn,DEM,550229,0,0,38,38,05
Oklahoma,U.S. House,Tom Guild,DEM,550229,0,0,17,17,05
Oklahoma,Governor,Mick Cornett,REP,550230,0,0,115,115,
Oklahoma,Governor,Kevin Stitt,REP,550230,0,0,84,84,
Oklahoma,Lieutenant Governor,Dana Murphy,REP,550230,0,0,70,70,
Oklahoma,Lieutenant Governor,Matt Pinnell,REP,550230,0,0,121,121,
Oklahoma,State Auditor,Cindy Byrd,REP,550230,0,0,86,86,
Oklahoma,State Auditor,Charlie Prater,REP,550230,0,0,101,101,
Oklahoma,Attorney General,Mike Hunter,REP,550230,0,0,115,115,
Oklahoma,Attorney General,Gentner Drummond,REP,550230,0,0,77,77,
Oklahoma,Superintendent of Public Instruction,Joy Hofmeister,REP,550230,0,0,122,122,
Oklahoma,Superintendent of Public Instruction,Linda Murphy,REP,550230,0,0,70,70,
Oklahoma,Commissioner of Labor,Cathy Costello,REP,550230,0,0,87,87,
Oklahoma,Commissioner of Labor,Leslie Osborn,REP,550230,0,0,100,100,
Oklahoma,Corporation Commissioner,Bob Anthony,REP,550230,0,0,112,112,
Oklahoma,Corporation Commissioner,Brian Bingman,REP,550230,0,0,77,77,
Oklahoma,Governor,Chris Powell,LIB,550230,0,0,0,0,
Oklahoma,Governor,Rex Lawhorn,LIB,550230,0,0,0,0,
Oklahoma,Corporation Commissioner,Ashley Nicole Mccray,DEM,550230,0,0,36,36,
Oklahoma,Corporation Commissioner,Blake Cummings,DEM,550230,0,0,21,21,
Oklahoma,U.S. House,Kendra Horn,DEM,550230,0,0,35,35,05
Oklahoma,U.S. House,Tom Guild,DEM,550230,0,0,24,24,05
Oklahoma,Governor,Mick Cornett,REP,550231,0,0,50,50,
Oklahoma,Governor,Kevin Stitt,REP,550231,0,0,61,61,
Oklahoma,Lieutenant Governor,Dana Murphy,REP,550231,0,0,51,51,
Oklahoma,Lieutenant Governor,Matt Pinnell,REP,550231,0,0,58,58,
Oklahoma,State Auditor,Cindy Byrd,REP,550231,0,0,47,47,
Oklahoma,State Auditor,Charlie Prater,REP,550231,0,0,61,61,
Oklahoma,Attorney General,Mike Hunter,REP,550231,0,0,63,63,
Oklahoma,Attorney General,Gentner Drummond,REP,550231,0,0,46,46,
Oklahoma,Superintendent of Public Instruction,Joy Hofmeister,REP,550231,0,0,50,50,
Oklahoma,Superintendent of Public Instruction,Linda Murphy,REP,550231,0,0,59,59,
Oklahoma,Commissioner of Labor,Cathy Costello,REP,550231,0,0,57,57,
Oklahoma,Commissioner of Labor,Leslie Osborn,REP,550231,0,0,52,52,
Oklahoma,Corporation Commissioner,Bob Anthony,REP,550231,0,0,59,59,
Oklahoma,Corporation Commissioner,Brian Bingman,REP,550231,0,0,49,49,
Oklahoma,Governor,Chris Powell,LIB,550231,0,0,1,1,
Oklahoma,Governor,Rex Lawhorn,LIB,550231,0,0,0,0,
Oklahoma,Corporation Commissioner,Ashley Nicole Mccray,DEM,550231,0,0,31,31,
Oklahoma,Corporation Commissioner,Blake Cummings,DEM,550231,0,0,15,15,
Oklahoma,U.S. House,Kendra Horn,DEM,550231,0,0,26,26,05
Oklahoma,U.S. House,Tom Guild,DEM,550231,0,0,20,20,05
Oklahoma,Governor,Mick Cornett,REP,550232,0,0,92,92,
Oklahoma,Governor,Kevin Stitt,REP,550232,0,0,103,103,
Oklahoma,Lieutenant Governor,Dana Murphy,REP,550232,0,0,76,76,
Oklahoma,Lieutenant Governor,Matt Pinnell,REP,550232,0,0,113,113,
Oklahoma,State Auditor,Cindy Byrd,REP,550232,0,0,67,67,
Oklahoma,State Auditor,Charlie Prater,REP,550232,0,0,115,115,
Oklahoma,Attorney General,Mike Hunter,REP,550232,0,0,103,103,
Oklahoma,Attorney General,Gentner Drummond,REP,550232,0,0,89,89,
Oklahoma,Superintendent of Public Instruction,Joy Hofmeister,REP,550232,0,0,112,112,
Oklahoma,Superintendent of Public Instruction,Linda Murphy,REP,550232,0,0,77,77,
Oklahoma,Commissioner of Labor,Cathy Costello,REP,550232,0,0,80,80,
Oklahoma,Commissioner of Labor,Leslie Osborn,REP,550232,0,0,104,104,
Oklahoma,Corporation Commissioner,Bob Anthony,REP,550232,0,0,111,111,
Oklahoma,Corporation Commissioner,Brian Bingman,REP,550232,0,0,79,79,
Oklahoma,Governor,Chris Powell,LIB,550232,0,0,1,1,
Oklahoma,Governor,Rex Lawhorn,LIB,550232,0,0,1,1,
Oklahoma,Corporation Commissioner,Ashley Nicole Mccray,DEM,550232,0,0,36,36,
Oklahoma,Corporation Commissioner,Blake Cummings,DEM,550232,0,0,17,17,
Oklahoma,U.S. House,Kendra Horn,DEM,550232,0,0,35,35,05
Oklahoma,U.S. House,Tom Guild,DEM,550232,0,0,18,18,05
Oklahoma,Governor,Mick Cornett,REP,550233,0,0,19,19,
Oklahoma,Governor,Kevin Stitt,REP,550233,0,0,15,15,
Oklahoma,Lieutenant Governor,Dana Murphy,REP,550233,0,0,13,13,
Oklahoma,Lieutenant Governor,Matt Pinnell,REP,550233,0,0,21,21,
Oklahoma,State Auditor,Cindy Byrd,REP,550233,0,0,11,11,
Oklahoma,State Auditor,Charlie Prater,REP,550233,0,0,20,20,
Oklahoma,Attorney General,Mike Hunter,REP,550233,0,0,18,18,
Oklahoma,Attorney General,Gentner Drummond,REP,550233,0,0,16,16,
Oklahoma,Superintendent of Public Instruction,Joy Hofmeister,REP,550233,0,0,17,17,
Oklahoma,Superintendent of Public Instruction,Linda Murphy,REP,550233,0,0,18,18,
Oklahoma,Commissioner of Labor,Cathy Costello,REP,550233,0,0,12,12,
Oklahoma,Commissioner of Labor,Leslie Osborn,REP,550233,0,0,19,19,
Oklahoma,Corporation Commissioner,Bob Anthony,REP,550233,0,0,13,13,
Oklahoma,Corporation Commissioner,Brian Bingman,REP,550233,0,0,21,21,
Oklahoma,Governor,Chris Powell,LIB,550233,0,0,2,2,
Oklahoma,Governor,Rex Lawhorn,LIB,550233,0,0,0,0,
Oklahoma,Corporation Commissioner,Ashley Nicole Mccray,DEM,550233,0,0,13,13,
Oklahoma,Corporation Commissioner,Blake Cummings,DEM,550233,0,0,7,7,
Oklahoma,U.S. House,Kendra Horn,DEM,550233,0,0,14,14,05
Oklahoma,U.S. House,Tom Guild,DEM,550233,0,0,5,5,05
Oklahoma,Governor,Mick Cornett,REP,550234,0,0,41,41,
Oklahoma,Governor,Kevin Stitt,REP,550234,0,0,39,39,
Oklahoma,Lieutenant Governor,Dana Murphy,REP,550234,0,0,37,37,
Oklahoma,Lieutenant Governor,Matt Pinnell,REP,550234,0,0,43,43,
Oklahoma,State Auditor,Cindy Byrd,REP,550234,0,0,37,37,
Oklahoma,State Auditor,Charlie Prater,REP,550234,0,0,40,40,
Oklahoma,Attorney General,Mike Hunter,REP,550234,0,0,48,48,
Oklahoma,Attorney General,Gentner Drummond,REP,550234,0,0,32,32,
Oklahoma,Superintendent of Public Instruction,Joy Hofmeister,REP,550234,0,0,42,42,
Oklahoma,Superintendent of Public Instruction,Linda Murphy,REP,550234,0,0,36,36,
Oklahoma,Commissioner of Labor,Cathy Costello,REP,550234,0,0,43,43,
Oklahoma,Commissioner of Labor,Leslie Osborn,REP,550234,0,0,35,35,
Oklahoma,Corporation Commissioner,Bob Anthony,REP,550234,0,0,40,40,
Oklahoma,Corporation Commissioner,Brian Bingman,REP,550234,0,0,37,37,
Oklahoma,Governor,Chris Powell,LIB,550234,0,0,0,0,
Oklahoma,Governor,Rex Lawhorn,LIB,550234,0,0,0,0,
Oklahoma,Corporation Commissioner,Ashley Nicole Mccray,DEM,550234,0,0,37,37,
Oklahoma,Corporation Commissioner,Blake Cummings,DEM,550234,0,0,15,15,
Oklahoma,U.S. House,Kendra Horn,DEM,550234,0,0,33,33,05
Oklahoma,U.S. House,Tom Guild,DEM,550234,0,0,19,19,05
Oklahoma,Governor,Mick Cornett,REP,550235,0,0,31,31,
Oklahoma,Governor,Kevin Stitt,REP,550235,0,0,26,26,
Oklahoma,Lieutenant Governor,Dana Murphy,REP,550235,0,0,25,25,
Oklahoma,Lieutenant Governor,Matt Pinnell,REP,550235,0,0,32,32,
Oklahoma,State Auditor,Cindy Byrd,REP,550235,0,0,20,20,
Oklahoma,State Auditor,Charlie Prater,REP,550235,0,0,35,35,
Oklahoma,Attorney General,Mike Hunter,REP,550235,0,0,22,22,
Oklahoma,Attorney General,Gentner Drummond,REP,550235,0,0,35,35,
Oklahoma,Superintendent of Public Instruction,Joy Hofmeister,REP,550235,0,0,26,26,
Oklahoma,Superintendent of Public Instruction,Linda Murphy,REP,550235,0,0,28,28,
Oklahoma,Commissioner of Labor,Cathy Costello,REP,550235,0,0,24,24,
Oklahoma,Commissioner of Labor,Leslie Osborn,REP,550235,0,0,33,33,
Oklahoma,Corporation Commissioner,Bob Anthony,REP,550235,0,0,37,37,
Oklahoma,Corporation Commissioner,Brian Bingman,REP,550235,0,0,18,18,
Oklahoma,Governor,Chris Powell,LIB,550235,0,0,0,0,
Oklahoma,Governor,Rex Lawhorn,LIB,550235,0,0,0,0,
Oklahoma,Corporation Commissioner,Ashley Nicole Mccray,DEM,550235,0,0,34,34,
Oklahoma,Corporation Commissioner,Blake Cummings,DEM,550235,0,0,11,11,
Oklahoma,U.S. House,Kendra Horn,DEM,550235,0,0,29,29,05
Oklahoma,U.S. House,Tom Guild,DEM,550235,0,0,15,15,05
Oklahoma,Governor,Mick Cornett,REP,550236,0,0,0,0,
Oklahoma,Governor,Kevin Stitt,REP,550236,0,0,0,0,
Oklahoma,Lieutenant Governor,Dana Murphy,REP,550236,0,0,0,0,
Oklahoma,Lieutenant Governor,Matt Pinnell,REP,550236,0,0,0,0,
Oklahoma,State Auditor,Cindy Byrd,REP,550236,0,0,0,0,
Oklahoma,State Auditor,Charlie Prater,REP,550236,0,0,0,0,
Oklahoma,Attorney General,Mike Hunter,REP,550236,0,0,0,0,
Oklahoma,Attorney General,Gentner Drummond,REP,550236,0,0,0,0,
Oklahoma,Superintendent of Public Instruction,Joy Hofmeister,REP,550236,0,0,0,0,
Oklahoma,Superintendent of Public Instruction,Linda Murphy,REP,550236,0,0,0,0,
Oklahoma,Commissioner of Labor,Cathy Costello,REP,550236,0,0,0,0,
Oklahoma,Commissioner of Labor,Leslie Osborn,REP,550236,0,0,0,0,
Oklahoma,Corporation Commissioner,Bob Anthony,REP,550236,0,0,0,0,
Oklahoma,Corporation Commissioner,Brian Bingman,REP,550236,0,0,0,0,
Oklahoma,Governor,Chris Powell,LIB,550236,0,0,0,0,
Oklahoma,Governor,Rex Lawhorn,LIB,550236,0,0,0,0,
Oklahoma,Corporation Commissioner,Ashley Nicole Mccray,DEM,550236,0,0,0,0,
Oklahoma,Corporation Commissioner,Blake Cummings,DEM,550236,0,0,0,0,
Oklahoma,U.S. House,Kendra Horn,DEM,550236,0,0,0,0,05
Oklahoma,U.S. House,Tom Guild,DEM,550236,0,0,0,0,05
Oklahoma,State House,Ajay Pittman,DEM,550236,0,0,0,0,99
Oklahoma,State House,Nkem House,DEM,550236,0,0,0,0,99
Oklahoma,Governor,Mick Cornett,REP,550237,0,0,0,0,
Oklahoma,Governor,Kevin Stitt,REP,550237,0,0,0,0,
Oklahoma,Lieutenant Governor,Dana Murphy,REP,550237,0,0,0,0,
Oklahoma,Lieutenant Governor,Matt Pinnell,REP,550237,0,0,0,0,
Oklahoma,State Auditor,Cindy Byrd,REP,550237,0,0,0,0,
Oklahoma,State Auditor,Charlie Prater,REP,550237,0,0,0,0,
Oklahoma,Attorney General,Mike Hunter,REP,550237,0,0,0,0,
Oklahoma,Attorney General,Gentner Drummond,REP,550237,0,0,0,0,
Oklahoma,Superintendent of Public Instruction,Joy Hofmeister,REP,550237,0,0,0,0,
Oklahoma,Superintendent of Public Instruction,Linda Murphy,REP,550237,0,0,0,0,
Oklahoma,Commissioner of Labor,Cathy Costello,REP,550237,0,0,0,0,
Oklahoma,Commissioner of Labor,Leslie Osborn,REP,550237,0,0,0,0,
Oklahoma,Corporation Commissioner,Bob Anthony,REP,550237,0,0,0,0,
Oklahoma,Corporation Commissioner,Brian Bingman,REP,550237,0,0,0,0,
Oklahoma,Governor,Chris Powell,LIB,550237,0,0,0,0,
Oklahoma,Governor,Rex Lawhorn,LIB,550237,0,0,0,0,
Oklahoma,Corporation Commissioner,Ashley Nicole Mccray,DEM,550237,0,0,0,0,
Oklahoma,Corporation Commissioner,Blake Cummings,DEM,550237,0,0,0,0,
Oklahoma,U.S. House,Kendra Horn,DEM,550237,0,0,0,0,05
Oklahoma,U.S. House,Tom Guild,DEM,550237,0,0,0,0,05
Oklahoma,State House,Ajay Pittman,DEM,550237,0,0,0,0,99
Oklahoma,State House,Nkem House,DEM,550237,0,0,0,0,99
Oklahoma,Governor,Mick Cornett,REP,550238,0,0,0,0,
Oklahoma,Governor,Kevin Stitt,REP,550238,0,0,0,0,
Oklahoma,Lieutenant Governor,Dana Murphy,REP,550238,0,0,0,0,
Oklahoma,Lieutenant Governor,Matt Pinnell,REP,550238,0,0,0,0,
Oklahoma,State Auditor,Cindy Byrd,REP,550238,0,0,0,0,
Oklahoma,State Auditor,Charlie Prater,REP,550238,0,0,0,0,
Oklahoma,Attorney General,Mike Hunter,REP,550238,0,0,0,0,
Oklahoma,Attorney General,Gentner Drummond,REP,550238,0,0,0,0,
Oklahoma,Superintendent of Public Instruction,Joy Hofmeister,REP,550238,0,0,0,0,
Oklahoma,Superintendent of Public Instruction,Linda Murphy,REP,550238,0,0,0,0,
Oklahoma,Commissioner of Labor,Cathy Costello,REP,550238,0,0,0,0,
Oklahoma,Commissioner of Labor,Leslie Osborn,REP,550238,0,0,0,0,
Oklahoma,Corporation Commissioner,Bob Anthony,REP,550238,0,0,0,0,
Oklahoma,Corporation Commissioner,Brian Bingman,REP,550238,0,0,0,0,
Oklahoma,Governor,Chris Powell,LIB,550238,0,0,0,0,
Oklahoma,Governor,Rex Lawhorn,LIB,550238,0,0,0,0,
Oklahoma,Corporation Commissioner,Ashley Nicole Mccray,DEM,550238,0,0,0,0,
Oklahoma,Corporation Commissioner,Blake Cummings,DEM,550238,0,0,0,0,
Oklahoma,U.S. House,Kendra Horn,DEM,550238,0,0,0,0,05
Oklahoma,U.S. House,Tom Guild,DEM,550238,0,0,0,0,05
Oklahoma,State House,Ajay Pittman,DEM,550238,0,0,0,0,99
Oklahoma,State House,Nkem House,DEM,550238,0,0,0,0,99
Oklahoma,Governor,Mick Cornett,REP,550239,0,0,65,65,
Oklahoma,Governor,Kevin Stitt,REP,550239,0,0,25,25,
Oklahoma,Lieutenant Governor,Dana Murphy,REP,550239,0,0,50,50,
Oklahoma,Lieutenant Governor,Matt Pinnell,REP,550239,0,0,34,34,
Oklahoma,State Auditor,Cindy Byrd,REP,550239,0,0,46,46,
Oklahoma,State Auditor,Charlie Prater,REP,550239,0,0,31,31,
Oklahoma,Attorney General,Mike Hunter,REP,550239,0,0,49,49,
Oklahoma,Attorney General,Gentner Drummond,REP,550239,0,0,33,33,
Oklahoma,Superintendent of Public Instruction,Joy Hofmeister,REP,550239,0,0,51,51,
Oklahoma,Superintendent of Public Instruction,Linda Murphy,REP,550239,0,0,31,31,
Oklahoma,Commissioner of Labor,Cathy Costello,REP,550239,0,0,36,36,
Oklahoma,Commissioner of Labor,Leslie Osborn,REP,550239,0,0,44,44,
Oklahoma,Corporation Commissioner,Bob Anthony,REP,550239,0,0,42,42,
Oklahoma,Corporation Commissioner,Brian Bingman,REP,550239,0,0,35,35,
Oklahoma,Governor,Chris Powell,LIB,550239,0,0,3,3,
Oklahoma,Governor,Rex Lawhorn,LIB,550239,0,0,0,0,
Oklahoma,Corporation Commissioner,Ashley Nicole Mccray,DEM,550239,0,0,174,174,
Oklahoma,Corporation Commissioner,Blake Cummings,DEM,550239,0,0,43,43,
Oklahoma,U.S. House,Kendra Horn,DEM,550239,0,0,185,185,05
Oklahoma,U.S. House,Tom Guild,DEM,550239,0,0,40,40,05
Oklahoma,State House,Ajay Pittman,DEM,550239,0,0,95,95,99
Oklahoma,State House,Nkem House,DEM,550239,0,0,131,131,99
Oklahoma,Governor,Mick Cornett,REP,550240,0,0,13,13,
Oklahoma,Governor,Kevin Stitt,REP,550240,0,0,4,4,
Oklahoma,Lieutenant Governor,Dana Murphy,REP,550240,0,0,9,9,
Oklahoma,Lieutenant Governor,Matt Pinnell,REP,550240,0,0,7,7,
Oklahoma,State Auditor,Cindy Byrd,REP,550240,0,0,7,7,
Oklahoma,State Auditor,Charlie Prater,REP,550240,0,0,8,8,
Oklahoma,Attorney General,Mike Hunter,REP,550240,0,0,10,10,
Oklahoma,Attorney General,Gentner Drummond,REP,550240,0,0,5,5,
Oklahoma,Superintendent of Public Instruction,Joy Hofmeister,REP,550240,0,0,8,8,
Oklahoma,Superintendent of Public Instruction,Linda Murphy,REP,550240,0,0,8,8,
Oklahoma,Commissioner of Labor,Cathy Costello,REP,550240,0,0,7,7,
Oklahoma,Commissioner of Labor,Leslie Osborn,REP,550240,0,0,8,8,
Oklahoma,Corporation Commissioner,Bob Anthony,REP,550240,0,0,7,7,
Oklahoma,Corporation Commissioner,Brian Bingman,REP,550240,0,0,8,8,
Oklahoma,Governor,Chris Powell,LIB,550240,0,0,0,0,
Oklahoma,Governor,Rex Lawhorn,LIB,550240,0,0,0,0,
Oklahoma,Corporation Commissioner,Ashley Nicole Mccray,DEM,550240,0,0,196,196,
Oklahoma,Corporation Commissioner,Blake Cummings,DEM,550240,0,0,37,37,
Oklahoma,U.S. House,Kendra Horn,DEM,550240,0,0,170,170,05
Oklahoma,U.S. House,Tom Guild,DEM,550240,0,0,68,68,05
Oklahoma,State House,Ajay Pittman,DEM,550240,0,0,139,139,99
Oklahoma,State House,Nkem House,DEM,550240,0,0,104,104,99
Oklahoma,Governor,Mick Cornett,REP,550241,0,0,41,41,
Oklahoma,Governor,Kevin Stitt,REP,550241,0,0,14,14,
Oklahoma,Lieutenant Governor,Dana Murphy,REP,550241,0,0,24,24,
Oklahoma,Lieutenant Governor,Matt Pinnell,REP,550241,0,0,28,28,
Oklahoma,State Auditor,Cindy Byrd,REP,550241,0,0,35,35,
Oklahoma,State Auditor,Charlie Prater,REP,550241,0,0,18,18,
Oklahoma,Attorney General,Mike Hunter,REP,550241,0,0,32,32,
Oklahoma,Attorney General,Gentner Drummond,REP,550241,0,0,22,22,
Oklahoma,Superintendent of Public Instruction,Joy Hofmeister,REP,550241,0,0,32,32,
Oklahoma,Superintendent of Public Instruction,Linda Murphy,REP,550241,0,0,21,21,
Oklahoma,Commissioner of Labor,Cathy Costello,REP,550241,0,0,19,19,
Oklahoma,Commissioner of Labor,Leslie Osborn,REP,550241,0,0,34,34,
Oklahoma,Corporation Commissioner,Bob Anthony,REP,550241,0,0,21,21,
Oklahoma,Corporation Commissioner,Brian Bingman,REP,550241,0,0,33,33,
Oklahoma,Governor,Chris Powell,LIB,550241,0,0,0,0,
Oklahoma,Governor,Rex Lawhorn,LIB,550241,0,0,1,1,
Oklahoma,Corporation Commissioner,Ashley Nicole Mccray,DEM,550241,0,0,153,153,
Oklahoma,Corporation Commissioner,Blake Cummings,DEM,550241,0,0,33,33,
Oklahoma,U.S. House,Kendra Horn,DEM,550241,0,0,148,148,05
Oklahoma,U.S. House,Tom Guild,DEM,550241,0,0,43,43,05
Oklahoma,State House,Ajay Pittman,DEM,550241,0,0,73,73,99
Oklahoma,State House,Nkem House,DEM,550241,0,0,121,121,99
Oklahoma,Governor,Mick Cornett,REP,550242,0,0,4,4,
Oklahoma,Governor,Kevin Stitt,REP,550242,0,0,0,0,
Oklahoma,Lieutenant Governor,Dana Murphy,REP,550242,0,0,2,2,
Oklahoma,Lieutenant Governor,Matt Pinnell,REP,550242,0,0,2,2,
Oklahoma,State Auditor,Cindy Byrd,REP,550242,0,0,4,4,
Oklahoma,State Auditor,Charlie Prater,REP,550242,0,0,0,0,
Oklahoma,Attorney General,Mike Hunter,REP,550242,0,0,4,4,
Oklahoma,Attorney General,Gentner Drummond,REP,550242,0,0,0,0,
Oklahoma,Superintendent of Public Instruction,Joy Hofmeister,REP,550242,0,0,3,3,
Oklahoma,Superintendent of Public Instruction,Linda Murphy,REP,550242,0,0,1,1,
Oklahoma,Commissioner of Labor,Cathy Costello,REP,550242,0,0,2,2,
Oklahoma,Commissioner of Labor,Leslie Osborn,REP,550242,0,0,2,2,
Oklahoma,Corporation Commissioner,Bob Anthony,REP,550242,0,0,2,2,
Oklahoma,Corporation Commissioner,Brian Bingman,REP,550242,0,0,1,1,
Oklahoma,Governor,Chris Powell,LIB,550242,0,0,0,0,
Oklahoma,Governor,Rex Lawhorn,LIB,550242,0,0,0,0,
Oklahoma,Corporation Commissioner,Ashley Nicole Mccray,DEM,550242,0,0,134,134,
Oklahoma,Corporation Commissioner,Blake Cummings,DEM,550242,0,0,49,49,
Oklahoma,U.S. House,Kendra Horn,DEM,550242,0,0,105,105,05
Oklahoma,U.S. House,Tom Guild,DEM,550242,0,0,78,78,05
Oklahoma,Governor,Mick Cornett,REP,550243,0,0,4,4,
Oklahoma,Governor,Kevin Stitt,REP,550243,0,0,4,4,
Oklahoma,Lieutenant Governor,Dana Murphy,REP,550243,0,0,6,6,
Oklahoma,Lieutenant Governor,Matt Pinnell,REP,550243,0,0,2,2,
Oklahoma,State Auditor,Cindy Byrd,REP,550243,0,0,4,4,
Oklahoma,State Auditor,Charlie Prater,REP,550243,0,0,4,4,
Oklahoma,Attorney General,Mike Hunter,REP,550243,0,0,7,7,
Oklahoma,Attorney General,Gentner Drummond,REP,550243,0,0,1,1,
Oklahoma,Superintendent of Public Instruction,Joy Hofmeister,REP,550243,0,0,5,5,
Oklahoma,Superintendent of Public Instruction,Linda Murphy,REP,550243,0,0,3,3,
Oklahoma,Commissioner of Labor,Cathy Costello,REP,550243,0,0,7,7,
Oklahoma,Commissioner of Labor,Leslie Osborn,REP,550243,0,0,1,1,
Oklahoma,Corporation Commissioner,Bob Anthony,REP,550243,0,0,8,8,
Oklahoma,Corporation Commissioner,Brian Bingman,REP,550243,0,0,0,0,
Oklahoma,Governor,Chris Powell,LIB,550243,0,0,2,2,
Oklahoma,Governor,Rex Lawhorn,LIB,550243,0,0,0,0,
Oklahoma,Corporation Commissioner,Ashley Nicole Mccray,DEM,550243,0,0,177,177,
Oklahoma,Corporation Commissioner,Blake Cummings,DEM,550243,0,0,39,39,
Oklahoma,U.S. House,Kendra Horn,DEM,550243,0,0,155,155,05
Oklahoma,U.S. House,Tom Guild,DEM,550243,0,0,66,66,05
Oklahoma,Governor,Mick Cornett,REP,550244,0,0,3,3,
Oklahoma,Governor,Kevin Stitt,REP,550244,0,0,5,5,
Oklahoma,Lieutenant Governor,Dana Murphy,REP,550244,0,0,5,5,
Oklahoma,Lieutenant Governor,Matt Pinnell,REP,550244,0,0,2,2,
Oklahoma,State Auditor,Cindy Byrd,REP,550244,0,0,4,4,
Oklahoma,State Auditor,Charlie Prater,REP,550244,0,0,3,3,
Oklahoma,Attorney General,Mike Hunter,REP,550244,0,0,3,3,
Oklahoma,Attorney General,Gentner Drummond,REP,550244,0,0,5,5,
Oklahoma,Superintendent of Public Instruction,Joy Hofmeister,REP,550244,0,0,3,3,
Oklahoma,Superintendent of Public Instruction,Linda Murphy,REP,550244,0,0,4,4,
Oklahoma,Commissioner of Labor,Cathy Costello,REP,550244,0,0,3,3,
Oklahoma,Commissioner of Labor,Leslie Osborn,REP,550244,0,0,4,4,
Oklahoma,Corporation Commissioner,Bob Anthony,REP,550244,0,0,3,3,
Oklahoma,Corporation Commissioner,Brian Bingman,REP,550244,0,0,4,4,
Oklahoma,Governor,Chris Powell,LIB,550244,0,0,0,0,
Oklahoma,Governor,Rex Lawhorn,LIB,550244,0,0,0,0,
Oklahoma,Corporation Commissioner,Ashley Nicole Mccray,DEM,550244,0,0,167,167,
Oklahoma,Corporation Commissioner,Blake Cummings,DEM,550244,0,0,48,48,
Oklahoma,U.S. House,Kendra Horn,DEM,550244,0,0,160,160,05
Oklahoma,U.S. House,Tom Guild,DEM,550244,0,0,60,60,05
Oklahoma,State House,Ajay Pittman,DEM,550244,0,0,99,99,99
Oklahoma,State House,Nkem House,DEM,550244,0,0,125,125,99
Oklahoma,Governor,Mick Cornett,REP,550245,0,0,1,1,
Oklahoma,Governor,Kevin Stitt,REP,550245,0,0,3,3,
Oklahoma,Lieutenant Governor,Dana Murphy,REP,550245,0,0,1,1,
Oklahoma,Lieutenant Governor,Matt Pinnell,REP,550245,0,0,3,3,
Oklahoma,State Auditor,Cindy Byrd,REP,550245,0,0,2,2,
Oklahoma,State Auditor,Charlie Prater,REP,550245,0,0,2,2,
Oklahoma,Attorney General,Mike Hunter,REP,550245,0,0,3,3,
Oklahoma,Attorney General,Gentner Drummond,REP,550245,0,0,1,1,
Oklahoma,Superintendent of Public Instruction,Joy Hofmeister,REP,550245,0,0,2,2,
Oklahoma,Superintendent of Public Instruction,Linda Murphy,REP,550245,0,0,2,2,
Oklahoma,Commissioner of Labor,Cathy Costello,REP,550245,0,0,3,3,
Oklahoma,Commissioner of Labor,Leslie Osborn,REP,550245,0,0,1,1,
Oklahoma,Corporation Commissioner,Bob Anthony,REP,550245,0,0,1,1,
Oklahoma,Corporation Commissioner,Brian Bingman,REP,550245,0,0,3,3,
Oklahoma,Governor,Chris Powell,LIB,550245,0,0,0,0,
Oklahoma,Governor,Rex Lawhorn,LIB,550245,0,0,0,0,
Oklahoma,Corporation Commissioner,Ashley Nicole Mccray,DEM,550245,0,0,228,228,
Oklahoma,Corporation Commissioner,Blake Cummings,DEM,550245,0,0,59,59,
Oklahoma,U.S. House,Kendra Horn,DEM,550245,0,0,193,193,05
Oklahoma,U.S. House,Tom Guild,DEM,550245,0,0,96,96,05
Oklahoma,State House,Ajay Pittman,DEM,550245,0,0,140,140,99
Oklahoma,State House,Nkem House,DEM,550245,0,0,154,154,99
Oklahoma,Governor,Mick Cornett,REP,550246,0,0,10,10,
Oklahoma,Governor,Kevin Stitt,REP,550246,0,0,20,20,
Oklahoma,Lieutenant Governor,Dana Murphy,REP,550246,0,0,15,15,
Oklahoma,Lieutenant Governor,Matt Pinnell,REP,550246,0,0,13,13,
Oklahoma,State Auditor,Cindy Byrd,REP,550246,0,0,14,14,
Oklahoma,State Auditor,Charlie Prater,REP,550246,0,0,14,14,
Oklahoma,Attorney General,Mike Hunter,REP,550246,0,0,11,11,
Oklahoma,Attorney General,Gentner Drummond,REP,550246,0,0,18,18,
Oklahoma,Superintendent of Public Instruction,Joy Hofmeister,REP,550246,0,0,14,14,
Oklahoma,Superintendent of Public Instruction,Linda Murphy,REP,550246,0,0,15,15,
Oklahoma,Commissioner of Labor,Cathy Costello,REP,550246,0,0,16,16,
Oklahoma,Commissioner of Labor,Leslie Osborn,REP,550246,0,0,14,14,
Oklahoma,Corporation Commissioner,Bob Anthony,REP,550246,0,0,10,10,
Oklahoma,Corporation Commissioner,Brian Bingman,REP,550246,0,0,18,18,
Oklahoma,Governor,Chris Powell,LIB,550246,0,0,0,0,
Oklahoma,Governor,Rex Lawhorn,LIB,550246,0,0,1,1,
Oklahoma,Corporation Commissioner,Ashley Nicole Mccray,DEM,550246,0,0,10,10,
Oklahoma,Corporation Commissioner,Blake Cummings,DEM,550246,0,0,6,6,
Oklahoma,U.S. House,Kendra Horn,DEM,550246,0,0,11,11,05
Oklahoma,U.S. House,Tom Guild,DEM,550246,0,0,5,5,05
Oklahoma,Governor,Mick Cornett,REP,550247,0,0,25,25,
Oklahoma,Governor,Kevin Stitt,REP,550247,0,0,26,26,
Oklahoma,Lieutenant Governor,Dana Murphy,REP,550247,0,0,16,16,
Oklahoma,Lieutenant Governor,Matt Pinnell,REP,550247,0,0,34,34,
Oklahoma,State Auditor,Cindy Byrd,REP,550247,0,0,21,21,
Oklahoma,State Auditor,Charlie Prater,REP,550247,0,0,29,29,
Oklahoma,Attorney General,Mike Hunter,REP,550247,0,0,25,25,
Oklahoma,Attorney General,Gentner Drummond,REP,550247,0,0,26,26,
Oklahoma,Superintendent of Public Instruction,Joy Hofmeister,REP,550247,0,0,28,28,
Oklahoma,Superintendent of Public Instruction,Linda Murphy,REP,550247,0,0,22,22,
Oklahoma,Commissioner of Labor,Cathy Costello,REP,550247,0,0,31,31,
Oklahoma,Commissioner of Labor,Leslie Osborn,REP,550247,0,0,19,19,
Oklahoma,Corporation Commissioner,Bob Anthony,REP,550247,0,0,19,19,
Oklahoma,Corporation Commissioner,Brian Bingman,REP,550247,0,0,31,31,
Oklahoma,Governor,Chris Powell,LIB,550247,0,0,0,0,
Oklahoma,Governor,Rex Lawhorn,LIB,550247,0,0,0,0,
Oklahoma,Corporation Commissioner,Ashley Nicole Mccray,DEM,550247,0,0,37,37,
Oklahoma,Corporation Commissioner,Blake Cummings,DEM,550247,0,0,12,12,
Oklahoma,U.S. House,Kendra Horn,DEM,550247,0,0,26,26,05
Oklahoma,U.S. House,Tom Guild,DEM,550247,0,0,23,23,05
Oklahoma,Governor,Mick Cornett,REP,550248,0,0,76,76,
Oklahoma,Governor,Kevin Stitt,REP,550248,0,0,59,59,
Oklahoma,Lieutenant Governor,Dana Murphy,REP,550248,0,0,54,54,
Oklahoma,Lieutenant Governor,Matt Pinnell,REP,550248,0,0,82,82,
Oklahoma,State Auditor,Cindy Byrd,REP,550248,0,0,52,52,
Oklahoma,State Auditor,Charlie Prater,REP,550248,0,0,84,84,
Oklahoma,Attorney General,Mike Hunter,REP,550248,0,0,69,69,
Oklahoma,Attorney General,Gentner Drummond,REP,550248,0,0,67,67,
Oklahoma,Superintendent of Public Instruction,Joy Hofmeister,REP,550248,0,0,74,74,
Oklahoma,Superintendent of Public Instruction,Linda Murphy,REP,550248,0,0,62,62,
Oklahoma,Commissioner of Labor,Cathy Costello,REP,550248,0,0,72,72,
Oklahoma,Commissioner of Labor,Leslie Osborn,REP,550248,0,0,62,62,
Oklahoma,Corporation Commissioner,Bob Anthony,REP,550248,0,0,68,68,
Oklahoma,Corporation Commissioner,Brian Bingman,REP,550248,0,0,68,68,
Oklahoma,Governor,Chris Powell,LIB,550248,0,0,0,0,
Oklahoma,Governor,Rex Lawhorn,LIB,550248,0,0,0,0,
Oklahoma,Corporation Commissioner,Ashley Nicole Mccray,DEM,550248,0,0,85,85,
Oklahoma,Corporation Commissioner,Blake Cummings,DEM,550248,0,0,33,33,
Oklahoma,U.S. House,Kendra Horn,DEM,550248,0,0,85,85,05
Oklahoma,U.S. House,Tom Guild,DEM,550248,0,0,35,35,05
Oklahoma,Governor,Mick Cornett,REP,550249,0,0,157,157,
Oklahoma,Governor,Kevin Stitt,REP,550249,0,0,122,122,
Oklahoma,Lieutenant Governor,Dana Murphy,REP,550249,0,0,148,148,
Oklahoma,Lieutenant Governor,Matt Pinnell,REP,550249,0,0,125,125,
Oklahoma,State Auditor,Cindy Byrd,REP,550249,0,0,124,124,
Oklahoma,State Auditor,Charlie Prater,REP,550249,0,0,137,137,
Oklahoma,Attorney General,Mike Hunter,REP,550249,0,0,165,165,
Oklahoma,Attorney General,Gentner Drummond,REP,550249,0,0,106,106,
Oklahoma,Superintendent of Public Instruction,Joy Hofmeister,REP,550249,0,0,155,155,
Oklahoma,Superintendent of Public Instruction,Linda Murphy,REP,550249,0,0,118,118,
Oklahoma,Commissioner of Labor,Cathy Costello,REP,550249,0,0,124,124,
Oklahoma,Commissioner of Labor,Leslie Osborn,REP,550249,0,0,144,144,
Oklahoma,Corporation Commissioner,Bob Anthony,REP,550249,0,0,174,174,
Oklahoma,Corporation Commissioner,Brian Bingman,REP,550249,0,0,98,98,
Oklahoma,Governor,Chris Powell,LIB,550249,0,0,1,1,
Oklahoma,Governor,Rex Lawhorn,LIB,550249,0,0,0,0,
Oklahoma,Corporation Commissioner,Ashley Nicole Mccray,DEM,550249,0,0,112,112,
Oklahoma,Corporation Commissioner,Blake Cummings,DEM,550249,0,0,50,50,
Oklahoma,U.S. House,Kendra Horn,DEM,550249,0,0,86,86,05
Oklahoma,U.S. House,Tom Guild,DEM,550249,0,0,76,76,05
Oklahoma,Governor,Mick Cornett,REP,550250,0,0,78,78,
Oklahoma,Governor,Kevin Stitt,REP,550250,0,0,75,75,
Oklahoma,Lieutenant Governor,Dana Murphy,REP,550250,0,0,66,66,
Oklahoma,Lieutenant Governor,Matt Pinnell,REP,550250,0,0,82,82,
Oklahoma,State Auditor,Cindy Byrd,REP,550250,0,0,64,64,
Oklahoma,State Auditor,Charlie Prater,REP,550250,0,0,80,80,
Oklahoma,Attorney General,Mike Hunter,REP,550250,0,0,71,71,
Oklahoma,Attorney General,Gentner Drummond,REP,550250,0,0,80,80,
Oklahoma,Superintendent of Public Instruction,Joy Hofmeister,REP,550250,0,0,77,77,
Oklahoma,Superintendent of Public Instruction,Linda Murphy,REP,550250,0,0,72,72,
Oklahoma,Commissioner of Labor,Cathy Costello,REP,550250,0,0,72,72,
Oklahoma,Commissioner of Labor,Leslie Osborn,REP,550250,0,0,73,73,
Oklahoma,Corporation Commissioner,Bob Anthony,REP,550250,0,0,75,75,
Oklahoma,Corporation Commissioner,Brian Bingman,REP,550250,0,0,74,74,
Oklahoma,Governor,Chris Powell,LIB,550250,0,0,1,1,
Oklahoma,Governor,Rex Lawhorn,LIB,550250,0,0,0,0,
Oklahoma,Corporation Commissioner,Ashley Nicole Mccray,DEM,550250,0,0,50,50,
Oklahoma,Corporation Commissioner,Blake Cummings,DEM,550250,0,0,15,15,
Oklahoma,U.S. House,Kendra Horn,DEM,550250,0,0,43,43,05
Oklahoma,U.S. House,Tom Guild,DEM,550250,0,0,23,23,05
Oklahoma,Governor,Mick Cornett,REP,550251,0,0,135,135,
Oklahoma,Governor,Kevin Stitt,REP,550251,0,0,94,94,
Oklahoma,Lieutenant Governor,Dana Murphy,REP,550251,0,0,120,120,
Oklahoma,Lieutenant Governor,Matt Pinnell,REP,550251,0,0,100,100,
Oklahoma,State Auditor,Cindy Byrd,REP,550251,0,0,116,116,
Oklahoma,State Auditor,Charlie Prater,REP,550251,0,0,98,98,
Oklahoma,Attorney General,Mike Hunter,REP,550251,0,0,117,117,
Oklahoma,Attorney General,Gentner Drummond,REP,550251,0,0,108,108,
Oklahoma,Superintendent of Public Instruction,Joy Hofmeister,REP,550251,0,0,124,124,
Oklahoma,Superintendent of Public Instruction,Linda Murphy,REP,550251,0,0,100,100,
Oklahoma,Commissioner of Labor,Cathy Costello,REP,550251,0,0,107,107,
Oklahoma,Commissioner of Labor,Leslie Osborn,REP,550251,0,0,112,112,
Oklahoma,Corporation Commissioner,Bob Anthony,REP,550251,0,0,136,136,
Oklahoma,Corporation Commissioner,Brian Bingman,REP,550251,0,0,85,85,
Oklahoma,Governor,Chris Powell,LIB,550251,0,0,0,0,
Oklahoma,Governor,Rex Lawhorn,LIB,550251,0,0,0,0,
Oklahoma,Corporation Commissioner,Ashley Nicole Mccray,DEM,550251,0,0,82,82,
Oklahoma,Corporation Commissioner,Blake Cummings,DEM,550251,0,0,24,24,
Oklahoma,U.S. House,Mary Brannon,DEM,550251,0,0,69,69,04
Oklahoma,U.S. House,Fred Gipson,DEM,550251,0,0,36,36,04
Oklahoma,Governor,Mick Cornett,REP,550252,0,0,216,216,
Oklahoma,Governor,Kevin Stitt,REP,550252,0,0,209,209,
Oklahoma,Lieutenant Governor,Dana Murphy,REP,550252,0,0,196,196,
Oklahoma,Lieutenant Governor,Matt Pinnell,REP,550252,0,0,225,225,
Oklahoma,State Auditor,Cindy Byrd,REP,550252,0,0,184,184,
Oklahoma,State Auditor,Charlie Prater,REP,550252,0,0,229,229,
Oklahoma,Attorney General,Mike Hunter,REP,550252,0,0,243,243,
Oklahoma,Attorney General,Gentner Drummond,REP,550252,0,0,177,177,
Oklahoma,Superintendent of Public Instruction,Joy Hofmeister,REP,550252,0,0,235,235,
Oklahoma,Superintendent of Public Instruction,Linda Murphy,REP,550252,0,0,190,190,
Oklahoma,Commissioner of Labor,Cathy Costello,REP,550252,0,0,208,208,
Oklahoma,Commissioner of Labor,Leslie Osborn,REP,550252,0,0,203,203,
Oklahoma,Corporation Commissioner,Bob Anthony,REP,550252,0,0,239,239,
Oklahoma,Corporation Commissioner,Brian Bingman,REP,550252,0,0,174,174,
Oklahoma,Governor,Chris Powell,LIB,550252,0,0,0,0,
Oklahoma,Governor,Rex Lawhorn,LIB,550252,0,0,0,0,
Oklahoma,Corporation Commissioner,Ashley Nicole Mccray,DEM,550252,0,0,57,57,
Oklahoma,Corporation Commissioner,Blake Cummings,DEM,550252,0,0,18,18,
Oklahoma,U.S. House,Mary Brannon,DEM,550252,0,0,56,56,04
Oklahoma,U.S. House,Fred Gipson,DEM,550252,0,0,19,19,04
Oklahoma,Governor,Mick Cornett,REP,550253,0,0,73,73,
Oklahoma,Governor,Kevin Stitt,REP,550253,0,0,84,84,
Oklahoma,Lieutenant Governor,Dana Murphy,REP,550253,0,0,70,70,
Oklahoma,Lieutenant Governor,Matt Pinnell,REP,550253,0,0,82,82,
Oklahoma,State Auditor,Cindy Byrd,REP,550253,0,0,66,66,
Oklahoma,State Auditor,Charlie Prater,REP,550253,0,0,82,82,
Oklahoma,Attorney General,Mike Hunter,REP,550253,0,0,71,71,
Oklahoma,Attorney General,Gentner Drummond,REP,550253,0,0,79,79,
Oklahoma,Superintendent of Public Instruction,Joy Hofmeister,REP,550253,0,0,82,82,
Oklahoma,Superintendent of Public Instruction,Linda Murphy,REP,550253,0,0,69,69,
Oklahoma,Commissioner of Labor,Cathy Costello,REP,550253,0,0,58,58,
Oklahoma,Commissioner of Labor,Leslie Osborn,REP,550253,0,0,87,87,
Oklahoma,Corporation Commissioner,Bob Anthony,REP,550253,0,0,79,79,
Oklahoma,Corporation Commissioner,Brian Bingman,REP,550253,0,0,69,69,
Oklahoma,State House,Tess Teague,REP,550253,0,0,67,67,10
Oklahoma,State House,Robert Manger,REP,550253,0,0,88,88,10
Oklahoma,Governor,Chris Powell,LIB,550253,0,0,0,0,
Oklahoma,Governor,Rex Lawhorn,LIB,550253,0,0,0,0,
Oklahoma,Corporation Commissioner,Ashley Nicole Mccray,DEM,550253,0,0,7,7,
Oklahoma,Corporation Commissioner,Blake Cummings,DEM,550253,0,0,9,9,
Oklahoma,U.S. House,Kendra Horn,DEM,550253,0,0,8,8,05
Oklahoma,U.S. House,Tom Guild,DEM,550253,0,0,8,8,05
Oklahoma,State House,Madeline Scott,DEM,550253,0,0,6,6,10
Oklahoma,State House,John Carpenter,DEM,550253,0,0,10,10,10
Oklahoma,Governor,Mick Cornett,REP,550254,0,0,206,206,
Oklahoma,Governor,Kevin Stitt,REP,550254,0,0,243,243,
Oklahoma,Lieutenant Governor,Dana Murphy,REP,550254,0,0,180,180,
Oklahoma,Lieutenant Governor,Matt Pinnell,REP,550254,0,0,244,244,
Oklahoma,State Auditor,Cindy Byrd,REP,550254,0,0,185,185,
Oklahoma,State Auditor,Charlie Prater,REP,550254,0,0,220,220,
Oklahoma,Attorney General,Mike Hunter,REP,550254,0,0,212,212,
Oklahoma,Attorney General,Gentner Drummond,REP,550254,0,0,220,220,
Oklahoma,Superintendent of Public Instruction,Joy Hofmeister,REP,550254,0,0,242,242,
Oklahoma,Superintendent of Public Instruction,Linda Murphy,REP,550254,0,0,185,185,
Oklahoma,Commissioner of Labor,Cathy Costello,REP,550254,0,0,174,174,
Oklahoma,Commissioner of Labor,Leslie Osborn,REP,550254,0,0,235,235,
Oklahoma,Corporation Commissioner,Bob Anthony,REP,550254,0,0,218,218,
Oklahoma,Corporation Commissioner,Brian Bingman,REP,550254,0,0,196,196,
Oklahoma,State House,Tess Teague,REP,550254,0,0,184,184,10
Oklahoma,State House,Robert Manger,REP,550254,0,0,249,249,10
Oklahoma,Governor,Chris Powell,LIB,550254,0,0,1,1,
Oklahoma,Governor,Rex Lawhorn,LIB,550254,0,0,0,0,
Oklahoma,Corporation Commissioner,Ashley Nicole Mccray,DEM,550254,0,0,61,61,
Oklahoma,Corporation Commissioner,Blake Cummings,DEM,550254,0,0,19,19,
Oklahoma,U.S. House,Kendra Horn,DEM,550254,0,0,59,59,05
Oklahoma,U.S. House,Tom Guild,DEM,550254,0,0,22,22,05
Oklahoma,State House,Madeline Scott,DEM,550254,0,0,48,48,10
Oklahoma,State House,John Carpenter,DEM,550254,0,0,34,34,10
Oklahoma,Governor,Mick Cornett,REP,550255,0,0,0,0,
Oklahoma,Governor,Kevin Stitt,REP,550255,0,0,0,0,
Oklahoma,Lieutenant Governor,Dana Murphy,REP,550255,0,0,0,0,
Oklahoma,Lieutenant Governor,Matt Pinnell,REP,550255,0,0,0,0,
Oklahoma,State Auditor,Cindy Byrd,REP,550255,0,0,0,0,
Oklahoma,State Auditor,Charlie Prater,REP,550255,0,0,0,0,
Oklahoma,Attorney General,Mike Hunter,REP,550255,0,0,0,0,
Oklahoma,Attorney General,Gentner Drummond,REP,550255,0,0,0,0,
Oklahoma,Superintendent of Public Instruction,Joy Hofmeister,REP,550255,0,0,0,0,
Oklahoma,Superintendent of Public Instruction,Linda Murphy,REP,550255,0,0,0,0,
Oklahoma,Commissioner of Labor,Cathy Costello,REP,550255,0,0,0,0,
Oklahoma,Commissioner of Labor,Leslie Osborn,REP,550255,0,0,0,0,
Oklahoma,Corporation Commissioner,Bob Anthony,REP,550255,0,0,0,0,
Oklahoma,Corporation Commissioner,Brian Bingman,REP,550255,0,0,0,0,
Oklahoma,Governor,Chris Powell,LIB,550255,0,0,0,0,
Oklahoma,Governor,Rex Lawhorn,LIB,550255,0,0,0,0,
Oklahoma,Corporation Commissioner,Ashley Nicole Mccray,DEM,550255,0,0,0,0,
Oklahoma,Corporation Commissioner,Blake Cummings,DEM,550255,0,0,0,0,
Oklahoma,U.S. House,Mary Brannon,DEM,550255,0,0,0,0,04
Oklahoma,U.S. House,Fred Gipson,DEM,550255,0,0,0,0,04
Oklahoma,Governor,Mick Cornett,REP,550256,0,0,0,0,
Oklahoma,Governor,Kevin Stitt,REP,550256,0,0,0,0,
Oklahoma,Lieutenant Governor,Dana Murphy,REP,550256,0,0,0,0,
Oklahoma,Lieutenant Governor,Matt Pinnell,REP,550256,0,0,0,0,
Oklahoma,State Auditor,Cindy Byrd,REP,550256,0,0,0,0,
Oklahoma,State Auditor,Charlie Prater,REP,550256,0,0,0,0,
Oklahoma,Attorney General,Mike Hunter,REP,550256,0,0,0,0,
Oklahoma,Attorney General,Gentner Drummond,REP,550256,0,0,0,0,
Oklahoma,Superintendent of Public Instruction,Joy Hofmeister,REP,550256,0,0,0,0,
Oklahoma,Superintendent of Public Instruction,Linda Murphy,REP,550256,0,0,0,0,
Oklahoma,Commissioner of Labor,Cathy Costello,REP,550256,0,0,0,0,
Oklahoma,Commissioner of Labor,Leslie Osborn,REP,550256,0,0,0,0,
Oklahoma,Corporation Commissioner,Bob Anthony,REP,550256,0,0,0,0,
Oklahoma,Corporation Commissioner,Brian Bingman,REP,550256,0,0,0,0,
Oklahoma,Governor,Chris Powell,LIB,550256,0,0,0,0,
Oklahoma,Governor,Rex Lawhorn,LIB,550256,0,0,0,0,
Oklahoma,Corporation Commissioner,Ashley Nicole Mccray,DEM,550256,0,0,0,0,
Oklahoma,Corporation Commissioner,Blake Cummings,DEM,550256,0,0,0,0,
Oklahoma,U.S. House,Kendra Horn,DEM,550256,0,0,0,0,05
Oklahoma,U.S. House,Tom Guild,DEM,550256,0,0,0,0,05
Oklahoma,Governor,Mick Cornett,REP,550257,0,0,8,8,
Oklahoma,Governor,Kevin Stitt,REP,550257,0,0,9,9,
Oklahoma,Lieutenant Governor,Dana Murphy,REP,550257,0,0,8,8,
Oklahoma,Lieutenant Governor,Matt Pinnell,REP,550257,0,0,9,9,
Oklahoma,State Auditor,Cindy Byrd,REP,550257,0,0,7,7,
Oklahoma,State Auditor,Charlie Prater,REP,550257,0,0,8,8,
Oklahoma,Attorney General,Mike Hunter,REP,550257,0,0,5,5,
Oklahoma,Attorney General,Gentner Drummond,REP,550257,0,0,11,11,
Oklahoma,Superintendent of Public Instruction,Joy Hofmeister,REP,550257,0,0,8,8,
Oklahoma,Superintendent of Public Instruction,Linda Murphy,REP,550257,0,0,7,7,
Oklahoma,Commissioner of Labor,Cathy Costello,REP,550257,0,0,6,6,
Oklahoma,Commissioner of Labor,Leslie Osborn,REP,550257,0,0,9,9,
Oklahoma,Corporation Commissioner,Bob Anthony,REP,550257,0,0,9,9,
Oklahoma,Corporation Commissioner,Brian Bingman,REP,550257,0,0,7,7,
Oklahoma,Governor,Chris Powell,LIB,550257,0,0,0,0,
Oklahoma,Governor,Rex Lawhorn,LIB,550257,0,0,0,0,
Oklahoma,Corporation Commissioner,Ashley Nicole Mccray,DEM,550257,0,0,15,15,
Oklahoma,Corporation Commissioner,Blake Cummings,DEM,550257,0,0,2,2,
Oklahoma,U.S. House,Kendra Horn,DEM,550257,0,0,14,14,05
Oklahoma,U.S. House,Tom Guild,DEM,550257,0,0,3,3,05
Oklahoma,State House,Ajay Pittman,DEM,550257,0,0,13,13,99
Oklahoma,State House,Nkem House,DEM,550257,0,0,4,4,99
Oklahoma,Governor,Mick Cornett,REP,559999,2727,698,0,3425,
Oklahoma,Governor,Kevin Stitt,REP,559999,1706,492,0,2198,
Oklahoma,Lieutenant Governor,Dana Murphy,REP,559999,2133,523,0,2656,
Oklahoma,Lieutenant Governor,Matt Pinnell,REP,559999,2185,640,0,2825,
Oklahoma,State Auditor,Cindy Byrd,REP,559999,2285,610,0,2895,
Oklahoma,State Auditor,Charlie Prater,REP,559999,1867,509,0,2376,
Oklahoma,Attorney General,Mike Hunter,REP,559999,2842,762,0,3604,
Oklahoma,Attorney General,Gentner Drummond,REP,559999,1499,409,0,1908,
Oklahoma,Superintendent of Public Instruction,Joy Hofmeister,REP,559999,2485,699,0,3184,
Oklahoma,Superintendent of Public Instruction,Linda Murphy,REP,559999,1849,466,0,2315,
Oklahoma,Commissioner of Labor,Cathy Costello,REP,559999,2161,535,0,2696,
Oklahoma,Commissioner of Labor,Leslie Osborn,REP,559999,2108,629,0,2737,
Oklahoma,Corporation Commissioner,Bob Anthony,REP,559999,2829,683,0,3512,
Oklahoma,Corporation Commissioner,Brian Bingman,REP,559999,1500,479,0,1979,
Oklahoma,State Senate,Lori Callahan,REP,559999,150,44,0,194,30
Oklahoma,State Senate,John Symcox,REP,559999,214,48,0,262,30
Oklahoma,State House,Roxanne Pollard,REP,559999,35,11,0,46,41
Oklahoma,State House,Denise Crosswhite Hader,REP,559999,59,11,0,70,41
Oklahoma,State House,Nicole Miller,REP,559999,380,76,0,456,82
Oklahoma,State House,Brad Martin,REP,559999,209,49,0,258,82
Oklahoma,State House,Julie Roach,REP,559999,159,26,0,185,10
Oklahoma,State House,Marilyn Stark,REP,559999,132,44,0,176,10
Oklahoma,State House,Tess Teague,REP,559999,97,20,0,117,10
Oklahoma,State House,Robert Manger,REP,559999,175,32,0,207,10
Oklahoma,Governor,Chris Powell,LIB,559999,15,8,0,23,
Oklahoma,Governor,Rex Lawhorn,LIB,559999,6,0,0,6,
Oklahoma,Corporation Commissioner,Ashley Nicole Mccray,DEM,559999,1978,771,0,2749,
Oklahoma,Corporation Commissioner,Blake Cummings,DEM,559999,537,200,0,737,
Oklahoma,U.S. House,Mary Brannon,DEM,559999,163,24,0,187,04
Oklahoma,U.S. House,Fred Gipson,DEM,559999,51,12,0,63,04
Oklahoma,U.S. House,Kendra Horn,DEM,559999,1908,737,0,2645,05
Oklahoma,U.S. House,Tom Guild,DEM,559999,445,208,0,653,05
Oklahoma,State House,Sara Peterson,DEM,559999,7,3,0,10,41
Oklahoma,State House,Jennie Scott,DEM,559999,17,2,0,19,41
Oklahoma,State House,Ajay Pittman,DEM,559999,81,91,0,172,99
Oklahoma,State House,Nkem House,DEM,559999,75,91,0,166,99
Oklahoma,State House,Madeline Scott,DEM,559999,74,13,0,87,10
Oklahoma,State House,John Carpenter,DEM,559999,67,7,0,74,10
Okmulgee,Governor,Mick Cornett,REP,560004,0,0,4,4,
Okmulgee,Governor,Kevin Stitt,REP,560004,0,1,16,17,
Okmulgee,Lieutenant Governor,Dana Murphy,REP,560004,0,1,4,5,
Okmulgee,Lieutenant Governor,Matt Pinnell,REP,560004,0,0,14,14,
Okmulgee,State Auditor,Cindy Byrd,REP,560004,0,1,6,7,
Okmulgee,State Auditor,Charlie Prater,REP,560004,0,0,10,10,
Okmulgee,Attorney General,Mike Hunter,REP,560004,0,0,6,6,
Okmulgee,Attorney General,Gentner Drummond,REP,560004,0,0,14,14,
Okmulgee,Superintendent of Public Instruction,Joy Hofmeister,REP,560004,0,0,6,6,
Okmulgee,Superintendent of Public Instruction,Linda Murphy,REP,560004,0,0,12,12,
Okmulgee,Commissioner of Labor,Cathy Costello,REP,560004,0,0,5,5,
Okmulgee,Commissioner of Labor,Leslie Osborn,REP,560004,0,0,11,11,
Okmulgee,Corporation Commissioner,Bob Anthony,REP,560004,0,1,2,3,
Okmulgee,Corporation Commissioner,Brian Bingman,REP,560004,0,0,15,15,
Okmulgee,Governor,Chris Powell,LIB,560004,0,0,0,0,
Okmulgee,Governor,Rex Lawhorn,LIB,560004,0,0,0,0,
Okmulgee,Corporation Commissioner,Ashley Nicole Mccray,DEM,560004,0,0,4,4,
Okmulgee,Corporation Commissioner,Blake Cummings,DEM,560004,0,0,4,4,
Okmulgee,U.S. House,Jason Nichols,DEM,560004,0,0,5,5,02
Okmulgee,U.S. House,Clay Padgett,DEM,560004,0,0,2,2,02
Okmulgee,Governor,Mick Cornett,REP,560007,1,3,25,29,
Okmulgee,Governor,Kevin Stitt,REP,560007,0,1,32,33,
Okmulgee,Lieutenant Governor,Dana Murphy,REP,560007,1,2,22,25,
Okmulgee,Lieutenant Governor,Matt Pinnell,REP,560007,0,2,35,37,
Okmulgee,State Auditor,Cindy Byrd,REP,560007,0,2,28,30,
Okmulgee,State Auditor,Charlie Prater,REP,560007,1,2,28,31,
Okmulgee,Attorney General,Mike Hunter,REP,560007,0,3,31,34,
Okmulgee,Attorney General,Gentner Drummond,REP,560007,1,1,25,27,
Okmulgee,Superintendent of Public Instruction,Joy Hofmeister,REP,560007,1,2,26,29,
Okmulgee,Superintendent of Public Instruction,Linda Murphy,REP,560007,0,2,31,33,
Okmulgee,Commissioner of Labor,Cathy Costello,REP,560007,0,1,20,21,
Okmulgee,Commissioner of Labor,Leslie Osborn,REP,560007,1,3,34,38,
Okmulgee,Corporation Commissioner,Bob Anthony,REP,560007,0,3,22,25,
Okmulgee,Corporation Commissioner,Brian Bingman,REP,560007,1,1,33,35,
Okmulgee,Governor,Chris Powell,LIB,560007,0,0,0,0,
Okmulgee,Governor,Rex Lawhorn,LIB,560007,0,0,0,0,
Okmulgee,Corporation Commissioner,Ashley Nicole Mccray,DEM,560007,1,1,29,31,
Okmulgee,Corporation Commissioner,Blake Cummings,DEM,560007,3,4,21,28,
Okmulgee,U.S. House,Jason Nichols,DEM,560007,3,3,31,37,02
Okmulgee,U.S. House,Clay Padgett,DEM,560007,1,2,19,22,02
Okmulgee,Governor,Mick Cornett,REP,560008,3,5,33,41,
Okmulgee,Governor,Kevin Stitt,REP,560008,0,10,59,69,
Okmulgee,Lieutenant Governor,Dana Murphy,REP,560008,2,5,28,35,
Okmulgee,Lieutenant Governor,Matt Pinnell,REP,560008,1,9,65,75,
Okmulgee,State Auditor,Cindy Byrd,REP,560008,1,6,35,42,
Okmulgee,State Auditor,Charlie Prater,REP,560008,2,8,55,65,
Okmulgee,Attorney General,Mike Hunter,REP,560008,2,7,38,47,
Okmulgee,Attorney General,Gentner Drummond,REP,560008,1,8,53,62,
Okmulgee,Superintendent of Public Instruction,Joy Hofmeister,REP,560008,2,7,48,57,
Okmulgee,Superintendent of Public Instruction,Linda Murphy,REP,560008,1,7,43,51,
Okmulgee,Commissioner of Labor,Cathy Costello,REP,560008,0,6,38,44,
Okmulgee,Commissioner of Labor,Leslie Osborn,REP,560008,3,8,55,66,
Okmulgee,Corporation Commissioner,Bob Anthony,REP,560008,0,8,31,39,
Okmulgee,Corporation Commissioner,Brian Bingman,REP,560008,3,6,60,69,
Okmulgee,Governor,Chris Powell,LIB,560008,0,0,0,0,
Okmulgee,Governor,Rex Lawhorn,LIB,560008,0,0,0,0,
Okmulgee,Corporation Commissioner,Ashley Nicole Mccray,DEM,560008,1,1,49,51,
Okmulgee,Corporation Commissioner,Blake Cummings,DEM,560008,2,1,39,42,
Okmulgee,U.S. House,Jason Nichols,DEM,560008,1,1,51,53,02
Okmulgee,U.S. House,Clay Padgett,DEM,560008,2,1,36,39,02
Okmulgee,Governor,Mick Cornett,REP,560009,2,7,13,22,
Okmulgee,Governor,Kevin Stitt,REP,560009,1,2,24,27,
Okmulgee,Lieutenant Governor,Dana Murphy,REP,560009,2,4,16,22,
Okmulgee,Lieutenant Governor,Matt Pinnell,REP,560009,1,5,21,27,
Okmulgee,State Auditor,Cindy Byrd,REP,560009,1,4,17,22,
Okmulgee,State Auditor,Charlie Prater,REP,560009,2,5,20,27,
Okmulgee,Attorney General,Mike Hunter,REP,560009,2,5,19,26,
Okmulgee,Attorney General,Gentner Drummond,REP,560009,1,4,18,23,
Okmulgee,Superintendent of Public Instruction,Joy Hofmeister,REP,560009,2,7,16,25,
Okmulgee,Superintendent of Public Instruction,Linda Murphy,REP,560009,1,2,21,24,
Okmulgee,Commissioner of Labor,Cathy Costello,REP,560009,2,0,19,21,
Okmulgee,Commissioner of Labor,Leslie Osborn,REP,560009,1,9,18,28,
Okmulgee,Corporation Commissioner,Bob Anthony,REP,560009,2,3,15,20,
Okmulgee,Corporation Commissioner,Brian Bingman,REP,560009,1,6,22,29,
Okmulgee,Governor,Chris Powell,LIB,560009,0,0,0,0,
Okmulgee,Governor,Rex Lawhorn,LIB,560009,0,0,0,0,
Okmulgee,Corporation Commissioner,Ashley Nicole Mccray,DEM,560009,4,19,67,90,
Okmulgee,Corporation Commissioner,Blake Cummings,DEM,560009,1,3,28,32,
Okmulgee,U.S. House,Jason Nichols,DEM,560009,2,10,42,54,02
Okmulgee,U.S. House,Clay Padgett,DEM,560009,3,12,53,68,02
Okmulgee,Governor,Mick Cornett,REP,560010,1,3,9,13,
Okmulgee,Governor,Kevin Stitt,REP,560010,1,3,32,36,
Okmulgee,Lieutenant Governor,Dana Murphy,REP,560010,0,1,14,15,
Okmulgee,Lieutenant Governor,Matt Pinnell,REP,560010,2,5,25,32,
Okmulgee,State Auditor,Cindy Byrd,REP,560010,0,2,17,19,
Okmulgee,State Auditor,Charlie Prater,REP,560010,2,4,21,27,
Okmulgee,Attorney General,Mike Hunter,REP,560010,1,2,17,20,
Okmulgee,Attorney General,Gentner Drummond,REP,560010,1,4,21,26,
Okmulgee,Superintendent of Public Instruction,Joy Hofmeister,REP,560010,0,2,24,26,
Okmulgee,Superintendent of Public Instruction,Linda Murphy,REP,560010,2,4,15,21,
Okmulgee,Commissioner of Labor,Cathy Costello,REP,560010,0,2,20,22,
Okmulgee,Commissioner of Labor,Leslie Osborn,REP,560010,2,4,18,24,
Okmulgee,Corporation Commissioner,Bob Anthony,REP,560010,2,1,20,23,
Okmulgee,Corporation Commissioner,Brian Bingman,REP,560010,0,5,18,23,
Okmulgee,Governor,Chris Powell,LIB,560010,0,0,0,0,
Okmulgee,Governor,Rex Lawhorn,LIB,560010,0,0,0,0,
Okmulgee,Corporation Commissioner,Ashley Nicole Mccray,DEM,560010,0,0,13,13,
Okmulgee,Corporation Commissioner,Blake Cummings,DEM,560010,0,3,20,23,
Okmulgee,U.S. House,Jason Nichols,DEM,560010,0,1,15,16,02
Okmulgee,U.S. House,Clay Padgett,DEM,560010,0,2,18,20,02
Okmulgee,Governor,Mick Cornett,REP,560011,3,11,47,61,
Okmulgee,Governor,Kevin Stitt,REP,560011,6,14,132,152,
Okmulgee,Lieutenant Governor,Dana Murphy,REP,560011,2,13,64,79,
Okmulgee,Lieutenant Governor,Matt Pinnell,REP,560011,7,12,112,131,
Okmulgee,State Auditor,Cindy Byrd,REP,560011,3,17,75,95,
Okmulgee,State Auditor,Charlie Prater,REP,560011,6,7,102,115,
Okmulgee,Attorney General,Mike Hunter,REP,560011,2,11,94,107,
Okmulgee,Attorney General,Gentner Drummond,REP,560011,7,14,84,105,
Okmulgee,Superintendent of Public Instruction,Joy Hofmeister,REP,560011,4,18,92,114,
Okmulgee,Superintendent of Public Instruction,Linda Murphy,REP,560011,5,6,85,96,
Okmulgee,Commissioner of Labor,Cathy Costello,REP,560011,4,13,89,106,
Okmulgee,Commissioner of Labor,Leslie Osborn,REP,560011,5,12,88,105,
Okmulgee,Corporation Commissioner,Bob Anthony,REP,560011,3,12,79,94,
Okmulgee,Corporation Commissioner,Brian Bingman,REP,560011,6,13,96,115,
Okmulgee,Governor,Chris Powell,LIB,560011,0,0,1,1,
Okmulgee,Governor,Rex Lawhorn,LIB,560011,0,0,0,0,
Okmulgee,Corporation Commissioner,Ashley Nicole Mccray,DEM,560011,10,15,84,109,
Okmulgee,Corporation Commissioner,Blake Cummings,DEM,560011,7,6,73,86,
Okmulgee,U.S. House,Jason Nichols,DEM,560011,10,7,83,100,02
Okmulgee,U.S. House,Clay Padgett,DEM,560011,7,15,74,96,02
Okmulgee,Governor,Mick Cornett,REP,560013,0,0,9,9,
Okmulgee,Governor,Kevin Stitt,REP,560013,1,0,28,29,
Okmulgee,Lieutenant Governor,Dana Murphy,REP,560013,1,0,11,12,
Okmulgee,Lieutenant Governor,Matt Pinnell,REP,560013,0,0,26,26,
Okmulgee,State Auditor,Cindy Byrd,REP,560013,1,0,6,7,
Okmulgee,State Auditor,Charlie Prater,REP,560013,0,0,30,30,
Okmulgee,Attorney General,Mike Hunter,REP,560013,0,0,16,16,
Okmulgee,Attorney General,Gentner Drummond,REP,560013,1,0,21,22,
Okmulgee,Superintendent of Public Instruction,Joy Hofmeister,REP,560013,0,0,23,23,
Okmulgee,Superintendent of Public Instruction,Linda Murphy,REP,560013,1,0,14,15,
Okmulgee,Commissioner of Labor,Cathy Costello,REP,560013,0,0,14,14,
Okmulgee,Commissioner of Labor,Leslie Osborn,REP,560013,1,0,23,24,
Okmulgee,Corporation Commissioner,Bob Anthony,REP,560013,0,0,19,19,
Okmulgee,Corporation Commissioner,Brian Bingman,REP,560013,1,0,18,19,
Okmulgee,Governor,Chris Powell,LIB,560013,0,0,0,0,
Okmulgee,Governor,Rex Lawhorn,LIB,560013,0,0,0,0,
Okmulgee,Corporation Commissioner,Ashley Nicole Mccray,DEM,560013,0,1,25,26,
Okmulgee,Corporation Commissioner,Blake Cummings,DEM,560013,0,0,29,29,
Okmulgee,U.S. House,Jason Nichols,DEM,560013,0,1,39,40,02
Okmulgee,U.S. House,Clay Padgett,DEM,560013,0,0,16,16,02
Okmulgee,Governor,Mick Cornett,REP,560014,1,0,8,9,
Okmulgee,Governor,Kevin Stitt,REP,560014,1,0,22,23,
Okmulgee,Lieutenant Governor,Dana Murphy,REP,560014,1,0,7,8,
Okmulgee,Lieutenant Governor,Matt Pinnell,REP,560014,1,0,21,22,
Okmulgee,State Auditor,Cindy Byrd,REP,560014,2,0,9,11,
Okmulgee,State Auditor,Charlie Prater,REP,560014,0,0,19,19,
Okmulgee,Attorney General,Mike Hunter,REP,560014,1,0,9,10,
Okmulgee,Attorney General,Gentner Drummond,REP,560014,1,0,21,22,
Okmulgee,Superintendent of Public Instruction,Joy Hofmeister,REP,560014,1,0,14,15,
Okmulgee,Superintendent of Public Instruction,Linda Murphy,REP,560014,1,0,14,15,
Okmulgee,Commissioner of Labor,Cathy Costello,REP,560014,0,0,9,9,
Okmulgee,Commissioner of Labor,Leslie Osborn,REP,560014,2,0,19,21,
Okmulgee,Corporation Commissioner,Bob Anthony,REP,560014,1,0,10,11,
Okmulgee,Corporation Commissioner,Brian Bingman,REP,560014,1,0,18,19,
Okmulgee,Governor,Chris Powell,LIB,560014,0,0,0,0,
Okmulgee,Governor,Rex Lawhorn,LIB,560014,0,0,0,0,
Okmulgee,Corporation Commissioner,Ashley Nicole Mccray,DEM,560014,1,1,19,21,
Okmulgee,Corporation Commissioner,Blake Cummings,DEM,560014,1,0,10,11,
Okmulgee,U.S. House,Jason Nichols,DEM,560014,1,1,19,21,02
Okmulgee,U.S. House,Clay Padgett,DEM,560014,1,0,10,11,02
Okmulgee,Governor,Mick Cornett,REP,560015,1,0,28,29,
Okmulgee,Governor,Kevin Stitt,REP,560015,3,2,56,61,
Okmulgee,Lieutenant Governor,Dana Murphy,REP,560015,1,0,27,28,
Okmulgee,Lieutenant Governor,Matt Pinnell,REP,560015,3,2,57,62,
Okmulgee,State Auditor,Cindy Byrd,REP,560015,4,1,34,39,
Okmulgee,State Auditor,Charlie Prater,REP,560015,1,0,47,48,
Okmulgee,Attorney General,Mike Hunter,REP,560015,3,2,33,38,
Okmulgee,Attorney General,Gentner Drummond,REP,560015,2,0,49,51,
Okmulgee,Superintendent of Public Instruction,Joy Hofmeister,REP,560015,2,0,52,54,
Okmulgee,Superintendent of Public Instruction,Linda Murphy,REP,560015,3,1,32,36,
Okmulgee,Commissioner of Labor,Cathy Costello,REP,560015,1,1,29,31,
Okmulgee,Commissioner of Labor,Leslie Osborn,REP,560015,4,0,54,58,
Okmulgee,Corporation Commissioner,Bob Anthony,REP,560015,1,0,32,33,
Okmulgee,Corporation Commissioner,Brian Bingman,REP,560015,4,1,50,55,
Okmulgee,Governor,Chris Powell,LIB,560015,0,0,0,0,
Okmulgee,Governor,Rex Lawhorn,LIB,560015,0,0,0,0,
Okmulgee,Corporation Commissioner,Ashley Nicole Mccray,DEM,560015,3,1,53,57,
Okmulgee,Corporation Commissioner,Blake Cummings,DEM,560015,5,2,36,43,
Okmulgee,U.S. House,Jason Nichols,DEM,560015,5,0,64,69,02
Okmulgee,U.S. House,Clay Padgett,DEM,560015,3,3,24,30,02
Okmulgee,Governor,Mick Cornett,REP,560016,0,0,12,12,
Okmulgee,Governor,Kevin Stitt,REP,560016,2,0,28,30,
Okmulgee,Lieutenant Governor,Dana Murphy,REP,560016,0,0,19,19,
Okmulgee,Lieutenant Governor,Matt Pinnell,REP,560016,2,0,22,24,
Okmulgee,State Auditor,Cindy Byrd,REP,560016,0,0,19,19,
Okmulgee,State Auditor,Charlie Prater,REP,560016,2,0,22,24,
Okmulgee,Attorney General,Mike Hunter,REP,560016,0,0,16,16,
Okmulgee,Attorney General,Gentner Drummond,REP,560016,2,0,25,27,
Okmulgee,Superintendent of Public Instruction,Joy Hofmeister,REP,560016,0,0,22,22,
Okmulgee,Superintendent of Public Instruction,Linda Murphy,REP,560016,2,0,19,21,
Okmulgee,Commissioner of Labor,Cathy Costello,REP,560016,2,0,18,20,
Okmulgee,Commissioner of Labor,Leslie Osborn,REP,560016,0,0,23,23,
Okmulgee,Corporation Commissioner,Bob Anthony,REP,560016,0,0,15,15,
Okmulgee,Corporation Commissioner,Brian Bingman,REP,560016,2,0,26,28,
Okmulgee,Governor,Chris Powell,LIB,560016,0,0,1,1,
Okmulgee,Governor,Rex Lawhorn,LIB,560016,0,0,0,0,
Okmulgee,Corporation Commissioner,Ashley Nicole Mccray,DEM,560016,3,3,25,31,
Okmulgee,Corporation Commissioner,Blake Cummings,DEM,560016,0,0,33,33,
Okmulgee,U.S. House,Jason Nichols,DEM,560016,0,3,36,39,02
Okmulgee,U.S. House,Clay Padgett,DEM,560016,3,0,21,24,02
Okmulgee,Governor,Mick Cornett,REP,560018,0,0,12,12,
Okmulgee,Governor,Kevin Stitt,REP,560018,1,1,30,32,
Okmulgee,Lieutenant Governor,Dana Murphy,REP,560018,0,0,8,8,
Okmulgee,Lieutenant Governor,Matt Pinnell,REP,560018,1,1,34,36,
Okmulgee,State Auditor,Cindy Byrd,REP,560018,1,0,18,19,
Okmulgee,State Auditor,Charlie Prater,REP,560018,0,1,24,25,
Okmulgee,Attorney General,Mike Hunter,REP,560018,0,1,13,14,
Okmulgee,Attorney General,Gentner Drummond,REP,560018,2,0,28,30,
Okmulgee,Superintendent of Public Instruction,Joy Hofmeister,REP,560018,0,1,32,33,
Okmulgee,Superintendent of Public Instruction,Linda Murphy,REP,560018,1,0,10,11,
Okmulgee,Commissioner of Labor,Cathy Costello,REP,560018,1,0,16,17,
Okmulgee,Commissioner of Labor,Leslie Osborn,REP,560018,0,1,25,26,
Okmulgee,Corporation Commissioner,Bob Anthony,REP,560018,0,0,18,18,
Okmulgee,Corporation Commissioner,Brian Bingman,REP,560018,1,1,24,26,
Okmulgee,Governor,Chris Powell,LIB,560018,0,0,1,1,
Okmulgee,Governor,Rex Lawhorn,LIB,560018,0,0,0,0,
Okmulgee,Corporation Commissioner,Ashley Nicole Mccray,DEM,560018,5,3,25,33,
Okmulgee,Corporation Commissioner,Blake Cummings,DEM,560018,3,0,27,30,
Okmulgee,U.S. House,Jason Nichols,DEM,560018,6,3,36,45,02
Okmulgee,U.S. House,Clay Padgett,DEM,560018,2,0,16,18,02
Okmulgee,Governor,Mick Cornett,REP,560019,0,0,12,12,
Okmulgee,Governor,Kevin Stitt,REP,560019,2,0,21,23,
Okmulgee,Lieutenant Governor,Dana Murphy,REP,560019,2,0,10,12,
Okmulgee,Lieutenant Governor,Matt Pinnell,REP,560019,0,0,23,23,
Okmulgee,State Auditor,Cindy Byrd,REP,560019,0,0,9,9,
Okmulgee,State Auditor,Charlie Prater,REP,560019,2,0,21,23,
Okmulgee,Attorney General,Mike Hunter,REP,560019,0,0,15,15,
Okmulgee,Attorney General,Gentner Drummond,REP,560019,2,0,17,19,
Okmulgee,Superintendent of Public Instruction,Joy Hofmeister,REP,560019,2,0,15,17,
Okmulgee,Superintendent of Public Instruction,Linda Murphy,REP,560019,0,0,16,16,
Okmulgee,Commissioner of Labor,Cathy Costello,REP,560019,0,0,11,11,
Okmulgee,Commissioner of Labor,Leslie Osborn,REP,560019,2,0,18,20,
Okmulgee,Corporation Commissioner,Bob Anthony,REP,560019,2,0,10,12,
Okmulgee,Corporation Commissioner,Brian Bingman,REP,560019,0,0,22,22,
Okmulgee,Governor,Chris Powell,LIB,560019,0,0,0,0,
Okmulgee,Governor,Rex Lawhorn,LIB,560019,0,0,0,0,
Okmulgee,Corporation Commissioner,Ashley Nicole Mccray,DEM,560019,0,3,22,25,
Okmulgee,Corporation Commissioner,Blake Cummings,DEM,560019,0,0,15,15,
Okmulgee,U.S. House,Jason Nichols,DEM,560019,0,2,21,23,02
Okmulgee,U.S. House,Clay Padgett,DEM,560019,0,1,16,17,02
Okmulgee,Governor,Mick Cornett,REP,560020,6,0,65,71,
Okmulgee,Governor,Kevin Stitt,REP,560020,5,5,142,152,
Okmulgee,Lieutenant Governor,Dana Murphy,REP,560020,5,3,74,82,
Okmulgee,Lieutenant Governor,Matt Pinnell,REP,560020,6,2,130,138,
Okmulgee,State Auditor,Cindy Byrd,REP,560020,3,4,91,98,
Okmulgee,State Auditor,Charlie Prater,REP,560020,5,1,112,118,
Okmulgee,Attorney General,Mike Hunter,REP,560020,4,0,70,74,
Okmulgee,Attorney General,Gentner Drummond,REP,560020,7,5,134,146,
Okmulgee,Superintendent of Public Instruction,Joy Hofmeister,REP,560020,6,0,122,128,
Okmulgee,Superintendent of Public Instruction,Linda Murphy,REP,560020,5,5,84,94,
Okmulgee,Commissioner of Labor,Cathy Costello,REP,560020,7,1,99,107,
Okmulgee,Commissioner of Labor,Leslie Osborn,REP,560020,2,4,102,108,
Okmulgee,Corporation Commissioner,Bob Anthony,REP,560020,6,5,94,105,
Okmulgee,Corporation Commissioner,Brian Bingman,REP,560020,5,0,110,115,
Okmulgee,Governor,Chris Powell,LIB,560020,0,0,0,0,
Okmulgee,Governor,Rex Lawhorn,LIB,560020,0,0,0,0,
Okmulgee,Corporation Commissioner,Ashley Nicole Mccray,DEM,560020,0,3,90,93,
Okmulgee,Corporation Commissioner,Blake Cummings,DEM,560020,0,0,60,60,
Okmulgee,U.S. House,Jason Nichols,DEM,560020,0,3,104,107,02
Okmulgee,U.S. House,Clay Padgett,DEM,560020,0,0,49,49,02
Okmulgee,Governor,Mick Cornett,REP,560021,0,0,5,5,
Okmulgee,Governor,Kevin Stitt,REP,560021,2,0,17,19,
Okmulgee,Lieutenant Governor,Dana Murphy,REP,560021,0,0,9,9,
Okmulgee,Lieutenant Governor,Matt Pinnell,REP,560021,2,0,13,15,
Okmulgee,State Auditor,Cindy Byrd,REP,560021,2,0,12,14,
Okmulgee,State Auditor,Charlie Prater,REP,560021,0,0,9,9,
Okmulgee,Attorney General,Mike Hunter,REP,560021,0,0,8,8,
Okmulgee,Attorney General,Gentner Drummond,REP,560021,2,0,14,16,
Okmulgee,Superintendent of Public Instruction,Joy Hofmeister,REP,560021,0,0,13,13,
Okmulgee,Superintendent of Public Instruction,Linda Murphy,REP,560021,2,0,9,11,
Okmulgee,Commissioner of Labor,Cathy Costello,REP,560021,2,0,9,11,
Okmulgee,Commissioner of Labor,Leslie Osborn,REP,560021,0,0,12,12,
Okmulgee,Corporation Commissioner,Bob Anthony,REP,560021,2,0,6,8,
Okmulgee,Corporation Commissioner,Brian Bingman,REP,560021,0,0,16,16,
Okmulgee,Governor,Chris Powell,LIB,560021,0,0,0,0,
Okmulgee,Governor,Rex Lawhorn,LIB,560021,0,0,0,0,
Okmulgee,Corporation Commissioner,Ashley Nicole Mccray,DEM,560021,2,5,27,34,
Okmulgee,Corporation Commissioner,Blake Cummings,DEM,560021,0,0,35,35,
Okmulgee,U.S. House,Jason Nichols,DEM,560021,2,3,50,55,02
Okmulgee,U.S. House,Clay Padgett,DEM,560021,0,2,13,15,02
Okmulgee,Governor,Mick Cornett,REP,560026,1,0,49,50,
Okmulgee,Governor,Kevin Stitt,REP,560026,1,3,102,106,
Okmulgee,Lieutenant Governor,Dana Murphy,REP,560026,0,1,56,57,
Okmulgee,Lieutenant Governor,Matt Pinnell,REP,560026,2,2,91,95,
Okmulgee,State Auditor,Cindy Byrd,REP,560026,2,1,58,61,
Okmulgee,State Auditor,Charlie Prater,REP,560026,0,2,86,88,
Okmulgee,Attorney General,Mike Hunter,REP,560026,0,2,58,60,
Okmulgee,Attorney General,Gentner Drummond,REP,560026,2,1,93,96,
Okmulgee,Superintendent of Public Instruction,Joy Hofmeister,REP,560026,1,2,79,82,
Okmulgee,Superintendent of Public Instruction,Linda Murphy,REP,560026,1,1,68,70,
Okmulgee,Commissioner of Labor,Cathy Costello,REP,560026,1,0,67,68,
Okmulgee,Commissioner of Labor,Leslie Osborn,REP,560026,1,3,77,81,
Okmulgee,Corporation Commissioner,Bob Anthony,REP,560026,0,2,60,62,
Okmulgee,Corporation Commissioner,Brian Bingman,REP,560026,2,1,90,93,
Okmulgee,Governor,Chris Powell,LIB,560026,0,0,0,0,
Okmulgee,Governor,Rex Lawhorn,LIB,560026,0,0,0,0,
Okmulgee,Corporation Commissioner,Ashley Nicole Mccray,DEM,560026,0,1,71,72,
Okmulgee,Corporation Commissioner,Blake Cummings,DEM,560026,0,2,94,96,
Okmulgee,U.S. House,Jason Nichols,DEM,560026,0,1,112,113,02
Okmulgee,U.S. House,Clay Padgett,DEM,560026,0,2,52,54,02
Okmulgee,Governor,Mick Cornett,REP,560027,2,1,15,18,
Okmulgee,Governor,Kevin Stitt,REP,560027,7,1,66,74,
Okmulgee,Lieutenant Governor,Dana Murphy,REP,560027,2,1,29,32,
Okmulgee,Lieutenant Governor,Matt Pinnell,REP,560027,7,1,50,58,
Okmulgee,State Auditor,Cindy Byrd,REP,560027,7,1,32,40,
Okmulgee,State Auditor,Charlie Prater,REP,560027,2,1,45,48,
Okmulgee,Attorney General,Mike Hunter,REP,560027,6,0,36,42,
Okmulgee,Attorney General,Gentner Drummond,REP,560027,3,2,43,48,
Okmulgee,Superintendent of Public Instruction,Joy Hofmeister,REP,560027,5,0,45,50,
Okmulgee,Superintendent of Public Instruction,Linda Murphy,REP,560027,4,2,34,40,
Okmulgee,Commissioner of Labor,Cathy Costello,REP,560027,7,1,46,54,
Okmulgee,Commissioner of Labor,Leslie Osborn,REP,560027,2,1,31,34,
Okmulgee,Corporation Commissioner,Bob Anthony,REP,560027,5,1,39,45,
Okmulgee,Corporation Commissioner,Brian Bingman,REP,560027,4,1,38,43,
Okmulgee,Governor,Chris Powell,LIB,560027,0,0,0,0,
Okmulgee,Governor,Rex Lawhorn,LIB,560027,0,0,0,0,
Okmulgee,Corporation Commissioner,Ashley Nicole Mccray,DEM,560027,3,2,19,24,
Okmulgee,Corporation Commissioner,Blake Cummings,DEM,560027,1,0,17,18,
Okmulgee,U.S. House,Jason Nichols,DEM,560027,3,2,23,28,02
Okmulgee,U.S. House,Clay Padgett,DEM,560027,1,0,13,14,02
Okmulgee,Governor,Mick Cornett,REP,560029,4,1,55,60,
Okmulgee,Governor,Kevin Stitt,REP,560029,15,2,178,195,
Okmulgee,Lieutenant Governor,Dana Murphy,REP,560029,5,0,74,79,
Okmulgee,Lieutenant Governor,Matt Pinnell,REP,560029,13,3,156,172,
Okmulgee,State Auditor,Cindy Byrd,REP,560029,12,0,85,97,
Okmulgee,State Auditor,Charlie Prater,REP,560029,7,3,139,149,
Okmulgee,Attorney General,Mike Hunter,REP,560029,7,1,91,99,
Okmulgee,Attorney General,Gentner Drummond,REP,560029,12,2,139,153,
Okmulgee,Superintendent of Public Instruction,Joy Hofmeister,REP,560029,10,1,120,131,
Okmulgee,Superintendent of Public Instruction,Linda Murphy,REP,560029,9,2,108,119,
Okmulgee,Commissioner of Labor,Cathy Costello,REP,560029,13,0,105,118,
Okmulgee,Commissioner of Labor,Leslie Osborn,REP,560029,6,3,121,130,
Okmulgee,Corporation Commissioner,Bob Anthony,REP,560029,8,1,96,105,
Okmulgee,Corporation Commissioner,Brian Bingman,REP,560029,11,2,133,146,
Okmulgee,Governor,Chris Powell,LIB,560029,0,0,0,0,
Okmulgee,Governor,Rex Lawhorn,LIB,560029,0,0,0,0,
Okmulgee,Corporation Commissioner,Ashley Nicole Mccray,DEM,560029,3,1,47,51,
Okmulgee,Corporation Commissioner,Blake Cummings,DEM,560029,1,2,30,33,
Okmulgee,U.S. House,Jason Nichols,DEM,560029,1,1,41,43,02
Okmulgee,U.S. House,Clay Padgett,DEM,560029,3,2,36,41,02
Okmulgee,Governor,Mick Cornett,REP,560031,0,0,6,6,
Okmulgee,Governor,Kevin Stitt,REP,560031,1,2,25,28,
Okmulgee,Lieutenant Governor,Dana Murphy,REP,560031,1,0,14,15,
Okmulgee,Lieutenant Governor,Matt Pinnell,REP,560031,0,1,17,18,
Okmulgee,State Auditor,Cindy Byrd,REP,560031,1,1,16,18,
Okmulgee,State Auditor,Charlie Prater,REP,560031,0,0,15,15,
Okmulgee,Attorney General,Mike Hunter,REP,560031,1,0,12,13,
Okmulgee,Attorney General,Gentner Drummond,REP,560031,0,1,19,20,
Okmulgee,Superintendent of Public Instruction,Joy Hofmeister,REP,560031,0,1,13,14,
Okmulgee,Superintendent of Public Instruction,Linda Murphy,REP,560031,1,0,18,19,
Okmulgee,Commissioner of Labor,Cathy Costello,REP,560031,1,1,17,19,
Okmulgee,Commissioner of Labor,Leslie Osborn,REP,560031,0,0,14,14,
Okmulgee,Corporation Commissioner,Bob Anthony,REP,560031,1,2,7,10,
Okmulgee,Corporation Commissioner,Brian Bingman,REP,560031,0,0,24,24,
Okmulgee,Governor,Chris Powell,LIB,560031,0,0,0,0,
Okmulgee,Governor,Rex Lawhorn,LIB,560031,0,0,0,0,
Okmulgee,Corporation Commissioner,Ashley Nicole Mccray,DEM,560031,0,0,20,20,
Okmulgee,Corporation Commissioner,Blake Cummings,DEM,560031,0,0,13,13,
Okmulgee,U.S. House,Jason Nichols,DEM,560031,0,0,17,17,02
Okmulgee,U.S. House,Clay Padgett,DEM,560031,0,0,16,16,02
Okmulgee,Governor,Mick Cornett,REP,560032,2,0,9,11,
Okmulgee,Governor,Kevin Stitt,REP,560032,1,5,30,36,
Okmulgee,Lieutenant Governor,Dana Murphy,REP,560032,2,1,14,17,
Okmulgee,Lieutenant Governor,Matt Pinnell,REP,560032,0,4,24,28,
Okmulgee,State Auditor,Cindy Byrd,REP,560032,1,3,15,19,
Okmulgee,State Auditor,Charlie Prater,REP,560032,1,2,23,26,
Okmulgee,Attorney General,Mike Hunter,REP,560032,0,3,14,17,
Okmulgee,Attorney General,Gentner Drummond,REP,560032,2,2,24,28,
Okmulgee,Superintendent of Public Instruction,Joy Hofmeister,REP,560032,0,2,17,19,
Okmulgee,Superintendent of Public Instruction,Linda Murphy,REP,560032,2,3,22,27,
Okmulgee,Commissioner of Labor,Cathy Costello,REP,560032,2,0,18,20,
Okmulgee,Commissioner of Labor,Leslie Osborn,REP,560032,0,5,21,26,
Okmulgee,Corporation Commissioner,Bob Anthony,REP,560032,0,2,18,20,
Okmulgee,Corporation Commissioner,Brian Bingman,REP,560032,2,3,18,23,
Okmulgee,Governor,Chris Powell,LIB,560032,0,0,0,0,
Okmulgee,Governor,Rex Lawhorn,LIB,560032,0,0,0,0,
Okmulgee,Corporation Commissioner,Ashley Nicole Mccray,DEM,560032,0,0,29,29,
Okmulgee,Corporation Commissioner,Blake Cummings,DEM,560032,0,1,17,18,
Okmulgee,U.S. House,Jason Nichols,DEM,560032,0,0,28,28,02
Okmulgee,U.S. House,Clay Padgett,DEM,560032,0,1,18,19,02
Okmulgee,Governor,Mick Cornett,REP,560033,0,2,19,21,
Okmulgee,Governor,Kevin Stitt,REP,560033,0,1,40,41,
Okmulgee,Lieutenant Governor,Dana Murphy,REP,560033,0,1,12,13,
Okmulgee,Lieutenant Governor,Matt Pinnell,REP,560033,0,1,40,41,
Okmulgee,State Auditor,Cindy Byrd,REP,560033,0,2,21,23,
Okmulgee,State Auditor,Charlie Prater,REP,560033,0,1,30,31,
Okmulgee,Attorney General,Mike Hunter,REP,560033,0,3,17,20,
Okmulgee,Attorney General,Gentner Drummond,REP,560033,0,0,40,40,
Okmulgee,Superintendent of Public Instruction,Joy Hofmeister,REP,560033,0,2,31,33,
Okmulgee,Superintendent of Public Instruction,Linda Murphy,REP,560033,0,1,26,27,
Okmulgee,Commissioner of Labor,Cathy Costello,REP,560033,0,0,25,25,
Okmulgee,Commissioner of Labor,Leslie Osborn,REP,560033,0,1,30,31,
Okmulgee,Corporation Commissioner,Bob Anthony,REP,560033,0,0,26,26,
Okmulgee,Corporation Commissioner,Brian Bingman,REP,560033,0,2,29,31,
Okmulgee,Governor,Chris Powell,LIB,560033,0,0,1,1,
Okmulgee,Governor,Rex Lawhorn,LIB,560033,0,0,0,0,
Okmulgee,Corporation Commissioner,Ashley Nicole Mccray,DEM,560033,0,4,23,27,
Okmulgee,Corporation Commissioner,Blake Cummings,DEM,560033,2,1,17,20,
Okmulgee,U.S. House,Jason Nichols,DEM,560033,0,1,22,23,02
Okmulgee,U.S. House,Clay Padgett,DEM,560033,2,4,18,24,02
Okmulgee,Governor,Mick Cornett,REP,560034,0,0,13,13,
Okmulgee,Governor,Kevin Stitt,REP,560034,0,0,61,61,
Okmulgee,Lieutenant Governor,Dana Murphy,REP,560034,0,0,21,21,
Okmulgee,Lieutenant Governor,Matt Pinnell,REP,560034,0,0,53,53,
Okmulgee,State Auditor,Cindy Byrd,REP,560034,0,0,25,25,
Okmulgee,State Auditor,Charlie Prater,REP,560034,0,0,47,47,
Okmulgee,Attorney General,Mike Hunter,REP,560034,0,0,16,16,
Okmulgee,Attorney General,Gentner Drummond,REP,560034,0,0,59,59,
Okmulgee,Superintendent of Public Instruction,Joy Hofmeister,REP,560034,0,0,39,39,
Okmulgee,Superintendent of Public Instruction,Linda Murphy,REP,560034,0,0,36,36,
Okmulgee,Commissioner of Labor,Cathy Costello,REP,560034,0,0,30,30,
Okmulgee,Commissioner of Labor,Leslie Osborn,REP,560034,0,0,41,41,
Okmulgee,Corporation Commissioner,Bob Anthony,REP,560034,0,0,33,33,
Okmulgee,Corporation Commissioner,Brian Bingman,REP,560034,0,0,39,39,
Okmulgee,Governor,Chris Powell,LIB,560034,0,0,0,0,
Okmulgee,Governor,Rex Lawhorn,LIB,560034,0,0,0,0,
Okmulgee,Corporation Commissioner,Ashley Nicole Mccray,DEM,560034,1,2,18,21,
Okmulgee,Corporation Commissioner,Blake Cummings,DEM,560034,0,0,20,20,
Okmulgee,U.S. House,Jason Nichols,DEM,560034,1,0,27,28,02
Okmulgee,U.S. House,Clay Padgett,DEM,560034,0,2,11,13,02
Okmulgee,Governor,Mick Cornett,REP,560035,0,0,9,9,
Okmulgee,Governor,Kevin Stitt,REP,560035,0,2,30,32,
Okmulgee,Lieutenant Governor,Dana Murphy,REP,560035,0,1,10,11,
Okmulgee,Lieutenant Governor,Matt Pinnell,REP,560035,0,1,29,30,
Okmulgee,State Auditor,Cindy Byrd,REP,560035,0,2,15,17,
Okmulgee,State Auditor,Charlie Prater,REP,560035,0,0,24,24,
Okmulgee,Attorney General,Mike Hunter,REP,560035,0,0,24,24,
Okmulgee,Attorney General,Gentner Drummond,REP,560035,0,2,15,17,
Okmulgee,Superintendent of Public Instruction,Joy Hofmeister,REP,560035,0,0,13,13,
Okmulgee,Superintendent of Public Instruction,Linda Murphy,REP,560035,0,2,26,28,
Okmulgee,Commissioner of Labor,Cathy Costello,REP,560035,0,2,17,19,
Okmulgee,Commissioner of Labor,Leslie Osborn,REP,560035,0,0,21,21,
Okmulgee,Corporation Commissioner,Bob Anthony,REP,560035,0,0,15,15,
Okmulgee,Corporation Commissioner,Brian Bingman,REP,560035,0,2,24,26,
Okmulgee,Governor,Chris Powell,LIB,560035,0,0,0,0,
Okmulgee,Governor,Rex Lawhorn,LIB,560035,0,0,0,0,
Okmulgee,Corporation Commissioner,Ashley Nicole Mccray,DEM,560035,0,0,21,21,
Okmulgee,Corporation Commissioner,Blake Cummings,DEM,560035,0,0,12,12,
Okmulgee,U.S. House,Jason Nichols,DEM,560035,0,0,21,21,02
Okmulgee,U.S. House,Clay Padgett,DEM,560035,0,0,12,12,02
Okmulgee,Governor,Mick Cornett,REP,560036,1,1,46,48,
Okmulgee,Governor,Kevin Stitt,REP,560036,1,8,77,86,
Okmulgee,Lieutenant Governor,Dana Murphy,REP,560036,0,2,40,42,
Okmulgee,Lieutenant Governor,Matt Pinnell,REP,560036,2,6,80,88,
Okmulgee,State Auditor,Cindy Byrd,REP,560036,1,5,40,46,
Okmulgee,State Auditor,Charlie Prater,REP,560036,1,3,77,81,
Okmulgee,Attorney General,Mike Hunter,REP,560036,0,2,52,54,
Okmulgee,Attorney General,Gentner Drummond,REP,560036,2,7,67,76,
Okmulgee,Superintendent of Public Instruction,Joy Hofmeister,REP,560036,2,4,72,78,
Okmulgee,Superintendent of Public Instruction,Linda Murphy,REP,560036,0,5,47,52,
Okmulgee,Commissioner of Labor,Cathy Costello,REP,560036,1,7,51,59,
Okmulgee,Commissioner of Labor,Leslie Osborn,REP,560036,1,1,67,69,
Okmulgee,Corporation Commissioner,Bob Anthony,REP,560036,0,3,57,60,
Okmulgee,Corporation Commissioner,Brian Bingman,REP,560036,2,6,63,71,
Okmulgee,Governor,Chris Powell,LIB,560036,0,0,0,0,
Okmulgee,Governor,Rex Lawhorn,LIB,560036,0,0,0,0,
Okmulgee,Corporation Commissioner,Ashley Nicole Mccray,DEM,560036,4,2,52,58,
Okmulgee,Corporation Commissioner,Blake Cummings,DEM,560036,2,2,58,62,
Okmulgee,U.S. House,Jason Nichols,DEM,560036,3,2,72,77,02
Okmulgee,U.S. House,Clay Padgett,DEM,560036,3,2,40,45,02
Okmulgee,Governor,Mick Cornett,REP,560038,0,1,9,10,
Okmulgee,Governor,Kevin Stitt,REP,560038,0,2,24,26,
Okmulgee,Lieutenant Governor,Dana Murphy,REP,560038,0,0,9,9,
Okmulgee,Lieutenant Governor,Matt Pinnell,REP,560038,0,3,23,26,
Okmulgee,State Auditor,Cindy Byrd,REP,560038,0,3,11,14,
Okmulgee,State Auditor,Charlie Prater,REP,560038,0,0,21,21,
Okmulgee,Attorney General,Mike Hunter,REP,560038,0,1,9,10,
Okmulgee,Attorney General,Gentner Drummond,REP,560038,0,2,24,26,
Okmulgee,Superintendent of Public Instruction,Joy Hofmeister,REP,560038,0,0,13,13,
Okmulgee,Superintendent of Public Instruction,Linda Murphy,REP,560038,0,3,19,22,
Okmulgee,Commissioner of Labor,Cathy Costello,REP,560038,0,3,15,18,
Okmulgee,Commissioner of Labor,Leslie Osborn,REP,560038,0,0,16,16,
Okmulgee,Corporation Commissioner,Bob Anthony,REP,560038,0,3,17,20,
Okmulgee,Corporation Commissioner,Brian Bingman,REP,560038,0,0,14,14,
Okmulgee,Governor,Chris Powell,LIB,560038,0,0,0,0,
Okmulgee,Governor,Rex Lawhorn,LIB,560038,0,0,0,0,
Okmulgee,Corporation Commissioner,Ashley Nicole Mccray,DEM,560038,0,0,17,17,
Okmulgee,Corporation Commissioner,Blake Cummings,DEM,560038,0,0,17,17,
Okmulgee,U.S. House,Jason Nichols,DEM,560038,0,0,24,24,02
Okmulgee,U.S. House,Clay Padgett,DEM,560038,0,0,10,10,02
Osage,Governor,Mick Cornett,REP,570101,0,0,16,16,
Osage,Governor,Kevin Stitt,REP,570101,0,1,33,34,
Osage,Lieutenant Governor,Dana Murphy,REP,570101,0,0,18,18,
Osage,Lieutenant Governor,Matt Pinnell,REP,570101,0,1,29,30,
Osage,State Auditor,Cindy Byrd,REP,570101,0,1,19,20,
Osage,State Auditor,Charlie Prater,REP,570101,0,0,24,24,
Osage,Attorney General,Mike Hunter,REP,570101,0,1,17,18,
Osage,Attorney General,Gentner Drummond,REP,570101,0,0,32,32,
Osage,Superintendent of Public Instruction,Joy Hofmeister,REP,570101,0,0,26,26,
Osage,Superintendent of Public Instruction,Linda Murphy,REP,570101,0,1,20,21,
Osage,Commissioner of Labor,Cathy Costello,REP,570101,0,0,18,18,
Osage,Commissioner of Labor,Leslie Osborn,REP,570101,0,1,26,27,
Osage,Corporation Commissioner,Bob Anthony,REP,570101,0,0,15,15,
Osage,Corporation Commissioner,Brian Bingman,REP,570101,0,1,33,34,
Osage,State Senate,Bill Coleman,REP,570101,0,1,31,32,10
Osage,State Senate,Amber Roberts,REP,570101,0,0,15,15,10
Osage,State House,Travis Dunlap,REP,570101,0,0,1,1,10
Osage,State House,Judd Strom,REP,570101,0,1,49,50,10
Osage,Governor,Chris Powell,LIB,570101,0,0,0,0,
Osage,Governor,Rex Lawhorn,LIB,570101,0,0,0,0,
Osage,Corporation Commissioner,Ashley Nicole Mccray,DEM,570101,0,0,2,2,
Osage,Corporation Commissioner,Blake Cummings,DEM,570101,0,0,9,9,
Osage,Governor,Mick Cornett,REP,570102,2,1,10,13,
Osage,Governor,Kevin Stitt,REP,570102,0,1,27,28,
Osage,Lieutenant Governor,Dana Murphy,REP,570102,0,2,14,16,
Osage,Lieutenant Governor,Matt Pinnell,REP,570102,2,0,23,25,
Osage,State Auditor,Cindy Byrd,REP,570102,0,2,17,19,
Osage,State Auditor,Charlie Prater,REP,570102,2,0,18,20,
Osage,Attorney General,Mike Hunter,REP,570102,0,0,11,11,
Osage,Attorney General,Gentner Drummond,REP,570102,2,2,26,30,
Osage,Superintendent of Public Instruction,Joy Hofmeister,REP,570102,0,0,15,15,
Osage,Superintendent of Public Instruction,Linda Murphy,REP,570102,2,2,22,26,
Osage,Commissioner of Labor,Cathy Costello,REP,570102,0,2,21,23,
Osage,Commissioner of Labor,Leslie Osborn,REP,570102,2,0,16,18,
Osage,Corporation Commissioner,Bob Anthony,REP,570102,0,1,21,22,
Osage,Corporation Commissioner,Brian Bingman,REP,570102,2,1,16,19,
Osage,State Senate,Bill Coleman,REP,570102,2,1,14,17,10
Osage,State Senate,Amber Roberts,REP,570102,0,1,21,22,10
Osage,State House,Sean Roberts,REP,570102,2,2,21,25,36
Osage,State House,Louise Redcorn,REP,570102,0,0,16,16,36
Osage,Governor,Chris Powell,LIB,570102,0,0,1,1,
Osage,Governor,Rex Lawhorn,LIB,570102,0,0,0,0,
Osage,Corporation Commissioner,Ashley Nicole Mccray,DEM,570102,4,0,7,11,
Osage,Corporation Commissioner,Blake Cummings,DEM,570102,0,0,4,4,
Osage,Governor,Mick Cornett,REP,570103,0,0,27,27,
Osage,Governor,Kevin Stitt,REP,570103,0,0,28,28,
Osage,Lieutenant Governor,Dana Murphy,REP,570103,0,0,23,23,
Osage,Lieutenant Governor,Matt Pinnell,REP,570103,0,0,32,32,
Osage,State Auditor,Cindy Byrd,REP,570103,0,0,22,22,
Osage,State Auditor,Charlie Prater,REP,570103,0,0,33,33,
Osage,Attorney General,Mike Hunter,REP,570103,0,0,33,33,
Osage,Attorney General,Gentner Drummond,REP,570103,0,0,24,24,
Osage,Superintendent of Public Instruction,Joy Hofmeister,REP,570103,0,0,27,27,
Osage,Superintendent of Public Instruction,Linda Murphy,REP,570103,0,0,28,28,
Osage,Commissioner of Labor,Cathy Costello,REP,570103,0,0,18,18,
Osage,Commissioner of Labor,Leslie Osborn,REP,570103,0,0,37,37,
Osage,Corporation Commissioner,Bob Anthony,REP,570103,0,0,20,20,
Osage,Corporation Commissioner,Brian Bingman,REP,570103,0,0,35,35,
Osage,State Senate,Bill Coleman,REP,570103,0,0,30,30,10
Osage,State Senate,Amber Roberts,REP,570103,0,0,25,25,10
Osage,Governor,Chris Powell,LIB,570103,0,0,0,0,
Osage,Governor,Rex Lawhorn,LIB,570103,0,0,0,0,
Osage,Corporation Commissioner,Ashley Nicole Mccray,DEM,570103,1,0,10,11,
Osage,Corporation Commissioner,Blake Cummings,DEM,570103,0,0,11,11,
Osage,Governor,Mick Cornett,REP,570105,3,0,101,104,
Osage,Governor,Kevin Stitt,REP,570105,15,0,95,110,
Osage,Lieutenant Governor,Dana Murphy,REP,570105,12,0,84,96,
Osage,Lieutenant Governor,Matt Pinnell,REP,570105,6,0,108,114,
Osage,State Auditor,Cindy Byrd,REP,570105,10,0,71,81,
Osage,State Auditor,Charlie Prater,REP,570105,8,0,115,123,
Osage,Attorney General,Mike Hunter,REP,570105,8,0,75,83,
Osage,Attorney General,Gentner Drummond,REP,570105,10,0,116,126,
Osage,Superintendent of Public Instruction,Joy Hofmeister,REP,570105,6,0,81,87,
Osage,Superintendent of Public Instruction,Linda Murphy,REP,570105,12,0,106,118,
Osage,Commissioner of Labor,Cathy Costello,REP,570105,6,0,73,79,
Osage,Commissioner of Labor,Leslie Osborn,REP,570105,12,0,114,126,
Osage,Corporation Commissioner,Bob Anthony,REP,570105,11,0,91,102,
Osage,Corporation Commissioner,Brian Bingman,REP,570105,7,0,97,104,
Osage,State Senate,Bill Coleman,REP,570105,11,0,140,151,10
Osage,State Senate,Amber Roberts,REP,570105,7,0,48,55,10
Osage,Governor,Chris Powell,LIB,570105,0,0,0,0,
Osage,Governor,Rex Lawhorn,LIB,570105,0,0,1,1,
Osage,Corporation Commissioner,Ashley Nicole Mccray,DEM,570105,6,1,35,42,
Osage,Corporation Commissioner,Blake Cummings,DEM,570105,2,0,15,17,
Osage,Governor,Mick Cornett,REP,570106,0,0,7,7,
Osage,Governor,Kevin Stitt,REP,570106,0,0,8,8,
Osage,Lieutenant Governor,Dana Murphy,REP,570106,0,0,11,11,
Osage,Lieutenant Governor,Matt Pinnell,REP,570106,0,0,4,4,
Osage,State Auditor,Cindy Byrd,REP,570106,0,0,3,3,
Osage,State Auditor,Charlie Prater,REP,570106,0,0,10,10,
Osage,Attorney General,Mike Hunter,REP,570106,0,0,4,4,
Osage,Attorney General,Gentner Drummond,REP,570106,0,0,11,11,
Osage,Superintendent of Public Instruction,Joy Hofmeister,REP,570106,0,0,10,10,
Osage,Superintendent of Public Instruction,Linda Murphy,REP,570106,0,0,5,5,
Osage,Commissioner of Labor,Cathy Costello,REP,570106,0,0,4,4,
Osage,Commissioner of Labor,Leslie Osborn,REP,570106,0,0,9,9,
Osage,Corporation Commissioner,Bob Anthony,REP,570106,0,0,5,5,
Osage,Corporation Commissioner,Brian Bingman,REP,570106,0,0,10,10,
Osage,State Senate,Bill Coleman,REP,570106,0,0,12,12,10
Osage,State Senate,Amber Roberts,REP,570106,0,0,2,2,10
Osage,Governor,Chris Powell,LIB,570106,0,0,0,0,
Osage,Governor,Rex Lawhorn,LIB,570106,0,0,0,0,
Osage,Corporation Commissioner,Ashley Nicole Mccray,DEM,570106,0,0,8,8,
Osage,Corporation Commissioner,Blake Cummings,DEM,570106,0,0,2,2,
Osage,Governor,Mick Cornett,REP,570107,7,15,86,108,
Osage,Governor,Kevin Stitt,REP,570107,5,15,99,119,
Osage,Lieutenant Governor,Dana Murphy,REP,570107,3,12,80,95,
Osage,Lieutenant Governor,Matt Pinnell,REP,570107,10,15,104,129,
Osage,State Auditor,Cindy Byrd,REP,570107,5,15,101,121,
Osage,State Auditor,Charlie Prater,REP,570107,7,14,80,101,
Osage,Attorney General,Mike Hunter,REP,570107,5,16,69,90,
Osage,Attorney General,Gentner Drummond,REP,570107,8,13,119,140,
Osage,Superintendent of Public Instruction,Joy Hofmeister,REP,570107,9,19,110,138,
Osage,Superintendent of Public Instruction,Linda Murphy,REP,570107,4,9,72,85,
Osage,Commissioner of Labor,Cathy Costello,REP,570107,7,16,76,99,
Osage,Commissioner of Labor,Leslie Osborn,REP,570107,5,11,103,119,
Osage,Corporation Commissioner,Bob Anthony,REP,570107,5,16,101,122,
Osage,Corporation Commissioner,Brian Bingman,REP,570107,7,12,76,95,
Osage,State Senate,Bill Coleman,REP,570107,13,24,123,160,10
Osage,State Senate,Amber Roberts,REP,570107,0,5,58,63,10
Osage,Governor,Chris Powell,LIB,570107,0,0,0,0,
Osage,Governor,Rex Lawhorn,LIB,570107,0,0,1,1,
Osage,Corporation Commissioner,Ashley Nicole Mccray,DEM,570107,4,7,51,62,
Osage,Corporation Commissioner,Blake Cummings,DEM,570107,1,6,40,47,
Osage,Governor,Mick Cornett,REP,570108,0,13,56,69,
Osage,Governor,Kevin Stitt,REP,570108,2,9,52,63,
Osage,Lieutenant Governor,Dana Murphy,REP,570108,0,8,58,66,
Osage,Lieutenant Governor,Matt Pinnell,REP,570108,2,11,47,60,
Osage,State Auditor,Cindy Byrd,REP,570108,2,11,47,60,
Osage,State Auditor,Charlie Prater,REP,570108,0,8,55,63,
Osage,Attorney General,Mike Hunter,REP,570108,0,5,49,54,
Osage,Attorney General,Gentner Drummond,REP,570108,2,18,59,79,
Osage,Superintendent of Public Instruction,Joy Hofmeister,REP,570108,2,14,57,73,
Osage,Superintendent of Public Instruction,Linda Murphy,REP,570108,0,9,48,57,
Osage,Commissioner of Labor,Cathy Costello,REP,570108,1,8,48,57,
Osage,Commissioner of Labor,Leslie Osborn,REP,570108,1,11,55,67,
Osage,Corporation Commissioner,Bob Anthony,REP,570108,1,12,56,69,
Osage,Corporation Commissioner,Brian Bingman,REP,570108,1,9,46,56,
Osage,State Senate,Bill Coleman,REP,570108,2,16,83,101,10
Osage,State Senate,Amber Roberts,REP,570108,0,5,22,27,10
Osage,State House,Sean Roberts,REP,570108,0,4,27,31,36
Osage,State House,Louise Redcorn,REP,570108,2,19,80,101,36
Osage,Governor,Chris Powell,LIB,570108,0,0,2,2,
Osage,Governor,Rex Lawhorn,LIB,570108,0,1,1,2,
Osage,Corporation Commissioner,Ashley Nicole Mccray,DEM,570108,2,2,33,37,
Osage,Corporation Commissioner,Blake Cummings,DEM,570108,1,3,28,32,
Osage,Governor,Mick Cornett,REP,570109,3,1,84,88,
Osage,Governor,Kevin Stitt,REP,570109,6,0,151,157,
Osage,Lieutenant Governor,Dana Murphy,REP,570109,7,1,91,99,
Osage,Lieutenant Governor,Matt Pinnell,REP,570109,2,0,140,142,
Osage,State Auditor,Cindy Byrd,REP,570109,3,1,98,102,
Osage,State Auditor,Charlie Prater,REP,570109,6,0,123,129,
Osage,Attorney General,Mike Hunter,REP,570109,4,0,97,101,
Osage,Attorney General,Gentner Drummond,REP,570109,5,1,139,145,
Osage,Superintendent of Public Instruction,Joy Hofmeister,REP,570109,4,1,135,140,
Osage,Superintendent of Public Instruction,Linda Murphy,REP,570109,5,0,99,104,
Osage,Commissioner of Labor,Cathy Costello,REP,570109,5,1,113,119,
Osage,Commissioner of Labor,Leslie Osborn,REP,570109,4,0,107,111,
Osage,Corporation Commissioner,Bob Anthony,REP,570109,7,1,100,108,
Osage,Corporation Commissioner,Brian Bingman,REP,570109,2,0,123,125,
Osage,State Senate,Bill Coleman,REP,570109,2,1,150,153,10
Osage,State Senate,Amber Roberts,REP,570109,6,0,69,75,10
Osage,State House,Travis Dunlap,REP,570109,4,1,102,107,10
Osage,State House,Judd Strom,REP,570109,5,0,137,142,10
Osage,Governor,Chris Powell,LIB,570109,0,0,0,0,
Osage,Governor,Rex Lawhorn,LIB,570109,0,0,0,0,
Osage,Corporation Commissioner,Ashley Nicole Mccray,DEM,570109,2,0,17,19,
Osage,Corporation Commissioner,Blake Cummings,DEM,570109,1,0,7,8,
Osage,Governor,Mick Cornett,REP,570110,2,2,42,46,
Osage,Governor,Kevin Stitt,REP,570110,3,3,107,113,
Osage,Lieutenant Governor,Dana Murphy,REP,570110,2,0,55,57,
Osage,Lieutenant Governor,Matt Pinnell,REP,570110,3,5,90,98,
Osage,State Auditor,Cindy Byrd,REP,570110,3,2,63,68,
Osage,State Auditor,Charlie Prater,REP,570110,2,3,81,86,
Osage,Attorney General,Mike Hunter,REP,570110,1,2,57,60,
Osage,Attorney General,Gentner Drummond,REP,570110,4,3,93,100,
Osage,Superintendent of Public Instruction,Joy Hofmeister,REP,570110,4,1,75,80,
Osage,Superintendent of Public Instruction,Linda Murphy,REP,570110,1,4,70,75,
Osage,Commissioner of Labor,Cathy Costello,REP,570110,1,2,69,72,
Osage,Commissioner of Labor,Leslie Osborn,REP,570110,4,3,76,83,
Osage,Corporation Commissioner,Bob Anthony,REP,570110,4,3,75,82,
Osage,Corporation Commissioner,Brian Bingman,REP,570110,1,2,67,70,
Osage,State Senate,Bill Coleman,REP,570110,5,4,98,107,10
Osage,State Senate,Amber Roberts,REP,570110,0,1,47,48,10
Osage,State House,Sean Roberts,REP,570110,1,3,81,85,36
Osage,State House,Louise Redcorn,REP,570110,4,2,65,71,36
Osage,Governor,Chris Powell,LIB,570110,0,0,0,0,
Osage,Governor,Rex Lawhorn,LIB,570110,0,0,0,0,
Osage,Corporation Commissioner,Ashley Nicole Mccray,DEM,570110,8,0,13,21,
Osage,Corporation Commissioner,Blake Cummings,DEM,570110,1,1,28,30,
Osage,Governor,Mick Cornett,REP,570111,0,3,25,28,
Osage,Governor,Kevin Stitt,REP,570111,0,6,39,45,
Osage,Lieutenant Governor,Dana Murphy,REP,570111,0,1,28,29,
Osage,Lieutenant Governor,Matt Pinnell,REP,570111,0,8,35,43,
Osage,State Auditor,Cindy Byrd,REP,570111,0,7,31,38,
Osage,State Auditor,Charlie Prater,REP,570111,0,2,31,33,
Osage,Attorney General,Mike Hunter,REP,570111,0,6,26,32,
Osage,Attorney General,Gentner Drummond,REP,570111,0,3,38,41,
Osage,Superintendent of Public Instruction,Joy Hofmeister,REP,570111,0,5,33,38,
Osage,Superintendent of Public Instruction,Linda Murphy,REP,570111,0,4,31,35,
Osage,Commissioner of Labor,Cathy Costello,REP,570111,0,0,24,24,
Osage,Commissioner of Labor,Leslie Osborn,REP,570111,0,9,38,47,
Osage,Corporation Commissioner,Bob Anthony,REP,570111,0,5,20,25,
Osage,Corporation Commissioner,Brian Bingman,REP,570111,0,4,44,48,
Osage,State Senate,Bill Coleman,REP,570111,0,9,44,53,10
Osage,State Senate,Amber Roberts,REP,570111,0,0,20,20,10
Osage,State House,Sean Roberts,REP,570111,0,3,24,27,36
Osage,State House,Louise Redcorn,REP,570111,0,5,34,39,36
Osage,Governor,Chris Powell,LIB,570111,0,0,0,0,
Osage,Governor,Rex Lawhorn,LIB,570111,0,0,0,0,
Osage,Corporation Commissioner,Ashley Nicole Mccray,DEM,570111,0,0,11,11,
Osage,Corporation Commissioner,Blake Cummings,DEM,570111,0,0,16,16,
Osage,Governor,Mick Cornett,REP,570112,4,1,22,27,
Osage,Governor,Kevin Stitt,REP,570112,7,6,57,70,
Osage,Lieutenant Governor,Dana Murphy,REP,570112,2,2,32,36,
Osage,Lieutenant Governor,Matt Pinnell,REP,570112,8,5,44,57,
Osage,State Auditor,Cindy Byrd,REP,570112,9,5,35,49,
Osage,State Auditor,Charlie Prater,REP,570112,2,1,37,40,
Osage,Attorney General,Mike Hunter,REP,570112,5,0,27,32,
Osage,Attorney General,Gentner Drummond,REP,570112,6,7,52,65,
Osage,Superintendent of Public Instruction,Joy Hofmeister,REP,570112,7,0,33,40,
Osage,Superintendent of Public Instruction,Linda Murphy,REP,570112,4,7,44,55,
Osage,Commissioner of Labor,Cathy Costello,REP,570112,1,6,40,47,
Osage,Commissioner of Labor,Leslie Osborn,REP,570112,10,0,35,45,
Osage,Corporation Commissioner,Bob Anthony,REP,570112,4,2,38,44,
Osage,Corporation Commissioner,Brian Bingman,REP,570112,7,4,38,49,
Osage,State Senate,Bill Coleman,REP,570112,8,1,39,48,10
Osage,State Senate,Amber Roberts,REP,570112,3,6,34,43,10
Osage,State House,Sean Roberts,REP,570112,6,7,42,55,36
Osage,State House,Louise Redcorn,REP,570112,5,0,35,40,36
Osage,Governor,Chris Powell,LIB,570112,0,0,0,0,
Osage,Governor,Rex Lawhorn,LIB,570112,0,0,0,0,
Osage,Corporation Commissioner,Ashley Nicole Mccray,DEM,570112,2,0,7,9,
Osage,Corporation Commissioner,Blake Cummings,DEM,570112,0,0,14,14,
Osage,Governor,Mick Cornett,REP,570113,0,0,4,4,
Osage,Governor,Kevin Stitt,REP,570113,0,0,5,5,
Osage,Lieutenant Governor,Dana Murphy,REP,570113,0,0,4,4,
Osage,Lieutenant Governor,Matt Pinnell,REP,570113,0,0,5,5,
Osage,State Auditor,Cindy Byrd,REP,570113,0,0,5,5,
Osage,State Auditor,Charlie Prater,REP,570113,0,0,4,4,
Osage,Attorney General,Mike Hunter,REP,570113,0,0,5,5,
Osage,Attorney General,Gentner Drummond,REP,570113,0,0,4,4,
Osage,Superintendent of Public Instruction,Joy Hofmeister,REP,570113,0,0,6,6,
Osage,Superintendent of Public Instruction,Linda Murphy,REP,570113,0,0,3,3,
Osage,Commissioner of Labor,Cathy Costello,REP,570113,0,0,3,3,
Osage,Commissioner of Labor,Leslie Osborn,REP,570113,0,0,5,5,
Osage,Corporation Commissioner,Bob Anthony,REP,570113,0,0,4,4,
Osage,Corporation Commissioner,Brian Bingman,REP,570113,0,0,5,5,
Osage,State Senate,Bill Coleman,REP,570113,0,0,7,7,10
Osage,State Senate,Amber Roberts,REP,570113,0,0,2,2,10
Osage,Governor,Chris Powell,LIB,570113,0,0,0,0,
Osage,Governor,Rex Lawhorn,LIB,570113,0,0,0,0,
Osage,Corporation Commissioner,Ashley Nicole Mccray,DEM,570113,2,0,4,6,
Osage,Corporation Commissioner,Blake Cummings,DEM,570113,0,0,0,0,
Osage,Governor,Mick Cornett,REP,570201,2,18,153,173,
Osage,Governor,Kevin Stitt,REP,570201,17,21,329,367,
Osage,Lieutenant Governor,Dana Murphy,REP,570201,7,16,163,186,
Osage,Lieutenant Governor,Matt Pinnell,REP,570201,11,20,314,345,
Osage,State Auditor,Cindy Byrd,REP,570201,6,19,224,249,
Osage,State Auditor,Charlie Prater,REP,570201,9,16,241,266,
Osage,Attorney General,Mike Hunter,REP,570201,6,19,196,221,
Osage,Attorney General,Gentner Drummond,REP,570201,12,20,282,314,
Osage,Superintendent of Public Instruction,Joy Hofmeister,REP,570201,11,24,253,288,
Osage,Superintendent of Public Instruction,Linda Murphy,REP,570201,8,14,221,243,
Osage,Commissioner of Labor,Cathy Costello,REP,570201,8,23,217,248,
Osage,Commissioner of Labor,Leslie Osborn,REP,570201,8,13,252,273,
Osage,Corporation Commissioner,Bob Anthony,REP,570201,9,29,218,256,
Osage,Corporation Commissioner,Brian Bingman,REP,570201,10,8,252,270,
Osage,State Senate,Bill Coleman,REP,570201,12,23,310,345,10
Osage,State Senate,Amber Roberts,REP,570201,5,12,163,180,10
Osage,State House,Sean Roberts,REP,570201,5,23,226,254,36
Osage,State House,Louise Redcorn,REP,570201,13,16,248,277,36
Osage,Governor,Chris Powell,LIB,570201,0,0,0,0,
Osage,Governor,Rex Lawhorn,LIB,570201,0,0,0,0,
Osage,Corporation Commissioner,Ashley Nicole Mccray,DEM,570201,0,5,56,61,
Osage,Corporation Commissioner,Blake Cummings,DEM,570201,1,3,36,40,
Osage,Governor,Mick Cornett,REP,570202,3,0,22,25,
Osage,Governor,Kevin Stitt,REP,570202,8,0,34,42,
Osage,Lieutenant Governor,Dana Murphy,REP,570202,3,0,22,25,
Osage,Lieutenant Governor,Matt Pinnell,REP,570202,8,0,32,40,
Osage,State Auditor,Cindy Byrd,REP,570202,8,0,24,32,
Osage,State Auditor,Charlie Prater,REP,570202,3,0,29,32,
Osage,Attorney General,Mike Hunter,REP,570202,3,0,19,22,
Osage,Attorney General,Gentner Drummond,REP,570202,8,0,36,44,
Osage,Superintendent of Public Instruction,Joy Hofmeister,REP,570202,5,0,33,38,
Osage,Superintendent of Public Instruction,Linda Murphy,REP,570202,6,0,23,29,
Osage,Commissioner of Labor,Cathy Costello,REP,570202,7,0,29,36,
Osage,Commissioner of Labor,Leslie Osborn,REP,570202,3,0,25,28,
Osage,Corporation Commissioner,Bob Anthony,REP,570202,6,0,28,34,
Osage,Corporation Commissioner,Brian Bingman,REP,570202,4,0,25,29,
Osage,Governor,Chris Powell,LIB,570202,0,0,1,1,
Osage,Governor,Rex Lawhorn,LIB,570202,0,0,0,0,
Osage,Corporation Commissioner,Ashley Nicole Mccray,DEM,570202,41,4,374,419,
Osage,Corporation Commissioner,Blake Cummings,DEM,570202,9,1,115,125,
Osage,Governor,Mick Cornett,REP,570203,9,37,185,231,
Osage,Governor,Kevin Stitt,REP,570203,13,39,409,461,
Osage,Lieutenant Governor,Dana Murphy,REP,570203,5,27,219,251,
Osage,Lieutenant Governor,Matt Pinnell,REP,570203,17,49,358,424,
Osage,State Auditor,Cindy Byrd,REP,570203,14,35,248,297,
Osage,State Auditor,Charlie Prater,REP,570203,8,37,322,367,
Osage,Attorney General,Mike Hunter,REP,570203,9,31,258,298,
Osage,Attorney General,Gentner Drummond,REP,570203,13,45,331,389,
Osage,Superintendent of Public Instruction,Joy Hofmeister,REP,570203,9,35,319,363,
Osage,Superintendent of Public Instruction,Linda Murphy,REP,570203,13,38,261,312,
Osage,Commissioner of Labor,Cathy Costello,REP,570203,15,27,280,322,
Osage,Commissioner of Labor,Leslie Osborn,REP,570203,7,48,293,348,
Osage,Corporation Commissioner,Bob Anthony,REP,570203,12,37,274,323,
Osage,Corporation Commissioner,Brian Bingman,REP,570203,9,37,296,342,
Osage,State Senate,Bill Coleman,REP,570203,16,56,385,457,10
Osage,State Senate,Amber Roberts,REP,570203,5,20,193,218,10
Osage,State House,Sean Roberts,REP,570203,10,22,318,350,36
Osage,State House,Louise Redcorn,REP,570203,12,54,269,335,36
Osage,Governor,Chris Powell,LIB,570203,0,0,0,0,
Osage,Governor,Rex Lawhorn,LIB,570203,0,0,0,0,
Osage,Corporation Commissioner,Ashley Nicole Mccray,DEM,570203,11,13,60,84,
Osage,Corporation Commissioner,Blake Cummings,DEM,570203,5,4,37,46,
Osage,Governor,Mick Cornett,REP,570204,2,1,42,45,
Osage,Governor,Kevin Stitt,REP,570204,5,1,87,93,
Osage,Lieutenant Governor,Dana Murphy,REP,570204,1,1,44,46,
Osage,Lieutenant Governor,Matt Pinnell,REP,570204,6,1,84,91,
Osage,State Auditor,Cindy Byrd,REP,570204,4,1,61,66,
Osage,State Auditor,Charlie Prater,REP,570204,3,1,65,69,
Osage,Attorney General,Mike Hunter,REP,570204,5,0,53,58,
Osage,Attorney General,Gentner Drummond,REP,570204,2,2,73,77,
Osage,Superintendent of Public Instruction,Joy Hofmeister,REP,570204,3,1,59,63,
Osage,Superintendent of Public Instruction,Linda Murphy,REP,570204,4,1,65,70,
Osage,Commissioner of Labor,Cathy Costello,REP,570204,3,1,44,48,
Osage,Commissioner of Labor,Leslie Osborn,REP,570204,4,1,81,86,
Osage,Corporation Commissioner,Bob Anthony,REP,570204,3,2,54,59,
Osage,Corporation Commissioner,Brian Bingman,REP,570204,3,0,69,72,
Osage,State Senate,Bill Coleman,REP,570204,6,2,73,81,10
Osage,State Senate,Amber Roberts,REP,570204,1,0,48,49,10
Osage,State House,Sean Roberts,REP,570204,5,1,62,68,36
Osage,State House,Louise Redcorn,REP,570204,2,1,63,66,36
Osage,Governor,Chris Powell,LIB,570204,0,0,0,0,
Osage,Governor,Rex Lawhorn,LIB,570204,0,0,0,0,
Osage,Corporation Commissioner,Ashley Nicole Mccray,DEM,570204,1,2,15,18,
Osage,Corporation Commissioner,Blake Cummings,DEM,570204,0,0,10,10,
Osage,Governor,Mick Cornett,REP,570205,0,0,14,14,
Osage,Governor,Kevin Stitt,REP,570205,2,0,25,27,
Osage,Lieutenant Governor,Dana Murphy,REP,570205,0,0,16,16,
Osage,Lieutenant Governor,Matt Pinnell,REP,570205,2,0,23,25,
Osage,State Auditor,Cindy Byrd,REP,570205,0,0,20,20,
Osage,State Auditor,Charlie Prater,REP,570205,2,0,17,19,
Osage,Attorney General,Mike Hunter,REP,570205,2,0,11,13,
Osage,Attorney General,Gentner Drummond,REP,570205,0,0,27,27,
Osage,Superintendent of Public Instruction,Joy Hofmeister,REP,570205,0,0,25,25,
Osage,Superintendent of Public Instruction,Linda Murphy,REP,570205,2,0,13,15,
Osage,Commissioner of Labor,Cathy Costello,REP,570205,0,0,20,20,
Osage,Commissioner of Labor,Leslie Osborn,REP,570205,2,0,19,21,
Osage,Corporation Commissioner,Bob Anthony,REP,570205,2,0,11,13,
Osage,Corporation Commissioner,Brian Bingman,REP,570205,0,0,27,27,
Osage,State House,Sean Roberts,REP,570205,2,0,26,28,36
Osage,State House,Louise Redcorn,REP,570205,0,0,11,11,36
Osage,Governor,Chris Powell,LIB,570205,0,0,0,0,
Osage,Governor,Rex Lawhorn,LIB,570205,0,0,0,0,
Osage,Corporation Commissioner,Ashley Nicole Mccray,DEM,570205,2,0,7,9,
Osage,Corporation Commissioner,Blake Cummings,DEM,570205,0,0,4,4,
Osage,Governor,Mick Cornett,REP,570301,0,1,36,37,
Osage,Governor,Kevin Stitt,REP,570301,1,0,54,55,
Osage,Lieutenant Governor,Dana Murphy,REP,570301,1,1,46,48,
Osage,Lieutenant Governor,Matt Pinnell,REP,570301,0,0,43,43,
Osage,State Auditor,Cindy Byrd,REP,570301,1,1,33,35,
Osage,State Auditor,Charlie Prater,REP,570301,0,0,55,55,
Osage,Attorney General,Mike Hunter,REP,570301,1,1,47,49,
Osage,Attorney General,Gentner Drummond,REP,570301,0,0,44,44,
Osage,Superintendent of Public Instruction,Joy Hofmeister,REP,570301,0,0,50,50,
Osage,Superintendent of Public Instruction,Linda Murphy,REP,570301,1,1,39,41,
Osage,Commissioner of Labor,Cathy Costello,REP,570301,0,0,44,44,
Osage,Commissioner of Labor,Leslie Osborn,REP,570301,1,1,40,42,
Osage,Corporation Commissioner,Bob Anthony,REP,570301,1,1,43,45,
Osage,Corporation Commissioner,Brian Bingman,REP,570301,0,0,43,43,
Osage,State Senate,Bill Coleman,REP,570301,0,1,64,65,10
Osage,State Senate,Amber Roberts,REP,570301,1,0,27,28,10
Osage,State House,Sean Roberts,REP,570301,0,0,31,31,36
Osage,State House,Louise Redcorn,REP,570301,1,1,59,61,36
Osage,Governor,Chris Powell,LIB,570301,0,0,0,0,
Osage,Governor,Rex Lawhorn,LIB,570301,0,0,0,0,
Osage,Corporation Commissioner,Ashley Nicole Mccray,DEM,570301,8,0,40,48,
Osage,Corporation Commissioner,Blake Cummings,DEM,570301,5,1,32,38,
Osage,Governor,Mick Cornett,REP,570302,4,0,8,12,
Osage,Governor,Kevin Stitt,REP,570302,1,1,16,18,
Osage,Lieutenant Governor,Dana Murphy,REP,570302,3,1,10,14,
Osage,Lieutenant Governor,Matt Pinnell,REP,570302,2,0,14,16,
Osage,State Auditor,Cindy Byrd,REP,570302,5,1,10,16,
Osage,State Auditor,Charlie Prater,REP,570302,0,0,14,14,
Osage,Attorney General,Mike Hunter,REP,570302,1,0,9,10,
Osage,Attorney General,Gentner Drummond,REP,570302,4,1,15,20,
Osage,Superintendent of Public Instruction,Joy Hofmeister,REP,570302,4,0,14,18,
Osage,Superintendent of Public Instruction,Linda Murphy,REP,570302,1,0,10,11,
Osage,Commissioner of Labor,Cathy Costello,REP,570302,1,1,14,16,
Osage,Commissioner of Labor,Leslie Osborn,REP,570302,3,0,10,13,
Osage,Corporation Commissioner,Bob Anthony,REP,570302,5,0,13,18,
Osage,Corporation Commissioner,Brian Bingman,REP,570302,0,1,10,11,
Osage,State Senate,Bill Coleman,REP,570302,5,1,19,25,10
Osage,State Senate,Amber Roberts,REP,570302,0,0,4,4,10
Osage,Governor,Chris Powell,LIB,570302,0,0,0,0,
Osage,Governor,Rex Lawhorn,LIB,570302,0,0,0,0,
Osage,Corporation Commissioner,Ashley Nicole Mccray,DEM,570302,0,0,4,4,
Osage,Corporation Commissioner,Blake Cummings,DEM,570302,0,0,9,9,
Osage,Governor,Mick Cornett,REP,570303,3,0,49,52,
Osage,Governor,Kevin Stitt,REP,570303,3,1,37,41,
Osage,Lieutenant Governor,Dana Murphy,REP,570303,3,1,41,45,
Osage,Lieutenant Governor,Matt Pinnell,REP,570303,3,0,44,47,
Osage,State Auditor,Cindy Byrd,REP,570303,5,1,30,36,
Osage,State Auditor,Charlie Prater,REP,570303,1,0,52,53,
Osage,Attorney General,Mike Hunter,REP,570303,4,1,35,40,
Osage,Attorney General,Gentner Drummond,REP,570303,2,0,51,53,
Osage,Superintendent of Public Instruction,Joy Hofmeister,REP,570303,2,0,49,51,
Osage,Superintendent of Public Instruction,Linda Murphy,REP,570303,4,1,36,41,
Osage,Commissioner of Labor,Cathy Costello,REP,570303,3,0,38,41,
Osage,Commissioner of Labor,Leslie Osborn,REP,570303,3,1,46,50,
Osage,Corporation Commissioner,Bob Anthony,REP,570303,4,0,47,51,
Osage,Corporation Commissioner,Brian Bingman,REP,570303,2,1,37,40,
Osage,State Senate,Bill Coleman,REP,570303,4,0,63,67,10
Osage,State Senate,Amber Roberts,REP,570303,2,1,23,26,10
Osage,Governor,Chris Powell,LIB,570303,0,0,0,0,
Osage,Governor,Rex Lawhorn,LIB,570303,0,0,0,0,
Osage,Corporation Commissioner,Ashley Nicole Mccray,DEM,570303,4,0,18,22,
Osage,Corporation Commissioner,Blake Cummings,DEM,570303,0,1,12,13,
Osage,Governor,Mick Cornett,REP,570305,7,1,26,34,
Osage,Governor,Kevin Stitt,REP,570305,3,1,58,62,
Osage,Lieutenant Governor,Dana Murphy,REP,570305,2,0,33,35,
Osage,Lieutenant Governor,Matt Pinnell,REP,570305,8,2,51,61,
Osage,State Auditor,Cindy Byrd,REP,570305,8,1,31,40,
Osage,State Auditor,Charlie Prater,REP,570305,2,1,50,53,
Osage,Attorney General,Mike Hunter,REP,570305,8,1,28,37,
Osage,Attorney General,Gentner Drummond,REP,570305,2,1,56,59,
Osage,Superintendent of Public Instruction,Joy Hofmeister,REP,570305,4,0,43,47,
Osage,Superintendent of Public Instruction,Linda Murphy,REP,570305,6,2,39,47,
Osage,Commissioner of Labor,Cathy Costello,REP,570305,5,2,32,39,
Osage,Commissioner of Labor,Leslie Osborn,REP,570305,5,0,49,54,
Osage,Corporation Commissioner,Bob Anthony,REP,570305,6,0,44,50,
Osage,Corporation Commissioner,Brian Bingman,REP,570305,4,2,40,46,
Osage,State Senate,Bill Coleman,REP,570305,10,1,54,65,10
Osage,State Senate,Amber Roberts,REP,570305,0,1,29,30,10
Osage,Governor,Chris Powell,LIB,570305,0,0,0,0,
Osage,Governor,Rex Lawhorn,LIB,570305,0,0,1,1,
Osage,Corporation Commissioner,Ashley Nicole Mccray,DEM,570305,5,0,19,24,
Osage,Corporation Commissioner,Blake Cummings,DEM,570305,3,0,11,14,
Osage,Governor,Mick Cornett,REP,570306,0,2,33,35,
Osage,Governor,Kevin Stitt,REP,570306,1,2,81,84,
Osage,Lieutenant Governor,Dana Murphy,REP,570306,0,4,46,50,
Osage,Lieutenant Governor,Matt Pinnell,REP,570306,1,0,66,67,
Osage,State Auditor,Cindy Byrd,REP,570306,0,2,51,53,
Osage,State Auditor,Charlie Prater,REP,570306,1,2,55,58,
Osage,Attorney General,Mike Hunter,REP,570306,0,1,47,48,
Osage,Attorney General,Gentner Drummond,REP,570306,1,3,66,70,
Osage,Superintendent of Public Instruction,Joy Hofmeister,REP,570306,0,2,55,57,
Osage,Superintendent of Public Instruction,Linda Murphy,REP,570306,1,2,53,56,
Osage,Commissioner of Labor,Cathy Costello,REP,570306,1,0,51,52,
Osage,Commissioner of Labor,Leslie Osborn,REP,570306,0,4,55,59,
Osage,Corporation Commissioner,Bob Anthony,REP,570306,1,2,55,58,
Osage,Corporation Commissioner,Brian Bingman,REP,570306,0,2,52,54,
Osage,State Senate,Bill Coleman,REP,570306,1,3,91,95,10
Osage,State Senate,Amber Roberts,REP,570306,0,1,19,20,10
Osage,State House,Sean Roberts,REP,570306,1,1,53,55,36
Osage,State House,Louise Redcorn,REP,570306,0,3,58,61,36
Osage,Governor,Chris Powell,LIB,570306,0,0,1,1,
Osage,Governor,Rex Lawhorn,LIB,570306,0,0,0,0,
Osage,Corporation Commissioner,Ashley Nicole Mccray,DEM,570306,2,0,10,12,
Osage,Corporation Commissioner,Blake Cummings,DEM,570306,0,0,28,28,
Osage,Governor,Mick Cornett,REP,570307,3,2,48,53,
Osage,Governor,Kevin Stitt,REP,570307,2,4,101,107,
Osage,Lieutenant Governor,Dana Murphy,REP,570307,1,3,73,77,
Osage,Lieutenant Governor,Matt Pinnell,REP,570307,4,3,74,81,
Osage,State Auditor,Cindy Byrd,REP,570307,4,6,85,95,
Osage,State Auditor,Charlie Prater,REP,570307,1,0,63,64,
Osage,Attorney General,Mike Hunter,REP,570307,1,3,56,60,
Osage,Attorney General,Gentner Drummond,REP,570307,4,2,94,100,
Osage,Superintendent of Public Instruction,Joy Hofmeister,REP,570307,2,2,86,90,
Osage,Superintendent of Public Instruction,Linda Murphy,REP,570307,3,4,62,69,
Osage,Commissioner of Labor,Cathy Costello,REP,570307,4,3,73,80,
Osage,Commissioner of Labor,Leslie Osborn,REP,570307,1,3,68,72,
Osage,Corporation Commissioner,Bob Anthony,REP,570307,1,2,60,63,
Osage,Corporation Commissioner,Brian Bingman,REP,570307,4,4,84,92,
Osage,State Senate,Bill Coleman,REP,570307,3,6,111,120,10
Osage,State Senate,Amber Roberts,REP,570307,2,0,39,41,10
Osage,State House,Sean Roberts,REP,570307,2,0,56,58,36
Osage,State House,Louise Redcorn,REP,570307,2,6,95,103,36
Osage,Governor,Chris Powell,LIB,570307,0,0,0,0,
Osage,Governor,Rex Lawhorn,LIB,570307,0,0,0,0,
Osage,Corporation Commissioner,Ashley Nicole Mccray,DEM,570307,1,0,33,34,
Osage,Corporation Commissioner,Blake Cummings,DEM,570307,2,0,36,38,
Osage,Governor,Mick Cornett,REP,570308,7,2,79,88,
Osage,Governor,Kevin Stitt,REP,570308,2,1,187,190,
Osage,Lieutenant Governor,Dana Murphy,REP,570308,6,2,97,105,
Osage,Lieutenant Governor,Matt Pinnell,REP,570308,3,1,164,168,
Osage,State Auditor,Cindy Byrd,REP,570308,5,2,125,132,
Osage,State Auditor,Charlie Prater,REP,570308,4,1,134,139,
Osage,Attorney General,Mike Hunter,REP,570308,2,3,84,89,
Osage,Attorney General,Gentner Drummond,REP,570308,7,0,183,190,
Osage,Superintendent of Public Instruction,Joy Hofmeister,REP,570308,7,2,130,139,
Osage,Superintendent of Public Instruction,Linda Murphy,REP,570308,2,1,126,129,
Osage,Commissioner of Labor,Cathy Costello,REP,570308,3,3,118,124,
Osage,Commissioner of Labor,Leslie Osborn,REP,570308,6,0,138,144,
Osage,Corporation Commissioner,Bob Anthony,REP,570308,5,3,118,126,
Osage,Corporation Commissioner,Brian Bingman,REP,570308,4,0,140,144,
Osage,State Senate,Bill Coleman,REP,570308,8,2,156,166,10
Osage,State Senate,Amber Roberts,REP,570308,1,1,103,105,10
Osage,State House,Sean Roberts,REP,570308,2,1,154,157,36
Osage,State House,Louise Redcorn,REP,570308,7,2,105,114,36
Osage,Governor,Chris Powell,LIB,570308,0,0,0,0,
Osage,Governor,Rex Lawhorn,LIB,570308,0,0,0,0,
Osage,Corporation Commissioner,Ashley Nicole Mccray,DEM,570308,3,0,38,41,
Osage,Corporation Commissioner,Blake Cummings,DEM,570308,1,0,15,16,
Osage,Governor,Mick Cornett,REP,570309,4,0,49,53,
Osage,Governor,Kevin Stitt,REP,570309,7,0,90,97,
Osage,Lieutenant Governor,Dana Murphy,REP,570309,8,0,56,64,
Osage,Lieutenant Governor,Matt Pinnell,REP,570309,2,0,82,84,
Osage,State Auditor,Cindy Byrd,REP,570309,3,0,53,56,
Osage,State Auditor,Charlie Prater,REP,570309,5,0,78,83,
Osage,Attorney General,Mike Hunter,REP,570309,3,0,50,53,
Osage,Attorney General,Gentner Drummond,REP,570309,8,0,90,98,
Osage,Superintendent of Public Instruction,Joy Hofmeister,REP,570309,3,0,71,74,
Osage,Superintendent of Public Instruction,Linda Murphy,REP,570309,7,0,61,68,
Osage,Commissioner of Labor,Cathy Costello,REP,570309,3,0,47,50,
Osage,Commissioner of Labor,Leslie Osborn,REP,570309,6,0,87,93,
Osage,Corporation Commissioner,Bob Anthony,REP,570309,6,0,64,70,
Osage,Corporation Commissioner,Brian Bingman,REP,570309,4,0,68,72,
Osage,State Senate,Bill Coleman,REP,570309,10,0,83,93,10
Osage,State Senate,Amber Roberts,REP,570309,0,0,53,53,10
Osage,State House,Sean Roberts,REP,570309,6,0,79,85,36
Osage,State House,Louise Redcorn,REP,570309,4,0,59,63,36
Osage,Governor,Chris Powell,LIB,570309,0,0,0,0,
Osage,Governor,Rex Lawhorn,LIB,570309,0,0,0,0,
Osage,Corporation Commissioner,Ashley Nicole Mccray,DEM,570309,3,0,13,16,
Osage,Corporation Commissioner,Blake Cummings,DEM,570309,0,0,11,11,
Osage,Governor,Mick Cornett,REP,570310,2,0,8,10,
Osage,Governor,Kevin Stitt,REP,570310,2,0,14,16,
Osage,Lieutenant Governor,Dana Murphy,REP,570310,0,0,8,8,
Osage,Lieutenant Governor,Matt Pinnell,REP,570310,4,0,12,16,
Osage,State Auditor,Cindy Byrd,REP,570310,0,0,6,6,
Osage,State Auditor,Charlie Prater,REP,570310,3,0,14,17,
Osage,Attorney General,Mike Hunter,REP,570310,1,0,4,5,
Osage,Attorney General,Gentner Drummond,REP,570310,3,0,16,19,
Osage,Superintendent of Public Instruction,Joy Hofmeister,REP,570310,2,0,13,15,
Osage,Superintendent of Public Instruction,Linda Murphy,REP,570310,2,0,8,10,
Osage,Commissioner of Labor,Cathy Costello,REP,570310,4,0,10,14,
Osage,Commissioner of Labor,Leslie Osborn,REP,570310,0,0,10,10,
Osage,Corporation Commissioner,Bob Anthony,REP,570310,2,0,15,17,
Osage,Corporation Commissioner,Brian Bingman,REP,570310,2,0,5,7,
Osage,Governor,Chris Powell,LIB,570310,0,0,0,0,
Osage,Governor,Rex Lawhorn,LIB,570310,0,0,0,0,
Osage,Corporation Commissioner,Ashley Nicole Mccray,DEM,570310,14,0,230,244,
Osage,Corporation Commissioner,Blake Cummings,DEM,570310,1,0,83,84,
Osage,Governor,Mick Cornett,REP,570311,4,0,7,11,
Osage,Governor,Kevin Stitt,REP,570311,0,2,5,7,
Osage,Lieutenant Governor,Dana Murphy,REP,570311,4,2,4,10,
Osage,Lieutenant Governor,Matt Pinnell,REP,570311,0,0,8,8,
Osage,State Auditor,Cindy Byrd,REP,570311,2,2,4,8,
Osage,State Auditor,Charlie Prater,REP,570311,2,0,8,10,
Osage,Attorney General,Mike Hunter,REP,570311,3,0,4,7,
Osage,Attorney General,Gentner Drummond,REP,570311,1,2,8,11,
Osage,Superintendent of Public Instruction,Joy Hofmeister,REP,570311,2,1,5,8,
Osage,Superintendent of Public Instruction,Linda Murphy,REP,570311,2,1,7,10,
Osage,Commissioner of Labor,Cathy Costello,REP,570311,4,2,6,12,
Osage,Commissioner of Labor,Leslie Osborn,REP,570311,0,0,6,6,
Osage,Corporation Commissioner,Bob Anthony,REP,570311,2,2,4,8,
Osage,Corporation Commissioner,Brian Bingman,REP,570311,2,0,8,10,
Osage,State House,Jadine Nollan,REP,570311,2,2,10,14,66
Osage,State House,Brian Jackson,REP,570311,2,0,2,4,66
Osage,Governor,Chris Powell,LIB,570311,0,0,0,0,
Osage,Governor,Rex Lawhorn,LIB,570311,0,0,0,0,
Osage,Corporation Commissioner,Ashley Nicole Mccray,DEM,570311,2,0,11,13,
Osage,Corporation Commissioner,Blake Cummings,DEM,570311,1,0,3,4,
Osage,Governor,Mick Cornett,REP,570312,1,0,48,49,
Osage,Governor,Kevin Stitt,REP,570312,7,0,100,107,
Osage,Lieutenant Governor,Dana Murphy,REP,570312,1,0,59,60,
Osage,Lieutenant Governor,Matt Pinnell,REP,570312,7,0,86,93,
Osage,State Auditor,Cindy Byrd,REP,570312,5,0,65,70,
Osage,State Auditor,Charlie Prater,REP,570312,3,0,76,79,
Osage,Attorney General,Mike Hunter,REP,570312,6,0,58,64,
Osage,Attorney General,Gentner Drummond,REP,570312,2,0,90,92,
Osage,Superintendent of Public Instruction,Joy Hofmeister,REP,570312,2,0,73,75,
Osage,Superintendent of Public Instruction,Linda Murphy,REP,570312,6,0,76,82,
Osage,Commissioner of Labor,Cathy Costello,REP,570312,3,0,67,70,
Osage,Commissioner of Labor,Leslie Osborn,REP,570312,5,0,79,84,
Osage,Corporation Commissioner,Bob Anthony,REP,570312,3,0,51,54,
Osage,Corporation Commissioner,Brian Bingman,REP,570312,5,0,94,99,
Osage,State Senate,Bill Coleman,REP,570312,5,0,93,98,10
Osage,State Senate,Amber Roberts,REP,570312,3,0,50,53,10
Osage,State House,Jadine Nollan,REP,570312,2,0,97,99,66
Osage,State House,Brian Jackson,REP,570312,6,0,52,58,66
Osage,Governor,Chris Powell,LIB,570312,0,0,0,0,
Osage,Governor,Rex Lawhorn,LIB,570312,0,0,2,2,
Osage,Corporation Commissioner,Ashley Nicole Mccray,DEM,570312,1,0,15,16,
Osage,Corporation Commissioner,Blake Cummings,DEM,570312,2,0,12,14,
Ottawa,Governor,Mick Cornett,REP,580002,0,2,17,19,
Ottawa,Governor,Kevin Stitt,REP,580002,0,2,31,33,
Ottawa,Lieutenant Governor,Dana Murphy,REP,580002,0,2,12,14,
Ottawa,Lieutenant Governor,Matt Pinnell,REP,580002,0,2,35,37,
Ottawa,State Auditor,Cindy Byrd,REP,580002,0,2,25,27,
Ottawa,State Auditor,Charlie Prater,REP,580002,0,1,22,23,
Ottawa,Attorney General,Mike Hunter,REP,580002,0,2,13,15,
Ottawa,Attorney General,Gentner Drummond,REP,580002,0,2,34,36,
Ottawa,Superintendent of Public Instruction,Joy Hofmeister,REP,580002,0,3,21,24,
Ottawa,Superintendent of Public Instruction,Linda Murphy,REP,580002,0,1,26,27,
Ottawa,Commissioner of Labor,Cathy Costello,REP,580002,0,2,18,20,
Ottawa,Commissioner of Labor,Leslie Osborn,REP,580002,0,2,29,31,
Ottawa,Corporation Commissioner,Bob Anthony,REP,580002,0,2,18,20,
Ottawa,Corporation Commissioner,Brian Bingman,REP,580002,0,1,29,30,
Ottawa,Governor,Chris Powell,LIB,580002,0,0,0,0,
Ottawa,Governor,Rex Lawhorn,LIB,580002,0,0,0,0,
Ottawa,Corporation Commissioner,Ashley Nicole Mccray,DEM,580002,2,7,48,57,
Ottawa,Corporation Commissioner,Blake Cummings,DEM,580002,1,1,32,34,
Ottawa,U.S. House,Jason Nichols,DEM,580002,2,8,51,61,02
Ottawa,U.S. House,Clay Padgett,DEM,580002,1,0,30,31,02
Ottawa,Governor,Mick Cornett,REP,580003,1,0,41,42,
Ottawa,Governor,Kevin Stitt,REP,580003,0,3,41,44,
Ottawa,Lieutenant Governor,Dana Murphy,REP,580003,1,1,24,26,
Ottawa,Lieutenant Governor,Matt Pinnell,REP,580003,0,2,57,59,
Ottawa,State Auditor,Cindy Byrd,REP,580003,0,3,38,41,
Ottawa,State Auditor,Charlie Prater,REP,580003,1,0,41,42,
Ottawa,Attorney General,Mike Hunter,REP,580003,1,0,27,28,
Ottawa,Attorney General,Gentner Drummond,REP,580003,0,3,52,55,
Ottawa,Superintendent of Public Instruction,Joy Hofmeister,REP,580003,1,1,51,53,
Ottawa,Superintendent of Public Instruction,Linda Murphy,REP,580003,0,2,31,33,
Ottawa,Commissioner of Labor,Cathy Costello,REP,580003,1,3,41,45,
Ottawa,Commissioner of Labor,Leslie Osborn,REP,580003,0,0,39,39,
Ottawa,Corporation Commissioner,Bob Anthony,REP,580003,0,0,31,31,
Ottawa,Corporation Commissioner,Brian Bingman,REP,580003,1,3,47,51,
Ottawa,Governor,Chris Powell,LIB,580003,0,0,1,1,
Ottawa,Governor,Rex Lawhorn,LIB,580003,0,0,0,0,
Ottawa,Corporation Commissioner,Ashley Nicole Mccray,DEM,580003,4,11,64,79,
Ottawa,Corporation Commissioner,Blake Cummings,DEM,580003,0,5,35,40,
Ottawa,U.S. House,Jason Nichols,DEM,580003,4,10,63,77,02
Ottawa,U.S. House,Clay Padgett,DEM,580003,0,6,38,44,02
Ottawa,Governor,Mick Cornett,REP,580004,1,3,24,28,
Ottawa,Governor,Kevin Stitt,REP,580004,0,4,18,22,
Ottawa,Lieutenant Governor,Dana Murphy,REP,580004,0,4,11,15,
Ottawa,Lieutenant Governor,Matt Pinnell,REP,580004,1,3,31,35,
Ottawa,State Auditor,Cindy Byrd,REP,580004,1,4,19,24,
Ottawa,State Auditor,Charlie Prater,REP,580004,0,3,21,24,
Ottawa,Attorney General,Mike Hunter,REP,580004,0,4,18,22,
Ottawa,Attorney General,Gentner Drummond,REP,580004,1,3,24,28,
Ottawa,Superintendent of Public Instruction,Joy Hofmeister,REP,580004,1,5,23,29,
Ottawa,Superintendent of Public Instruction,Linda Murphy,REP,580004,0,2,19,21,
Ottawa,Commissioner of Labor,Cathy Costello,REP,580004,0,5,23,28,
Ottawa,Commissioner of Labor,Leslie Osborn,REP,580004,1,2,18,21,
Ottawa,Corporation Commissioner,Bob Anthony,REP,580004,1,3,18,22,
Ottawa,Corporation Commissioner,Brian Bingman,REP,580004,0,4,24,28,
Ottawa,Governor,Chris Powell,LIB,580004,0,0,0,0,
Ottawa,Governor,Rex Lawhorn,LIB,580004,0,0,0,0,
Ottawa,Corporation Commissioner,Ashley Nicole Mccray,DEM,580004,6,2,23,31,
Ottawa,Corporation Commissioner,Blake Cummings,DEM,580004,0,0,21,21,
Ottawa,U.S. House,Jason Nichols,DEM,580004,6,1,23,30,02
Ottawa,U.S. House,Clay Padgett,DEM,580004,0,1,21,22,02
Ottawa,Governor,Mick Cornett,REP,580005,0,2,12,14,
Ottawa,Governor,Kevin Stitt,REP,580005,2,0,13,15,
Ottawa,Lieutenant Governor,Dana Murphy,REP,580005,0,1,10,11,
Ottawa,Lieutenant Governor,Matt Pinnell,REP,580005,2,1,13,16,
Ottawa,State Auditor,Cindy Byrd,REP,580005,2,2,17,21,
Ottawa,State Auditor,Charlie Prater,REP,580005,0,0,6,6,
Ottawa,Attorney General,Mike Hunter,REP,580005,0,0,14,14,
Ottawa,Attorney General,Gentner Drummond,REP,580005,2,2,11,15,
Ottawa,Superintendent of Public Instruction,Joy Hofmeister,REP,580005,0,1,7,8,
Ottawa,Superintendent of Public Instruction,Linda Murphy,REP,580005,2,1,17,20,
Ottawa,Commissioner of Labor,Cathy Costello,REP,580005,0,2,18,20,
Ottawa,Commissioner of Labor,Leslie Osborn,REP,580005,2,0,5,7,
Ottawa,Corporation Commissioner,Bob Anthony,REP,580005,0,1,13,14,
Ottawa,Corporation Commissioner,Brian Bingman,REP,580005,2,1,11,14,
Ottawa,Governor,Chris Powell,LIB,580005,0,0,0,0,
Ottawa,Governor,Rex Lawhorn,LIB,580005,0,0,0,0,
Ottawa,Corporation Commissioner,Ashley Nicole Mccray,DEM,580005,1,2,22,25,
Ottawa,Corporation Commissioner,Blake Cummings,DEM,580005,0,0,11,11,
Ottawa,U.S. House,Jason Nichols,DEM,580005,1,1,18,20,02
Ottawa,U.S. House,Clay Padgett,DEM,580005,0,1,16,17,02
Ottawa,Governor,Mick Cornett,REP,580007,1,1,42,44,
Ottawa,Governor,Kevin Stitt,REP,580007,2,8,77,87,
Ottawa,Lieutenant Governor,Dana Murphy,REP,580007,0,3,32,35,
Ottawa,Lieutenant Governor,Matt Pinnell,REP,580007,3,6,80,89,
Ottawa,State Auditor,Cindy Byrd,REP,580007,0,4,66,70,
Ottawa,State Auditor,Charlie Prater,REP,580007,3,3,47,53,
Ottawa,Attorney General,Mike Hunter,REP,580007,2,3,42,47,
Ottawa,Attorney General,Gentner Drummond,REP,580007,1,6,72,79,
Ottawa,Superintendent of Public Instruction,Joy Hofmeister,REP,580007,3,5,65,73,
Ottawa,Superintendent of Public Instruction,Linda Murphy,REP,580007,0,4,49,53,
Ottawa,Commissioner of Labor,Cathy Costello,REP,580007,0,5,65,70,
Ottawa,Commissioner of Labor,Leslie Osborn,REP,580007,3,4,49,56,
Ottawa,Corporation Commissioner,Bob Anthony,REP,580007,0,4,56,60,
Ottawa,Corporation Commissioner,Brian Bingman,REP,580007,3,5,53,61,
Ottawa,Governor,Chris Powell,LIB,580007,0,0,0,0,
Ottawa,Governor,Rex Lawhorn,LIB,580007,0,0,0,0,
Ottawa,Corporation Commissioner,Ashley Nicole Mccray,DEM,580007,3,16,84,103,
Ottawa,Corporation Commissioner,Blake Cummings,DEM,580007,1,2,47,50,
Ottawa,U.S. House,Jason Nichols,DEM,580007,4,13,78,95,02
Ottawa,U.S. House,Clay Padgett,DEM,580007,0,5,53,58,02
Ottawa,Governor,Mick Cornett,REP,580008,0,0,4,4,
Ottawa,Governor,Kevin Stitt,REP,580008,0,3,14,17,
Ottawa,Lieutenant Governor,Dana Murphy,REP,580008,0,2,5,7,
Ottawa,Lieutenant Governor,Matt Pinnell,REP,580008,0,1,12,13,
Ottawa,State Auditor,Cindy Byrd,REP,580008,0,2,7,9,
Ottawa,State Auditor,Charlie Prater,REP,580008,0,1,10,11,
Ottawa,Attorney General,Mike Hunter,REP,580008,0,1,4,5,
Ottawa,Attorney General,Gentner Drummond,REP,580008,0,2,14,16,
Ottawa,Superintendent of Public Instruction,Joy Hofmeister,REP,580008,0,3,5,8,
Ottawa,Superintendent of Public Instruction,Linda Murphy,REP,580008,0,0,13,13,
Ottawa,Commissioner of Labor,Cathy Costello,REP,580008,0,2,14,16,
Ottawa,Commissioner of Labor,Leslie Osborn,REP,580008,0,1,4,5,
Ottawa,Corporation Commissioner,Bob Anthony,REP,580008,0,2,6,8,
Ottawa,Corporation Commissioner,Brian Bingman,REP,580008,0,1,11,12,
Ottawa,Governor,Chris Powell,LIB,580008,0,0,0,0,
Ottawa,Governor,Rex Lawhorn,LIB,580008,0,0,1,1,
Ottawa,Corporation Commissioner,Ashley Nicole Mccray,DEM,580008,0,1,17,18,
Ottawa,Corporation Commissioner,Blake Cummings,DEM,580008,0,0,12,12,
Ottawa,U.S. House,Jason Nichols,DEM,580008,0,1,18,19,02
Ottawa,U.S. House,Clay Padgett,DEM,580008,0,0,12,12,02
Ottawa,Governor,Mick Cornett,REP,580009,0,1,5,6,
Ottawa,Governor,Kevin Stitt,REP,580009,1,0,18,19,
Ottawa,Lieutenant Governor,Dana Murphy,REP,580009,0,1,7,8,
Ottawa,Lieutenant Governor,Matt Pinnell,REP,580009,1,0,16,17,
Ottawa,State Auditor,Cindy Byrd,REP,580009,1,1,11,13,
Ottawa,State Auditor,Charlie Prater,REP,580009,0,0,12,12,
Ottawa,Attorney General,Mike Hunter,REP,580009,1,0,13,14,
Ottawa,Attorney General,Gentner Drummond,REP,580009,0,1,10,11,
Ottawa,Superintendent of Public Instruction,Joy Hofmeister,REP,580009,0,0,10,10,
Ottawa,Superintendent of Public Instruction,Linda Murphy,REP,580009,1,0,12,13,
Ottawa,Commissioner of Labor,Cathy Costello,REP,580009,1,1,18,20,
Ottawa,Commissioner of Labor,Leslie Osborn,REP,580009,0,0,4,4,
Ottawa,Corporation Commissioner,Bob Anthony,REP,580009,0,1,9,10,
Ottawa,Corporation Commissioner,Brian Bingman,REP,580009,1,0,13,14,
Ottawa,Governor,Chris Powell,LIB,580009,0,0,0,0,
Ottawa,Governor,Rex Lawhorn,LIB,580009,0,0,0,0,
Ottawa,Corporation Commissioner,Ashley Nicole Mccray,DEM,580009,3,2,26,31,
Ottawa,Corporation Commissioner,Blake Cummings,DEM,580009,1,0,18,19,
Ottawa,U.S. House,Jason Nichols,DEM,580009,3,1,28,32,02
Ottawa,U.S. House,Clay Padgett,DEM,580009,1,1,16,18,02
Ottawa,Governor,Mick Cornett,REP,580011,2,1,15,18,
Ottawa,Governor,Kevin Stitt,REP,580011,4,2,27,33,
Ottawa,Lieutenant Governor,Dana Murphy,REP,580011,0,0,8,8,
Ottawa,Lieutenant Governor,Matt Pinnell,REP,580011,6,2,34,42,
Ottawa,State Auditor,Cindy Byrd,REP,580011,2,0,25,27,
Ottawa,State Auditor,Charlie Prater,REP,580011,3,2,17,22,
Ottawa,Attorney General,Mike Hunter,REP,580011,4,1,11,16,
Ottawa,Attorney General,Gentner Drummond,REP,580011,2,2,31,35,
Ottawa,Superintendent of Public Instruction,Joy Hofmeister,REP,580011,3,0,13,16,
Ottawa,Superintendent of Public Instruction,Linda Murphy,REP,580011,3,2,29,34,
Ottawa,Commissioner of Labor,Cathy Costello,REP,580011,1,0,26,27,
Ottawa,Commissioner of Labor,Leslie Osborn,REP,580011,4,2,16,22,
Ottawa,Corporation Commissioner,Bob Anthony,REP,580011,3,1,15,19,
Ottawa,Corporation Commissioner,Brian Bingman,REP,580011,2,1,27,30,
Ottawa,Governor,Chris Powell,LIB,580011,0,0,0,0,
Ottawa,Governor,Rex Lawhorn,LIB,580011,0,0,0,0,
Ottawa,Corporation Commissioner,Ashley Nicole Mccray,DEM,580011,3,2,43,48,
Ottawa,Corporation Commissioner,Blake Cummings,DEM,580011,3,3,18,24,
Ottawa,U.S. House,Jason Nichols,DEM,580011,4,4,37,45,02
Ottawa,U.S. House,Clay Padgett,DEM,580011,2,1,24,27,02
Ottawa,Governor,Mick Cornett,REP,580012,0,3,16,19,
Ottawa,Governor,Kevin Stitt,REP,580012,0,1,16,17,
Ottawa,Lieutenant Governor,Dana Murphy,REP,580012,0,3,13,16,
Ottawa,Lieutenant Governor,Matt Pinnell,REP,580012,0,1,20,21,
Ottawa,State Auditor,Cindy Byrd,REP,580012,0,4,17,21,
Ottawa,State Auditor,Charlie Prater,REP,580012,0,0,15,15,
Ottawa,Attorney General,Mike Hunter,REP,580012,0,1,12,13,
Ottawa,Attorney General,Gentner Drummond,REP,580012,0,3,19,22,
Ottawa,Superintendent of Public Instruction,Joy Hofmeister,REP,580012,0,4,11,15,
Ottawa,Superintendent of Public Instruction,Linda Murphy,REP,580012,0,0,21,21,
Ottawa,Commissioner of Labor,Cathy Costello,REP,580012,0,1,13,14,
Ottawa,Commissioner of Labor,Leslie Osborn,REP,580012,0,3,17,20,
Ottawa,Corporation Commissioner,Bob Anthony,REP,580012,0,3,11,14,
Ottawa,Corporation Commissioner,Brian Bingman,REP,580012,0,1,19,20,
Ottawa,Governor,Chris Powell,LIB,580012,0,0,0,0,
Ottawa,Governor,Rex Lawhorn,LIB,580012,0,0,0,0,
Ottawa,Corporation Commissioner,Ashley Nicole Mccray,DEM,580012,2,6,39,47,
Ottawa,Corporation Commissioner,Blake Cummings,DEM,580012,0,1,27,28,
Ottawa,U.S. House,Jason Nichols,DEM,580012,1,6,36,43,02
Ottawa,U.S. House,Clay Padgett,DEM,580012,1,1,30,32,02
Ottawa,Governor,Mick Cornett,REP,580014,0,0,19,19,
Ottawa,Governor,Kevin Stitt,REP,580014,0,3,34,37,
Ottawa,Lieutenant Governor,Dana Murphy,REP,580014,0,1,12,13,
Ottawa,Lieutenant Governor,Matt Pinnell,REP,580014,0,2,41,43,
Ottawa,State Auditor,Cindy Byrd,REP,580014,0,2,27,29,
Ottawa,State Auditor,Charlie Prater,REP,580014,0,1,25,26,
Ottawa,Attorney General,Mike Hunter,REP,580014,0,3,20,23,
Ottawa,Attorney General,Gentner Drummond,REP,580014,0,0,32,32,
Ottawa,Superintendent of Public Instruction,Joy Hofmeister,REP,580014,0,2,17,19,
Ottawa,Superintendent of Public Instruction,Linda Murphy,REP,580014,0,1,33,34,
Ottawa,Commissioner of Labor,Cathy Costello,REP,580014,0,3,29,32,
Ottawa,Commissioner of Labor,Leslie Osborn,REP,580014,0,0,22,22,
Ottawa,Corporation Commissioner,Bob Anthony,REP,580014,0,0,22,22,
Ottawa,Corporation Commissioner,Brian Bingman,REP,580014,0,3,29,32,
Ottawa,Governor,Chris Powell,LIB,580014,0,0,0,0,
Ottawa,Governor,Rex Lawhorn,LIB,580014,0,0,0,0,
Ottawa,Corporation Commissioner,Ashley Nicole Mccray,DEM,580014,1,4,101,106,
Ottawa,Corporation Commissioner,Blake Cummings,DEM,580014,0,2,90,92,
Ottawa,U.S. House,Jason Nichols,DEM,580014,1,3,113,117,02
Ottawa,U.S. House,Clay Padgett,DEM,580014,0,3,77,80,02
Ottawa,Governor,Mick Cornett,REP,580023,0,0,21,21,
Ottawa,Governor,Kevin Stitt,REP,580023,3,1,32,36,
Ottawa,Lieutenant Governor,Dana Murphy,REP,580023,1,0,19,20,
Ottawa,Lieutenant Governor,Matt Pinnell,REP,580023,2,1,34,37,
Ottawa,State Auditor,Cindy Byrd,REP,580023,1,0,29,30,
Ottawa,State Auditor,Charlie Prater,REP,580023,2,1,24,27,
Ottawa,Attorney General,Mike Hunter,REP,580023,2,0,18,20,
Ottawa,Attorney General,Gentner Drummond,REP,580023,1,1,35,37,
Ottawa,Superintendent of Public Instruction,Joy Hofmeister,REP,580023,2,0,22,24,
Ottawa,Superintendent of Public Instruction,Linda Murphy,REP,580023,1,1,31,33,
Ottawa,Commissioner of Labor,Cathy Costello,REP,580023,1,0,25,26,
Ottawa,Commissioner of Labor,Leslie Osborn,REP,580023,2,1,27,30,
Ottawa,Corporation Commissioner,Bob Anthony,REP,580023,2,0,24,26,
Ottawa,Corporation Commissioner,Brian Bingman,REP,580023,1,1,28,30,
Ottawa,Governor,Chris Powell,LIB,580023,0,0,0,0,
Ottawa,Governor,Rex Lawhorn,LIB,580023,0,0,0,0,
Ottawa,Corporation Commissioner,Ashley Nicole Mccray,DEM,580023,0,3,62,65,
Ottawa,Corporation Commissioner,Blake Cummings,DEM,580023,0,0,34,34,
Ottawa,U.S. House,Jason Nichols,DEM,580023,0,2,65,67,02
Ottawa,U.S. House,Clay Padgett,DEM,580023,0,1,33,34,02
Ottawa,Governor,Mick Cornett,REP,580025,0,0,12,12,
Ottawa,Governor,Kevin Stitt,REP,580025,1,0,43,44,
Ottawa,Lieutenant Governor,Dana Murphy,REP,580025,0,0,15,15,
Ottawa,Lieutenant Governor,Matt Pinnell,REP,580025,1,0,39,40,
Ottawa,State Auditor,Cindy Byrd,REP,580025,1,0,27,28,
Ottawa,State Auditor,Charlie Prater,REP,580025,0,0,28,28,
Ottawa,Attorney General,Mike Hunter,REP,580025,0,0,15,15,
Ottawa,Attorney General,Gentner Drummond,REP,580025,1,0,40,41,
Ottawa,Superintendent of Public Instruction,Joy Hofmeister,REP,580025,1,0,20,21,
Ottawa,Superintendent of Public Instruction,Linda Murphy,REP,580025,0,0,35,35,
Ottawa,Commissioner of Labor,Cathy Costello,REP,580025,1,0,40,41,
Ottawa,Commissioner of Labor,Leslie Osborn,REP,580025,0,0,15,15,
Ottawa,Corporation Commissioner,Bob Anthony,REP,580025,1,0,30,31,
Ottawa,Corporation Commissioner,Brian Bingman,REP,580025,0,0,24,24,
Ottawa,Governor,Chris Powell,LIB,580025,0,0,0,0,
Ottawa,Governor,Rex Lawhorn,LIB,580025,0,0,0,0,
Ottawa,Corporation Commissioner,Ashley Nicole Mccray,DEM,580025,2,0,18,20,
Ottawa,Corporation Commissioner,Blake Cummings,DEM,580025,0,0,18,18,
Ottawa,U.S. House,Jason Nichols,DEM,580025,2,0,18,20,02
Ottawa,U.S. House,Clay Padgett,DEM,580025,0,0,19,19,02
Ottawa,Governor,Mick Cornett,REP,580026,0,0,23,23,
Ottawa,Governor,Kevin Stitt,REP,580026,4,1,56,61,
Ottawa,Lieutenant Governor,Dana Murphy,REP,580026,0,1,17,18,
Ottawa,Lieutenant Governor,Matt Pinnell,REP,580026,4,0,60,64,
Ottawa,State Auditor,Cindy Byrd,REP,580026,1,0,30,31,
Ottawa,State Auditor,Charlie Prater,REP,580026,3,1,47,51,
Ottawa,Attorney General,Mike Hunter,REP,580026,2,1,32,35,
Ottawa,Attorney General,Gentner Drummond,REP,580026,2,0,46,48,
Ottawa,Superintendent of Public Instruction,Joy Hofmeister,REP,580026,1,0,29,30,
Ottawa,Superintendent of Public Instruction,Linda Murphy,REP,580026,2,1,47,50,
Ottawa,Commissioner of Labor,Cathy Costello,REP,580026,3,0,40,43,
Ottawa,Commissioner of Labor,Leslie Osborn,REP,580026,0,1,37,38,
Ottawa,Corporation Commissioner,Bob Anthony,REP,580026,3,0,28,31,
Ottawa,Corporation Commissioner,Brian Bingman,REP,580026,1,1,46,48,
Ottawa,Governor,Chris Powell,LIB,580026,0,0,0,0,
Ottawa,Governor,Rex Lawhorn,LIB,580026,0,0,0,0,
Ottawa,Corporation Commissioner,Ashley Nicole Mccray,DEM,580026,1,1,43,45,
Ottawa,Corporation Commissioner,Blake Cummings,DEM,580026,0,0,19,19,
Ottawa,U.S. House,Jason Nichols,DEM,580026,1,1,36,38,02
Ottawa,U.S. House,Clay Padgett,DEM,580026,0,0,27,27,02
Ottawa,Governor,Mick Cornett,REP,580028,3,2,43,48,
Ottawa,Governor,Kevin Stitt,REP,580028,2,0,93,95,
Ottawa,Lieutenant Governor,Dana Murphy,REP,580028,2,2,32,36,
Ottawa,Lieutenant Governor,Matt Pinnell,REP,580028,3,0,104,107,
Ottawa,State Auditor,Cindy Byrd,REP,580028,2,2,72,76,
Ottawa,State Auditor,Charlie Prater,REP,580028,3,0,62,65,
Ottawa,Attorney General,Mike Hunter,REP,580028,4,1,49,54,
Ottawa,Attorney General,Gentner Drummond,REP,580028,1,1,84,86,
Ottawa,Superintendent of Public Instruction,Joy Hofmeister,REP,580028,4,1,54,59,
Ottawa,Superintendent of Public Instruction,Linda Murphy,REP,580028,1,1,81,83,
Ottawa,Commissioner of Labor,Cathy Costello,REP,580028,2,0,63,65,
Ottawa,Commissioner of Labor,Leslie Osborn,REP,580028,3,2,71,76,
Ottawa,Corporation Commissioner,Bob Anthony,REP,580028,5,2,67,74,
Ottawa,Corporation Commissioner,Brian Bingman,REP,580028,0,0,66,66,
Ottawa,Governor,Chris Powell,LIB,580028,0,0,0,0,
Ottawa,Governor,Rex Lawhorn,LIB,580028,0,0,0,0,
Ottawa,Corporation Commissioner,Ashley Nicole Mccray,DEM,580028,4,5,57,66,
Ottawa,Corporation Commissioner,Blake Cummings,DEM,580028,0,0,33,33,
Ottawa,U.S. House,Jason Nichols,DEM,580028,3,0,59,62,02
Ottawa,U.S. House,Clay Padgett,DEM,580028,1,5,32,38,02
Ottawa,Governor,Mick Cornett,REP,580031,0,4,16,20,
Ottawa,Governor,Kevin Stitt,REP,580031,3,0,57,60,
Ottawa,Lieutenant Governor,Dana Murphy,REP,580031,2,2,16,20,
Ottawa,Lieutenant Governor,Matt Pinnell,REP,580031,1,2,56,59,
Ottawa,State Auditor,Cindy Byrd,REP,580031,3,2,41,46,
Ottawa,State Auditor,Charlie Prater,REP,580031,0,2,31,33,
Ottawa,Attorney General,Mike Hunter,REP,580031,3,0,29,32,
Ottawa,Attorney General,Gentner Drummond,REP,580031,0,4,42,46,
Ottawa,Superintendent of Public Instruction,Joy Hofmeister,REP,580031,0,3,35,38,
Ottawa,Superintendent of Public Instruction,Linda Murphy,REP,580031,3,1,36,40,
Ottawa,Commissioner of Labor,Cathy Costello,REP,580031,3,2,43,48,
Ottawa,Commissioner of Labor,Leslie Osborn,REP,580031,0,2,28,30,
Ottawa,Corporation Commissioner,Bob Anthony,REP,580031,3,3,39,45,
Ottawa,Corporation Commissioner,Brian Bingman,REP,580031,0,1,32,33,
Ottawa,Governor,Chris Powell,LIB,580031,0,0,0,0,
Ottawa,Governor,Rex Lawhorn,LIB,580031,0,0,1,1,
Ottawa,Corporation Commissioner,Ashley Nicole Mccray,DEM,580031,2,2,64,68,
Ottawa,Corporation Commissioner,Blake Cummings,DEM,580031,1,4,38,43,
Ottawa,U.S. House,Jason Nichols,DEM,580031,3,2,62,67,02
Ottawa,U.S. House,Clay Padgett,DEM,580031,0,4,41,45,02
Ottawa,Governor,Mick Cornett,REP,580034,2,0,12,14,
Ottawa,Governor,Kevin Stitt,REP,580034,0,3,35,38,
Ottawa,Lieutenant Governor,Dana Murphy,REP,580034,0,2,14,16,
Ottawa,Lieutenant Governor,Matt Pinnell,REP,580034,2,1,35,38,
Ottawa,State Auditor,Cindy Byrd,REP,580034,2,2,22,26,
Ottawa,State Auditor,Charlie Prater,REP,580034,0,1,26,27,
Ottawa,Attorney General,Mike Hunter,REP,580034,1,1,21,23,
Ottawa,Attorney General,Gentner Drummond,REP,580034,1,2,27,30,
Ottawa,Superintendent of Public Instruction,Joy Hofmeister,REP,580034,1,0,18,19,
Ottawa,Superintendent of Public Instruction,Linda Murphy,REP,580034,1,3,32,36,
Ottawa,Commissioner of Labor,Cathy Costello,REP,580034,0,2,27,29,
Ottawa,Commissioner of Labor,Leslie Osborn,REP,580034,2,1,21,24,
Ottawa,Corporation Commissioner,Bob Anthony,REP,580034,1,1,20,22,
Ottawa,Corporation Commissioner,Brian Bingman,REP,580034,1,2,27,30,
Ottawa,Governor,Chris Powell,LIB,580034,0,0,0,0,
Ottawa,Governor,Rex Lawhorn,LIB,580034,0,0,0,0,
Ottawa,Corporation Commissioner,Ashley Nicole Mccray,DEM,580034,2,2,33,37,
Ottawa,Corporation Commissioner,Blake Cummings,DEM,580034,2,1,23,26,
Ottawa,U.S. House,Jason Nichols,DEM,580034,5,1,34,40,02
Ottawa,U.S. House,Clay Padgett,DEM,580034,0,2,24,26,02
Pawnee,Governor,Mick Cornett,REP,590104,0,15,41,56,
Pawnee,Governor,Kevin Stitt,REP,590104,1,5,75,81,
Pawnee,Lieutenant Governor,Dana Murphy,REP,590104,0,16,44,60,
Pawnee,Lieutenant Governor,Matt Pinnell,REP,590104,1,3,71,75,
Pawnee,State Auditor,Cindy Byrd,REP,590104,0,13,50,63,
Pawnee,State Auditor,Charlie Prater,REP,590104,1,4,62,67,
Pawnee,Attorney General,Mike Hunter,REP,590104,0,12,42,54,
Pawnee,Attorney General,Gentner Drummond,REP,590104,1,7,72,80,
Pawnee,Superintendent of Public Instruction,Joy Hofmeister,REP,590104,1,15,57,73,
Pawnee,Superintendent of Public Instruction,Linda Murphy,REP,590104,0,5,58,63,
Pawnee,Commissioner of Labor,Cathy Costello,REP,590104,0,6,45,51,
Pawnee,Commissioner of Labor,Leslie Osborn,REP,590104,1,12,67,80,
Pawnee,Corporation Commissioner,Bob Anthony,REP,590104,1,9,46,56,
Pawnee,Corporation Commissioner,Brian Bingman,REP,590104,0,11,69,80,
Pawnee,Governor,Chris Powell,LIB,590104,0,0,0,0,
Pawnee,Governor,Rex Lawhorn,LIB,590104,0,0,0,0,
Pawnee,Corporation Commissioner,Ashley Nicole Mccray,DEM,590104,1,7,22,30,
Pawnee,Corporation Commissioner,Blake Cummings,DEM,590104,1,2,32,35,
Pawnee,Governor,Mick Cornett,REP,590111,0,0,28,28,
Pawnee,Governor,Kevin Stitt,REP,590111,0,1,41,42,
Pawnee,Lieutenant Governor,Dana Murphy,REP,590111,0,0,28,28,
Pawnee,Lieutenant Governor,Matt Pinnell,REP,590111,0,1,39,40,
Pawnee,State Auditor,Cindy Byrd,REP,590111,0,0,35,35,
Pawnee,State Auditor,Charlie Prater,REP,590111,0,1,32,33,
Pawnee,Attorney General,Mike Hunter,REP,590111,0,1,28,29,
Pawnee,Attorney General,Gentner Drummond,REP,590111,0,0,41,41,
Pawnee,Superintendent of Public Instruction,Joy Hofmeister,REP,590111,0,0,34,34,
Pawnee,Superintendent of Public Instruction,Linda Murphy,REP,590111,0,1,35,36,
Pawnee,Commissioner of Labor,Cathy Costello,REP,590111,0,1,25,26,
Pawnee,Commissioner of Labor,Leslie Osborn,REP,590111,0,0,43,43,
Pawnee,Corporation Commissioner,Bob Anthony,REP,590111,0,1,27,28,
Pawnee,Corporation Commissioner,Brian Bingman,REP,590111,0,0,39,39,
Pawnee,Governor,Chris Powell,LIB,590111,0,0,0,0,
Pawnee,Governor,Rex Lawhorn,LIB,590111,0,0,0,0,
Pawnee,Corporation Commissioner,Ashley Nicole Mccray,DEM,590111,0,0,9,9,
Pawnee,Corporation Commissioner,Blake Cummings,DEM,590111,0,0,9,9,
Pawnee,Governor,Mick Cornett,REP,590112,0,0,14,14,
Pawnee,Governor,Kevin Stitt,REP,590112,0,0,33,33,
Pawnee,Lieutenant Governor,Dana Murphy,REP,590112,0,0,12,12,
Pawnee,Lieutenant Governor,Matt Pinnell,REP,590112,0,0,36,36,
Pawnee,State Auditor,Cindy Byrd,REP,590112,0,0,10,10,
Pawnee,State Auditor,Charlie Prater,REP,590112,0,0,38,38,
Pawnee,Attorney General,Mike Hunter,REP,590112,0,0,17,17,
Pawnee,Attorney General,Gentner Drummond,REP,590112,0,0,32,32,
Pawnee,Superintendent of Public Instruction,Joy Hofmeister,REP,590112,0,0,23,23,
Pawnee,Superintendent of Public Instruction,Linda Murphy,REP,590112,0,0,26,26,
Pawnee,Commissioner of Labor,Cathy Costello,REP,590112,0,0,26,26,
Pawnee,Commissioner of Labor,Leslie Osborn,REP,590112,0,0,23,23,
Pawnee,Corporation Commissioner,Bob Anthony,REP,590112,0,0,28,28,
Pawnee,Corporation Commissioner,Brian Bingman,REP,590112,0,0,21,21,
Pawnee,Governor,Chris Powell,LIB,590112,0,0,0,0,
Pawnee,Governor,Rex Lawhorn,LIB,590112,0,0,0,0,
Pawnee,Corporation Commissioner,Ashley Nicole Mccray,DEM,590112,2,0,9,11,
Pawnee,Corporation Commissioner,Blake Cummings,DEM,590112,0,0,15,15,
Pawnee,Governor,Mick Cornett,REP,590118,1,3,63,67,
Pawnee,Governor,Kevin Stitt,REP,590118,0,5,113,118,
Pawnee,Lieutenant Governor,Dana Murphy,REP,590118,1,5,81,87,
Pawnee,Lieutenant Governor,Matt Pinnell,REP,590118,0,3,92,95,
Pawnee,State Auditor,Cindy Byrd,REP,590118,1,2,56,59,
Pawnee,State Auditor,Charlie Prater,REP,590118,0,6,115,121,
Pawnee,Attorney General,Mike Hunter,REP,590118,0,2,56,58,
Pawnee,Attorney General,Gentner Drummond,REP,590118,1,6,120,127,
Pawnee,Superintendent of Public Instruction,Joy Hofmeister,REP,590118,1,6,83,90,
Pawnee,Superintendent of Public Instruction,Linda Murphy,REP,590118,0,2,90,92,
Pawnee,Commissioner of Labor,Cathy Costello,REP,590118,1,5,76,82,
Pawnee,Commissioner of Labor,Leslie Osborn,REP,590118,0,3,95,98,
Pawnee,Corporation Commissioner,Bob Anthony,REP,590118,1,5,74,80,
Pawnee,Corporation Commissioner,Brian Bingman,REP,590118,0,3,98,101,
Pawnee,Governor,Chris Powell,LIB,590118,0,0,0,0,
Pawnee,Governor,Rex Lawhorn,LIB,590118,0,0,0,0,
Pawnee,Corporation Commissioner,Ashley Nicole Mccray,DEM,590118,1,1,29,31,
Pawnee,Corporation Commissioner,Blake Cummings,DEM,590118,0,0,17,17,
Pawnee,Governor,Mick Cornett,REP,590202,0,8,87,95,
Pawnee,Governor,Kevin Stitt,REP,590202,5,10,85,100,
Pawnee,Lieutenant Governor,Dana Murphy,REP,590202,2,3,63,68,
Pawnee,Lieutenant Governor,Matt Pinnell,REP,590202,3,13,105,121,
Pawnee,State Auditor,Cindy Byrd,REP,590202,4,9,69,82,
Pawnee,State Auditor,Charlie Prater,REP,590202,1,8,92,101,
Pawnee,Attorney General,Mike Hunter,REP,590202,3,11,68,82,
Pawnee,Attorney General,Gentner Drummond,REP,590202,2,7,103,112,
Pawnee,Superintendent of Public Instruction,Joy Hofmeister,REP,590202,3,13,107,123,
Pawnee,Superintendent of Public Instruction,Linda Murphy,REP,590202,2,5,63,70,
Pawnee,Commissioner of Labor,Cathy Costello,REP,590202,4,8,52,64,
Pawnee,Commissioner of Labor,Leslie Osborn,REP,590202,1,10,113,124,
Pawnee,Corporation Commissioner,Bob Anthony,REP,590202,4,10,75,89,
Pawnee,Corporation Commissioner,Brian Bingman,REP,590202,1,7,94,102,
Pawnee,Governor,Chris Powell,LIB,590202,0,0,0,0,
Pawnee,Governor,Rex Lawhorn,LIB,590202,0,0,0,0,
Pawnee,Corporation Commissioner,Ashley Nicole Mccray,DEM,590202,2,8,67,77,
Pawnee,Corporation Commissioner,Blake Cummings,DEM,590202,1,2,32,35,
Pawnee,Governor,Mick Cornett,REP,590215,0,0,6,6,
Pawnee,Governor,Kevin Stitt,REP,590215,0,0,11,11,
Pawnee,Lieutenant Governor,Dana Murphy,REP,590215,0,0,6,6,
Pawnee,Lieutenant Governor,Matt Pinnell,REP,590215,0,0,9,9,
Pawnee,State Auditor,Cindy Byrd,REP,590215,0,0,5,5,
Pawnee,State Auditor,Charlie Prater,REP,590215,0,0,10,10,
Pawnee,Attorney General,Mike Hunter,REP,590215,0,0,5,5,
Pawnee,Attorney General,Gentner Drummond,REP,590215,0,0,12,12,
Pawnee,Superintendent of Public Instruction,Joy Hofmeister,REP,590215,0,0,9,9,
Pawnee,Superintendent of Public Instruction,Linda Murphy,REP,590215,0,0,6,6,
Pawnee,Commissioner of Labor,Cathy Costello,REP,590215,0,0,4,4,
Pawnee,Commissioner of Labor,Leslie Osborn,REP,590215,0,0,11,11,
Pawnee,Corporation Commissioner,Bob Anthony,REP,590215,0,0,5,5,
Pawnee,Corporation Commissioner,Brian Bingman,REP,590215,0,0,10,10,
Pawnee,Governor,Chris Powell,LIB,590215,0,0,0,0,
Pawnee,Governor,Rex Lawhorn,LIB,590215,0,0,0,0,
Pawnee,Corporation Commissioner,Ashley Nicole Mccray,DEM,590215,0,1,6,7,
Pawnee,Corporation Commissioner,Blake Cummings,DEM,590215,0,0,4,4,
Pawnee,Governor,Mick Cornett,REP,590217,3,1,66,70,
Pawnee,Governor,Kevin Stitt,REP,590217,2,1,78,81,
Pawnee,Lieutenant Governor,Dana Murphy,REP,590217,3,1,60,64,
Pawnee,Lieutenant Governor,Matt Pinnell,REP,590217,2,1,80,83,
Pawnee,State Auditor,Cindy Byrd,REP,590217,3,2,58,63,
Pawnee,State Auditor,Charlie Prater,REP,590217,2,0,80,82,
Pawnee,Attorney General,Mike Hunter,REP,590217,2,2,49,53,
Pawnee,Attorney General,Gentner Drummond,REP,590217,3,0,94,97,
Pawnee,Superintendent of Public Instruction,Joy Hofmeister,REP,590217,2,1,83,86,
Pawnee,Superintendent of Public Instruction,Linda Murphy,REP,590217,3,1,57,61,
Pawnee,Commissioner of Labor,Cathy Costello,REP,590217,3,1,62,66,
Pawnee,Commissioner of Labor,Leslie Osborn,REP,590217,2,1,75,78,
Pawnee,Corporation Commissioner,Bob Anthony,REP,590217,1,2,63,66,
Pawnee,Corporation Commissioner,Brian Bingman,REP,590217,4,0,75,79,
Pawnee,Governor,Chris Powell,LIB,590217,0,0,0,0,
Pawnee,Governor,Rex Lawhorn,LIB,590217,0,0,0,0,
Pawnee,Corporation Commissioner,Ashley Nicole Mccray,DEM,590217,1,0,22,23,
Pawnee,Corporation Commissioner,Blake Cummings,DEM,590217,2,0,17,19,
Pawnee,Governor,Mick Cornett,REP,590307,2,2,63,67,
Pawnee,Governor,Kevin Stitt,REP,590307,5,7,139,151,
Pawnee,Lieutenant Governor,Dana Murphy,REP,590307,0,2,66,68,
Pawnee,Lieutenant Governor,Matt Pinnell,REP,590307,7,7,133,147,
Pawnee,State Auditor,Cindy Byrd,REP,590307,5,4,68,77,
Pawnee,State Auditor,Charlie Prater,REP,590307,1,5,123,129,
Pawnee,Attorney General,Mike Hunter,REP,590307,4,3,66,73,
Pawnee,Attorney General,Gentner Drummond,REP,590307,3,6,134,143,
Pawnee,Superintendent of Public Instruction,Joy Hofmeister,REP,590307,3,2,103,108,
Pawnee,Superintendent of Public Instruction,Linda Murphy,REP,590307,4,7,97,108,
Pawnee,Commissioner of Labor,Cathy Costello,REP,590307,3,8,83,94,
Pawnee,Commissioner of Labor,Leslie Osborn,REP,590307,3,1,114,118,
Pawnee,Corporation Commissioner,Bob Anthony,REP,590307,5,2,87,94,
Pawnee,Corporation Commissioner,Brian Bingman,REP,590307,2,7,112,121,
Pawnee,Governor,Chris Powell,LIB,590307,0,0,2,2,
Pawnee,Governor,Rex Lawhorn,LIB,590307,0,0,1,1,
Pawnee,Corporation Commissioner,Ashley Nicole Mccray,DEM,590307,5,1,17,23,
Pawnee,Corporation Commissioner,Blake Cummings,DEM,590307,0,0,13,13,
Pawnee,Governor,Mick Cornett,REP,590309,0,0,18,18,
Pawnee,Governor,Kevin Stitt,REP,590309,0,0,42,42,
Pawnee,Lieutenant Governor,Dana Murphy,REP,590309,0,0,28,28,
Pawnee,Lieutenant Governor,Matt Pinnell,REP,590309,0,0,30,30,
Pawnee,State Auditor,Cindy Byrd,REP,590309,0,0,22,22,
Pawnee,State Auditor,Charlie Prater,REP,590309,0,0,33,33,
Pawnee,Attorney General,Mike Hunter,REP,590309,0,0,27,27,
Pawnee,Attorney General,Gentner Drummond,REP,590309,0,0,34,34,
Pawnee,Superintendent of Public Instruction,Joy Hofmeister,REP,590309,0,0,29,29,
Pawnee,Superintendent of Public Instruction,Linda Murphy,REP,590309,0,0,28,28,
Pawnee,Commissioner of Labor,Cathy Costello,REP,590309,0,0,26,26,
Pawnee,Commissioner of Labor,Leslie Osborn,REP,590309,0,0,32,32,
Pawnee,Corporation Commissioner,Bob Anthony,REP,590309,0,0,30,30,
Pawnee,Corporation Commissioner,Brian Bingman,REP,590309,0,0,29,29,
Pawnee,Governor,Chris Powell,LIB,590309,0,0,0,0,
Pawnee,Governor,Rex Lawhorn,LIB,590309,0,0,1,1,
Pawnee,Corporation Commissioner,Ashley Nicole Mccray,DEM,590309,1,0,9,10,
Pawnee,Corporation Commissioner,Blake Cummings,DEM,590309,0,0,3,3,
Pawnee,Governor,Mick Cornett,REP,590314,0,3,42,45,
Pawnee,Governor,Kevin Stitt,REP,590314,1,4,107,112,
Pawnee,Lieutenant Governor,Dana Murphy,REP,590314,0,2,53,55,
Pawnee,Lieutenant Governor,Matt Pinnell,REP,590314,1,4,97,102,
Pawnee,State Auditor,Cindy Byrd,REP,590314,0,1,56,57,
Pawnee,State Auditor,Charlie Prater,REP,590314,1,5,90,96,
Pawnee,Attorney General,Mike Hunter,REP,590314,1,1,56,58,
Pawnee,Attorney General,Gentner Drummond,REP,590314,0,6,93,99,
Pawnee,Superintendent of Public Instruction,Joy Hofmeister,REP,590314,1,4,67,72,
Pawnee,Superintendent of Public Instruction,Linda Murphy,REP,590314,0,2,80,82,
Pawnee,Commissioner of Labor,Cathy Costello,REP,590314,1,2,61,64,
Pawnee,Commissioner of Labor,Leslie Osborn,REP,590314,0,4,86,90,
Pawnee,Corporation Commissioner,Bob Anthony,REP,590314,1,3,70,74,
Pawnee,Corporation Commissioner,Brian Bingman,REP,590314,0,4,79,83,
Pawnee,Governor,Chris Powell,LIB,590314,0,0,0,0,
Pawnee,Governor,Rex Lawhorn,LIB,590314,0,0,0,0,
Pawnee,Corporation Commissioner,Ashley Nicole Mccray,DEM,590314,2,2,9,13,
Pawnee,Corporation Commissioner,Blake Cummings,DEM,590314,0,2,20,22,
Payne,Governor,Mick Cornett,REP,600001,2,1,33,36,
Payne,Governor,Kevin Stitt,REP,600001,0,0,19,19,
Payne,Lieutenant Governor,Dana Murphy,REP,600001,1,0,22,23,
Payne,Lieutenant Governor,Matt Pinnell,REP,600001,1,1,29,31,
Payne,State Auditor,Cindy Byrd,REP,600001,1,1,25,27,
Payne,State Auditor,Charlie Prater,REP,600001,1,0,24,25,
Payne,Attorney General,Mike Hunter,REP,600001,1,0,24,25,
Payne,Attorney General,Gentner Drummond,REP,600001,1,1,25,27,
Payne,Superintendent of Public Instruction,Joy Hofmeister,REP,600001,0,1,26,27,
Payne,Superintendent of Public Instruction,Linda Murphy,REP,600001,2,0,25,27,
Payne,Commissioner of Labor,Cathy Costello,REP,600001,0,0,26,26,
Payne,Commissioner of Labor,Leslie Osborn,REP,600001,2,1,23,26,
Payne,Corporation Commissioner,Bob Anthony,REP,600001,2,1,16,19,
Payne,Corporation Commissioner,Brian Bingman,REP,600001,0,0,33,33,
Payne,Governor,Chris Powell,LIB,600001,0,0,0,0,
Payne,Governor,Rex Lawhorn,LIB,600001,0,0,1,1,
Payne,Corporation Commissioner,Ashley Nicole Mccray,DEM,600001,2,2,17,21,
Payne,Corporation Commissioner,Blake Cummings,DEM,600001,1,1,8,10,
Payne,Governor,Mick Cornett,REP,600002,4,1,60,65,
Payne,Governor,Kevin Stitt,REP,600002,1,8,44,53,
Payne,Lieutenant Governor,Dana Murphy,REP,600002,1,2,45,48,
Payne,Lieutenant Governor,Matt Pinnell,REP,600002,4,7,56,67,
Payne,State Auditor,Cindy Byrd,REP,600002,2,3,57,62,
Payne,State Auditor,Charlie Prater,REP,600002,3,6,45,54,
Payne,Attorney General,Mike Hunter,REP,600002,4,5,36,45,
Payne,Attorney General,Gentner Drummond,REP,600002,1,4,64,69,
Payne,Superintendent of Public Instruction,Joy Hofmeister,REP,600002,4,4,51,59,
Payne,Superintendent of Public Instruction,Linda Murphy,REP,600002,1,5,48,54,
Payne,Commissioner of Labor,Cathy Costello,REP,600002,3,6,52,61,
Payne,Commissioner of Labor,Leslie Osborn,REP,600002,2,3,47,52,
Payne,Corporation Commissioner,Bob Anthony,REP,600002,4,8,49,61,
Payne,Corporation Commissioner,Brian Bingman,REP,600002,1,1,48,50,
Payne,Governor,Chris Powell,LIB,600002,0,0,0,0,
Payne,Governor,Rex Lawhorn,LIB,600002,0,0,0,0,
Payne,Corporation Commissioner,Ashley Nicole Mccray,DEM,600002,2,4,34,40,
Payne,Corporation Commissioner,Blake Cummings,DEM,600002,1,1,19,21,
Payne,Governor,Mick Cornett,REP,600003,1,2,26,29,
Payne,Governor,Kevin Stitt,REP,600003,0,1,37,38,
Payne,Lieutenant Governor,Dana Murphy,REP,600003,1,1,27,29,
Payne,Lieutenant Governor,Matt Pinnell,REP,600003,0,2,36,38,
Payne,State Auditor,Cindy Byrd,REP,600003,1,1,34,36,
Payne,State Auditor,Charlie Prater,REP,600003,0,2,28,30,
Payne,Attorney General,Mike Hunter,REP,600003,0,2,20,22,
Payne,Attorney General,Gentner Drummond,REP,600003,1,1,43,45,
Payne,Superintendent of Public Instruction,Joy Hofmeister,REP,600003,1,0,29,30,
Payne,Superintendent of Public Instruction,Linda Murphy,REP,600003,0,3,34,37,
Payne,Commissioner of Labor,Cathy Costello,REP,600003,0,3,23,26,
Payne,Commissioner of Labor,Leslie Osborn,REP,600003,1,0,40,41,
Payne,Corporation Commissioner,Bob Anthony,REP,600003,1,3,30,34,
Payne,Corporation Commissioner,Brian Bingman,REP,600003,0,0,33,33,
Payne,Governor,Chris Powell,LIB,600003,0,0,0,0,
Payne,Governor,Rex Lawhorn,LIB,600003,0,0,0,0,
Payne,Corporation Commissioner,Ashley Nicole Mccray,DEM,600003,1,0,17,18,
Payne,Corporation Commissioner,Blake Cummings,DEM,600003,1,0,6,7,
Payne,Governor,Mick Cornett,REP,600004,5,9,142,156,
Payne,Governor,Kevin Stitt,REP,600004,1,7,82,90,
Payne,Lieutenant Governor,Dana Murphy,REP,600004,1,7,84,92,
Payne,Lieutenant Governor,Matt Pinnell,REP,600004,5,9,138,152,
Payne,State Auditor,Cindy Byrd,REP,600004,3,10,110,123,
Payne,State Auditor,Charlie Prater,REP,600004,2,6,103,111,
Payne,Attorney General,Mike Hunter,REP,600004,4,8,104,116,
Payne,Attorney General,Gentner Drummond,REP,600004,2,8,119,129,
Payne,Superintendent of Public Instruction,Joy Hofmeister,REP,600004,5,15,143,163,
Payne,Superintendent of Public Instruction,Linda Murphy,REP,600004,1,1,77,79,
Payne,Commissioner of Labor,Cathy Costello,REP,600004,1,6,91,98,
Payne,Commissioner of Labor,Leslie Osborn,REP,600004,3,9,126,138,
Payne,Corporation Commissioner,Bob Anthony,REP,600004,3,7,128,138,
Payne,Corporation Commissioner,Brian Bingman,REP,600004,3,9,88,100,
Payne,Governor,Chris Powell,LIB,600004,0,0,0,0,
Payne,Governor,Rex Lawhorn,LIB,600004,0,0,0,0,
Payne,Corporation Commissioner,Ashley Nicole Mccray,DEM,600004,0,2,50,52,
Payne,Corporation Commissioner,Blake Cummings,DEM,600004,0,2,17,19,
Payne,Governor,Mick Cornett,REP,600005,3,0,36,39,
Payne,Governor,Kevin Stitt,REP,600005,2,1,23,26,
Payne,Lieutenant Governor,Dana Murphy,REP,600005,2,0,24,26,
Payne,Lieutenant Governor,Matt Pinnell,REP,600005,3,1,35,39,
Payne,State Auditor,Cindy Byrd,REP,600005,2,0,35,37,
Payne,State Auditor,Charlie Prater,REP,600005,2,1,21,24,
Payne,Attorney General,Mike Hunter,REP,600005,1,0,21,22,
Payne,Attorney General,Gentner Drummond,REP,600005,4,1,36,41,
Payne,Superintendent of Public Instruction,Joy Hofmeister,REP,600005,1,0,28,29,
Payne,Superintendent of Public Instruction,Linda Murphy,REP,600005,4,1,30,35,
Payne,Commissioner of Labor,Cathy Costello,REP,600005,2,0,21,23,
Payne,Commissioner of Labor,Leslie Osborn,REP,600005,3,1,36,40,
Payne,Corporation Commissioner,Bob Anthony,REP,600005,3,0,21,24,
Payne,Corporation Commissioner,Brian Bingman,REP,600005,2,1,36,39,
Payne,Governor,Chris Powell,LIB,600005,0,0,0,0,
Payne,Governor,Rex Lawhorn,LIB,600005,0,0,0,0,
Payne,Corporation Commissioner,Ashley Nicole Mccray,DEM,600005,0,0,12,12,
Payne,Corporation Commissioner,Blake Cummings,DEM,600005,0,0,4,4,
Payne,Governor,Mick Cornett,REP,600006,2,5,108,115,
Payne,Governor,Kevin Stitt,REP,600006,2,6,79,87,
Payne,Lieutenant Governor,Dana Murphy,REP,600006,4,3,87,94,
Payne,Lieutenant Governor,Matt Pinnell,REP,600006,0,8,91,99,
Payne,State Auditor,Cindy Byrd,REP,600006,1,8,101,110,
Payne,State Auditor,Charlie Prater,REP,600006,3,3,77,83,
Payne,Attorney General,Mike Hunter,REP,600006,2,6,81,89,
Payne,Attorney General,Gentner Drummond,REP,600006,2,5,104,111,
Payne,Superintendent of Public Instruction,Joy Hofmeister,REP,600006,2,10,108,120,
Payne,Superintendent of Public Instruction,Linda Murphy,REP,600006,2,1,75,78,
Payne,Commissioner of Labor,Cathy Costello,REP,600006,4,4,85,93,
Payne,Commissioner of Labor,Leslie Osborn,REP,600006,0,7,97,104,
Payne,Corporation Commissioner,Bob Anthony,REP,600006,2,8,92,102,
Payne,Corporation Commissioner,Brian Bingman,REP,600006,2,3,88,93,
Payne,Governor,Chris Powell,LIB,600006,0,0,1,1,
Payne,Governor,Rex Lawhorn,LIB,600006,0,0,2,2,
Payne,Corporation Commissioner,Ashley Nicole Mccray,DEM,600006,3,5,49,57,
Payne,Corporation Commissioner,Blake Cummings,DEM,600006,0,3,18,21,
Payne,Governor,Mick Cornett,REP,600007,0,1,18,19,
Payne,Governor,Kevin Stitt,REP,600007,0,0,16,16,
Payne,Lieutenant Governor,Dana Murphy,REP,600007,0,0,20,20,
Payne,Lieutenant Governor,Matt Pinnell,REP,600007,0,0,12,12,
Payne,State Auditor,Cindy Byrd,REP,600007,0,1,14,15,
Payne,State Auditor,Charlie Prater,REP,600007,0,0,20,20,
Payne,Attorney General,Mike Hunter,REP,600007,0,1,20,21,
Payne,Attorney General,Gentner Drummond,REP,600007,0,0,13,13,
Payne,Superintendent of Public Instruction,Joy Hofmeister,REP,600007,0,0,16,16,
Payne,Superintendent of Public Instruction,Linda Murphy,REP,600007,0,1,17,18,
Payne,Commissioner of Labor,Cathy Costello,REP,600007,0,0,18,18,
Payne,Commissioner of Labor,Leslie Osborn,REP,600007,0,1,15,16,
Payne,Corporation Commissioner,Bob Anthony,REP,600007,0,0,16,16,
Payne,Corporation Commissioner,Brian Bingman,REP,600007,0,1,16,17,
Payne,Governor,Chris Powell,LIB,600007,0,0,0,0,
Payne,Governor,Rex Lawhorn,LIB,600007,0,0,0,0,
Payne,Corporation Commissioner,Ashley Nicole Mccray,DEM,600007,3,1,16,20,
Payne,Corporation Commissioner,Blake Cummings,DEM,600007,0,0,6,6,
Payne,Governor,Mick Cornett,REP,600008,2,6,56,64,
Payne,Governor,Kevin Stitt,REP,600008,0,1,31,32,
Payne,Lieutenant Governor,Dana Murphy,REP,600008,0,2,42,44,
Payne,Lieutenant Governor,Matt Pinnell,REP,600008,2,5,42,49,
Payne,State Auditor,Cindy Byrd,REP,600008,0,4,48,52,
Payne,State Auditor,Charlie Prater,REP,600008,2,3,34,39,
Payne,Attorney General,Mike Hunter,REP,600008,0,3,32,35,
Payne,Attorney General,Gentner Drummond,REP,600008,2,4,55,61,
Payne,Superintendent of Public Instruction,Joy Hofmeister,REP,600008,0,3,50,53,
Payne,Superintendent of Public Instruction,Linda Murphy,REP,600008,2,4,34,40,
Payne,Commissioner of Labor,Cathy Costello,REP,600008,0,6,40,46,
Payne,Commissioner of Labor,Leslie Osborn,REP,600008,2,1,42,45,
Payne,Corporation Commissioner,Bob Anthony,REP,600008,2,4,36,42,
Payne,Corporation Commissioner,Brian Bingman,REP,600008,0,3,45,48,
Payne,Governor,Chris Powell,LIB,600008,0,0,0,0,
Payne,Governor,Rex Lawhorn,LIB,600008,0,0,1,1,
Payne,Corporation Commissioner,Ashley Nicole Mccray,DEM,600008,4,2,43,49,
Payne,Corporation Commissioner,Blake Cummings,DEM,600008,2,0,11,13,
Payne,Governor,Mick Cornett,REP,600009,5,11,201,217,
Payne,Governor,Kevin Stitt,REP,600009,3,9,106,118,
Payne,Lieutenant Governor,Dana Murphy,REP,600009,3,9,148,160,
Payne,Lieutenant Governor,Matt Pinnell,REP,600009,4,11,147,162,
Payne,State Auditor,Cindy Byrd,REP,600009,6,10,142,158,
Payne,State Auditor,Charlie Prater,REP,600009,1,10,136,147,
Payne,Attorney General,Mike Hunter,REP,600009,4,10,161,175,
Payne,Attorney General,Gentner Drummond,REP,600009,3,10,142,155,
Payne,Superintendent of Public Instruction,Joy Hofmeister,REP,600009,4,15,190,209,
Payne,Superintendent of Public Instruction,Linda Murphy,REP,600009,4,5,109,118,
Payne,Commissioner of Labor,Cathy Costello,REP,600009,3,7,126,136,
Payne,Commissioner of Labor,Leslie Osborn,REP,600009,5,13,161,179,
Payne,Corporation Commissioner,Bob Anthony,REP,600009,4,17,159,180,
Payne,Corporation Commissioner,Brian Bingman,REP,600009,4,3,125,132,
Payne,Governor,Chris Powell,LIB,600009,0,0,1,1,
Payne,Governor,Rex Lawhorn,LIB,600009,0,0,0,0,
Payne,Corporation Commissioner,Ashley Nicole Mccray,DEM,600009,1,1,52,54,
Payne,Corporation Commissioner,Blake Cummings,DEM,600009,0,0,17,17,
Payne,Governor,Mick Cornett,REP,600010,2,2,41,45,
Payne,Governor,Kevin Stitt,REP,600010,1,3,22,26,
Payne,Lieutenant Governor,Dana Murphy,REP,600010,1,4,31,36,
Payne,Lieutenant Governor,Matt Pinnell,REP,600010,2,1,31,34,
Payne,State Auditor,Cindy Byrd,REP,600010,2,4,33,39,
Payne,State Auditor,Charlie Prater,REP,600010,1,1,25,27,
Payne,Attorney General,Mike Hunter,REP,600010,1,3,40,44,
Payne,Attorney General,Gentner Drummond,REP,600010,2,2,23,27,
Payne,Superintendent of Public Instruction,Joy Hofmeister,REP,600010,2,3,36,41,
Payne,Superintendent of Public Instruction,Linda Murphy,REP,600010,1,2,24,27,
Payne,Commissioner of Labor,Cathy Costello,REP,600010,2,3,22,27,
Payne,Commissioner of Labor,Leslie Osborn,REP,600010,1,2,39,42,
Payne,Corporation Commissioner,Bob Anthony,REP,600010,2,2,39,43,
Payne,Corporation Commissioner,Brian Bingman,REP,600010,1,3,22,26,
Payne,Governor,Chris Powell,LIB,600010,0,0,0,0,
Payne,Governor,Rex Lawhorn,LIB,600010,0,0,0,0,
Payne,Corporation Commissioner,Ashley Nicole Mccray,DEM,600010,0,3,17,20,
Payne,Corporation Commissioner,Blake Cummings,DEM,600010,1,0,3,4,
Payne,Governor,Mick Cornett,REP,600011,0,0,32,32,
Payne,Governor,Kevin Stitt,REP,600011,2,3,9,14,
Payne,Lieutenant Governor,Dana Murphy,REP,600011,2,3,19,24,
Payne,Lieutenant Governor,Matt Pinnell,REP,600011,0,0,21,21,
Payne,State Auditor,Cindy Byrd,REP,600011,2,2,20,24,
Payne,State Auditor,Charlie Prater,REP,600011,0,1,20,21,
Payne,Attorney General,Mike Hunter,REP,600011,0,2,15,17,
Payne,Attorney General,Gentner Drummond,REP,600011,2,1,26,29,
Payne,Superintendent of Public Instruction,Joy Hofmeister,REP,600011,2,2,25,29,
Payne,Superintendent of Public Instruction,Linda Murphy,REP,600011,0,1,14,15,
Payne,Commissioner of Labor,Cathy Costello,REP,600011,1,1,18,20,
Payne,Commissioner of Labor,Leslie Osborn,REP,600011,1,2,21,24,
Payne,Corporation Commissioner,Bob Anthony,REP,600011,2,2,17,21,
Payne,Corporation Commissioner,Brian Bingman,REP,600011,0,1,23,24,
Payne,Governor,Chris Powell,LIB,600011,0,0,0,0,
Payne,Governor,Rex Lawhorn,LIB,600011,0,0,0,0,
Payne,Corporation Commissioner,Ashley Nicole Mccray,DEM,600011,0,2,9,11,
Payne,Corporation Commissioner,Blake Cummings,DEM,600011,0,0,5,5,
Payne,Governor,Mick Cornett,REP,600012,0,1,13,14,
Payne,Governor,Kevin Stitt,REP,600012,0,0,9,9,
Payne,Lieutenant Governor,Dana Murphy,REP,600012,0,0,8,8,
Payne,Lieutenant Governor,Matt Pinnell,REP,600012,0,1,11,12,
Payne,State Auditor,Cindy Byrd,REP,600012,0,0,9,9,
Payne,State Auditor,Charlie Prater,REP,600012,0,0,10,10,
Payne,Attorney General,Mike Hunter,REP,600012,0,0,14,14,
Payne,Attorney General,Gentner Drummond,REP,600012,0,1,7,8,
Payne,Superintendent of Public Instruction,Joy Hofmeister,REP,600012,0,0,9,9,
Payne,Superintendent of Public Instruction,Linda Murphy,REP,600012,0,1,12,13,
Payne,Commissioner of Labor,Cathy Costello,REP,600012,0,0,6,6,
Payne,Commissioner of Labor,Leslie Osborn,REP,600012,0,1,12,13,
Payne,Corporation Commissioner,Bob Anthony,REP,600012,0,0,15,15,
Payne,Corporation Commissioner,Brian Bingman,REP,600012,0,1,5,6,
Payne,Governor,Chris Powell,LIB,600012,0,0,0,0,
Payne,Governor,Rex Lawhorn,LIB,600012,0,0,0,0,
Payne,Corporation Commissioner,Ashley Nicole Mccray,DEM,600012,0,0,15,15,
Payne,Corporation Commissioner,Blake Cummings,DEM,600012,0,1,2,3,
Payne,Governor,Mick Cornett,REP,600013,4,11,144,159,
Payne,Governor,Kevin Stitt,REP,600013,1,11,127,139,
Payne,Lieutenant Governor,Dana Murphy,REP,600013,2,8,125,135,
Payne,Lieutenant Governor,Matt Pinnell,REP,600013,3,14,140,157,
Payne,State Auditor,Cindy Byrd,REP,600013,2,11,149,162,
Payne,State Auditor,Charlie Prater,REP,600013,3,11,107,121,
Payne,Attorney General,Mike Hunter,REP,600013,3,8,118,129,
Payne,Attorney General,Gentner Drummond,REP,600013,2,14,146,162,
Payne,Superintendent of Public Instruction,Joy Hofmeister,REP,600013,1,13,142,156,
Payne,Superintendent of Public Instruction,Linda Murphy,REP,600013,4,9,126,139,
Payne,Commissioner of Labor,Cathy Costello,REP,600013,4,14,142,160,
Payne,Commissioner of Labor,Leslie Osborn,REP,600013,1,8,120,129,
Payne,Corporation Commissioner,Bob Anthony,REP,600013,1,15,149,165,
Payne,Corporation Commissioner,Brian Bingman,REP,600013,4,7,115,126,
Payne,Governor,Chris Powell,LIB,600013,0,0,0,0,
Payne,Governor,Rex Lawhorn,LIB,600013,0,0,0,0,
Payne,Corporation Commissioner,Ashley Nicole Mccray,DEM,600013,3,3,54,60,
Payne,Corporation Commissioner,Blake Cummings,DEM,600013,1,3,19,23,
Payne,Governor,Mick Cornett,REP,600014,0,2,2,4,
Payne,Governor,Kevin Stitt,REP,600014,0,0,1,1,
Payne,Lieutenant Governor,Dana Murphy,REP,600014,0,0,0,0,
Payne,Lieutenant Governor,Matt Pinnell,REP,600014,0,2,2,4,
Payne,State Auditor,Cindy Byrd,REP,600014,0,0,1,1,
Payne,State Auditor,Charlie Prater,REP,600014,0,2,2,4,
Payne,Attorney General,Mike Hunter,REP,600014,0,2,2,4,
Payne,Attorney General,Gentner Drummond,REP,600014,0,0,1,1,
Payne,Superintendent of Public Instruction,Joy Hofmeister,REP,600014,0,2,1,3,
Payne,Superintendent of Public Instruction,Linda Murphy,REP,600014,0,0,2,2,
Payne,Commissioner of Labor,Cathy Costello,REP,600014,0,1,1,2,
Payne,Commissioner of Labor,Leslie Osborn,REP,600014,0,1,1,2,
Payne,Corporation Commissioner,Bob Anthony,REP,600014,0,2,1,3,
Payne,Corporation Commissioner,Brian Bingman,REP,600014,0,0,1,1,
Payne,Governor,Chris Powell,LIB,600014,0,0,0,0,
Payne,Governor,Rex Lawhorn,LIB,600014,0,0,0,0,
Payne,Corporation Commissioner,Ashley Nicole Mccray,DEM,600014,0,0,0,0,
Payne,Corporation Commissioner,Blake Cummings,DEM,600014,0,0,0,0,
Payne,Governor,Mick Cornett,REP,600015,1,5,78,84,
Payne,Governor,Kevin Stitt,REP,600015,4,2,31,37,
Payne,Lieutenant Governor,Dana Murphy,REP,600015,2,5,49,56,
Payne,Lieutenant Governor,Matt Pinnell,REP,600015,3,2,61,66,
Payne,State Auditor,Cindy Byrd,REP,600015,3,6,51,60,
Payne,State Auditor,Charlie Prater,REP,600015,2,1,57,60,
Payne,Attorney General,Mike Hunter,REP,600015,4,3,44,51,
Payne,Attorney General,Gentner Drummond,REP,600015,1,4,63,68,
Payne,Superintendent of Public Instruction,Joy Hofmeister,REP,600015,4,3,62,69,
Payne,Superintendent of Public Instruction,Linda Murphy,REP,600015,1,4,46,51,
Payne,Commissioner of Labor,Cathy Costello,REP,600015,5,2,42,49,
Payne,Commissioner of Labor,Leslie Osborn,REP,600015,0,5,64,69,
Payne,Corporation Commissioner,Bob Anthony,REP,600015,3,2,58,63,
Payne,Corporation Commissioner,Brian Bingman,REP,600015,2,5,49,56,
Payne,Governor,Chris Powell,LIB,600015,0,0,0,0,
Payne,Governor,Rex Lawhorn,LIB,600015,0,0,0,0,
Payne,Corporation Commissioner,Ashley Nicole Mccray,DEM,600015,2,0,44,46,
Payne,Corporation Commissioner,Blake Cummings,DEM,600015,2,0,14,16,
Payne,Governor,Mick Cornett,REP,600016,16,35,280,331,
Payne,Governor,Kevin Stitt,REP,600016,5,13,158,176,
Payne,Lieutenant Governor,Dana Murphy,REP,600016,6,25,197,228,
Payne,Lieutenant Governor,Matt Pinnell,REP,600016,16,23,226,265,
Payne,State Auditor,Cindy Byrd,REP,600016,8,23,203,234,
Payne,State Auditor,Charlie Prater,REP,600016,11,22,204,237,
Payne,Attorney General,Mike Hunter,REP,600016,13,29,200,242,
Payne,Attorney General,Gentner Drummond,REP,600016,8,18,233,259,
Payne,Superintendent of Public Instruction,Joy Hofmeister,REP,600016,16,24,253,293,
Payne,Superintendent of Public Instruction,Linda Murphy,REP,600016,6,24,175,205,
Payne,Commissioner of Labor,Cathy Costello,REP,600016,6,19,170,195,
Payne,Commissioner of Labor,Leslie Osborn,REP,600016,14,27,233,274,
Payne,Corporation Commissioner,Bob Anthony,REP,600016,14,30,250,294,
Payne,Corporation Commissioner,Brian Bingman,REP,600016,6,17,164,187,
Payne,Governor,Chris Powell,LIB,600016,0,0,0,0,
Payne,Governor,Rex Lawhorn,LIB,600016,0,0,0,0,
Payne,Corporation Commissioner,Ashley Nicole Mccray,DEM,600016,12,5,63,80,
Payne,Corporation Commissioner,Blake Cummings,DEM,600016,1,2,34,37,
Payne,Governor,Mick Cornett,REP,600101,5,1,99,105,
Payne,Governor,Kevin Stitt,REP,600101,2,1,107,110,
Payne,Lieutenant Governor,Dana Murphy,REP,600101,5,2,70,77,
Payne,Lieutenant Governor,Matt Pinnell,REP,600101,2,0,132,134,
Payne,State Auditor,Cindy Byrd,REP,600101,2,2,79,83,
Payne,State Auditor,Charlie Prater,REP,600101,5,0,120,125,
Payne,Attorney General,Mike Hunter,REP,600101,5,0,77,82,
Payne,Attorney General,Gentner Drummond,REP,600101,2,2,127,131,
Payne,Superintendent of Public Instruction,Joy Hofmeister,REP,600101,3,1,107,111,
Payne,Superintendent of Public Instruction,Linda Murphy,REP,600101,4,1,95,100,
Payne,Commissioner of Labor,Cathy Costello,REP,600101,7,0,94,101,
Payne,Commissioner of Labor,Leslie Osborn,REP,600101,0,2,107,109,
Payne,Corporation Commissioner,Bob Anthony,REP,600101,4,0,106,110,
Payne,Corporation Commissioner,Brian Bingman,REP,600101,3,2,98,103,
Payne,Governor,Chris Powell,LIB,600101,0,0,0,0,
Payne,Governor,Rex Lawhorn,LIB,600101,0,0,1,1,
Payne,Corporation Commissioner,Ashley Nicole Mccray,DEM,600101,2,0,12,14,
Payne,Corporation Commissioner,Blake Cummings,DEM,600101,0,1,18,19,
Payne,Governor,Mick Cornett,REP,600102,0,0,103,103,
Payne,Governor,Kevin Stitt,REP,600102,4,1,135,140,
Payne,Lieutenant Governor,Dana Murphy,REP,600102,2,0,83,85,
Payne,Lieutenant Governor,Matt Pinnell,REP,600102,3,1,147,151,
Payne,State Auditor,Cindy Byrd,REP,600102,2,1,101,104,
Payne,State Auditor,Charlie Prater,REP,600102,3,0,126,129,
Payne,Attorney General,Mike Hunter,REP,600102,1,0,102,103,
Payne,Attorney General,Gentner Drummond,REP,600102,3,1,135,139,
Payne,Superintendent of Public Instruction,Joy Hofmeister,REP,600102,2,0,147,149,
Payne,Superintendent of Public Instruction,Linda Murphy,REP,600102,2,1,90,93,
Payne,Commissioner of Labor,Cathy Costello,REP,600102,1,0,107,108,
Payne,Commissioner of Labor,Leslie Osborn,REP,600102,4,1,121,126,
Payne,Corporation Commissioner,Bob Anthony,REP,600102,2,0,115,117,
Payne,Corporation Commissioner,Brian Bingman,REP,600102,3,1,117,121,
Payne,Governor,Chris Powell,LIB,600102,0,0,0,0,
Payne,Governor,Rex Lawhorn,LIB,600102,0,0,0,0,
Payne,Corporation Commissioner,Ashley Nicole Mccray,DEM,600102,5,1,22,28,
Payne,Corporation Commissioner,Blake Cummings,DEM,600102,2,0,28,30,
Payne,Governor,Mick Cornett,REP,600103,1,1,99,101,
Payne,Governor,Kevin Stitt,REP,600103,2,0,87,89,
Payne,Lieutenant Governor,Dana Murphy,REP,600103,0,0,81,81,
Payne,Lieutenant Governor,Matt Pinnell,REP,600103,3,1,102,106,
Payne,State Auditor,Cindy Byrd,REP,600103,1,1,70,72,
Payne,State Auditor,Charlie Prater,REP,600103,2,0,111,113,
Payne,Attorney General,Mike Hunter,REP,600103,0,1,73,74,
Payne,Attorney General,Gentner Drummond,REP,600103,3,0,111,114,
Payne,Superintendent of Public Instruction,Joy Hofmeister,REP,600103,2,1,92,95,
Payne,Superintendent of Public Instruction,Linda Murphy,REP,600103,1,0,89,90,
Payne,Commissioner of Labor,Cathy Costello,REP,600103,1,0,80,81,
Payne,Commissioner of Labor,Leslie Osborn,REP,600103,1,1,101,103,
Payne,Corporation Commissioner,Bob Anthony,REP,600103,0,1,77,78,
Payne,Corporation Commissioner,Brian Bingman,REP,600103,3,0,105,108,
Payne,Governor,Chris Powell,LIB,600103,0,0,0,0,
Payne,Governor,Rex Lawhorn,LIB,600103,0,0,0,0,
Payne,Corporation Commissioner,Ashley Nicole Mccray,DEM,600103,0,0,30,30,
Payne,Corporation Commissioner,Blake Cummings,DEM,600103,2,0,28,30,
Payne,Governor,Mick Cornett,REP,600104,3,2,116,121,
Payne,Governor,Kevin Stitt,REP,600104,3,1,139,143,
Payne,Lieutenant Governor,Dana Murphy,REP,600104,2,0,84,86,
Payne,Lieutenant Governor,Matt Pinnell,REP,600104,4,3,171,178,
Payne,State Auditor,Cindy Byrd,REP,600104,2,0,99,101,
Payne,State Auditor,Charlie Prater,REP,600104,3,3,152,158,
Payne,Attorney General,Mike Hunter,REP,600104,3,0,95,98,
Payne,Attorney General,Gentner Drummond,REP,600104,3,3,158,164,
Payne,Superintendent of Public Instruction,Joy Hofmeister,REP,600104,6,1,150,157,
Payne,Superintendent of Public Instruction,Linda Murphy,REP,600104,0,2,102,104,
Payne,Commissioner of Labor,Cathy Costello,REP,600104,2,0,111,113,
Payne,Commissioner of Labor,Leslie Osborn,REP,600104,4,3,142,149,
Payne,Corporation Commissioner,Bob Anthony,REP,600104,3,1,125,129,
Payne,Corporation Commissioner,Brian Bingman,REP,600104,3,2,126,131,
Payne,Governor,Chris Powell,LIB,600104,0,0,0,0,
Payne,Governor,Rex Lawhorn,LIB,600104,0,0,0,0,
Payne,Corporation Commissioner,Ashley Nicole Mccray,DEM,600104,0,2,22,24,
Payne,Corporation Commissioner,Blake Cummings,DEM,600104,0,1,24,25,
Payne,Governor,Mick Cornett,REP,600201,2,0,113,115,
Payne,Governor,Kevin Stitt,REP,600201,4,1,107,112,
Payne,Lieutenant Governor,Dana Murphy,REP,600201,2,1,84,87,
Payne,Lieutenant Governor,Matt Pinnell,REP,600201,4,0,129,133,
Payne,State Auditor,Cindy Byrd,REP,600201,4,1,79,84,
Payne,State Auditor,Charlie Prater,REP,600201,2,0,128,130,
Payne,Attorney General,Mike Hunter,REP,600201,3,1,108,112,
Payne,Attorney General,Gentner Drummond,REP,600201,3,0,108,111,
Payne,Superintendent of Public Instruction,Joy Hofmeister,REP,600201,3,0,103,106,
Payne,Superintendent of Public Instruction,Linda Murphy,REP,600201,3,1,111,115,
Payne,Commissioner of Labor,Cathy Costello,REP,600201,4,0,92,96,
Payne,Commissioner of Labor,Leslie Osborn,REP,600201,2,1,118,121,
Payne,Corporation Commissioner,Bob Anthony,REP,600201,1,1,95,97,
Payne,Corporation Commissioner,Brian Bingman,REP,600201,5,0,119,124,
Payne,Governor,Chris Powell,LIB,600201,0,0,0,0,
Payne,Governor,Rex Lawhorn,LIB,600201,0,0,0,0,
Payne,Corporation Commissioner,Ashley Nicole Mccray,DEM,600201,2,1,59,62,
Payne,Corporation Commissioner,Blake Cummings,DEM,600201,2,2,116,120,
Payne,Governor,Mick Cornett,REP,600301,6,12,197,215,
Payne,Governor,Kevin Stitt,REP,600301,5,4,206,215,
Payne,Lieutenant Governor,Dana Murphy,REP,600301,5,5,177,187,
Payne,Lieutenant Governor,Matt Pinnell,REP,600301,5,11,223,239,
Payne,State Auditor,Cindy Byrd,REP,600301,6,6,186,198,
Payne,State Auditor,Charlie Prater,REP,600301,4,10,207,221,
Payne,Attorney General,Mike Hunter,REP,600301,3,7,182,192,
Payne,Attorney General,Gentner Drummond,REP,600301,8,9,218,235,
Payne,Superintendent of Public Instruction,Joy Hofmeister,REP,600301,5,8,221,234,
Payne,Superintendent of Public Instruction,Linda Murphy,REP,600301,6,8,180,194,
Payne,Commissioner of Labor,Cathy Costello,REP,600301,4,6,201,211,
Payne,Commissioner of Labor,Leslie Osborn,REP,600301,7,10,197,214,
Payne,Corporation Commissioner,Bob Anthony,REP,600301,7,7,222,236,
Payne,Corporation Commissioner,Brian Bingman,REP,600301,4,9,180,193,
Payne,Governor,Chris Powell,LIB,600301,0,0,0,0,
Payne,Governor,Rex Lawhorn,LIB,600301,0,0,2,2,
Payne,Corporation Commissioner,Ashley Nicole Mccray,DEM,600301,2,1,36,39,
Payne,Corporation Commissioner,Blake Cummings,DEM,600301,1,1,27,29,
Payne,Governor,Mick Cornett,REP,600401,13,29,275,317,
Payne,Governor,Kevin Stitt,REP,600401,6,16,154,176,
Payne,Lieutenant Governor,Dana Murphy,REP,600401,3,25,196,224,
Payne,Lieutenant Governor,Matt Pinnell,REP,600401,13,18,214,245,
Payne,State Auditor,Cindy Byrd,REP,600401,10,26,198,234,
Payne,State Auditor,Charlie Prater,REP,600401,7,18,202,227,
Payne,Attorney General,Mike Hunter,REP,600401,11,29,198,238,
Payne,Attorney General,Gentner Drummond,REP,600401,7,16,223,246,
Payne,Superintendent of Public Instruction,Joy Hofmeister,REP,600401,10,22,267,299,
Payne,Superintendent of Public Instruction,Linda Murphy,REP,600401,7,20,151,178,
Payne,Commissioner of Labor,Cathy Costello,REP,600401,7,20,196,223,
Payne,Commissioner of Labor,Leslie Osborn,REP,600401,9,23,214,246,
Payne,Corporation Commissioner,Bob Anthony,REP,600401,12,27,225,264,
Payne,Corporation Commissioner,Brian Bingman,REP,600401,5,17,183,205,
Payne,Governor,Chris Powell,LIB,600401,0,0,1,1,
Payne,Governor,Rex Lawhorn,LIB,600401,0,0,0,0,
Payne,Corporation Commissioner,Ashley Nicole Mccray,DEM,600401,3,6,64,73,
Payne,Corporation Commissioner,Blake Cummings,DEM,600401,2,0,22,24,
Payne,Governor,Mick Cornett,REP,600402,6,11,98,115,
Payne,Governor,Kevin Stitt,REP,600402,1,6,68,75,
Payne,Lieutenant Governor,Dana Murphy,REP,600402,5,2,67,74,
Payne,Lieutenant Governor,Matt Pinnell,REP,600402,2,15,94,111,
Payne,State Auditor,Cindy Byrd,REP,600402,6,7,70,83,
Payne,State Auditor,Charlie Prater,REP,600402,1,10,85,96,
Payne,Attorney General,Mike Hunter,REP,600402,1,12,79,92,
Payne,Attorney General,Gentner Drummond,REP,600402,3,5,86,94,
Payne,Superintendent of Public Instruction,Joy Hofmeister,REP,600402,4,11,92,107,
Payne,Superintendent of Public Instruction,Linda Murphy,REP,600402,3,6,69,78,
Payne,Commissioner of Labor,Cathy Costello,REP,600402,2,5,55,62,
Payne,Commissioner of Labor,Leslie Osborn,REP,600402,2,12,103,117,
Payne,Corporation Commissioner,Bob Anthony,REP,600402,3,11,79,93,
Payne,Corporation Commissioner,Brian Bingman,REP,600402,1,6,84,91,
Payne,Governor,Chris Powell,LIB,600402,0,0,0,0,
Payne,Governor,Rex Lawhorn,LIB,600402,0,0,0,0,
Payne,Corporation Commissioner,Ashley Nicole Mccray,DEM,600402,1,0,26,27,
Payne,Corporation Commissioner,Blake Cummings,DEM,600402,0,0,18,18,
Payne,Governor,Mick Cornett,REP,600403,4,4,93,101,
Payne,Governor,Kevin Stitt,REP,600403,0,11,76,87,
Payne,Lieutenant Governor,Dana Murphy,REP,600403,0,3,65,68,
Payne,Lieutenant Governor,Matt Pinnell,REP,600403,4,12,101,117,
Payne,State Auditor,Cindy Byrd,REP,600403,2,7,71,80,
Payne,State Auditor,Charlie Prater,REP,600403,2,6,90,98,
Payne,Attorney General,Mike Hunter,REP,600403,3,6,78,87,
Payne,Attorney General,Gentner Drummond,REP,600403,1,9,88,98,
Payne,Superintendent of Public Instruction,Joy Hofmeister,REP,600403,2,9,101,112,
Payne,Superintendent of Public Instruction,Linda Murphy,REP,600403,2,6,67,75,
Payne,Commissioner of Labor,Cathy Costello,REP,600403,0,5,80,85,
Payne,Commissioner of Labor,Leslie Osborn,REP,600403,3,10,83,96,
Payne,Corporation Commissioner,Bob Anthony,REP,600403,2,7,88,97,
Payne,Corporation Commissioner,Brian Bingman,REP,600403,2,8,73,83,
Payne,Governor,Chris Powell,LIB,600403,0,0,0,0,
Payne,Governor,Rex Lawhorn,LIB,600403,0,0,0,0,
Payne,Corporation Commissioner,Ashley Nicole Mccray,DEM,600403,2,6,31,39,
Payne,Corporation Commissioner,Blake Cummings,DEM,600403,0,0,13,13,
Payne,Governor,Mick Cornett,REP,600404,0,5,9,14,
Payne,Governor,Kevin Stitt,REP,600404,0,0,16,16,
Payne,Lieutenant Governor,Dana Murphy,REP,600404,0,1,10,11,
Payne,Lieutenant Governor,Matt Pinnell,REP,600404,0,4,15,19,
Payne,State Auditor,Cindy Byrd,REP,600404,0,3,9,12,
Payne,State Auditor,Charlie Prater,REP,600404,0,2,16,18,
Payne,Attorney General,Mike Hunter,REP,600404,0,2,13,15,
Payne,Attorney General,Gentner Drummond,REP,600404,0,3,12,15,
Payne,Superintendent of Public Instruction,Joy Hofmeister,REP,600404,0,4,13,17,
Payne,Superintendent of Public Instruction,Linda Murphy,REP,600404,0,1,12,13,
Payne,Commissioner of Labor,Cathy Costello,REP,600404,0,3,15,18,
Payne,Commissioner of Labor,Leslie Osborn,REP,600404,0,2,10,12,
Payne,Corporation Commissioner,Bob Anthony,REP,600404,0,3,12,15,
Payne,Corporation Commissioner,Brian Bingman,REP,600404,0,2,13,15,
Payne,Governor,Chris Powell,LIB,600404,0,0,0,0,
Payne,Governor,Rex Lawhorn,LIB,600404,0,0,0,0,
Payne,Corporation Commissioner,Ashley Nicole Mccray,DEM,600404,2,1,9,12,
Payne,Corporation Commissioner,Blake Cummings,DEM,600404,0,0,1,1,
Payne,Governor,Mick Cornett,REP,600405,7,11,105,123,
Payne,Governor,Kevin Stitt,REP,600405,1,14,141,156,
Payne,Lieutenant Governor,Dana Murphy,REP,600405,7,11,107,125,
Payne,Lieutenant Governor,Matt Pinnell,REP,600405,1,14,134,149,
Payne,State Auditor,Cindy Byrd,REP,600405,5,10,100,115,
Payne,State Auditor,Charlie Prater,REP,600405,3,14,138,155,
Payne,Attorney General,Mike Hunter,REP,600405,4,13,103,120,
Payne,Attorney General,Gentner Drummond,REP,600405,4,11,140,155,
Payne,Superintendent of Public Instruction,Joy Hofmeister,REP,600405,6,12,136,154,
Payne,Superintendent of Public Instruction,Linda Murphy,REP,600405,2,11,107,120,
Payne,Commissioner of Labor,Cathy Costello,REP,600405,2,15,101,118,
Payne,Commissioner of Labor,Leslie Osborn,REP,600405,5,8,137,150,
Payne,Corporation Commissioner,Bob Anthony,REP,600405,7,11,118,136,
Payne,Corporation Commissioner,Brian Bingman,REP,600405,1,13,122,136,
Payne,Governor,Chris Powell,LIB,600405,0,0,0,0,
Payne,Governor,Rex Lawhorn,LIB,600405,0,0,0,0,
Payne,Corporation Commissioner,Ashley Nicole Mccray,DEM,600405,1,2,18,21,
Payne,Corporation Commissioner,Blake Cummings,DEM,600405,0,1,21,22,
Payne,Governor,Mick Cornett,REP,600406,4,6,104,114,
Payne,Governor,Kevin Stitt,REP,600406,6,4,117,127,
Payne,Lieutenant Governor,Dana Murphy,REP,600406,6,5,93,104,
Payne,Lieutenant Governor,Matt Pinnell,REP,600406,4,5,124,133,
Payne,State Auditor,Cindy Byrd,REP,600406,1,2,88,91,
Payne,State Auditor,Charlie Prater,REP,600406,7,7,124,138,
Payne,Attorney General,Mike Hunter,REP,600406,4,6,86,96,
Payne,Attorney General,Gentner Drummond,REP,600406,4,4,127,135,
Payne,Superintendent of Public Instruction,Joy Hofmeister,REP,600406,6,2,123,131,
Payne,Superintendent of Public Instruction,Linda Murphy,REP,600406,4,8,96,108,
Payne,Commissioner of Labor,Cathy Costello,REP,600406,6,6,110,122,
Payne,Commissioner of Labor,Leslie Osborn,REP,600406,3,3,105,111,
Payne,Corporation Commissioner,Bob Anthony,REP,600406,4,7,100,111,
Payne,Corporation Commissioner,Brian Bingman,REP,600406,6,2,114,122,
Payne,Governor,Chris Powell,LIB,600406,0,0,0,0,
Payne,Governor,Rex Lawhorn,LIB,600406,0,0,0,0,
Payne,Corporation Commissioner,Ashley Nicole Mccray,DEM,600406,1,0,23,24,
Payne,Corporation Commissioner,Blake Cummings,DEM,600406,0,0,19,19,
Payne,Governor,Mick Cornett,REP,600407,2,11,111,124,
Payne,Governor,Kevin Stitt,REP,600407,1,7,117,125,
Payne,Lieutenant Governor,Dana Murphy,REP,600407,0,11,96,107,
Payne,Lieutenant Governor,Matt Pinnell,REP,600407,3,7,127,137,
Payne,State Auditor,Cindy Byrd,REP,600407,3,13,107,123,
Payne,State Auditor,Charlie Prater,REP,600407,0,5,109,114,
Payne,Attorney General,Mike Hunter,REP,600407,1,11,86,98,
Payne,Attorney General,Gentner Drummond,REP,600407,2,7,135,144,
Payne,Superintendent of Public Instruction,Joy Hofmeister,REP,600407,3,12,119,134,
Payne,Superintendent of Public Instruction,Linda Murphy,REP,600407,0,5,103,108,
Payne,Commissioner of Labor,Cathy Costello,REP,600407,2,11,103,116,
Payne,Commissioner of Labor,Leslie Osborn,REP,600407,1,6,119,126,
Payne,Corporation Commissioner,Bob Anthony,REP,600407,0,12,105,117,
Payne,Corporation Commissioner,Brian Bingman,REP,600407,3,6,116,125,
Payne,Governor,Chris Powell,LIB,600407,0,0,0,0,
Payne,Governor,Rex Lawhorn,LIB,600407,0,1,0,1,
Payne,Corporation Commissioner,Ashley Nicole Mccray,DEM,600407,1,1,35,37,
Payne,Corporation Commissioner,Blake Cummings,DEM,600407,1,1,13,15,
Payne,Governor,Mick Cornett,REP,600408,0,1,38,39,
Payne,Governor,Kevin Stitt,REP,600408,0,0,37,37,
Payne,Lieutenant Governor,Dana Murphy,REP,600408,0,0,28,28,
Payne,Lieutenant Governor,Matt Pinnell,REP,600408,0,1,45,46,
Payne,State Auditor,Cindy Byrd,REP,600408,0,1,40,41,
Payne,State Auditor,Charlie Prater,REP,600408,0,0,33,33,
Payne,Attorney General,Mike Hunter,REP,600408,0,0,29,29,
Payne,Attorney General,Gentner Drummond,REP,600408,0,1,45,46,
Payne,Superintendent of Public Instruction,Joy Hofmeister,REP,600408,0,0,39,39,
Payne,Superintendent of Public Instruction,Linda Murphy,REP,600408,0,1,36,37,
Payne,Commissioner of Labor,Cathy Costello,REP,600408,0,0,32,32,
Payne,Commissioner of Labor,Leslie Osborn,REP,600408,0,1,41,42,
Payne,Corporation Commissioner,Bob Anthony,REP,600408,0,1,39,40,
Payne,Corporation Commissioner,Brian Bingman,REP,600408,0,0,35,35,
Payne,Governor,Chris Powell,LIB,600408,0,0,0,0,
Payne,Governor,Rex Lawhorn,LIB,600408,0,0,0,0,
Payne,Corporation Commissioner,Ashley Nicole Mccray,DEM,600408,0,0,6,6,
Payne,Corporation Commissioner,Blake Cummings,DEM,600408,0,0,8,8,
Payne,Governor,Mick Cornett,REP,600409,0,11,97,108,
Payne,Governor,Kevin Stitt,REP,600409,6,4,102,112,
Payne,Lieutenant Governor,Dana Murphy,REP,600409,2,6,88,96,
Payne,Lieutenant Governor,Matt Pinnell,REP,600409,2,9,105,116,
Payne,State Auditor,Cindy Byrd,REP,600409,2,6,79,87,
Payne,State Auditor,Charlie Prater,REP,600409,3,9,114,126,
Payne,Attorney General,Mike Hunter,REP,600409,6,5,68,79,
Payne,Attorney General,Gentner Drummond,REP,600409,0,10,129,139,
Payne,Superintendent of Public Instruction,Joy Hofmeister,REP,600409,6,10,96,112,
Payne,Superintendent of Public Instruction,Linda Murphy,REP,600409,0,5,96,101,
Payne,Commissioner of Labor,Cathy Costello,REP,600409,3,8,89,100,
Payne,Commissioner of Labor,Leslie Osborn,REP,600409,2,7,102,111,
Payne,Corporation Commissioner,Bob Anthony,REP,600409,2,4,96,102,
Payne,Corporation Commissioner,Brian Bingman,REP,600409,3,11,100,114,
Payne,Governor,Chris Powell,LIB,600409,0,0,1,1,
Payne,Governor,Rex Lawhorn,LIB,600409,0,0,2,2,
Payne,Corporation Commissioner,Ashley Nicole Mccray,DEM,600409,0,2,35,37,
Payne,Corporation Commissioner,Blake Cummings,DEM,600409,2,1,18,21,
Pittsburg,Governor,Mick Cornett,REP,610001,0,0,1,1,
Pittsburg,Governor,Kevin Stitt,REP,610001,0,0,2,2,
Pittsburg,Lieutenant Governor,Dana Murphy,REP,610001,0,0,3,3,
Pittsburg,Lieutenant Governor,Matt Pinnell,REP,610001,0,0,0,0,
Pittsburg,State Auditor,Cindy Byrd,REP,610001,0,0,1,1,
Pittsburg,State Auditor,Charlie Prater,REP,610001,0,0,2,2,
Pittsburg,Attorney General,Mike Hunter,REP,610001,0,0,1,1,
Pittsburg,Attorney General,Gentner Drummond,REP,610001,0,0,2,2,
Pittsburg,Superintendent of Public Instruction,Joy Hofmeister,REP,610001,0,0,2,2,
Pittsburg,Superintendent of Public Instruction,Linda Murphy,REP,610001,0,0,1,1,
Pittsburg,Commissioner of Labor,Cathy Costello,REP,610001,0,0,1,1,
Pittsburg,Commissioner of Labor,Leslie Osborn,REP,610001,0,0,2,2,
Pittsburg,Corporation Commissioner,Bob Anthony,REP,610001,0,0,2,2,
Pittsburg,Corporation Commissioner,Brian Bingman,REP,610001,0,0,1,1,
Pittsburg,State House,Josh Hass,REP,610001,0,0,2,2,17
Pittsburg,State House,Jim Grego,REP,610001,0,0,1,1,17
Pittsburg,Governor,Chris Powell,LIB,610001,0,0,0,0,
Pittsburg,Governor,Rex Lawhorn,LIB,610001,0,0,0,0,
Pittsburg,Corporation Commissioner,Ashley Nicole Mccray,DEM,610001,1,2,8,11,
Pittsburg,Corporation Commissioner,Blake Cummings,DEM,610001,0,0,4,4,
Pittsburg,U.S. House,Jason Nichols,DEM,610001,1,1,9,11,02
Pittsburg,U.S. House,Clay Padgett,DEM,610001,0,1,3,4,02
Pittsburg,Governor,Mick Cornett,REP,610003,0,1,15,16,
Pittsburg,Governor,Kevin Stitt,REP,610003,2,2,35,39,
Pittsburg,Lieutenant Governor,Dana Murphy,REP,610003,1,2,17,20,
Pittsburg,Lieutenant Governor,Matt Pinnell,REP,610003,1,1,33,35,
Pittsburg,State Auditor,Cindy Byrd,REP,610003,1,2,23,26,
Pittsburg,State Auditor,Charlie Prater,REP,610003,1,1,26,28,
Pittsburg,Attorney General,Mike Hunter,REP,610003,2,1,24,27,
Pittsburg,Attorney General,Gentner Drummond,REP,610003,0,2,26,28,
Pittsburg,Superintendent of Public Instruction,Joy Hofmeister,REP,610003,2,2,26,30,
Pittsburg,Superintendent of Public Instruction,Linda Murphy,REP,610003,0,1,23,24,
Pittsburg,Commissioner of Labor,Cathy Costello,REP,610003,2,2,28,32,
Pittsburg,Commissioner of Labor,Leslie Osborn,REP,610003,0,1,23,24,
Pittsburg,Corporation Commissioner,Bob Anthony,REP,610003,0,2,22,24,
Pittsburg,Corporation Commissioner,Brian Bingman,REP,610003,2,1,27,30,
Pittsburg,State House,Josh Hass,REP,610003,1,3,38,42,17
Pittsburg,State House,Jim Grego,REP,610003,1,0,13,14,17
Pittsburg,Governor,Chris Powell,LIB,610003,0,0,1,1,
Pittsburg,Governor,Rex Lawhorn,LIB,610003,0,0,0,0,
Pittsburg,Corporation Commissioner,Ashley Nicole Mccray,DEM,610003,1,3,40,44,
Pittsburg,Corporation Commissioner,Blake Cummings,DEM,610003,0,5,24,29,
Pittsburg,U.S. House,Jason Nichols,DEM,610003,0,6,30,36,02
Pittsburg,U.S. House,Clay Padgett,DEM,610003,1,2,34,37,02
Pittsburg,Governor,Mick Cornett,REP,610004,0,3,24,27,
Pittsburg,Governor,Kevin Stitt,REP,610004,1,4,61,66,
Pittsburg,Lieutenant Governor,Dana Murphy,REP,610004,1,4,29,34,
Pittsburg,Lieutenant Governor,Matt Pinnell,REP,610004,0,3,54,57,
Pittsburg,State Auditor,Cindy Byrd,REP,610004,1,2,37,40,
Pittsburg,State Auditor,Charlie Prater,REP,610004,0,5,45,50,
Pittsburg,Attorney General,Mike Hunter,REP,610004,1,4,34,39,
Pittsburg,Attorney General,Gentner Drummond,REP,610004,0,3,51,54,
Pittsburg,Superintendent of Public Instruction,Joy Hofmeister,REP,610004,1,5,46,52,
Pittsburg,Superintendent of Public Instruction,Linda Murphy,REP,610004,0,2,38,40,
Pittsburg,Commissioner of Labor,Cathy Costello,REP,610004,0,2,42,44,
Pittsburg,Commissioner of Labor,Leslie Osborn,REP,610004,1,5,40,46,
Pittsburg,Corporation Commissioner,Bob Anthony,REP,610004,1,4,36,41,
Pittsburg,Corporation Commissioner,Brian Bingman,REP,610004,0,3,47,50,
Pittsburg,Governor,Chris Powell,LIB,610004,0,0,1,1,
Pittsburg,Governor,Rex Lawhorn,LIB,610004,0,0,0,0,
Pittsburg,Corporation Commissioner,Ashley Nicole Mccray,DEM,610004,1,8,64,73,
Pittsburg,Corporation Commissioner,Blake Cummings,DEM,610004,0,2,44,46,
Pittsburg,U.S. House,Jason Nichols,DEM,610004,0,7,77,84,02
Pittsburg,U.S. House,Clay Padgett,DEM,610004,1,3,30,34,02
Pittsburg,Governor,Mick Cornett,REP,610005,0,0,8,8,
Pittsburg,Governor,Kevin Stitt,REP,610005,2,0,24,26,
Pittsburg,Lieutenant Governor,Dana Murphy,REP,610005,0,0,14,14,
Pittsburg,Lieutenant Governor,Matt Pinnell,REP,610005,2,0,17,19,
Pittsburg,State Auditor,Cindy Byrd,REP,610005,0,0,12,12,
Pittsburg,State Auditor,Charlie Prater,REP,610005,2,0,19,21,
Pittsburg,Attorney General,Mike Hunter,REP,610005,2,0,17,19,
Pittsburg,Attorney General,Gentner Drummond,REP,610005,0,0,14,14,
Pittsburg,Superintendent of Public Instruction,Joy Hofmeister,REP,610005,1,0,12,13,
Pittsburg,Superintendent of Public Instruction,Linda Murphy,REP,610005,1,0,20,21,
Pittsburg,Commissioner of Labor,Cathy Costello,REP,610005,2,0,15,17,
Pittsburg,Commissioner of Labor,Leslie Osborn,REP,610005,0,0,16,16,
Pittsburg,Corporation Commissioner,Bob Anthony,REP,610005,2,0,18,20,
Pittsburg,Corporation Commissioner,Brian Bingman,REP,610005,0,0,14,14,
Pittsburg,Governor,Chris Powell,LIB,610005,0,0,0,0,
Pittsburg,Governor,Rex Lawhorn,LIB,610005,0,0,0,0,
Pittsburg,Corporation Commissioner,Ashley Nicole Mccray,DEM,610005,0,4,36,40,
Pittsburg,Corporation Commissioner,Blake Cummings,DEM,610005,0,0,28,28,
Pittsburg,U.S. House,Jason Nichols,DEM,610005,0,3,33,36,02
Pittsburg,U.S. House,Clay Padgett,DEM,610005,0,1,30,31,02
Pittsburg,Governor,Mick Cornett,REP,610006,0,0,29,29,
Pittsburg,Governor,Kevin Stitt,REP,610006,1,2,47,50,
Pittsburg,Lieutenant Governor,Dana Murphy,REP,610006,0,1,22,23,
Pittsburg,Lieutenant Governor,Matt Pinnell,REP,610006,1,1,54,56,
Pittsburg,State Auditor,Cindy Byrd,REP,610006,0,1,34,35,
Pittsburg,State Auditor,Charlie Prater,REP,610006,1,1,41,43,
Pittsburg,Attorney General,Mike Hunter,REP,610006,0,0,36,36,
Pittsburg,Attorney General,Gentner Drummond,REP,610006,1,2,40,43,
Pittsburg,Superintendent of Public Instruction,Joy Hofmeister,REP,610006,1,0,52,53,
Pittsburg,Superintendent of Public Instruction,Linda Murphy,REP,610006,0,2,24,26,
Pittsburg,Commissioner of Labor,Cathy Costello,REP,610006,0,1,27,28,
Pittsburg,Commissioner of Labor,Leslie Osborn,REP,610006,1,1,49,51,
Pittsburg,Corporation Commissioner,Bob Anthony,REP,610006,0,0,33,33,
Pittsburg,Corporation Commissioner,Brian Bingman,REP,610006,1,2,43,46,
Pittsburg,Governor,Chris Powell,LIB,610006,0,0,0,0,
Pittsburg,Governor,Rex Lawhorn,LIB,610006,0,0,0,0,
Pittsburg,Corporation Commissioner,Ashley Nicole Mccray,DEM,610006,5,3,51,59,
Pittsburg,Corporation Commissioner,Blake Cummings,DEM,610006,0,3,33,36,
Pittsburg,U.S. House,Jason Nichols,DEM,610006,3,3,45,51,02
Pittsburg,U.S. House,Clay Padgett,DEM,610006,2,3,41,46,02
Pittsburg,Governor,Mick Cornett,REP,610007,1,2,29,32,
Pittsburg,Governor,Kevin Stitt,REP,610007,1,1,40,42,
Pittsburg,Lieutenant Governor,Dana Murphy,REP,610007,1,1,24,26,
Pittsburg,Lieutenant Governor,Matt Pinnell,REP,610007,0,2,43,45,
Pittsburg,State Auditor,Cindy Byrd,REP,610007,1,3,32,36,
Pittsburg,State Auditor,Charlie Prater,REP,610007,0,0,34,34,
Pittsburg,Attorney General,Mike Hunter,REP,610007,1,0,39,40,
Pittsburg,Attorney General,Gentner Drummond,REP,610007,1,3,27,31,
Pittsburg,Superintendent of Public Instruction,Joy Hofmeister,REP,610007,2,2,31,35,
Pittsburg,Superintendent of Public Instruction,Linda Murphy,REP,610007,0,1,37,38,
Pittsburg,Commissioner of Labor,Cathy Costello,REP,610007,1,1,25,27,
Pittsburg,Commissioner of Labor,Leslie Osborn,REP,610007,1,2,42,45,
Pittsburg,Corporation Commissioner,Bob Anthony,REP,610007,1,2,25,28,
Pittsburg,Corporation Commissioner,Brian Bingman,REP,610007,1,1,40,42,
Pittsburg,State House,Josh Hass,REP,610007,1,2,49,52,17
Pittsburg,State House,Jim Grego,REP,610007,1,1,21,23,17
Pittsburg,Governor,Chris Powell,LIB,610007,0,0,0,0,
Pittsburg,Governor,Rex Lawhorn,LIB,610007,0,0,0,0,
Pittsburg,Corporation Commissioner,Ashley Nicole Mccray,DEM,610007,3,1,41,45,
Pittsburg,Corporation Commissioner,Blake Cummings,DEM,610007,0,1,26,27,
Pittsburg,U.S. House,Jason Nichols,DEM,610007,2,0,38,40,02
Pittsburg,U.S. House,Clay Padgett,DEM,610007,1,2,29,32,02
Pittsburg,Governor,Mick Cornett,REP,610008,0,0,13,13,
Pittsburg,Governor,Kevin Stitt,REP,610008,2,1,18,21,
Pittsburg,Lieutenant Governor,Dana Murphy,REP,610008,0,0,14,14,
Pittsburg,Lieutenant Governor,Matt Pinnell,REP,610008,2,1,16,19,
Pittsburg,State Auditor,Cindy Byrd,REP,610008,0,1,14,15,
Pittsburg,State Auditor,Charlie Prater,REP,610008,2,0,16,18,
Pittsburg,Attorney General,Mike Hunter,REP,610008,0,1,16,17,
Pittsburg,Attorney General,Gentner Drummond,REP,610008,2,0,15,17,
Pittsburg,Superintendent of Public Instruction,Joy Hofmeister,REP,610008,0,1,17,18,
Pittsburg,Superintendent of Public Instruction,Linda Murphy,REP,610008,2,0,13,15,
Pittsburg,Commissioner of Labor,Cathy Costello,REP,610008,0,0,14,14,
Pittsburg,Commissioner of Labor,Leslie Osborn,REP,610008,2,1,16,19,
Pittsburg,Corporation Commissioner,Bob Anthony,REP,610008,0,1,10,11,
Pittsburg,Corporation Commissioner,Brian Bingman,REP,610008,2,0,21,23,
Pittsburg,Governor,Chris Powell,LIB,610008,0,0,0,0,
Pittsburg,Governor,Rex Lawhorn,LIB,610008,0,0,0,0,
Pittsburg,Corporation Commissioner,Ashley Nicole Mccray,DEM,610008,0,2,24,26,
Pittsburg,Corporation Commissioner,Blake Cummings,DEM,610008,0,2,13,15,
Pittsburg,U.S. House,Jason Nichols,DEM,610008,0,2,21,23,02
Pittsburg,U.S. House,Clay Padgett,DEM,610008,0,2,16,18,02
Pittsburg,Governor,Mick Cornett,REP,610011,2,2,18,22,
Pittsburg,Governor,Kevin Stitt,REP,610011,1,4,35,40,
Pittsburg,Lieutenant Governor,Dana Murphy,REP,610011,0,2,15,17,
Pittsburg,Lieutenant Governor,Matt Pinnell,REP,610011,3,4,37,44,
Pittsburg,State Auditor,Cindy Byrd,REP,610011,3,1,19,23,
Pittsburg,State Auditor,Charlie Prater,REP,610011,0,5,32,37,
Pittsburg,Attorney General,Mike Hunter,REP,610011,0,4,27,31,
Pittsburg,Attorney General,Gentner Drummond,REP,610011,3,2,26,31,
Pittsburg,Superintendent of Public Instruction,Joy Hofmeister,REP,610011,2,4,31,37,
Pittsburg,Superintendent of Public Instruction,Linda Murphy,REP,610011,1,2,22,25,
Pittsburg,Commissioner of Labor,Cathy Costello,REP,610011,1,0,21,22,
Pittsburg,Commissioner of Labor,Leslie Osborn,REP,610011,1,6,31,38,
Pittsburg,Corporation Commissioner,Bob Anthony,REP,610011,2,6,23,31,
Pittsburg,Corporation Commissioner,Brian Bingman,REP,610011,1,0,28,29,
Pittsburg,Governor,Chris Powell,LIB,610011,0,0,0,0,
Pittsburg,Governor,Rex Lawhorn,LIB,610011,0,0,1,1,
Pittsburg,Corporation Commissioner,Ashley Nicole Mccray,DEM,610011,3,7,65,75,
Pittsburg,Corporation Commissioner,Blake Cummings,DEM,610011,3,3,50,56,
Pittsburg,U.S. House,Jason Nichols,DEM,610011,3,4,72,79,02
Pittsburg,U.S. House,Clay Padgett,DEM,610011,3,7,43,53,02
Pittsburg,Governor,Mick Cornett,REP,610014,0,2,21,23,
Pittsburg,Governor,Kevin Stitt,REP,610014,1,1,44,46,
Pittsburg,Lieutenant Governor,Dana Murphy,REP,610014,1,1,27,29,
Pittsburg,Lieutenant Governor,Matt Pinnell,REP,610014,0,2,38,40,
Pittsburg,State Auditor,Cindy Byrd,REP,610014,1,1,32,34,
Pittsburg,State Auditor,Charlie Prater,REP,610014,0,2,33,35,
Pittsburg,Attorney General,Mike Hunter,REP,610014,1,2,31,34,
Pittsburg,Attorney General,Gentner Drummond,REP,610014,0,1,34,35,
Pittsburg,Superintendent of Public Instruction,Joy Hofmeister,REP,610014,0,3,34,37,
Pittsburg,Superintendent of Public Instruction,Linda Murphy,REP,610014,1,0,32,33,
Pittsburg,Commissioner of Labor,Cathy Costello,REP,610014,1,1,31,33,
Pittsburg,Commissioner of Labor,Leslie Osborn,REP,610014,0,2,35,37,
Pittsburg,Corporation Commissioner,Bob Anthony,REP,610014,1,3,37,41,
Pittsburg,Corporation Commissioner,Brian Bingman,REP,610014,0,0,29,29,
Pittsburg,State House,Josh Hass,REP,610014,1,1,34,36,17
Pittsburg,State House,Jim Grego,REP,610014,0,2,32,34,17
Pittsburg,Governor,Chris Powell,LIB,610014,0,0,0,0,
Pittsburg,Governor,Rex Lawhorn,LIB,610014,0,0,0,0,
Pittsburg,Corporation Commissioner,Ashley Nicole Mccray,DEM,610014,5,5,48,58,
Pittsburg,Corporation Commissioner,Blake Cummings,DEM,610014,2,6,52,60,
Pittsburg,U.S. House,Jason Nichols,DEM,610014,3,6,53,62,02
Pittsburg,U.S. House,Clay Padgett,DEM,610014,4,5,49,58,02
Pittsburg,Governor,Mick Cornett,REP,610015,0,0,5,5,
Pittsburg,Governor,Kevin Stitt,REP,610015,0,0,4,4,
Pittsburg,Lieutenant Governor,Dana Murphy,REP,610015,0,0,4,4,
Pittsburg,Lieutenant Governor,Matt Pinnell,REP,610015,0,0,5,5,
Pittsburg,State Auditor,Cindy Byrd,REP,610015,0,0,7,7,
Pittsburg,State Auditor,Charlie Prater,REP,610015,0,0,2,2,
Pittsburg,Attorney General,Mike Hunter,REP,610015,0,0,4,4,
Pittsburg,Attorney General,Gentner Drummond,REP,610015,0,0,5,5,
Pittsburg,Superintendent of Public Instruction,Joy Hofmeister,REP,610015,0,0,9,9,
Pittsburg,Superintendent of Public Instruction,Linda Murphy,REP,610015,0,0,0,0,
Pittsburg,Commissioner of Labor,Cathy Costello,REP,610015,0,0,7,7,
Pittsburg,Commissioner of Labor,Leslie Osborn,REP,610015,0,0,2,2,
Pittsburg,Corporation Commissioner,Bob Anthony,REP,610015,0,0,2,2,
Pittsburg,Corporation Commissioner,Brian Bingman,REP,610015,0,0,7,7,
Pittsburg,Governor,Chris Powell,LIB,610015,0,0,0,0,
Pittsburg,Governor,Rex Lawhorn,LIB,610015,0,0,0,0,
Pittsburg,Corporation Commissioner,Ashley Nicole Mccray,DEM,610015,0,2,15,17,
Pittsburg,Corporation Commissioner,Blake Cummings,DEM,610015,0,0,9,9,
Pittsburg,U.S. House,Jason Nichols,DEM,610015,0,1,11,12,02
Pittsburg,U.S. House,Clay Padgett,DEM,610015,0,1,13,14,02
Pittsburg,Governor,Mick Cornett,REP,610019,0,0,5,5,
Pittsburg,Governor,Kevin Stitt,REP,610019,1,3,20,24,
Pittsburg,Lieutenant Governor,Dana Murphy,REP,610019,0,1,8,9,
Pittsburg,Lieutenant Governor,Matt Pinnell,REP,610019,1,2,17,20,
Pittsburg,State Auditor,Cindy Byrd,REP,610019,0,1,16,17,
Pittsburg,State Auditor,Charlie Prater,REP,610019,1,1,9,11,
Pittsburg,Attorney General,Mike Hunter,REP,610019,0,0,7,7,
Pittsburg,Attorney General,Gentner Drummond,REP,610019,1,3,19,23,
Pittsburg,Superintendent of Public Instruction,Joy Hofmeister,REP,610019,1,1,15,17,
Pittsburg,Superintendent of Public Instruction,Linda Murphy,REP,610019,0,2,10,12,
Pittsburg,Commissioner of Labor,Cathy Costello,REP,610019,1,1,13,15,
Pittsburg,Commissioner of Labor,Leslie Osborn,REP,610019,0,2,12,14,
Pittsburg,Corporation Commissioner,Bob Anthony,REP,610019,0,2,8,10,
Pittsburg,Corporation Commissioner,Brian Bingman,REP,610019,1,1,18,20,
Pittsburg,State House,Josh Hass,REP,610019,1,2,23,26,17
Pittsburg,State House,Jim Grego,REP,610019,0,1,3,4,17
Pittsburg,Governor,Chris Powell,LIB,610019,0,0,0,0,
Pittsburg,Governor,Rex Lawhorn,LIB,610019,0,0,0,0,
Pittsburg,Corporation Commissioner,Ashley Nicole Mccray,DEM,610019,0,1,20,21,
Pittsburg,Corporation Commissioner,Blake Cummings,DEM,610019,0,0,31,31,
Pittsburg,U.S. House,Jason Nichols,DEM,610019,0,0,25,25,02
Pittsburg,U.S. House,Clay Padgett,DEM,610019,0,1,26,27,02
Pittsburg,Governor,Mick Cornett,REP,610020,0,0,3,3,
Pittsburg,Governor,Kevin Stitt,REP,610020,1,4,3,8,
Pittsburg,Lieutenant Governor,Dana Murphy,REP,610020,1,2,1,4,
Pittsburg,Lieutenant Governor,Matt Pinnell,REP,610020,0,2,5,7,
Pittsburg,State Auditor,Cindy Byrd,REP,610020,0,4,2,6,
Pittsburg,State Auditor,Charlie Prater,REP,610020,1,0,4,5,
Pittsburg,Attorney General,Mike Hunter,REP,610020,1,2,2,5,
Pittsburg,Attorney General,Gentner Drummond,REP,610020,0,2,4,6,
Pittsburg,Superintendent of Public Instruction,Joy Hofmeister,REP,610020,0,0,5,5,
Pittsburg,Superintendent of Public Instruction,Linda Murphy,REP,610020,1,4,1,6,
Pittsburg,Commissioner of Labor,Cathy Costello,REP,610020,0,0,2,2,
Pittsburg,Commissioner of Labor,Leslie Osborn,REP,610020,1,4,4,9,
Pittsburg,Corporation Commissioner,Bob Anthony,REP,610020,0,0,3,3,
Pittsburg,Corporation Commissioner,Brian Bingman,REP,610020,1,4,3,8,
Pittsburg,State House,Josh Hass,REP,610020,1,0,5,6,17
Pittsburg,State House,Jim Grego,REP,610020,0,4,1,5,17
Pittsburg,Governor,Chris Powell,LIB,610020,0,0,0,0,
Pittsburg,Governor,Rex Lawhorn,LIB,610020,0,0,0,0,
Pittsburg,Corporation Commissioner,Ashley Nicole Mccray,DEM,610020,0,2,2,4,
Pittsburg,Corporation Commissioner,Blake Cummings,DEM,610020,0,1,15,16,
Pittsburg,U.S. House,Jason Nichols,DEM,610020,0,2,13,15,02
Pittsburg,U.S. House,Clay Padgett,DEM,610020,0,1,4,5,02
Pittsburg,Governor,Mick Cornett,REP,610021,0,0,19,19,
Pittsburg,Governor,Kevin Stitt,REP,610021,0,4,30,34,
Pittsburg,Lieutenant Governor,Dana Murphy,REP,610021,0,0,14,14,
Pittsburg,Lieutenant Governor,Matt Pinnell,REP,610021,0,4,32,36,
Pittsburg,State Auditor,Cindy Byrd,REP,610021,0,3,24,27,
Pittsburg,State Auditor,Charlie Prater,REP,610021,0,1,22,23,
Pittsburg,Attorney General,Mike Hunter,REP,610021,0,2,20,22,
Pittsburg,Attorney General,Gentner Drummond,REP,610021,0,2,27,29,
Pittsburg,Superintendent of Public Instruction,Joy Hofmeister,REP,610021,0,2,20,22,
Pittsburg,Superintendent of Public Instruction,Linda Murphy,REP,610021,0,2,25,27,
Pittsburg,Commissioner of Labor,Cathy Costello,REP,610021,0,2,21,23,
Pittsburg,Commissioner of Labor,Leslie Osborn,REP,610021,0,2,21,23,
Pittsburg,Corporation Commissioner,Bob Anthony,REP,610021,0,2,26,28,
Pittsburg,Corporation Commissioner,Brian Bingman,REP,610021,0,2,20,22,
Pittsburg,Governor,Chris Powell,LIB,610021,0,0,0,0,
Pittsburg,Governor,Rex Lawhorn,LIB,610021,0,0,0,0,
Pittsburg,Corporation Commissioner,Ashley Nicole Mccray,DEM,610021,0,3,43,46,
Pittsburg,Corporation Commissioner,Blake Cummings,DEM,610021,0,6,40,46,
Pittsburg,U.S. House,Jason Nichols,DEM,610021,0,6,35,41,02
Pittsburg,U.S. House,Clay Padgett,DEM,610021,0,3,47,50,02
Pittsburg,Governor,Mick Cornett,REP,610023,0,0,7,7,
Pittsburg,Governor,Kevin Stitt,REP,610023,0,0,9,9,
Pittsburg,Lieutenant Governor,Dana Murphy,REP,610023,0,0,3,3,
Pittsburg,Lieutenant Governor,Matt Pinnell,REP,610023,0,0,13,13,
Pittsburg,State Auditor,Cindy Byrd,REP,610023,0,0,7,7,
Pittsburg,State Auditor,Charlie Prater,REP,610023,0,0,8,8,
Pittsburg,Attorney General,Mike Hunter,REP,610023,0,0,6,6,
Pittsburg,Attorney General,Gentner Drummond,REP,610023,0,0,10,10,
Pittsburg,Superintendent of Public Instruction,Joy Hofmeister,REP,610023,0,0,5,5,
Pittsburg,Superintendent of Public Instruction,Linda Murphy,REP,610023,0,0,11,11,
Pittsburg,Commissioner of Labor,Cathy Costello,REP,610023,0,0,7,7,
Pittsburg,Commissioner of Labor,Leslie Osborn,REP,610023,0,0,9,9,
Pittsburg,Corporation Commissioner,Bob Anthony,REP,610023,0,0,6,6,
Pittsburg,Corporation Commissioner,Brian Bingman,REP,610023,0,0,10,10,
Pittsburg,Governor,Chris Powell,LIB,610023,0,0,0,0,
Pittsburg,Governor,Rex Lawhorn,LIB,610023,0,0,0,0,
Pittsburg,Corporation Commissioner,Ashley Nicole Mccray,DEM,610023,0,0,5,5,
Pittsburg,Corporation Commissioner,Blake Cummings,DEM,610023,0,0,15,15,
Pittsburg,U.S. House,Jason Nichols,DEM,610023,0,0,14,14,02
Pittsburg,U.S. House,Clay Padgett,DEM,610023,0,0,6,6,02
Pittsburg,Governor,Mick Cornett,REP,610026,1,2,16,19,
Pittsburg,Governor,Kevin Stitt,REP,610026,0,1,40,41,
Pittsburg,Lieutenant Governor,Dana Murphy,REP,610026,1,2,20,23,
Pittsburg,Lieutenant Governor,Matt Pinnell,REP,610026,0,1,34,35,
Pittsburg,State Auditor,Cindy Byrd,REP,610026,1,2,20,23,
Pittsburg,State Auditor,Charlie Prater,REP,610026,0,1,34,35,
Pittsburg,Attorney General,Mike Hunter,REP,610026,1,0,29,30,
Pittsburg,Attorney General,Gentner Drummond,REP,610026,0,3,27,30,
Pittsburg,Superintendent of Public Instruction,Joy Hofmeister,REP,610026,1,1,28,30,
Pittsburg,Superintendent of Public Instruction,Linda Murphy,REP,610026,0,2,26,28,
Pittsburg,Commissioner of Labor,Cathy Costello,REP,610026,1,2,18,21,
Pittsburg,Commissioner of Labor,Leslie Osborn,REP,610026,0,1,34,35,
Pittsburg,Corporation Commissioner,Bob Anthony,REP,610026,1,1,14,16,
Pittsburg,Corporation Commissioner,Brian Bingman,REP,610026,0,2,37,39,
Pittsburg,State House,Josh Hass,REP,610026,1,1,27,29,17
Pittsburg,State House,Jim Grego,REP,610026,0,2,28,30,17
Pittsburg,Governor,Chris Powell,LIB,610026,0,0,0,0,
Pittsburg,Governor,Rex Lawhorn,LIB,610026,0,0,1,1,
Pittsburg,Corporation Commissioner,Ashley Nicole Mccray,DEM,610026,3,1,34,38,
Pittsburg,Corporation Commissioner,Blake Cummings,DEM,610026,1,3,37,41,
Pittsburg,U.S. House,Jason Nichols,DEM,610026,3,0,34,37,02
Pittsburg,U.S. House,Clay Padgett,DEM,610026,1,4,37,42,02
Pittsburg,Governor,Mick Cornett,REP,610027,1,1,83,85,
Pittsburg,Governor,Kevin Stitt,REP,610027,4,6,88,98,
Pittsburg,Lieutenant Governor,Dana Murphy,REP,610027,3,1,59,63,
Pittsburg,Lieutenant Governor,Matt Pinnell,REP,610027,2,6,111,119,
Pittsburg,State Auditor,Cindy Byrd,REP,610027,1,5,64,70,
Pittsburg,State Auditor,Charlie Prater,REP,610027,4,2,101,107,
Pittsburg,Attorney General,Mike Hunter,REP,610027,2,2,79,83,
Pittsburg,Attorney General,Gentner Drummond,REP,610027,3,5,89,97,
Pittsburg,Superintendent of Public Instruction,Joy Hofmeister,REP,610027,3,6,91,100,
Pittsburg,Superintendent of Public Instruction,Linda Murphy,REP,610027,2,1,78,81,
Pittsburg,Commissioner of Labor,Cathy Costello,REP,610027,4,5,55,64,
Pittsburg,Commissioner of Labor,Leslie Osborn,REP,610027,1,2,107,110,
Pittsburg,Corporation Commissioner,Bob Anthony,REP,610027,3,5,76,84,
Pittsburg,Corporation Commissioner,Brian Bingman,REP,610027,2,2,94,98,
Pittsburg,Governor,Chris Powell,LIB,610027,0,0,0,0,
Pittsburg,Governor,Rex Lawhorn,LIB,610027,0,0,1,1,
Pittsburg,Corporation Commissioner,Ashley Nicole Mccray,DEM,610027,3,4,78,85,
Pittsburg,Corporation Commissioner,Blake Cummings,DEM,610027,3,2,74,79,
Pittsburg,U.S. House,Jason Nichols,DEM,610027,3,1,88,92,02
Pittsburg,U.S. House,Clay Padgett,DEM,610027,3,4,65,72,02
Pittsburg,Governor,Mick Cornett,REP,610028,1,0,9,10,
Pittsburg,Governor,Kevin Stitt,REP,610028,0,0,13,13,
Pittsburg,Lieutenant Governor,Dana Murphy,REP,610028,0,0,10,10,
Pittsburg,Lieutenant Governor,Matt Pinnell,REP,610028,1,0,12,13,
Pittsburg,State Auditor,Cindy Byrd,REP,610028,1,0,6,7,
Pittsburg,State Auditor,Charlie Prater,REP,610028,0,0,14,14,
Pittsburg,Attorney General,Mike Hunter,REP,610028,0,0,11,11,
Pittsburg,Attorney General,Gentner Drummond,REP,610028,1,0,9,10,
Pittsburg,Superintendent of Public Instruction,Joy Hofmeister,REP,610028,0,0,8,8,
Pittsburg,Superintendent of Public Instruction,Linda Murphy,REP,610028,1,0,14,15,
Pittsburg,Commissioner of Labor,Cathy Costello,REP,610028,0,0,8,8,
Pittsburg,Commissioner of Labor,Leslie Osborn,REP,610028,1,0,11,12,
Pittsburg,Corporation Commissioner,Bob Anthony,REP,610028,1,0,11,12,
Pittsburg,Corporation Commissioner,Brian Bingman,REP,610028,0,0,8,8,
Pittsburg,Governor,Chris Powell,LIB,610028,0,0,0,0,
Pittsburg,Governor,Rex Lawhorn,LIB,610028,0,0,0,0,
Pittsburg,Corporation Commissioner,Ashley Nicole Mccray,DEM,610028,3,0,40,43,
Pittsburg,Corporation Commissioner,Blake Cummings,DEM,610028,2,1,25,28,
Pittsburg,U.S. House,Jason Nichols,DEM,610028,5,0,34,39,02
Pittsburg,U.S. House,Clay Padgett,DEM,610028,0,1,29,30,02
Pittsburg,Governor,Mick Cornett,REP,610029,0,0,6,6,
Pittsburg,Governor,Kevin Stitt,REP,610029,0,1,32,33,
Pittsburg,Lieutenant Governor,Dana Murphy,REP,610029,0,1,13,14,
Pittsburg,Lieutenant Governor,Matt Pinnell,REP,610029,0,0,25,25,
Pittsburg,State Auditor,Cindy Byrd,REP,610029,0,1,17,18,
Pittsburg,State Auditor,Charlie Prater,REP,610029,0,0,21,21,
Pittsburg,Attorney General,Mike Hunter,REP,610029,0,0,23,23,
Pittsburg,Attorney General,Gentner Drummond,REP,610029,0,1,13,14,
Pittsburg,Superintendent of Public Instruction,Joy Hofmeister,REP,610029,0,0,23,23,
Pittsburg,Superintendent of Public Instruction,Linda Murphy,REP,610029,0,1,13,14,
Pittsburg,Commissioner of Labor,Cathy Costello,REP,610029,0,1,17,18,
Pittsburg,Commissioner of Labor,Leslie Osborn,REP,610029,0,0,21,21,
Pittsburg,Corporation Commissioner,Bob Anthony,REP,610029,0,0,22,22,
Pittsburg,Corporation Commissioner,Brian Bingman,REP,610029,0,1,16,17,
Pittsburg,State House,Josh Hass,REP,610029,0,0,20,20,17
Pittsburg,State House,Jim Grego,REP,610029,0,1,18,19,17
Pittsburg,Governor,Chris Powell,LIB,610029,0,0,0,0,
Pittsburg,Governor,Rex Lawhorn,LIB,610029,0,0,0,0,
Pittsburg,Corporation Commissioner,Ashley Nicole Mccray,DEM,610029,1,2,14,17,
Pittsburg,Corporation Commissioner,Blake Cummings,DEM,610029,0,0,24,24,
Pittsburg,U.S. House,Jason Nichols,DEM,610029,1,2,17,20,02
Pittsburg,U.S. House,Clay Padgett,DEM,610029,0,0,21,21,02
Pittsburg,Governor,Mick Cornett,REP,610030,0,0,15,15,
Pittsburg,Governor,Kevin Stitt,REP,610030,0,0,26,26,
Pittsburg,Lieutenant Governor,Dana Murphy,REP,610030,0,0,11,11,
Pittsburg,Lieutenant Governor,Matt Pinnell,REP,610030,0,0,29,29,
Pittsburg,State Auditor,Cindy Byrd,REP,610030,0,0,9,9,
Pittsburg,State Auditor,Charlie Prater,REP,610030,0,0,32,32,
Pittsburg,Attorney General,Mike Hunter,REP,610030,0,0,15,15,
Pittsburg,Attorney General,Gentner Drummond,REP,610030,0,0,26,26,
Pittsburg,Superintendent of Public Instruction,Joy Hofmeister,REP,610030,0,0,16,16,
Pittsburg,Superintendent of Public Instruction,Linda Murphy,REP,610030,0,0,25,25,
Pittsburg,Commissioner of Labor,Cathy Costello,REP,610030,0,0,18,18,
Pittsburg,Commissioner of Labor,Leslie Osborn,REP,610030,0,0,23,23,
Pittsburg,Corporation Commissioner,Bob Anthony,REP,610030,0,0,16,16,
Pittsburg,Corporation Commissioner,Brian Bingman,REP,610030,0,0,24,24,
Pittsburg,State House,Josh Hass,REP,610030,0,0,19,19,17
Pittsburg,State House,Jim Grego,REP,610030,0,0,22,22,17
Pittsburg,Governor,Chris Powell,LIB,610030,0,0,0,0,
Pittsburg,Governor,Rex Lawhorn,LIB,610030,0,0,0,0,
Pittsburg,Corporation Commissioner,Ashley Nicole Mccray,DEM,610030,0,2,39,41,
Pittsburg,Corporation Commissioner,Blake Cummings,DEM,610030,0,0,35,35,
Pittsburg,U.S. House,Jason Nichols,DEM,610030,0,1,36,37,02
Pittsburg,U.S. House,Clay Padgett,DEM,610030,0,1,37,38,02
Pittsburg,Governor,Mick Cornett,REP,610031,0,0,38,38,
Pittsburg,Governor,Kevin Stitt,REP,610031,2,2,59,63,
Pittsburg,Lieutenant Governor,Dana Murphy,REP,610031,0,0,32,32,
Pittsburg,Lieutenant Governor,Matt Pinnell,REP,610031,2,2,65,69,
Pittsburg,State Auditor,Cindy Byrd,REP,610031,2,1,35,38,
Pittsburg,State Auditor,Charlie Prater,REP,610031,0,1,58,59,
Pittsburg,Attorney General,Mike Hunter,REP,610031,2,1,47,50,
Pittsburg,Attorney General,Gentner Drummond,REP,610031,0,1,47,48,
Pittsburg,Superintendent of Public Instruction,Joy Hofmeister,REP,610031,0,0,47,47,
Pittsburg,Superintendent of Public Instruction,Linda Murphy,REP,610031,2,2,47,51,
Pittsburg,Commissioner of Labor,Cathy Costello,REP,610031,2,1,31,34,
Pittsburg,Commissioner of Labor,Leslie Osborn,REP,610031,0,1,60,61,
Pittsburg,Corporation Commissioner,Bob Anthony,REP,610031,2,0,44,46,
Pittsburg,Corporation Commissioner,Brian Bingman,REP,610031,0,2,50,52,
Pittsburg,State House,Josh Hass,REP,610031,2,1,54,57,17
Pittsburg,State House,Jim Grego,REP,610031,0,1,41,42,17
Pittsburg,Governor,Chris Powell,LIB,610031,0,0,0,0,
Pittsburg,Governor,Rex Lawhorn,LIB,610031,0,0,0,0,
Pittsburg,Corporation Commissioner,Ashley Nicole Mccray,DEM,610031,0,1,23,24,
Pittsburg,Corporation Commissioner,Blake Cummings,DEM,610031,0,1,42,43,
Pittsburg,U.S. House,Jason Nichols,DEM,610031,0,0,36,36,02
Pittsburg,U.S. House,Clay Padgett,DEM,610031,0,2,27,29,02
Pittsburg,Governor,Mick Cornett,REP,610032,1,7,41,49,
Pittsburg,Governor,Kevin Stitt,REP,610032,4,12,99,115,
Pittsburg,Lieutenant Governor,Dana Murphy,REP,610032,1,10,58,69,
Pittsburg,Lieutenant Governor,Matt Pinnell,REP,610032,3,9,79,91,
Pittsburg,State Auditor,Cindy Byrd,REP,610032,2,12,65,79,
Pittsburg,State Auditor,Charlie Prater,REP,610032,2,7,64,73,
Pittsburg,Attorney General,Mike Hunter,REP,610032,3,10,62,75,
Pittsburg,Attorney General,Gentner Drummond,REP,610032,1,9,73,83,
Pittsburg,Superintendent of Public Instruction,Joy Hofmeister,REP,610032,2,9,84,95,
Pittsburg,Superintendent of Public Instruction,Linda Murphy,REP,610032,2,10,51,63,
Pittsburg,Commissioner of Labor,Cathy Costello,REP,610032,4,10,63,77,
Pittsburg,Commissioner of Labor,Leslie Osborn,REP,610032,0,9,67,76,
Pittsburg,Corporation Commissioner,Bob Anthony,REP,610032,4,14,69,87,
Pittsburg,Corporation Commissioner,Brian Bingman,REP,610032,0,5,66,71,
Pittsburg,State House,Josh Hass,REP,610032,3,8,89,100,17
Pittsburg,State House,Jim Grego,REP,610032,1,11,50,62,17
Pittsburg,Governor,Chris Powell,LIB,610032,0,0,0,0,
Pittsburg,Governor,Rex Lawhorn,LIB,610032,0,0,0,0,
Pittsburg,Corporation Commissioner,Ashley Nicole Mccray,DEM,610032,0,8,65,73,
Pittsburg,Corporation Commissioner,Blake Cummings,DEM,610032,1,7,40,48,
Pittsburg,U.S. House,Jason Nichols,DEM,610032,0,7,56,63,02
Pittsburg,U.S. House,Clay Padgett,DEM,610032,1,10,51,62,02
Pittsburg,Governor,Mick Cornett,REP,610033,0,0,9,9,
Pittsburg,Governor,Kevin Stitt,REP,610033,0,3,21,24,
Pittsburg,Lieutenant Governor,Dana Murphy,REP,610033,0,0,8,8,
Pittsburg,Lieutenant Governor,Matt Pinnell,REP,610033,0,3,20,23,
Pittsburg,State Auditor,Cindy Byrd,REP,610033,0,0,11,11,
Pittsburg,State Auditor,Charlie Prater,REP,610033,0,3,17,20,
Pittsburg,Attorney General,Mike Hunter,REP,610033,0,1,14,15,
Pittsburg,Attorney General,Gentner Drummond,REP,610033,0,2,15,17,
Pittsburg,Superintendent of Public Instruction,Joy Hofmeister,REP,610033,0,0,9,9,
Pittsburg,Superintendent of Public Instruction,Linda Murphy,REP,610033,0,3,18,21,
Pittsburg,Commissioner of Labor,Cathy Costello,REP,610033,0,1,8,9,
Pittsburg,Commissioner of Labor,Leslie Osborn,REP,610033,0,2,19,21,
Pittsburg,Corporation Commissioner,Bob Anthony,REP,610033,0,1,7,8,
Pittsburg,Corporation Commissioner,Brian Bingman,REP,610033,0,2,21,23,
Pittsburg,State House,Josh Hass,REP,610033,0,3,15,18,17
Pittsburg,State House,Jim Grego,REP,610033,0,0,15,15,17
Pittsburg,Governor,Chris Powell,LIB,610033,0,0,0,0,
Pittsburg,Governor,Rex Lawhorn,LIB,610033,0,0,0,0,
Pittsburg,Corporation Commissioner,Ashley Nicole Mccray,DEM,610033,1,3,57,61,
Pittsburg,Corporation Commissioner,Blake Cummings,DEM,610033,0,0,66,66,
Pittsburg,U.S. House,Jason Nichols,DEM,610033,1,2,63,66,02
Pittsburg,U.S. House,Clay Padgett,DEM,610033,0,1,61,62,02
Pittsburg,Governor,Mick Cornett,REP,610034,1,1,15,17,
Pittsburg,Governor,Kevin Stitt,REP,610034,0,0,43,43,
Pittsburg,Lieutenant Governor,Dana Murphy,REP,610034,0,1,19,20,
Pittsburg,Lieutenant Governor,Matt Pinnell,REP,610034,1,0,36,37,
Pittsburg,State Auditor,Cindy Byrd,REP,610034,1,1,26,28,
Pittsburg,State Auditor,Charlie Prater,REP,610034,0,0,29,29,
Pittsburg,Attorney General,Mike Hunter,REP,610034,1,0,24,25,
Pittsburg,Attorney General,Gentner Drummond,REP,610034,0,1,32,33,
Pittsburg,Superintendent of Public Instruction,Joy Hofmeister,REP,610034,0,0,30,30,
Pittsburg,Superintendent of Public Instruction,Linda Murphy,REP,610034,1,1,27,29,
Pittsburg,Commissioner of Labor,Cathy Costello,REP,610034,1,0,25,26,
Pittsburg,Commissioner of Labor,Leslie Osborn,REP,610034,0,1,30,31,
Pittsburg,Corporation Commissioner,Bob Anthony,REP,610034,0,1,17,18,
Pittsburg,Corporation Commissioner,Brian Bingman,REP,610034,1,0,37,38,
Pittsburg,State House,Josh Hass,REP,610034,1,0,37,38,17
Pittsburg,State House,Jim Grego,REP,610034,0,1,21,22,17
Pittsburg,Governor,Chris Powell,LIB,610034,0,0,0,0,
Pittsburg,Governor,Rex Lawhorn,LIB,610034,0,0,0,0,
Pittsburg,Corporation Commissioner,Ashley Nicole Mccray,DEM,610034,1,6,123,130,
Pittsburg,Corporation Commissioner,Blake Cummings,DEM,610034,0,2,107,109,
Pittsburg,U.S. House,Jason Nichols,DEM,610034,1,5,130,136,02
Pittsburg,U.S. House,Clay Padgett,DEM,610034,0,3,102,105,02
Pittsburg,Governor,Mick Cornett,REP,610035,0,0,18,18,
Pittsburg,Governor,Kevin Stitt,REP,610035,0,1,24,25,
Pittsburg,Lieutenant Governor,Dana Murphy,REP,610035,0,0,21,21,
Pittsburg,Lieutenant Governor,Matt Pinnell,REP,610035,0,1,20,21,
Pittsburg,State Auditor,Cindy Byrd,REP,610035,0,1,11,12,
Pittsburg,State Auditor,Charlie Prater,REP,610035,0,0,29,29,
Pittsburg,Attorney General,Mike Hunter,REP,610035,0,0,19,19,
Pittsburg,Attorney General,Gentner Drummond,REP,610035,0,1,22,23,
Pittsburg,Superintendent of Public Instruction,Joy Hofmeister,REP,610035,0,0,11,11,
Pittsburg,Superintendent of Public Instruction,Linda Murphy,REP,610035,0,1,29,30,
Pittsburg,Commissioner of Labor,Cathy Costello,REP,610035,0,1,16,17,
Pittsburg,Commissioner of Labor,Leslie Osborn,REP,610035,0,0,25,25,
Pittsburg,Corporation Commissioner,Bob Anthony,REP,610035,0,1,14,15,
Pittsburg,Corporation Commissioner,Brian Bingman,REP,610035,0,0,26,26,
Pittsburg,State House,Josh Hass,REP,610035,0,0,21,21,17
Pittsburg,State House,Jim Grego,REP,610035,0,1,21,22,17
Pittsburg,Governor,Chris Powell,LIB,610035,0,0,0,0,
Pittsburg,Governor,Rex Lawhorn,LIB,610035,0,0,0,0,
Pittsburg,Corporation Commissioner,Ashley Nicole Mccray,DEM,610035,4,0,77,81,
Pittsburg,Corporation Commissioner,Blake Cummings,DEM,610035,3,1,56,60,
Pittsburg,U.S. House,Jason Nichols,DEM,610035,4,1,68,73,02
Pittsburg,U.S. House,Clay Padgett,DEM,610035,3,0,66,69,02
Pittsburg,Governor,Mick Cornett,REP,610036,0,0,4,4,
Pittsburg,Governor,Kevin Stitt,REP,610036,0,0,18,18,
Pittsburg,Lieutenant Governor,Dana Murphy,REP,610036,0,0,5,5,
Pittsburg,Lieutenant Governor,Matt Pinnell,REP,610036,0,0,17,17,
Pittsburg,State Auditor,Cindy Byrd,REP,610036,0,0,8,8,
Pittsburg,State Auditor,Charlie Prater,REP,610036,0,0,14,14,
Pittsburg,Attorney General,Mike Hunter,REP,610036,0,0,10,10,
Pittsburg,Attorney General,Gentner Drummond,REP,610036,0,0,12,12,
Pittsburg,Superintendent of Public Instruction,Joy Hofmeister,REP,610036,0,0,8,8,
Pittsburg,Superintendent of Public Instruction,Linda Murphy,REP,610036,0,0,14,14,
Pittsburg,Commissioner of Labor,Cathy Costello,REP,610036,0,0,5,5,
Pittsburg,Commissioner of Labor,Leslie Osborn,REP,610036,0,0,15,15,
Pittsburg,Corporation Commissioner,Bob Anthony,REP,610036,0,0,9,9,
Pittsburg,Corporation Commissioner,Brian Bingman,REP,610036,0,0,12,12,
Pittsburg,Governor,Chris Powell,LIB,610036,0,0,0,0,
Pittsburg,Governor,Rex Lawhorn,LIB,610036,0,0,0,0,
Pittsburg,Corporation Commissioner,Ashley Nicole Mccray,DEM,610036,1,2,8,11,
Pittsburg,Corporation Commissioner,Blake Cummings,DEM,610036,0,1,13,14,
Pittsburg,U.S. House,Jason Nichols,DEM,610036,1,0,11,12,02
Pittsburg,U.S. House,Clay Padgett,DEM,610036,0,3,10,13,02
Pittsburg,Governor,Mick Cornett,REP,610037,0,0,9,9,
Pittsburg,Governor,Kevin Stitt,REP,610037,0,4,37,41,
Pittsburg,Lieutenant Governor,Dana Murphy,REP,610037,0,0,21,21,
Pittsburg,Lieutenant Governor,Matt Pinnell,REP,610037,0,4,24,28,
Pittsburg,State Auditor,Cindy Byrd,REP,610037,0,4,25,29,
Pittsburg,State Auditor,Charlie Prater,REP,610037,0,0,21,21,
Pittsburg,Attorney General,Mike Hunter,REP,610037,0,0,16,16,
Pittsburg,Attorney General,Gentner Drummond,REP,610037,0,4,29,33,
Pittsburg,Superintendent of Public Instruction,Joy Hofmeister,REP,610037,0,4,19,23,
Pittsburg,Superintendent of Public Instruction,Linda Murphy,REP,610037,0,0,26,26,
Pittsburg,Commissioner of Labor,Cathy Costello,REP,610037,0,4,14,18,
Pittsburg,Commissioner of Labor,Leslie Osborn,REP,610037,0,0,31,31,
Pittsburg,Corporation Commissioner,Bob Anthony,REP,610037,0,0,28,28,
Pittsburg,Corporation Commissioner,Brian Bingman,REP,610037,0,4,17,21,
Pittsburg,Governor,Chris Powell,LIB,610037,0,0,0,0,
Pittsburg,Governor,Rex Lawhorn,LIB,610037,0,0,0,0,
Pittsburg,Corporation Commissioner,Ashley Nicole Mccray,DEM,610037,0,1,31,32,
Pittsburg,Corporation Commissioner,Blake Cummings,DEM,610037,1,2,60,63,
Pittsburg,U.S. House,Jason Nichols,DEM,610037,1,1,48,50,02
Pittsburg,U.S. House,Clay Padgett,DEM,610037,0,2,43,45,02
Pittsburg,Governor,Mick Cornett,REP,610038,0,0,0,0,
Pittsburg,Governor,Kevin Stitt,REP,610038,0,0,9,9,
Pittsburg,Lieutenant Governor,Dana Murphy,REP,610038,0,0,3,3,
Pittsburg,Lieutenant Governor,Matt Pinnell,REP,610038,0,0,6,6,
Pittsburg,State Auditor,Cindy Byrd,REP,610038,0,0,2,2,
Pittsburg,State Auditor,Charlie Prater,REP,610038,0,0,7,7,
Pittsburg,Attorney General,Mike Hunter,REP,610038,0,0,3,3,
Pittsburg,Attorney General,Gentner Drummond,REP,610038,0,0,6,6,
Pittsburg,Superintendent of Public Instruction,Joy Hofmeister,REP,610038,0,0,6,6,
Pittsburg,Superintendent of Public Instruction,Linda Murphy,REP,610038,0,0,3,3,
Pittsburg,Commissioner of Labor,Cathy Costello,REP,610038,0,0,2,2,
Pittsburg,Commissioner of Labor,Leslie Osborn,REP,610038,0,0,6,6,
Pittsburg,Corporation Commissioner,Bob Anthony,REP,610038,0,0,1,1,
Pittsburg,Corporation Commissioner,Brian Bingman,REP,610038,0,0,7,7,
Pittsburg,State House,Josh Hass,REP,610038,0,0,3,3,17
Pittsburg,State House,Jim Grego,REP,610038,0,0,6,6,17
Pittsburg,Governor,Chris Powell,LIB,610038,0,0,0,0,
Pittsburg,Governor,Rex Lawhorn,LIB,610038,0,0,0,0,
Pittsburg,Corporation Commissioner,Ashley Nicole Mccray,DEM,610038,0,0,1,1,
Pittsburg,Corporation Commissioner,Blake Cummings,DEM,610038,0,0,1,1,
Pittsburg,U.S. House,Jason Nichols,DEM,610038,0,0,1,1,02
Pittsburg,U.S. House,Clay Padgett,DEM,610038,0,0,1,1,02
Pittsburg,Governor,Mick Cornett,REP,610039,0,0,14,14,
Pittsburg,Governor,Kevin Stitt,REP,610039,1,2,24,27,
Pittsburg,Lieutenant Governor,Dana Murphy,REP,610039,1,0,15,16,
Pittsburg,Lieutenant Governor,Matt Pinnell,REP,610039,0,2,23,25,
Pittsburg,State Auditor,Cindy Byrd,REP,610039,0,0,15,15,
Pittsburg,State Auditor,Charlie Prater,REP,610039,1,2,22,25,
Pittsburg,Attorney General,Mike Hunter,REP,610039,1,0,18,19,
Pittsburg,Attorney General,Gentner Drummond,REP,610039,0,2,18,20,
Pittsburg,Superintendent of Public Instruction,Joy Hofmeister,REP,610039,1,2,22,25,
Pittsburg,Superintendent of Public Instruction,Linda Murphy,REP,610039,0,0,15,15,
Pittsburg,Commissioner of Labor,Cathy Costello,REP,610039,0,0,19,19,
Pittsburg,Commissioner of Labor,Leslie Osborn,REP,610039,1,2,17,20,
Pittsburg,Corporation Commissioner,Bob Anthony,REP,610039,0,1,13,14,
Pittsburg,Corporation Commissioner,Brian Bingman,REP,610039,1,1,23,25,
Pittsburg,Governor,Chris Powell,LIB,610039,0,0,0,0,
Pittsburg,Governor,Rex Lawhorn,LIB,610039,0,0,0,0,
Pittsburg,Corporation Commissioner,Ashley Nicole Mccray,DEM,610039,0,0,30,30,
Pittsburg,Corporation Commissioner,Blake Cummings,DEM,610039,0,0,26,26,
Pittsburg,U.S. House,Jason Nichols,DEM,610039,0,0,30,30,02
Pittsburg,U.S. House,Clay Padgett,DEM,610039,0,0,27,27,02
Pittsburg,Governor,Mick Cornett,REP,610040,0,2,5,7,
Pittsburg,Governor,Kevin Stitt,REP,610040,0,1,34,35,
Pittsburg,Lieutenant Governor,Dana Murphy,REP,610040,0,2,15,17,
Pittsburg,Lieutenant Governor,Matt Pinnell,REP,610040,0,1,23,24,
Pittsburg,State Auditor,Cindy Byrd,REP,610040,0,1,18,19,
Pittsburg,State Auditor,Charlie Prater,REP,610040,0,2,20,22,
Pittsburg,Attorney General,Mike Hunter,REP,610040,0,1,14,15,
Pittsburg,Attorney General,Gentner Drummond,REP,610040,0,2,24,26,
Pittsburg,Superintendent of Public Instruction,Joy Hofmeister,REP,610040,0,2,14,16,
Pittsburg,Superintendent of Public Instruction,Linda Murphy,REP,610040,0,1,25,26,
Pittsburg,Commissioner of Labor,Cathy Costello,REP,610040,0,2,12,14,
Pittsburg,Commissioner of Labor,Leslie Osborn,REP,610040,0,1,27,28,
Pittsburg,Corporation Commissioner,Bob Anthony,REP,610040,0,1,11,12,
Pittsburg,Corporation Commissioner,Brian Bingman,REP,610040,0,2,27,29,
Pittsburg,State House,Josh Hass,REP,610040,0,0,24,24,17
Pittsburg,State House,Jim Grego,REP,610040,0,3,15,18,17
Pittsburg,Governor,Chris Powell,LIB,610040,0,0,0,0,
Pittsburg,Governor,Rex Lawhorn,LIB,610040,0,0,0,0,
Pittsburg,Corporation Commissioner,Ashley Nicole Mccray,DEM,610040,1,0,17,18,
Pittsburg,Corporation Commissioner,Blake Cummings,DEM,610040,0,0,26,26,
Pittsburg,U.S. House,Jason Nichols,DEM,610040,1,0,28,29,02
Pittsburg,U.S. House,Clay Padgett,DEM,610040,0,0,15,15,02
Pittsburg,Governor,Mick Cornett,REP,610041,0,2,22,24,
Pittsburg,Governor,Kevin Stitt,REP,610041,0,1,39,40,
Pittsburg,Lieutenant Governor,Dana Murphy,REP,610041,0,1,18,19,
Pittsburg,Lieutenant Governor,Matt Pinnell,REP,610041,0,2,41,43,
Pittsburg,State Auditor,Cindy Byrd,REP,610041,0,3,29,32,
Pittsburg,State Auditor,Charlie Prater,REP,610041,0,0,30,30,
Pittsburg,Attorney General,Mike Hunter,REP,610041,0,3,25,28,
Pittsburg,Attorney General,Gentner Drummond,REP,610041,0,0,34,34,
Pittsburg,Superintendent of Public Instruction,Joy Hofmeister,REP,610041,0,2,22,24,
Pittsburg,Superintendent of Public Instruction,Linda Murphy,REP,610041,0,1,37,38,
Pittsburg,Commissioner of Labor,Cathy Costello,REP,610041,0,2,22,24,
Pittsburg,Commissioner of Labor,Leslie Osborn,REP,610041,0,1,37,38,
Pittsburg,Corporation Commissioner,Bob Anthony,REP,610041,0,1,33,34,
Pittsburg,Corporation Commissioner,Brian Bingman,REP,610041,0,2,26,28,
Pittsburg,State House,Josh Hass,REP,610041,0,2,31,33,17
Pittsburg,State House,Jim Grego,REP,610041,0,1,30,31,17
Pittsburg,Governor,Chris Powell,LIB,610041,0,0,0,0,
Pittsburg,Governor,Rex Lawhorn,LIB,610041,0,0,0,0,
Pittsburg,Corporation Commissioner,Ashley Nicole Mccray,DEM,610041,0,5,67,72,
Pittsburg,Corporation Commissioner,Blake Cummings,DEM,610041,0,3,62,65,
Pittsburg,U.S. House,Jason Nichols,DEM,610041,0,2,60,62,02
Pittsburg,U.S. House,Clay Padgett,DEM,610041,0,6,69,75,02
Pittsburg,Governor,Mick Cornett,REP,610042,1,0,22,23,
Pittsburg,Governor,Kevin Stitt,REP,610042,1,4,32,37,
Pittsburg,Lieutenant Governor,Dana Murphy,REP,610042,0,1,24,25,
Pittsburg,Lieutenant Governor,Matt Pinnell,REP,610042,2,3,30,35,
Pittsburg,State Auditor,Cindy Byrd,REP,610042,2,2,18,22,
Pittsburg,State Auditor,Charlie Prater,REP,610042,0,0,34,34,
Pittsburg,Attorney General,Mike Hunter,REP,610042,0,2,16,18,
Pittsburg,Attorney General,Gentner Drummond,REP,610042,2,3,38,43,
Pittsburg,Superintendent of Public Instruction,Joy Hofmeister,REP,610042,0,0,28,28,
Pittsburg,Superintendent of Public Instruction,Linda Murphy,REP,610042,2,3,26,31,
Pittsburg,Commissioner of Labor,Cathy Costello,REP,610042,2,2,15,19,
Pittsburg,Commissioner of Labor,Leslie Osborn,REP,610042,0,0,39,39,
Pittsburg,Corporation Commissioner,Bob Anthony,REP,610042,0,2,28,30,
Pittsburg,Corporation Commissioner,Brian Bingman,REP,610042,2,0,26,28,
Pittsburg,State House,Josh Hass,REP,610042,0,3,34,37,17
Pittsburg,State House,Jim Grego,REP,610042,2,2,21,25,17
Pittsburg,Governor,Chris Powell,LIB,610042,0,0,0,0,
Pittsburg,Governor,Rex Lawhorn,LIB,610042,0,0,0,0,
Pittsburg,Corporation Commissioner,Ashley Nicole Mccray,DEM,610042,1,4,33,38,
Pittsburg,Corporation Commissioner,Blake Cummings,DEM,610042,0,3,32,35,
Pittsburg,U.S. House,Jason Nichols,DEM,610042,0,4,34,38,02
Pittsburg,U.S. House,Clay Padgett,DEM,610042,1,3,31,35,02
Pittsburg,Governor,Mick Cornett,REP,610043,0,0,6,6,
Pittsburg,Governor,Kevin Stitt,REP,610043,0,2,13,15,
Pittsburg,Lieutenant Governor,Dana Murphy,REP,610043,0,1,4,5,
Pittsburg,Lieutenant Governor,Matt Pinnell,REP,610043,0,1,14,15,
Pittsburg,State Auditor,Cindy Byrd,REP,610043,0,1,4,5,
Pittsburg,State Auditor,Charlie Prater,REP,610043,0,1,15,16,
Pittsburg,Attorney General,Mike Hunter,REP,610043,0,2,7,9,
Pittsburg,Attorney General,Gentner Drummond,REP,610043,0,0,12,12,
Pittsburg,Superintendent of Public Instruction,Joy Hofmeister,REP,610043,0,1,5,6,
Pittsburg,Superintendent of Public Instruction,Linda Murphy,REP,610043,0,1,14,15,
Pittsburg,Commissioner of Labor,Cathy Costello,REP,610043,0,1,4,5,
Pittsburg,Commissioner of Labor,Leslie Osborn,REP,610043,0,1,14,15,
Pittsburg,Corporation Commissioner,Bob Anthony,REP,610043,0,1,4,5,
Pittsburg,Corporation Commissioner,Brian Bingman,REP,610043,0,1,14,15,
Pittsburg,State House,Josh Hass,REP,610043,0,2,9,11,17
Pittsburg,State House,Jim Grego,REP,610043,0,0,10,10,17
Pittsburg,Governor,Chris Powell,LIB,610043,0,0,0,0,
Pittsburg,Governor,Rex Lawhorn,LIB,610043,0,0,0,0,
Pittsburg,Corporation Commissioner,Ashley Nicole Mccray,DEM,610043,0,2,13,15,
Pittsburg,Corporation Commissioner,Blake Cummings,DEM,610043,0,1,24,25,
Pittsburg,U.S. House,Jason Nichols,DEM,610043,0,0,20,20,02
Pittsburg,U.S. House,Clay Padgett,DEM,610043,0,3,18,21,02
Pittsburg,Governor,Mick Cornett,REP,610044,1,0,10,11,
Pittsburg,Governor,Kevin Stitt,REP,610044,0,0,38,38,
Pittsburg,Lieutenant Governor,Dana Murphy,REP,610044,1,0,24,25,
Pittsburg,Lieutenant Governor,Matt Pinnell,REP,610044,0,0,23,23,
Pittsburg,State Auditor,Cindy Byrd,REP,610044,0,0,20,20,
Pittsburg,State Auditor,Charlie Prater,REP,610044,1,0,25,26,
Pittsburg,Attorney General,Mike Hunter,REP,610044,1,0,22,23,
Pittsburg,Attorney General,Gentner Drummond,REP,610044,0,0,24,24,
Pittsburg,Superintendent of Public Instruction,Joy Hofmeister,REP,610044,0,0,26,26,
Pittsburg,Superintendent of Public Instruction,Linda Murphy,REP,610044,1,0,21,22,
Pittsburg,Commissioner of Labor,Cathy Costello,REP,610044,0,0,15,15,
Pittsburg,Commissioner of Labor,Leslie Osborn,REP,610044,1,0,31,32,
Pittsburg,Corporation Commissioner,Bob Anthony,REP,610044,0,0,17,17,
Pittsburg,Corporation Commissioner,Brian Bingman,REP,610044,1,0,29,30,
Pittsburg,State House,Josh Hass,REP,610044,1,0,15,16,17
Pittsburg,State House,Jim Grego,REP,610044,0,0,29,29,17
Pittsburg,Governor,Chris Powell,LIB,610044,0,0,0,0,
Pittsburg,Governor,Rex Lawhorn,LIB,610044,0,0,0,0,
Pittsburg,Corporation Commissioner,Ashley Nicole Mccray,DEM,610044,3,1,34,38,
Pittsburg,Corporation Commissioner,Blake Cummings,DEM,610044,0,0,64,64,
Pittsburg,U.S. House,Jason Nichols,DEM,610044,1,0,43,44,02
Pittsburg,U.S. House,Clay Padgett,DEM,610044,2,1,54,57,02
Pittsburg,Governor,Mick Cornett,REP,610045,0,0,0,0,
Pittsburg,Governor,Kevin Stitt,REP,610045,0,0,0,0,
Pittsburg,Lieutenant Governor,Dana Murphy,REP,610045,0,0,0,0,
Pittsburg,Lieutenant Governor,Matt Pinnell,REP,610045,0,0,0,0,
Pittsburg,State Auditor,Cindy Byrd,REP,610045,0,0,0,0,
Pittsburg,State Auditor,Charlie Prater,REP,610045,0,0,0,0,
Pittsburg,Attorney General,Mike Hunter,REP,610045,0,0,0,0,
Pittsburg,Attorney General,Gentner Drummond,REP,610045,0,0,0,0,
Pittsburg,Superintendent of Public Instruction,Joy Hofmeister,REP,610045,0,0,0,0,
Pittsburg,Superintendent of Public Instruction,Linda Murphy,REP,610045,0,0,0,0,
Pittsburg,Commissioner of Labor,Cathy Costello,REP,610045,0,0,0,0,
Pittsburg,Commissioner of Labor,Leslie Osborn,REP,610045,0,0,0,0,
Pittsburg,Corporation Commissioner,Bob Anthony,REP,610045,0,0,0,0,
Pittsburg,Corporation Commissioner,Brian Bingman,REP,610045,0,0,0,0,
Pittsburg,State House,Josh Hass,REP,610045,0,0,0,0,17
Pittsburg,State House,Jim Grego,REP,610045,0,0,0,0,17
Pittsburg,Governor,Chris Powell,LIB,610045,0,0,0,0,
Pittsburg,Governor,Rex Lawhorn,LIB,610045,0,0,0,0,
Pittsburg,Corporation Commissioner,Ashley Nicole Mccray,DEM,610045,0,0,1,1,
Pittsburg,Corporation Commissioner,Blake Cummings,DEM,610045,0,0,3,3,
Pittsburg,U.S. House,Jason Nichols,DEM,610045,0,0,4,4,02
Pittsburg,U.S. House,Clay Padgett,DEM,610045,0,0,0,0,02
Pittsburg,Governor,Mick Cornett,REP,610046,0,2,4,6,
Pittsburg,Governor,Kevin Stitt,REP,610046,0,0,16,16,
Pittsburg,Lieutenant Governor,Dana Murphy,REP,610046,0,0,12,12,
Pittsburg,Lieutenant Governor,Matt Pinnell,REP,610046,0,2,8,10,
Pittsburg,State Auditor,Cindy Byrd,REP,610046,0,2,7,9,
Pittsburg,State Auditor,Charlie Prater,REP,610046,0,0,12,12,
Pittsburg,Attorney General,Mike Hunter,REP,610046,0,2,8,10,
Pittsburg,Attorney General,Gentner Drummond,REP,610046,0,0,11,11,
Pittsburg,Superintendent of Public Instruction,Joy Hofmeister,REP,610046,0,2,12,14,
Pittsburg,Superintendent of Public Instruction,Linda Murphy,REP,610046,0,0,7,7,
Pittsburg,Commissioner of Labor,Cathy Costello,REP,610046,0,2,6,8,
Pittsburg,Commissioner of Labor,Leslie Osborn,REP,610046,0,0,13,13,
Pittsburg,Corporation Commissioner,Bob Anthony,REP,610046,0,0,4,4,
Pittsburg,Corporation Commissioner,Brian Bingman,REP,610046,0,2,15,17,
Pittsburg,Governor,Chris Powell,LIB,610046,0,0,0,0,
Pittsburg,Governor,Rex Lawhorn,LIB,610046,0,0,0,0,
Pittsburg,Corporation Commissioner,Ashley Nicole Mccray,DEM,610046,0,0,9,9,
Pittsburg,Corporation Commissioner,Blake Cummings,DEM,610046,0,0,13,13,
Pittsburg,U.S. House,Jason Nichols,DEM,610046,0,0,9,9,02
Pittsburg,U.S. House,Clay Padgett,DEM,610046,0,0,13,13,02
Pittsburg,Governor,Mick Cornett,REP,610047,0,0,7,7,
Pittsburg,Governor,Kevin Stitt,REP,610047,0,0,13,13,
Pittsburg,Lieutenant Governor,Dana Murphy,REP,610047,0,0,6,6,
Pittsburg,Lieutenant Governor,Matt Pinnell,REP,610047,0,0,13,13,
Pittsburg,State Auditor,Cindy Byrd,REP,610047,0,0,7,7,
Pittsburg,State Auditor,Charlie Prater,REP,610047,0,0,11,11,
Pittsburg,Attorney General,Mike Hunter,REP,610047,0,0,8,8,
Pittsburg,Attorney General,Gentner Drummond,REP,610047,0,0,12,12,
Pittsburg,Superintendent of Public Instruction,Joy Hofmeister,REP,610047,0,0,6,6,
Pittsburg,Superintendent of Public Instruction,Linda Murphy,REP,610047,0,0,13,13,
Pittsburg,Commissioner of Labor,Cathy Costello,REP,610047,0,0,8,8,
Pittsburg,Commissioner of Labor,Leslie Osborn,REP,610047,0,0,10,10,
Pittsburg,Corporation Commissioner,Bob Anthony,REP,610047,0,0,10,10,
Pittsburg,Corporation Commissioner,Brian Bingman,REP,610047,0,0,9,9,
Pittsburg,State House,Josh Hass,REP,610047,0,0,16,16,17
Pittsburg,State House,Jim Grego,REP,610047,0,0,4,4,17
Pittsburg,Governor,Chris Powell,LIB,610047,0,0,2,2,
Pittsburg,Governor,Rex Lawhorn,LIB,610047,0,0,0,0,
Pittsburg,Corporation Commissioner,Ashley Nicole Mccray,DEM,610047,1,1,43,45,
Pittsburg,Corporation Commissioner,Blake Cummings,DEM,610047,3,0,27,30,
Pittsburg,U.S. House,Jason Nichols,DEM,610047,0,0,34,34,02
Pittsburg,U.S. House,Clay Padgett,DEM,610047,4,1,36,41,02
Pittsburg,Governor,Mick Cornett,REP,610048,0,0,1,1,
Pittsburg,Governor,Kevin Stitt,REP,610048,0,0,6,6,
Pittsburg,Lieutenant Governor,Dana Murphy,REP,610048,0,0,3,3,
Pittsburg,Lieutenant Governor,Matt Pinnell,REP,610048,0,0,5,5,
Pittsburg,State Auditor,Cindy Byrd,REP,610048,0,0,3,3,
Pittsburg,State Auditor,Charlie Prater,REP,610048,0,0,3,3,
Pittsburg,Attorney General,Mike Hunter,REP,610048,0,0,1,1,
Pittsburg,Attorney General,Gentner Drummond,REP,610048,0,0,6,6,
Pittsburg,Superintendent of Public Instruction,Joy Hofmeister,REP,610048,0,0,3,3,
Pittsburg,Superintendent of Public Instruction,Linda Murphy,REP,610048,0,0,5,5,
Pittsburg,Commissioner of Labor,Cathy Costello,REP,610048,0,0,4,4,
Pittsburg,Commissioner of Labor,Leslie Osborn,REP,610048,0,0,3,3,
Pittsburg,Corporation Commissioner,Bob Anthony,REP,610048,0,0,4,4,
Pittsburg,Corporation Commissioner,Brian Bingman,REP,610048,0,0,4,4,
Pittsburg,Governor,Chris Powell,LIB,610048,0,0,0,0,
Pittsburg,Governor,Rex Lawhorn,LIB,610048,0,0,0,0,
Pittsburg,Corporation Commissioner,Ashley Nicole Mccray,DEM,610048,0,0,10,10,
Pittsburg,Corporation Commissioner,Blake Cummings,DEM,610048,1,0,17,18,
Pittsburg,U.S. House,Jason Nichols,DEM,610048,1,0,9,10,02
Pittsburg,U.S. House,Clay Padgett,DEM,610048,0,0,18,18,02
Pittsburg,Governor,Mick Cornett,REP,610049,0,1,20,21,
Pittsburg,Governor,Kevin Stitt,REP,610049,0,1,29,30,
Pittsburg,Lieutenant Governor,Dana Murphy,REP,610049,0,1,22,23,
Pittsburg,Lieutenant Governor,Matt Pinnell,REP,610049,0,1,27,28,
Pittsburg,State Auditor,Cindy Byrd,REP,610049,0,1,26,27,
Pittsburg,State Auditor,Charlie Prater,REP,610049,0,1,23,24,
Pittsburg,Attorney General,Mike Hunter,REP,610049,0,2,22,24,
Pittsburg,Attorney General,Gentner Drummond,REP,610049,0,0,27,27,
Pittsburg,Superintendent of Public Instruction,Joy Hofmeister,REP,610049,0,2,25,27,
Pittsburg,Superintendent of Public Instruction,Linda Murphy,REP,610049,0,0,23,23,
Pittsburg,Commissioner of Labor,Cathy Costello,REP,610049,0,0,22,22,
Pittsburg,Commissioner of Labor,Leslie Osborn,REP,610049,0,2,27,29,
Pittsburg,Corporation Commissioner,Bob Anthony,REP,610049,0,2,22,24,
Pittsburg,Corporation Commissioner,Brian Bingman,REP,610049,0,0,26,26,
Pittsburg,Governor,Chris Powell,LIB,610049,0,0,0,0,
Pittsburg,Governor,Rex Lawhorn,LIB,610049,0,0,1,1,
Pittsburg,Corporation Commissioner,Ashley Nicole Mccray,DEM,610049,1,2,31,34,
Pittsburg,Corporation Commissioner,Blake Cummings,DEM,610049,1,3,23,27,
Pittsburg,U.S. House,Jason Nichols,DEM,610049,1,1,22,24,02
Pittsburg,U.S. House,Clay Padgett,DEM,610049,1,4,33,38,02
Pittsburg,Governor,Mick Cornett,REP,610051,0,0,18,18,
Pittsburg,Governor,Kevin Stitt,REP,610051,0,3,11,14,
Pittsburg,Lieutenant Governor,Dana Murphy,REP,610051,0,2,10,12,
Pittsburg,Lieutenant Governor,Matt Pinnell,REP,610051,0,1,17,18,
Pittsburg,State Auditor,Cindy Byrd,REP,610051,0,3,14,17,
Pittsburg,State Auditor,Charlie Prater,REP,610051,0,0,12,12,
Pittsburg,Attorney General,Mike Hunter,REP,610051,0,3,17,20,
Pittsburg,Attorney General,Gentner Drummond,REP,610051,0,0,12,12,
Pittsburg,Superintendent of Public Instruction,Joy Hofmeister,REP,610051,0,1,16,17,
Pittsburg,Superintendent of Public Instruction,Linda Murphy,REP,610051,0,2,13,15,
Pittsburg,Commissioner of Labor,Cathy Costello,REP,610051,0,2,8,10,
Pittsburg,Commissioner of Labor,Leslie Osborn,REP,610051,0,1,17,18,
Pittsburg,Corporation Commissioner,Bob Anthony,REP,610051,0,2,13,15,
Pittsburg,Corporation Commissioner,Brian Bingman,REP,610051,0,1,13,14,
Pittsburg,State House,Josh Hass,REP,610051,0,3,19,22,17
Pittsburg,State House,Jim Grego,REP,610051,0,0,10,10,17
Pittsburg,Governor,Chris Powell,LIB,610051,0,0,0,0,
Pittsburg,Governor,Rex Lawhorn,LIB,610051,0,0,0,0,
Pittsburg,Corporation Commissioner,Ashley Nicole Mccray,DEM,610051,1,0,21,22,
Pittsburg,Corporation Commissioner,Blake Cummings,DEM,610051,3,1,29,33,
Pittsburg,U.S. House,Jason Nichols,DEM,610051,2,1,29,32,02
Pittsburg,U.S. House,Clay Padgett,DEM,610051,2,0,21,23,02
Pittsburg,Governor,Mick Cornett,REP,610052,0,0,2,2,
Pittsburg,Governor,Kevin Stitt,REP,610052,0,0,4,4,
Pittsburg,Lieutenant Governor,Dana Murphy,REP,610052,0,0,3,3,
Pittsburg,Lieutenant Governor,Matt Pinnell,REP,610052,0,0,3,3,
Pittsburg,State Auditor,Cindy Byrd,REP,610052,0,0,6,6,
Pittsburg,State Auditor,Charlie Prater,REP,610052,0,0,0,0,
Pittsburg,Attorney General,Mike Hunter,REP,610052,0,0,0,0,
Pittsburg,Attorney General,Gentner Drummond,REP,610052,0,0,6,6,
Pittsburg,Superintendent of Public Instruction,Joy Hofmeister,REP,610052,0,0,3,3,
Pittsburg,Superintendent of Public Instruction,Linda Murphy,REP,610052,0,0,3,3,
Pittsburg,Commissioner of Labor,Cathy Costello,REP,610052,0,0,1,1,
Pittsburg,Commissioner of Labor,Leslie Osborn,REP,610052,0,0,5,5,
Pittsburg,Corporation Commissioner,Bob Anthony,REP,610052,0,0,0,0,
Pittsburg,Corporation Commissioner,Brian Bingman,REP,610052,0,0,6,6,
Pittsburg,Governor,Chris Powell,LIB,610052,0,0,0,0,
Pittsburg,Governor,Rex Lawhorn,LIB,610052,0,0,0,0,
Pittsburg,Corporation Commissioner,Ashley Nicole Mccray,DEM,610052,0,0,1,1,
Pittsburg,Corporation Commissioner,Blake Cummings,DEM,610052,0,0,1,1,
Pittsburg,U.S. House,Jason Nichols,DEM,610052,0,0,1,1,02
Pittsburg,U.S. House,Clay Padgett,DEM,610052,0,0,1,1,02
Pittsburg,Governor,Mick Cornett,REP,610053,0,0,1,1,
Pittsburg,Governor,Kevin Stitt,REP,610053,0,0,2,2,
Pittsburg,Lieutenant Governor,Dana Murphy,REP,610053,0,0,1,1,
Pittsburg,Lieutenant Governor,Matt Pinnell,REP,610053,0,0,2,2,
Pittsburg,State Auditor,Cindy Byrd,REP,610053,0,0,0,0,
Pittsburg,State Auditor,Charlie Prater,REP,610053,0,0,3,3,
Pittsburg,Attorney General,Mike Hunter,REP,610053,0,0,3,3,
Pittsburg,Attorney General,Gentner Drummond,REP,610053,0,0,0,0,
Pittsburg,Superintendent of Public Instruction,Joy Hofmeister,REP,610053,0,0,2,2,
Pittsburg,Superintendent of Public Instruction,Linda Murphy,REP,610053,0,0,1,1,
Pittsburg,Commissioner of Labor,Cathy Costello,REP,610053,0,0,1,1,
Pittsburg,Commissioner of Labor,Leslie Osborn,REP,610053,0,0,2,2,
Pittsburg,Corporation Commissioner,Bob Anthony,REP,610053,0,0,2,2,
Pittsburg,Corporation Commissioner,Brian Bingman,REP,610053,0,0,1,1,
Pittsburg,Governor,Chris Powell,LIB,610053,0,0,0,0,
Pittsburg,Governor,Rex Lawhorn,LIB,610053,0,0,0,0,
Pittsburg,Corporation Commissioner,Ashley Nicole Mccray,DEM,610053,0,0,4,4,
Pittsburg,Corporation Commissioner,Blake Cummings,DEM,610053,0,0,6,6,
Pittsburg,U.S. House,Jason Nichols,DEM,610053,0,0,4,4,02
Pittsburg,U.S. House,Clay Padgett,DEM,610053,0,0,6,6,02
Pontotoc,Governor,Mick Cornett,REP,620013,4,15,66,85,
Pontotoc,Governor,Kevin Stitt,REP,620013,0,3,69,72,
Pontotoc,Lieutenant Governor,Dana Murphy,REP,620013,0,8,61,69,
Pontotoc,Lieutenant Governor,Matt Pinnell,REP,620013,4,10,71,85,
Pontotoc,State Auditor,Cindy Byrd,REP,620013,3,12,91,106,
Pontotoc,State Auditor,Charlie Prater,REP,620013,0,6,41,47,
Pontotoc,Attorney General,Mike Hunter,REP,620013,3,9,76,88,
Pontotoc,Attorney General,Gentner Drummond,REP,620013,1,9,55,65,
Pontotoc,Superintendent of Public Instruction,Joy Hofmeister,REP,620013,3,13,84,100,
Pontotoc,Superintendent of Public Instruction,Linda Murphy,REP,620013,1,5,46,52,
Pontotoc,Commissioner of Labor,Cathy Costello,REP,620013,0,9,53,62,
Pontotoc,Commissioner of Labor,Leslie Osborn,REP,620013,4,9,73,86,
Pontotoc,Corporation Commissioner,Bob Anthony,REP,620013,2,15,67,84,
Pontotoc,Corporation Commissioner,Brian Bingman,REP,620013,2,3,59,64,
Pontotoc,Governor,Chris Powell,LIB,620013,0,0,0,0,
Pontotoc,Governor,Rex Lawhorn,LIB,620013,0,0,0,0,
Pontotoc,Corporation Commissioner,Ashley Nicole Mccray,DEM,620013,3,8,43,54,
Pontotoc,Corporation Commissioner,Blake Cummings,DEM,620013,0,5,35,40,
Pontotoc,U.S. House,Mary Brannon,DEM,620013,3,5,28,36,04
Pontotoc,U.S. House,Fred Gipson,DEM,620013,0,8,51,59,04
Pontotoc,Governor,Mick Cornett,REP,620016,4,12,86,102,
Pontotoc,Governor,Kevin Stitt,REP,620016,4,20,101,125,
Pontotoc,Lieutenant Governor,Dana Murphy,REP,620016,2,7,68,77,
Pontotoc,Lieutenant Governor,Matt Pinnell,REP,620016,5,25,115,145,
Pontotoc,State Auditor,Cindy Byrd,REP,620016,4,14,112,130,
Pontotoc,State Auditor,Charlie Prater,REP,620016,4,18,70,92,
Pontotoc,Attorney General,Mike Hunter,REP,620016,5,13,111,129,
Pontotoc,Attorney General,Gentner Drummond,REP,620016,3,19,72,94,
Pontotoc,Superintendent of Public Instruction,Joy Hofmeister,REP,620016,6,19,120,145,
Pontotoc,Superintendent of Public Instruction,Linda Murphy,REP,620016,2,13,63,78,
Pontotoc,Commissioner of Labor,Cathy Costello,REP,620016,4,18,83,105,
Pontotoc,Commissioner of Labor,Leslie Osborn,REP,620016,4,13,91,108,
Pontotoc,Corporation Commissioner,Bob Anthony,REP,620016,5,21,107,133,
Pontotoc,Corporation Commissioner,Brian Bingman,REP,620016,3,11,73,87,
Pontotoc,Governor,Chris Powell,LIB,620016,0,0,2,2,
Pontotoc,Governor,Rex Lawhorn,LIB,620016,0,0,1,1,
Pontotoc,Corporation Commissioner,Ashley Nicole Mccray,DEM,620016,6,13,65,84,
Pontotoc,Corporation Commissioner,Blake Cummings,DEM,620016,2,5,31,38,
Pontotoc,U.S. House,Mary Brannon,DEM,620016,3,6,46,55,04
Pontotoc,U.S. House,Fred Gipson,DEM,620016,5,12,50,67,04
Pontotoc,Governor,Mick Cornett,REP,620022,3,6,41,50,
Pontotoc,Governor,Kevin Stitt,REP,620022,1,3,43,47,
Pontotoc,Lieutenant Governor,Dana Murphy,REP,620022,2,2,34,38,
Pontotoc,Lieutenant Governor,Matt Pinnell,REP,620022,2,6,51,59,
Pontotoc,State Auditor,Cindy Byrd,REP,620022,4,5,54,63,
Pontotoc,State Auditor,Charlie Prater,REP,620022,0,3,28,31,
Pontotoc,Attorney General,Mike Hunter,REP,620022,1,8,49,58,
Pontotoc,Attorney General,Gentner Drummond,REP,620022,3,1,34,38,
Pontotoc,Superintendent of Public Instruction,Joy Hofmeister,REP,620022,4,3,57,64,
Pontotoc,Superintendent of Public Instruction,Linda Murphy,REP,620022,0,5,26,31,
Pontotoc,Commissioner of Labor,Cathy Costello,REP,620022,2,3,38,43,
Pontotoc,Commissioner of Labor,Leslie Osborn,REP,620022,2,5,43,50,
Pontotoc,Corporation Commissioner,Bob Anthony,REP,620022,2,7,44,53,
Pontotoc,Corporation Commissioner,Brian Bingman,REP,620022,2,2,35,39,
Pontotoc,Governor,Chris Powell,LIB,620022,0,0,1,1,
Pontotoc,Governor,Rex Lawhorn,LIB,620022,0,0,0,0,
Pontotoc,Corporation Commissioner,Ashley Nicole Mccray,DEM,620022,3,2,50,55,
Pontotoc,Corporation Commissioner,Blake Cummings,DEM,620022,1,0,28,29,
Pontotoc,U.S. House,Mary Brannon,DEM,620022,3,0,36,39,04
Pontotoc,U.S. House,Fred Gipson,DEM,620022,1,2,43,46,04
Pontotoc,Governor,Mick Cornett,REP,620025,2,19,80,101,
Pontotoc,Governor,Kevin Stitt,REP,620025,0,8,90,98,
Pontotoc,Lieutenant Governor,Dana Murphy,REP,620025,2,7,61,70,
Pontotoc,Lieutenant Governor,Matt Pinnell,REP,620025,0,17,108,125,
Pontotoc,State Auditor,Cindy Byrd,REP,620025,1,21,95,117,
Pontotoc,State Auditor,Charlie Prater,REP,620025,1,5,71,77,
Pontotoc,Attorney General,Mike Hunter,REP,620025,1,17,82,100,
Pontotoc,Attorney General,Gentner Drummond,REP,620025,0,10,85,95,
Pontotoc,Superintendent of Public Instruction,Joy Hofmeister,REP,620025,1,18,100,119,
Pontotoc,Superintendent of Public Instruction,Linda Murphy,REP,620025,1,8,71,80,
Pontotoc,Commissioner of Labor,Cathy Costello,REP,620025,0,14,81,95,
Pontotoc,Commissioner of Labor,Leslie Osborn,REP,620025,1,12,84,97,
Pontotoc,Corporation Commissioner,Bob Anthony,REP,620025,1,9,101,111,
Pontotoc,Corporation Commissioner,Brian Bingman,REP,620025,1,17,64,82,
Pontotoc,Governor,Chris Powell,LIB,620025,0,0,0,0,
Pontotoc,Governor,Rex Lawhorn,LIB,620025,0,0,0,0,
Pontotoc,Corporation Commissioner,Ashley Nicole Mccray,DEM,620025,4,5,53,62,
Pontotoc,Corporation Commissioner,Blake Cummings,DEM,620025,4,2,48,54,
Pontotoc,U.S. House,Mary Brannon,DEM,620025,4,2,53,59,04
Pontotoc,U.S. House,Fred Gipson,DEM,620025,4,5,48,57,04
Pontotoc,Governor,Mick Cornett,REP,620031,2,1,28,31,
Pontotoc,Governor,Kevin Stitt,REP,620031,1,2,46,49,
Pontotoc,Lieutenant Governor,Dana Murphy,REP,620031,2,0,26,28,
Pontotoc,Lieutenant Governor,Matt Pinnell,REP,620031,1,3,46,50,
Pontotoc,State Auditor,Cindy Byrd,REP,620031,0,0,40,40,
Pontotoc,State Auditor,Charlie Prater,REP,620031,3,3,32,38,
Pontotoc,Attorney General,Mike Hunter,REP,620031,2,1,34,37,
Pontotoc,Attorney General,Gentner Drummond,REP,620031,1,2,36,39,
Pontotoc,Superintendent of Public Instruction,Joy Hofmeister,REP,620031,3,2,44,49,
Pontotoc,Superintendent of Public Instruction,Linda Murphy,REP,620031,0,1,29,30,
Pontotoc,Commissioner of Labor,Cathy Costello,REP,620031,2,1,38,41,
Pontotoc,Commissioner of Labor,Leslie Osborn,REP,620031,1,2,33,36,
Pontotoc,Corporation Commissioner,Bob Anthony,REP,620031,2,2,33,37,
Pontotoc,Corporation Commissioner,Brian Bingman,REP,620031,1,1,38,40,
Pontotoc,Governor,Chris Powell,LIB,620031,0,0,1,1,
Pontotoc,Governor,Rex Lawhorn,LIB,620031,0,0,0,0,
Pontotoc,Corporation Commissioner,Ashley Nicole Mccray,DEM,620031,4,4,61,69,
Pontotoc,Corporation Commissioner,Blake Cummings,DEM,620031,0,4,27,31,
Pontotoc,U.S. House,Mary Brannon,DEM,620031,1,3,44,48,04
Pontotoc,U.S. House,Fred Gipson,DEM,620031,3,5,43,51,04
Pontotoc,Governor,Mick Cornett,REP,620051,0,1,22,23,
Pontotoc,Governor,Kevin Stitt,REP,620051,0,0,33,33,
Pontotoc,Lieutenant Governor,Dana Murphy,REP,620051,0,1,21,22,
Pontotoc,Lieutenant Governor,Matt Pinnell,REP,620051,0,0,35,35,
Pontotoc,State Auditor,Cindy Byrd,REP,620051,0,1,28,29,
Pontotoc,State Auditor,Charlie Prater,REP,620051,0,0,26,26,
Pontotoc,Attorney General,Mike Hunter,REP,620051,0,0,28,28,
Pontotoc,Attorney General,Gentner Drummond,REP,620051,0,1,29,30,
Pontotoc,Superintendent of Public Instruction,Joy Hofmeister,REP,620051,0,0,28,28,
Pontotoc,Superintendent of Public Instruction,Linda Murphy,REP,620051,0,1,27,28,
Pontotoc,Commissioner of Labor,Cathy Costello,REP,620051,0,0,27,27,
Pontotoc,Commissioner of Labor,Leslie Osborn,REP,620051,0,1,30,31,
Pontotoc,Corporation Commissioner,Bob Anthony,REP,620051,0,0,29,29,
Pontotoc,Corporation Commissioner,Brian Bingman,REP,620051,0,1,27,28,
Pontotoc,Governor,Chris Powell,LIB,620051,0,0,0,0,
Pontotoc,Governor,Rex Lawhorn,LIB,620051,0,0,0,0,
Pontotoc,Corporation Commissioner,Ashley Nicole Mccray,DEM,620051,0,0,14,14,
Pontotoc,Corporation Commissioner,Blake Cummings,DEM,620051,0,1,20,21,
Pontotoc,U.S. House,Mary Brannon,DEM,620051,0,0,15,15,04
Pontotoc,U.S. House,Fred Gipson,DEM,620051,0,1,19,20,04
Pontotoc,Governor,Mick Cornett,REP,620052,1,3,28,32,
Pontotoc,Governor,Kevin Stitt,REP,620052,1,6,31,38,
Pontotoc,Lieutenant Governor,Dana Murphy,REP,620052,0,5,18,23,
Pontotoc,Lieutenant Governor,Matt Pinnell,REP,620052,2,4,38,44,
Pontotoc,State Auditor,Cindy Byrd,REP,620052,2,5,38,45,
Pontotoc,State Auditor,Charlie Prater,REP,620052,0,4,18,22,
Pontotoc,Attorney General,Mike Hunter,REP,620052,1,2,30,33,
Pontotoc,Attorney General,Gentner Drummond,REP,620052,1,7,25,33,
Pontotoc,Superintendent of Public Instruction,Joy Hofmeister,REP,620052,2,7,40,49,
Pontotoc,Superintendent of Public Instruction,Linda Murphy,REP,620052,0,2,18,20,
Pontotoc,Commissioner of Labor,Cathy Costello,REP,620052,1,6,20,27,
Pontotoc,Commissioner of Labor,Leslie Osborn,REP,620052,1,3,34,38,
Pontotoc,Corporation Commissioner,Bob Anthony,REP,620052,2,6,26,34,
Pontotoc,Corporation Commissioner,Brian Bingman,REP,620052,0,2,28,30,
Pontotoc,Governor,Chris Powell,LIB,620052,0,0,0,0,
Pontotoc,Governor,Rex Lawhorn,LIB,620052,0,0,0,0,
Pontotoc,Corporation Commissioner,Ashley Nicole Mccray,DEM,620052,0,2,24,26,
Pontotoc,Corporation Commissioner,Blake Cummings,DEM,620052,2,0,20,22,
Pontotoc,U.S. House,Mary Brannon,DEM,620052,2,1,24,27,04
Pontotoc,U.S. House,Fred Gipson,DEM,620052,0,1,20,21,04
Pontotoc,Governor,Mick Cornett,REP,620053,10,16,135,161,
Pontotoc,Governor,Kevin Stitt,REP,620053,2,15,94,111,
Pontotoc,Lieutenant Governor,Dana Murphy,REP,620053,8,11,102,121,
Pontotoc,Lieutenant Governor,Matt Pinnell,REP,620053,4,20,119,143,
Pontotoc,State Auditor,Cindy Byrd,REP,620053,10,19,167,196,
Pontotoc,State Auditor,Charlie Prater,REP,620053,2,11,54,67,
Pontotoc,Attorney General,Mike Hunter,REP,620053,9,19,145,173,
Pontotoc,Attorney General,Gentner Drummond,REP,620053,3,11,78,92,
Pontotoc,Superintendent of Public Instruction,Joy Hofmeister,REP,620053,7,19,142,168,
Pontotoc,Superintendent of Public Instruction,Linda Murphy,REP,620053,5,10,85,100,
Pontotoc,Commissioner of Labor,Cathy Costello,REP,620053,9,14,116,139,
Pontotoc,Commissioner of Labor,Leslie Osborn,REP,620053,3,14,103,120,
Pontotoc,Corporation Commissioner,Bob Anthony,REP,620053,9,18,135,162,
Pontotoc,Corporation Commissioner,Brian Bingman,REP,620053,3,11,80,94,
Pontotoc,Governor,Chris Powell,LIB,620053,0,0,0,0,
Pontotoc,Governor,Rex Lawhorn,LIB,620053,0,0,0,0,
Pontotoc,Corporation Commissioner,Ashley Nicole Mccray,DEM,620053,5,8,65,78,
Pontotoc,Corporation Commissioner,Blake Cummings,DEM,620053,2,2,36,40,
Pontotoc,U.S. House,Mary Brannon,DEM,620053,3,6,52,61,04
Pontotoc,U.S. House,Fred Gipson,DEM,620053,4,4,49,57,04
Pontotoc,Governor,Mick Cornett,REP,620054,0,0,11,11,
Pontotoc,Governor,Kevin Stitt,REP,620054,0,0,9,9,
Pontotoc,Lieutenant Governor,Dana Murphy,REP,620054,0,0,6,6,
Pontotoc,Lieutenant Governor,Matt Pinnell,REP,620054,0,0,14,14,
Pontotoc,State Auditor,Cindy Byrd,REP,620054,0,0,15,15,
Pontotoc,State Auditor,Charlie Prater,REP,620054,0,0,5,5,
Pontotoc,Attorney General,Mike Hunter,REP,620054,0,0,9,9,
Pontotoc,Attorney General,Gentner Drummond,REP,620054,0,0,11,11,
Pontotoc,Superintendent of Public Instruction,Joy Hofmeister,REP,620054,0,0,14,14,
Pontotoc,Superintendent of Public Instruction,Linda Murphy,REP,620054,0,0,6,6,
Pontotoc,Commissioner of Labor,Cathy Costello,REP,620054,0,0,11,11,
Pontotoc,Commissioner of Labor,Leslie Osborn,REP,620054,0,0,9,9,
Pontotoc,Corporation Commissioner,Bob Anthony,REP,620054,0,0,15,15,
Pontotoc,Corporation Commissioner,Brian Bingman,REP,620054,0,0,5,5,
Pontotoc,Governor,Chris Powell,LIB,620054,0,0,0,0,
Pontotoc,Governor,Rex Lawhorn,LIB,620054,0,0,0,0,
Pontotoc,Corporation Commissioner,Ashley Nicole Mccray,DEM,620054,0,0,7,7,
Pontotoc,Corporation Commissioner,Blake Cummings,DEM,620054,0,0,6,6,
Pontotoc,U.S. House,Mary Brannon,DEM,620054,0,0,6,6,04
Pontotoc,U.S. House,Fred Gipson,DEM,620054,0,0,8,8,04
Pontotoc,Governor,Mick Cornett,REP,620055,0,2,7,9,
Pontotoc,Governor,Kevin Stitt,REP,620055,0,2,7,9,
Pontotoc,Lieutenant Governor,Dana Murphy,REP,620055,0,2,5,7,
Pontotoc,Lieutenant Governor,Matt Pinnell,REP,620055,0,2,9,11,
Pontotoc,State Auditor,Cindy Byrd,REP,620055,0,3,5,8,
Pontotoc,State Auditor,Charlie Prater,REP,620055,0,1,9,10,
Pontotoc,Attorney General,Mike Hunter,REP,620055,0,1,8,9,
Pontotoc,Attorney General,Gentner Drummond,REP,620055,0,3,6,9,
Pontotoc,Superintendent of Public Instruction,Joy Hofmeister,REP,620055,0,2,8,10,
Pontotoc,Superintendent of Public Instruction,Linda Murphy,REP,620055,0,2,6,8,
Pontotoc,Commissioner of Labor,Cathy Costello,REP,620055,0,0,6,6,
Pontotoc,Commissioner of Labor,Leslie Osborn,REP,620055,0,4,8,12,
Pontotoc,Corporation Commissioner,Bob Anthony,REP,620055,0,0,8,8,
Pontotoc,Corporation Commissioner,Brian Bingman,REP,620055,0,4,6,10,
Pontotoc,Governor,Chris Powell,LIB,620055,0,0,0,0,
Pontotoc,Governor,Rex Lawhorn,LIB,620055,0,0,0,0,
Pontotoc,Corporation Commissioner,Ashley Nicole Mccray,DEM,620055,2,0,8,10,
Pontotoc,Corporation Commissioner,Blake Cummings,DEM,620055,0,0,16,16,
Pontotoc,U.S. House,Mary Brannon,DEM,620055,0,0,9,9,04
Pontotoc,U.S. House,Fred Gipson,DEM,620055,2,0,15,17,04
Pontotoc,Governor,Mick Cornett,REP,620056,0,1,10,11,
Pontotoc,Governor,Kevin Stitt,REP,620056,0,0,27,27,
Pontotoc,Lieutenant Governor,Dana Murphy,REP,620056,0,1,20,21,
Pontotoc,Lieutenant Governor,Matt Pinnell,REP,620056,0,0,17,17,
Pontotoc,State Auditor,Cindy Byrd,REP,620056,0,0,17,17,
Pontotoc,State Auditor,Charlie Prater,REP,620056,0,1,20,21,
Pontotoc,Attorney General,Mike Hunter,REP,620056,0,1,16,17,
Pontotoc,Attorney General,Gentner Drummond,REP,620056,0,0,21,21,
Pontotoc,Superintendent of Public Instruction,Joy Hofmeister,REP,620056,0,1,18,19,
Pontotoc,Superintendent of Public Instruction,Linda Murphy,REP,620056,0,0,20,20,
Pontotoc,Commissioner of Labor,Cathy Costello,REP,620056,0,0,18,18,
Pontotoc,Commissioner of Labor,Leslie Osborn,REP,620056,0,1,19,20,
Pontotoc,Corporation Commissioner,Bob Anthony,REP,620056,0,1,18,19,
Pontotoc,Corporation Commissioner,Brian Bingman,REP,620056,0,0,20,20,
Pontotoc,Governor,Chris Powell,LIB,620056,0,0,0,0,
Pontotoc,Governor,Rex Lawhorn,LIB,620056,0,0,0,0,
Pontotoc,Corporation Commissioner,Ashley Nicole Mccray,DEM,620056,2,0,7,9,
Pontotoc,Corporation Commissioner,Blake Cummings,DEM,620056,0,1,21,22,
Pontotoc,U.S. House,Mary Brannon,DEM,620056,0,0,10,10,04
Pontotoc,U.S. House,Fred Gipson,DEM,620056,2,1,18,21,04
Pontotoc,Governor,Mick Cornett,REP,620058,0,2,45,47,
Pontotoc,Governor,Kevin Stitt,REP,620058,3,3,63,69,
Pontotoc,Lieutenant Governor,Dana Murphy,REP,620058,0,2,49,51,
Pontotoc,Lieutenant Governor,Matt Pinnell,REP,620058,3,3,58,64,
Pontotoc,State Auditor,Cindy Byrd,REP,620058,1,4,74,79,
Pontotoc,State Auditor,Charlie Prater,REP,620058,2,1,33,36,
Pontotoc,Attorney General,Mike Hunter,REP,620058,2,2,57,61,
Pontotoc,Attorney General,Gentner Drummond,REP,620058,1,3,49,53,
Pontotoc,Superintendent of Public Instruction,Joy Hofmeister,REP,620058,0,4,73,77,
Pontotoc,Superintendent of Public Instruction,Linda Murphy,REP,620058,3,1,33,37,
Pontotoc,Commissioner of Labor,Cathy Costello,REP,620058,3,3,53,59,
Pontotoc,Commissioner of Labor,Leslie Osborn,REP,620058,0,2,52,54,
Pontotoc,Corporation Commissioner,Bob Anthony,REP,620058,1,4,54,59,
Pontotoc,Corporation Commissioner,Brian Bingman,REP,620058,2,1,50,53,
Pontotoc,Governor,Chris Powell,LIB,620058,0,0,0,0,
Pontotoc,Governor,Rex Lawhorn,LIB,620058,0,0,0,0,
Pontotoc,Corporation Commissioner,Ashley Nicole Mccray,DEM,620058,3,3,38,44,
Pontotoc,Corporation Commissioner,Blake Cummings,DEM,620058,0,1,44,45,
Pontotoc,U.S. House,Mary Brannon,DEM,620058,3,3,42,48,04
Pontotoc,U.S. House,Fred Gipson,DEM,620058,0,2,43,45,04
Pontotoc,Governor,Mick Cornett,REP,620059,0,1,22,23,
Pontotoc,Governor,Kevin Stitt,REP,620059,1,0,40,41,
Pontotoc,Lieutenant Governor,Dana Murphy,REP,620059,1,1,24,26,
Pontotoc,Lieutenant Governor,Matt Pinnell,REP,620059,0,0,38,38,
Pontotoc,State Auditor,Cindy Byrd,REP,620059,1,1,29,31,
Pontotoc,State Auditor,Charlie Prater,REP,620059,0,0,32,32,
Pontotoc,Attorney General,Mike Hunter,REP,620059,0,1,27,28,
Pontotoc,Attorney General,Gentner Drummond,REP,620059,1,0,34,35,
Pontotoc,Superintendent of Public Instruction,Joy Hofmeister,REP,620059,1,1,35,37,
Pontotoc,Superintendent of Public Instruction,Linda Murphy,REP,620059,0,0,26,26,
Pontotoc,Commissioner of Labor,Cathy Costello,REP,620059,0,1,24,25,
Pontotoc,Commissioner of Labor,Leslie Osborn,REP,620059,1,0,34,35,
Pontotoc,Corporation Commissioner,Bob Anthony,REP,620059,1,1,21,23,
Pontotoc,Corporation Commissioner,Brian Bingman,REP,620059,0,0,38,38,
Pontotoc,Governor,Chris Powell,LIB,620059,0,0,0,0,
Pontotoc,Governor,Rex Lawhorn,LIB,620059,0,0,0,0,
Pontotoc,Corporation Commissioner,Ashley Nicole Mccray,DEM,620059,0,1,10,11,
Pontotoc,Corporation Commissioner,Blake Cummings,DEM,620059,0,5,27,32,
Pontotoc,U.S. House,Mary Brannon,DEM,620059,0,2,12,14,04
Pontotoc,U.S. House,Fred Gipson,DEM,620059,0,4,25,29,04
Pontotoc,Governor,Mick Cornett,REP,620060,1,4,50,55,
Pontotoc,Governor,Kevin Stitt,REP,620060,0,4,68,72,
Pontotoc,Lieutenant Governor,Dana Murphy,REP,620060,1,0,45,46,
Pontotoc,Lieutenant Governor,Matt Pinnell,REP,620060,0,8,69,77,
Pontotoc,State Auditor,Cindy Byrd,REP,620060,0,3,70,73,
Pontotoc,State Auditor,Charlie Prater,REP,620060,1,5,47,53,
Pontotoc,Attorney General,Mike Hunter,REP,620060,0,4,46,50,
Pontotoc,Attorney General,Gentner Drummond,REP,620060,1,4,70,75,
Pontotoc,Superintendent of Public Instruction,Joy Hofmeister,REP,620060,0,6,77,83,
Pontotoc,Superintendent of Public Instruction,Linda Murphy,REP,620060,1,2,39,42,
Pontotoc,Commissioner of Labor,Cathy Costello,REP,620060,1,3,57,61,
Pontotoc,Commissioner of Labor,Leslie Osborn,REP,620060,0,5,57,62,
Pontotoc,Corporation Commissioner,Bob Anthony,REP,620060,1,1,60,62,
Pontotoc,Corporation Commissioner,Brian Bingman,REP,620060,0,7,53,60,
Pontotoc,Governor,Chris Powell,LIB,620060,0,0,0,0,
Pontotoc,Governor,Rex Lawhorn,LIB,620060,0,0,1,1,
Pontotoc,Corporation Commissioner,Ashley Nicole Mccray,DEM,620060,0,1,55,56,
Pontotoc,Corporation Commissioner,Blake Cummings,DEM,620060,0,2,22,24,
Pontotoc,U.S. House,Mary Brannon,DEM,620060,0,2,32,34,04
Pontotoc,U.S. House,Fred Gipson,DEM,620060,0,1,45,46,04
Pontotoc,Governor,Mick Cornett,REP,620061,0,1,5,6,
Pontotoc,Governor,Kevin Stitt,REP,620061,0,1,21,22,
Pontotoc,Lieutenant Governor,Dana Murphy,REP,620061,0,2,8,10,
Pontotoc,Lieutenant Governor,Matt Pinnell,REP,620061,0,0,18,18,
Pontotoc,State Auditor,Cindy Byrd,REP,620061,0,2,13,15,
Pontotoc,State Auditor,Charlie Prater,REP,620061,0,0,13,13,
Pontotoc,Attorney General,Mike Hunter,REP,620061,0,2,14,16,
Pontotoc,Attorney General,Gentner Drummond,REP,620061,0,0,12,12,
Pontotoc,Superintendent of Public Instruction,Joy Hofmeister,REP,620061,0,2,7,9,
Pontotoc,Superintendent of Public Instruction,Linda Murphy,REP,620061,0,0,19,19,
Pontotoc,Commissioner of Labor,Cathy Costello,REP,620061,0,1,15,16,
Pontotoc,Commissioner of Labor,Leslie Osborn,REP,620061,0,1,10,11,
Pontotoc,Corporation Commissioner,Bob Anthony,REP,620061,0,2,13,15,
Pontotoc,Corporation Commissioner,Brian Bingman,REP,620061,0,0,13,13,
Pontotoc,Governor,Chris Powell,LIB,620061,0,0,0,0,
Pontotoc,Governor,Rex Lawhorn,LIB,620061,0,0,0,0,
Pontotoc,Corporation Commissioner,Ashley Nicole Mccray,DEM,620061,0,0,9,9,
Pontotoc,Corporation Commissioner,Blake Cummings,DEM,620061,0,3,14,17,
Pontotoc,U.S. House,Mary Brannon,DEM,620061,0,0,8,8,04
Pontotoc,U.S. House,Fred Gipson,DEM,620061,0,3,15,18,04
Pontotoc,Governor,Mick Cornett,REP,620062,1,0,46,47,
Pontotoc,Governor,Kevin Stitt,REP,620062,4,2,59,65,
Pontotoc,Lieutenant Governor,Dana Murphy,REP,620062,2,0,44,46,
Pontotoc,Lieutenant Governor,Matt Pinnell,REP,620062,3,2,61,66,
Pontotoc,State Auditor,Cindy Byrd,REP,620062,5,2,61,68,
Pontotoc,State Auditor,Charlie Prater,REP,620062,0,0,43,43,
Pontotoc,Attorney General,Mike Hunter,REP,620062,3,0,46,49,
Pontotoc,Attorney General,Gentner Drummond,REP,620062,2,2,59,63,
Pontotoc,Superintendent of Public Instruction,Joy Hofmeister,REP,620062,0,2,56,58,
Pontotoc,Superintendent of Public Instruction,Linda Murphy,REP,620062,5,0,49,54,
Pontotoc,Commissioner of Labor,Cathy Costello,REP,620062,3,2,50,55,
Pontotoc,Commissioner of Labor,Leslie Osborn,REP,620062,2,0,51,53,
Pontotoc,Corporation Commissioner,Bob Anthony,REP,620062,2,0,57,59,
Pontotoc,Corporation Commissioner,Brian Bingman,REP,620062,3,2,45,50,
Pontotoc,Governor,Chris Powell,LIB,620062,0,0,0,0,
Pontotoc,Governor,Rex Lawhorn,LIB,620062,0,0,0,0,
Pontotoc,Corporation Commissioner,Ashley Nicole Mccray,DEM,620062,0,2,31,33,
Pontotoc,Corporation Commissioner,Blake Cummings,DEM,620062,1,0,21,22,
Pontotoc,U.S. House,Mary Brannon,DEM,620062,1,2,29,32,04
Pontotoc,U.S. House,Fred Gipson,DEM,620062,0,0,23,23,04
Pontotoc,Governor,Mick Cornett,REP,620063,0,0,13,13,
Pontotoc,Governor,Kevin Stitt,REP,620063,3,0,21,24,
Pontotoc,Lieutenant Governor,Dana Murphy,REP,620063,1,0,12,13,
Pontotoc,Lieutenant Governor,Matt Pinnell,REP,620063,1,0,22,23,
Pontotoc,State Auditor,Cindy Byrd,REP,620063,1,0,20,21,
Pontotoc,State Auditor,Charlie Prater,REP,620063,1,0,14,15,
Pontotoc,Attorney General,Mike Hunter,REP,620063,1,0,15,16,
Pontotoc,Attorney General,Gentner Drummond,REP,620063,2,0,19,21,
Pontotoc,Superintendent of Public Instruction,Joy Hofmeister,REP,620063,3,0,18,21,
Pontotoc,Superintendent of Public Instruction,Linda Murphy,REP,620063,0,0,15,15,
Pontotoc,Commissioner of Labor,Cathy Costello,REP,620063,2,0,18,20,
Pontotoc,Commissioner of Labor,Leslie Osborn,REP,620063,1,0,15,16,
Pontotoc,Corporation Commissioner,Bob Anthony,REP,620063,2,0,16,18,
Pontotoc,Corporation Commissioner,Brian Bingman,REP,620063,1,0,17,18,
Pontotoc,Governor,Chris Powell,LIB,620063,0,0,0,0,
Pontotoc,Governor,Rex Lawhorn,LIB,620063,0,0,0,0,
Pontotoc,Corporation Commissioner,Ashley Nicole Mccray,DEM,620063,3,0,19,22,
Pontotoc,Corporation Commissioner,Blake Cummings,DEM,620063,2,0,11,13,
Pontotoc,U.S. House,Mary Brannon,DEM,620063,4,0,17,21,04
Pontotoc,U.S. House,Fred Gipson,DEM,620063,1,0,13,14,04
Pontotoc,Governor,Mick Cornett,REP,620064,0,0,35,35,
Pontotoc,Governor,Kevin Stitt,REP,620064,1,1,59,61,
Pontotoc,Lieutenant Governor,Dana Murphy,REP,620064,1,0,31,32,
Pontotoc,Lieutenant Governor,Matt Pinnell,REP,620064,0,1,61,62,
Pontotoc,State Auditor,Cindy Byrd,REP,620064,1,0,63,64,
Pontotoc,State Auditor,Charlie Prater,REP,620064,0,1,29,30,
Pontotoc,Attorney General,Mike Hunter,REP,620064,1,0,49,50,
Pontotoc,Attorney General,Gentner Drummond,REP,620064,0,1,44,45,
Pontotoc,Superintendent of Public Instruction,Joy Hofmeister,REP,620064,1,1,50,52,
Pontotoc,Superintendent of Public Instruction,Linda Murphy,REP,620064,0,0,42,42,
Pontotoc,Commissioner of Labor,Cathy Costello,REP,620064,0,0,42,42,
Pontotoc,Commissioner of Labor,Leslie Osborn,REP,620064,1,1,51,53,
Pontotoc,Corporation Commissioner,Bob Anthony,REP,620064,1,0,55,56,
Pontotoc,Corporation Commissioner,Brian Bingman,REP,620064,0,1,37,38,
Pontotoc,Governor,Chris Powell,LIB,620064,0,0,0,0,
Pontotoc,Governor,Rex Lawhorn,LIB,620064,0,0,0,0,
Pontotoc,Corporation Commissioner,Ashley Nicole Mccray,DEM,620064,1,4,25,30,
Pontotoc,Corporation Commissioner,Blake Cummings,DEM,620064,0,0,24,24,
Pontotoc,U.S. House,Mary Brannon,DEM,620064,1,0,19,20,04
Pontotoc,U.S. House,Fred Gipson,DEM,620064,0,4,30,34,04
Pontotoc,Governor,Mick Cornett,REP,620065,1,0,15,16,
Pontotoc,Governor,Kevin Stitt,REP,620065,1,7,39,47,
Pontotoc,Lieutenant Governor,Dana Murphy,REP,620065,1,2,20,23,
Pontotoc,Lieutenant Governor,Matt Pinnell,REP,620065,1,5,32,38,
Pontotoc,State Auditor,Cindy Byrd,REP,620065,0,7,35,42,
Pontotoc,State Auditor,Charlie Prater,REP,620065,2,0,17,19,
Pontotoc,Attorney General,Mike Hunter,REP,620065,2,3,24,29,
Pontotoc,Attorney General,Gentner Drummond,REP,620065,0,4,30,34,
Pontotoc,Superintendent of Public Instruction,Joy Hofmeister,REP,620065,1,6,26,33,
Pontotoc,Superintendent of Public Instruction,Linda Murphy,REP,620065,1,1,27,29,
Pontotoc,Commissioner of Labor,Cathy Costello,REP,620065,2,6,24,32,
Pontotoc,Commissioner of Labor,Leslie Osborn,REP,620065,0,1,27,28,
Pontotoc,Corporation Commissioner,Bob Anthony,REP,620065,2,4,30,36,
Pontotoc,Corporation Commissioner,Brian Bingman,REP,620065,0,3,21,24,
Pontotoc,Governor,Chris Powell,LIB,620065,0,0,0,0,
Pontotoc,Governor,Rex Lawhorn,LIB,620065,0,0,0,0,
Pontotoc,Corporation Commissioner,Ashley Nicole Mccray,DEM,620065,0,0,18,18,
Pontotoc,Corporation Commissioner,Blake Cummings,DEM,620065,0,0,21,21,
Pontotoc,U.S. House,Mary Brannon,DEM,620065,0,0,17,17,04
Pontotoc,U.S. House,Fred Gipson,DEM,620065,0,0,22,22,04
Pontotoc,Governor,Mick Cornett,REP,620066,0,3,30,33,
Pontotoc,Governor,Kevin Stitt,REP,620066,0,5,63,68,
Pontotoc,Lieutenant Governor,Dana Murphy,REP,620066,0,2,38,40,
Pontotoc,Lieutenant Governor,Matt Pinnell,REP,620066,0,6,54,60,
Pontotoc,State Auditor,Cindy Byrd,REP,620066,0,4,52,56,
Pontotoc,State Auditor,Charlie Prater,REP,620066,0,3,35,38,
Pontotoc,Attorney General,Mike Hunter,REP,620066,0,6,48,54,
Pontotoc,Attorney General,Gentner Drummond,REP,620066,0,0,43,43,
Pontotoc,Superintendent of Public Instruction,Joy Hofmeister,REP,620066,0,5,42,47,
Pontotoc,Superintendent of Public Instruction,Linda Murphy,REP,620066,0,1,46,47,
Pontotoc,Commissioner of Labor,Cathy Costello,REP,620066,0,0,43,43,
Pontotoc,Commissioner of Labor,Leslie Osborn,REP,620066,0,6,46,52,
Pontotoc,Corporation Commissioner,Bob Anthony,REP,620066,0,3,41,44,
Pontotoc,Corporation Commissioner,Brian Bingman,REP,620066,0,3,44,47,
Pontotoc,Governor,Chris Powell,LIB,620066,0,0,0,0,
Pontotoc,Governor,Rex Lawhorn,LIB,620066,0,0,0,0,
Pontotoc,Corporation Commissioner,Ashley Nicole Mccray,DEM,620066,1,1,16,18,
Pontotoc,Corporation Commissioner,Blake Cummings,DEM,620066,0,0,20,20,
Pontotoc,U.S. House,Mary Brannon,DEM,620066,1,0,12,13,04
Pontotoc,U.S. House,Fred Gipson,DEM,620066,0,1,24,25,04
Pontotoc,Governor,Mick Cornett,REP,620067,3,0,23,26,
Pontotoc,Governor,Kevin Stitt,REP,620067,0,0,33,33,
Pontotoc,Lieutenant Governor,Dana Murphy,REP,620067,1,0,18,19,
Pontotoc,Lieutenant Governor,Matt Pinnell,REP,620067,2,0,37,39,
Pontotoc,State Auditor,Cindy Byrd,REP,620067,2,0,40,42,
Pontotoc,State Auditor,Charlie Prater,REP,620067,1,0,16,17,
Pontotoc,Attorney General,Mike Hunter,REP,620067,2,0,29,31,
Pontotoc,Attorney General,Gentner Drummond,REP,620067,1,0,26,27,
Pontotoc,Superintendent of Public Instruction,Joy Hofmeister,REP,620067,3,0,28,31,
Pontotoc,Superintendent of Public Instruction,Linda Murphy,REP,620067,0,0,28,28,
Pontotoc,Commissioner of Labor,Cathy Costello,REP,620067,2,0,30,32,
Pontotoc,Commissioner of Labor,Leslie Osborn,REP,620067,1,0,25,26,
Pontotoc,Corporation Commissioner,Bob Anthony,REP,620067,3,0,31,34,
Pontotoc,Corporation Commissioner,Brian Bingman,REP,620067,0,0,23,23,
Pontotoc,Governor,Chris Powell,LIB,620067,0,0,0,0,
Pontotoc,Governor,Rex Lawhorn,LIB,620067,0,0,0,0,
Pontotoc,Corporation Commissioner,Ashley Nicole Mccray,DEM,620067,2,0,9,11,
Pontotoc,Corporation Commissioner,Blake Cummings,DEM,620067,0,0,15,15,
Pontotoc,U.S. House,Mary Brannon,DEM,620067,0,0,9,9,04
Pontotoc,U.S. House,Fred Gipson,DEM,620067,2,0,15,17,04
Pottawatomie,Governor,Mick Cornett,REP,630001,1,0,49,50,
Pottawatomie,Governor,Kevin Stitt,REP,630001,0,2,39,41,
Pottawatomie,Lieutenant Governor,Dana Murphy,REP,630001,1,2,49,52,
Pottawatomie,Lieutenant Governor,Matt Pinnell,REP,630001,0,0,36,36,
Pottawatomie,State Auditor,Cindy Byrd,REP,630001,1,1,46,48,
Pottawatomie,State Auditor,Charlie Prater,REP,630001,0,1,38,39,
Pottawatomie,Attorney General,Mike Hunter,REP,630001,1,1,44,46,
Pottawatomie,Attorney General,Gentner Drummond,REP,630001,0,1,39,40,
Pottawatomie,Superintendent of Public Instruction,Joy Hofmeister,REP,630001,0,0,52,52,
Pottawatomie,Superintendent of Public Instruction,Linda Murphy,REP,630001,1,2,35,38,
Pottawatomie,Commissioner of Labor,Cathy Costello,REP,630001,1,0,46,47,
Pottawatomie,Commissioner of Labor,Leslie Osborn,REP,630001,0,2,40,42,
Pottawatomie,Corporation Commissioner,Bob Anthony,REP,630001,1,2,43,46,
Pottawatomie,Corporation Commissioner,Brian Bingman,REP,630001,0,0,42,42,
Pottawatomie,Governor,Chris Powell,LIB,630001,0,0,0,0,
Pottawatomie,Governor,Rex Lawhorn,LIB,630001,0,0,0,0,
Pottawatomie,Corporation Commissioner,Ashley Nicole Mccray,DEM,630001,1,0,13,14,
Pottawatomie,Corporation Commissioner,Blake Cummings,DEM,630001,2,0,15,17,
Pottawatomie,U.S. House,Kendra Horn,DEM,630001,2,0,15,17,05
Pottawatomie,U.S. House,Tom Guild,DEM,630001,1,0,13,14,05
Pottawatomie,State House,Terry Hopkins,DEM,630001,1,0,17,18,26
Pottawatomie,State House,E. Bruce Bushong,DEM,630001,2,0,12,14,26
Pottawatomie,Governor,Mick Cornett,REP,630002,0,0,46,46,
Pottawatomie,Governor,Kevin Stitt,REP,630002,0,3,35,38,
Pottawatomie,Lieutenant Governor,Dana Murphy,REP,630002,0,1,30,31,
Pottawatomie,Lieutenant Governor,Matt Pinnell,REP,630002,0,2,50,52,
Pottawatomie,State Auditor,Cindy Byrd,REP,630002,0,1,36,37,
Pottawatomie,State Auditor,Charlie Prater,REP,630002,0,2,43,45,
Pottawatomie,Attorney General,Mike Hunter,REP,630002,0,1,43,44,
Pottawatomie,Attorney General,Gentner Drummond,REP,630002,0,2,36,38,
Pottawatomie,Superintendent of Public Instruction,Joy Hofmeister,REP,630002,0,1,41,42,
Pottawatomie,Superintendent of Public Instruction,Linda Murphy,REP,630002,0,2,39,41,
Pottawatomie,Commissioner of Labor,Cathy Costello,REP,630002,0,2,45,47,
Pottawatomie,Commissioner of Labor,Leslie Osborn,REP,630002,0,1,33,34,
Pottawatomie,Corporation Commissioner,Bob Anthony,REP,630002,0,0,39,39,
Pottawatomie,Corporation Commissioner,Brian Bingman,REP,630002,0,3,39,42,
Pottawatomie,Governor,Chris Powell,LIB,630002,0,0,0,0,
Pottawatomie,Governor,Rex Lawhorn,LIB,630002,0,0,0,0,
Pottawatomie,Corporation Commissioner,Ashley Nicole Mccray,DEM,630002,2,0,43,45,
Pottawatomie,Corporation Commissioner,Blake Cummings,DEM,630002,1,0,17,18,
Pottawatomie,U.S. House,Kendra Horn,DEM,630002,2,0,37,39,05
Pottawatomie,U.S. House,Tom Guild,DEM,630002,1,0,23,24,05
Pottawatomie,State House,Terry Hopkins,DEM,630002,1,0,27,28,26
Pottawatomie,State House,E. Bruce Bushong,DEM,630002,2,0,33,35,26
Pottawatomie,Governor,Mick Cornett,REP,630003,0,6,64,70,
Pottawatomie,Governor,Kevin Stitt,REP,630003,3,0,51,54,
Pottawatomie,Lieutenant Governor,Dana Murphy,REP,630003,2,4,49,55,
Pottawatomie,Lieutenant Governor,Matt Pinnell,REP,630003,1,2,65,68,
Pottawatomie,State Auditor,Cindy Byrd,REP,630003,2,3,46,51,
Pottawatomie,State Auditor,Charlie Prater,REP,630003,1,3,67,71,
Pottawatomie,Attorney General,Mike Hunter,REP,630003,3,4,61,68,
Pottawatomie,Attorney General,Gentner Drummond,REP,630003,0,2,53,55,
Pottawatomie,Superintendent of Public Instruction,Joy Hofmeister,REP,630003,0,5,64,69,
Pottawatomie,Superintendent of Public Instruction,Linda Murphy,REP,630003,3,1,48,52,
Pottawatomie,Commissioner of Labor,Cathy Costello,REP,630003,2,5,53,60,
Pottawatomie,Commissioner of Labor,Leslie Osborn,REP,630003,1,1,60,62,
Pottawatomie,Corporation Commissioner,Bob Anthony,REP,630003,2,5,53,60,
Pottawatomie,Corporation Commissioner,Brian Bingman,REP,630003,1,1,59,61,
Pottawatomie,Governor,Chris Powell,LIB,630003,0,0,0,0,
Pottawatomie,Governor,Rex Lawhorn,LIB,630003,0,0,1,1,
Pottawatomie,Corporation Commissioner,Ashley Nicole Mccray,DEM,630003,5,6,64,75,
Pottawatomie,Corporation Commissioner,Blake Cummings,DEM,630003,1,2,34,37,
Pottawatomie,U.S. House,Kendra Horn,DEM,630003,2,4,67,73,05
Pottawatomie,U.S. House,Tom Guild,DEM,630003,4,4,32,40,05
Pottawatomie,State House,Terry Hopkins,DEM,630003,4,6,56,66,26
Pottawatomie,State House,E. Bruce Bushong,DEM,630003,2,2,43,47,26
Pottawatomie,Governor,Mick Cornett,REP,630006,4,1,46,51,
Pottawatomie,Governor,Kevin Stitt,REP,630006,2,2,82,86,
Pottawatomie,Lieutenant Governor,Dana Murphy,REP,630006,1,2,48,51,
Pottawatomie,Lieutenant Governor,Matt Pinnell,REP,630006,5,3,76,84,
Pottawatomie,State Auditor,Cindy Byrd,REP,630006,3,2,51,56,
Pottawatomie,State Auditor,Charlie Prater,REP,630006,3,3,68,74,
Pottawatomie,Attorney General,Mike Hunter,REP,630006,1,4,71,76,
Pottawatomie,Attorney General,Gentner Drummond,REP,630006,5,1,53,59,
Pottawatomie,Superintendent of Public Instruction,Joy Hofmeister,REP,630006,4,3,64,71,
Pottawatomie,Superintendent of Public Instruction,Linda Murphy,REP,630006,2,2,61,65,
Pottawatomie,Commissioner of Labor,Cathy Costello,REP,630006,1,3,70,74,
Pottawatomie,Commissioner of Labor,Leslie Osborn,REP,630006,5,2,54,61,
Pottawatomie,Corporation Commissioner,Bob Anthony,REP,630006,5,4,61,70,
Pottawatomie,Corporation Commissioner,Brian Bingman,REP,630006,1,1,60,62,
Pottawatomie,Governor,Chris Powell,LIB,630006,0,0,0,0,
Pottawatomie,Governor,Rex Lawhorn,LIB,630006,0,0,2,2,
Pottawatomie,Corporation Commissioner,Ashley Nicole Mccray,DEM,630006,1,3,49,53,
Pottawatomie,Corporation Commissioner,Blake Cummings,DEM,630006,2,1,21,24,
Pottawatomie,U.S. House,Kendra Horn,DEM,630006,2,3,54,59,05
Pottawatomie,U.S. House,Tom Guild,DEM,630006,1,1,17,19,05
Pottawatomie,State House,Terry Hopkins,DEM,630006,3,3,34,40,26
Pottawatomie,State House,E. Bruce Bushong,DEM,630006,0,1,37,38,26
Pottawatomie,Governor,Mick Cornett,REP,630007,7,7,78,92,
Pottawatomie,Governor,Kevin Stitt,REP,630007,2,5,68,75,
Pottawatomie,Lieutenant Governor,Dana Murphy,REP,630007,1,7,64,72,
Pottawatomie,Lieutenant Governor,Matt Pinnell,REP,630007,8,5,80,93,
Pottawatomie,State Auditor,Cindy Byrd,REP,630007,2,5,72,79,
Pottawatomie,State Auditor,Charlie Prater,REP,630007,7,6,66,79,
Pottawatomie,Attorney General,Mike Hunter,REP,630007,5,9,79,93,
Pottawatomie,Attorney General,Gentner Drummond,REP,630007,4,3,63,70,
Pottawatomie,Superintendent of Public Instruction,Joy Hofmeister,REP,630007,8,6,89,103,
Pottawatomie,Superintendent of Public Instruction,Linda Murphy,REP,630007,1,6,51,58,
Pottawatomie,Commissioner of Labor,Cathy Costello,REP,630007,3,7,64,74,
Pottawatomie,Commissioner of Labor,Leslie Osborn,REP,630007,6,4,77,87,
Pottawatomie,Corporation Commissioner,Bob Anthony,REP,630007,6,7,73,86,
Pottawatomie,Corporation Commissioner,Brian Bingman,REP,630007,3,4,71,78,
Pottawatomie,Governor,Chris Powell,LIB,630007,0,0,1,1,
Pottawatomie,Governor,Rex Lawhorn,LIB,630007,0,0,1,1,
Pottawatomie,Corporation Commissioner,Ashley Nicole Mccray,DEM,630007,6,7,63,76,
Pottawatomie,Corporation Commissioner,Blake Cummings,DEM,630007,3,4,32,39,
Pottawatomie,U.S. House,Kendra Horn,DEM,630007,5,8,70,83,05
Pottawatomie,U.S. House,Tom Guild,DEM,630007,4,3,29,36,05
Pottawatomie,State House,Terry Hopkins,DEM,630007,6,9,50,65,26
Pottawatomie,State House,E. Bruce Bushong,DEM,630007,3,2,49,54,26
Pottawatomie,Governor,Mick Cornett,REP,630009,9,21,118,148,
Pottawatomie,Governor,Kevin Stitt,REP,630009,4,24,103,131,
Pottawatomie,Lieutenant Governor,Dana Murphy,REP,630009,6,14,89,109,
Pottawatomie,Lieutenant Governor,Matt Pinnell,REP,630009,7,30,130,167,
Pottawatomie,State Auditor,Cindy Byrd,REP,630009,9,21,98,128,
Pottawatomie,State Auditor,Charlie Prater,REP,630009,4,21,119,144,
Pottawatomie,Attorney General,Mike Hunter,REP,630009,7,26,111,144,
Pottawatomie,Attorney General,Gentner Drummond,REP,630009,6,18,107,131,
Pottawatomie,Superintendent of Public Instruction,Joy Hofmeister,REP,630009,6,20,132,158,
Pottawatomie,Superintendent of Public Instruction,Linda Murphy,REP,630009,7,23,85,115,
Pottawatomie,Commissioner of Labor,Cathy Costello,REP,630009,9,11,93,113,
Pottawatomie,Commissioner of Labor,Leslie Osborn,REP,630009,4,32,118,154,
Pottawatomie,Corporation Commissioner,Bob Anthony,REP,630009,5,23,112,140,
Pottawatomie,Corporation Commissioner,Brian Bingman,REP,630009,8,19,105,132,
Pottawatomie,Governor,Chris Powell,LIB,630009,1,0,1,2,
Pottawatomie,Governor,Rex Lawhorn,LIB,630009,0,0,0,0,
Pottawatomie,Corporation Commissioner,Ashley Nicole Mccray,DEM,630009,6,7,51,64,
Pottawatomie,Corporation Commissioner,Blake Cummings,DEM,630009,0,4,34,38,
Pottawatomie,U.S. House,Kendra Horn,DEM,630009,5,8,46,59,05
Pottawatomie,U.S. House,Tom Guild,DEM,630009,2,4,43,49,05
Pottawatomie,State House,Terry Hopkins,DEM,630009,5,6,51,62,26
Pottawatomie,State House,E. Bruce Bushong,DEM,630009,2,6,38,46,26
Pottawatomie,Governor,Mick Cornett,REP,630011,3,13,217,233,
Pottawatomie,Governor,Kevin Stitt,REP,630011,14,13,153,180,
Pottawatomie,Lieutenant Governor,Dana Murphy,REP,630011,5,9,147,161,
Pottawatomie,Lieutenant Governor,Matt Pinnell,REP,630011,12,17,215,244,
Pottawatomie,State Auditor,Cindy Byrd,REP,630011,6,11,150,167,
Pottawatomie,State Auditor,Charlie Prater,REP,630011,11,15,200,226,
Pottawatomie,Attorney General,Mike Hunter,REP,630011,9,15,200,224,
Pottawatomie,Attorney General,Gentner Drummond,REP,630011,8,11,159,178,
Pottawatomie,Superintendent of Public Instruction,Joy Hofmeister,REP,630011,9,16,234,259,
Pottawatomie,Superintendent of Public Instruction,Linda Murphy,REP,630011,8,10,126,144,
Pottawatomie,Commissioner of Labor,Cathy Costello,REP,630011,7,16,167,190,
Pottawatomie,Commissioner of Labor,Leslie Osborn,REP,630011,10,10,189,209,
Pottawatomie,Corporation Commissioner,Bob Anthony,REP,630011,9,11,211,231,
Pottawatomie,Corporation Commissioner,Brian Bingman,REP,630011,8,15,147,170,
Pottawatomie,Governor,Chris Powell,LIB,630011,0,0,0,0,
Pottawatomie,Governor,Rex Lawhorn,LIB,630011,0,0,0,0,
Pottawatomie,Corporation Commissioner,Ashley Nicole Mccray,DEM,630011,15,8,111,134,
Pottawatomie,Corporation Commissioner,Blake Cummings,DEM,630011,2,4,44,50,
Pottawatomie,U.S. House,Kendra Horn,DEM,630011,15,10,114,139,05
Pottawatomie,U.S. House,Tom Guild,DEM,630011,2,2,44,48,05
Pottawatomie,State House,Terry Hopkins,DEM,630011,6,2,78,86,26
Pottawatomie,State House,E. Bruce Bushong,DEM,630011,11,10,80,101,26
Pottawatomie,Governor,Mick Cornett,REP,630012,9,9,108,126,
Pottawatomie,Governor,Kevin Stitt,REP,630012,1,1,72,74,
Pottawatomie,Lieutenant Governor,Dana Murphy,REP,630012,2,4,85,91,
Pottawatomie,Lieutenant Governor,Matt Pinnell,REP,630012,8,6,92,106,
Pottawatomie,State Auditor,Cindy Byrd,REP,630012,6,8,98,112,
Pottawatomie,State Auditor,Charlie Prater,REP,630012,4,1,77,82,
Pottawatomie,Attorney General,Mike Hunter,REP,630012,8,9,102,119,
Pottawatomie,Attorney General,Gentner Drummond,REP,630012,2,1,70,73,
Pottawatomie,Superintendent of Public Instruction,Joy Hofmeister,REP,630012,4,5,117,126,
Pottawatomie,Superintendent of Public Instruction,Linda Murphy,REP,630012,6,4,62,72,
Pottawatomie,Commissioner of Labor,Cathy Costello,REP,630012,8,5,72,85,
Pottawatomie,Commissioner of Labor,Leslie Osborn,REP,630012,2,5,104,111,
Pottawatomie,Corporation Commissioner,Bob Anthony,REP,630012,7,6,82,95,
Pottawatomie,Corporation Commissioner,Brian Bingman,REP,630012,3,4,91,98,
Pottawatomie,Governor,Chris Powell,LIB,630012,0,0,0,0,
Pottawatomie,Governor,Rex Lawhorn,LIB,630012,0,0,0,0,
Pottawatomie,Corporation Commissioner,Ashley Nicole Mccray,DEM,630012,10,7,73,90,
Pottawatomie,Corporation Commissioner,Blake Cummings,DEM,630012,2,7,37,46,
Pottawatomie,U.S. House,Kendra Horn,DEM,630012,9,9,86,104,05
Pottawatomie,U.S. House,Tom Guild,DEM,630012,3,5,26,34,05
Pottawatomie,State House,Terry Hopkins,DEM,630012,4,9,51,64,26
Pottawatomie,State House,E. Bruce Bushong,DEM,630012,8,5,64,77,26
Pottawatomie,Governor,Mick Cornett,REP,630013,14,18,188,220,
Pottawatomie,Governor,Kevin Stitt,REP,630013,15,7,103,125,
Pottawatomie,Lieutenant Governor,Dana Murphy,REP,630013,12,14,134,160,
Pottawatomie,Lieutenant Governor,Matt Pinnell,REP,630013,17,10,150,177,
Pottawatomie,State Auditor,Cindy Byrd,REP,630013,15,12,124,151,
Pottawatomie,State Auditor,Charlie Prater,REP,630013,14,12,152,178,
Pottawatomie,Attorney General,Mike Hunter,REP,630013,15,15,178,208,
Pottawatomie,Attorney General,Gentner Drummond,REP,630013,13,9,109,131,
Pottawatomie,Superintendent of Public Instruction,Joy Hofmeister,REP,630013,16,16,193,225,
Pottawatomie,Superintendent of Public Instruction,Linda Murphy,REP,630013,12,7,92,111,
Pottawatomie,Commissioner of Labor,Cathy Costello,REP,630013,18,11,140,169,
Pottawatomie,Commissioner of Labor,Leslie Osborn,REP,630013,10,12,141,163,
Pottawatomie,Corporation Commissioner,Bob Anthony,REP,630013,9,14,169,192,
Pottawatomie,Corporation Commissioner,Brian Bingman,REP,630013,19,8,113,140,
Pottawatomie,Governor,Chris Powell,LIB,630013,1,0,0,1,
Pottawatomie,Governor,Rex Lawhorn,LIB,630013,0,0,1,1,
Pottawatomie,Corporation Commissioner,Ashley Nicole Mccray,DEM,630013,9,7,114,130,
Pottawatomie,Corporation Commissioner,Blake Cummings,DEM,630013,8,6,57,71,
Pottawatomie,U.S. House,Kendra Horn,DEM,630013,14,12,126,152,05
Pottawatomie,U.S. House,Tom Guild,DEM,630013,5,2,51,58,05
Pottawatomie,State House,Terry Hopkins,DEM,630013,13,7,76,96,26
Pottawatomie,State House,E. Bruce Bushong,DEM,630013,6,7,110,123,26
Pottawatomie,Governor,Mick Cornett,REP,630015,8,6,97,111,
Pottawatomie,Governor,Kevin Stitt,REP,630015,8,8,100,116,
Pottawatomie,Lieutenant Governor,Dana Murphy,REP,630015,4,6,74,84,
Pottawatomie,Lieutenant Governor,Matt Pinnell,REP,630015,11,7,118,136,
Pottawatomie,State Auditor,Cindy Byrd,REP,630015,9,7,87,103,
Pottawatomie,State Auditor,Charlie Prater,REP,630015,7,6,104,117,
Pottawatomie,Attorney General,Mike Hunter,REP,630015,8,8,98,114,
Pottawatomie,Attorney General,Gentner Drummond,REP,630015,8,6,94,108,
Pottawatomie,Superintendent of Public Instruction,Joy Hofmeister,REP,630015,9,6,107,122,
Pottawatomie,Superintendent of Public Instruction,Linda Murphy,REP,630015,7,8,86,101,
Pottawatomie,Commissioner of Labor,Cathy Costello,REP,630015,8,3,96,107,
Pottawatomie,Commissioner of Labor,Leslie Osborn,REP,630015,8,10,97,115,
Pottawatomie,Corporation Commissioner,Bob Anthony,REP,630015,12,9,105,126,
Pottawatomie,Corporation Commissioner,Brian Bingman,REP,630015,4,5,87,96,
Pottawatomie,Governor,Chris Powell,LIB,630015,0,0,0,0,
Pottawatomie,Governor,Rex Lawhorn,LIB,630015,0,0,0,0,
Pottawatomie,Corporation Commissioner,Ashley Nicole Mccray,DEM,630015,8,6,80,94,
Pottawatomie,Corporation Commissioner,Blake Cummings,DEM,630015,0,2,41,43,
Pottawatomie,U.S. House,Kendra Horn,DEM,630015,5,6,80,91,05
Pottawatomie,U.S. House,Tom Guild,DEM,630015,3,2,45,50,05
Pottawatomie,State House,Terry Hopkins,DEM,630015,7,3,63,73,26
Pottawatomie,State House,E. Bruce Bushong,DEM,630015,1,5,63,69,26
Pottawatomie,Governor,Mick Cornett,REP,630018,7,8,97,112,
Pottawatomie,Governor,Kevin Stitt,REP,630018,2,3,73,78,
Pottawatomie,Lieutenant Governor,Dana Murphy,REP,630018,5,5,84,94,
Pottawatomie,Lieutenant Governor,Matt Pinnell,REP,630018,4,6,81,91,
Pottawatomie,State Auditor,Cindy Byrd,REP,630018,5,7,67,79,
Pottawatomie,State Auditor,Charlie Prater,REP,630018,4,3,95,102,
Pottawatomie,Attorney General,Mike Hunter,REP,630018,8,9,85,102,
Pottawatomie,Attorney General,Gentner Drummond,REP,630018,1,2,82,85,
Pottawatomie,Superintendent of Public Instruction,Joy Hofmeister,REP,630018,7,5,107,119,
Pottawatomie,Superintendent of Public Instruction,Linda Murphy,REP,630018,2,6,62,70,
Pottawatomie,Commissioner of Labor,Cathy Costello,REP,630018,6,2,65,73,
Pottawatomie,Commissioner of Labor,Leslie Osborn,REP,630018,3,9,101,113,
Pottawatomie,Corporation Commissioner,Bob Anthony,REP,630018,5,6,104,115,
Pottawatomie,Corporation Commissioner,Brian Bingman,REP,630018,4,5,63,72,
Pottawatomie,Governor,Chris Powell,LIB,630018,1,0,0,1,
Pottawatomie,Governor,Rex Lawhorn,LIB,630018,0,0,0,0,
Pottawatomie,Corporation Commissioner,Ashley Nicole Mccray,DEM,630018,10,2,57,69,
Pottawatomie,Corporation Commissioner,Blake Cummings,DEM,630018,0,3,35,38,
Pottawatomie,U.S. House,Kendra Horn,DEM,630018,10,4,65,79,05
Pottawatomie,U.S. House,Tom Guild,DEM,630018,0,1,29,30,05
Pottawatomie,State House,Terry Hopkins,DEM,630018,4,3,58,65,26
Pottawatomie,State House,E. Bruce Bushong,DEM,630018,6,2,37,45,26
Pottawatomie,Governor,Mick Cornett,REP,630021,2,3,60,65,
Pottawatomie,Governor,Kevin Stitt,REP,630021,4,1,83,88,
Pottawatomie,Lieutenant Governor,Dana Murphy,REP,630021,2,0,63,65,
Pottawatomie,Lieutenant Governor,Matt Pinnell,REP,630021,4,4,79,87,
Pottawatomie,State Auditor,Cindy Byrd,REP,630021,3,1,56,60,
Pottawatomie,State Auditor,Charlie Prater,REP,630021,3,2,85,90,
Pottawatomie,Attorney General,Mike Hunter,REP,630021,5,2,93,100,
Pottawatomie,Attorney General,Gentner Drummond,REP,630021,1,2,48,51,
Pottawatomie,Superintendent of Public Instruction,Joy Hofmeister,REP,630021,1,4,85,90,
Pottawatomie,Superintendent of Public Instruction,Linda Murphy,REP,630021,5,0,56,61,
Pottawatomie,Commissioner of Labor,Cathy Costello,REP,630021,2,2,62,66,
Pottawatomie,Commissioner of Labor,Leslie Osborn,REP,630021,4,2,78,84,
Pottawatomie,Corporation Commissioner,Bob Anthony,REP,630021,2,1,77,80,
Pottawatomie,Corporation Commissioner,Brian Bingman,REP,630021,4,3,63,70,
Pottawatomie,Governor,Chris Powell,LIB,630021,0,0,0,0,
Pottawatomie,Governor,Rex Lawhorn,LIB,630021,0,0,0,0,
Pottawatomie,Corporation Commissioner,Ashley Nicole Mccray,DEM,630021,0,2,36,38,
Pottawatomie,Corporation Commissioner,Blake Cummings,DEM,630021,0,0,20,20,
Pottawatomie,U.S. House,Kendra Horn,DEM,630021,0,2,30,32,05
Pottawatomie,U.S. House,Tom Guild,DEM,630021,0,0,26,26,05
Pottawatomie,State House,Terry Hopkins,DEM,630021,0,1,26,27,26
Pottawatomie,State House,E. Bruce Bushong,DEM,630021,0,1,31,32,26
Pottawatomie,Governor,Mick Cornett,REP,630022,1,6,137,144,
Pottawatomie,Governor,Kevin Stitt,REP,630022,2,10,156,168,
Pottawatomie,Lieutenant Governor,Dana Murphy,REP,630022,1,3,122,126,
Pottawatomie,Lieutenant Governor,Matt Pinnell,REP,630022,2,13,165,180,
Pottawatomie,State Auditor,Cindy Byrd,REP,630022,2,8,153,163,
Pottawatomie,State Auditor,Charlie Prater,REP,630022,1,8,132,141,
Pottawatomie,Attorney General,Mike Hunter,REP,630022,2,6,152,160,
Pottawatomie,Attorney General,Gentner Drummond,REP,630022,1,10,137,148,
Pottawatomie,Superintendent of Public Instruction,Joy Hofmeister,REP,630022,2,10,178,190,
Pottawatomie,Superintendent of Public Instruction,Linda Murphy,REP,630022,1,6,115,122,
Pottawatomie,Commissioner of Labor,Cathy Costello,REP,630022,0,7,117,124,
Pottawatomie,Commissioner of Labor,Leslie Osborn,REP,630022,3,9,170,182,
Pottawatomie,Corporation Commissioner,Bob Anthony,REP,630022,2,10,160,172,
Pottawatomie,Corporation Commissioner,Brian Bingman,REP,630022,1,6,128,135,
Pottawatomie,State House,Danny Sterling,REP,630022,1,8,191,200,27
Pottawatomie,State House,Dave Spaulding,REP,630022,1,7,96,104,27
Pottawatomie,Governor,Chris Powell,LIB,630022,0,1,1,2,
Pottawatomie,Governor,Rex Lawhorn,LIB,630022,0,0,1,1,
Pottawatomie,Corporation Commissioner,Ashley Nicole Mccray,DEM,630022,3,5,34,42,
Pottawatomie,Corporation Commissioner,Blake Cummings,DEM,630022,3,3,25,31,
Pottawatomie,U.S. House,Kendra Horn,DEM,630022,4,6,40,50,05
Pottawatomie,U.S. House,Tom Guild,DEM,630022,2,2,19,23,05
Pottawatomie,Governor,Mick Cornett,REP,630024,11,1,113,125,
Pottawatomie,Governor,Kevin Stitt,REP,630024,9,4,154,167,
Pottawatomie,Lieutenant Governor,Dana Murphy,REP,630024,10,0,105,115,
Pottawatomie,Lieutenant Governor,Matt Pinnell,REP,630024,10,5,158,173,
Pottawatomie,State Auditor,Cindy Byrd,REP,630024,14,1,108,123,
Pottawatomie,State Auditor,Charlie Prater,REP,630024,6,4,149,159,
Pottawatomie,Attorney General,Mike Hunter,REP,630024,11,1,115,127,
Pottawatomie,Attorney General,Gentner Drummond,REP,630024,9,4,149,162,
Pottawatomie,Superintendent of Public Instruction,Joy Hofmeister,REP,630024,12,3,154,169,
Pottawatomie,Superintendent of Public Instruction,Linda Murphy,REP,630024,7,2,107,116,
Pottawatomie,Commissioner of Labor,Cathy Costello,REP,630024,13,3,121,137,
Pottawatomie,Commissioner of Labor,Leslie Osborn,REP,630024,7,2,140,149,
Pottawatomie,Corporation Commissioner,Bob Anthony,REP,630024,13,2,148,163,
Pottawatomie,Corporation Commissioner,Brian Bingman,REP,630024,7,3,111,121,
Pottawatomie,Governor,Chris Powell,LIB,630024,0,0,1,1,
Pottawatomie,Governor,Rex Lawhorn,LIB,630024,0,0,0,0,
Pottawatomie,Corporation Commissioner,Ashley Nicole Mccray,DEM,630024,9,2,33,44,
Pottawatomie,Corporation Commissioner,Blake Cummings,DEM,630024,5,0,26,31,
Pottawatomie,U.S. House,Kendra Horn,DEM,630024,11,2,38,51,05
Pottawatomie,U.S. House,Tom Guild,DEM,630024,4,0,22,26,05
Pottawatomie,Governor,Mick Cornett,REP,630025,0,2,60,62,
Pottawatomie,Governor,Kevin Stitt,REP,630025,9,0,107,116,
Pottawatomie,Lieutenant Governor,Dana Murphy,REP,630025,4,0,61,65,
Pottawatomie,Lieutenant Governor,Matt Pinnell,REP,630025,5,2,101,108,
Pottawatomie,State Auditor,Cindy Byrd,REP,630025,6,0,71,77,
Pottawatomie,State Auditor,Charlie Prater,REP,630025,3,2,87,92,
Pottawatomie,Attorney General,Mike Hunter,REP,630025,7,0,84,91,
Pottawatomie,Attorney General,Gentner Drummond,REP,630025,2,2,83,87,
Pottawatomie,Superintendent of Public Instruction,Joy Hofmeister,REP,630025,4,2,89,95,
Pottawatomie,Superintendent of Public Instruction,Linda Murphy,REP,630025,5,0,72,77,
Pottawatomie,Commissioner of Labor,Cathy Costello,REP,630025,7,0,76,83,
Pottawatomie,Commissioner of Labor,Leslie Osborn,REP,630025,2,2,81,85,
Pottawatomie,Corporation Commissioner,Bob Anthony,REP,630025,6,0,75,81,
Pottawatomie,Corporation Commissioner,Brian Bingman,REP,630025,3,2,88,93,
Pottawatomie,Governor,Chris Powell,LIB,630025,0,0,2,2,
Pottawatomie,Governor,Rex Lawhorn,LIB,630025,0,0,0,0,
Pottawatomie,Corporation Commissioner,Ashley Nicole Mccray,DEM,630025,3,0,29,32,
Pottawatomie,Corporation Commissioner,Blake Cummings,DEM,630025,0,0,28,28,
Pottawatomie,U.S. House,Kendra Horn,DEM,630025,3,0,32,35,05
Pottawatomie,U.S. House,Tom Guild,DEM,630025,0,0,25,25,05
Pottawatomie,Governor,Mick Cornett,REP,630026,5,0,77,82,
Pottawatomie,Governor,Kevin Stitt,REP,630026,6,6,99,111,
Pottawatomie,Lieutenant Governor,Dana Murphy,REP,630026,4,3,62,69,
Pottawatomie,Lieutenant Governor,Matt Pinnell,REP,630026,7,3,110,120,
Pottawatomie,State Auditor,Cindy Byrd,REP,630026,7,2,73,82,
Pottawatomie,State Auditor,Charlie Prater,REP,630026,4,4,95,103,
Pottawatomie,Attorney General,Mike Hunter,REP,630026,6,4,73,83,
Pottawatomie,Attorney General,Gentner Drummond,REP,630026,5,2,98,105,
Pottawatomie,Superintendent of Public Instruction,Joy Hofmeister,REP,630026,6,4,106,116,
Pottawatomie,Superintendent of Public Instruction,Linda Murphy,REP,630026,5,2,67,74,
Pottawatomie,Commissioner of Labor,Cathy Costello,REP,630026,8,3,86,97,
Pottawatomie,Commissioner of Labor,Leslie Osborn,REP,630026,1,3,86,90,
Pottawatomie,Corporation Commissioner,Bob Anthony,REP,630026,9,4,94,107,
Pottawatomie,Corporation Commissioner,Brian Bingman,REP,630026,0,2,78,80,
Pottawatomie,Governor,Chris Powell,LIB,630026,0,0,0,0,
Pottawatomie,Governor,Rex Lawhorn,LIB,630026,0,0,0,0,
Pottawatomie,Corporation Commissioner,Ashley Nicole Mccray,DEM,630026,0,1,40,41,
Pottawatomie,Corporation Commissioner,Blake Cummings,DEM,630026,3,0,15,18,
Pottawatomie,U.S. House,Kendra Horn,DEM,630026,4,0,38,42,05
Pottawatomie,U.S. House,Tom Guild,DEM,630026,0,1,19,20,05
Pottawatomie,State House,Terry Hopkins,DEM,630026,2,1,29,32,26
Pottawatomie,State House,E. Bruce Bushong,DEM,630026,2,0,28,30,26
Pottawatomie,Governor,Mick Cornett,REP,630027,1,1,66,68,
Pottawatomie,Governor,Kevin Stitt,REP,630027,4,2,136,142,
Pottawatomie,Lieutenant Governor,Dana Murphy,REP,630027,1,2,65,68,
Pottawatomie,Lieutenant Governor,Matt Pinnell,REP,630027,4,1,134,139,
Pottawatomie,State Auditor,Cindy Byrd,REP,630027,4,3,94,101,
Pottawatomie,State Auditor,Charlie Prater,REP,630027,0,0,106,106,
Pottawatomie,Attorney General,Mike Hunter,REP,630027,1,1,84,86,
Pottawatomie,Attorney General,Gentner Drummond,REP,630027,4,2,116,122,
Pottawatomie,Superintendent of Public Instruction,Joy Hofmeister,REP,630027,3,2,102,107,
Pottawatomie,Superintendent of Public Instruction,Linda Murphy,REP,630027,2,1,96,99,
Pottawatomie,Commissioner of Labor,Cathy Costello,REP,630027,2,1,92,95,
Pottawatomie,Commissioner of Labor,Leslie Osborn,REP,630027,2,2,106,110,
Pottawatomie,Corporation Commissioner,Bob Anthony,REP,630027,2,1,100,103,
Pottawatomie,Corporation Commissioner,Brian Bingman,REP,630027,2,2,100,104,
Pottawatomie,State House,Danny Sterling,REP,630027,5,3,124,132,27
Pottawatomie,State House,Dave Spaulding,REP,630027,0,0,75,75,27
Pottawatomie,Governor,Chris Powell,LIB,630027,0,0,0,0,
Pottawatomie,Governor,Rex Lawhorn,LIB,630027,0,0,1,1,
Pottawatomie,Corporation Commissioner,Ashley Nicole Mccray,DEM,630027,1,0,32,33,
Pottawatomie,Corporation Commissioner,Blake Cummings,DEM,630027,1,1,18,20,
Pottawatomie,U.S. House,Kendra Horn,DEM,630027,2,1,29,32,05
Pottawatomie,U.S. House,Tom Guild,DEM,630027,0,0,21,21,05
Pottawatomie,Governor,Mick Cornett,REP,630029,8,6,160,174,
Pottawatomie,Governor,Kevin Stitt,REP,630029,4,6,122,132,
Pottawatomie,Lieutenant Governor,Dana Murphy,REP,630029,9,6,128,143,
Pottawatomie,Lieutenant Governor,Matt Pinnell,REP,630029,4,5,143,152,
Pottawatomie,State Auditor,Cindy Byrd,REP,630029,11,7,144,162,
Pottawatomie,State Auditor,Charlie Prater,REP,630029,2,4,122,128,
Pottawatomie,Attorney General,Mike Hunter,REP,630029,10,3,166,179,
Pottawatomie,Attorney General,Gentner Drummond,REP,630029,3,8,105,116,
Pottawatomie,Superintendent of Public Instruction,Joy Hofmeister,REP,630029,3,7,163,173,
Pottawatomie,Superintendent of Public Instruction,Linda Murphy,REP,630029,10,5,117,132,
Pottawatomie,Commissioner of Labor,Cathy Costello,REP,630029,8,3,132,143,
Pottawatomie,Commissioner of Labor,Leslie Osborn,REP,630029,5,9,139,153,
Pottawatomie,Corporation Commissioner,Bob Anthony,REP,630029,7,10,158,175,
Pottawatomie,Corporation Commissioner,Brian Bingman,REP,630029,6,2,110,118,
Pottawatomie,State House,Danny Sterling,REP,630029,12,10,223,245,27
Pottawatomie,State House,Dave Spaulding,REP,630029,1,2,62,65,27
Pottawatomie,Governor,Chris Powell,LIB,630029,0,0,1,1,
Pottawatomie,Governor,Rex Lawhorn,LIB,630029,0,0,1,1,
Pottawatomie,Corporation Commissioner,Ashley Nicole Mccray,DEM,630029,7,5,52,64,
Pottawatomie,Corporation Commissioner,Blake Cummings,DEM,630029,3,1,44,48,
Pottawatomie,U.S. House,Kendra Horn,DEM,630029,7,5,41,53,05
Pottawatomie,U.S. House,Tom Guild,DEM,630029,3,1,54,58,05
Pottawatomie,Governor,Mick Cornett,REP,630030,9,12,173,194,
Pottawatomie,Governor,Kevin Stitt,REP,630030,5,7,185,197,
Pottawatomie,Lieutenant Governor,Dana Murphy,REP,630030,5,10,167,182,
Pottawatomie,Lieutenant Governor,Matt Pinnell,REP,630030,9,9,182,200,
Pottawatomie,State Auditor,Cindy Byrd,REP,630030,10,12,192,214,
Pottawatomie,State Auditor,Charlie Prater,REP,630030,4,7,159,170,
Pottawatomie,Attorney General,Mike Hunter,REP,630030,7,10,188,205,
Pottawatomie,Attorney General,Gentner Drummond,REP,630030,7,9,158,174,
Pottawatomie,Superintendent of Public Instruction,Joy Hofmeister,REP,630030,8,11,208,227,
Pottawatomie,Superintendent of Public Instruction,Linda Murphy,REP,630030,6,8,145,159,
Pottawatomie,Commissioner of Labor,Cathy Costello,REP,630030,8,11,150,169,
Pottawatomie,Commissioner of Labor,Leslie Osborn,REP,630030,6,8,188,202,
Pottawatomie,Corporation Commissioner,Bob Anthony,REP,630030,9,15,194,218,
Pottawatomie,Corporation Commissioner,Brian Bingman,REP,630030,5,4,152,161,
Pottawatomie,State House,Danny Sterling,REP,630030,7,11,273,291,27
Pottawatomie,State House,Dave Spaulding,REP,630030,7,8,84,99,27
Pottawatomie,Governor,Chris Powell,LIB,630030,0,0,0,0,
Pottawatomie,Governor,Rex Lawhorn,LIB,630030,0,0,0,0,
Pottawatomie,Corporation Commissioner,Ashley Nicole Mccray,DEM,630030,6,4,97,107,
Pottawatomie,Corporation Commissioner,Blake Cummings,DEM,630030,0,3,46,49,
Pottawatomie,U.S. House,Kendra Horn,DEM,630030,4,4,100,108,05
Pottawatomie,U.S. House,Tom Guild,DEM,630030,2,3,44,49,05
Pottawatomie,Governor,Mick Cornett,REP,630031,20,9,170,199,
Pottawatomie,Governor,Kevin Stitt,REP,630031,13,19,188,220,
Pottawatomie,Lieutenant Governor,Dana Murphy,REP,630031,17,11,128,156,
Pottawatomie,Lieutenant Governor,Matt Pinnell,REP,630031,16,17,229,262,
Pottawatomie,State Auditor,Cindy Byrd,REP,630031,22,14,163,199,
Pottawatomie,State Auditor,Charlie Prater,REP,630031,11,13,183,207,
Pottawatomie,Attorney General,Mike Hunter,REP,630031,15,14,164,193,
Pottawatomie,Attorney General,Gentner Drummond,REP,630031,18,14,191,223,
Pottawatomie,Superintendent of Public Instruction,Joy Hofmeister,REP,630031,19,16,200,235,
Pottawatomie,Superintendent of Public Instruction,Linda Murphy,REP,630031,14,10,155,179,
Pottawatomie,Commissioner of Labor,Cathy Costello,REP,630031,17,11,167,195,
Pottawatomie,Commissioner of Labor,Leslie Osborn,REP,630031,16,15,184,215,
Pottawatomie,Corporation Commissioner,Bob Anthony,REP,630031,23,11,189,223,
Pottawatomie,Corporation Commissioner,Brian Bingman,REP,630031,10,17,164,191,
Pottawatomie,Governor,Chris Powell,LIB,630031,0,0,2,2,
Pottawatomie,Governor,Rex Lawhorn,LIB,630031,0,0,1,1,
Pottawatomie,Corporation Commissioner,Ashley Nicole Mccray,DEM,630031,5,10,79,94,
Pottawatomie,Corporation Commissioner,Blake Cummings,DEM,630031,4,4,46,54,
Pottawatomie,U.S. House,Kendra Horn,DEM,630031,6,10,86,102,05
Pottawatomie,U.S. House,Tom Guild,DEM,630031,3,4,39,46,05
Pottawatomie,Governor,Mick Cornett,REP,630033,2,1,43,46,
Pottawatomie,Governor,Kevin Stitt,REP,630033,1,0,66,67,
Pottawatomie,Lieutenant Governor,Dana Murphy,REP,630033,1,0,33,34,
Pottawatomie,Lieutenant Governor,Matt Pinnell,REP,630033,2,1,72,75,
Pottawatomie,State Auditor,Cindy Byrd,REP,630033,1,0,50,51,
Pottawatomie,State Auditor,Charlie Prater,REP,630033,2,1,53,56,
Pottawatomie,Attorney General,Mike Hunter,REP,630033,2,1,67,70,
Pottawatomie,Attorney General,Gentner Drummond,REP,630033,1,0,42,43,
Pottawatomie,Superintendent of Public Instruction,Joy Hofmeister,REP,630033,1,1,57,59,
Pottawatomie,Superintendent of Public Instruction,Linda Murphy,REP,630033,2,0,49,51,
Pottawatomie,Commissioner of Labor,Cathy Costello,REP,630033,1,0,50,51,
Pottawatomie,Commissioner of Labor,Leslie Osborn,REP,630033,2,1,54,57,
Pottawatomie,Corporation Commissioner,Bob Anthony,REP,630033,2,0,63,65,
Pottawatomie,Corporation Commissioner,Brian Bingman,REP,630033,1,1,43,45,
Pottawatomie,State House,Danny Sterling,REP,630033,3,1,67,71,27
Pottawatomie,State House,Dave Spaulding,REP,630033,0,0,41,41,27
Pottawatomie,Governor,Chris Powell,LIB,630033,0,0,0,0,
Pottawatomie,Governor,Rex Lawhorn,LIB,630033,0,0,0,0,
Pottawatomie,Corporation Commissioner,Ashley Nicole Mccray,DEM,630033,1,0,22,23,
Pottawatomie,Corporation Commissioner,Blake Cummings,DEM,630033,0,0,19,19,
Pottawatomie,U.S. House,Kendra Horn,DEM,630033,1,0,18,19,05
Pottawatomie,U.S. House,Tom Guild,DEM,630033,0,0,24,24,05
Pottawatomie,Governor,Mick Cornett,REP,630037,1,1,54,56,
Pottawatomie,Governor,Kevin Stitt,REP,630037,0,4,84,88,
Pottawatomie,Lieutenant Governor,Dana Murphy,REP,630037,1,2,54,57,
Pottawatomie,Lieutenant Governor,Matt Pinnell,REP,630037,0,3,81,84,
Pottawatomie,State Auditor,Cindy Byrd,REP,630037,1,4,64,69,
Pottawatomie,State Auditor,Charlie Prater,REP,630037,0,1,66,67,
Pottawatomie,Attorney General,Mike Hunter,REP,630037,1,3,62,66,
Pottawatomie,Attorney General,Gentner Drummond,REP,630037,0,2,72,74,
Pottawatomie,Superintendent of Public Instruction,Joy Hofmeister,REP,630037,1,2,60,63,
Pottawatomie,Superintendent of Public Instruction,Linda Murphy,REP,630037,0,3,74,77,
Pottawatomie,Commissioner of Labor,Cathy Costello,REP,630037,1,0,53,54,
Pottawatomie,Commissioner of Labor,Leslie Osborn,REP,630037,0,5,74,79,
Pottawatomie,Corporation Commissioner,Bob Anthony,REP,630037,1,3,71,75,
Pottawatomie,Corporation Commissioner,Brian Bingman,REP,630037,0,2,64,66,
Pottawatomie,State House,Danny Sterling,REP,630037,1,3,70,74,27
Pottawatomie,State House,Dave Spaulding,REP,630037,0,2,62,64,27
Pottawatomie,Governor,Chris Powell,LIB,630037,0,0,1,1,
Pottawatomie,Governor,Rex Lawhorn,LIB,630037,0,0,1,1,
Pottawatomie,Corporation Commissioner,Ashley Nicole Mccray,DEM,630037,2,0,28,30,
Pottawatomie,Corporation Commissioner,Blake Cummings,DEM,630037,0,1,7,8,
Pottawatomie,U.S. House,Kendra Horn,DEM,630037,2,0,24,26,05
Pottawatomie,U.S. House,Tom Guild,DEM,630037,0,1,11,12,05
Pottawatomie,Governor,Mick Cornett,REP,630038,2,0,22,24,
Pottawatomie,Governor,Kevin Stitt,REP,630038,4,4,43,51,
Pottawatomie,Lieutenant Governor,Dana Murphy,REP,630038,4,2,17,23,
Pottawatomie,Lieutenant Governor,Matt Pinnell,REP,630038,2,2,48,52,
Pottawatomie,State Auditor,Cindy Byrd,REP,630038,5,0,31,36,
Pottawatomie,State Auditor,Charlie Prater,REP,630038,1,3,33,37,
Pottawatomie,Attorney General,Mike Hunter,REP,630038,4,4,33,41,
Pottawatomie,Attorney General,Gentner Drummond,REP,630038,2,0,32,34,
Pottawatomie,Superintendent of Public Instruction,Joy Hofmeister,REP,630038,3,2,29,34,
Pottawatomie,Superintendent of Public Instruction,Linda Murphy,REP,630038,3,2,34,39,
Pottawatomie,Commissioner of Labor,Cathy Costello,REP,630038,1,4,32,37,
Pottawatomie,Commissioner of Labor,Leslie Osborn,REP,630038,5,0,32,37,
Pottawatomie,Corporation Commissioner,Bob Anthony,REP,630038,0,3,28,31,
Pottawatomie,Corporation Commissioner,Brian Bingman,REP,630038,6,1,36,43,
Pottawatomie,State House,Danny Sterling,REP,630038,3,2,35,40,27
Pottawatomie,State House,Dave Spaulding,REP,630038,3,2,29,34,27
Pottawatomie,Governor,Chris Powell,LIB,630038,0,0,0,0,
Pottawatomie,Governor,Rex Lawhorn,LIB,630038,0,0,0,0,
Pottawatomie,Corporation Commissioner,Ashley Nicole Mccray,DEM,630038,3,1,27,31,
Pottawatomie,Corporation Commissioner,Blake Cummings,DEM,630038,1,0,23,24,
Pottawatomie,U.S. House,Kendra Horn,DEM,630038,4,0,28,32,05
Pottawatomie,U.S. House,Tom Guild,DEM,630038,0,1,22,23,05
Pottawatomie,Governor,Mick Cornett,REP,630040,1,2,33,36,
Pottawatomie,Governor,Kevin Stitt,REP,630040,1,0,35,36,
Pottawatomie,Lieutenant Governor,Dana Murphy,REP,630040,0,0,23,23,
Pottawatomie,Lieutenant Governor,Matt Pinnell,REP,630040,2,2,43,47,
Pottawatomie,State Auditor,Cindy Byrd,REP,630040,1,1,35,37,
Pottawatomie,State Auditor,Charlie Prater,REP,630040,1,1,31,33,
Pottawatomie,Attorney General,Mike Hunter,REP,630040,1,0,42,43,
Pottawatomie,Attorney General,Gentner Drummond,REP,630040,1,1,25,27,
Pottawatomie,Superintendent of Public Instruction,Joy Hofmeister,REP,630040,0,1,34,35,
Pottawatomie,Superintendent of Public Instruction,Linda Murphy,REP,630040,2,1,33,36,
Pottawatomie,Commissioner of Labor,Cathy Costello,REP,630040,1,0,30,31,
Pottawatomie,Commissioner of Labor,Leslie Osborn,REP,630040,1,2,35,38,
Pottawatomie,Corporation Commissioner,Bob Anthony,REP,630040,2,0,33,35,
Pottawatomie,Corporation Commissioner,Brian Bingman,REP,630040,0,2,33,35,
Pottawatomie,State House,Danny Sterling,REP,630040,1,2,34,37,27
Pottawatomie,State House,Dave Spaulding,REP,630040,1,0,33,34,27
Pottawatomie,Governor,Chris Powell,LIB,630040,0,0,0,0,
Pottawatomie,Governor,Rex Lawhorn,LIB,630040,0,0,0,0,
Pottawatomie,Corporation Commissioner,Ashley Nicole Mccray,DEM,630040,2,0,16,18,
Pottawatomie,Corporation Commissioner,Blake Cummings,DEM,630040,1,0,24,25,
Pottawatomie,U.S. House,Kendra Horn,DEM,630040,1,0,14,15,05
Pottawatomie,U.S. House,Tom Guild,DEM,630040,2,0,26,28,05
Pottawatomie,Governor,Mick Cornett,REP,630041,0,0,38,38,
Pottawatomie,Governor,Kevin Stitt,REP,630041,1,0,58,59,
Pottawatomie,Lieutenant Governor,Dana Murphy,REP,630041,1,0,34,35,
Pottawatomie,Lieutenant Governor,Matt Pinnell,REP,630041,0,0,58,58,
Pottawatomie,State Auditor,Cindy Byrd,REP,630041,1,0,39,40,
Pottawatomie,State Auditor,Charlie Prater,REP,630041,0,0,52,52,
Pottawatomie,Attorney General,Mike Hunter,REP,630041,0,0,42,42,
Pottawatomie,Attorney General,Gentner Drummond,REP,630041,1,0,50,51,
Pottawatomie,Superintendent of Public Instruction,Joy Hofmeister,REP,630041,0,0,51,51,
Pottawatomie,Superintendent of Public Instruction,Linda Murphy,REP,630041,1,0,41,42,
Pottawatomie,Commissioner of Labor,Cathy Costello,REP,630041,0,0,32,32,
Pottawatomie,Commissioner of Labor,Leslie Osborn,REP,630041,1,0,59,60,
Pottawatomie,Corporation Commissioner,Bob Anthony,REP,630041,0,0,45,45,
Pottawatomie,Corporation Commissioner,Brian Bingman,REP,630041,1,0,46,47,
Pottawatomie,State House,Danny Sterling,REP,630041,0,0,41,41,27
Pottawatomie,State House,Dave Spaulding,REP,630041,1,0,53,54,27
Pottawatomie,Governor,Chris Powell,LIB,630041,0,0,0,0,
Pottawatomie,Governor,Rex Lawhorn,LIB,630041,0,0,0,0,
Pottawatomie,Corporation Commissioner,Ashley Nicole Mccray,DEM,630041,1,0,27,28,
Pottawatomie,Corporation Commissioner,Blake Cummings,DEM,630041,0,0,22,22,
Pottawatomie,U.S. House,Kendra Horn,DEM,630041,0,0,23,23,05
Pottawatomie,U.S. House,Tom Guild,DEM,630041,1,0,26,27,05
Pottawatomie,Governor,Mick Cornett,REP,630042,2,0,32,34,
Pottawatomie,Governor,Kevin Stitt,REP,630042,1,2,36,39,
Pottawatomie,Lieutenant Governor,Dana Murphy,REP,630042,3,1,23,27,
Pottawatomie,Lieutenant Governor,Matt Pinnell,REP,630042,0,1,42,43,
Pottawatomie,State Auditor,Cindy Byrd,REP,630042,3,0,36,39,
Pottawatomie,State Auditor,Charlie Prater,REP,630042,0,2,30,32,
Pottawatomie,Attorney General,Mike Hunter,REP,630042,3,0,35,38,
Pottawatomie,Attorney General,Gentner Drummond,REP,630042,0,2,31,33,
Pottawatomie,Superintendent of Public Instruction,Joy Hofmeister,REP,630042,0,2,39,41,
Pottawatomie,Superintendent of Public Instruction,Linda Murphy,REP,630042,3,0,26,29,
Pottawatomie,Commissioner of Labor,Cathy Costello,REP,630042,0,0,30,30,
Pottawatomie,Commissioner of Labor,Leslie Osborn,REP,630042,3,2,36,41,
Pottawatomie,Corporation Commissioner,Bob Anthony,REP,630042,1,0,35,36,
Pottawatomie,Corporation Commissioner,Brian Bingman,REP,630042,2,2,33,37,
Pottawatomie,State House,Bobby Cleveland,REP,630042,0,2,33,35,20
Pottawatomie,State House,Sherrie Conley,REP,630042,3,0,33,36,20
Pottawatomie,Governor,Chris Powell,LIB,630042,0,0,0,0,
Pottawatomie,Governor,Rex Lawhorn,LIB,630042,0,0,0,0,
Pottawatomie,Corporation Commissioner,Ashley Nicole Mccray,DEM,630042,0,0,20,20,
Pottawatomie,Corporation Commissioner,Blake Cummings,DEM,630042,0,0,12,12,
Pottawatomie,U.S. House,Kendra Horn,DEM,630042,0,0,20,20,05
Pottawatomie,U.S. House,Tom Guild,DEM,630042,0,0,12,12,05
Pushmataha,Governor,Mick Cornett,REP,640001,0,1,5,6,
Pushmataha,Governor,Kevin Stitt,REP,640001,0,1,13,14,
Pushmataha,Lieutenant Governor,Dana Murphy,REP,640001,0,1,5,6,
Pushmataha,Lieutenant Governor,Matt Pinnell,REP,640001,0,1,11,12,
Pushmataha,State Auditor,Cindy Byrd,REP,640001,0,1,6,7,
Pushmataha,State Auditor,Charlie Prater,REP,640001,0,1,8,9,
Pushmataha,Attorney General,Mike Hunter,REP,640001,0,1,5,6,
Pushmataha,Attorney General,Gentner Drummond,REP,640001,0,1,12,13,
Pushmataha,Superintendent of Public Instruction,Joy Hofmeister,REP,640001,0,1,8,9,
Pushmataha,Superintendent of Public Instruction,Linda Murphy,REP,640001,0,1,4,5,
Pushmataha,Commissioner of Labor,Cathy Costello,REP,640001,0,2,11,13,
Pushmataha,Commissioner of Labor,Leslie Osborn,REP,640001,0,0,3,3,
Pushmataha,Corporation Commissioner,Bob Anthony,REP,640001,0,1,8,9,
Pushmataha,Corporation Commissioner,Brian Bingman,REP,640001,0,1,7,8,
Pushmataha,Governor,Chris Powell,LIB,640001,0,0,0,0,
Pushmataha,Governor,Rex Lawhorn,LIB,640001,0,0,0,0,
Pushmataha,Corporation Commissioner,Ashley Nicole Mccray,DEM,640001,0,1,18,19,
Pushmataha,Corporation Commissioner,Blake Cummings,DEM,640001,1,4,21,26,
Pushmataha,U.S. House,Jason Nichols,DEM,640001,0,1,11,12,02
Pushmataha,U.S. House,Clay Padgett,DEM,640001,1,5,29,35,02
Pushmataha,Governor,Mick Cornett,REP,640002,0,0,4,4,
Pushmataha,Governor,Kevin Stitt,REP,640002,0,8,25,33,
Pushmataha,Lieutenant Governor,Dana Murphy,REP,640002,0,2,11,13,
Pushmataha,Lieutenant Governor,Matt Pinnell,REP,640002,0,5,18,23,
Pushmataha,State Auditor,Cindy Byrd,REP,640002,0,5,21,26,
Pushmataha,State Auditor,Charlie Prater,REP,640002,0,2,8,10,
Pushmataha,Attorney General,Mike Hunter,REP,640002,0,3,11,14,
Pushmataha,Attorney General,Gentner Drummond,REP,640002,0,4,18,22,
Pushmataha,Superintendent of Public Instruction,Joy Hofmeister,REP,640002,0,3,12,15,
Pushmataha,Superintendent of Public Instruction,Linda Murphy,REP,640002,0,5,17,22,
Pushmataha,Commissioner of Labor,Cathy Costello,REP,640002,0,5,14,19,
Pushmataha,Commissioner of Labor,Leslie Osborn,REP,640002,0,3,14,17,
Pushmataha,Corporation Commissioner,Bob Anthony,REP,640002,0,4,12,16,
Pushmataha,Corporation Commissioner,Brian Bingman,REP,640002,0,2,16,18,
Pushmataha,Governor,Chris Powell,LIB,640002,0,0,0,0,
Pushmataha,Governor,Rex Lawhorn,LIB,640002,0,0,0,0,
Pushmataha,Corporation Commissioner,Ashley Nicole Mccray,DEM,640002,2,3,35,40,
Pushmataha,Corporation Commissioner,Blake Cummings,DEM,640002,0,7,62,69,
Pushmataha,U.S. House,Jason Nichols,DEM,640002,1,1,26,28,02
Pushmataha,U.S. House,Clay Padgett,DEM,640002,1,10,74,85,02
Pushmataha,Governor,Mick Cornett,REP,640003,0,0,6,6,
Pushmataha,Governor,Kevin Stitt,REP,640003,0,0,18,18,
Pushmataha,Lieutenant Governor,Dana Murphy,REP,640003,0,0,10,10,
Pushmataha,Lieutenant Governor,Matt Pinnell,REP,640003,0,0,14,14,
Pushmataha,State Auditor,Cindy Byrd,REP,640003,0,0,13,13,
Pushmataha,State Auditor,Charlie Prater,REP,640003,0,0,10,10,
Pushmataha,Attorney General,Mike Hunter,REP,640003,0,0,9,9,
Pushmataha,Attorney General,Gentner Drummond,REP,640003,0,0,14,14,
Pushmataha,Superintendent of Public Instruction,Joy Hofmeister,REP,640003,0,0,10,10,
Pushmataha,Superintendent of Public Instruction,Linda Murphy,REP,640003,0,0,12,12,
Pushmataha,Commissioner of Labor,Cathy Costello,REP,640003,0,0,18,18,
Pushmataha,Commissioner of Labor,Leslie Osborn,REP,640003,0,0,5,5,
Pushmataha,Corporation Commissioner,Bob Anthony,REP,640003,0,0,14,14,
Pushmataha,Corporation Commissioner,Brian Bingman,REP,640003,0,0,10,10,
Pushmataha,Governor,Chris Powell,LIB,640003,0,0,0,0,
Pushmataha,Governor,Rex Lawhorn,LIB,640003,0,0,0,0,
Pushmataha,Corporation Commissioner,Ashley Nicole Mccray,DEM,640003,0,1,17,18,
Pushmataha,Corporation Commissioner,Blake Cummings,DEM,640003,1,3,26,30,
Pushmataha,U.S. House,Jason Nichols,DEM,640003,0,1,10,11,02
Pushmataha,U.S. House,Clay Padgett,DEM,640003,1,3,37,41,02
Pushmataha,Governor,Mick Cornett,REP,640004,0,0,13,13,
Pushmataha,Governor,Kevin Stitt,REP,640004,0,1,23,24,
Pushmataha,Lieutenant Governor,Dana Murphy,REP,640004,0,0,9,9,
Pushmataha,Lieutenant Governor,Matt Pinnell,REP,640004,0,1,27,28,
Pushmataha,State Auditor,Cindy Byrd,REP,640004,0,1,23,24,
Pushmataha,State Auditor,Charlie Prater,REP,640004,0,0,13,13,
Pushmataha,Attorney General,Mike Hunter,REP,640004,0,0,17,17,
Pushmataha,Attorney General,Gentner Drummond,REP,640004,0,1,19,20,
Pushmataha,Superintendent of Public Instruction,Joy Hofmeister,REP,640004,0,1,14,15,
Pushmataha,Superintendent of Public Instruction,Linda Murphy,REP,640004,0,0,22,22,
Pushmataha,Commissioner of Labor,Cathy Costello,REP,640004,0,0,27,27,
Pushmataha,Commissioner of Labor,Leslie Osborn,REP,640004,0,1,9,10,
Pushmataha,Corporation Commissioner,Bob Anthony,REP,640004,0,0,21,21,
Pushmataha,Corporation Commissioner,Brian Bingman,REP,640004,0,1,15,16,
Pushmataha,Governor,Chris Powell,LIB,640004,0,0,0,0,
Pushmataha,Governor,Rex Lawhorn,LIB,640004,0,0,0,0,
Pushmataha,Corporation Commissioner,Ashley Nicole Mccray,DEM,640004,1,0,25,26,
Pushmataha,Corporation Commissioner,Blake Cummings,DEM,640004,1,3,32,36,
Pushmataha,U.S. House,Jason Nichols,DEM,640004,1,1,14,16,02
Pushmataha,U.S. House,Clay Padgett,DEM,640004,2,3,46,51,02
Pushmataha,Governor,Mick Cornett,REP,640005,0,0,1,1,
Pushmataha,Governor,Kevin Stitt,REP,640005,0,0,8,8,
Pushmataha,Lieutenant Governor,Dana Murphy,REP,640005,0,0,5,5,
Pushmataha,Lieutenant Governor,Matt Pinnell,REP,640005,0,0,4,4,
Pushmataha,State Auditor,Cindy Byrd,REP,640005,0,0,9,9,
Pushmataha,State Auditor,Charlie Prater,REP,640005,0,0,0,0,
Pushmataha,Attorney General,Mike Hunter,REP,640005,0,0,3,3,
Pushmataha,Attorney General,Gentner Drummond,REP,640005,0,0,6,6,
Pushmataha,Superintendent of Public Instruction,Joy Hofmeister,REP,640005,0,0,3,3,
Pushmataha,Superintendent of Public Instruction,Linda Murphy,REP,640005,0,0,5,5,
Pushmataha,Commissioner of Labor,Cathy Costello,REP,640005,0,0,6,6,
Pushmataha,Commissioner of Labor,Leslie Osborn,REP,640005,0,0,3,3,
Pushmataha,Corporation Commissioner,Bob Anthony,REP,640005,0,0,5,5,
Pushmataha,Corporation Commissioner,Brian Bingman,REP,640005,0,0,4,4,
Pushmataha,Governor,Chris Powell,LIB,640005,0,0,0,0,
Pushmataha,Governor,Rex Lawhorn,LIB,640005,0,0,0,0,
Pushmataha,Corporation Commissioner,Ashley Nicole Mccray,DEM,640005,0,1,9,10,
Pushmataha,Corporation Commissioner,Blake Cummings,DEM,640005,0,0,10,10,
Pushmataha,U.S. House,Jason Nichols,DEM,640005,0,0,5,5,02
Pushmataha,U.S. House,Clay Padgett,DEM,640005,0,1,16,17,02
Pushmataha,Governor,Mick Cornett,REP,640007,0,0,2,2,
Pushmataha,Governor,Kevin Stitt,REP,640007,0,0,3,3,
Pushmataha,Lieutenant Governor,Dana Murphy,REP,640007,0,0,1,1,
Pushmataha,Lieutenant Governor,Matt Pinnell,REP,640007,0,0,4,4,
Pushmataha,State Auditor,Cindy Byrd,REP,640007,0,0,5,5,
Pushmataha,State Auditor,Charlie Prater,REP,640007,0,0,0,0,
Pushmataha,Attorney General,Mike Hunter,REP,640007,0,0,2,2,
Pushmataha,Attorney General,Gentner Drummond,REP,640007,0,0,3,3,
Pushmataha,Superintendent of Public Instruction,Joy Hofmeister,REP,640007,0,0,1,1,
Pushmataha,Superintendent of Public Instruction,Linda Murphy,REP,640007,0,0,4,4,
Pushmataha,Commissioner of Labor,Cathy Costello,REP,640007,0,0,3,3,
Pushmataha,Commissioner of Labor,Leslie Osborn,REP,640007,0,0,2,2,
Pushmataha,Corporation Commissioner,Bob Anthony,REP,640007,0,0,1,1,
Pushmataha,Corporation Commissioner,Brian Bingman,REP,640007,0,0,4,4,
Pushmataha,Governor,Chris Powell,LIB,640007,0,0,0,0,
Pushmataha,Governor,Rex Lawhorn,LIB,640007,0,0,0,0,
Pushmataha,Corporation Commissioner,Ashley Nicole Mccray,DEM,640007,1,0,22,23,
Pushmataha,Corporation Commissioner,Blake Cummings,DEM,640007,0,0,8,8,
Pushmataha,U.S. House,Jason Nichols,DEM,640007,1,0,16,17,02
Pushmataha,U.S. House,Clay Padgett,DEM,640007,0,0,15,15,02
Pushmataha,Governor,Mick Cornett,REP,640008,0,0,0,0,
Pushmataha,Governor,Kevin Stitt,REP,640008,0,0,6,6,
Pushmataha,Lieutenant Governor,Dana Murphy,REP,640008,0,0,0,0,
Pushmataha,Lieutenant Governor,Matt Pinnell,REP,640008,0,0,5,5,
Pushmataha,State Auditor,Cindy Byrd,REP,640008,0,0,1,1,
Pushmataha,State Auditor,Charlie Prater,REP,640008,0,0,4,4,
Pushmataha,Attorney General,Mike Hunter,REP,640008,0,0,1,1,
Pushmataha,Attorney General,Gentner Drummond,REP,640008,0,0,4,4,
Pushmataha,Superintendent of Public Instruction,Joy Hofmeister,REP,640008,0,0,4,4,
Pushmataha,Superintendent of Public Instruction,Linda Murphy,REP,640008,0,0,1,1,
Pushmataha,Commissioner of Labor,Cathy Costello,REP,640008,0,0,0,0,
Pushmataha,Commissioner of Labor,Leslie Osborn,REP,640008,0,0,5,5,
Pushmataha,Corporation Commissioner,Bob Anthony,REP,640008,0,0,2,2,
Pushmataha,Corporation Commissioner,Brian Bingman,REP,640008,0,0,3,3,
Pushmataha,Governor,Chris Powell,LIB,640008,0,0,0,0,
Pushmataha,Governor,Rex Lawhorn,LIB,640008,0,0,0,0,
Pushmataha,Corporation Commissioner,Ashley Nicole Mccray,DEM,640008,0,0,10,10,
Pushmataha,Corporation Commissioner,Blake Cummings,DEM,640008,0,0,12,12,
Pushmataha,U.S. House,Jason Nichols,DEM,640008,0,0,5,5,02
Pushmataha,U.S. House,Clay Padgett,DEM,640008,0,0,19,19,02
Pushmataha,Governor,Mick Cornett,REP,640009,0,0,3,3,
Pushmataha,Governor,Kevin Stitt,REP,640009,1,0,6,7,
Pushmataha,Lieutenant Governor,Dana Murphy,REP,640009,0,0,3,3,
Pushmataha,Lieutenant Governor,Matt Pinnell,REP,640009,1,0,6,7,
Pushmataha,State Auditor,Cindy Byrd,REP,640009,1,0,5,6,
Pushmataha,State Auditor,Charlie Prater,REP,640009,0,0,4,4,
Pushmataha,Attorney General,Mike Hunter,REP,640009,1,0,5,6,
Pushmataha,Attorney General,Gentner Drummond,REP,640009,0,0,3,3,
Pushmataha,Superintendent of Public Instruction,Joy Hofmeister,REP,640009,0,0,4,4,
Pushmataha,Superintendent of Public Instruction,Linda Murphy,REP,640009,1,0,3,4,
Pushmataha,Commissioner of Labor,Cathy Costello,REP,640009,1,0,2,3,
Pushmataha,Commissioner of Labor,Leslie Osborn,REP,640009,0,0,4,4,
Pushmataha,Corporation Commissioner,Bob Anthony,REP,640009,1,0,3,4,
Pushmataha,Corporation Commissioner,Brian Bingman,REP,640009,0,0,2,2,
Pushmataha,Governor,Chris Powell,LIB,640009,0,0,0,0,
Pushmataha,Governor,Rex Lawhorn,LIB,640009,0,0,1,1,
Pushmataha,Corporation Commissioner,Ashley Nicole Mccray,DEM,640009,0,0,27,27,
Pushmataha,Corporation Commissioner,Blake Cummings,DEM,640009,1,1,53,55,
Pushmataha,U.S. House,Jason Nichols,DEM,640009,1,1,36,38,02
Pushmataha,U.S. House,Clay Padgett,DEM,640009,0,0,43,43,02
Pushmataha,Governor,Mick Cornett,REP,640010,0,0,0,0,
Pushmataha,Governor,Kevin Stitt,REP,640010,0,0,9,9,
Pushmataha,Lieutenant Governor,Dana Murphy,REP,640010,0,0,3,3,
Pushmataha,Lieutenant Governor,Matt Pinnell,REP,640010,0,0,6,6,
Pushmataha,State Auditor,Cindy Byrd,REP,640010,0,0,7,7,
Pushmataha,State Auditor,Charlie Prater,REP,640010,0,0,2,2,
Pushmataha,Attorney General,Mike Hunter,REP,640010,0,0,2,2,
Pushmataha,Attorney General,Gentner Drummond,REP,640010,0,0,7,7,
Pushmataha,Superintendent of Public Instruction,Joy Hofmeister,REP,640010,0,0,2,2,
Pushmataha,Superintendent of Public Instruction,Linda Murphy,REP,640010,0,0,7,7,
Pushmataha,Commissioner of Labor,Cathy Costello,REP,640010,0,0,8,8,
Pushmataha,Commissioner of Labor,Leslie Osborn,REP,640010,0,0,1,1,
Pushmataha,Corporation Commissioner,Bob Anthony,REP,640010,0,0,7,7,
Pushmataha,Corporation Commissioner,Brian Bingman,REP,640010,0,0,2,2,
Pushmataha,Governor,Chris Powell,LIB,640010,0,0,0,0,
Pushmataha,Governor,Rex Lawhorn,LIB,640010,0,0,0,0,
Pushmataha,Corporation Commissioner,Ashley Nicole Mccray,DEM,640010,0,1,10,11,
Pushmataha,Corporation Commissioner,Blake Cummings,DEM,640010,0,1,10,11,
Pushmataha,U.S. House,Jason Nichols,DEM,640010,0,2,8,10,02
Pushmataha,U.S. House,Clay Padgett,DEM,640010,0,0,13,13,02
Pushmataha,Governor,Mick Cornett,REP,640011,1,0,9,10,
Pushmataha,Governor,Kevin Stitt,REP,640011,0,0,18,18,
Pushmataha,Lieutenant Governor,Dana Murphy,REP,640011,1,0,9,10,
Pushmataha,Lieutenant Governor,Matt Pinnell,REP,640011,0,0,19,19,
Pushmataha,State Auditor,Cindy Byrd,REP,640011,1,0,19,20,
Pushmataha,State Auditor,Charlie Prater,REP,640011,0,0,9,9,
Pushmataha,Attorney General,Mike Hunter,REP,640011,0,0,7,7,
Pushmataha,Attorney General,Gentner Drummond,REP,640011,1,0,21,22,
Pushmataha,Superintendent of Public Instruction,Joy Hofmeister,REP,640011,0,0,14,14,
Pushmataha,Superintendent of Public Instruction,Linda Murphy,REP,640011,1,0,13,14,
Pushmataha,Commissioner of Labor,Cathy Costello,REP,640011,1,0,14,15,
Pushmataha,Commissioner of Labor,Leslie Osborn,REP,640011,0,0,11,11,
Pushmataha,Corporation Commissioner,Bob Anthony,REP,640011,1,0,11,12,
Pushmataha,Corporation Commissioner,Brian Bingman,REP,640011,0,0,13,13,
Pushmataha,Governor,Chris Powell,LIB,640011,0,0,0,0,
Pushmataha,Governor,Rex Lawhorn,LIB,640011,0,0,0,0,
Pushmataha,Corporation Commissioner,Ashley Nicole Mccray,DEM,640011,0,2,33,35,
Pushmataha,Corporation Commissioner,Blake Cummings,DEM,640011,1,0,36,37,
Pushmataha,U.S. House,Jason Nichols,DEM,640011,2,0,22,24,02
Pushmataha,U.S. House,Clay Padgett,DEM,640011,0,2,46,48,02
Pushmataha,Governor,Mick Cornett,REP,640012,0,0,1,1,
Pushmataha,Governor,Kevin Stitt,REP,640012,0,0,6,6,
Pushmataha,Lieutenant Governor,Dana Murphy,REP,640012,0,0,1,1,
Pushmataha,Lieutenant Governor,Matt Pinnell,REP,640012,0,0,4,4,
Pushmataha,State Auditor,Cindy Byrd,REP,640012,0,0,2,2,
Pushmataha,State Auditor,Charlie Prater,REP,640012,0,0,4,4,
Pushmataha,Attorney General,Mike Hunter,REP,640012,0,0,0,0,
Pushmataha,Attorney General,Gentner Drummond,REP,640012,0,0,7,7,
Pushmataha,Superintendent of Public Instruction,Joy Hofmeister,REP,640012,0,0,1,1,
Pushmataha,Superintendent of Public Instruction,Linda Murphy,REP,640012,0,0,5,5,
Pushmataha,Commissioner of Labor,Cathy Costello,REP,640012,0,0,0,0,
Pushmataha,Commissioner of Labor,Leslie Osborn,REP,640012,0,0,6,6,
Pushmataha,Corporation Commissioner,Bob Anthony,REP,640012,0,0,1,1,
Pushmataha,Corporation Commissioner,Brian Bingman,REP,640012,0,0,5,5,
Pushmataha,Governor,Chris Powell,LIB,640012,0,0,0,0,
Pushmataha,Governor,Rex Lawhorn,LIB,640012,0,0,0,0,
Pushmataha,Corporation Commissioner,Ashley Nicole Mccray,DEM,640012,0,0,14,14,
Pushmataha,Corporation Commissioner,Blake Cummings,DEM,640012,0,0,9,9,
Pushmataha,U.S. House,Jason Nichols,DEM,640012,0,0,8,8,02
Pushmataha,U.S. House,Clay Padgett,DEM,640012,0,0,16,16,02
Pushmataha,Governor,Mick Cornett,REP,640013,0,0,2,2,
Pushmataha,Governor,Kevin Stitt,REP,640013,0,0,12,12,
Pushmataha,Lieutenant Governor,Dana Murphy,REP,640013,0,0,0,0,
Pushmataha,Lieutenant Governor,Matt Pinnell,REP,640013,0,0,12,12,
Pushmataha,State Auditor,Cindy Byrd,REP,640013,0,0,7,7,
Pushmataha,State Auditor,Charlie Prater,REP,640013,0,0,4,4,
Pushmataha,Attorney General,Mike Hunter,REP,640013,0,0,6,6,
Pushmataha,Attorney General,Gentner Drummond,REP,640013,0,0,8,8,
Pushmataha,Superintendent of Public Instruction,Joy Hofmeister,REP,640013,0,0,5,5,
Pushmataha,Superintendent of Public Instruction,Linda Murphy,REP,640013,0,0,6,6,
Pushmataha,Commissioner of Labor,Cathy Costello,REP,640013,0,0,7,7,
Pushmataha,Commissioner of Labor,Leslie Osborn,REP,640013,0,0,4,4,
Pushmataha,Corporation Commissioner,Bob Anthony,REP,640013,0,0,6,6,
Pushmataha,Corporation Commissioner,Brian Bingman,REP,640013,0,0,5,5,
Pushmataha,Governor,Chris Powell,LIB,640013,0,0,0,0,
Pushmataha,Governor,Rex Lawhorn,LIB,640013,0,0,0,0,
Pushmataha,Corporation Commissioner,Ashley Nicole Mccray,DEM,640013,0,0,9,9,
Pushmataha,Corporation Commissioner,Blake Cummings,DEM,640013,0,0,2,2,
Pushmataha,U.S. House,Jason Nichols,DEM,640013,0,0,7,7,02
Pushmataha,U.S. House,Clay Padgett,DEM,640013,0,0,5,5,02
Pushmataha,Governor,Mick Cornett,REP,640014,0,0,5,5,
Pushmataha,Governor,Kevin Stitt,REP,640014,0,1,9,10,
Pushmataha,Lieutenant Governor,Dana Murphy,REP,640014,0,1,10,11,
Pushmataha,Lieutenant Governor,Matt Pinnell,REP,640014,0,0,4,4,
Pushmataha,State Auditor,Cindy Byrd,REP,640014,0,1,11,12,
Pushmataha,State Auditor,Charlie Prater,REP,640014,0,0,3,3,
Pushmataha,Attorney General,Mike Hunter,REP,640014,0,1,5,6,
Pushmataha,Attorney General,Gentner Drummond,REP,640014,0,0,8,8,
Pushmataha,Superintendent of Public Instruction,Joy Hofmeister,REP,640014,0,0,3,3,
Pushmataha,Superintendent of Public Instruction,Linda Murphy,REP,640014,0,1,8,9,
Pushmataha,Commissioner of Labor,Cathy Costello,REP,640014,0,0,6,6,
Pushmataha,Commissioner of Labor,Leslie Osborn,REP,640014,0,1,6,7,
Pushmataha,Corporation Commissioner,Bob Anthony,REP,640014,0,0,8,8,
Pushmataha,Corporation Commissioner,Brian Bingman,REP,640014,0,1,4,5,
Pushmataha,Governor,Chris Powell,LIB,640014,0,0,0,0,
Pushmataha,Governor,Rex Lawhorn,LIB,640014,0,0,0,0,
Pushmataha,Corporation Commissioner,Ashley Nicole Mccray,DEM,640014,0,0,3,3,
Pushmataha,Corporation Commissioner,Blake Cummings,DEM,640014,0,1,6,7,
Pushmataha,U.S. House,Jason Nichols,DEM,640014,0,0,3,3,02
Pushmataha,U.S. House,Clay Padgett,DEM,640014,0,1,6,7,02
Pushmataha,Governor,Mick Cornett,REP,640015,1,0,6,7,
Pushmataha,Governor,Kevin Stitt,REP,640015,1,0,21,22,
Pushmataha,Lieutenant Governor,Dana Murphy,REP,640015,1,0,8,9,
Pushmataha,Lieutenant Governor,Matt Pinnell,REP,640015,1,0,19,20,
Pushmataha,State Auditor,Cindy Byrd,REP,640015,1,0,13,14,
Pushmataha,State Auditor,Charlie Prater,REP,640015,1,0,12,13,
Pushmataha,Attorney General,Mike Hunter,REP,640015,1,0,13,14,
Pushmataha,Attorney General,Gentner Drummond,REP,640015,1,0,14,15,
Pushmataha,Superintendent of Public Instruction,Joy Hofmeister,REP,640015,0,0,14,14,
Pushmataha,Superintendent of Public Instruction,Linda Murphy,REP,640015,2,0,12,14,
Pushmataha,Commissioner of Labor,Cathy Costello,REP,640015,1,0,18,19,
Pushmataha,Commissioner of Labor,Leslie Osborn,REP,640015,1,0,8,9,
Pushmataha,Corporation Commissioner,Bob Anthony,REP,640015,1,0,14,15,
Pushmataha,Corporation Commissioner,Brian Bingman,REP,640015,1,0,13,14,
Pushmataha,Governor,Chris Powell,LIB,640015,0,0,0,0,
Pushmataha,Governor,Rex Lawhorn,LIB,640015,0,0,0,0,
Pushmataha,Corporation Commissioner,Ashley Nicole Mccray,DEM,640015,1,0,78,79,
Pushmataha,Corporation Commissioner,Blake Cummings,DEM,640015,7,0,113,120,
Pushmataha,U.S. House,Jason Nichols,DEM,640015,6,0,96,102,02
Pushmataha,U.S. House,Clay Padgett,DEM,640015,2,0,96,98,02
Pushmataha,Governor,Mick Cornett,REP,640016,0,0,4,4,
Pushmataha,Governor,Kevin Stitt,REP,640016,1,0,18,19,
Pushmataha,Lieutenant Governor,Dana Murphy,REP,640016,1,0,5,6,
Pushmataha,Lieutenant Governor,Matt Pinnell,REP,640016,0,0,17,17,
Pushmataha,State Auditor,Cindy Byrd,REP,640016,1,0,11,12,
Pushmataha,State Auditor,Charlie Prater,REP,640016,0,0,10,10,
Pushmataha,Attorney General,Mike Hunter,REP,640016,0,0,12,12,
Pushmataha,Attorney General,Gentner Drummond,REP,640016,1,0,11,12,
Pushmataha,Superintendent of Public Instruction,Joy Hofmeister,REP,640016,0,0,15,15,
Pushmataha,Superintendent of Public Instruction,Linda Murphy,REP,640016,1,0,5,6,
Pushmataha,Commissioner of Labor,Cathy Costello,REP,640016,0,0,6,6,
Pushmataha,Commissioner of Labor,Leslie Osborn,REP,640016,1,0,14,15,
Pushmataha,Corporation Commissioner,Bob Anthony,REP,640016,0,0,6,6,
Pushmataha,Corporation Commissioner,Brian Bingman,REP,640016,1,0,15,16,
Pushmataha,Governor,Chris Powell,LIB,640016,0,0,0,0,
Pushmataha,Governor,Rex Lawhorn,LIB,640016,0,0,0,0,
Pushmataha,Corporation Commissioner,Ashley Nicole Mccray,DEM,640016,2,0,16,18,
Pushmataha,Corporation Commissioner,Blake Cummings,DEM,640016,2,0,26,28,
Pushmataha,U.S. House,Jason Nichols,DEM,640016,2,0,26,28,02
Pushmataha,U.S. House,Clay Padgett,DEM,640016,2,0,16,18,02
Pushmataha,Governor,Mick Cornett,REP,640017,0,0,4,4,
Pushmataha,Governor,Kevin Stitt,REP,640017,0,0,11,11,
Pushmataha,Lieutenant Governor,Dana Murphy,REP,640017,0,0,6,6,
Pushmataha,Lieutenant Governor,Matt Pinnell,REP,640017,0,0,8,8,
Pushmataha,State Auditor,Cindy Byrd,REP,640017,0,0,9,9,
Pushmataha,State Auditor,Charlie Prater,REP,640017,0,0,5,5,
Pushmataha,Attorney General,Mike Hunter,REP,640017,0,0,2,2,
Pushmataha,Attorney General,Gentner Drummond,REP,640017,0,0,12,12,
Pushmataha,Superintendent of Public Instruction,Joy Hofmeister,REP,640017,0,0,4,4,
Pushmataha,Superintendent of Public Instruction,Linda Murphy,REP,640017,0,0,10,10,
Pushmataha,Commissioner of Labor,Cathy Costello,REP,640017,0,0,10,10,
Pushmataha,Commissioner of Labor,Leslie Osborn,REP,640017,0,0,4,4,
Pushmataha,Corporation Commissioner,Bob Anthony,REP,640017,0,0,6,6,
Pushmataha,Corporation Commissioner,Brian Bingman,REP,640017,0,0,8,8,
Pushmataha,Governor,Chris Powell,LIB,640017,0,0,0,0,
Pushmataha,Governor,Rex Lawhorn,LIB,640017,0,0,0,0,
Pushmataha,Corporation Commissioner,Ashley Nicole Mccray,DEM,640017,1,0,35,36,
Pushmataha,Corporation Commissioner,Blake Cummings,DEM,640017,0,0,50,50,
Pushmataha,U.S. House,Jason Nichols,DEM,640017,1,0,53,54,02
Pushmataha,U.S. House,Clay Padgett,DEM,640017,0,0,31,31,02
Roger Mills,Governor,Mick Cornett,REP,650101,1,0,9,10,
Roger Mills,Governor,Kevin Stitt,REP,650101,0,0,16,16,
Roger Mills,Lieutenant Governor,Dana Murphy,REP,650101,0,0,12,12,
Roger Mills,Lieutenant Governor,Matt Pinnell,REP,650101,1,0,13,14,
Roger Mills,State Auditor,Cindy Byrd,REP,650101,1,0,8,9,
Roger Mills,State Auditor,Charlie Prater,REP,650101,0,0,17,17,
Roger Mills,Attorney General,Mike Hunter,REP,650101,1,0,21,22,
Roger Mills,Attorney General,Gentner Drummond,REP,650101,0,0,4,4,
Roger Mills,Superintendent of Public Instruction,Joy Hofmeister,REP,650101,0,0,13,13,
Roger Mills,Superintendent of Public Instruction,Linda Murphy,REP,650101,1,0,12,13,
Roger Mills,Commissioner of Labor,Cathy Costello,REP,650101,1,0,11,12,
Roger Mills,Commissioner of Labor,Leslie Osborn,REP,650101,0,0,14,14,
Roger Mills,Corporation Commissioner,Bob Anthony,REP,650101,1,0,12,13,
Roger Mills,Corporation Commissioner,Brian Bingman,REP,650101,0,0,13,13,
Roger Mills,Governor,Chris Powell,LIB,650101,0,0,0,0,
Roger Mills,Governor,Rex Lawhorn,LIB,650101,0,0,0,0,
Roger Mills,Corporation Commissioner,Ashley Nicole Mccray,DEM,650101,0,0,1,1,
Roger Mills,Corporation Commissioner,Blake Cummings,DEM,650101,0,0,3,3,
Roger Mills,Governor,Mick Cornett,REP,650102,0,2,3,5,
Roger Mills,Governor,Kevin Stitt,REP,650102,0,1,17,18,
Roger Mills,Lieutenant Governor,Dana Murphy,REP,650102,0,2,6,8,
Roger Mills,Lieutenant Governor,Matt Pinnell,REP,650102,0,1,14,15,
Roger Mills,State Auditor,Cindy Byrd,REP,650102,0,1,7,8,
Roger Mills,State Auditor,Charlie Prater,REP,650102,0,2,13,15,
Roger Mills,Attorney General,Mike Hunter,REP,650102,0,1,12,13,
Roger Mills,Attorney General,Gentner Drummond,REP,650102,0,2,8,10,
Roger Mills,Superintendent of Public Instruction,Joy Hofmeister,REP,650102,0,0,9,9,
Roger Mills,Superintendent of Public Instruction,Linda Murphy,REP,650102,0,3,9,12,
Roger Mills,Commissioner of Labor,Cathy Costello,REP,650102,0,2,10,12,
Roger Mills,Commissioner of Labor,Leslie Osborn,REP,650102,0,1,10,11,
Roger Mills,Corporation Commissioner,Bob Anthony,REP,650102,0,2,8,10,
Roger Mills,Corporation Commissioner,Brian Bingman,REP,650102,0,1,12,13,
Roger Mills,Governor,Chris Powell,LIB,650102,0,0,0,0,
Roger Mills,Governor,Rex Lawhorn,LIB,650102,0,0,0,0,
Roger Mills,Corporation Commissioner,Ashley Nicole Mccray,DEM,650102,0,0,7,7,
Roger Mills,Corporation Commissioner,Blake Cummings,DEM,650102,0,1,8,9,
Roger Mills,Governor,Mick Cornett,REP,650103,0,2,28,30,
Roger Mills,Governor,Kevin Stitt,REP,650103,2,2,27,31,
Roger Mills,Lieutenant Governor,Dana Murphy,REP,650103,1,3,24,28,
Roger Mills,Lieutenant Governor,Matt Pinnell,REP,650103,1,1,31,33,
Roger Mills,State Auditor,Cindy Byrd,REP,650103,0,2,18,20,
Roger Mills,State Auditor,Charlie Prater,REP,650103,2,2,34,38,
Roger Mills,Attorney General,Mike Hunter,REP,650103,1,3,25,29,
Roger Mills,Attorney General,Gentner Drummond,REP,650103,1,1,30,32,
Roger Mills,Superintendent of Public Instruction,Joy Hofmeister,REP,650103,0,2,23,25,
Roger Mills,Superintendent of Public Instruction,Linda Murphy,REP,650103,2,2,32,36,
Roger Mills,Commissioner of Labor,Cathy Costello,REP,650103,1,3,29,33,
Roger Mills,Commissioner of Labor,Leslie Osborn,REP,650103,1,1,26,28,
Roger Mills,Corporation Commissioner,Bob Anthony,REP,650103,0,3,31,34,
Roger Mills,Corporation Commissioner,Brian Bingman,REP,650103,2,1,22,25,
Roger Mills,Governor,Chris Powell,LIB,650103,0,0,0,0,
Roger Mills,Governor,Rex Lawhorn,LIB,650103,0,0,0,0,
Roger Mills,Corporation Commissioner,Ashley Nicole Mccray,DEM,650103,0,2,10,12,
Roger Mills,Corporation Commissioner,Blake Cummings,DEM,650103,1,2,5,8,
Roger Mills,Governor,Mick Cornett,REP,650201,0,2,28,30,
Roger Mills,Governor,Kevin Stitt,REP,650201,1,0,28,29,
Roger Mills,Lieutenant Governor,Dana Murphy,REP,650201,0,1,23,24,
Roger Mills,Lieutenant Governor,Matt Pinnell,REP,650201,1,1,33,35,
Roger Mills,State Auditor,Cindy Byrd,REP,650201,1,1,16,18,
Roger Mills,State Auditor,Charlie Prater,REP,650201,0,1,39,40,
Roger Mills,Attorney General,Mike Hunter,REP,650201,0,0,29,29,
Roger Mills,Attorney General,Gentner Drummond,REP,650201,1,2,27,30,
Roger Mills,Superintendent of Public Instruction,Joy Hofmeister,REP,650201,0,2,36,38,
Roger Mills,Superintendent of Public Instruction,Linda Murphy,REP,650201,1,0,20,21,
Roger Mills,Commissioner of Labor,Cathy Costello,REP,650201,0,0,25,25,
Roger Mills,Commissioner of Labor,Leslie Osborn,REP,650201,1,2,29,32,
Roger Mills,Corporation Commissioner,Bob Anthony,REP,650201,0,2,35,37,
Roger Mills,Corporation Commissioner,Brian Bingman,REP,650201,1,0,21,22,
Roger Mills,Governor,Chris Powell,LIB,650201,0,0,0,0,
Roger Mills,Governor,Rex Lawhorn,LIB,650201,0,0,0,0,
Roger Mills,Corporation Commissioner,Ashley Nicole Mccray,DEM,650201,2,0,11,13,
Roger Mills,Corporation Commissioner,Blake Cummings,DEM,650201,0,1,25,26,
Roger Mills,Governor,Mick Cornett,REP,650202,0,1,5,6,
Roger Mills,Governor,Kevin Stitt,REP,650202,0,3,7,10,
Roger Mills,Lieutenant Governor,Dana Murphy,REP,650202,0,4,7,11,
Roger Mills,Lieutenant Governor,Matt Pinnell,REP,650202,0,0,5,5,
Roger Mills,State Auditor,Cindy Byrd,REP,650202,0,2,2,4,
Roger Mills,State Auditor,Charlie Prater,REP,650202,0,1,9,10,
Roger Mills,Attorney General,Mike Hunter,REP,650202,0,4,5,9,
Roger Mills,Attorney General,Gentner Drummond,REP,650202,0,0,7,7,
Roger Mills,Superintendent of Public Instruction,Joy Hofmeister,REP,650202,0,0,3,3,
Roger Mills,Superintendent of Public Instruction,Linda Murphy,REP,650202,0,4,9,13,
Roger Mills,Commissioner of Labor,Cathy Costello,REP,650202,0,2,7,9,
Roger Mills,Commissioner of Labor,Leslie Osborn,REP,650202,0,1,5,6,
Roger Mills,Corporation Commissioner,Bob Anthony,REP,650202,0,3,6,9,
Roger Mills,Corporation Commissioner,Brian Bingman,REP,650202,0,1,6,7,
Roger Mills,Governor,Chris Powell,LIB,650202,0,0,0,0,
Roger Mills,Governor,Rex Lawhorn,LIB,650202,0,0,0,0,
Roger Mills,Corporation Commissioner,Ashley Nicole Mccray,DEM,650202,1,3,1,5,
Roger Mills,Corporation Commissioner,Blake Cummings,DEM,650202,0,1,4,5,
Roger Mills,Governor,Mick Cornett,REP,650203,2,0,10,12,
Roger Mills,Governor,Kevin Stitt,REP,650203,0,0,10,10,
Roger Mills,Lieutenant Governor,Dana Murphy,REP,650203,2,0,8,10,
Roger Mills,Lieutenant Governor,Matt Pinnell,REP,650203,0,0,11,11,
Roger Mills,State Auditor,Cindy Byrd,REP,650203,2,0,9,11,
Roger Mills,State Auditor,Charlie Prater,REP,650203,0,0,8,8,
Roger Mills,Attorney General,Mike Hunter,REP,650203,0,0,10,10,
Roger Mills,Attorney General,Gentner Drummond,REP,650203,2,0,9,11,
Roger Mills,Superintendent of Public Instruction,Joy Hofmeister,REP,650203,2,0,10,12,
Roger Mills,Superintendent of Public Instruction,Linda Murphy,REP,650203,0,0,9,9,
Roger Mills,Commissioner of Labor,Cathy Costello,REP,650203,0,0,7,7,
Roger Mills,Commissioner of Labor,Leslie Osborn,REP,650203,2,0,12,14,
Roger Mills,Corporation Commissioner,Bob Anthony,REP,650203,0,0,7,7,
Roger Mills,Corporation Commissioner,Brian Bingman,REP,650203,2,0,12,14,
Roger Mills,Governor,Chris Powell,LIB,650203,0,0,0,0,
Roger Mills,Governor,Rex Lawhorn,LIB,650203,0,0,0,0,
Roger Mills,Corporation Commissioner,Ashley Nicole Mccray,DEM,650203,0,0,5,5,
Roger Mills,Corporation Commissioner,Blake Cummings,DEM,650203,2,0,5,7,
Roger Mills,Governor,Mick Cornett,REP,650301,0,1,10,11,
Roger Mills,Governor,Kevin Stitt,REP,650301,1,0,20,21,
Roger Mills,Lieutenant Governor,Dana Murphy,REP,650301,0,0,13,13,
Roger Mills,Lieutenant Governor,Matt Pinnell,REP,650301,1,1,16,18,
Roger Mills,State Auditor,Cindy Byrd,REP,650301,0,0,14,14,
Roger Mills,State Auditor,Charlie Prater,REP,650301,1,1,14,16,
Roger Mills,Attorney General,Mike Hunter,REP,650301,0,0,20,20,
Roger Mills,Attorney General,Gentner Drummond,REP,650301,1,1,10,12,
Roger Mills,Superintendent of Public Instruction,Joy Hofmeister,REP,650301,1,1,9,11,
Roger Mills,Superintendent of Public Instruction,Linda Murphy,REP,650301,0,0,20,20,
Roger Mills,Commissioner of Labor,Cathy Costello,REP,650301,1,0,14,15,
Roger Mills,Commissioner of Labor,Leslie Osborn,REP,650301,0,1,14,15,
Roger Mills,Corporation Commissioner,Bob Anthony,REP,650301,0,1,16,17,
Roger Mills,Corporation Commissioner,Brian Bingman,REP,650301,1,0,12,13,
Roger Mills,Governor,Chris Powell,LIB,650301,0,0,0,0,
Roger Mills,Governor,Rex Lawhorn,LIB,650301,0,0,0,0,
Roger Mills,Corporation Commissioner,Ashley Nicole Mccray,DEM,650301,0,0,6,6,
Roger Mills,Corporation Commissioner,Blake Cummings,DEM,650301,0,0,8,8,
Roger Mills,Governor,Mick Cornett,REP,650302,1,2,19,22,
Roger Mills,Governor,Kevin Stitt,REP,650302,1,2,29,32,
Roger Mills,Lieutenant Governor,Dana Murphy,REP,650302,2,1,26,29,
Roger Mills,Lieutenant Governor,Matt Pinnell,REP,650302,0,2,21,23,
Roger Mills,State Auditor,Cindy Byrd,REP,650302,1,0,19,20,
Roger Mills,State Auditor,Charlie Prater,REP,650302,1,2,25,28,
Roger Mills,Attorney General,Mike Hunter,REP,650302,0,2,33,35,
Roger Mills,Attorney General,Gentner Drummond,REP,650302,2,2,14,18,
Roger Mills,Superintendent of Public Instruction,Joy Hofmeister,REP,650302,1,0,11,12,
Roger Mills,Superintendent of Public Instruction,Linda Murphy,REP,650302,1,4,37,42,
Roger Mills,Commissioner of Labor,Cathy Costello,REP,650302,1,0,29,30,
Roger Mills,Commissioner of Labor,Leslie Osborn,REP,650302,1,4,15,20,
Roger Mills,Corporation Commissioner,Bob Anthony,REP,650302,0,2,29,31,
Roger Mills,Corporation Commissioner,Brian Bingman,REP,650302,2,2,18,22,
Roger Mills,Governor,Chris Powell,LIB,650302,0,0,0,0,
Roger Mills,Governor,Rex Lawhorn,LIB,650302,0,0,0,0,
Roger Mills,Corporation Commissioner,Ashley Nicole Mccray,DEM,650302,1,0,5,6,
Roger Mills,Corporation Commissioner,Blake Cummings,DEM,650302,0,1,7,8,
Roger Mills,Governor,Mick Cornett,REP,650303,3,1,17,21,
Roger Mills,Governor,Kevin Stitt,REP,650303,1,5,27,33,
Roger Mills,Lieutenant Governor,Dana Murphy,REP,650303,0,2,24,26,
Roger Mills,Lieutenant Governor,Matt Pinnell,REP,650303,4,4,19,27,
Roger Mills,State Auditor,Cindy Byrd,REP,650303,2,3,21,26,
Roger Mills,State Auditor,Charlie Prater,REP,650303,2,2,21,25,
Roger Mills,Attorney General,Mike Hunter,REP,650303,3,1,17,21,
Roger Mills,Attorney General,Gentner Drummond,REP,650303,1,5,25,31,
Roger Mills,Superintendent of Public Instruction,Joy Hofmeister,REP,650303,1,3,12,16,
Roger Mills,Superintendent of Public Instruction,Linda Murphy,REP,650303,3,3,32,38,
Roger Mills,Commissioner of Labor,Cathy Costello,REP,650303,2,2,19,23,
Roger Mills,Commissioner of Labor,Leslie Osborn,REP,650303,2,4,23,29,
Roger Mills,Corporation Commissioner,Bob Anthony,REP,650303,1,2,24,27,
Roger Mills,Corporation Commissioner,Brian Bingman,REP,650303,3,4,19,26,
Roger Mills,Governor,Chris Powell,LIB,650303,0,0,0,0,
Roger Mills,Governor,Rex Lawhorn,LIB,650303,0,0,0,0,
Roger Mills,Corporation Commissioner,Ashley Nicole Mccray,DEM,650303,0,1,8,9,
Roger Mills,Corporation Commissioner,Blake Cummings,DEM,650303,0,3,7,10,
Rogers,Governor,Mick Cornett,REP,660001,7,15,92,114,
Rogers,Governor,Kevin Stitt,REP,660001,11,31,146,188,
Rogers,Lieutenant Governor,Dana Murphy,REP,660001,5,13,70,88,
Rogers,Lieutenant Governor,Matt Pinnell,REP,660001,13,30,167,210,
Rogers,State Auditor,Cindy Byrd,REP,660001,10,25,117,152,
Rogers,State Auditor,Charlie Prater,REP,660001,6,19,113,138,
Rogers,Attorney General,Mike Hunter,REP,660001,10,13,102,125,
Rogers,Attorney General,Gentner Drummond,REP,660001,8,32,136,176,
Rogers,Superintendent of Public Instruction,Joy Hofmeister,REP,660001,11,28,131,170,
Rogers,Superintendent of Public Instruction,Linda Murphy,REP,660001,4,18,99,121,
Rogers,Commissioner of Labor,Cathy Costello,REP,660001,10,21,114,145,
Rogers,Commissioner of Labor,Leslie Osborn,REP,660001,6,22,115,143,
Rogers,Corporation Commissioner,Bob Anthony,REP,660001,9,23,115,147,
Rogers,Corporation Commissioner,Brian Bingman,REP,660001,8,21,114,143,
Rogers,Governor,Chris Powell,LIB,660001,0,0,0,0,
Rogers,Governor,Rex Lawhorn,LIB,660001,0,0,0,0,
Rogers,Corporation Commissioner,Ashley Nicole Mccray,DEM,660001,8,7,68,83,
Rogers,Corporation Commissioner,Blake Cummings,DEM,660001,1,6,31,38,
Rogers,U.S. House,Jason Nichols,DEM,660001,6,5,70,81,02
Rogers,U.S. House,Clay Padgett,DEM,660001,3,8,29,40,02
Rogers,Governor,Mick Cornett,REP,660002,2,2,49,53,
Rogers,Governor,Kevin Stitt,REP,660002,7,14,65,86,
Rogers,Lieutenant Governor,Dana Murphy,REP,660002,1,6,31,38,
Rogers,Lieutenant Governor,Matt Pinnell,REP,660002,7,8,79,94,
Rogers,State Auditor,Cindy Byrd,REP,660002,4,6,54,64,
Rogers,State Auditor,Charlie Prater,REP,660002,5,8,58,71,
Rogers,Attorney General,Mike Hunter,REP,660002,4,6,39,49,
Rogers,Attorney General,Gentner Drummond,REP,660002,5,8,70,83,
Rogers,Superintendent of Public Instruction,Joy Hofmeister,REP,660002,1,2,54,57,
Rogers,Superintendent of Public Instruction,Linda Murphy,REP,660002,8,12,55,75,
Rogers,Commissioner of Labor,Cathy Costello,REP,660002,5,7,56,68,
Rogers,Commissioner of Labor,Leslie Osborn,REP,660002,4,8,55,67,
Rogers,Corporation Commissioner,Bob Anthony,REP,660002,6,7,49,62,
Rogers,Corporation Commissioner,Brian Bingman,REP,660002,3,6,59,68,
Rogers,Governor,Chris Powell,LIB,660002,0,0,0,0,
Rogers,Governor,Rex Lawhorn,LIB,660002,0,0,0,0,
Rogers,Corporation Commissioner,Ashley Nicole Mccray,DEM,660002,3,9,33,45,
Rogers,Corporation Commissioner,Blake Cummings,DEM,660002,1,8,21,30,
Rogers,U.S. House,Jason Nichols,DEM,660002,0,7,38,45,02
Rogers,U.S. House,Clay Padgett,DEM,660002,4,11,16,31,02
Rogers,Governor,Mick Cornett,REP,660003,2,5,45,52,
Rogers,Governor,Kevin Stitt,REP,660003,7,11,98,116,
Rogers,Lieutenant Governor,Dana Murphy,REP,660003,7,6,41,54,
Rogers,Lieutenant Governor,Matt Pinnell,REP,660003,2,9,101,112,
Rogers,State Auditor,Cindy Byrd,REP,660003,8,9,75,92,
Rogers,State Auditor,Charlie Prater,REP,660003,1,7,66,74,
Rogers,Attorney General,Mike Hunter,REP,660003,5,5,67,77,
Rogers,Attorney General,Gentner Drummond,REP,660003,4,10,74,88,
Rogers,Superintendent of Public Instruction,Joy Hofmeister,REP,660003,6,8,69,83,
Rogers,Superintendent of Public Instruction,Linda Murphy,REP,660003,3,8,72,83,
Rogers,Commissioner of Labor,Cathy Costello,REP,660003,7,6,90,103,
Rogers,Commissioner of Labor,Leslie Osborn,REP,660003,2,9,51,62,
Rogers,Corporation Commissioner,Bob Anthony,REP,660003,6,5,73,84,
Rogers,Corporation Commissioner,Brian Bingman,REP,660003,3,10,66,79,
Rogers,Governor,Chris Powell,LIB,660003,0,0,0,0,
Rogers,Governor,Rex Lawhorn,LIB,660003,0,0,0,0,
Rogers,Corporation Commissioner,Ashley Nicole Mccray,DEM,660003,4,0,37,41,
Rogers,Corporation Commissioner,Blake Cummings,DEM,660003,5,5,20,30,
Rogers,U.S. House,Jason Nichols,DEM,660003,8,3,33,44,02
Rogers,U.S. House,Clay Padgett,DEM,660003,1,2,24,27,02
Rogers,Governor,Mick Cornett,REP,660004,5,22,139,166,
Rogers,Governor,Kevin Stitt,REP,660004,12,13,156,181,
Rogers,Lieutenant Governor,Dana Murphy,REP,660004,5,14,94,113,
Rogers,Lieutenant Governor,Matt Pinnell,REP,660004,12,20,197,229,
Rogers,State Auditor,Cindy Byrd,REP,660004,9,13,139,161,
Rogers,State Auditor,Charlie Prater,REP,660004,8,19,144,171,
Rogers,Attorney General,Mike Hunter,REP,660004,5,10,141,156,
Rogers,Attorney General,Gentner Drummond,REP,660004,12,23,151,186,
Rogers,Superintendent of Public Instruction,Joy Hofmeister,REP,660004,8,22,147,177,
Rogers,Superintendent of Public Instruction,Linda Murphy,REP,660004,9,12,140,161,
Rogers,Commissioner of Labor,Cathy Costello,REP,660004,8,13,150,171,
Rogers,Commissioner of Labor,Leslie Osborn,REP,660004,8,20,137,165,
Rogers,Corporation Commissioner,Bob Anthony,REP,660004,11,17,140,168,
Rogers,Corporation Commissioner,Brian Bingman,REP,660004,6,17,143,166,
Rogers,Governor,Chris Powell,LIB,660004,0,0,1,1,
Rogers,Governor,Rex Lawhorn,LIB,660004,0,0,0,0,
Rogers,Corporation Commissioner,Ashley Nicole Mccray,DEM,660004,4,8,68,80,
Rogers,Corporation Commissioner,Blake Cummings,DEM,660004,4,2,35,41,
Rogers,U.S. House,Jason Nichols,DEM,660004,5,3,60,68,02
Rogers,U.S. House,Clay Padgett,DEM,660004,3,7,44,54,02
Rogers,Governor,Mick Cornett,REP,660005,5,11,64,80,
Rogers,Governor,Kevin Stitt,REP,660005,3,20,144,167,
Rogers,Lieutenant Governor,Dana Murphy,REP,660005,1,13,45,59,
Rogers,Lieutenant Governor,Matt Pinnell,REP,660005,7,18,156,181,
Rogers,State Auditor,Cindy Byrd,REP,660005,7,19,78,104,
Rogers,State Auditor,Charlie Prater,REP,660005,1,11,121,133,
Rogers,Attorney General,Mike Hunter,REP,660005,6,9,77,92,
Rogers,Attorney General,Gentner Drummond,REP,660005,2,21,127,150,
Rogers,Superintendent of Public Instruction,Joy Hofmeister,REP,660005,2,22,95,119,
Rogers,Superintendent of Public Instruction,Linda Murphy,REP,660005,5,9,108,122,
Rogers,Commissioner of Labor,Cathy Costello,REP,660005,6,16,103,125,
Rogers,Commissioner of Labor,Leslie Osborn,REP,660005,2,14,96,112,
Rogers,Corporation Commissioner,Bob Anthony,REP,660005,4,15,103,122,
Rogers,Corporation Commissioner,Brian Bingman,REP,660005,4,15,97,116,
Rogers,Governor,Chris Powell,LIB,660005,0,0,0,0,
Rogers,Governor,Rex Lawhorn,LIB,660005,0,0,0,0,
Rogers,Corporation Commissioner,Ashley Nicole Mccray,DEM,660005,2,5,31,38,
Rogers,Corporation Commissioner,Blake Cummings,DEM,660005,2,3,17,22,
Rogers,U.S. House,Jason Nichols,DEM,660005,3,7,20,30,02
Rogers,U.S. House,Clay Padgett,DEM,660005,1,1,28,30,02
Rogers,Governor,Mick Cornett,REP,660006,6,2,44,52,
Rogers,Governor,Kevin Stitt,REP,660006,4,18,123,145,
Rogers,Lieutenant Governor,Dana Murphy,REP,660006,3,6,62,71,
Rogers,Lieutenant Governor,Matt Pinnell,REP,660006,7,14,101,122,
Rogers,State Auditor,Cindy Byrd,REP,660006,6,9,81,96,
Rogers,State Auditor,Charlie Prater,REP,660006,4,11,78,93,
Rogers,Attorney General,Mike Hunter,REP,660006,4,5,73,82,
Rogers,Attorney General,Gentner Drummond,REP,660006,5,14,95,114,
Rogers,Superintendent of Public Instruction,Joy Hofmeister,REP,660006,6,13,94,113,
Rogers,Superintendent of Public Instruction,Linda Murphy,REP,660006,4,7,71,82,
Rogers,Commissioner of Labor,Cathy Costello,REP,660006,4,8,89,101,
Rogers,Commissioner of Labor,Leslie Osborn,REP,660006,6,12,73,91,
Rogers,Corporation Commissioner,Bob Anthony,REP,660006,4,10,98,112,
Rogers,Corporation Commissioner,Brian Bingman,REP,660006,5,10,65,80,
Rogers,U.S. House,Tim Harris,REP,660006,5,5,66,76,01
Rogers,U.S. House,Kevin Hern,REP,660006,4,15,102,121,01
Rogers,Governor,Chris Powell,LIB,660006,0,0,0,0,
Rogers,Governor,Rex Lawhorn,LIB,660006,0,0,0,0,
Rogers,Corporation Commissioner,Ashley Nicole Mccray,DEM,660006,5,4,19,28,
Rogers,Corporation Commissioner,Blake Cummings,DEM,660006,2,1,6,9,
Rogers,U.S. House,Tim Gilpin,DEM,660006,2,3,16,21,01
Rogers,U.S. House,Amanda Douglas,DEM,660006,5,2,9,16,01
Rogers,Governor,Mick Cornett,REP,660007,3,19,94,116,
Rogers,Governor,Kevin Stitt,REP,660007,10,28,148,186,
Rogers,Lieutenant Governor,Dana Murphy,REP,660007,5,10,96,111,
Rogers,Lieutenant Governor,Matt Pinnell,REP,660007,8,36,142,186,
Rogers,State Auditor,Cindy Byrd,REP,660007,8,17,138,163,
Rogers,State Auditor,Charlie Prater,REP,660007,5,25,100,130,
Rogers,Attorney General,Mike Hunter,REP,660007,7,23,114,144,
Rogers,Attorney General,Gentner Drummond,REP,660007,6,23,127,156,
Rogers,Superintendent of Public Instruction,Joy Hofmeister,REP,660007,8,22,134,164,
Rogers,Superintendent of Public Instruction,Linda Murphy,REP,660007,5,22,105,132,
Rogers,Commissioner of Labor,Cathy Costello,REP,660007,6,24,122,152,
Rogers,Commissioner of Labor,Leslie Osborn,REP,660007,7,19,116,142,
Rogers,Corporation Commissioner,Bob Anthony,REP,660007,6,23,129,158,
Rogers,Corporation Commissioner,Brian Bingman,REP,660007,7,19,107,133,
Rogers,Governor,Chris Powell,LIB,660007,0,0,0,0,
Rogers,Governor,Rex Lawhorn,LIB,660007,0,0,0,0,
Rogers,Corporation Commissioner,Ashley Nicole Mccray,DEM,660007,2,8,43,53,
Rogers,Corporation Commissioner,Blake Cummings,DEM,660007,2,7,24,33,
Rogers,U.S. House,Jason Nichols,DEM,660007,2,7,37,46,02
Rogers,U.S. House,Clay Padgett,DEM,660007,2,9,29,40,02
Rogers,Governor,Mick Cornett,REP,660008,7,16,90,113,
Rogers,Governor,Kevin Stitt,REP,660008,4,17,115,136,
Rogers,Lieutenant Governor,Dana Murphy,REP,660008,4,10,53,67,
Rogers,Lieutenant Governor,Matt Pinnell,REP,660008,7,23,150,180,
Rogers,State Auditor,Cindy Byrd,REP,660008,7,17,100,124,
Rogers,State Auditor,Charlie Prater,REP,660008,4,16,98,118,
Rogers,Attorney General,Mike Hunter,REP,660008,4,11,77,92,
Rogers,Attorney General,Gentner Drummond,REP,660008,7,22,124,153,
Rogers,Superintendent of Public Instruction,Joy Hofmeister,REP,660008,6,21,123,150,
Rogers,Superintendent of Public Instruction,Linda Murphy,REP,660008,5,11,79,95,
Rogers,Commissioner of Labor,Cathy Costello,REP,660008,8,17,89,114,
Rogers,Commissioner of Labor,Leslie Osborn,REP,660008,3,15,111,129,
Rogers,Corporation Commissioner,Bob Anthony,REP,660008,8,16,86,110,
Rogers,Corporation Commissioner,Brian Bingman,REP,660008,3,16,109,128,
Rogers,Governor,Chris Powell,LIB,660008,0,0,0,0,
Rogers,Governor,Rex Lawhorn,LIB,660008,0,0,1,1,
Rogers,Corporation Commissioner,Ashley Nicole Mccray,DEM,660008,4,9,48,61,
Rogers,Corporation Commissioner,Blake Cummings,DEM,660008,4,8,13,25,
Rogers,U.S. House,Jason Nichols,DEM,660008,6,7,40,53,02
Rogers,U.S. House,Clay Padgett,DEM,660008,2,10,22,34,02
Rogers,Governor,Mick Cornett,REP,660009,1,4,55,60,
Rogers,Governor,Kevin Stitt,REP,660009,7,11,84,102,
Rogers,Lieutenant Governor,Dana Murphy,REP,660009,3,0,30,33,
Rogers,Lieutenant Governor,Matt Pinnell,REP,660009,5,15,107,127,
Rogers,State Auditor,Cindy Byrd,REP,660009,5,9,61,75,
Rogers,State Auditor,Charlie Prater,REP,660009,3,6,70,79,
Rogers,Attorney General,Mike Hunter,REP,660009,4,7,58,69,
Rogers,Attorney General,Gentner Drummond,REP,660009,4,8,80,92,
Rogers,Superintendent of Public Instruction,Joy Hofmeister,REP,660009,5,6,77,88,
Rogers,Superintendent of Public Instruction,Linda Murphy,REP,660009,3,9,57,69,
Rogers,Commissioner of Labor,Cathy Costello,REP,660009,5,11,71,87,
Rogers,Commissioner of Labor,Leslie Osborn,REP,660009,3,4,65,72,
Rogers,Corporation Commissioner,Bob Anthony,REP,660009,6,11,75,92,
Rogers,Corporation Commissioner,Brian Bingman,REP,660009,2,4,58,64,
Rogers,Governor,Chris Powell,LIB,660009,0,0,0,0,
Rogers,Governor,Rex Lawhorn,LIB,660009,0,0,0,0,
Rogers,Corporation Commissioner,Ashley Nicole Mccray,DEM,660009,2,4,11,17,
Rogers,Corporation Commissioner,Blake Cummings,DEM,660009,3,3,6,12,
Rogers,U.S. House,Jason Nichols,DEM,660009,5,3,11,19,02
Rogers,U.S. House,Clay Padgett,DEM,660009,0,4,7,11,02
Rogers,Governor,Mick Cornett,REP,660010,5,0,102,107,
Rogers,Governor,Kevin Stitt,REP,660010,10,11,267,288,
Rogers,Lieutenant Governor,Dana Murphy,REP,660010,6,3,134,143,
Rogers,Lieutenant Governor,Matt Pinnell,REP,660010,10,6,228,244,
Rogers,State Auditor,Cindy Byrd,REP,660010,7,5,146,158,
Rogers,State Auditor,Charlie Prater,REP,660010,9,4,213,226,
Rogers,Attorney General,Mike Hunter,REP,660010,8,6,157,171,
Rogers,Attorney General,Gentner Drummond,REP,660010,7,5,207,219,
Rogers,Superintendent of Public Instruction,Joy Hofmeister,REP,660010,8,7,190,205,
Rogers,Superintendent of Public Instruction,Linda Murphy,REP,660010,8,2,171,181,
Rogers,Commissioner of Labor,Cathy Costello,REP,660010,11,7,189,207,
Rogers,Commissioner of Labor,Leslie Osborn,REP,660010,5,1,163,169,
Rogers,Corporation Commissioner,Bob Anthony,REP,660010,8,7,188,203,
Rogers,Corporation Commissioner,Brian Bingman,REP,660010,7,2,170,179,
Rogers,U.S. House,Tim Harris,REP,660010,10,4,126,140,01
Rogers,U.S. House,Kevin Hern,REP,660010,6,7,240,253,01
Rogers,Governor,Chris Powell,LIB,660010,0,0,2,2,
Rogers,Governor,Rex Lawhorn,LIB,660010,0,0,0,0,
Rogers,Corporation Commissioner,Ashley Nicole Mccray,DEM,660010,2,1,73,76,
Rogers,Corporation Commissioner,Blake Cummings,DEM,660010,6,0,35,41,
Rogers,U.S. House,Tim Gilpin,DEM,660010,4,0,56,60,01
Rogers,U.S. House,Amanda Douglas,DEM,660010,4,1,52,57,01
Rogers,Governor,Mick Cornett,REP,660011,1,11,79,91,
Rogers,Governor,Kevin Stitt,REP,660011,6,11,167,184,
Rogers,Lieutenant Governor,Dana Murphy,REP,660011,3,9,61,73,
Rogers,Lieutenant Governor,Matt Pinnell,REP,660011,3,12,184,199,
Rogers,State Auditor,Cindy Byrd,REP,660011,6,13,107,126,
Rogers,State Auditor,Charlie Prater,REP,660011,1,8,136,145,
Rogers,Attorney General,Mike Hunter,REP,660011,2,8,110,120,
Rogers,Attorney General,Gentner Drummond,REP,660011,5,14,137,156,
Rogers,Superintendent of Public Instruction,Joy Hofmeister,REP,660011,3,11,115,129,
Rogers,Superintendent of Public Instruction,Linda Murphy,REP,660011,4,11,129,144,
Rogers,Commissioner of Labor,Cathy Costello,REP,660011,5,17,117,139,
Rogers,Commissioner of Labor,Leslie Osborn,REP,660011,2,5,123,130,
Rogers,Corporation Commissioner,Bob Anthony,REP,660011,1,12,115,128,
Rogers,Corporation Commissioner,Brian Bingman,REP,660011,6,10,124,140,
Rogers,Governor,Chris Powell,LIB,660011,0,0,0,0,
Rogers,Governor,Rex Lawhorn,LIB,660011,0,0,0,0,
Rogers,Corporation Commissioner,Ashley Nicole Mccray,DEM,660011,3,8,66,77,
Rogers,Corporation Commissioner,Blake Cummings,DEM,660011,2,3,41,46,
Rogers,U.S. House,Jason Nichols,DEM,660011,3,8,63,74,02
Rogers,U.S. House,Clay Padgett,DEM,660011,2,3,45,50,02
Rogers,Governor,Mick Cornett,REP,660012,0,0,27,27,
Rogers,Governor,Kevin Stitt,REP,660012,2,3,46,51,
Rogers,Lieutenant Governor,Dana Murphy,REP,660012,1,0,21,22,
Rogers,Lieutenant Governor,Matt Pinnell,REP,660012,1,3,49,53,
Rogers,State Auditor,Cindy Byrd,REP,660012,2,0,30,32,
Rogers,State Auditor,Charlie Prater,REP,660012,0,3,40,43,
Rogers,Attorney General,Mike Hunter,REP,660012,2,0,29,31,
Rogers,Attorney General,Gentner Drummond,REP,660012,0,3,43,46,
Rogers,Superintendent of Public Instruction,Joy Hofmeister,REP,660012,1,0,39,40,
Rogers,Superintendent of Public Instruction,Linda Murphy,REP,660012,1,3,32,36,
Rogers,Commissioner of Labor,Cathy Costello,REP,660012,1,0,26,27,
Rogers,Commissioner of Labor,Leslie Osborn,REP,660012,1,3,44,48,
Rogers,Corporation Commissioner,Bob Anthony,REP,660012,2,0,35,37,
Rogers,Corporation Commissioner,Brian Bingman,REP,660012,0,3,34,37,
Rogers,Governor,Chris Powell,LIB,660012,0,0,0,0,
Rogers,Governor,Rex Lawhorn,LIB,660012,0,0,0,0,
Rogers,Corporation Commissioner,Ashley Nicole Mccray,DEM,660012,0,1,14,15,
Rogers,Corporation Commissioner,Blake Cummings,DEM,660012,0,0,9,9,
Rogers,U.S. House,Jason Nichols,DEM,660012,0,0,13,13,02
Rogers,U.S. House,Clay Padgett,DEM,660012,0,1,10,11,02
Rogers,Governor,Mick Cornett,REP,660013,1,9,71,81,
Rogers,Governor,Kevin Stitt,REP,660013,2,17,131,150,
Rogers,Lieutenant Governor,Dana Murphy,REP,660013,1,7,50,58,
Rogers,Lieutenant Governor,Matt Pinnell,REP,660013,2,18,150,170,
Rogers,State Auditor,Cindy Byrd,REP,660013,1,8,79,88,
Rogers,State Auditor,Charlie Prater,REP,660013,2,17,119,138,
Rogers,Attorney General,Mike Hunter,REP,660013,2,8,83,93,
Rogers,Attorney General,Gentner Drummond,REP,660013,1,17,119,137,
Rogers,Superintendent of Public Instruction,Joy Hofmeister,REP,660013,3,14,106,123,
Rogers,Superintendent of Public Instruction,Linda Murphy,REP,660013,0,12,94,106,
Rogers,Commissioner of Labor,Cathy Costello,REP,660013,2,15,109,126,
Rogers,Commissioner of Labor,Leslie Osborn,REP,660013,1,10,89,100,
Rogers,Corporation Commissioner,Bob Anthony,REP,660013,3,14,94,111,
Rogers,Corporation Commissioner,Brian Bingman,REP,660013,0,12,106,118,
Rogers,Governor,Chris Powell,LIB,660013,0,0,0,0,
Rogers,Governor,Rex Lawhorn,LIB,660013,0,0,0,0,
Rogers,Corporation Commissioner,Ashley Nicole Mccray,DEM,660013,2,7,38,47,
Rogers,Corporation Commissioner,Blake Cummings,DEM,660013,0,1,19,20,
Rogers,U.S. House,Jason Nichols,DEM,660013,2,4,31,37,02
Rogers,U.S. House,Clay Padgett,DEM,660013,0,4,26,30,02
Rogers,Governor,Mick Cornett,REP,660014,6,20,93,119,
Rogers,Governor,Kevin Stitt,REP,660014,2,14,152,168,
Rogers,Lieutenant Governor,Dana Murphy,REP,660014,5,9,79,93,
Rogers,Lieutenant Governor,Matt Pinnell,REP,660014,3,24,165,192,
Rogers,State Auditor,Cindy Byrd,REP,660014,4,16,114,134,
Rogers,State Auditor,Charlie Prater,REP,660014,4,16,121,141,
Rogers,Attorney General,Mike Hunter,REP,660014,2,11,96,109,
Rogers,Attorney General,Gentner Drummond,REP,660014,6,21,147,174,
Rogers,Superintendent of Public Instruction,Joy Hofmeister,REP,660014,5,27,143,175,
Rogers,Superintendent of Public Instruction,Linda Murphy,REP,660014,2,6,104,112,
Rogers,Commissioner of Labor,Cathy Costello,REP,660014,1,14,128,143,
Rogers,Commissioner of Labor,Leslie Osborn,REP,660014,6,19,112,137,
Rogers,Corporation Commissioner,Bob Anthony,REP,660014,8,19,123,150,
Rogers,Corporation Commissioner,Brian Bingman,REP,660014,0,13,114,127,
Rogers,Governor,Chris Powell,LIB,660014,0,0,0,0,
Rogers,Governor,Rex Lawhorn,LIB,660014,0,0,0,0,
Rogers,Corporation Commissioner,Ashley Nicole Mccray,DEM,660014,1,8,42,51,
Rogers,Corporation Commissioner,Blake Cummings,DEM,660014,0,6,19,25,
Rogers,U.S. House,Jason Nichols,DEM,660014,1,6,36,43,02
Rogers,U.S. House,Clay Padgett,DEM,660014,0,8,24,32,02
Rogers,Governor,Mick Cornett,REP,660015,3,5,108,116,
Rogers,Governor,Kevin Stitt,REP,660015,2,9,170,181,
Rogers,Lieutenant Governor,Dana Murphy,REP,660015,1,4,91,96,
Rogers,Lieutenant Governor,Matt Pinnell,REP,660015,4,8,183,195,
Rogers,State Auditor,Cindy Byrd,REP,660015,2,6,126,134,
Rogers,State Auditor,Charlie Prater,REP,660015,2,5,145,152,
Rogers,Attorney General,Mike Hunter,REP,660015,3,7,121,131,
Rogers,Attorney General,Gentner Drummond,REP,660015,2,6,157,165,
Rogers,Superintendent of Public Instruction,Joy Hofmeister,REP,660015,2,6,158,166,
Rogers,Superintendent of Public Instruction,Linda Murphy,REP,660015,3,6,115,124,
Rogers,Commissioner of Labor,Cathy Costello,REP,660015,3,8,122,133,
Rogers,Commissioner of Labor,Leslie Osborn,REP,660015,1,5,151,157,
Rogers,Corporation Commissioner,Bob Anthony,REP,660015,5,7,116,128,
Rogers,Corporation Commissioner,Brian Bingman,REP,660015,0,5,157,162,
Rogers,Governor,Chris Powell,LIB,660015,0,0,0,0,
Rogers,Governor,Rex Lawhorn,LIB,660015,0,0,0,0,
Rogers,Corporation Commissioner,Ashley Nicole Mccray,DEM,660015,4,2,54,60,
Rogers,Corporation Commissioner,Blake Cummings,DEM,660015,3,1,35,39,
Rogers,U.S. House,Jason Nichols,DEM,660015,4,1,52,57,02
Rogers,U.S. House,Clay Padgett,DEM,660015,3,2,37,42,02
Rogers,Governor,Mick Cornett,REP,660017,1,2,45,48,
Rogers,Governor,Kevin Stitt,REP,660017,2,6,87,95,
Rogers,Lieutenant Governor,Dana Murphy,REP,660017,0,0,36,36,
Rogers,Lieutenant Governor,Matt Pinnell,REP,660017,3,8,97,108,
Rogers,State Auditor,Cindy Byrd,REP,660017,3,3,56,62,
Rogers,State Auditor,Charlie Prater,REP,660017,0,5,73,78,
Rogers,Attorney General,Mike Hunter,REP,660017,1,5,57,63,
Rogers,Attorney General,Gentner Drummond,REP,660017,2,2,75,79,
Rogers,Superintendent of Public Instruction,Joy Hofmeister,REP,660017,3,3,76,82,
Rogers,Superintendent of Public Instruction,Linda Murphy,REP,660017,0,5,55,60,
Rogers,Commissioner of Labor,Cathy Costello,REP,660017,0,4,68,72,
Rogers,Commissioner of Labor,Leslie Osborn,REP,660017,3,4,62,69,
Rogers,Corporation Commissioner,Bob Anthony,REP,660017,1,3,62,66,
Rogers,Corporation Commissioner,Brian Bingman,REP,660017,2,5,70,77,
Rogers,Governor,Chris Powell,LIB,660017,0,0,0,0,
Rogers,Governor,Rex Lawhorn,LIB,660017,0,0,0,0,
Rogers,Corporation Commissioner,Ashley Nicole Mccray,DEM,660017,0,3,19,22,
Rogers,Corporation Commissioner,Blake Cummings,DEM,660017,0,3,17,20,
Rogers,U.S. House,Jason Nichols,DEM,660017,0,3,20,23,02
Rogers,U.S. House,Clay Padgett,DEM,660017,0,3,16,19,02
Rogers,Governor,Mick Cornett,REP,660018,5,15,128,148,
Rogers,Governor,Kevin Stitt,REP,660018,7,22,196,225,
Rogers,Lieutenant Governor,Dana Murphy,REP,660018,2,7,82,91,
Rogers,Lieutenant Governor,Matt Pinnell,REP,660018,11,30,238,279,
Rogers,State Auditor,Cindy Byrd,REP,660018,4,16,146,166,
Rogers,State Auditor,Charlie Prater,REP,660018,9,20,171,200,
Rogers,Attorney General,Mike Hunter,REP,660018,3,17,128,148,
Rogers,Attorney General,Gentner Drummond,REP,660018,10,20,190,220,
Rogers,Superintendent of Public Instruction,Joy Hofmeister,REP,660018,8,24,187,219,
Rogers,Superintendent of Public Instruction,Linda Murphy,REP,660018,5,13,129,147,
Rogers,Commissioner of Labor,Cathy Costello,REP,660018,10,21,170,201,
Rogers,Commissioner of Labor,Leslie Osborn,REP,660018,3,16,144,163,
Rogers,Corporation Commissioner,Bob Anthony,REP,660018,9,24,161,194,
Rogers,Corporation Commissioner,Brian Bingman,REP,660018,4,13,158,175,
Rogers,Governor,Chris Powell,LIB,660018,0,0,0,0,
Rogers,Governor,Rex Lawhorn,LIB,660018,0,0,0,0,
Rogers,Corporation Commissioner,Ashley Nicole Mccray,DEM,660018,4,7,38,49,
Rogers,Corporation Commissioner,Blake Cummings,DEM,660018,3,4,31,38,
Rogers,U.S. House,Jason Nichols,DEM,660018,2,9,40,51,02
Rogers,U.S. House,Clay Padgett,DEM,660018,5,3,29,37,02
Rogers,Governor,Mick Cornett,REP,660019,1,5,57,63,
Rogers,Governor,Kevin Stitt,REP,660019,5,7,126,138,
Rogers,Lieutenant Governor,Dana Murphy,REP,660019,3,3,59,65,
Rogers,Lieutenant Governor,Matt Pinnell,REP,660019,3,9,124,136,
Rogers,State Auditor,Cindy Byrd,REP,660019,2,5,81,88,
Rogers,State Auditor,Charlie Prater,REP,660019,3,7,97,107,
Rogers,Attorney General,Mike Hunter,REP,660019,1,6,78,85,
Rogers,Attorney General,Gentner Drummond,REP,660019,5,6,106,117,
Rogers,Superintendent of Public Instruction,Joy Hofmeister,REP,660019,4,8,96,108,
Rogers,Superintendent of Public Instruction,Linda Murphy,REP,660019,2,4,88,94,
Rogers,Commissioner of Labor,Cathy Costello,REP,660019,4,3,90,97,
Rogers,Commissioner of Labor,Leslie Osborn,REP,660019,1,9,91,101,
Rogers,Corporation Commissioner,Bob Anthony,REP,660019,4,5,91,100,
Rogers,Corporation Commissioner,Brian Bingman,REP,660019,1,7,88,96,
Rogers,Governor,Chris Powell,LIB,660019,0,0,0,0,
Rogers,Governor,Rex Lawhorn,LIB,660019,0,0,0,0,
Rogers,Corporation Commissioner,Ashley Nicole Mccray,DEM,660019,8,3,8,19,
Rogers,Corporation Commissioner,Blake Cummings,DEM,660019,1,3,16,20,
Rogers,U.S. House,Jason Nichols,DEM,660019,4,4,16,24,02
Rogers,U.S. House,Clay Padgett,DEM,660019,5,2,8,15,02
Rogers,Governor,Mick Cornett,REP,660020,7,25,131,163,
Rogers,Governor,Kevin Stitt,REP,660020,5,21,191,217,
Rogers,Lieutenant Governor,Dana Murphy,REP,660020,2,14,93,109,
Rogers,Lieutenant Governor,Matt Pinnell,REP,660020,10,32,226,268,
Rogers,State Auditor,Cindy Byrd,REP,660020,4,23,163,190,
Rogers,State Auditor,Charlie Prater,REP,660020,8,21,150,179,
Rogers,Attorney General,Mike Hunter,REP,660020,5,17,122,144,
Rogers,Attorney General,Gentner Drummond,REP,660020,7,29,195,231,
Rogers,Superintendent of Public Instruction,Joy Hofmeister,REP,660020,3,28,195,226,
Rogers,Superintendent of Public Instruction,Linda Murphy,REP,660020,9,17,126,152,
Rogers,Commissioner of Labor,Cathy Costello,REP,660020,9,30,158,197,
Rogers,Commissioner of Labor,Leslie Osborn,REP,660020,3,15,160,178,
Rogers,Corporation Commissioner,Bob Anthony,REP,660020,3,23,153,179,
Rogers,Corporation Commissioner,Brian Bingman,REP,660020,9,22,163,194,
Rogers,Governor,Chris Powell,LIB,660020,0,0,0,0,
Rogers,Governor,Rex Lawhorn,LIB,660020,0,0,0,0,
Rogers,Corporation Commissioner,Ashley Nicole Mccray,DEM,660020,2,4,62,68,
Rogers,Corporation Commissioner,Blake Cummings,DEM,660020,0,6,36,42,
Rogers,U.S. House,Jason Nichols,DEM,660020,1,4,51,56,02
Rogers,U.S. House,Clay Padgett,DEM,660020,1,6,49,56,02
Rogers,Governor,Mick Cornett,REP,660021,2,3,41,46,
Rogers,Governor,Kevin Stitt,REP,660021,3,3,68,74,
Rogers,Lieutenant Governor,Dana Murphy,REP,660021,0,0,30,30,
Rogers,Lieutenant Governor,Matt Pinnell,REP,660021,5,6,75,86,
Rogers,State Auditor,Cindy Byrd,REP,660021,5,3,58,66,
Rogers,State Auditor,Charlie Prater,REP,660021,0,3,43,46,
Rogers,Attorney General,Mike Hunter,REP,660021,3,3,55,61,
Rogers,Attorney General,Gentner Drummond,REP,660021,2,3,47,52,
Rogers,Superintendent of Public Instruction,Joy Hofmeister,REP,660021,1,4,68,73,
Rogers,Superintendent of Public Instruction,Linda Murphy,REP,660021,4,2,38,44,
Rogers,Commissioner of Labor,Cathy Costello,REP,660021,5,3,43,51,
Rogers,Commissioner of Labor,Leslie Osborn,REP,660021,0,2,60,62,
Rogers,Corporation Commissioner,Bob Anthony,REP,660021,3,3,43,49,
Rogers,Corporation Commissioner,Brian Bingman,REP,660021,2,3,58,63,
Rogers,U.S. House,Tim Harris,REP,660021,2,2,39,43,01
Rogers,U.S. House,Kevin Hern,REP,660021,3,4,67,74,01
Rogers,Governor,Chris Powell,LIB,660021,0,0,0,0,
Rogers,Governor,Rex Lawhorn,LIB,660021,0,0,0,0,
Rogers,Corporation Commissioner,Ashley Nicole Mccray,DEM,660021,2,1,3,6,
Rogers,Corporation Commissioner,Blake Cummings,DEM,660021,0,0,2,2,
Rogers,U.S. House,Tim Gilpin,DEM,660021,1,1,2,4,01
Rogers,U.S. House,Amanda Douglas,DEM,660021,1,0,3,4,01
Rogers,Governor,Mick Cornett,REP,660022,5,9,108,122,
Rogers,Governor,Kevin Stitt,REP,660022,7,19,151,177,
Rogers,Lieutenant Governor,Dana Murphy,REP,660022,4,9,64,77,
Rogers,Lieutenant Governor,Matt Pinnell,REP,660022,8,18,194,220,
Rogers,State Auditor,Cindy Byrd,REP,660022,5,13,106,124,
Rogers,State Auditor,Charlie Prater,REP,660022,5,13,144,162,
Rogers,Attorney General,Mike Hunter,REP,660022,4,8,105,117,
Rogers,Attorney General,Gentner Drummond,REP,660022,8,20,153,181,
Rogers,Superintendent of Public Instruction,Joy Hofmeister,REP,660022,8,14,139,161,
Rogers,Superintendent of Public Instruction,Linda Murphy,REP,660022,3,13,117,133,
Rogers,Commissioner of Labor,Cathy Costello,REP,660022,2,14,126,142,
Rogers,Commissioner of Labor,Leslie Osborn,REP,660022,8,12,126,146,
Rogers,Corporation Commissioner,Bob Anthony,REP,660022,6,10,131,147,
Rogers,Corporation Commissioner,Brian Bingman,REP,660022,4,16,125,145,
Rogers,Governor,Chris Powell,LIB,660022,0,0,0,0,
Rogers,Governor,Rex Lawhorn,LIB,660022,0,0,0,0,
Rogers,Corporation Commissioner,Ashley Nicole Mccray,DEM,660022,1,0,48,49,
Rogers,Corporation Commissioner,Blake Cummings,DEM,660022,1,2,38,41,
Rogers,U.S. House,Jason Nichols,DEM,660022,1,1,49,51,02
Rogers,U.S. House,Clay Padgett,DEM,660022,1,1,38,40,02
Rogers,Governor,Mick Cornett,REP,660023,3,4,84,91,
Rogers,Governor,Kevin Stitt,REP,660023,2,13,269,284,
Rogers,Lieutenant Governor,Dana Murphy,REP,660023,2,6,89,97,
Rogers,Lieutenant Governor,Matt Pinnell,REP,660023,3,11,259,273,
Rogers,State Auditor,Cindy Byrd,REP,660023,3,5,128,136,
Rogers,State Auditor,Charlie Prater,REP,660023,2,12,211,225,
Rogers,Attorney General,Mike Hunter,REP,660023,3,6,134,143,
Rogers,Attorney General,Gentner Drummond,REP,660023,2,11,213,226,
Rogers,Superintendent of Public Instruction,Joy Hofmeister,REP,660023,3,8,168,179,
Rogers,Superintendent of Public Instruction,Linda Murphy,REP,660023,2,9,173,184,
Rogers,Commissioner of Labor,Cathy Costello,REP,660023,5,11,176,192,
Rogers,Commissioner of Labor,Leslie Osborn,REP,660023,0,6,166,172,
Rogers,Corporation Commissioner,Bob Anthony,REP,660023,3,7,178,188,
Rogers,Corporation Commissioner,Brian Bingman,REP,660023,2,10,169,181,
Rogers,Governor,Chris Powell,LIB,660023,0,0,0,0,
Rogers,Governor,Rex Lawhorn,LIB,660023,0,0,0,0,
Rogers,Corporation Commissioner,Ashley Nicole Mccray,DEM,660023,2,4,74,80,
Rogers,Corporation Commissioner,Blake Cummings,DEM,660023,1,1,85,87,
Rogers,U.S. House,Jason Nichols,DEM,660023,1,0,101,102,02
Rogers,U.S. House,Clay Padgett,DEM,660023,2,5,60,67,02
Rogers,Governor,Mick Cornett,REP,660024,0,1,47,48,
Rogers,Governor,Kevin Stitt,REP,660024,5,2,87,94,
Rogers,Lieutenant Governor,Dana Murphy,REP,660024,3,1,47,51,
Rogers,Lieutenant Governor,Matt Pinnell,REP,660024,2,2,87,91,
Rogers,State Auditor,Cindy Byrd,REP,660024,3,3,53,59,
Rogers,State Auditor,Charlie Prater,REP,660024,1,0,81,82,
Rogers,Attorney General,Mike Hunter,REP,660024,1,2,45,48,
Rogers,Attorney General,Gentner Drummond,REP,660024,4,1,89,94,
Rogers,Superintendent of Public Instruction,Joy Hofmeister,REP,660024,4,2,73,79,
Rogers,Superintendent of Public Instruction,Linda Murphy,REP,660024,1,1,58,60,
Rogers,Commissioner of Labor,Cathy Costello,REP,660024,3,2,58,63,
Rogers,Commissioner of Labor,Leslie Osborn,REP,660024,2,1,74,77,
Rogers,Corporation Commissioner,Bob Anthony,REP,660024,3,1,62,66,
Rogers,Corporation Commissioner,Brian Bingman,REP,660024,2,2,72,76,
Rogers,Governor,Chris Powell,LIB,660024,0,0,0,0,
Rogers,Governor,Rex Lawhorn,LIB,660024,0,0,0,0,
Rogers,Corporation Commissioner,Ashley Nicole Mccray,DEM,660024,0,1,23,24,
Rogers,Corporation Commissioner,Blake Cummings,DEM,660024,0,0,10,10,
Rogers,U.S. House,Jason Nichols,DEM,660024,0,0,19,19,02
Rogers,U.S. House,Clay Padgett,DEM,660024,0,1,14,15,02
Rogers,Governor,Mick Cornett,REP,660025,1,0,16,17,
Rogers,Governor,Kevin Stitt,REP,660025,3,0,42,45,
Rogers,Lieutenant Governor,Dana Murphy,REP,660025,0,0,22,22,
Rogers,Lieutenant Governor,Matt Pinnell,REP,660025,4,0,36,40,
Rogers,State Auditor,Cindy Byrd,REP,660025,0,0,25,25,
Rogers,State Auditor,Charlie Prater,REP,660025,4,0,32,36,
Rogers,Attorney General,Mike Hunter,REP,660025,2,0,22,24,
Rogers,Attorney General,Gentner Drummond,REP,660025,2,0,36,38,
Rogers,Superintendent of Public Instruction,Joy Hofmeister,REP,660025,2,0,30,32,
Rogers,Superintendent of Public Instruction,Linda Murphy,REP,660025,2,0,28,30,
Rogers,Commissioner of Labor,Cathy Costello,REP,660025,4,0,26,30,
Rogers,Commissioner of Labor,Leslie Osborn,REP,660025,0,0,30,30,
Rogers,Corporation Commissioner,Bob Anthony,REP,660025,2,0,22,24,
Rogers,Corporation Commissioner,Brian Bingman,REP,660025,2,0,36,38,
Rogers,U.S. House,Tim Harris,REP,660025,3,0,23,26,01
Rogers,U.S. House,Kevin Hern,REP,660025,1,0,35,36,01
Rogers,Governor,Chris Powell,LIB,660025,0,0,0,0,
Rogers,Governor,Rex Lawhorn,LIB,660025,0,0,0,0,
Rogers,Corporation Commissioner,Ashley Nicole Mccray,DEM,660025,0,2,5,7,
Rogers,Corporation Commissioner,Blake Cummings,DEM,660025,0,0,3,3,
Rogers,U.S. House,Tim Gilpin,DEM,660025,0,2,4,6,01
Rogers,U.S. House,Amanda Douglas,DEM,660025,0,0,5,5,01
Rogers,Governor,Mick Cornett,REP,660026,6,8,115,129,
Rogers,Governor,Kevin Stitt,REP,660026,7,14,261,282,
Rogers,Lieutenant Governor,Dana Murphy,REP,660026,2,5,102,109,
Rogers,Lieutenant Governor,Matt Pinnell,REP,660026,11,17,268,296,
Rogers,State Auditor,Cindy Byrd,REP,660026,6,12,148,166,
Rogers,State Auditor,Charlie Prater,REP,660026,8,10,211,229,
Rogers,Attorney General,Mike Hunter,REP,660026,1,10,140,151,
Rogers,Attorney General,Gentner Drummond,REP,660026,13,12,234,259,
Rogers,Superintendent of Public Instruction,Joy Hofmeister,REP,660026,8,8,190,206,
Rogers,Superintendent of Public Instruction,Linda Murphy,REP,660026,6,14,182,202,
Rogers,Commissioner of Labor,Cathy Costello,REP,660026,7,12,184,203,
Rogers,Commissioner of Labor,Leslie Osborn,REP,660026,7,10,181,198,
Rogers,Corporation Commissioner,Bob Anthony,REP,660026,5,7,168,180,
Rogers,Corporation Commissioner,Brian Bingman,REP,660026,9,15,197,221,
Rogers,Governor,Chris Powell,LIB,660026,0,0,1,1,
Rogers,Governor,Rex Lawhorn,LIB,660026,0,0,0,0,
Rogers,Corporation Commissioner,Ashley Nicole Mccray,DEM,660026,6,2,48,56,
Rogers,Corporation Commissioner,Blake Cummings,DEM,660026,3,2,33,38,
Rogers,U.S. House,Jason Nichols,DEM,660026,4,3,47,54,02
Rogers,U.S. House,Clay Padgett,DEM,660026,5,1,34,40,02
Rogers,Governor,Mick Cornett,REP,660027,3,5,52,60,
Rogers,Governor,Kevin Stitt,REP,660027,1,5,111,117,
Rogers,Lieutenant Governor,Dana Murphy,REP,660027,1,6,48,55,
Rogers,Lieutenant Governor,Matt Pinnell,REP,660027,3,4,113,120,
Rogers,State Auditor,Cindy Byrd,REP,660027,1,7,71,79,
Rogers,State Auditor,Charlie Prater,REP,660027,3,3,87,93,
Rogers,Attorney General,Mike Hunter,REP,660027,2,4,59,65,
Rogers,Attorney General,Gentner Drummond,REP,660027,2,6,102,110,
Rogers,Superintendent of Public Instruction,Joy Hofmeister,REP,660027,1,5,71,77,
Rogers,Superintendent of Public Instruction,Linda Murphy,REP,660027,3,5,89,97,
Rogers,Commissioner of Labor,Cathy Costello,REP,660027,2,7,75,84,
Rogers,Commissioner of Labor,Leslie Osborn,REP,660027,2,3,81,86,
Rogers,Corporation Commissioner,Bob Anthony,REP,660027,1,7,76,84,
Rogers,Corporation Commissioner,Brian Bingman,REP,660027,3,3,83,89,
Rogers,Governor,Chris Powell,LIB,660027,0,0,0,0,
Rogers,Governor,Rex Lawhorn,LIB,660027,0,0,0,0,
Rogers,Corporation Commissioner,Ashley Nicole Mccray,DEM,660027,0,1,26,27,
Rogers,Corporation Commissioner,Blake Cummings,DEM,660027,2,0,20,22,
Rogers,U.S. House,Jason Nichols,DEM,660027,1,0,21,22,02
Rogers,U.S. House,Clay Padgett,DEM,660027,1,1,27,29,02
Rogers,Governor,Mick Cornett,REP,660029,2,5,64,71,
Rogers,Governor,Kevin Stitt,REP,660029,4,1,105,110,
Rogers,Lieutenant Governor,Dana Murphy,REP,660029,1,3,51,55,
Rogers,Lieutenant Governor,Matt Pinnell,REP,660029,5,3,117,125,
Rogers,State Auditor,Cindy Byrd,REP,660029,1,4,66,71,
Rogers,State Auditor,Charlie Prater,REP,660029,5,2,96,103,
Rogers,Attorney General,Mike Hunter,REP,660029,2,0,73,75,
Rogers,Attorney General,Gentner Drummond,REP,660029,4,6,95,105,
Rogers,Superintendent of Public Instruction,Joy Hofmeister,REP,660029,1,6,93,100,
Rogers,Superintendent of Public Instruction,Linda Murphy,REP,660029,5,0,74,79,
Rogers,Commissioner of Labor,Cathy Costello,REP,660029,1,3,81,85,
Rogers,Commissioner of Labor,Leslie Osborn,REP,660029,5,3,84,92,
Rogers,Corporation Commissioner,Bob Anthony,REP,660029,2,3,87,92,
Rogers,Corporation Commissioner,Brian Bingman,REP,660029,4,3,78,85,
Rogers,Governor,Chris Powell,LIB,660029,0,0,0,0,
Rogers,Governor,Rex Lawhorn,LIB,660029,0,0,0,0,
Rogers,Corporation Commissioner,Ashley Nicole Mccray,DEM,660029,0,2,14,16,
Rogers,Corporation Commissioner,Blake Cummings,DEM,660029,0,0,10,10,
Rogers,U.S. House,Jason Nichols,DEM,660029,0,1,18,19,02
Rogers,U.S. House,Clay Padgett,DEM,660029,0,1,6,7,02
Rogers,Governor,Mick Cornett,REP,660030,14,19,130,163,
Rogers,Governor,Kevin Stitt,REP,660030,14,19,301,334,
Rogers,Lieutenant Governor,Dana Murphy,REP,660030,16,17,152,185,
Rogers,Lieutenant Governor,Matt Pinnell,REP,660030,12,21,270,303,
Rogers,State Auditor,Cindy Byrd,REP,660030,19,22,226,267,
Rogers,State Auditor,Charlie Prater,REP,660030,9,16,181,206,
Rogers,Attorney General,Mike Hunter,REP,660030,12,17,185,214,
Rogers,Attorney General,Gentner Drummond,REP,660030,16,21,240,277,
Rogers,Superintendent of Public Instruction,Joy Hofmeister,REP,660030,14,24,228,266,
Rogers,Superintendent of Public Instruction,Linda Murphy,REP,660030,14,14,196,224,
Rogers,Commissioner of Labor,Cathy Costello,REP,660030,14,22,215,251,
Rogers,Commissioner of Labor,Leslie Osborn,REP,660030,12,16,198,226,
Rogers,Corporation Commissioner,Bob Anthony,REP,660030,14,18,206,238,
Rogers,Corporation Commissioner,Brian Bingman,REP,660030,14,20,204,238,
Rogers,Governor,Chris Powell,LIB,660030,0,0,0,0,
Rogers,Governor,Rex Lawhorn,LIB,660030,0,0,1,1,
Rogers,Corporation Commissioner,Ashley Nicole Mccray,DEM,660030,8,6,48,62,
Rogers,Corporation Commissioner,Blake Cummings,DEM,660030,2,0,24,26,
Rogers,U.S. House,Jason Nichols,DEM,660030,5,2,47,54,02
Rogers,U.S. House,Clay Padgett,DEM,660030,5,4,25,34,02
Rogers,Governor,Mick Cornett,REP,660031,9,19,109,137,
Rogers,Governor,Kevin Stitt,REP,660031,14,24,207,245,
Rogers,Lieutenant Governor,Dana Murphy,REP,660031,8,16,129,153,
Rogers,Lieutenant Governor,Matt Pinnell,REP,660031,15,26,170,211,
Rogers,State Auditor,Cindy Byrd,REP,660031,13,18,161,192,
Rogers,State Auditor,Charlie Prater,REP,660031,9,23,127,159,
Rogers,Attorney General,Mike Hunter,REP,660031,11,19,126,156,
Rogers,Attorney General,Gentner Drummond,REP,660031,12,24,183,219,
Rogers,Superintendent of Public Instruction,Joy Hofmeister,REP,660031,14,29,191,234,
Rogers,Superintendent of Public Instruction,Linda Murphy,REP,660031,8,14,114,136,
Rogers,Commissioner of Labor,Cathy Costello,REP,660031,18,23,138,179,
Rogers,Commissioner of Labor,Leslie Osborn,REP,660031,5,20,157,182,
Rogers,Corporation Commissioner,Bob Anthony,REP,660031,18,26,155,199,
Rogers,Corporation Commissioner,Brian Bingman,REP,660031,4,16,141,161,
Rogers,U.S. House,Tim Harris,REP,660031,16,21,108,145,01
Rogers,U.S. House,Kevin Hern,REP,660031,7,22,202,231,01
Rogers,Governor,Chris Powell,LIB,660031,1,0,0,1,
Rogers,Governor,Rex Lawhorn,LIB,660031,0,0,1,1,
Rogers,Corporation Commissioner,Ashley Nicole Mccray,DEM,660031,0,8,34,42,
Rogers,Corporation Commissioner,Blake Cummings,DEM,660031,2,8,24,34,
Rogers,U.S. House,Tim Gilpin,DEM,660031,2,9,39,50,01
Rogers,U.S. House,Amanda Douglas,DEM,660031,0,7,22,29,01
Rogers,Governor,Mick Cornett,REP,660032,15,5,36,56,
Rogers,Governor,Kevin Stitt,REP,660032,10,15,106,131,
Rogers,Lieutenant Governor,Dana Murphy,REP,660032,8,7,59,74,
Rogers,Lieutenant Governor,Matt Pinnell,REP,660032,17,12,78,107,
Rogers,State Auditor,Cindy Byrd,REP,660032,16,5,72,93,
Rogers,State Auditor,Charlie Prater,REP,660032,9,14,64,87,
Rogers,Attorney General,Mike Hunter,REP,660032,12,4,59,75,
Rogers,Attorney General,Gentner Drummond,REP,660032,13,16,81,110,
Rogers,Superintendent of Public Instruction,Joy Hofmeister,REP,660032,9,6,71,86,
Rogers,Superintendent of Public Instruction,Linda Murphy,REP,660032,16,14,70,100,
Rogers,Commissioner of Labor,Cathy Costello,REP,660032,16,9,62,87,
Rogers,Commissioner of Labor,Leslie Osborn,REP,660032,9,11,74,94,
Rogers,Corporation Commissioner,Bob Anthony,REP,660032,9,9,54,72,
Rogers,Corporation Commissioner,Brian Bingman,REP,660032,14,10,81,105,
Rogers,Governor,Chris Powell,LIB,660032,0,0,0,0,
Rogers,Governor,Rex Lawhorn,LIB,660032,0,0,0,0,
Rogers,Corporation Commissioner,Ashley Nicole Mccray,DEM,660032,2,1,8,11,
Rogers,Corporation Commissioner,Blake Cummings,DEM,660032,3,2,7,12,
Rogers,U.S. House,Jason Nichols,DEM,660032,3,3,6,12,02
Rogers,U.S. House,Clay Padgett,DEM,660032,2,0,9,11,02
Rogers,Governor,Mick Cornett,REP,660033,0,1,28,29,
Rogers,Governor,Kevin Stitt,REP,660033,1,3,77,81,
Rogers,Lieutenant Governor,Dana Murphy,REP,660033,0,2,36,38,
Rogers,Lieutenant Governor,Matt Pinnell,REP,660033,1,2,67,70,
Rogers,State Auditor,Cindy Byrd,REP,660033,1,2,47,50,
Rogers,State Auditor,Charlie Prater,REP,660033,0,2,57,59,
Rogers,Attorney General,Mike Hunter,REP,660033,0,1,28,29,
Rogers,Attorney General,Gentner Drummond,REP,660033,1,3,77,81,
Rogers,Superintendent of Public Instruction,Joy Hofmeister,REP,660033,0,1,64,65,
Rogers,Superintendent of Public Instruction,Linda Murphy,REP,660033,1,3,40,44,
Rogers,Commissioner of Labor,Cathy Costello,REP,660033,1,0,50,51,
Rogers,Commissioner of Labor,Leslie Osborn,REP,660033,0,4,53,57,
Rogers,Corporation Commissioner,Bob Anthony,REP,660033,1,1,46,48,
Rogers,Corporation Commissioner,Brian Bingman,REP,660033,0,3,56,59,
Rogers,Governor,Chris Powell,LIB,660033,0,0,0,0,
Rogers,Governor,Rex Lawhorn,LIB,660033,0,0,0,0,
Rogers,Corporation Commissioner,Ashley Nicole Mccray,DEM,660033,0,0,14,14,
Rogers,Corporation Commissioner,Blake Cummings,DEM,660033,0,0,7,7,
Rogers,U.S. House,Jason Nichols,DEM,660033,0,0,11,11,02
Rogers,U.S. House,Clay Padgett,DEM,660033,0,0,8,8,02
Rogers,Governor,Mick Cornett,REP,660110,6,9,80,95,
Rogers,Governor,Kevin Stitt,REP,660110,1,9,149,159,
Rogers,Lieutenant Governor,Dana Murphy,REP,660110,3,8,79,90,
Rogers,Lieutenant Governor,Matt Pinnell,REP,660110,4,10,142,156,
Rogers,State Auditor,Cindy Byrd,REP,660110,4,12,108,124,
Rogers,State Auditor,Charlie Prater,REP,660110,3,6,113,122,
Rogers,Attorney General,Mike Hunter,REP,660110,2,12,80,94,
Rogers,Attorney General,Gentner Drummond,REP,660110,4,6,145,155,
Rogers,Superintendent of Public Instruction,Joy Hofmeister,REP,660110,5,14,125,144,
Rogers,Superintendent of Public Instruction,Linda Murphy,REP,660110,2,4,96,102,
Rogers,Commissioner of Labor,Cathy Costello,REP,660110,5,12,111,128,
Rogers,Commissioner of Labor,Leslie Osborn,REP,660110,2,6,108,116,
Rogers,Corporation Commissioner,Bob Anthony,REP,660110,4,13,114,131,
Rogers,Corporation Commissioner,Brian Bingman,REP,660110,3,4,106,113,
Rogers,Governor,Chris Powell,LIB,660110,0,0,0,0,
Rogers,Governor,Rex Lawhorn,LIB,660110,0,0,0,0,
Rogers,Corporation Commissioner,Ashley Nicole Mccray,DEM,660110,2,2,36,40,
Rogers,Corporation Commissioner,Blake Cummings,DEM,660110,0,1,18,19,
Rogers,U.S. House,Jason Nichols,DEM,660110,2,1,40,43,02
Rogers,U.S. House,Clay Padgett,DEM,660110,0,2,14,16,02
Rogers,Governor,Mick Cornett,REP,660116,1,0,51,52,
Rogers,Governor,Kevin Stitt,REP,660116,1,5,113,119,
Rogers,Lieutenant Governor,Dana Murphy,REP,660116,1,0,57,58,
Rogers,Lieutenant Governor,Matt Pinnell,REP,660116,1,5,107,113,
Rogers,State Auditor,Cindy Byrd,REP,660116,1,4,73,78,
Rogers,State Auditor,Charlie Prater,REP,660116,1,1,87,89,
Rogers,Attorney General,Mike Hunter,REP,660116,0,2,60,62,
Rogers,Attorney General,Gentner Drummond,REP,660116,1,3,103,107,
Rogers,Superintendent of Public Instruction,Joy Hofmeister,REP,660116,1,4,83,88,
Rogers,Superintendent of Public Instruction,Linda Murphy,REP,660116,1,1,76,78,
Rogers,Commissioner of Labor,Cathy Costello,REP,660116,0,2,67,69,
Rogers,Commissioner of Labor,Leslie Osborn,REP,660116,2,3,91,96,
Rogers,Corporation Commissioner,Bob Anthony,REP,660116,1,2,78,81,
Rogers,Corporation Commissioner,Brian Bingman,REP,660116,1,3,80,84,
Rogers,Governor,Chris Powell,LIB,660116,0,0,0,0,
Rogers,Governor,Rex Lawhorn,LIB,660116,0,0,0,0,
Rogers,Corporation Commissioner,Ashley Nicole Mccray,DEM,660116,0,2,21,23,
Rogers,Corporation Commissioner,Blake Cummings,DEM,660116,0,0,10,10,
Rogers,U.S. House,Jason Nichols,DEM,660116,0,0,17,17,02
Rogers,U.S. House,Clay Padgett,DEM,660116,0,2,14,16,02
Rogers,Governor,Mick Cornett,REP,660120,6,8,81,95,
Rogers,Governor,Kevin Stitt,REP,660120,4,9,157,170,
Rogers,Lieutenant Governor,Dana Murphy,REP,660120,5,8,78,91,
Rogers,Lieutenant Governor,Matt Pinnell,REP,660120,5,9,154,168,
Rogers,State Auditor,Cindy Byrd,REP,660120,6,9,110,125,
Rogers,State Auditor,Charlie Prater,REP,660120,4,8,114,126,
Rogers,Attorney General,Mike Hunter,REP,660120,1,7,95,103,
Rogers,Attorney General,Gentner Drummond,REP,660120,9,10,142,161,
Rogers,Superintendent of Public Instruction,Joy Hofmeister,REP,660120,7,9,152,168,
Rogers,Superintendent of Public Instruction,Linda Murphy,REP,660120,3,8,81,92,
Rogers,Commissioner of Labor,Cathy Costello,REP,660120,8,5,100,113,
Rogers,Commissioner of Labor,Leslie Osborn,REP,660120,2,12,129,143,
Rogers,Corporation Commissioner,Bob Anthony,REP,660120,8,12,104,124,
Rogers,Corporation Commissioner,Brian Bingman,REP,660120,2,5,124,131,
Rogers,Governor,Chris Powell,LIB,660120,0,0,0,0,
Rogers,Governor,Rex Lawhorn,LIB,660120,0,0,0,0,
Rogers,Corporation Commissioner,Ashley Nicole Mccray,DEM,660120,3,2,30,35,
Rogers,Corporation Commissioner,Blake Cummings,DEM,660120,1,0,19,20,
Rogers,U.S. House,Jason Nichols,DEM,660120,2,2,27,31,02
Rogers,U.S. House,Clay Padgett,DEM,660120,2,0,22,24,02
Rogers,Governor,Mick Cornett,REP,660128,0,0,61,61,
Rogers,Governor,Kevin Stitt,REP,660128,0,5,129,134,
Rogers,Lieutenant Governor,Dana Murphy,REP,660128,0,4,66,70,
Rogers,Lieutenant Governor,Matt Pinnell,REP,660128,0,1,117,118,
Rogers,State Auditor,Cindy Byrd,REP,660128,0,4,77,81,
Rogers,State Auditor,Charlie Prater,REP,660128,0,1,103,104,
Rogers,Attorney General,Mike Hunter,REP,660128,0,2,71,73,
Rogers,Attorney General,Gentner Drummond,REP,660128,0,3,115,118,
Rogers,Superintendent of Public Instruction,Joy Hofmeister,REP,660128,0,2,86,88,
Rogers,Superintendent of Public Instruction,Linda Murphy,REP,660128,0,3,99,102,
Rogers,Commissioner of Labor,Cathy Costello,REP,660128,0,5,87,92,
Rogers,Commissioner of Labor,Leslie Osborn,REP,660128,0,0,92,92,
Rogers,Corporation Commissioner,Bob Anthony,REP,660128,0,5,81,86,
Rogers,Corporation Commissioner,Brian Bingman,REP,660128,0,0,105,105,
Rogers,Governor,Chris Powell,LIB,660128,0,0,0,0,
Rogers,Governor,Rex Lawhorn,LIB,660128,0,0,0,0,
Rogers,Corporation Commissioner,Ashley Nicole Mccray,DEM,660128,0,0,42,42,
Rogers,Corporation Commissioner,Blake Cummings,DEM,660128,0,1,19,20,
Rogers,U.S. House,Jason Nichols,DEM,660128,0,1,36,37,02
Rogers,U.S. House,Clay Padgett,DEM,660128,0,0,25,25,02
Rogers,Governor,Mick Cornett,REP,660130,21,35,180,236,
Rogers,Governor,Kevin Stitt,REP,660130,24,44,299,367,
Rogers,Lieutenant Governor,Dana Murphy,REP,660130,22,36,191,249,
Rogers,Lieutenant Governor,Matt Pinnell,REP,660130,24,43,281,348,
Rogers,State Auditor,Cindy Byrd,REP,660130,29,41,238,308,
Rogers,State Auditor,Charlie Prater,REP,660130,14,36,217,267,
Rogers,Attorney General,Mike Hunter,REP,660130,22,29,210,261,
Rogers,Attorney General,Gentner Drummond,REP,660130,23,49,264,336,
Rogers,Superintendent of Public Instruction,Joy Hofmeister,REP,660130,24,54,268,346,
Rogers,Superintendent of Public Instruction,Linda Murphy,REP,660130,19,23,200,242,
Rogers,Commissioner of Labor,Cathy Costello,REP,660130,24,34,245,303,
Rogers,Commissioner of Labor,Leslie Osborn,REP,660130,21,42,216,279,
Rogers,Corporation Commissioner,Bob Anthony,REP,660130,27,40,271,338,
Rogers,Corporation Commissioner,Brian Bingman,REP,660130,19,38,195,252,
Rogers,U.S. House,Tim Harris,REP,660130,27,35,197,259,01
Rogers,U.S. House,Kevin Hern,REP,660130,19,44,277,340,01
Rogers,Governor,Chris Powell,LIB,660130,0,0,0,0,
Rogers,Governor,Rex Lawhorn,LIB,660130,0,0,0,0,
Rogers,Corporation Commissioner,Ashley Nicole Mccray,DEM,660130,8,12,62,82,
Rogers,Corporation Commissioner,Blake Cummings,DEM,660130,3,7,28,38,
Rogers,U.S. House,Tim Gilpin,DEM,660130,6,14,50,70,01
Rogers,U.S. House,Amanda Douglas,DEM,660130,5,5,40,50,01
Seminole,Governor,Mick Cornett,REP,670010,1,7,59,67,
Seminole,Governor,Kevin Stitt,REP,670010,2,6,60,68,
Seminole,Lieutenant Governor,Dana Murphy,REP,670010,1,7,59,67,
Seminole,Lieutenant Governor,Matt Pinnell,REP,670010,2,6,61,69,
Seminole,State Auditor,Cindy Byrd,REP,670010,3,8,60,71,
Seminole,State Auditor,Charlie Prater,REP,670010,0,5,55,60,
Seminole,Attorney General,Mike Hunter,REP,670010,1,3,68,72,
Seminole,Attorney General,Gentner Drummond,REP,670010,2,10,53,65,
Seminole,Superintendent of Public Instruction,Joy Hofmeister,REP,670010,0,7,67,74,
Seminole,Superintendent of Public Instruction,Linda Murphy,REP,670010,3,6,55,64,
Seminole,Commissioner of Labor,Cathy Costello,REP,670010,3,9,52,64,
Seminole,Commissioner of Labor,Leslie Osborn,REP,670010,0,4,66,70,
Seminole,Corporation Commissioner,Bob Anthony,REP,670010,1,7,65,73,
Seminole,Corporation Commissioner,Brian Bingman,REP,670010,2,6,54,62,
Seminole,Governor,Chris Powell,LIB,670010,0,0,0,0,
Seminole,Governor,Rex Lawhorn,LIB,670010,0,0,0,0,
Seminole,Corporation Commissioner,Ashley Nicole Mccray,DEM,670010,2,2,46,50,
Seminole,Corporation Commissioner,Blake Cummings,DEM,670010,3,3,44,50,
Seminole,U.S. House,Kendra Horn,DEM,670010,5,4,48,57,05
Seminole,U.S. House,Tom Guild,DEM,670010,0,1,42,43,05
Seminole,Governor,Mick Cornett,REP,670012,0,0,6,6,
Seminole,Governor,Kevin Stitt,REP,670012,2,0,14,16,
Seminole,Lieutenant Governor,Dana Murphy,REP,670012,0,0,7,7,
Seminole,Lieutenant Governor,Matt Pinnell,REP,670012,2,0,13,15,
Seminole,State Auditor,Cindy Byrd,REP,670012,1,0,15,16,
Seminole,State Auditor,Charlie Prater,REP,670012,1,0,5,6,
Seminole,Attorney General,Mike Hunter,REP,670012,1,0,10,11,
Seminole,Attorney General,Gentner Drummond,REP,670012,1,0,10,11,
Seminole,Superintendent of Public Instruction,Joy Hofmeister,REP,670012,0,0,9,9,
Seminole,Superintendent of Public Instruction,Linda Murphy,REP,670012,2,0,11,13,
Seminole,Commissioner of Labor,Cathy Costello,REP,670012,0,0,8,8,
Seminole,Commissioner of Labor,Leslie Osborn,REP,670012,2,0,11,13,
Seminole,Corporation Commissioner,Bob Anthony,REP,670012,2,0,10,12,
Seminole,Corporation Commissioner,Brian Bingman,REP,670012,0,0,9,9,
Seminole,Governor,Chris Powell,LIB,670012,0,0,0,0,
Seminole,Governor,Rex Lawhorn,LIB,670012,0,0,0,0,
Seminole,Corporation Commissioner,Ashley Nicole Mccray,DEM,670012,0,1,12,13,
Seminole,Corporation Commissioner,Blake Cummings,DEM,670012,0,0,11,11,
Seminole,U.S. House,Kendra Horn,DEM,670012,0,1,8,9,05
Seminole,U.S. House,Tom Guild,DEM,670012,0,0,15,15,05
Seminole,Governor,Mick Cornett,REP,670014,2,0,41,43,
Seminole,Governor,Kevin Stitt,REP,670014,3,3,80,86,
Seminole,Lieutenant Governor,Dana Murphy,REP,670014,3,1,51,55,
Seminole,Lieutenant Governor,Matt Pinnell,REP,670014,2,2,66,70,
Seminole,State Auditor,Cindy Byrd,REP,670014,4,1,60,65,
Seminole,State Auditor,Charlie Prater,REP,670014,1,2,53,56,
Seminole,Attorney General,Mike Hunter,REP,670014,2,2,58,62,
Seminole,Attorney General,Gentner Drummond,REP,670014,3,1,61,65,
Seminole,Superintendent of Public Instruction,Joy Hofmeister,REP,670014,2,0,61,63,
Seminole,Superintendent of Public Instruction,Linda Murphy,REP,670014,3,3,59,65,
Seminole,Commissioner of Labor,Cathy Costello,REP,670014,3,1,66,70,
Seminole,Commissioner of Labor,Leslie Osborn,REP,670014,2,2,53,57,
Seminole,Corporation Commissioner,Bob Anthony,REP,670014,5,1,52,58,
Seminole,Corporation Commissioner,Brian Bingman,REP,670014,0,2,67,69,
Seminole,Governor,Chris Powell,LIB,670014,0,0,0,0,
Seminole,Governor,Rex Lawhorn,LIB,670014,0,0,0,0,
Seminole,Corporation Commissioner,Ashley Nicole Mccray,DEM,670014,0,0,41,41,
Seminole,Corporation Commissioner,Blake Cummings,DEM,670014,5,1,49,55,
Seminole,U.S. House,Kendra Horn,DEM,670014,1,0,34,35,05
Seminole,U.S. House,Tom Guild,DEM,670014,4,1,57,62,05
Seminole,Governor,Mick Cornett,REP,670015,4,2,10,16,
Seminole,Governor,Kevin Stitt,REP,670015,0,2,30,32,
Seminole,Lieutenant Governor,Dana Murphy,REP,670015,4,2,18,24,
Seminole,Lieutenant Governor,Matt Pinnell,REP,670015,0,2,22,24,
Seminole,State Auditor,Cindy Byrd,REP,670015,4,4,17,25,
Seminole,State Auditor,Charlie Prater,REP,670015,0,0,22,22,
Seminole,Attorney General,Mike Hunter,REP,670015,2,2,20,24,
Seminole,Attorney General,Gentner Drummond,REP,670015,2,2,17,21,
Seminole,Superintendent of Public Instruction,Joy Hofmeister,REP,670015,2,3,18,23,
Seminole,Superintendent of Public Instruction,Linda Murphy,REP,670015,2,1,22,25,
Seminole,Commissioner of Labor,Cathy Costello,REP,670015,0,4,19,23,
Seminole,Commissioner of Labor,Leslie Osborn,REP,670015,4,0,21,25,
Seminole,Corporation Commissioner,Bob Anthony,REP,670015,4,4,26,34,
Seminole,Corporation Commissioner,Brian Bingman,REP,670015,0,0,14,14,
Seminole,Governor,Chris Powell,LIB,670015,0,0,0,0,
Seminole,Governor,Rex Lawhorn,LIB,670015,0,0,0,0,
Seminole,Corporation Commissioner,Ashley Nicole Mccray,DEM,670015,0,1,20,21,
Seminole,Corporation Commissioner,Blake Cummings,DEM,670015,1,2,33,36,
Seminole,U.S. House,Kendra Horn,DEM,670015,0,3,25,28,05
Seminole,U.S. House,Tom Guild,DEM,670015,1,0,27,28,05
Seminole,Governor,Mick Cornett,REP,670020,3,5,79,87,
Seminole,Governor,Kevin Stitt,REP,670020,1,0,47,48,
Seminole,Lieutenant Governor,Dana Murphy,REP,670020,1,3,33,37,
Seminole,Lieutenant Governor,Matt Pinnell,REP,670020,3,2,89,94,
Seminole,State Auditor,Cindy Byrd,REP,670020,1,2,49,52,
Seminole,State Auditor,Charlie Prater,REP,670020,4,3,72,79,
Seminole,Attorney General,Mike Hunter,REP,670020,2,5,65,72,
Seminole,Attorney General,Gentner Drummond,REP,670020,3,0,59,62,
Seminole,Superintendent of Public Instruction,Joy Hofmeister,REP,670020,2,3,78,83,
Seminole,Superintendent of Public Instruction,Linda Murphy,REP,670020,3,2,46,51,
Seminole,Commissioner of Labor,Cathy Costello,REP,670020,1,2,55,58,
Seminole,Commissioner of Labor,Leslie Osborn,REP,670020,4,3,67,74,
Seminole,Corporation Commissioner,Bob Anthony,REP,670020,4,3,61,68,
Seminole,Corporation Commissioner,Brian Bingman,REP,670020,1,2,63,66,
Seminole,Governor,Chris Powell,LIB,670020,0,0,0,0,
Seminole,Governor,Rex Lawhorn,LIB,670020,0,0,0,0,
Seminole,Corporation Commissioner,Ashley Nicole Mccray,DEM,670020,0,1,30,31,
Seminole,Corporation Commissioner,Blake Cummings,DEM,670020,2,1,34,37,
Seminole,U.S. House,Kendra Horn,DEM,670020,0,1,29,30,05
Seminole,U.S. House,Tom Guild,DEM,670020,1,1,36,38,05
Seminole,Governor,Mick Cornett,REP,670022,3,1,57,61,
Seminole,Governor,Kevin Stitt,REP,670022,1,0,63,64,
Seminole,Lieutenant Governor,Dana Murphy,REP,670022,3,0,48,51,
Seminole,Lieutenant Governor,Matt Pinnell,REP,670022,1,1,72,74,
Seminole,State Auditor,Cindy Byrd,REP,670022,2,1,60,63,
Seminole,State Auditor,Charlie Prater,REP,670022,2,0,58,60,
Seminole,Attorney General,Mike Hunter,REP,670022,1,0,70,71,
Seminole,Attorney General,Gentner Drummond,REP,670022,3,1,51,55,
Seminole,Superintendent of Public Instruction,Joy Hofmeister,REP,670022,2,0,57,59,
Seminole,Superintendent of Public Instruction,Linda Murphy,REP,670022,2,1,63,66,
Seminole,Commissioner of Labor,Cathy Costello,REP,670022,1,0,49,50,
Seminole,Commissioner of Labor,Leslie Osborn,REP,670022,3,1,69,73,
Seminole,Corporation Commissioner,Bob Anthony,REP,670022,2,1,73,76,
Seminole,Corporation Commissioner,Brian Bingman,REP,670022,2,0,46,48,
Seminole,Governor,Chris Powell,LIB,670022,0,0,0,0,
Seminole,Governor,Rex Lawhorn,LIB,670022,0,0,0,0,
Seminole,Corporation Commissioner,Ashley Nicole Mccray,DEM,670022,1,5,33,39,
Seminole,Corporation Commissioner,Blake Cummings,DEM,670022,2,1,35,38,
Seminole,U.S. House,Kendra Horn,DEM,670022,3,6,37,46,05
Seminole,U.S. House,Tom Guild,DEM,670022,0,0,30,30,05
Seminole,Governor,Mick Cornett,REP,670023,5,3,81,89,
Seminole,Governor,Kevin Stitt,REP,670023,1,4,64,69,
Seminole,Lieutenant Governor,Dana Murphy,REP,670023,4,2,58,64,
Seminole,Lieutenant Governor,Matt Pinnell,REP,670023,2,4,84,90,
Seminole,State Auditor,Cindy Byrd,REP,670023,6,4,75,85,
Seminole,State Auditor,Charlie Prater,REP,670023,0,2,69,71,
Seminole,Attorney General,Mike Hunter,REP,670023,5,5,85,95,
Seminole,Attorney General,Gentner Drummond,REP,670023,1,1,58,60,
Seminole,Superintendent of Public Instruction,Joy Hofmeister,REP,670023,4,3,88,95,
Seminole,Superintendent of Public Instruction,Linda Murphy,REP,670023,2,3,57,62,
Seminole,Commissioner of Labor,Cathy Costello,REP,670023,3,3,61,67,
Seminole,Commissioner of Labor,Leslie Osborn,REP,670023,3,3,83,89,
Seminole,Corporation Commissioner,Bob Anthony,REP,670023,4,2,82,88,
Seminole,Corporation Commissioner,Brian Bingman,REP,670023,2,4,61,67,
Seminole,Governor,Chris Powell,LIB,670023,0,0,0,0,
Seminole,Governor,Rex Lawhorn,LIB,670023,0,0,1,1,
Seminole,Corporation Commissioner,Ashley Nicole Mccray,DEM,670023,5,6,39,50,
Seminole,Corporation Commissioner,Blake Cummings,DEM,670023,0,2,39,41,
Seminole,U.S. House,Kendra Horn,DEM,670023,4,8,39,51,05
Seminole,U.S. House,Tom Guild,DEM,670023,1,1,43,45,05
Seminole,Governor,Mick Cornett,REP,670024,0,2,27,29,
Seminole,Governor,Kevin Stitt,REP,670024,3,0,49,52,
Seminole,Lieutenant Governor,Dana Murphy,REP,670024,0,0,31,31,
Seminole,Lieutenant Governor,Matt Pinnell,REP,670024,3,1,44,48,
Seminole,State Auditor,Cindy Byrd,REP,670024,0,0,33,33,
Seminole,State Auditor,Charlie Prater,REP,670024,3,1,43,47,
Seminole,Attorney General,Mike Hunter,REP,670024,1,1,40,42,
Seminole,Attorney General,Gentner Drummond,REP,670024,2,0,36,38,
Seminole,Superintendent of Public Instruction,Joy Hofmeister,REP,670024,0,0,34,34,
Seminole,Superintendent of Public Instruction,Linda Murphy,REP,670024,3,1,42,46,
Seminole,Commissioner of Labor,Cathy Costello,REP,670024,0,1,32,33,
Seminole,Commissioner of Labor,Leslie Osborn,REP,670024,3,0,44,47,
Seminole,Corporation Commissioner,Bob Anthony,REP,670024,3,1,41,45,
Seminole,Corporation Commissioner,Brian Bingman,REP,670024,0,0,34,34,
Seminole,Governor,Chris Powell,LIB,670024,0,0,0,0,
Seminole,Governor,Rex Lawhorn,LIB,670024,0,0,0,0,
Seminole,Corporation Commissioner,Ashley Nicole Mccray,DEM,670024,1,0,33,34,
Seminole,Corporation Commissioner,Blake Cummings,DEM,670024,0,0,27,27,
Seminole,U.S. House,Kendra Horn,DEM,670024,1,0,24,25,05
Seminole,U.S. House,Tom Guild,DEM,670024,0,0,35,35,05
Seminole,Governor,Mick Cornett,REP,670025,1,0,7,8,
Seminole,Governor,Kevin Stitt,REP,670025,2,0,14,16,
Seminole,Lieutenant Governor,Dana Murphy,REP,670025,2,0,5,7,
Seminole,Lieutenant Governor,Matt Pinnell,REP,670025,1,0,16,17,
Seminole,State Auditor,Cindy Byrd,REP,670025,3,0,11,14,
Seminole,State Auditor,Charlie Prater,REP,670025,0,0,10,10,
Seminole,Attorney General,Mike Hunter,REP,670025,3,0,7,10,
Seminole,Attorney General,Gentner Drummond,REP,670025,0,0,14,14,
Seminole,Superintendent of Public Instruction,Joy Hofmeister,REP,670025,2,0,11,13,
Seminole,Superintendent of Public Instruction,Linda Murphy,REP,670025,1,0,10,11,
Seminole,Commissioner of Labor,Cathy Costello,REP,670025,2,0,10,12,
Seminole,Commissioner of Labor,Leslie Osborn,REP,670025,1,0,11,12,
Seminole,Corporation Commissioner,Bob Anthony,REP,670025,1,0,9,10,
Seminole,Corporation Commissioner,Brian Bingman,REP,670025,2,0,12,14,
Seminole,Governor,Chris Powell,LIB,670025,0,0,0,0,
Seminole,Governor,Rex Lawhorn,LIB,670025,0,0,0,0,
Seminole,Corporation Commissioner,Ashley Nicole Mccray,DEM,670025,2,0,8,10,
Seminole,Corporation Commissioner,Blake Cummings,DEM,670025,1,0,12,13,
Seminole,U.S. House,Kendra Horn,DEM,670025,2,0,10,12,05
Seminole,U.S. House,Tom Guild,DEM,670025,1,0,10,11,05
Seminole,Governor,Mick Cornett,REP,670030,0,0,24,24,
Seminole,Governor,Kevin Stitt,REP,670030,0,1,21,22,
Seminole,Lieutenant Governor,Dana Murphy,REP,670030,0,1,20,21,
Seminole,Lieutenant Governor,Matt Pinnell,REP,670030,0,0,25,25,
Seminole,State Auditor,Cindy Byrd,REP,670030,0,0,17,17,
Seminole,State Auditor,Charlie Prater,REP,670030,0,1,27,28,
Seminole,Attorney General,Mike Hunter,REP,670030,0,1,23,24,
Seminole,Attorney General,Gentner Drummond,REP,670030,0,0,22,22,
Seminole,Superintendent of Public Instruction,Joy Hofmeister,REP,670030,0,1,22,23,
Seminole,Superintendent of Public Instruction,Linda Murphy,REP,670030,0,0,23,23,
Seminole,Commissioner of Labor,Cathy Costello,REP,670030,0,0,18,18,
Seminole,Commissioner of Labor,Leslie Osborn,REP,670030,0,1,27,28,
Seminole,Corporation Commissioner,Bob Anthony,REP,670030,0,0,25,25,
Seminole,Corporation Commissioner,Brian Bingman,REP,670030,0,1,20,21,
Seminole,Governor,Chris Powell,LIB,670030,0,0,0,0,
Seminole,Governor,Rex Lawhorn,LIB,670030,0,0,0,0,
Seminole,Corporation Commissioner,Ashley Nicole Mccray,DEM,670030,0,0,9,9,
Seminole,Corporation Commissioner,Blake Cummings,DEM,670030,0,1,21,22,
Seminole,U.S. House,Kendra Horn,DEM,670030,0,0,12,12,05
Seminole,U.S. House,Tom Guild,DEM,670030,0,1,18,19,05
Seminole,Governor,Mick Cornett,REP,670032,3,4,25,32,
Seminole,Governor,Kevin Stitt,REP,670032,2,9,35,46,
Seminole,Lieutenant Governor,Dana Murphy,REP,670032,1,4,22,27,
Seminole,Lieutenant Governor,Matt Pinnell,REP,670032,4,9,37,50,
Seminole,State Auditor,Cindy Byrd,REP,670032,1,8,24,33,
Seminole,State Auditor,Charlie Prater,REP,670032,4,4,34,42,
Seminole,Attorney General,Mike Hunter,REP,670032,2,8,27,37,
Seminole,Attorney General,Gentner Drummond,REP,670032,3,4,32,39,
Seminole,Superintendent of Public Instruction,Joy Hofmeister,REP,670032,3,4,37,44,
Seminole,Superintendent of Public Instruction,Linda Murphy,REP,670032,2,8,23,33,
Seminole,Commissioner of Labor,Cathy Costello,REP,670032,4,2,18,24,
Seminole,Commissioner of Labor,Leslie Osborn,REP,670032,1,10,40,51,
Seminole,Corporation Commissioner,Bob Anthony,REP,670032,3,8,33,44,
Seminole,Corporation Commissioner,Brian Bingman,REP,670032,2,4,25,31,
Seminole,Governor,Chris Powell,LIB,670032,0,0,2,2,
Seminole,Governor,Rex Lawhorn,LIB,670032,0,0,0,0,
Seminole,Corporation Commissioner,Ashley Nicole Mccray,DEM,670032,1,6,23,30,
Seminole,Corporation Commissioner,Blake Cummings,DEM,670032,0,6,43,49,
Seminole,U.S. House,Kendra Horn,DEM,670032,0,10,27,37,05
Seminole,U.S. House,Tom Guild,DEM,670032,1,2,39,42,05
Seminole,Governor,Mick Cornett,REP,670033,0,1,2,3,
Seminole,Governor,Kevin Stitt,REP,670033,0,0,5,5,
Seminole,Lieutenant Governor,Dana Murphy,REP,670033,0,0,3,3,
Seminole,Lieutenant Governor,Matt Pinnell,REP,670033,0,1,4,5,
Seminole,State Auditor,Cindy Byrd,REP,670033,0,1,3,4,
Seminole,State Auditor,Charlie Prater,REP,670033,0,0,3,3,
Seminole,Attorney General,Mike Hunter,REP,670033,0,0,2,2,
Seminole,Attorney General,Gentner Drummond,REP,670033,0,1,5,6,
Seminole,Superintendent of Public Instruction,Joy Hofmeister,REP,670033,0,1,4,5,
Seminole,Superintendent of Public Instruction,Linda Murphy,REP,670033,0,0,3,3,
Seminole,Commissioner of Labor,Cathy Costello,REP,670033,0,0,2,2,
Seminole,Commissioner of Labor,Leslie Osborn,REP,670033,0,1,4,5,
Seminole,Corporation Commissioner,Bob Anthony,REP,670033,0,0,5,5,
Seminole,Corporation Commissioner,Brian Bingman,REP,670033,0,1,2,3,
Seminole,Governor,Chris Powell,LIB,670033,0,0,0,0,
Seminole,Governor,Rex Lawhorn,LIB,670033,0,0,0,0,
Seminole,Corporation Commissioner,Ashley Nicole Mccray,DEM,670033,0,0,2,2,
Seminole,Corporation Commissioner,Blake Cummings,DEM,670033,0,0,7,7,
Seminole,U.S. House,Kendra Horn,DEM,670033,0,0,1,1,05
Seminole,U.S. House,Tom Guild,DEM,670033,0,0,8,8,05
Seminole,Governor,Mick Cornett,REP,670034,2,11,36,49,
Seminole,Governor,Kevin Stitt,REP,670034,1,4,51,56,
Seminole,Lieutenant Governor,Dana Murphy,REP,670034,2,7,32,41,
Seminole,Lieutenant Governor,Matt Pinnell,REP,670034,1,8,56,65,
Seminole,State Auditor,Cindy Byrd,REP,670034,1,4,44,49,
Seminole,State Auditor,Charlie Prater,REP,670034,2,11,44,57,
Seminole,Attorney General,Mike Hunter,REP,670034,3,12,32,47,
Seminole,Attorney General,Gentner Drummond,REP,670034,0,3,56,59,
Seminole,Superintendent of Public Instruction,Joy Hofmeister,REP,670034,2,11,51,64,
Seminole,Superintendent of Public Instruction,Linda Murphy,REP,670034,1,4,37,42,
Seminole,Commissioner of Labor,Cathy Costello,REP,670034,3,4,38,45,
Seminole,Commissioner of Labor,Leslie Osborn,REP,670034,0,11,50,61,
Seminole,Corporation Commissioner,Bob Anthony,REP,670034,0,10,43,53,
Seminole,Corporation Commissioner,Brian Bingman,REP,670034,3,5,44,52,
Seminole,Governor,Chris Powell,LIB,670034,0,0,0,0,
Seminole,Governor,Rex Lawhorn,LIB,670034,0,0,0,0,
Seminole,Corporation Commissioner,Ashley Nicole Mccray,DEM,670034,1,11,63,75,
Seminole,Corporation Commissioner,Blake Cummings,DEM,670034,0,1,43,44,
Seminole,U.S. House,Kendra Horn,DEM,670034,0,5,50,55,05
Seminole,U.S. House,Tom Guild,DEM,670034,1,7,58,66,05
Seminole,Governor,Mick Cornett,REP,670035,4,1,53,58,
Seminole,Governor,Kevin Stitt,REP,670035,0,0,34,34,
Seminole,Lieutenant Governor,Dana Murphy,REP,670035,2,0,32,34,
Seminole,Lieutenant Governor,Matt Pinnell,REP,670035,2,1,52,55,
Seminole,State Auditor,Cindy Byrd,REP,670035,1,0,29,30,
Seminole,State Auditor,Charlie Prater,REP,670035,2,1,51,54,
Seminole,Attorney General,Mike Hunter,REP,670035,2,1,37,40,
Seminole,Attorney General,Gentner Drummond,REP,670035,2,0,49,51,
Seminole,Superintendent of Public Instruction,Joy Hofmeister,REP,670035,1,1,44,46,
Seminole,Superintendent of Public Instruction,Linda Murphy,REP,670035,3,0,41,44,
Seminole,Commissioner of Labor,Cathy Costello,REP,670035,2,1,29,32,
Seminole,Commissioner of Labor,Leslie Osborn,REP,670035,2,0,53,55,
Seminole,Corporation Commissioner,Bob Anthony,REP,670035,1,1,36,38,
Seminole,Corporation Commissioner,Brian Bingman,REP,670035,3,0,46,49,
Seminole,Governor,Chris Powell,LIB,670035,0,0,0,0,
Seminole,Governor,Rex Lawhorn,LIB,670035,0,0,0,0,
Seminole,Corporation Commissioner,Ashley Nicole Mccray,DEM,670035,0,2,17,19,
Seminole,Corporation Commissioner,Blake Cummings,DEM,670035,0,3,8,11,
Seminole,U.S. House,Kendra Horn,DEM,670035,0,5,11,16,05
Seminole,U.S. House,Tom Guild,DEM,670035,0,0,14,14,05
Sequoyah,Governor,Mick Cornett,REP,680101,0,0,12,12,
Sequoyah,Governor,Kevin Stitt,REP,680101,0,1,30,31,
Sequoyah,Lieutenant Governor,Dana Murphy,REP,680101,0,1,16,17,
Sequoyah,Lieutenant Governor,Matt Pinnell,REP,680101,0,0,26,26,
Sequoyah,State Auditor,Cindy Byrd,REP,680101,0,1,27,28,
Sequoyah,State Auditor,Charlie Prater,REP,680101,0,0,13,13,
Sequoyah,Attorney General,Mike Hunter,REP,680101,0,0,26,26,
Sequoyah,Attorney General,Gentner Drummond,REP,680101,0,1,16,17,
Sequoyah,Superintendent of Public Instruction,Joy Hofmeister,REP,680101,0,1,17,18,
Sequoyah,Superintendent of Public Instruction,Linda Murphy,REP,680101,0,0,23,23,
Sequoyah,Commissioner of Labor,Cathy Costello,REP,680101,0,0,21,21,
Sequoyah,Commissioner of Labor,Leslie Osborn,REP,680101,0,1,18,19,
Sequoyah,Corporation Commissioner,Bob Anthony,REP,680101,0,1,24,25,
Sequoyah,Corporation Commissioner,Brian Bingman,REP,680101,0,0,15,15,
Sequoyah,Governor,Chris Powell,LIB,680101,0,0,0,0,
Sequoyah,Governor,Rex Lawhorn,LIB,680101,0,0,0,0,
Sequoyah,Corporation Commissioner,Ashley Nicole Mccray,DEM,680101,2,0,25,27,
Sequoyah,Corporation Commissioner,Blake Cummings,DEM,680101,0,0,29,29,
Sequoyah,U.S. House,Jason Nichols,DEM,680101,2,0,34,36,02
Sequoyah,U.S. House,Clay Padgett,DEM,680101,0,0,22,22,02
Sequoyah,Governor,Mick Cornett,REP,680102,0,0,9,9,
Sequoyah,Governor,Kevin Stitt,REP,680102,0,0,17,17,
Sequoyah,Lieutenant Governor,Dana Murphy,REP,680102,0,0,8,8,
Sequoyah,Lieutenant Governor,Matt Pinnell,REP,680102,0,0,17,17,
Sequoyah,State Auditor,Cindy Byrd,REP,680102,0,0,15,15,
Sequoyah,State Auditor,Charlie Prater,REP,680102,0,0,10,10,
Sequoyah,Attorney General,Mike Hunter,REP,680102,0,0,16,16,
Sequoyah,Attorney General,Gentner Drummond,REP,680102,0,0,9,9,
Sequoyah,Superintendent of Public Instruction,Joy Hofmeister,REP,680102,0,0,12,12,
Sequoyah,Superintendent of Public Instruction,Linda Murphy,REP,680102,0,0,14,14,
Sequoyah,Commissioner of Labor,Cathy Costello,REP,680102,0,0,15,15,
Sequoyah,Commissioner of Labor,Leslie Osborn,REP,680102,0,0,11,11,
Sequoyah,Corporation Commissioner,Bob Anthony,REP,680102,0,0,16,16,
Sequoyah,Corporation Commissioner,Brian Bingman,REP,680102,0,0,9,9,
Sequoyah,Governor,Chris Powell,LIB,680102,0,0,0,0,
Sequoyah,Governor,Rex Lawhorn,LIB,680102,0,0,0,0,
Sequoyah,Corporation Commissioner,Ashley Nicole Mccray,DEM,680102,0,1,14,15,
Sequoyah,Corporation Commissioner,Blake Cummings,DEM,680102,0,1,13,14,
Sequoyah,U.S. House,Jason Nichols,DEM,680102,0,0,18,18,02
Sequoyah,U.S. House,Clay Padgett,DEM,680102,0,2,9,11,02
Sequoyah,Governor,Mick Cornett,REP,680103,3,0,11,14,
Sequoyah,Governor,Kevin Stitt,REP,680103,0,0,25,25,
Sequoyah,Lieutenant Governor,Dana Murphy,REP,680103,0,0,11,11,
Sequoyah,Lieutenant Governor,Matt Pinnell,REP,680103,3,0,25,28,
Sequoyah,State Auditor,Cindy Byrd,REP,680103,0,0,19,19,
Sequoyah,State Auditor,Charlie Prater,REP,680103,3,0,16,19,
Sequoyah,Attorney General,Mike Hunter,REP,680103,2,0,20,22,
Sequoyah,Attorney General,Gentner Drummond,REP,680103,1,0,15,16,
Sequoyah,Superintendent of Public Instruction,Joy Hofmeister,REP,680103,0,0,15,15,
Sequoyah,Superintendent of Public Instruction,Linda Murphy,REP,680103,3,0,20,23,
Sequoyah,Commissioner of Labor,Cathy Costello,REP,680103,1,0,11,12,
Sequoyah,Commissioner of Labor,Leslie Osborn,REP,680103,2,0,24,26,
Sequoyah,Corporation Commissioner,Bob Anthony,REP,680103,3,0,18,21,
Sequoyah,Corporation Commissioner,Brian Bingman,REP,680103,0,0,17,17,
Sequoyah,Governor,Chris Powell,LIB,680103,0,0,0,0,
Sequoyah,Governor,Rex Lawhorn,LIB,680103,0,0,0,0,
Sequoyah,Corporation Commissioner,Ashley Nicole Mccray,DEM,680103,2,5,24,31,
Sequoyah,Corporation Commissioner,Blake Cummings,DEM,680103,0,0,13,13,
Sequoyah,U.S. House,Jason Nichols,DEM,680103,2,5,16,23,02
Sequoyah,U.S. House,Clay Padgett,DEM,680103,0,0,21,21,02
Sequoyah,Governor,Mick Cornett,REP,680104,0,0,8,8,
Sequoyah,Governor,Kevin Stitt,REP,680104,3,2,45,50,
Sequoyah,Lieutenant Governor,Dana Murphy,REP,680104,2,1,10,13,
Sequoyah,Lieutenant Governor,Matt Pinnell,REP,680104,1,1,44,46,
Sequoyah,State Auditor,Cindy Byrd,REP,680104,2,2,22,26,
Sequoyah,State Auditor,Charlie Prater,REP,680104,1,0,30,31,
Sequoyah,Attorney General,Mike Hunter,REP,680104,0,2,25,27,
Sequoyah,Attorney General,Gentner Drummond,REP,680104,3,0,29,32,
Sequoyah,Superintendent of Public Instruction,Joy Hofmeister,REP,680104,0,0,22,22,
Sequoyah,Superintendent of Public Instruction,Linda Murphy,REP,680104,3,2,32,37,
Sequoyah,Commissioner of Labor,Cathy Costello,REP,680104,1,1,24,26,
Sequoyah,Commissioner of Labor,Leslie Osborn,REP,680104,2,1,29,32,
Sequoyah,Corporation Commissioner,Bob Anthony,REP,680104,0,0,24,24,
Sequoyah,Corporation Commissioner,Brian Bingman,REP,680104,3,2,29,34,
Sequoyah,Governor,Chris Powell,LIB,680104,0,0,0,0,
Sequoyah,Governor,Rex Lawhorn,LIB,680104,0,0,0,0,
Sequoyah,Corporation Commissioner,Ashley Nicole Mccray,DEM,680104,0,0,12,12,
Sequoyah,Corporation Commissioner,Blake Cummings,DEM,680104,0,0,19,19,
Sequoyah,U.S. House,Jason Nichols,DEM,680104,0,0,14,14,02
Sequoyah,U.S. House,Clay Padgett,DEM,680104,0,0,17,17,02
Sequoyah,Governor,Mick Cornett,REP,680105,0,0,7,7,
Sequoyah,Governor,Kevin Stitt,REP,680105,2,3,25,30,
Sequoyah,Lieutenant Governor,Dana Murphy,REP,680105,0,0,14,14,
Sequoyah,Lieutenant Governor,Matt Pinnell,REP,680105,2,3,15,20,
Sequoyah,State Auditor,Cindy Byrd,REP,680105,1,0,22,23,
Sequoyah,State Auditor,Charlie Prater,REP,680105,1,3,7,11,
Sequoyah,Attorney General,Mike Hunter,REP,680105,2,0,10,12,
Sequoyah,Attorney General,Gentner Drummond,REP,680105,0,3,20,23,
Sequoyah,Superintendent of Public Instruction,Joy Hofmeister,REP,680105,1,0,11,12,
Sequoyah,Superintendent of Public Instruction,Linda Murphy,REP,680105,0,3,19,22,
Sequoyah,Commissioner of Labor,Cathy Costello,REP,680105,1,3,16,20,
Sequoyah,Commissioner of Labor,Leslie Osborn,REP,680105,1,0,13,14,
Sequoyah,Corporation Commissioner,Bob Anthony,REP,680105,2,0,18,20,
Sequoyah,Corporation Commissioner,Brian Bingman,REP,680105,0,3,9,12,
Sequoyah,Governor,Chris Powell,LIB,680105,0,0,0,0,
Sequoyah,Governor,Rex Lawhorn,LIB,680105,0,0,0,0,
Sequoyah,Corporation Commissioner,Ashley Nicole Mccray,DEM,680105,1,0,15,16,
Sequoyah,Corporation Commissioner,Blake Cummings,DEM,680105,1,0,10,11,
Sequoyah,U.S. House,Jason Nichols,DEM,680105,1,0,13,14,02
Sequoyah,U.S. House,Clay Padgett,DEM,680105,1,0,12,13,02
Sequoyah,Governor,Mick Cornett,REP,680106,2,0,13,15,
Sequoyah,Governor,Kevin Stitt,REP,680106,1,1,24,26,
Sequoyah,Lieutenant Governor,Dana Murphy,REP,680106,2,0,5,7,
Sequoyah,Lieutenant Governor,Matt Pinnell,REP,680106,1,1,32,34,
Sequoyah,State Auditor,Cindy Byrd,REP,680106,2,1,24,27,
Sequoyah,State Auditor,Charlie Prater,REP,680106,1,0,14,15,
Sequoyah,Attorney General,Mike Hunter,REP,680106,1,1,28,30,
Sequoyah,Attorney General,Gentner Drummond,REP,680106,2,0,10,12,
Sequoyah,Superintendent of Public Instruction,Joy Hofmeister,REP,680106,0,0,8,8,
Sequoyah,Superintendent of Public Instruction,Linda Murphy,REP,680106,3,1,29,33,
Sequoyah,Commissioner of Labor,Cathy Costello,REP,680106,1,1,21,23,
Sequoyah,Commissioner of Labor,Leslie Osborn,REP,680106,2,0,17,19,
Sequoyah,Corporation Commissioner,Bob Anthony,REP,680106,2,0,21,23,
Sequoyah,Corporation Commissioner,Brian Bingman,REP,680106,1,1,16,18,
Sequoyah,Governor,Chris Powell,LIB,680106,0,0,0,0,
Sequoyah,Governor,Rex Lawhorn,LIB,680106,0,0,0,0,
Sequoyah,Corporation Commissioner,Ashley Nicole Mccray,DEM,680106,0,0,9,9,
Sequoyah,Corporation Commissioner,Blake Cummings,DEM,680106,0,0,18,18,
Sequoyah,U.S. House,Jason Nichols,DEM,680106,0,0,19,19,02
Sequoyah,U.S. House,Clay Padgett,DEM,680106,0,0,8,8,02
Sequoyah,Governor,Mick Cornett,REP,680201,0,0,9,9,
Sequoyah,Governor,Kevin Stitt,REP,680201,0,0,25,25,
Sequoyah,Lieutenant Governor,Dana Murphy,REP,680201,0,0,10,10,
Sequoyah,Lieutenant Governor,Matt Pinnell,REP,680201,0,0,24,24,
Sequoyah,State Auditor,Cindy Byrd,REP,680201,0,0,10,10,
Sequoyah,State Auditor,Charlie Prater,REP,680201,0,0,24,24,
Sequoyah,Attorney General,Mike Hunter,REP,680201,0,0,15,15,
Sequoyah,Attorney General,Gentner Drummond,REP,680201,0,0,19,19,
Sequoyah,Superintendent of Public Instruction,Joy Hofmeister,REP,680201,0,0,13,13,
Sequoyah,Superintendent of Public Instruction,Linda Murphy,REP,680201,0,0,21,21,
Sequoyah,Commissioner of Labor,Cathy Costello,REP,680201,0,0,14,14,
Sequoyah,Commissioner of Labor,Leslie Osborn,REP,680201,0,0,19,19,
Sequoyah,Corporation Commissioner,Bob Anthony,REP,680201,0,0,9,9,
Sequoyah,Corporation Commissioner,Brian Bingman,REP,680201,0,0,25,25,
Sequoyah,Governor,Chris Powell,LIB,680201,0,0,0,0,
Sequoyah,Governor,Rex Lawhorn,LIB,680201,0,0,0,0,
Sequoyah,Corporation Commissioner,Ashley Nicole Mccray,DEM,680201,0,2,14,16,
Sequoyah,Corporation Commissioner,Blake Cummings,DEM,680201,0,0,12,12,
Sequoyah,U.S. House,Jason Nichols,DEM,680201,0,0,10,10,02
Sequoyah,U.S. House,Clay Padgett,DEM,680201,0,2,17,19,02
Sequoyah,Governor,Mick Cornett,REP,680202,3,0,10,13,
Sequoyah,Governor,Kevin Stitt,REP,680202,0,1,12,13,
Sequoyah,Lieutenant Governor,Dana Murphy,REP,680202,2,1,8,11,
Sequoyah,Lieutenant Governor,Matt Pinnell,REP,680202,1,0,14,15,
Sequoyah,State Auditor,Cindy Byrd,REP,680202,1,0,12,13,
Sequoyah,State Auditor,Charlie Prater,REP,680202,2,1,10,13,
Sequoyah,Attorney General,Mike Hunter,REP,680202,3,0,8,11,
Sequoyah,Attorney General,Gentner Drummond,REP,680202,0,1,14,15,
Sequoyah,Superintendent of Public Instruction,Joy Hofmeister,REP,680202,2,0,8,10,
Sequoyah,Superintendent of Public Instruction,Linda Murphy,REP,680202,1,1,13,15,
Sequoyah,Commissioner of Labor,Cathy Costello,REP,680202,1,1,9,11,
Sequoyah,Commissioner of Labor,Leslie Osborn,REP,680202,2,0,12,14,
Sequoyah,Corporation Commissioner,Bob Anthony,REP,680202,1,0,9,10,
Sequoyah,Corporation Commissioner,Brian Bingman,REP,680202,2,1,13,16,
Sequoyah,Governor,Chris Powell,LIB,680202,0,0,0,0,
Sequoyah,Governor,Rex Lawhorn,LIB,680202,0,0,0,0,
Sequoyah,Corporation Commissioner,Ashley Nicole Mccray,DEM,680202,2,1,15,18,
Sequoyah,Corporation Commissioner,Blake Cummings,DEM,680202,1,0,25,26,
Sequoyah,U.S. House,Jason Nichols,DEM,680202,2,1,26,29,02
Sequoyah,U.S. House,Clay Padgett,DEM,680202,1,0,15,16,02
Sequoyah,Governor,Mick Cornett,REP,680203,0,0,1,1,
Sequoyah,Governor,Kevin Stitt,REP,680203,4,0,6,10,
Sequoyah,Lieutenant Governor,Dana Murphy,REP,680203,2,0,2,4,
Sequoyah,Lieutenant Governor,Matt Pinnell,REP,680203,2,0,5,7,
Sequoyah,State Auditor,Cindy Byrd,REP,680203,0,0,3,3,
Sequoyah,State Auditor,Charlie Prater,REP,680203,4,0,3,7,
Sequoyah,Attorney General,Mike Hunter,REP,680203,2,0,4,6,
Sequoyah,Attorney General,Gentner Drummond,REP,680203,2,0,3,5,
Sequoyah,Superintendent of Public Instruction,Joy Hofmeister,REP,680203,4,0,4,8,
Sequoyah,Superintendent of Public Instruction,Linda Murphy,REP,680203,0,0,2,2,
Sequoyah,Commissioner of Labor,Cathy Costello,REP,680203,2,0,1,3,
Sequoyah,Commissioner of Labor,Leslie Osborn,REP,680203,2,0,5,7,
Sequoyah,Corporation Commissioner,Bob Anthony,REP,680203,4,0,1,5,
Sequoyah,Corporation Commissioner,Brian Bingman,REP,680203,0,0,5,5,
Sequoyah,Governor,Chris Powell,LIB,680203,0,0,0,0,
Sequoyah,Governor,Rex Lawhorn,LIB,680203,0,0,0,0,
Sequoyah,Corporation Commissioner,Ashley Nicole Mccray,DEM,680203,0,1,9,10,
Sequoyah,Corporation Commissioner,Blake Cummings,DEM,680203,0,0,8,8,
Sequoyah,U.S. House,Jason Nichols,DEM,680203,0,1,8,9,02
Sequoyah,U.S. House,Clay Padgett,DEM,680203,0,0,9,9,02
Sequoyah,Governor,Mick Cornett,REP,680204,0,0,6,6,
Sequoyah,Governor,Kevin Stitt,REP,680204,1,1,25,27,
Sequoyah,Lieutenant Governor,Dana Murphy,REP,680204,0,1,4,5,
Sequoyah,Lieutenant Governor,Matt Pinnell,REP,680204,1,0,27,28,
Sequoyah,State Auditor,Cindy Byrd,REP,680204,0,1,19,20,
Sequoyah,State Auditor,Charlie Prater,REP,680204,1,0,12,13,
Sequoyah,Attorney General,Mike Hunter,REP,680204,0,0,21,21,
Sequoyah,Attorney General,Gentner Drummond,REP,680204,1,1,10,12,
Sequoyah,Superintendent of Public Instruction,Joy Hofmeister,REP,680204,0,0,10,10,
Sequoyah,Superintendent of Public Instruction,Linda Murphy,REP,680204,1,1,21,23,
Sequoyah,Commissioner of Labor,Cathy Costello,REP,680204,1,0,23,24,
Sequoyah,Commissioner of Labor,Leslie Osborn,REP,680204,0,1,7,8,
Sequoyah,Corporation Commissioner,Bob Anthony,REP,680204,0,1,24,25,
Sequoyah,Corporation Commissioner,Brian Bingman,REP,680204,1,0,6,7,
Sequoyah,Governor,Chris Powell,LIB,680204,0,0,0,0,
Sequoyah,Governor,Rex Lawhorn,LIB,680204,0,0,0,0,
Sequoyah,Corporation Commissioner,Ashley Nicole Mccray,DEM,680204,0,0,8,8,
Sequoyah,Corporation Commissioner,Blake Cummings,DEM,680204,0,0,2,2,
Sequoyah,U.S. House,Jason Nichols,DEM,680204,0,0,4,4,02
Sequoyah,U.S. House,Clay Padgett,DEM,680204,0,0,6,6,02
Sequoyah,Governor,Mick Cornett,REP,680205,1,1,18,20,
Sequoyah,Governor,Kevin Stitt,REP,680205,0,9,19,28,
Sequoyah,Lieutenant Governor,Dana Murphy,REP,680205,1,5,12,18,
Sequoyah,Lieutenant Governor,Matt Pinnell,REP,680205,0,5,24,29,
Sequoyah,State Auditor,Cindy Byrd,REP,680205,1,6,15,22,
Sequoyah,State Auditor,Charlie Prater,REP,680205,0,4,21,25,
Sequoyah,Attorney General,Mike Hunter,REP,680205,0,6,17,23,
Sequoyah,Attorney General,Gentner Drummond,REP,680205,1,4,19,24,
Sequoyah,Superintendent of Public Instruction,Joy Hofmeister,REP,680205,0,2,14,16,
Sequoyah,Superintendent of Public Instruction,Linda Murphy,REP,680205,1,8,24,33,
Sequoyah,Commissioner of Labor,Cathy Costello,REP,680205,0,5,19,24,
Sequoyah,Commissioner of Labor,Leslie Osborn,REP,680205,1,5,18,24,
Sequoyah,Corporation Commissioner,Bob Anthony,REP,680205,0,8,18,26,
Sequoyah,Corporation Commissioner,Brian Bingman,REP,680205,1,2,18,21,
Sequoyah,Governor,Chris Powell,LIB,680205,0,0,0,0,
Sequoyah,Governor,Rex Lawhorn,LIB,680205,0,0,0,0,
Sequoyah,Corporation Commissioner,Ashley Nicole Mccray,DEM,680205,3,3,30,36,
Sequoyah,Corporation Commissioner,Blake Cummings,DEM,680205,1,4,19,24,
Sequoyah,U.S. House,Jason Nichols,DEM,680205,0,6,20,26,02
Sequoyah,U.S. House,Clay Padgett,DEM,680205,4,1,29,34,02
Sequoyah,Governor,Mick Cornett,REP,680206,0,0,8,8,
Sequoyah,Governor,Kevin Stitt,REP,680206,0,3,11,14,
Sequoyah,Lieutenant Governor,Dana Murphy,REP,680206,0,0,6,6,
Sequoyah,Lieutenant Governor,Matt Pinnell,REP,680206,0,3,13,16,
Sequoyah,State Auditor,Cindy Byrd,REP,680206,0,1,10,11,
Sequoyah,State Auditor,Charlie Prater,REP,680206,0,2,9,11,
Sequoyah,Attorney General,Mike Hunter,REP,680206,0,0,5,5,
Sequoyah,Attorney General,Gentner Drummond,REP,680206,0,3,14,17,
Sequoyah,Superintendent of Public Instruction,Joy Hofmeister,REP,680206,0,0,7,7,
Sequoyah,Superintendent of Public Instruction,Linda Murphy,REP,680206,0,3,12,15,
Sequoyah,Commissioner of Labor,Cathy Costello,REP,680206,0,2,12,14,
Sequoyah,Commissioner of Labor,Leslie Osborn,REP,680206,0,1,7,8,
Sequoyah,Corporation Commissioner,Bob Anthony,REP,680206,0,1,11,12,
Sequoyah,Corporation Commissioner,Brian Bingman,REP,680206,0,2,8,10,
Sequoyah,Governor,Chris Powell,LIB,680206,0,0,0,0,
Sequoyah,Governor,Rex Lawhorn,LIB,680206,0,0,0,0,
Sequoyah,Corporation Commissioner,Ashley Nicole Mccray,DEM,680206,0,5,12,17,
Sequoyah,Corporation Commissioner,Blake Cummings,DEM,680206,0,0,8,8,
Sequoyah,U.S. House,Jason Nichols,DEM,680206,0,2,8,10,02
Sequoyah,U.S. House,Clay Padgett,DEM,680206,0,3,12,15,02
Sequoyah,Governor,Mick Cornett,REP,680207,1,0,8,9,
Sequoyah,Governor,Kevin Stitt,REP,680207,0,0,27,27,
Sequoyah,Lieutenant Governor,Dana Murphy,REP,680207,0,0,5,5,
Sequoyah,Lieutenant Governor,Matt Pinnell,REP,680207,1,0,31,32,
Sequoyah,State Auditor,Cindy Byrd,REP,680207,0,0,18,18,
Sequoyah,State Auditor,Charlie Prater,REP,680207,1,0,18,19,
Sequoyah,Attorney General,Mike Hunter,REP,680207,0,0,10,10,
Sequoyah,Attorney General,Gentner Drummond,REP,680207,1,0,26,27,
Sequoyah,Superintendent of Public Instruction,Joy Hofmeister,REP,680207,0,0,13,13,
Sequoyah,Superintendent of Public Instruction,Linda Murphy,REP,680207,1,0,22,23,
Sequoyah,Commissioner of Labor,Cathy Costello,REP,680207,1,0,17,18,
Sequoyah,Commissioner of Labor,Leslie Osborn,REP,680207,0,0,18,18,
Sequoyah,Corporation Commissioner,Bob Anthony,REP,680207,0,0,18,18,
Sequoyah,Corporation Commissioner,Brian Bingman,REP,680207,1,0,16,17,
Sequoyah,Governor,Chris Powell,LIB,680207,0,0,0,0,
Sequoyah,Governor,Rex Lawhorn,LIB,680207,0,0,0,0,
Sequoyah,Corporation Commissioner,Ashley Nicole Mccray,DEM,680207,0,5,17,22,
Sequoyah,Corporation Commissioner,Blake Cummings,DEM,680207,2,1,14,17,
Sequoyah,U.S. House,Jason Nichols,DEM,680207,2,3,14,19,02
Sequoyah,U.S. House,Clay Padgett,DEM,680207,0,3,18,21,02
Sequoyah,Governor,Mick Cornett,REP,680208,0,3,29,32,
Sequoyah,Governor,Kevin Stitt,REP,680208,0,5,36,41,
Sequoyah,Lieutenant Governor,Dana Murphy,REP,680208,0,2,19,21,
Sequoyah,Lieutenant Governor,Matt Pinnell,REP,680208,0,6,47,53,
Sequoyah,State Auditor,Cindy Byrd,REP,680208,0,4,31,35,
Sequoyah,State Auditor,Charlie Prater,REP,680208,0,4,34,38,
Sequoyah,Attorney General,Mike Hunter,REP,680208,0,3,27,30,
Sequoyah,Attorney General,Gentner Drummond,REP,680208,0,5,39,44,
Sequoyah,Superintendent of Public Instruction,Joy Hofmeister,REP,680208,0,3,28,31,
Sequoyah,Superintendent of Public Instruction,Linda Murphy,REP,680208,0,5,37,42,
Sequoyah,Commissioner of Labor,Cathy Costello,REP,680208,0,1,33,34,
Sequoyah,Commissioner of Labor,Leslie Osborn,REP,680208,0,7,32,39,
Sequoyah,Corporation Commissioner,Bob Anthony,REP,680208,0,1,30,31,
Sequoyah,Corporation Commissioner,Brian Bingman,REP,680208,0,7,34,41,
Sequoyah,Governor,Chris Powell,LIB,680208,0,0,0,0,
Sequoyah,Governor,Rex Lawhorn,LIB,680208,0,0,0,0,
Sequoyah,Corporation Commissioner,Ashley Nicole Mccray,DEM,680208,0,0,37,37,
Sequoyah,Corporation Commissioner,Blake Cummings,DEM,680208,0,1,33,34,
Sequoyah,U.S. House,Jason Nichols,DEM,680208,0,0,42,42,02
Sequoyah,U.S. House,Clay Padgett,DEM,680208,0,1,29,30,02
Sequoyah,Governor,Mick Cornett,REP,680209,0,0,14,14,
Sequoyah,Governor,Kevin Stitt,REP,680209,0,0,28,28,
Sequoyah,Lieutenant Governor,Dana Murphy,REP,680209,0,0,13,13,
Sequoyah,Lieutenant Governor,Matt Pinnell,REP,680209,0,0,29,29,
Sequoyah,State Auditor,Cindy Byrd,REP,680209,0,0,19,19,
Sequoyah,State Auditor,Charlie Prater,REP,680209,0,0,23,23,
Sequoyah,Attorney General,Mike Hunter,REP,680209,0,0,20,20,
Sequoyah,Attorney General,Gentner Drummond,REP,680209,0,0,22,22,
Sequoyah,Superintendent of Public Instruction,Joy Hofmeister,REP,680209,0,0,16,16,
Sequoyah,Superintendent of Public Instruction,Linda Murphy,REP,680209,0,0,26,26,
Sequoyah,Commissioner of Labor,Cathy Costello,REP,680209,0,0,17,17,
Sequoyah,Commissioner of Labor,Leslie Osborn,REP,680209,0,0,24,24,
Sequoyah,Corporation Commissioner,Bob Anthony,REP,680209,0,0,19,19,
Sequoyah,Corporation Commissioner,Brian Bingman,REP,680209,0,0,22,22,
Sequoyah,Governor,Chris Powell,LIB,680209,0,0,0,0,
Sequoyah,Governor,Rex Lawhorn,LIB,680209,0,0,0,0,
Sequoyah,Corporation Commissioner,Ashley Nicole Mccray,DEM,680209,0,0,29,29,
Sequoyah,Corporation Commissioner,Blake Cummings,DEM,680209,0,0,21,21,
Sequoyah,U.S. House,Jason Nichols,DEM,680209,0,0,22,22,02
Sequoyah,U.S. House,Clay Padgett,DEM,680209,0,0,28,28,02
Sequoyah,Governor,Mick Cornett,REP,680210,1,0,21,22,
Sequoyah,Governor,Kevin Stitt,REP,680210,3,0,34,37,
Sequoyah,Lieutenant Governor,Dana Murphy,REP,680210,3,0,19,22,
Sequoyah,Lieutenant Governor,Matt Pinnell,REP,680210,1,0,35,36,
Sequoyah,State Auditor,Cindy Byrd,REP,680210,3,0,20,23,
Sequoyah,State Auditor,Charlie Prater,REP,680210,1,0,33,34,
Sequoyah,Attorney General,Mike Hunter,REP,680210,4,0,13,17,
Sequoyah,Attorney General,Gentner Drummond,REP,680210,0,0,40,40,
Sequoyah,Superintendent of Public Instruction,Joy Hofmeister,REP,680210,2,0,28,30,
Sequoyah,Superintendent of Public Instruction,Linda Murphy,REP,680210,2,0,25,27,
Sequoyah,Commissioner of Labor,Cathy Costello,REP,680210,2,0,23,25,
Sequoyah,Commissioner of Labor,Leslie Osborn,REP,680210,2,0,29,31,
Sequoyah,Corporation Commissioner,Bob Anthony,REP,680210,3,0,23,26,
Sequoyah,Corporation Commissioner,Brian Bingman,REP,680210,1,0,29,30,
Sequoyah,Governor,Chris Powell,LIB,680210,0,0,0,0,
Sequoyah,Governor,Rex Lawhorn,LIB,680210,0,0,0,0,
Sequoyah,Corporation Commissioner,Ashley Nicole Mccray,DEM,680210,0,0,22,22,
Sequoyah,Corporation Commissioner,Blake Cummings,DEM,680210,0,0,32,32,
Sequoyah,U.S. House,Jason Nichols,DEM,680210,0,0,30,30,02
Sequoyah,U.S. House,Clay Padgett,DEM,680210,0,0,24,24,02
Sequoyah,Governor,Mick Cornett,REP,680301,0,4,15,19,
Sequoyah,Governor,Kevin Stitt,REP,680301,4,3,23,30,
Sequoyah,Lieutenant Governor,Dana Murphy,REP,680301,0,0,9,9,
Sequoyah,Lieutenant Governor,Matt Pinnell,REP,680301,4,7,28,39,
Sequoyah,State Auditor,Cindy Byrd,REP,680301,2,1,23,26,
Sequoyah,State Auditor,Charlie Prater,REP,680301,2,6,12,20,
Sequoyah,Attorney General,Mike Hunter,REP,680301,4,5,15,24,
Sequoyah,Attorney General,Gentner Drummond,REP,680301,0,2,21,23,
Sequoyah,Superintendent of Public Instruction,Joy Hofmeister,REP,680301,2,3,21,26,
Sequoyah,Superintendent of Public Instruction,Linda Murphy,REP,680301,2,4,16,22,
Sequoyah,Commissioner of Labor,Cathy Costello,REP,680301,2,4,15,21,
Sequoyah,Commissioner of Labor,Leslie Osborn,REP,680301,2,3,22,27,
Sequoyah,Corporation Commissioner,Bob Anthony,REP,680301,3,3,18,24,
Sequoyah,Corporation Commissioner,Brian Bingman,REP,680301,1,4,20,25,
Sequoyah,Governor,Chris Powell,LIB,680301,0,0,0,0,
Sequoyah,Governor,Rex Lawhorn,LIB,680301,0,0,1,1,
Sequoyah,Corporation Commissioner,Ashley Nicole Mccray,DEM,680301,3,7,37,47,
Sequoyah,Corporation Commissioner,Blake Cummings,DEM,680301,0,3,27,30,
Sequoyah,U.S. House,Jason Nichols,DEM,680301,0,2,27,29,02
Sequoyah,U.S. House,Clay Padgett,DEM,680301,3,8,38,49,02
Sequoyah,Governor,Mick Cornett,REP,680302,0,1,7,8,
Sequoyah,Governor,Kevin Stitt,REP,680302,0,1,14,15,
Sequoyah,Lieutenant Governor,Dana Murphy,REP,680302,0,0,9,9,
Sequoyah,Lieutenant Governor,Matt Pinnell,REP,680302,0,2,12,14,
Sequoyah,State Auditor,Cindy Byrd,REP,680302,0,0,12,12,
Sequoyah,State Auditor,Charlie Prater,REP,680302,0,2,10,12,
Sequoyah,Attorney General,Mike Hunter,REP,680302,0,2,12,14,
Sequoyah,Attorney General,Gentner Drummond,REP,680302,0,0,10,10,
Sequoyah,Superintendent of Public Instruction,Joy Hofmeister,REP,680302,0,0,13,13,
Sequoyah,Superintendent of Public Instruction,Linda Murphy,REP,680302,0,2,8,10,
Sequoyah,Commissioner of Labor,Cathy Costello,REP,680302,0,0,11,11,
Sequoyah,Commissioner of Labor,Leslie Osborn,REP,680302,0,2,10,12,
Sequoyah,Corporation Commissioner,Bob Anthony,REP,680302,0,1,11,12,
Sequoyah,Corporation Commissioner,Brian Bingman,REP,680302,0,1,9,10,
Sequoyah,Governor,Chris Powell,LIB,680302,0,0,0,0,
Sequoyah,Governor,Rex Lawhorn,LIB,680302,0,0,0,0,
Sequoyah,Corporation Commissioner,Ashley Nicole Mccray,DEM,680302,0,4,9,13,
Sequoyah,Corporation Commissioner,Blake Cummings,DEM,680302,0,1,20,21,
Sequoyah,U.S. House,Jason Nichols,DEM,680302,0,4,7,11,02
Sequoyah,U.S. House,Clay Padgett,DEM,680302,0,1,22,23,02
Sequoyah,Governor,Mick Cornett,REP,680303,0,1,21,22,
Sequoyah,Governor,Kevin Stitt,REP,680303,1,0,24,25,
Sequoyah,Lieutenant Governor,Dana Murphy,REP,680303,0,0,14,14,
Sequoyah,Lieutenant Governor,Matt Pinnell,REP,680303,1,1,31,33,
Sequoyah,State Auditor,Cindy Byrd,REP,680303,0,0,25,25,
Sequoyah,State Auditor,Charlie Prater,REP,680303,1,1,20,22,
Sequoyah,Attorney General,Mike Hunter,REP,680303,0,1,24,25,
Sequoyah,Attorney General,Gentner Drummond,REP,680303,1,0,21,22,
Sequoyah,Superintendent of Public Instruction,Joy Hofmeister,REP,680303,0,1,25,26,
Sequoyah,Superintendent of Public Instruction,Linda Murphy,REP,680303,1,0,20,21,
Sequoyah,Commissioner of Labor,Cathy Costello,REP,680303,0,1,26,27,
Sequoyah,Commissioner of Labor,Leslie Osborn,REP,680303,1,0,18,19,
Sequoyah,Corporation Commissioner,Bob Anthony,REP,680303,1,1,21,23,
Sequoyah,Corporation Commissioner,Brian Bingman,REP,680303,0,0,24,24,
Sequoyah,Governor,Chris Powell,LIB,680303,0,0,0,0,
Sequoyah,Governor,Rex Lawhorn,LIB,680303,0,0,0,0,
Sequoyah,Corporation Commissioner,Ashley Nicole Mccray,DEM,680303,1,6,48,55,
Sequoyah,Corporation Commissioner,Blake Cummings,DEM,680303,2,3,34,39,
Sequoyah,U.S. House,Jason Nichols,DEM,680303,1,3,39,43,02
Sequoyah,U.S. House,Clay Padgett,DEM,680303,2,6,43,51,02
Sequoyah,Governor,Mick Cornett,REP,680304,0,2,9,11,
Sequoyah,Governor,Kevin Stitt,REP,680304,0,5,15,20,
Sequoyah,Lieutenant Governor,Dana Murphy,REP,680304,0,2,8,10,
Sequoyah,Lieutenant Governor,Matt Pinnell,REP,680304,0,4,16,20,
Sequoyah,State Auditor,Cindy Byrd,REP,680304,0,5,11,16,
Sequoyah,State Auditor,Charlie Prater,REP,680304,0,0,12,12,
Sequoyah,Attorney General,Mike Hunter,REP,680304,0,3,17,20,
Sequoyah,Attorney General,Gentner Drummond,REP,680304,0,3,7,10,
Sequoyah,Superintendent of Public Instruction,Joy Hofmeister,REP,680304,0,2,8,10,
Sequoyah,Superintendent of Public Instruction,Linda Murphy,REP,680304,0,3,16,19,
Sequoyah,Commissioner of Labor,Cathy Costello,REP,680304,0,2,9,11,
Sequoyah,Commissioner of Labor,Leslie Osborn,REP,680304,0,4,15,19,
Sequoyah,Corporation Commissioner,Bob Anthony,REP,680304,0,4,13,17,
Sequoyah,Corporation Commissioner,Brian Bingman,REP,680304,0,1,11,12,
Sequoyah,Governor,Chris Powell,LIB,680304,0,0,0,0,
Sequoyah,Governor,Rex Lawhorn,LIB,680304,0,0,0,0,
Sequoyah,Corporation Commissioner,Ashley Nicole Mccray,DEM,680304,1,0,5,6,
Sequoyah,Corporation Commissioner,Blake Cummings,DEM,680304,0,0,9,9,
Sequoyah,U.S. House,Jason Nichols,DEM,680304,1,0,4,5,02
Sequoyah,U.S. House,Clay Padgett,DEM,680304,0,0,10,10,02
Sequoyah,Governor,Mick Cornett,REP,680305,0,0,19,19,
Sequoyah,Governor,Kevin Stitt,REP,680305,1,0,8,9,
Sequoyah,Lieutenant Governor,Dana Murphy,REP,680305,0,0,15,15,
Sequoyah,Lieutenant Governor,Matt Pinnell,REP,680305,1,0,12,13,
Sequoyah,State Auditor,Cindy Byrd,REP,680305,0,0,16,16,
Sequoyah,State Auditor,Charlie Prater,REP,680305,1,0,11,12,
Sequoyah,Attorney General,Mike Hunter,REP,680305,1,0,12,13,
Sequoyah,Attorney General,Gentner Drummond,REP,680305,0,0,15,15,
Sequoyah,Superintendent of Public Instruction,Joy Hofmeister,REP,680305,0,0,16,16,
Sequoyah,Superintendent of Public Instruction,Linda Murphy,REP,680305,1,0,11,12,
Sequoyah,Commissioner of Labor,Cathy Costello,REP,680305,1,0,20,21,
Sequoyah,Commissioner of Labor,Leslie Osborn,REP,680305,0,0,7,7,
Sequoyah,Corporation Commissioner,Bob Anthony,REP,680305,1,0,21,22,
Sequoyah,Corporation Commissioner,Brian Bingman,REP,680305,0,0,6,6,
Sequoyah,Governor,Chris Powell,LIB,680305,0,0,0,0,
Sequoyah,Governor,Rex Lawhorn,LIB,680305,0,0,0,0,
Sequoyah,Corporation Commissioner,Ashley Nicole Mccray,DEM,680305,0,2,11,13,
Sequoyah,Corporation Commissioner,Blake Cummings,DEM,680305,0,1,14,15,
Sequoyah,U.S. House,Jason Nichols,DEM,680305,0,0,12,12,02
Sequoyah,U.S. House,Clay Padgett,DEM,680305,0,3,13,16,02
Sequoyah,Governor,Mick Cornett,REP,680306,0,1,23,24,
Sequoyah,Governor,Kevin Stitt,REP,680306,1,2,33,36,
Sequoyah,Lieutenant Governor,Dana Murphy,REP,680306,0,0,17,17,
Sequoyah,Lieutenant Governor,Matt Pinnell,REP,680306,1,3,39,43,
Sequoyah,State Auditor,Cindy Byrd,REP,680306,0,0,26,26,
Sequoyah,State Auditor,Charlie Prater,REP,680306,1,3,30,34,
Sequoyah,Attorney General,Mike Hunter,REP,680306,1,1,28,30,
Sequoyah,Attorney General,Gentner Drummond,REP,680306,0,2,28,30,
Sequoyah,Superintendent of Public Instruction,Joy Hofmeister,REP,680306,1,3,26,30,
Sequoyah,Superintendent of Public Instruction,Linda Murphy,REP,680306,0,0,29,29,
Sequoyah,Commissioner of Labor,Cathy Costello,REP,680306,0,2,15,17,
Sequoyah,Commissioner of Labor,Leslie Osborn,REP,680306,1,1,41,43,
Sequoyah,Corporation Commissioner,Bob Anthony,REP,680306,0,3,32,35,
Sequoyah,Corporation Commissioner,Brian Bingman,REP,680306,1,0,23,24,
Sequoyah,Governor,Chris Powell,LIB,680306,0,0,0,0,
Sequoyah,Governor,Rex Lawhorn,LIB,680306,0,0,0,0,
Sequoyah,Corporation Commissioner,Ashley Nicole Mccray,DEM,680306,1,5,22,28,
Sequoyah,Corporation Commissioner,Blake Cummings,DEM,680306,0,1,24,25,
Sequoyah,U.S. House,Jason Nichols,DEM,680306,0,3,15,18,02
Sequoyah,U.S. House,Clay Padgett,DEM,680306,1,3,30,34,02
Sequoyah,Governor,Mick Cornett,REP,680307,0,3,8,11,
Sequoyah,Governor,Kevin Stitt,REP,680307,0,3,14,17,
Sequoyah,Lieutenant Governor,Dana Murphy,REP,680307,0,3,6,9,
Sequoyah,Lieutenant Governor,Matt Pinnell,REP,680307,0,3,15,18,
Sequoyah,State Auditor,Cindy Byrd,REP,680307,0,2,13,15,
Sequoyah,State Auditor,Charlie Prater,REP,680307,0,3,8,11,
Sequoyah,Attorney General,Mike Hunter,REP,680307,0,3,13,16,
Sequoyah,Attorney General,Gentner Drummond,REP,680307,0,2,9,11,
Sequoyah,Superintendent of Public Instruction,Joy Hofmeister,REP,680307,0,3,7,10,
Sequoyah,Superintendent of Public Instruction,Linda Murphy,REP,680307,0,2,15,17,
Sequoyah,Commissioner of Labor,Cathy Costello,REP,680307,0,2,13,15,
Sequoyah,Commissioner of Labor,Leslie Osborn,REP,680307,0,3,8,11,
Sequoyah,Corporation Commissioner,Bob Anthony,REP,680307,0,3,12,15,
Sequoyah,Corporation Commissioner,Brian Bingman,REP,680307,0,2,9,11,
Sequoyah,Governor,Chris Powell,LIB,680307,0,0,0,0,
Sequoyah,Governor,Rex Lawhorn,LIB,680307,0,0,0,0,
Sequoyah,Corporation Commissioner,Ashley Nicole Mccray,DEM,680307,1,2,16,19,
Sequoyah,Corporation Commissioner,Blake Cummings,DEM,680307,0,0,13,13,
Sequoyah,U.S. House,Jason Nichols,DEM,680307,0,1,14,15,02
Sequoyah,U.S. House,Clay Padgett,DEM,680307,1,1,15,17,02
Sequoyah,Governor,Mick Cornett,REP,680308,0,2,3,5,
Sequoyah,Governor,Kevin Stitt,REP,680308,0,2,13,15,
Sequoyah,Lieutenant Governor,Dana Murphy,REP,680308,0,2,4,6,
Sequoyah,Lieutenant Governor,Matt Pinnell,REP,680308,0,2,12,14,
Sequoyah,State Auditor,Cindy Byrd,REP,680308,0,2,6,8,
Sequoyah,State Auditor,Charlie Prater,REP,680308,0,2,10,12,
Sequoyah,Attorney General,Mike Hunter,REP,680308,0,2,4,6,
Sequoyah,Attorney General,Gentner Drummond,REP,680308,0,2,12,14,
Sequoyah,Superintendent of Public Instruction,Joy Hofmeister,REP,680308,0,0,5,5,
Sequoyah,Superintendent of Public Instruction,Linda Murphy,REP,680308,0,3,11,14,
Sequoyah,Commissioner of Labor,Cathy Costello,REP,680308,0,2,6,8,
Sequoyah,Commissioner of Labor,Leslie Osborn,REP,680308,0,1,10,11,
Sequoyah,Corporation Commissioner,Bob Anthony,REP,680308,0,2,4,6,
Sequoyah,Corporation Commissioner,Brian Bingman,REP,680308,0,1,12,13,
Sequoyah,Governor,Chris Powell,LIB,680308,0,0,0,0,
Sequoyah,Governor,Rex Lawhorn,LIB,680308,0,0,0,0,
Sequoyah,Corporation Commissioner,Ashley Nicole Mccray,DEM,680308,0,0,6,6,
Sequoyah,Corporation Commissioner,Blake Cummings,DEM,680308,0,0,7,7,
Sequoyah,U.S. House,Jason Nichols,DEM,680308,0,0,3,3,02
Sequoyah,U.S. House,Clay Padgett,DEM,680308,0,0,11,11,02
Sequoyah,Governor,Mick Cornett,REP,680309,1,0,6,7,
Sequoyah,Governor,Kevin Stitt,REP,680309,0,0,11,11,
Sequoyah,Lieutenant Governor,Dana Murphy,REP,680309,0,0,2,2,
Sequoyah,Lieutenant Governor,Matt Pinnell,REP,680309,1,0,15,16,
Sequoyah,State Auditor,Cindy Byrd,REP,680309,1,0,6,7,
Sequoyah,State Auditor,Charlie Prater,REP,680309,0,0,11,11,
Sequoyah,Attorney General,Mike Hunter,REP,680309,0,0,13,13,
Sequoyah,Attorney General,Gentner Drummond,REP,680309,1,0,4,5,
Sequoyah,Superintendent of Public Instruction,Joy Hofmeister,REP,680309,0,0,5,5,
Sequoyah,Superintendent of Public Instruction,Linda Murphy,REP,680309,1,0,11,12,
Sequoyah,Commissioner of Labor,Cathy Costello,REP,680309,0,0,5,5,
Sequoyah,Commissioner of Labor,Leslie Osborn,REP,680309,1,0,11,12,
Sequoyah,Corporation Commissioner,Bob Anthony,REP,680309,0,0,7,7,
Sequoyah,Corporation Commissioner,Brian Bingman,REP,680309,1,0,9,10,
Sequoyah,Governor,Chris Powell,LIB,680309,0,0,0,0,
Sequoyah,Governor,Rex Lawhorn,LIB,680309,0,0,0,0,
Sequoyah,Corporation Commissioner,Ashley Nicole Mccray,DEM,680309,1,0,6,7,
Sequoyah,Corporation Commissioner,Blake Cummings,DEM,680309,1,0,11,12,
Sequoyah,U.S. House,Jason Nichols,DEM,680309,0,0,7,7,02
Sequoyah,U.S. House,Clay Padgett,DEM,680309,2,0,10,12,02
Sequoyah,Governor,Mick Cornett,REP,680310,0,3,5,8,
Sequoyah,Governor,Kevin Stitt,REP,680310,2,1,16,19,
Sequoyah,Lieutenant Governor,Dana Murphy,REP,680310,0,1,6,7,
Sequoyah,Lieutenant Governor,Matt Pinnell,REP,680310,2,3,15,20,
Sequoyah,State Auditor,Cindy Byrd,REP,680310,1,1,16,18,
Sequoyah,State Auditor,Charlie Prater,REP,680310,1,3,6,10,
Sequoyah,Attorney General,Mike Hunter,REP,680310,2,1,18,21,
Sequoyah,Attorney General,Gentner Drummond,REP,680310,0,3,4,7,
Sequoyah,Superintendent of Public Instruction,Joy Hofmeister,REP,680310,0,1,12,13,
Sequoyah,Superintendent of Public Instruction,Linda Murphy,REP,680310,2,3,12,17,
Sequoyah,Commissioner of Labor,Cathy Costello,REP,680310,1,4,17,22,
Sequoyah,Commissioner of Labor,Leslie Osborn,REP,680310,1,0,4,5,
Sequoyah,Corporation Commissioner,Bob Anthony,REP,680310,2,4,14,20,
Sequoyah,Corporation Commissioner,Brian Bingman,REP,680310,0,0,7,7,
Sequoyah,Governor,Chris Powell,LIB,680310,0,0,0,0,
Sequoyah,Governor,Rex Lawhorn,LIB,680310,0,0,0,0,
Sequoyah,Corporation Commissioner,Ashley Nicole Mccray,DEM,680310,1,1,8,10,
Sequoyah,Corporation Commissioner,Blake Cummings,DEM,680310,0,1,8,9,
Sequoyah,U.S. House,Jason Nichols,DEM,680310,0,1,5,6,02
Sequoyah,U.S. House,Clay Padgett,DEM,680310,1,1,11,13,02
Stephens,Governor,Mick Cornett,REP,690001,5,9,154,168,
Stephens,Governor,Kevin Stitt,REP,690001,1,12,139,152,
Stephens,Lieutenant Governor,Dana Murphy,REP,690001,3,6,117,126,
Stephens,Lieutenant Governor,Matt Pinnell,REP,690001,3,15,164,182,
Stephens,State Auditor,Cindy Byrd,REP,690001,6,14,145,165,
Stephens,State Auditor,Charlie Prater,REP,690001,0,6,126,132,
Stephens,Attorney General,Mike Hunter,REP,690001,3,11,167,181,
Stephens,Attorney General,Gentner Drummond,REP,690001,3,10,118,131,
Stephens,Superintendent of Public Instruction,Joy Hofmeister,REP,690001,1,10,153,164,
Stephens,Superintendent of Public Instruction,Linda Murphy,REP,690001,5,10,129,144,
Stephens,Commissioner of Labor,Cathy Costello,REP,690001,2,11,144,157,
Stephens,Commissioner of Labor,Leslie Osborn,REP,690001,4,8,125,137,
Stephens,Corporation Commissioner,Bob Anthony,REP,690001,3,16,156,175,
Stephens,Corporation Commissioner,Brian Bingman,REP,690001,3,1,120,124,
Stephens,Governor,Chris Powell,LIB,690001,0,0,0,0,
Stephens,Governor,Rex Lawhorn,LIB,690001,0,0,0,0,
Stephens,Corporation Commissioner,Ashley Nicole Mccray,DEM,690001,0,3,23,26,
Stephens,Corporation Commissioner,Blake Cummings,DEM,690001,0,1,29,30,
Stephens,U.S. House,Mary Brannon,DEM,690001,0,0,30,30,04
Stephens,U.S. House,Fred Gipson,DEM,690001,0,4,22,26,04
Stephens,Governor,Mick Cornett,REP,690003,2,5,108,115,
Stephens,Governor,Kevin Stitt,REP,690003,2,7,77,86,
Stephens,Lieutenant Governor,Dana Murphy,REP,690003,4,4,72,80,
Stephens,Lieutenant Governor,Matt Pinnell,REP,690003,0,8,113,121,
Stephens,State Auditor,Cindy Byrd,REP,690003,2,7,93,102,
Stephens,State Auditor,Charlie Prater,REP,690003,2,5,86,93,
Stephens,Attorney General,Mike Hunter,REP,690003,3,8,99,110,
Stephens,Attorney General,Gentner Drummond,REP,690003,1,6,83,90,
Stephens,Superintendent of Public Instruction,Joy Hofmeister,REP,690003,2,8,102,112,
Stephens,Superintendent of Public Instruction,Linda Murphy,REP,690003,2,5,79,86,
Stephens,Commissioner of Labor,Cathy Costello,REP,690003,3,5,94,102,
Stephens,Commissioner of Labor,Leslie Osborn,REP,690003,1,7,87,95,
Stephens,Corporation Commissioner,Bob Anthony,REP,690003,3,6,108,117,
Stephens,Corporation Commissioner,Brian Bingman,REP,690003,1,6,72,79,
Stephens,Governor,Chris Powell,LIB,690003,0,0,2,2,
Stephens,Governor,Rex Lawhorn,LIB,690003,0,0,0,0,
Stephens,Corporation Commissioner,Ashley Nicole Mccray,DEM,690003,6,0,18,24,
Stephens,Corporation Commissioner,Blake Cummings,DEM,690003,0,0,18,18,
Stephens,U.S. House,Mary Brannon,DEM,690003,5,0,15,20,04
Stephens,U.S. House,Fred Gipson,DEM,690003,1,0,20,21,04
Stephens,Governor,Mick Cornett,REP,690004,4,5,48,57,
Stephens,Governor,Kevin Stitt,REP,690004,2,2,77,81,
Stephens,Lieutenant Governor,Dana Murphy,REP,690004,0,2,42,44,
Stephens,Lieutenant Governor,Matt Pinnell,REP,690004,6,5,82,93,
Stephens,State Auditor,Cindy Byrd,REP,690004,3,2,57,62,
Stephens,State Auditor,Charlie Prater,REP,690004,3,5,65,73,
Stephens,Attorney General,Mike Hunter,REP,690004,3,5,67,75,
Stephens,Attorney General,Gentner Drummond,REP,690004,3,2,57,62,
Stephens,Superintendent of Public Instruction,Joy Hofmeister,REP,690004,4,6,68,78,
Stephens,Superintendent of Public Instruction,Linda Murphy,REP,690004,2,1,54,57,
Stephens,Commissioner of Labor,Cathy Costello,REP,690004,2,1,62,65,
Stephens,Commissioner of Labor,Leslie Osborn,REP,690004,4,6,59,69,
Stephens,Corporation Commissioner,Bob Anthony,REP,690004,3,2,69,74,
Stephens,Corporation Commissioner,Brian Bingman,REP,690004,3,5,52,60,
Stephens,Governor,Chris Powell,LIB,690004,0,0,0,0,
Stephens,Governor,Rex Lawhorn,LIB,690004,0,0,0,0,
Stephens,Corporation Commissioner,Ashley Nicole Mccray,DEM,690004,2,0,27,29,
Stephens,Corporation Commissioner,Blake Cummings,DEM,690004,0,2,16,18,
Stephens,U.S. House,Mary Brannon,DEM,690004,2,1,24,27,04
Stephens,U.S. House,Fred Gipson,DEM,690004,0,1,19,20,04
Stephens,Governor,Mick Cornett,REP,690008,1,3,24,28,
Stephens,Governor,Kevin Stitt,REP,690008,0,2,49,51,
Stephens,Lieutenant Governor,Dana Murphy,REP,690008,0,3,26,29,
Stephens,Lieutenant Governor,Matt Pinnell,REP,690008,1,2,48,51,
Stephens,State Auditor,Cindy Byrd,REP,690008,1,4,33,38,
Stephens,State Auditor,Charlie Prater,REP,690008,0,1,40,41,
Stephens,Attorney General,Mike Hunter,REP,690008,0,2,39,41,
Stephens,Attorney General,Gentner Drummond,REP,690008,1,3,35,39,
Stephens,Superintendent of Public Instruction,Joy Hofmeister,REP,690008,0,4,33,37,
Stephens,Superintendent of Public Instruction,Linda Murphy,REP,690008,1,1,40,42,
Stephens,Commissioner of Labor,Cathy Costello,REP,690008,0,3,32,35,
Stephens,Commissioner of Labor,Leslie Osborn,REP,690008,1,2,38,41,
Stephens,Corporation Commissioner,Bob Anthony,REP,690008,0,2,47,49,
Stephens,Corporation Commissioner,Brian Bingman,REP,690008,1,3,27,31,
Stephens,Governor,Chris Powell,LIB,690008,0,0,0,0,
Stephens,Governor,Rex Lawhorn,LIB,690008,0,0,0,0,
Stephens,Corporation Commissioner,Ashley Nicole Mccray,DEM,690008,1,4,26,31,
Stephens,Corporation Commissioner,Blake Cummings,DEM,690008,2,0,20,22,
Stephens,U.S. House,Mary Brannon,DEM,690008,3,4,22,29,04
Stephens,U.S. House,Fred Gipson,DEM,690008,0,0,24,24,04
Stephens,Governor,Mick Cornett,REP,690012,0,2,40,42,
Stephens,Governor,Kevin Stitt,REP,690012,2,2,57,61,
Stephens,Lieutenant Governor,Dana Murphy,REP,690012,0,1,40,41,
Stephens,Lieutenant Governor,Matt Pinnell,REP,690012,2,2,57,61,
Stephens,State Auditor,Cindy Byrd,REP,690012,0,3,47,50,
Stephens,State Auditor,Charlie Prater,REP,690012,2,1,48,51,
Stephens,Attorney General,Mike Hunter,REP,690012,0,1,46,47,
Stephens,Attorney General,Gentner Drummond,REP,690012,2,3,50,55,
Stephens,Superintendent of Public Instruction,Joy Hofmeister,REP,690012,1,4,33,38,
Stephens,Superintendent of Public Instruction,Linda Murphy,REP,690012,1,0,64,65,
Stephens,Commissioner of Labor,Cathy Costello,REP,690012,1,2,49,52,
Stephens,Commissioner of Labor,Leslie Osborn,REP,690012,1,2,44,47,
Stephens,Corporation Commissioner,Bob Anthony,REP,690012,0,1,55,56,
Stephens,Corporation Commissioner,Brian Bingman,REP,690012,2,3,39,44,
Stephens,Governor,Chris Powell,LIB,690012,0,0,0,0,
Stephens,Governor,Rex Lawhorn,LIB,690012,0,0,1,1,
Stephens,Corporation Commissioner,Ashley Nicole Mccray,DEM,690012,1,1,31,33,
Stephens,Corporation Commissioner,Blake Cummings,DEM,690012,0,1,8,9,
Stephens,U.S. House,Mary Brannon,DEM,690012,1,2,24,27,04
Stephens,U.S. House,Fred Gipson,DEM,690012,0,0,15,15,04
Stephens,Governor,Mick Cornett,REP,690013,0,1,7,8,
Stephens,Governor,Kevin Stitt,REP,690013,3,1,15,19,
Stephens,Lieutenant Governor,Dana Murphy,REP,690013,1,0,10,11,
Stephens,Lieutenant Governor,Matt Pinnell,REP,690013,2,2,12,16,
Stephens,State Auditor,Cindy Byrd,REP,690013,1,0,11,12,
Stephens,State Auditor,Charlie Prater,REP,690013,2,2,11,15,
Stephens,Attorney General,Mike Hunter,REP,690013,2,2,11,15,
Stephens,Attorney General,Gentner Drummond,REP,690013,1,0,11,12,
Stephens,Superintendent of Public Instruction,Joy Hofmeister,REP,690013,1,0,7,8,
Stephens,Superintendent of Public Instruction,Linda Murphy,REP,690013,1,2,16,19,
Stephens,Commissioner of Labor,Cathy Costello,REP,690013,0,1,12,13,
Stephens,Commissioner of Labor,Leslie Osborn,REP,690013,2,1,11,14,
Stephens,Corporation Commissioner,Bob Anthony,REP,690013,1,2,9,12,
Stephens,Corporation Commissioner,Brian Bingman,REP,690013,2,0,13,15,
Stephens,Governor,Chris Powell,LIB,690013,0,0,0,0,
Stephens,Governor,Rex Lawhorn,LIB,690013,0,0,0,0,
Stephens,Corporation Commissioner,Ashley Nicole Mccray,DEM,690013,5,0,9,14,
Stephens,Corporation Commissioner,Blake Cummings,DEM,690013,3,0,12,15,
Stephens,U.S. House,Mary Brannon,DEM,690013,6,0,11,17,04
Stephens,U.S. House,Fred Gipson,DEM,690013,1,0,10,11,04
Stephens,Governor,Mick Cornett,REP,690014,4,6,55,65,
Stephens,Governor,Kevin Stitt,REP,690014,1,14,128,143,
Stephens,Lieutenant Governor,Dana Murphy,REP,690014,5,6,72,83,
Stephens,Lieutenant Governor,Matt Pinnell,REP,690014,0,14,106,120,
Stephens,State Auditor,Cindy Byrd,REP,690014,4,16,108,128,
Stephens,State Auditor,Charlie Prater,REP,690014,1,4,66,71,
Stephens,Attorney General,Mike Hunter,REP,690014,4,9,82,95,
Stephens,Attorney General,Gentner Drummond,REP,690014,1,11,97,109,
Stephens,Superintendent of Public Instruction,Joy Hofmeister,REP,690014,3,7,92,102,
Stephens,Superintendent of Public Instruction,Linda Murphy,REP,690014,2,12,86,100,
Stephens,Commissioner of Labor,Cathy Costello,REP,690014,3,16,91,110,
Stephens,Commissioner of Labor,Leslie Osborn,REP,690014,2,4,87,93,
Stephens,Corporation Commissioner,Bob Anthony,REP,690014,4,14,103,121,
Stephens,Corporation Commissioner,Brian Bingman,REP,690014,1,6,73,80,
Stephens,Governor,Chris Powell,LIB,690014,0,0,1,1,
Stephens,Governor,Rex Lawhorn,LIB,690014,0,0,0,0,
Stephens,Corporation Commissioner,Ashley Nicole Mccray,DEM,690014,1,0,21,22,
Stephens,Corporation Commissioner,Blake Cummings,DEM,690014,0,0,20,20,
Stephens,U.S. House,Mary Brannon,DEM,690014,1,0,19,20,04
Stephens,U.S. House,Fred Gipson,DEM,690014,0,0,22,22,04
Stephens,Governor,Mick Cornett,REP,690015,1,0,14,15,
Stephens,Governor,Kevin Stitt,REP,690015,0,1,19,20,
Stephens,Lieutenant Governor,Dana Murphy,REP,690015,1,0,12,13,
Stephens,Lieutenant Governor,Matt Pinnell,REP,690015,0,1,21,22,
Stephens,State Auditor,Cindy Byrd,REP,690015,1,0,22,23,
Stephens,State Auditor,Charlie Prater,REP,690015,0,1,11,12,
Stephens,Attorney General,Mike Hunter,REP,690015,0,0,13,13,
Stephens,Attorney General,Gentner Drummond,REP,690015,1,1,20,22,
Stephens,Superintendent of Public Instruction,Joy Hofmeister,REP,690015,0,1,20,21,
Stephens,Superintendent of Public Instruction,Linda Murphy,REP,690015,1,0,13,14,
Stephens,Commissioner of Labor,Cathy Costello,REP,690015,1,0,16,17,
Stephens,Commissioner of Labor,Leslie Osborn,REP,690015,0,1,17,18,
Stephens,Corporation Commissioner,Bob Anthony,REP,690015,0,1,19,20,
Stephens,Corporation Commissioner,Brian Bingman,REP,690015,1,0,14,15,
Stephens,Governor,Chris Powell,LIB,690015,0,0,0,0,
Stephens,Governor,Rex Lawhorn,LIB,690015,0,0,0,0,
Stephens,Corporation Commissioner,Ashley Nicole Mccray,DEM,690015,0,0,7,7,
Stephens,Corporation Commissioner,Blake Cummings,DEM,690015,0,0,6,6,
Stephens,U.S. House,Mary Brannon,DEM,690015,0,0,5,5,04
Stephens,U.S. House,Fred Gipson,DEM,690015,0,0,8,8,04
Stephens,Governor,Mick Cornett,REP,690016,6,6,112,124,
Stephens,Governor,Kevin Stitt,REP,690016,2,9,155,166,
Stephens,Lieutenant Governor,Dana Murphy,REP,690016,5,3,98,106,
Stephens,Lieutenant Governor,Matt Pinnell,REP,690016,3,12,162,177,
Stephens,State Auditor,Cindy Byrd,REP,690016,6,8,146,160,
Stephens,State Auditor,Charlie Prater,REP,690016,2,6,109,117,
Stephens,Attorney General,Mike Hunter,REP,690016,5,5,128,138,
Stephens,Attorney General,Gentner Drummond,REP,690016,3,10,131,144,
Stephens,Superintendent of Public Instruction,Joy Hofmeister,REP,690016,3,6,135,144,
Stephens,Superintendent of Public Instruction,Linda Murphy,REP,690016,5,8,125,138,
Stephens,Commissioner of Labor,Cathy Costello,REP,690016,7,5,133,145,
Stephens,Commissioner of Labor,Leslie Osborn,REP,690016,1,8,114,123,
Stephens,Corporation Commissioner,Bob Anthony,REP,690016,6,7,141,154,
Stephens,Corporation Commissioner,Brian Bingman,REP,690016,2,7,111,120,
Stephens,Governor,Chris Powell,LIB,690016,0,0,0,0,
Stephens,Governor,Rex Lawhorn,LIB,690016,0,0,0,0,
Stephens,Corporation Commissioner,Ashley Nicole Mccray,DEM,690016,0,2,28,30,
Stephens,Corporation Commissioner,Blake Cummings,DEM,690016,2,4,24,30,
Stephens,U.S. House,Mary Brannon,DEM,690016,0,3,28,31,04
Stephens,U.S. House,Fred Gipson,DEM,690016,2,3,24,29,04
Stephens,Governor,Mick Cornett,REP,690019,5,7,138,150,
Stephens,Governor,Kevin Stitt,REP,690019,9,17,145,171,
Stephens,Lieutenant Governor,Dana Murphy,REP,690019,9,6,114,129,
Stephens,Lieutenant Governor,Matt Pinnell,REP,690019,5,18,163,186,
Stephens,State Auditor,Cindy Byrd,REP,690019,5,15,148,168,
Stephens,State Auditor,Charlie Prater,REP,690019,9,9,123,141,
Stephens,Attorney General,Mike Hunter,REP,690019,8,8,148,164,
Stephens,Attorney General,Gentner Drummond,REP,690019,6,16,131,153,
Stephens,Superintendent of Public Instruction,Joy Hofmeister,REP,690019,2,13,145,160,
Stephens,Superintendent of Public Instruction,Linda Murphy,REP,690019,12,10,136,158,
Stephens,Commissioner of Labor,Cathy Costello,REP,690019,7,12,132,151,
Stephens,Commissioner of Labor,Leslie Osborn,REP,690019,7,11,140,158,
Stephens,Corporation Commissioner,Bob Anthony,REP,690019,9,14,134,157,
Stephens,Corporation Commissioner,Brian Bingman,REP,690019,5,10,141,156,
Stephens,Governor,Chris Powell,LIB,690019,0,0,0,0,
Stephens,Governor,Rex Lawhorn,LIB,690019,0,0,0,0,
Stephens,Corporation Commissioner,Ashley Nicole Mccray,DEM,690019,0,3,36,39,
Stephens,Corporation Commissioner,Blake Cummings,DEM,690019,2,2,30,34,
Stephens,U.S. House,Mary Brannon,DEM,690019,1,2,38,41,04
Stephens,U.S. House,Fred Gipson,DEM,690019,1,3,28,32,04
Stephens,Governor,Mick Cornett,REP,690032,3,4,91,98,
Stephens,Governor,Kevin Stitt,REP,690032,0,6,97,103,
Stephens,Lieutenant Governor,Dana Murphy,REP,690032,3,5,71,79,
Stephens,Lieutenant Governor,Matt Pinnell,REP,690032,0,5,113,118,
Stephens,State Auditor,Cindy Byrd,REP,690032,1,4,80,85,
Stephens,State Auditor,Charlie Prater,REP,690032,2,6,101,109,
Stephens,Attorney General,Mike Hunter,REP,690032,2,9,102,113,
Stephens,Attorney General,Gentner Drummond,REP,690032,1,1,83,85,
Stephens,Superintendent of Public Instruction,Joy Hofmeister,REP,690032,1,6,81,88,
Stephens,Superintendent of Public Instruction,Linda Murphy,REP,690032,2,4,103,109,
Stephens,Commissioner of Labor,Cathy Costello,REP,690032,2,8,79,89,
Stephens,Commissioner of Labor,Leslie Osborn,REP,690032,1,2,100,103,
Stephens,Corporation Commissioner,Bob Anthony,REP,690032,1,10,100,111,
Stephens,Corporation Commissioner,Brian Bingman,REP,690032,2,0,84,86,
Stephens,Governor,Chris Powell,LIB,690032,0,0,0,0,
Stephens,Governor,Rex Lawhorn,LIB,690032,0,0,0,0,
Stephens,Corporation Commissioner,Ashley Nicole Mccray,DEM,690032,1,1,35,37,
Stephens,Corporation Commissioner,Blake Cummings,DEM,690032,3,0,40,43,
Stephens,U.S. House,Mary Brannon,DEM,690032,1,1,40,42,04
Stephens,U.S. House,Fred Gipson,DEM,690032,3,0,36,39,04
Stephens,Governor,Mick Cornett,REP,690033,4,8,131,143,
Stephens,Governor,Kevin Stitt,REP,690033,9,7,153,169,
Stephens,Lieutenant Governor,Dana Murphy,REP,690033,3,6,127,136,
Stephens,Lieutenant Governor,Matt Pinnell,REP,690033,10,9,149,168,
Stephens,State Auditor,Cindy Byrd,REP,690033,5,9,133,147,
Stephens,State Auditor,Charlie Prater,REP,690033,7,6,137,150,
Stephens,Attorney General,Mike Hunter,REP,690033,8,14,136,158,
Stephens,Attorney General,Gentner Drummond,REP,690033,5,1,143,149,
Stephens,Superintendent of Public Instruction,Joy Hofmeister,REP,690033,4,7,153,164,
Stephens,Superintendent of Public Instruction,Linda Murphy,REP,690033,8,8,125,141,
Stephens,Commissioner of Labor,Cathy Costello,REP,690033,9,6,118,133,
Stephens,Commissioner of Labor,Leslie Osborn,REP,690033,5,9,154,168,
Stephens,Corporation Commissioner,Bob Anthony,REP,690033,6,11,172,189,
Stephens,Corporation Commissioner,Brian Bingman,REP,690033,4,4,102,110,
Stephens,Governor,Chris Powell,LIB,690033,0,0,0,0,
Stephens,Governor,Rex Lawhorn,LIB,690033,0,0,0,0,
Stephens,Corporation Commissioner,Ashley Nicole Mccray,DEM,690033,1,0,61,62,
Stephens,Corporation Commissioner,Blake Cummings,DEM,690033,1,1,29,31,
Stephens,U.S. House,Mary Brannon,DEM,690033,1,0,63,64,04
Stephens,U.S. House,Fred Gipson,DEM,690033,1,1,26,28,04
Stephens,Governor,Mick Cornett,REP,690041,1,2,34,37,
Stephens,Governor,Kevin Stitt,REP,690041,3,1,69,73,
Stephens,Lieutenant Governor,Dana Murphy,REP,690041,1,3,24,28,
Stephens,Lieutenant Governor,Matt Pinnell,REP,690041,3,0,77,80,
Stephens,State Auditor,Cindy Byrd,REP,690041,2,2,47,51,
Stephens,State Auditor,Charlie Prater,REP,690041,2,1,55,58,
Stephens,Attorney General,Mike Hunter,REP,690041,1,3,49,53,
Stephens,Attorney General,Gentner Drummond,REP,690041,3,0,52,55,
Stephens,Superintendent of Public Instruction,Joy Hofmeister,REP,690041,2,1,46,49,
Stephens,Superintendent of Public Instruction,Linda Murphy,REP,690041,2,2,56,60,
Stephens,Commissioner of Labor,Cathy Costello,REP,690041,3,3,45,51,
Stephens,Commissioner of Labor,Leslie Osborn,REP,690041,1,0,56,57,
Stephens,Corporation Commissioner,Bob Anthony,REP,690041,3,1,49,53,
Stephens,Corporation Commissioner,Brian Bingman,REP,690041,1,2,53,56,
Stephens,Governor,Chris Powell,LIB,690041,0,0,0,0,
Stephens,Governor,Rex Lawhorn,LIB,690041,0,0,0,0,
Stephens,Corporation Commissioner,Ashley Nicole Mccray,DEM,690041,2,0,22,24,
Stephens,Corporation Commissioner,Blake Cummings,DEM,690041,0,0,13,13,
Stephens,U.S. House,Mary Brannon,DEM,690041,2,0,15,17,04
Stephens,U.S. House,Fred Gipson,DEM,690041,0,0,20,20,04
Stephens,Governor,Mick Cornett,REP,690049,0,0,19,19,
Stephens,Governor,Kevin Stitt,REP,690049,0,0,30,30,
Stephens,Lieutenant Governor,Dana Murphy,REP,690049,0,0,24,24,
Stephens,Lieutenant Governor,Matt Pinnell,REP,690049,0,0,23,23,
Stephens,State Auditor,Cindy Byrd,REP,690049,0,0,25,25,
Stephens,State Auditor,Charlie Prater,REP,690049,0,0,23,23,
Stephens,Attorney General,Mike Hunter,REP,690049,0,0,19,19,
Stephens,Attorney General,Gentner Drummond,REP,690049,0,0,29,29,
Stephens,Superintendent of Public Instruction,Joy Hofmeister,REP,690049,0,0,23,23,
Stephens,Superintendent of Public Instruction,Linda Murphy,REP,690049,0,0,25,25,
Stephens,Commissioner of Labor,Cathy Costello,REP,690049,0,0,21,21,
Stephens,Commissioner of Labor,Leslie Osborn,REP,690049,0,0,27,27,
Stephens,Corporation Commissioner,Bob Anthony,REP,690049,0,0,20,20,
Stephens,Corporation Commissioner,Brian Bingman,REP,690049,0,0,28,28,
Stephens,Governor,Chris Powell,LIB,690049,0,0,0,0,
Stephens,Governor,Rex Lawhorn,LIB,690049,0,0,0,0,
Stephens,Corporation Commissioner,Ashley Nicole Mccray,DEM,690049,1,0,1,2,
Stephens,Corporation Commissioner,Blake Cummings,DEM,690049,0,0,6,6,
Stephens,U.S. House,Mary Brannon,DEM,690049,1,0,2,3,04
Stephens,U.S. House,Fred Gipson,DEM,690049,0,0,5,5,04
Stephens,Governor,Mick Cornett,REP,690050,0,10,117,127,
Stephens,Governor,Kevin Stitt,REP,690050,2,8,184,194,
Stephens,Lieutenant Governor,Dana Murphy,REP,690050,1,10,119,130,
Stephens,Lieutenant Governor,Matt Pinnell,REP,690050,0,8,171,179,
Stephens,State Auditor,Cindy Byrd,REP,690050,1,7,137,145,
Stephens,State Auditor,Charlie Prater,REP,690050,1,11,152,164,
Stephens,Attorney General,Mike Hunter,REP,690050,0,8,138,146,
Stephens,Attorney General,Gentner Drummond,REP,690050,2,10,155,167,
Stephens,Superintendent of Public Instruction,Joy Hofmeister,REP,690050,1,7,136,144,
Stephens,Superintendent of Public Instruction,Linda Murphy,REP,690050,1,11,160,172,
Stephens,Commissioner of Labor,Cathy Costello,REP,690050,1,9,151,161,
Stephens,Commissioner of Labor,Leslie Osborn,REP,690050,1,9,138,148,
Stephens,Corporation Commissioner,Bob Anthony,REP,690050,1,8,155,164,
Stephens,Corporation Commissioner,Brian Bingman,REP,690050,1,10,132,143,
Stephens,Governor,Chris Powell,LIB,690050,0,1,0,1,
Stephens,Governor,Rex Lawhorn,LIB,690050,0,0,0,0,
Stephens,Corporation Commissioner,Ashley Nicole Mccray,DEM,690050,2,0,35,37,
Stephens,Corporation Commissioner,Blake Cummings,DEM,690050,2,1,21,24,
Stephens,U.S. House,Mary Brannon,DEM,690050,3,1,32,36,04
Stephens,U.S. House,Fred Gipson,DEM,690050,1,0,23,24,04
Stephens,Governor,Mick Cornett,REP,690051,0,2,40,42,
Stephens,Governor,Kevin Stitt,REP,690051,0,0,73,73,
Stephens,Lieutenant Governor,Dana Murphy,REP,690051,0,1,54,55,
Stephens,Lieutenant Governor,Matt Pinnell,REP,690051,0,1,59,60,
Stephens,State Auditor,Cindy Byrd,REP,690051,0,2,65,67,
Stephens,State Auditor,Charlie Prater,REP,690051,0,0,44,44,
Stephens,Attorney General,Mike Hunter,REP,690051,0,1,41,42,
Stephens,Attorney General,Gentner Drummond,REP,690051,0,1,69,70,
Stephens,Superintendent of Public Instruction,Joy Hofmeister,REP,690051,0,1,49,50,
Stephens,Superintendent of Public Instruction,Linda Murphy,REP,690051,0,1,61,62,
Stephens,Commissioner of Labor,Cathy Costello,REP,690051,0,1,59,60,
Stephens,Commissioner of Labor,Leslie Osborn,REP,690051,0,1,52,53,
Stephens,Corporation Commissioner,Bob Anthony,REP,690051,0,2,50,52,
Stephens,Corporation Commissioner,Brian Bingman,REP,690051,0,0,62,62,
Stephens,Governor,Chris Powell,LIB,690051,0,0,0,0,
Stephens,Governor,Rex Lawhorn,LIB,690051,0,0,1,1,
Stephens,Corporation Commissioner,Ashley Nicole Mccray,DEM,690051,2,1,10,13,
Stephens,Corporation Commissioner,Blake Cummings,DEM,690051,0,0,9,9,
Stephens,U.S. House,Mary Brannon,DEM,690051,2,1,9,12,04
Stephens,U.S. House,Fred Gipson,DEM,690051,0,0,10,10,04
Stephens,Governor,Mick Cornett,REP,690052,0,5,25,30,
Stephens,Governor,Kevin Stitt,REP,690052,0,3,24,27,
Stephens,Lieutenant Governor,Dana Murphy,REP,690052,0,1,25,26,
Stephens,Lieutenant Governor,Matt Pinnell,REP,690052,0,7,24,31,
Stephens,State Auditor,Cindy Byrd,REP,690052,0,6,25,31,
Stephens,State Auditor,Charlie Prater,REP,690052,0,2,24,26,
Stephens,Attorney General,Mike Hunter,REP,690052,0,8,27,35,
Stephens,Attorney General,Gentner Drummond,REP,690052,0,0,19,19,
Stephens,Superintendent of Public Instruction,Joy Hofmeister,REP,690052,0,3,21,24,
Stephens,Superintendent of Public Instruction,Linda Murphy,REP,690052,0,5,27,32,
Stephens,Commissioner of Labor,Cathy Costello,REP,690052,0,2,21,23,
Stephens,Commissioner of Labor,Leslie Osborn,REP,690052,0,6,27,33,
Stephens,Corporation Commissioner,Bob Anthony,REP,690052,0,7,34,41,
Stephens,Corporation Commissioner,Brian Bingman,REP,690052,0,1,13,14,
Stephens,Governor,Chris Powell,LIB,690052,0,0,0,0,
Stephens,Governor,Rex Lawhorn,LIB,690052,0,0,0,0,
Stephens,Corporation Commissioner,Ashley Nicole Mccray,DEM,690052,1,1,1,3,
Stephens,Corporation Commissioner,Blake Cummings,DEM,690052,0,0,6,6,
Stephens,U.S. House,Mary Brannon,DEM,690052,0,0,4,4,04
Stephens,U.S. House,Fred Gipson,DEM,690052,1,1,3,5,04
Stephens,Governor,Mick Cornett,REP,690053,0,0,23,23,
Stephens,Governor,Kevin Stitt,REP,690053,1,3,23,27,
Stephens,Lieutenant Governor,Dana Murphy,REP,690053,0,2,21,23,
Stephens,Lieutenant Governor,Matt Pinnell,REP,690053,1,1,24,26,
Stephens,State Auditor,Cindy Byrd,REP,690053,0,0,24,24,
Stephens,State Auditor,Charlie Prater,REP,690053,1,2,19,22,
Stephens,Attorney General,Mike Hunter,REP,690053,0,1,23,24,
Stephens,Attorney General,Gentner Drummond,REP,690053,1,2,22,25,
Stephens,Superintendent of Public Instruction,Joy Hofmeister,REP,690053,0,0,22,22,
Stephens,Superintendent of Public Instruction,Linda Murphy,REP,690053,1,3,24,28,
Stephens,Commissioner of Labor,Cathy Costello,REP,690053,0,1,23,24,
Stephens,Commissioner of Labor,Leslie Osborn,REP,690053,1,2,19,22,
Stephens,Corporation Commissioner,Bob Anthony,REP,690053,1,2,30,33,
Stephens,Corporation Commissioner,Brian Bingman,REP,690053,0,1,15,16,
Stephens,Governor,Chris Powell,LIB,690053,0,0,0,0,
Stephens,Governor,Rex Lawhorn,LIB,690053,0,0,0,0,
Stephens,Corporation Commissioner,Ashley Nicole Mccray,DEM,690053,0,0,6,6,
Stephens,Corporation Commissioner,Blake Cummings,DEM,690053,0,0,4,4,
Stephens,U.S. House,Mary Brannon,DEM,690053,0,0,5,5,04
Stephens,U.S. House,Fred Gipson,DEM,690053,0,0,5,5,04
Stephens,Governor,Mick Cornett,REP,690054,5,0,19,24,
Stephens,Governor,Kevin Stitt,REP,690054,0,0,37,37,
Stephens,Lieutenant Governor,Dana Murphy,REP,690054,5,0,17,22,
Stephens,Lieutenant Governor,Matt Pinnell,REP,690054,0,0,39,39,
Stephens,State Auditor,Cindy Byrd,REP,690054,5,0,21,26,
Stephens,State Auditor,Charlie Prater,REP,690054,0,0,34,34,
Stephens,Attorney General,Mike Hunter,REP,690054,3,0,27,30,
Stephens,Attorney General,Gentner Drummond,REP,690054,2,0,29,31,
Stephens,Superintendent of Public Instruction,Joy Hofmeister,REP,690054,3,0,21,24,
Stephens,Superintendent of Public Instruction,Linda Murphy,REP,690054,2,0,33,35,
Stephens,Commissioner of Labor,Cathy Costello,REP,690054,2,0,34,36,
Stephens,Commissioner of Labor,Leslie Osborn,REP,690054,3,0,19,22,
Stephens,Corporation Commissioner,Bob Anthony,REP,690054,1,0,24,25,
Stephens,Corporation Commissioner,Brian Bingman,REP,690054,4,0,29,33,
Stephens,Governor,Chris Powell,LIB,690054,0,0,0,0,
Stephens,Governor,Rex Lawhorn,LIB,690054,0,0,0,0,
Stephens,Corporation Commissioner,Ashley Nicole Mccray,DEM,690054,0,0,6,6,
Stephens,Corporation Commissioner,Blake Cummings,DEM,690054,0,0,10,10,
Stephens,U.S. House,Mary Brannon,DEM,690054,0,0,4,4,04
Stephens,U.S. House,Fred Gipson,DEM,690054,0,0,12,12,04
Stephens,Governor,Mick Cornett,REP,690055,0,0,14,14,
Stephens,Governor,Kevin Stitt,REP,690055,0,0,33,33,
Stephens,Lieutenant Governor,Dana Murphy,REP,690055,0,0,19,19,
Stephens,Lieutenant Governor,Matt Pinnell,REP,690055,0,0,26,26,
Stephens,State Auditor,Cindy Byrd,REP,690055,0,0,19,19,
Stephens,State Auditor,Charlie Prater,REP,690055,0,0,28,28,
Stephens,Attorney General,Mike Hunter,REP,690055,0,0,19,19,
Stephens,Attorney General,Gentner Drummond,REP,690055,0,0,28,28,
Stephens,Superintendent of Public Instruction,Joy Hofmeister,REP,690055,0,0,29,29,
Stephens,Superintendent of Public Instruction,Linda Murphy,REP,690055,0,0,17,17,
Stephens,Commissioner of Labor,Cathy Costello,REP,690055,0,0,30,30,
Stephens,Commissioner of Labor,Leslie Osborn,REP,690055,0,0,16,16,
Stephens,Corporation Commissioner,Bob Anthony,REP,690055,0,0,19,19,
Stephens,Corporation Commissioner,Brian Bingman,REP,690055,0,0,26,26,
Stephens,Governor,Chris Powell,LIB,690055,0,0,0,0,
Stephens,Governor,Rex Lawhorn,LIB,690055,0,0,0,0,
Stephens,Corporation Commissioner,Ashley Nicole Mccray,DEM,690055,0,0,8,8,
Stephens,Corporation Commissioner,Blake Cummings,DEM,690055,0,0,17,17,
Stephens,U.S. House,Mary Brannon,DEM,690055,0,0,10,10,04
Stephens,U.S. House,Fred Gipson,DEM,690055,0,0,15,15,04
Stephens,Governor,Mick Cornett,REP,690056,0,0,20,20,
Stephens,Governor,Kevin Stitt,REP,690056,2,0,32,34,
Stephens,Lieutenant Governor,Dana Murphy,REP,690056,2,0,19,21,
Stephens,Lieutenant Governor,Matt Pinnell,REP,690056,0,0,33,33,
Stephens,State Auditor,Cindy Byrd,REP,690056,2,0,32,34,
Stephens,State Auditor,Charlie Prater,REP,690056,0,0,20,20,
Stephens,Attorney General,Mike Hunter,REP,690056,2,0,24,26,
Stephens,Attorney General,Gentner Drummond,REP,690056,0,0,29,29,
Stephens,Superintendent of Public Instruction,Joy Hofmeister,REP,690056,2,0,22,24,
Stephens,Superintendent of Public Instruction,Linda Murphy,REP,690056,0,0,30,30,
Stephens,Commissioner of Labor,Cathy Costello,REP,690056,2,0,24,26,
Stephens,Commissioner of Labor,Leslie Osborn,REP,690056,0,0,28,28,
Stephens,Corporation Commissioner,Bob Anthony,REP,690056,2,0,24,26,
Stephens,Corporation Commissioner,Brian Bingman,REP,690056,0,0,27,27,
Stephens,Governor,Chris Powell,LIB,690056,0,0,0,0,
Stephens,Governor,Rex Lawhorn,LIB,690056,0,0,0,0,
Stephens,Corporation Commissioner,Ashley Nicole Mccray,DEM,690056,0,2,10,12,
Stephens,Corporation Commissioner,Blake Cummings,DEM,690056,0,1,14,15,
Stephens,U.S. House,Mary Brannon,DEM,690056,0,3,10,13,04
Stephens,U.S. House,Fred Gipson,DEM,690056,0,0,14,14,04
Stephens,Governor,Mick Cornett,REP,690057,0,3,47,50,
Stephens,Governor,Kevin Stitt,REP,690057,1,6,67,74,
Stephens,Lieutenant Governor,Dana Murphy,REP,690057,0,3,54,57,
Stephens,Lieutenant Governor,Matt Pinnell,REP,690057,1,5,58,64,
Stephens,State Auditor,Cindy Byrd,REP,690057,1,5,62,68,
Stephens,State Auditor,Charlie Prater,REP,690057,0,3,47,50,
Stephens,Attorney General,Mike Hunter,REP,690057,0,4,62,66,
Stephens,Attorney General,Gentner Drummond,REP,690057,1,4,46,51,
Stephens,Superintendent of Public Instruction,Joy Hofmeister,REP,690057,0,5,52,57,
Stephens,Superintendent of Public Instruction,Linda Murphy,REP,690057,0,3,59,62,
Stephens,Commissioner of Labor,Cathy Costello,REP,690057,0,4,50,54,
Stephens,Commissioner of Labor,Leslie Osborn,REP,690057,0,4,60,64,
Stephens,Corporation Commissioner,Bob Anthony,REP,690057,0,4,46,50,
Stephens,Corporation Commissioner,Brian Bingman,REP,690057,1,4,64,69,
Stephens,Governor,Chris Powell,LIB,690057,0,0,0,0,
Stephens,Governor,Rex Lawhorn,LIB,690057,0,0,0,0,
Stephens,Corporation Commissioner,Ashley Nicole Mccray,DEM,690057,0,1,23,24,
Stephens,Corporation Commissioner,Blake Cummings,DEM,690057,1,0,19,20,
Stephens,U.S. House,Mary Brannon,DEM,690057,1,1,18,20,04
Stephens,U.S. House,Fred Gipson,DEM,690057,0,0,24,24,04
Stephens,Governor,Mick Cornett,REP,690058,0,0,20,20,
Stephens,Governor,Kevin Stitt,REP,690058,0,2,23,25,
Stephens,Lieutenant Governor,Dana Murphy,REP,690058,0,2,17,19,
Stephens,Lieutenant Governor,Matt Pinnell,REP,690058,0,0,25,25,
Stephens,State Auditor,Cindy Byrd,REP,690058,0,2,13,15,
Stephens,State Auditor,Charlie Prater,REP,690058,0,0,30,30,
Stephens,Attorney General,Mike Hunter,REP,690058,0,0,17,17,
Stephens,Attorney General,Gentner Drummond,REP,690058,0,2,26,28,
Stephens,Superintendent of Public Instruction,Joy Hofmeister,REP,690058,0,2,14,16,
Stephens,Superintendent of Public Instruction,Linda Murphy,REP,690058,0,0,29,29,
Stephens,Commissioner of Labor,Cathy Costello,REP,690058,0,2,13,15,
Stephens,Commissioner of Labor,Leslie Osborn,REP,690058,0,0,30,30,
Stephens,Corporation Commissioner,Bob Anthony,REP,690058,0,2,22,24,
Stephens,Corporation Commissioner,Brian Bingman,REP,690058,0,0,21,21,
Stephens,Governor,Chris Powell,LIB,690058,0,0,0,0,
Stephens,Governor,Rex Lawhorn,LIB,690058,0,0,0,0,
Stephens,Corporation Commissioner,Ashley Nicole Mccray,DEM,690058,0,0,11,11,
Stephens,Corporation Commissioner,Blake Cummings,DEM,690058,0,0,7,7,
Stephens,U.S. House,Mary Brannon,DEM,690058,0,0,17,17,04
Stephens,U.S. House,Fred Gipson,DEM,690058,0,0,2,2,04
Stephens,Governor,Mick Cornett,REP,690059,0,0,9,9,
Stephens,Governor,Kevin Stitt,REP,690059,1,1,20,22,
Stephens,Lieutenant Governor,Dana Murphy,REP,690059,0,0,13,13,
Stephens,Lieutenant Governor,Matt Pinnell,REP,690059,1,1,16,18,
Stephens,State Auditor,Cindy Byrd,REP,690059,0,0,9,9,
Stephens,State Auditor,Charlie Prater,REP,690059,1,1,20,22,
Stephens,Attorney General,Mike Hunter,REP,690059,1,1,10,12,
Stephens,Attorney General,Gentner Drummond,REP,690059,0,0,19,19,
Stephens,Superintendent of Public Instruction,Joy Hofmeister,REP,690059,1,1,14,16,
Stephens,Superintendent of Public Instruction,Linda Murphy,REP,690059,0,0,15,15,
Stephens,Commissioner of Labor,Cathy Costello,REP,690059,0,1,15,16,
Stephens,Commissioner of Labor,Leslie Osborn,REP,690059,1,0,14,15,
Stephens,Corporation Commissioner,Bob Anthony,REP,690059,0,1,15,16,
Stephens,Corporation Commissioner,Brian Bingman,REP,690059,1,0,14,15,
Stephens,Governor,Chris Powell,LIB,690059,0,0,0,0,
Stephens,Governor,Rex Lawhorn,LIB,690059,0,0,2,2,
Stephens,Corporation Commissioner,Ashley Nicole Mccray,DEM,690059,0,0,4,4,
Stephens,Corporation Commissioner,Blake Cummings,DEM,690059,0,0,7,7,
Stephens,U.S. House,Mary Brannon,DEM,690059,0,0,8,8,04
Stephens,U.S. House,Fred Gipson,DEM,690059,0,0,3,3,04
Stephens,Governor,Mick Cornett,REP,690060,0,2,1,3,
Stephens,Governor,Kevin Stitt,REP,690060,0,0,1,1,
Stephens,Lieutenant Governor,Dana Murphy,REP,690060,0,0,0,0,
Stephens,Lieutenant Governor,Matt Pinnell,REP,690060,0,2,2,4,
Stephens,State Auditor,Cindy Byrd,REP,690060,0,1,2,3,
Stephens,State Auditor,Charlie Prater,REP,690060,0,1,0,1,
Stephens,Attorney General,Mike Hunter,REP,690060,0,2,2,4,
Stephens,Attorney General,Gentner Drummond,REP,690060,0,0,0,0,
Stephens,Superintendent of Public Instruction,Joy Hofmeister,REP,690060,0,0,0,0,
Stephens,Superintendent of Public Instruction,Linda Murphy,REP,690060,0,2,2,4,
Stephens,Commissioner of Labor,Cathy Costello,REP,690060,0,1,2,3,
Stephens,Commissioner of Labor,Leslie Osborn,REP,690060,0,1,0,1,
Stephens,Corporation Commissioner,Bob Anthony,REP,690060,0,0,2,2,
Stephens,Corporation Commissioner,Brian Bingman,REP,690060,0,2,0,2,
Stephens,Governor,Chris Powell,LIB,690060,0,0,0,0,
Stephens,Governor,Rex Lawhorn,LIB,690060,0,0,0,0,
Stephens,Corporation Commissioner,Ashley Nicole Mccray,DEM,690060,0,0,0,0,
Stephens,Corporation Commissioner,Blake Cummings,DEM,690060,0,0,0,0,
Stephens,U.S. House,Mary Brannon,DEM,690060,0,0,0,0,04
Stephens,U.S. House,Fred Gipson,DEM,690060,0,0,0,0,04
Stephens,Governor,Mick Cornett,REP,690061,0,1,19,20,
Stephens,Governor,Kevin Stitt,REP,690061,0,2,54,56,
Stephens,Lieutenant Governor,Dana Murphy,REP,690061,0,2,24,26,
Stephens,Lieutenant Governor,Matt Pinnell,REP,690061,0,1,48,49,
Stephens,State Auditor,Cindy Byrd,REP,690061,0,1,39,40,
Stephens,State Auditor,Charlie Prater,REP,690061,0,2,33,35,
Stephens,Attorney General,Mike Hunter,REP,690061,0,0,32,32,
Stephens,Attorney General,Gentner Drummond,REP,690061,0,3,41,44,
Stephens,Superintendent of Public Instruction,Joy Hofmeister,REP,690061,0,3,39,42,
Stephens,Superintendent of Public Instruction,Linda Murphy,REP,690061,0,0,34,34,
Stephens,Commissioner of Labor,Cathy Costello,REP,690061,0,0,35,35,
Stephens,Commissioner of Labor,Leslie Osborn,REP,690061,0,2,38,40,
Stephens,Corporation Commissioner,Bob Anthony,REP,690061,0,1,34,35,
Stephens,Corporation Commissioner,Brian Bingman,REP,690061,0,2,38,40,
Stephens,Governor,Chris Powell,LIB,690061,0,0,0,0,
Stephens,Governor,Rex Lawhorn,LIB,690061,0,0,0,0,
Stephens,Corporation Commissioner,Ashley Nicole Mccray,DEM,690061,0,2,17,19,
Stephens,Corporation Commissioner,Blake Cummings,DEM,690061,0,1,11,12,
Stephens,U.S. House,Mary Brannon,DEM,690061,0,3,14,17,04
Stephens,U.S. House,Fred Gipson,DEM,690061,0,0,13,13,04
Stephens,Governor,Mick Cornett,REP,690062,0,1,22,23,
Stephens,Governor,Kevin Stitt,REP,690062,1,3,48,52,
Stephens,Lieutenant Governor,Dana Murphy,REP,690062,0,0,20,20,
Stephens,Lieutenant Governor,Matt Pinnell,REP,690062,1,4,50,55,
Stephens,State Auditor,Cindy Byrd,REP,690062,1,1,43,45,
Stephens,State Auditor,Charlie Prater,REP,690062,0,3,26,29,
Stephens,Attorney General,Mike Hunter,REP,690062,0,4,25,29,
Stephens,Attorney General,Gentner Drummond,REP,690062,1,0,45,46,
Stephens,Superintendent of Public Instruction,Joy Hofmeister,REP,690062,1,2,41,44,
Stephens,Superintendent of Public Instruction,Linda Murphy,REP,690062,0,2,28,30,
Stephens,Commissioner of Labor,Cathy Costello,REP,690062,0,3,30,33,
Stephens,Commissioner of Labor,Leslie Osborn,REP,690062,1,1,39,41,
Stephens,Corporation Commissioner,Bob Anthony,REP,690062,1,3,29,33,
Stephens,Corporation Commissioner,Brian Bingman,REP,690062,0,1,39,40,
Stephens,Governor,Chris Powell,LIB,690062,0,0,0,0,
Stephens,Governor,Rex Lawhorn,LIB,690062,0,0,0,0,
Stephens,Corporation Commissioner,Ashley Nicole Mccray,DEM,690062,1,0,15,16,
Stephens,Corporation Commissioner,Blake Cummings,DEM,690062,1,0,19,20,
Stephens,U.S. House,Mary Brannon,DEM,690062,1,0,18,19,04
Stephens,U.S. House,Fred Gipson,DEM,690062,1,0,16,17,04
Stephens,Governor,Mick Cornett,REP,690063,0,0,28,28,
Stephens,Governor,Kevin Stitt,REP,690063,2,1,52,55,
Stephens,Lieutenant Governor,Dana Murphy,REP,690063,2,0,23,25,
Stephens,Lieutenant Governor,Matt Pinnell,REP,690063,0,1,56,57,
Stephens,State Auditor,Cindy Byrd,REP,690063,0,1,46,47,
Stephens,State Auditor,Charlie Prater,REP,690063,2,0,34,36,
Stephens,Attorney General,Mike Hunter,REP,690063,1,1,43,45,
Stephens,Attorney General,Gentner Drummond,REP,690063,0,0,36,36,
Stephens,Superintendent of Public Instruction,Joy Hofmeister,REP,690063,0,0,42,42,
Stephens,Superintendent of Public Instruction,Linda Murphy,REP,690063,2,1,34,37,
Stephens,Commissioner of Labor,Cathy Costello,REP,690063,2,1,34,37,
Stephens,Commissioner of Labor,Leslie Osborn,REP,690063,0,0,44,44,
Stephens,Corporation Commissioner,Bob Anthony,REP,690063,2,1,47,50,
Stephens,Corporation Commissioner,Brian Bingman,REP,690063,0,0,31,31,
Stephens,Governor,Chris Powell,LIB,690063,0,0,2,2,
Stephens,Governor,Rex Lawhorn,LIB,690063,0,0,0,0,
Stephens,Corporation Commissioner,Ashley Nicole Mccray,DEM,690063,0,0,8,8,
Stephens,Corporation Commissioner,Blake Cummings,DEM,690063,0,0,6,6,
Stephens,U.S. House,Mary Brannon,DEM,690063,0,0,7,7,04
Stephens,U.S. House,Fred Gipson,DEM,690063,0,0,7,7,04
Texas,Governor,Mick Cornett,REP,700101,5,1,57,63,
Texas,Governor,Kevin Stitt,REP,700101,11,2,113,126,
Texas,Lieutenant Governor,Dana Murphy,REP,700101,7,1,79,87,
Texas,Lieutenant Governor,Matt Pinnell,REP,700101,9,2,87,98,
Texas,State Auditor,Cindy Byrd,REP,700101,12,3,85,100,
Texas,State Auditor,Charlie Prater,REP,700101,3,0,79,82,
Texas,Attorney General,Mike Hunter,REP,700101,7,3,82,92,
Texas,Attorney General,Gentner Drummond,REP,700101,9,0,87,96,
Texas,Superintendent of Public Instruction,Joy Hofmeister,REP,700101,4,2,72,78,
Texas,Superintendent of Public Instruction,Linda Murphy,REP,700101,12,1,93,106,
Texas,Commissioner of Labor,Cathy Costello,REP,700101,11,2,95,108,
Texas,Commissioner of Labor,Leslie Osborn,REP,700101,5,1,73,79,
Texas,Corporation Commissioner,Bob Anthony,REP,700101,14,3,100,117,
Texas,Corporation Commissioner,Brian Bingman,REP,700101,2,0,63,65,
Texas,State House,Kenton Patzkowsky,REP,700101,9,2,97,108,61
Texas,State House,Brad Raven,REP,700101,7,1,74,82,61
Texas,Governor,Chris Powell,LIB,700101,0,0,0,0,
Texas,Governor,Rex Lawhorn,LIB,700101,0,0,0,0,
Texas,Corporation Commissioner,Ashley Nicole Mccray,DEM,700101,0,0,6,6,
Texas,Corporation Commissioner,Blake Cummings,DEM,700101,0,0,6,6,
Texas,Governor,Mick Cornett,REP,700102,0,0,19,19,
Texas,Governor,Kevin Stitt,REP,700102,2,3,26,31,
Texas,Lieutenant Governor,Dana Murphy,REP,700102,0,2,26,28,
Texas,Lieutenant Governor,Matt Pinnell,REP,700102,2,1,19,22,
Texas,State Auditor,Cindy Byrd,REP,700102,1,0,22,23,
Texas,State Auditor,Charlie Prater,REP,700102,0,3,22,25,
Texas,Attorney General,Mike Hunter,REP,700102,1,0,22,23,
Texas,Attorney General,Gentner Drummond,REP,700102,0,3,23,26,
Texas,Superintendent of Public Instruction,Joy Hofmeister,REP,700102,0,3,14,17,
Texas,Superintendent of Public Instruction,Linda Murphy,REP,700102,1,0,31,32,
Texas,Commissioner of Labor,Cathy Costello,REP,700102,0,1,29,30,
Texas,Commissioner of Labor,Leslie Osborn,REP,700102,1,2,16,19,
Texas,Corporation Commissioner,Bob Anthony,REP,700102,1,3,19,23,
Texas,Corporation Commissioner,Brian Bingman,REP,700102,0,0,26,26,
Texas,State House,Kenton Patzkowsky,REP,700102,1,2,30,33,61
Texas,State House,Brad Raven,REP,700102,0,1,15,16,61
Texas,Governor,Chris Powell,LIB,700102,0,0,0,0,
Texas,Governor,Rex Lawhorn,LIB,700102,0,0,0,0,
Texas,Corporation Commissioner,Ashley Nicole Mccray,DEM,700102,0,0,0,0,
Texas,Corporation Commissioner,Blake Cummings,DEM,700102,0,1,2,3,
Texas,Governor,Mick Cornett,REP,700104,0,0,32,32,
Texas,Governor,Kevin Stitt,REP,700104,8,0,59,67,
Texas,Lieutenant Governor,Dana Murphy,REP,700104,4,0,43,47,
Texas,Lieutenant Governor,Matt Pinnell,REP,700104,3,0,47,50,
Texas,State Auditor,Cindy Byrd,REP,700104,4,0,34,38,
Texas,State Auditor,Charlie Prater,REP,700104,3,0,54,57,
Texas,Attorney General,Mike Hunter,REP,700104,3,0,39,42,
Texas,Attorney General,Gentner Drummond,REP,700104,5,0,52,57,
Texas,Superintendent of Public Instruction,Joy Hofmeister,REP,700104,0,0,34,34,
Texas,Superintendent of Public Instruction,Linda Murphy,REP,700104,8,0,56,64,
Texas,Commissioner of Labor,Cathy Costello,REP,700104,2,0,50,52,
Texas,Commissioner of Labor,Leslie Osborn,REP,700104,6,0,40,46,
Texas,Corporation Commissioner,Bob Anthony,REP,700104,4,0,49,53,
Texas,Corporation Commissioner,Brian Bingman,REP,700104,4,0,41,45,
Texas,State House,Kenton Patzkowsky,REP,700104,1,0,56,57,61
Texas,State House,Brad Raven,REP,700104,7,0,36,43,61
Texas,Governor,Chris Powell,LIB,700104,0,0,0,0,
Texas,Governor,Rex Lawhorn,LIB,700104,0,0,0,0,
Texas,Corporation Commissioner,Ashley Nicole Mccray,DEM,700104,0,0,4,4,
Texas,Corporation Commissioner,Blake Cummings,DEM,700104,0,0,12,12,
Texas,Governor,Mick Cornett,REP,700107,1,0,16,17,
Texas,Governor,Kevin Stitt,REP,700107,1,3,23,27,
Texas,Lieutenant Governor,Dana Murphy,REP,700107,1,1,25,27,
Texas,Lieutenant Governor,Matt Pinnell,REP,700107,1,2,13,16,
Texas,State Auditor,Cindy Byrd,REP,700107,0,1,30,31,
Texas,State Auditor,Charlie Prater,REP,700107,2,2,6,10,
Texas,Attorney General,Mike Hunter,REP,700107,2,2,21,25,
Texas,Attorney General,Gentner Drummond,REP,700107,0,1,18,19,
Texas,Superintendent of Public Instruction,Joy Hofmeister,REP,700107,1,1,14,16,
Texas,Superintendent of Public Instruction,Linda Murphy,REP,700107,1,2,26,29,
Texas,Commissioner of Labor,Cathy Costello,REP,700107,1,2,22,25,
Texas,Commissioner of Labor,Leslie Osborn,REP,700107,1,1,17,19,
Texas,Corporation Commissioner,Bob Anthony,REP,700107,0,2,17,19,
Texas,Corporation Commissioner,Brian Bingman,REP,700107,2,1,20,23,
Texas,State House,Kenton Patzkowsky,REP,700107,2,2,23,27,61
Texas,State House,Brad Raven,REP,700107,0,1,17,18,61
Texas,Governor,Chris Powell,LIB,700107,0,0,0,0,
Texas,Governor,Rex Lawhorn,LIB,700107,0,0,0,0,
Texas,Corporation Commissioner,Ashley Nicole Mccray,DEM,700107,0,0,10,10,
Texas,Corporation Commissioner,Blake Cummings,DEM,700107,0,0,2,2,
Texas,Governor,Mick Cornett,REP,700201,6,4,80,90,
Texas,Governor,Kevin Stitt,REP,700201,10,16,122,148,
Texas,Lieutenant Governor,Dana Murphy,REP,700201,6,11,97,114,
Texas,Lieutenant Governor,Matt Pinnell,REP,700201,9,9,104,122,
Texas,State Auditor,Cindy Byrd,REP,700201,10,9,119,138,
Texas,State Auditor,Charlie Prater,REP,700201,5,10,77,92,
Texas,Attorney General,Mike Hunter,REP,700201,10,10,99,119,
Texas,Attorney General,Gentner Drummond,REP,700201,5,10,97,112,
Texas,Superintendent of Public Instruction,Joy Hofmeister,REP,700201,6,8,86,100,
Texas,Superintendent of Public Instruction,Linda Murphy,REP,700201,10,11,113,134,
Texas,Commissioner of Labor,Cathy Costello,REP,700201,13,14,126,153,
Texas,Commissioner of Labor,Leslie Osborn,REP,700201,2,5,72,79,
Texas,Corporation Commissioner,Bob Anthony,REP,700201,8,15,106,129,
Texas,Corporation Commissioner,Brian Bingman,REP,700201,6,5,90,101,
Texas,State House,Kenton Patzkowsky,REP,700201,12,12,106,130,61
Texas,State House,Brad Raven,REP,700201,3,8,96,107,61
Texas,Governor,Chris Powell,LIB,700201,0,1,0,1,
Texas,Governor,Rex Lawhorn,LIB,700201,0,0,0,0,
Texas,Corporation Commissioner,Ashley Nicole Mccray,DEM,700201,0,2,11,13,
Texas,Corporation Commissioner,Blake Cummings,DEM,700201,1,0,5,6,
Texas,Governor,Mick Cornett,REP,700202,1,5,17,23,
Texas,Governor,Kevin Stitt,REP,700202,1,9,40,50,
Texas,Lieutenant Governor,Dana Murphy,REP,700202,2,9,29,40,
Texas,Lieutenant Governor,Matt Pinnell,REP,700202,0,5,27,32,
Texas,State Auditor,Cindy Byrd,REP,700202,1,9,25,35,
Texas,State Auditor,Charlie Prater,REP,700202,1,5,29,35,
Texas,Attorney General,Mike Hunter,REP,700202,1,5,31,37,
Texas,Attorney General,Gentner Drummond,REP,700202,1,9,25,35,
Texas,Superintendent of Public Instruction,Joy Hofmeister,REP,700202,1,8,18,27,
Texas,Superintendent of Public Instruction,Linda Murphy,REP,700202,1,5,38,44,
Texas,Commissioner of Labor,Cathy Costello,REP,700202,2,8,35,45,
Texas,Commissioner of Labor,Leslie Osborn,REP,700202,0,6,21,27,
Texas,Corporation Commissioner,Bob Anthony,REP,700202,2,9,24,35,
Texas,Corporation Commissioner,Brian Bingman,REP,700202,0,5,32,37,
Texas,State House,Kenton Patzkowsky,REP,700202,2,2,32,36,61
Texas,State House,Brad Raven,REP,700202,0,12,26,38,61
Texas,Governor,Chris Powell,LIB,700202,0,0,1,1,
Texas,Governor,Rex Lawhorn,LIB,700202,0,0,0,0,
Texas,Corporation Commissioner,Ashley Nicole Mccray,DEM,700202,2,1,0,3,
Texas,Corporation Commissioner,Blake Cummings,DEM,700202,0,0,4,4,
Texas,Governor,Mick Cornett,REP,700205,4,10,74,88,
Texas,Governor,Kevin Stitt,REP,700205,5,19,112,136,
Texas,Lieutenant Governor,Dana Murphy,REP,700205,5,12,80,97,
Texas,Lieutenant Governor,Matt Pinnell,REP,700205,4,17,101,122,
Texas,State Auditor,Cindy Byrd,REP,700205,6,12,94,112,
Texas,State Auditor,Charlie Prater,REP,700205,3,16,79,98,
Texas,Attorney General,Mike Hunter,REP,700205,8,12,89,109,
Texas,Attorney General,Gentner Drummond,REP,700205,1,16,93,110,
Texas,Superintendent of Public Instruction,Joy Hofmeister,REP,700205,3,17,90,110,
Texas,Superintendent of Public Instruction,Linda Murphy,REP,700205,6,12,90,108,
Texas,Commissioner of Labor,Cathy Costello,REP,700205,7,15,104,126,
Texas,Commissioner of Labor,Leslie Osborn,REP,700205,2,14,81,97,
Texas,Corporation Commissioner,Bob Anthony,REP,700205,6,20,90,116,
Texas,Corporation Commissioner,Brian Bingman,REP,700205,3,9,91,103,
Texas,State House,Kenton Patzkowsky,REP,700205,5,17,106,128,61
Texas,State House,Brad Raven,REP,700205,4,12,82,98,61
Texas,Governor,Chris Powell,LIB,700205,0,0,0,0,
Texas,Governor,Rex Lawhorn,LIB,700205,0,0,0,0,
Texas,Corporation Commissioner,Ashley Nicole Mccray,DEM,700205,1,2,13,16,
Texas,Corporation Commissioner,Blake Cummings,DEM,700205,1,2,7,10,
Texas,Governor,Mick Cornett,REP,700302,1,0,13,14,
Texas,Governor,Kevin Stitt,REP,700302,2,7,13,22,
Texas,Lieutenant Governor,Dana Murphy,REP,700302,2,5,11,18,
Texas,Lieutenant Governor,Matt Pinnell,REP,700302,1,2,14,17,
Texas,State Auditor,Cindy Byrd,REP,700302,3,6,12,21,
Texas,State Auditor,Charlie Prater,REP,700302,0,1,11,12,
Texas,Attorney General,Mike Hunter,REP,700302,2,3,15,20,
Texas,Attorney General,Gentner Drummond,REP,700302,1,4,8,13,
Texas,Superintendent of Public Instruction,Joy Hofmeister,REP,700302,0,6,9,15,
Texas,Superintendent of Public Instruction,Linda Murphy,REP,700302,3,1,15,19,
Texas,Commissioner of Labor,Cathy Costello,REP,700302,3,3,10,16,
Texas,Commissioner of Labor,Leslie Osborn,REP,700302,0,4,13,17,
Texas,Corporation Commissioner,Bob Anthony,REP,700302,3,4,9,16,
Texas,Corporation Commissioner,Brian Bingman,REP,700302,0,3,14,17,
Texas,State House,Kenton Patzkowsky,REP,700302,1,6,10,17,61
Texas,State House,Brad Raven,REP,700302,2,1,15,18,61
Texas,Governor,Chris Powell,LIB,700302,0,0,0,0,
Texas,Governor,Rex Lawhorn,LIB,700302,0,0,0,0,
Texas,Corporation Commissioner,Ashley Nicole Mccray,DEM,700302,0,0,3,3,
Texas,Corporation Commissioner,Blake Cummings,DEM,700302,0,0,1,1,
Texas,Governor,Mick Cornett,REP,700303,2,0,24,26,
Texas,Governor,Kevin Stitt,REP,700303,6,0,58,64,
Texas,Lieutenant Governor,Dana Murphy,REP,700303,6,0,33,39,
Texas,Lieutenant Governor,Matt Pinnell,REP,700303,2,0,49,51,
Texas,State Auditor,Cindy Byrd,REP,700303,5,0,30,35,
Texas,State Auditor,Charlie Prater,REP,700303,3,0,52,55,
Texas,Attorney General,Mike Hunter,REP,700303,7,0,36,43,
Texas,Attorney General,Gentner Drummond,REP,700303,1,0,46,47,
Texas,Superintendent of Public Instruction,Joy Hofmeister,REP,700303,2,0,29,31,
Texas,Superintendent of Public Instruction,Linda Murphy,REP,700303,6,0,51,57,
Texas,Commissioner of Labor,Cathy Costello,REP,700303,6,0,39,45,
Texas,Commissioner of Labor,Leslie Osborn,REP,700303,2,0,40,42,
Texas,Corporation Commissioner,Bob Anthony,REP,700303,5,0,46,51,
Texas,Corporation Commissioner,Brian Bingman,REP,700303,3,0,32,35,
Texas,State House,Kenton Patzkowsky,REP,700303,2,0,55,57,61
Texas,State House,Brad Raven,REP,700303,6,0,28,34,61
Texas,Governor,Chris Powell,LIB,700303,0,0,1,1,
Texas,Governor,Rex Lawhorn,LIB,700303,0,0,0,0,
Texas,Corporation Commissioner,Ashley Nicole Mccray,DEM,700303,0,0,10,10,
Texas,Corporation Commissioner,Blake Cummings,DEM,700303,0,0,3,3,
Texas,Governor,Mick Cornett,REP,700304,0,1,26,27,
Texas,Governor,Kevin Stitt,REP,700304,5,2,38,45,
Texas,Lieutenant Governor,Dana Murphy,REP,700304,0,3,31,34,
Texas,Lieutenant Governor,Matt Pinnell,REP,700304,5,0,33,38,
Texas,State Auditor,Cindy Byrd,REP,700304,0,2,31,33,
Texas,State Auditor,Charlie Prater,REP,700304,2,1,32,35,
Texas,Attorney General,Mike Hunter,REP,700304,0,3,33,36,
Texas,Attorney General,Gentner Drummond,REP,700304,5,0,29,34,
Texas,Superintendent of Public Instruction,Joy Hofmeister,REP,700304,0,0,28,28,
Texas,Superintendent of Public Instruction,Linda Murphy,REP,700304,2,3,36,41,
Texas,Commissioner of Labor,Cathy Costello,REP,700304,0,1,34,35,
Texas,Commissioner of Labor,Leslie Osborn,REP,700304,2,2,30,34,
Texas,Corporation Commissioner,Bob Anthony,REP,700304,2,2,28,32,
Texas,Corporation Commissioner,Brian Bingman,REP,700304,0,1,34,35,
Texas,State House,Kenton Patzkowsky,REP,700304,2,1,38,41,61
Texas,State House,Brad Raven,REP,700304,1,2,26,29,61
Texas,Governor,Chris Powell,LIB,700304,0,0,0,0,
Texas,Governor,Rex Lawhorn,LIB,700304,0,0,0,0,
Texas,Corporation Commissioner,Ashley Nicole Mccray,DEM,700304,0,0,10,10,
Texas,Corporation Commissioner,Blake Cummings,DEM,700304,0,0,10,10,
Texas,Governor,Mick Cornett,REP,700305,1,7,71,79,
Texas,Governor,Kevin Stitt,REP,700305,3,12,124,139,
Texas,Lieutenant Governor,Dana Murphy,REP,700305,0,12,103,115,
Texas,Lieutenant Governor,Matt Pinnell,REP,700305,3,7,92,102,
Texas,State Auditor,Cindy Byrd,REP,700305,2,5,117,124,
Texas,State Auditor,Charlie Prater,REP,700305,2,13,74,89,
Texas,Attorney General,Mike Hunter,REP,700305,2,14,91,107,
Texas,Attorney General,Gentner Drummond,REP,700305,2,5,102,109,
Texas,Superintendent of Public Instruction,Joy Hofmeister,REP,700305,2,6,86,94,
Texas,Superintendent of Public Instruction,Linda Murphy,REP,700305,2,13,109,124,
Texas,Commissioner of Labor,Cathy Costello,REP,700305,4,13,112,129,
Texas,Commissioner of Labor,Leslie Osborn,REP,700305,0,6,82,88,
Texas,Corporation Commissioner,Bob Anthony,REP,700305,1,13,95,109,
Texas,Corporation Commissioner,Brian Bingman,REP,700305,3,5,96,104,
Texas,State House,Kenton Patzkowsky,REP,700305,5,12,120,137,61
Texas,State House,Brad Raven,REP,700305,0,7,76,83,61
Texas,Governor,Chris Powell,LIB,700305,0,0,0,0,
Texas,Governor,Rex Lawhorn,LIB,700305,0,0,0,0,
Texas,Corporation Commissioner,Ashley Nicole Mccray,DEM,700305,0,0,26,26,
Texas,Corporation Commissioner,Blake Cummings,DEM,700305,0,0,5,5,
Tillman,Governor,Mick Cornett,REP,710001,2,4,61,67,
Tillman,Governor,Kevin Stitt,REP,710001,0,22,86,108,
Tillman,Lieutenant Governor,Dana Murphy,REP,710001,1,6,50,57,
Tillman,Lieutenant Governor,Matt Pinnell,REP,710001,1,20,96,117,
Tillman,State Auditor,Cindy Byrd,REP,710001,2,7,65,74,
Tillman,State Auditor,Charlie Prater,REP,710001,0,19,78,97,
Tillman,Attorney General,Mike Hunter,REP,710001,2,10,55,67,
Tillman,Attorney General,Gentner Drummond,REP,710001,0,15,89,104,
Tillman,Superintendent of Public Instruction,Joy Hofmeister,REP,710001,2,13,88,103,
Tillman,Superintendent of Public Instruction,Linda Murphy,REP,710001,0,12,61,73,
Tillman,Commissioner of Labor,Cathy Costello,REP,710001,2,15,48,65,
Tillman,Commissioner of Labor,Leslie Osborn,REP,710001,0,11,95,106,
Tillman,Corporation Commissioner,Bob Anthony,REP,710001,1,10,62,73,
Tillman,Corporation Commissioner,Brian Bingman,REP,710001,1,15,82,98,
Tillman,State House,Jeff Coody,REP,710001,0,7,45,52,63
Tillman,State House,Trey Caldwell,REP,710001,3,19,104,126,63
Tillman,Governor,Chris Powell,LIB,710001,0,0,0,0,
Tillman,Governor,Rex Lawhorn,LIB,710001,0,0,0,0,
Tillman,Corporation Commissioner,Ashley Nicole Mccray,DEM,710001,5,2,23,30,
Tillman,Corporation Commissioner,Blake Cummings,DEM,710001,2,2,22,26,
Tillman,U.S. House,Mary Brannon,DEM,710001,4,1,22,27,04
Tillman,U.S. House,Fred Gipson,DEM,710001,3,3,22,28,04
Tillman,Governor,Mick Cornett,REP,710002,0,2,23,25,
Tillman,Governor,Kevin Stitt,REP,710002,1,6,28,35,
Tillman,Lieutenant Governor,Dana Murphy,REP,710002,1,3,16,20,
Tillman,Lieutenant Governor,Matt Pinnell,REP,710002,0,5,35,40,
Tillman,State Auditor,Cindy Byrd,REP,710002,0,3,30,33,
Tillman,State Auditor,Charlie Prater,REP,710002,1,5,21,27,
Tillman,Attorney General,Mike Hunter,REP,710002,0,5,31,36,
Tillman,Attorney General,Gentner Drummond,REP,710002,1,3,20,24,
Tillman,Superintendent of Public Instruction,Joy Hofmeister,REP,710002,0,5,26,31,
Tillman,Superintendent of Public Instruction,Linda Murphy,REP,710002,1,3,24,28,
Tillman,Commissioner of Labor,Cathy Costello,REP,710002,1,6,11,18,
Tillman,Commissioner of Labor,Leslie Osborn,REP,710002,0,2,39,41,
Tillman,Corporation Commissioner,Bob Anthony,REP,710002,1,4,25,30,
Tillman,Corporation Commissioner,Brian Bingman,REP,710002,0,4,26,30,
Tillman,State House,Jeff Coody,REP,710002,0,2,17,19,63
Tillman,State House,Trey Caldwell,REP,710002,1,6,34,41,63
Tillman,Governor,Chris Powell,LIB,710002,0,0,0,0,
Tillman,Governor,Rex Lawhorn,LIB,710002,0,0,0,0,
Tillman,Corporation Commissioner,Ashley Nicole Mccray,DEM,710002,0,1,12,13,
Tillman,Corporation Commissioner,Blake Cummings,DEM,710002,1,0,11,12,
Tillman,U.S. House,Mary Brannon,DEM,710002,1,0,15,16,04
Tillman,U.S. House,Fred Gipson,DEM,710002,0,1,8,9,04
Tillman,Governor,Mick Cornett,REP,710003,0,0,6,6,
Tillman,Governor,Kevin Stitt,REP,710003,0,3,17,20,
Tillman,Lieutenant Governor,Dana Murphy,REP,710003,0,1,7,8,
Tillman,Lieutenant Governor,Matt Pinnell,REP,710003,0,2,16,18,
Tillman,State Auditor,Cindy Byrd,REP,710003,0,2,11,13,
Tillman,State Auditor,Charlie Prater,REP,710003,0,1,12,13,
Tillman,Attorney General,Mike Hunter,REP,710003,0,2,11,13,
Tillman,Attorney General,Gentner Drummond,REP,710003,0,1,12,13,
Tillman,Superintendent of Public Instruction,Joy Hofmeister,REP,710003,0,2,15,17,
Tillman,Superintendent of Public Instruction,Linda Murphy,REP,710003,0,1,8,9,
Tillman,Commissioner of Labor,Cathy Costello,REP,710003,0,0,7,7,
Tillman,Commissioner of Labor,Leslie Osborn,REP,710003,0,3,16,19,
Tillman,Corporation Commissioner,Bob Anthony,REP,710003,0,3,13,16,
Tillman,Corporation Commissioner,Brian Bingman,REP,710003,0,0,10,10,
Tillman,State House,Jeff Coody,REP,710003,0,1,8,9,63
Tillman,State House,Trey Caldwell,REP,710003,0,2,15,17,63
Tillman,Governor,Chris Powell,LIB,710003,0,0,0,0,
Tillman,Governor,Rex Lawhorn,LIB,710003,0,0,0,0,
Tillman,Corporation Commissioner,Ashley Nicole Mccray,DEM,710003,0,1,6,7,
Tillman,Corporation Commissioner,Blake Cummings,DEM,710003,0,0,6,6,
Tillman,U.S. House,Mary Brannon,DEM,710003,0,1,3,4,04
Tillman,U.S. House,Fred Gipson,DEM,710003,0,0,9,9,04
Tillman,Governor,Mick Cornett,REP,710004,0,4,13,17,
Tillman,Governor,Kevin Stitt,REP,710004,0,5,15,20,
Tillman,Lieutenant Governor,Dana Murphy,REP,710004,0,7,7,14,
Tillman,Lieutenant Governor,Matt Pinnell,REP,710004,0,2,21,23,
Tillman,State Auditor,Cindy Byrd,REP,710004,0,5,7,12,
Tillman,State Auditor,Charlie Prater,REP,710004,0,4,21,25,
Tillman,Attorney General,Mike Hunter,REP,710004,0,3,12,15,
Tillman,Attorney General,Gentner Drummond,REP,710004,0,6,16,22,
Tillman,Superintendent of Public Instruction,Joy Hofmeister,REP,710004,0,7,17,24,
Tillman,Superintendent of Public Instruction,Linda Murphy,REP,710004,0,2,10,12,
Tillman,Commissioner of Labor,Cathy Costello,REP,710004,0,2,13,15,
Tillman,Commissioner of Labor,Leslie Osborn,REP,710004,0,7,15,22,
Tillman,Corporation Commissioner,Bob Anthony,REP,710004,0,5,18,23,
Tillman,Corporation Commissioner,Brian Bingman,REP,710004,0,4,9,13,
Tillman,State House,Jeff Coody,REP,710004,0,4,9,13,63
Tillman,State House,Trey Caldwell,REP,710004,0,5,19,24,63
Tillman,Governor,Chris Powell,LIB,710004,0,0,0,0,
Tillman,Governor,Rex Lawhorn,LIB,710004,0,0,0,0,
Tillman,Corporation Commissioner,Ashley Nicole Mccray,DEM,710004,0,0,6,6,
Tillman,Corporation Commissioner,Blake Cummings,DEM,710004,0,0,9,9,
Tillman,U.S. House,Mary Brannon,DEM,710004,0,0,8,8,04
Tillman,U.S. House,Fred Gipson,DEM,710004,0,0,7,7,04
Tillman,Governor,Mick Cornett,REP,710006,2,1,8,11,
Tillman,Governor,Kevin Stitt,REP,710006,3,0,38,41,
Tillman,Lieutenant Governor,Dana Murphy,REP,710006,4,1,21,26,
Tillman,Lieutenant Governor,Matt Pinnell,REP,710006,1,0,24,25,
Tillman,State Auditor,Cindy Byrd,REP,710006,5,0,26,31,
Tillman,State Auditor,Charlie Prater,REP,710006,0,1,18,19,
Tillman,Attorney General,Mike Hunter,REP,710006,2,0,24,26,
Tillman,Attorney General,Gentner Drummond,REP,710006,3,1,21,25,
Tillman,Superintendent of Public Instruction,Joy Hofmeister,REP,710006,4,1,26,31,
Tillman,Superintendent of Public Instruction,Linda Murphy,REP,710006,1,0,19,20,
Tillman,Commissioner of Labor,Cathy Costello,REP,710006,2,1,15,18,
Tillman,Commissioner of Labor,Leslie Osborn,REP,710006,2,0,28,30,
Tillman,Corporation Commissioner,Bob Anthony,REP,710006,3,1,23,27,
Tillman,Corporation Commissioner,Brian Bingman,REP,710006,2,0,20,22,
Tillman,State House,Jeff Coody,REP,710006,1,0,27,28,63
Tillman,State House,Trey Caldwell,REP,710006,4,1,19,24,63
Tillman,Governor,Chris Powell,LIB,710006,0,0,1,1,
Tillman,Governor,Rex Lawhorn,LIB,710006,0,0,0,0,
Tillman,Corporation Commissioner,Ashley Nicole Mccray,DEM,710006,0,0,10,10,
Tillman,Corporation Commissioner,Blake Cummings,DEM,710006,0,0,5,5,
Tillman,U.S. House,Mary Brannon,DEM,710006,0,0,5,5,04
Tillman,U.S. House,Fred Gipson,DEM,710006,0,0,10,10,04
Tillman,Governor,Mick Cornett,REP,710007,0,0,37,37,
Tillman,Governor,Kevin Stitt,REP,710007,0,0,61,61,
Tillman,Lieutenant Governor,Dana Murphy,REP,710007,0,0,40,40,
Tillman,Lieutenant Governor,Matt Pinnell,REP,710007,0,0,57,57,
Tillman,State Auditor,Cindy Byrd,REP,710007,0,0,38,38,
Tillman,State Auditor,Charlie Prater,REP,710007,0,0,56,56,
Tillman,Attorney General,Mike Hunter,REP,710007,0,0,46,46,
Tillman,Attorney General,Gentner Drummond,REP,710007,0,0,50,50,
Tillman,Superintendent of Public Instruction,Joy Hofmeister,REP,710007,0,0,40,40,
Tillman,Superintendent of Public Instruction,Linda Murphy,REP,710007,0,0,56,56,
Tillman,Commissioner of Labor,Cathy Costello,REP,710007,0,0,43,43,
Tillman,Commissioner of Labor,Leslie Osborn,REP,710007,0,0,51,51,
Tillman,Corporation Commissioner,Bob Anthony,REP,710007,0,0,45,45,
Tillman,Corporation Commissioner,Brian Bingman,REP,710007,0,0,46,46,
Tillman,State House,Jeff Coody,REP,710007,0,0,79,79,63
Tillman,State House,Trey Caldwell,REP,710007,0,0,23,23,63
Tillman,Governor,Chris Powell,LIB,710007,0,0,0,0,
Tillman,Governor,Rex Lawhorn,LIB,710007,0,0,0,0,
Tillman,Corporation Commissioner,Ashley Nicole Mccray,DEM,710007,0,0,25,25,
Tillman,Corporation Commissioner,Blake Cummings,DEM,710007,0,0,20,20,
Tillman,U.S. House,Mary Brannon,DEM,710007,0,0,22,22,04
Tillman,U.S. House,Fred Gipson,DEM,710007,0,0,23,23,04
Tillman,Governor,Mick Cornett,REP,710009,0,1,13,14,
Tillman,Governor,Kevin Stitt,REP,710009,2,1,19,22,
Tillman,Lieutenant Governor,Dana Murphy,REP,710009,0,1,13,14,
Tillman,Lieutenant Governor,Matt Pinnell,REP,710009,2,1,20,23,
Tillman,State Auditor,Cindy Byrd,REP,710009,0,1,14,15,
Tillman,State Auditor,Charlie Prater,REP,710009,0,1,19,20,
Tillman,Attorney General,Mike Hunter,REP,710009,0,1,15,16,
Tillman,Attorney General,Gentner Drummond,REP,710009,0,1,18,19,
Tillman,Superintendent of Public Instruction,Joy Hofmeister,REP,710009,2,0,18,20,
Tillman,Superintendent of Public Instruction,Linda Murphy,REP,710009,0,2,15,17,
Tillman,Commissioner of Labor,Cathy Costello,REP,710009,0,0,7,7,
Tillman,Commissioner of Labor,Leslie Osborn,REP,710009,0,2,25,27,
Tillman,Corporation Commissioner,Bob Anthony,REP,710009,2,2,19,23,
Tillman,Corporation Commissioner,Brian Bingman,REP,710009,0,0,13,13,
Tillman,State House,Jeff Coody,REP,710009,2,2,20,24,63
Tillman,State House,Trey Caldwell,REP,710009,0,0,15,15,63
Tillman,Governor,Chris Powell,LIB,710009,0,0,0,0,
Tillman,Governor,Rex Lawhorn,LIB,710009,0,0,0,0,
Tillman,Corporation Commissioner,Ashley Nicole Mccray,DEM,710009,1,1,20,22,
Tillman,Corporation Commissioner,Blake Cummings,DEM,710009,1,0,6,7,
Tillman,U.S. House,Mary Brannon,DEM,710009,0,0,17,17,04
Tillman,U.S. House,Fred Gipson,DEM,710009,2,1,9,12,04
Tillman,Governor,Mick Cornett,REP,710010,3,0,52,55,
Tillman,Governor,Kevin Stitt,REP,710010,0,3,37,40,
Tillman,Lieutenant Governor,Dana Murphy,REP,710010,0,0,44,44,
Tillman,Lieutenant Governor,Matt Pinnell,REP,710010,3,3,42,48,
Tillman,State Auditor,Cindy Byrd,REP,710010,0,1,45,46,
Tillman,State Auditor,Charlie Prater,REP,710010,1,2,39,42,
Tillman,Attorney General,Mike Hunter,REP,710010,2,0,43,45,
Tillman,Attorney General,Gentner Drummond,REP,710010,1,3,43,47,
Tillman,Superintendent of Public Instruction,Joy Hofmeister,REP,710010,0,3,49,52,
Tillman,Superintendent of Public Instruction,Linda Murphy,REP,710010,1,0,39,40,
Tillman,Commissioner of Labor,Cathy Costello,REP,710010,2,0,37,39,
Tillman,Commissioner of Labor,Leslie Osborn,REP,710010,0,3,49,52,
Tillman,Corporation Commissioner,Bob Anthony,REP,710010,2,3,41,46,
Tillman,Corporation Commissioner,Brian Bingman,REP,710010,1,0,44,45,
Tillman,State House,Jeff Coody,REP,710010,1,2,27,30,63
Tillman,State House,Trey Caldwell,REP,710010,2,1,62,65,63
Tillman,Governor,Chris Powell,LIB,710010,0,0,0,0,
Tillman,Governor,Rex Lawhorn,LIB,710010,0,0,0,0,
Tillman,Corporation Commissioner,Ashley Nicole Mccray,DEM,710010,1,1,23,25,
Tillman,Corporation Commissioner,Blake Cummings,DEM,710010,1,1,28,30,
Tillman,U.S. House,Mary Brannon,DEM,710010,1,2,21,24,04
Tillman,U.S. House,Fred Gipson,DEM,710010,1,0,30,31,04
Tillman,Governor,Mick Cornett,REP,710012,0,0,7,7,
Tillman,Governor,Kevin Stitt,REP,710012,0,1,10,11,
Tillman,Lieutenant Governor,Dana Murphy,REP,710012,0,1,3,4,
Tillman,Lieutenant Governor,Matt Pinnell,REP,710012,0,0,13,13,
Tillman,State Auditor,Cindy Byrd,REP,710012,0,0,5,5,
Tillman,State Auditor,Charlie Prater,REP,710012,0,0,10,10,
Tillman,Attorney General,Mike Hunter,REP,710012,0,0,11,11,
Tillman,Attorney General,Gentner Drummond,REP,710012,0,1,6,7,
Tillman,Superintendent of Public Instruction,Joy Hofmeister,REP,710012,0,0,10,10,
Tillman,Superintendent of Public Instruction,Linda Murphy,REP,710012,0,1,7,8,
Tillman,Commissioner of Labor,Cathy Costello,REP,710012,0,0,5,5,
Tillman,Commissioner of Labor,Leslie Osborn,REP,710012,0,1,12,13,
Tillman,Corporation Commissioner,Bob Anthony,REP,710012,0,1,9,10,
Tillman,Corporation Commissioner,Brian Bingman,REP,710012,0,0,8,8,
Tillman,State House,Jeff Coody,REP,710012,0,1,4,5,63
Tillman,State House,Trey Caldwell,REP,710012,0,0,12,12,63
Tillman,Governor,Chris Powell,LIB,710012,0,0,0,0,
Tillman,Governor,Rex Lawhorn,LIB,710012,0,0,0,0,
Tillman,Corporation Commissioner,Ashley Nicole Mccray,DEM,710012,1,1,5,7,
Tillman,Corporation Commissioner,Blake Cummings,DEM,710012,0,0,8,8,
Tillman,U.S. House,Mary Brannon,DEM,710012,1,0,6,7,04
Tillman,U.S. House,Fred Gipson,DEM,710012,0,1,7,8,04
Tulsa,Governor,Mick Cornett,REP,720001,0,0,2,2,
Tulsa,Governor,Kevin Stitt,REP,720001,0,0,5,5,
Tulsa,Lieutenant Governor,Dana Murphy,REP,720001,0,0,3,3,
Tulsa,Lieutenant Governor,Matt Pinnell,REP,720001,0,0,4,4,
Tulsa,State Auditor,Cindy Byrd,REP,720001,0,0,3,3,
Tulsa,State Auditor,Charlie Prater,REP,720001,0,0,3,3,
Tulsa,Attorney General,Mike Hunter,REP,720001,0,0,1,1,
Tulsa,Attorney General,Gentner Drummond,REP,720001,0,0,5,5,
Tulsa,Superintendent of Public Instruction,Joy Hofmeister,REP,720001,0,0,4,4,
Tulsa,Superintendent of Public Instruction,Linda Murphy,REP,720001,0,0,3,3,
Tulsa,Commissioner of Labor,Cathy Costello,REP,720001,0,0,5,5,
Tulsa,Commissioner of Labor,Leslie Osborn,REP,720001,0,0,2,2,
Tulsa,Corporation Commissioner,Bob Anthony,REP,720001,0,0,5,5,
Tulsa,Corporation Commissioner,Brian Bingman,REP,720001,0,0,2,2,
Tulsa,U.S. House,Tim Harris,REP,720001,0,0,2,2,01
Tulsa,U.S. House,Kevin Hern,REP,720001,0,0,5,5,01
Tulsa,Governor,Chris Powell,LIB,720001,0,0,0,0,
Tulsa,Governor,Rex Lawhorn,LIB,720001,0,0,0,0,
Tulsa,Corporation Commissioner,Ashley Nicole Mccray,DEM,720001,0,0,160,160,
Tulsa,Corporation Commissioner,Blake Cummings,DEM,720001,0,0,75,75,
Tulsa,U.S. House,Tim Gilpin,DEM,720001,0,0,142,142,01
Tulsa,U.S. House,Amanda Douglas,DEM,720001,0,0,93,93,01
Tulsa,Governor,Mick Cornett,REP,720002,0,0,6,6,
Tulsa,Governor,Kevin Stitt,REP,720002,0,0,15,15,
Tulsa,Lieutenant Governor,Dana Murphy,REP,720002,0,0,14,14,
Tulsa,Lieutenant Governor,Matt Pinnell,REP,720002,0,0,7,7,
Tulsa,State Auditor,Cindy Byrd,REP,720002,0,0,10,10,
Tulsa,State Auditor,Charlie Prater,REP,720002,0,0,9,9,
Tulsa,Attorney General,Mike Hunter,REP,720002,0,0,8,8,
Tulsa,Attorney General,Gentner Drummond,REP,720002,0,0,13,13,
Tulsa,Superintendent of Public Instruction,Joy Hofmeister,REP,720002,0,0,9,9,
Tulsa,Superintendent of Public Instruction,Linda Murphy,REP,720002,0,0,11,11,
Tulsa,Commissioner of Labor,Cathy Costello,REP,720002,0,0,8,8,
Tulsa,Commissioner of Labor,Leslie Osborn,REP,720002,0,0,12,12,
Tulsa,Corporation Commissioner,Bob Anthony,REP,720002,0,0,8,8,
Tulsa,Corporation Commissioner,Brian Bingman,REP,720002,0,0,11,11,
Tulsa,U.S. House,Tim Harris,REP,720002,0,0,4,4,01
Tulsa,U.S. House,Kevin Hern,REP,720002,0,0,17,17,01
Tulsa,Governor,Chris Powell,LIB,720002,0,0,0,0,
Tulsa,Governor,Rex Lawhorn,LIB,720002,0,0,0,0,
Tulsa,Corporation Commissioner,Ashley Nicole Mccray,DEM,720002,0,0,100,100,
Tulsa,Corporation Commissioner,Blake Cummings,DEM,720002,0,0,52,52,
Tulsa,U.S. House,Tim Gilpin,DEM,720002,0,0,74,74,01
Tulsa,U.S. House,Amanda Douglas,DEM,720002,0,0,78,78,01
Tulsa,Governor,Mick Cornett,REP,720003,0,0,10,10,
Tulsa,Governor,Kevin Stitt,REP,720003,0,0,32,32,
Tulsa,Lieutenant Governor,Dana Murphy,REP,720003,0,0,19,19,
Tulsa,Lieutenant Governor,Matt Pinnell,REP,720003,0,0,23,23,
Tulsa,State Auditor,Cindy Byrd,REP,720003,0,0,15,15,
Tulsa,State Auditor,Charlie Prater,REP,720003,0,0,27,27,
Tulsa,Attorney General,Mike Hunter,REP,720003,0,0,19,19,
Tulsa,Attorney General,Gentner Drummond,REP,720003,0,0,23,23,
Tulsa,Superintendent of Public Instruction,Joy Hofmeister,REP,720003,0,0,22,22,
Tulsa,Superintendent of Public Instruction,Linda Murphy,REP,720003,0,0,19,19,
Tulsa,Commissioner of Labor,Cathy Costello,REP,720003,0,0,24,24,
Tulsa,Commissioner of Labor,Leslie Osborn,REP,720003,0,0,18,18,
Tulsa,Corporation Commissioner,Bob Anthony,REP,720003,0,0,27,27,
Tulsa,Corporation Commissioner,Brian Bingman,REP,720003,0,0,14,14,
Tulsa,U.S. House,Tim Harris,REP,720003,0,0,16,16,01
Tulsa,U.S. House,Kevin Hern,REP,720003,0,0,26,26,01
Tulsa,Governor,Chris Powell,LIB,720003,0,0,1,1,
Tulsa,Governor,Rex Lawhorn,LIB,720003,0,0,0,0,
Tulsa,Corporation Commissioner,Ashley Nicole Mccray,DEM,720003,0,0,16,16,
Tulsa,Corporation Commissioner,Blake Cummings,DEM,720003,0,0,5,5,
Tulsa,U.S. House,Tim Gilpin,DEM,720003,0,0,15,15,01
Tulsa,U.S. House,Amanda Douglas,DEM,720003,0,0,6,6,01
Tulsa,Governor,Mick Cornett,REP,720004,0,0,5,5,
Tulsa,Governor,Kevin Stitt,REP,720004,0,0,9,9,
Tulsa,Lieutenant Governor,Dana Murphy,REP,720004,0,0,8,8,
Tulsa,Lieutenant Governor,Matt Pinnell,REP,720004,0,0,5,5,
Tulsa,State Auditor,Cindy Byrd,REP,720004,0,0,10,10,
Tulsa,State Auditor,Charlie Prater,REP,720004,0,0,3,3,
Tulsa,Attorney General,Mike Hunter,REP,720004,0,0,3,3,
Tulsa,Attorney General,Gentner Drummond,REP,720004,0,0,10,10,
Tulsa,Superintendent of Public Instruction,Joy Hofmeister,REP,720004,0,0,4,4,
Tulsa,Superintendent of Public Instruction,Linda Murphy,REP,720004,0,0,9,9,
Tulsa,Commissioner of Labor,Cathy Costello,REP,720004,0,0,5,5,
Tulsa,Commissioner of Labor,Leslie Osborn,REP,720004,0,0,8,8,
Tulsa,Corporation Commissioner,Bob Anthony,REP,720004,0,0,4,4,
Tulsa,Corporation Commissioner,Brian Bingman,REP,720004,0,0,9,9,
Tulsa,U.S. House,Tim Harris,REP,720004,0,0,4,4,01
Tulsa,U.S. House,Kevin Hern,REP,720004,0,0,10,10,01
Tulsa,Governor,Chris Powell,LIB,720004,0,0,0,0,
Tulsa,Governor,Rex Lawhorn,LIB,720004,0,0,0,0,
Tulsa,Corporation Commissioner,Ashley Nicole Mccray,DEM,720004,0,0,194,194,
Tulsa,Corporation Commissioner,Blake Cummings,DEM,720004,0,0,82,82,
Tulsa,U.S. House,Tim Gilpin,DEM,720004,0,0,135,135,01
Tulsa,U.S. House,Amanda Douglas,DEM,720004,0,0,145,145,01
Tulsa,Governor,Mick Cornett,REP,720005,0,0,5,5,
Tulsa,Governor,Kevin Stitt,REP,720005,0,0,11,11,
Tulsa,Lieutenant Governor,Dana Murphy,REP,720005,0,0,5,5,
Tulsa,Lieutenant Governor,Matt Pinnell,REP,720005,0,0,11,11,
Tulsa,State Auditor,Cindy Byrd,REP,720005,0,0,9,9,
Tulsa,State Auditor,Charlie Prater,REP,720005,0,0,7,7,
Tulsa,Attorney General,Mike Hunter,REP,720005,0,0,5,5,
Tulsa,Attorney General,Gentner Drummond,REP,720005,0,0,11,11,
Tulsa,Superintendent of Public Instruction,Joy Hofmeister,REP,720005,0,0,6,6,
Tulsa,Superintendent of Public Instruction,Linda Murphy,REP,720005,0,0,10,10,
Tulsa,Commissioner of Labor,Cathy Costello,REP,720005,0,0,6,6,
Tulsa,Commissioner of Labor,Leslie Osborn,REP,720005,0,0,10,10,
Tulsa,Corporation Commissioner,Bob Anthony,REP,720005,0,0,6,6,
Tulsa,Corporation Commissioner,Brian Bingman,REP,720005,0,0,10,10,
Tulsa,U.S. House,Tim Harris,REP,720005,0,0,6,6,01
Tulsa,U.S. House,Kevin Hern,REP,720005,0,0,10,10,01
Tulsa,Governor,Chris Powell,LIB,720005,0,0,0,0,
Tulsa,Governor,Rex Lawhorn,LIB,720005,0,0,0,0,
Tulsa,Corporation Commissioner,Ashley Nicole Mccray,DEM,720005,0,0,92,92,
Tulsa,Corporation Commissioner,Blake Cummings,DEM,720005,0,0,37,37,
Tulsa,U.S. House,Tim Gilpin,DEM,720005,0,0,67,67,01
Tulsa,U.S. House,Amanda Douglas,DEM,720005,0,0,63,63,01
Tulsa,Governor,Mick Cornett,REP,720006,0,0,7,7,
Tulsa,Governor,Kevin Stitt,REP,720006,0,0,4,4,
Tulsa,Lieutenant Governor,Dana Murphy,REP,720006,0,0,5,5,
Tulsa,Lieutenant Governor,Matt Pinnell,REP,720006,0,0,6,6,
Tulsa,State Auditor,Cindy Byrd,REP,720006,0,0,6,6,
Tulsa,State Auditor,Charlie Prater,REP,720006,0,0,4,4,
Tulsa,Attorney General,Mike Hunter,REP,720006,0,0,3,3,
Tulsa,Attorney General,Gentner Drummond,REP,720006,0,0,8,8,
Tulsa,Superintendent of Public Instruction,Joy Hofmeister,REP,720006,0,0,5,5,
Tulsa,Superintendent of Public Instruction,Linda Murphy,REP,720006,0,0,6,6,
Tulsa,Commissioner of Labor,Cathy Costello,REP,720006,0,0,2,2,
Tulsa,Commissioner of Labor,Leslie Osborn,REP,720006,0,0,9,9,
Tulsa,Corporation Commissioner,Bob Anthony,REP,720006,0,0,3,3,
Tulsa,Corporation Commissioner,Brian Bingman,REP,720006,0,0,8,8,
Tulsa,U.S. House,Tim Harris,REP,720006,0,0,4,4,01
Tulsa,U.S. House,Kevin Hern,REP,720006,0,0,7,7,01
Tulsa,Governor,Chris Powell,LIB,720006,0,0,0,0,
Tulsa,Governor,Rex Lawhorn,LIB,720006,0,0,1,1,
Tulsa,Corporation Commissioner,Ashley Nicole Mccray,DEM,720006,0,0,229,229,
Tulsa,Corporation Commissioner,Blake Cummings,DEM,720006,0,0,83,83,
Tulsa,U.S. House,Tim Gilpin,DEM,720006,0,0,163,163,01
Tulsa,U.S. House,Amanda Douglas,DEM,720006,0,0,158,158,01
Tulsa,Governor,Mick Cornett,REP,720007,0,0,8,8,
Tulsa,Governor,Kevin Stitt,REP,720007,0,0,8,8,
Tulsa,Lieutenant Governor,Dana Murphy,REP,720007,0,0,7,7,
Tulsa,Lieutenant Governor,Matt Pinnell,REP,720007,0,0,9,9,
Tulsa,State Auditor,Cindy Byrd,REP,720007,0,0,8,8,
Tulsa,State Auditor,Charlie Prater,REP,720007,0,0,8,8,
Tulsa,Attorney General,Mike Hunter,REP,720007,0,0,5,5,
Tulsa,Attorney General,Gentner Drummond,REP,720007,0,0,11,11,
Tulsa,Superintendent of Public Instruction,Joy Hofmeister,REP,720007,0,0,8,8,
Tulsa,Superintendent of Public Instruction,Linda Murphy,REP,720007,0,0,8,8,
Tulsa,Commissioner of Labor,Cathy Costello,REP,720007,0,0,6,6,
Tulsa,Commissioner of Labor,Leslie Osborn,REP,720007,0,0,10,10,
Tulsa,Corporation Commissioner,Bob Anthony,REP,720007,0,0,8,8,
Tulsa,Corporation Commissioner,Brian Bingman,REP,720007,0,0,8,8,
Tulsa,U.S. House,Tim Harris,REP,720007,0,0,8,8,01
Tulsa,U.S. House,Kevin Hern,REP,720007,0,0,8,8,01
Tulsa,Governor,Chris Powell,LIB,720007,0,0,0,0,
Tulsa,Governor,Rex Lawhorn,LIB,720007,0,0,0,0,
Tulsa,Corporation Commissioner,Ashley Nicole Mccray,DEM,720007,0,0,113,113,
Tulsa,Corporation Commissioner,Blake Cummings,DEM,720007,0,0,39,39,
Tulsa,U.S. House,Tim Gilpin,DEM,720007,0,0,89,89,01
Tulsa,U.S. House,Amanda Douglas,DEM,720007,0,0,69,69,01
Tulsa,Governor,Mick Cornett,REP,720008,0,0,10,10,
Tulsa,Governor,Kevin Stitt,REP,720008,0,0,12,12,
Tulsa,Lieutenant Governor,Dana Murphy,REP,720008,0,0,6,6,
Tulsa,Lieutenant Governor,Matt Pinnell,REP,720008,0,0,16,16,
Tulsa,State Auditor,Cindy Byrd,REP,720008,0,0,7,7,
Tulsa,State Auditor,Charlie Prater,REP,720008,0,0,15,15,
Tulsa,Attorney General,Mike Hunter,REP,720008,0,0,8,8,
Tulsa,Attorney General,Gentner Drummond,REP,720008,0,0,14,14,
Tulsa,Superintendent of Public Instruction,Joy Hofmeister,REP,720008,0,0,11,11,
Tulsa,Superintendent of Public Instruction,Linda Murphy,REP,720008,0,0,10,10,
Tulsa,Commissioner of Labor,Cathy Costello,REP,720008,0,0,10,10,
Tulsa,Commissioner of Labor,Leslie Osborn,REP,720008,0,0,12,12,
Tulsa,Corporation Commissioner,Bob Anthony,REP,720008,0,0,8,8,
Tulsa,Corporation Commissioner,Brian Bingman,REP,720008,0,0,11,11,
Tulsa,U.S. House,Tim Harris,REP,720008,0,0,4,4,01
Tulsa,U.S. House,Kevin Hern,REP,720008,0,0,18,18,01
Tulsa,Governor,Chris Powell,LIB,720008,0,0,0,0,
Tulsa,Governor,Rex Lawhorn,LIB,720008,0,0,0,0,
Tulsa,Corporation Commissioner,Ashley Nicole Mccray,DEM,720008,0,0,84,84,
Tulsa,Corporation Commissioner,Blake Cummings,DEM,720008,0,0,20,20,
Tulsa,U.S. House,Tim Gilpin,DEM,720008,0,0,49,49,01
Tulsa,U.S. House,Amanda Douglas,DEM,720008,0,0,56,56,01
Tulsa,Governor,Mick Cornett,REP,720009,0,0,2,2,
Tulsa,Governor,Kevin Stitt,REP,720009,0,0,5,5,
Tulsa,Lieutenant Governor,Dana Murphy,REP,720009,0,0,2,2,
Tulsa,Lieutenant Governor,Matt Pinnell,REP,720009,0,0,5,5,
Tulsa,State Auditor,Cindy Byrd,REP,720009,0,0,2,2,
Tulsa,State Auditor,Charlie Prater,REP,720009,0,0,4,4,
Tulsa,Attorney General,Mike Hunter,REP,720009,0,0,2,2,
Tulsa,Attorney General,Gentner Drummond,REP,720009,0,0,4,4,
Tulsa,Superintendent of Public Instruction,Joy Hofmeister,REP,720009,0,0,4,4,
Tulsa,Superintendent of Public Instruction,Linda Murphy,REP,720009,0,0,2,2,
Tulsa,Commissioner of Labor,Cathy Costello,REP,720009,0,0,2,2,
Tulsa,Commissioner of Labor,Leslie Osborn,REP,720009,0,0,3,3,
Tulsa,Corporation Commissioner,Bob Anthony,REP,720009,0,0,4,4,
Tulsa,Corporation Commissioner,Brian Bingman,REP,720009,0,0,2,2,
Tulsa,U.S. House,Tim Harris,REP,720009,0,0,1,1,01
Tulsa,U.S. House,Kevin Hern,REP,720009,0,0,5,5,01
Tulsa,Governor,Chris Powell,LIB,720009,0,0,0,0,
Tulsa,Governor,Rex Lawhorn,LIB,720009,0,0,0,0,
Tulsa,Corporation Commissioner,Ashley Nicole Mccray,DEM,720009,0,0,34,34,
Tulsa,Corporation Commissioner,Blake Cummings,DEM,720009,0,0,8,8,
Tulsa,U.S. House,Tim Gilpin,DEM,720009,0,0,15,15,01
Tulsa,U.S. House,Amanda Douglas,DEM,720009,0,0,27,27,01
Tulsa,Governor,Mick Cornett,REP,720010,0,0,5,5,
Tulsa,Governor,Kevin Stitt,REP,720010,0,0,4,4,
Tulsa,Lieutenant Governor,Dana Murphy,REP,720010,0,0,4,4,
Tulsa,Lieutenant Governor,Matt Pinnell,REP,720010,0,0,5,5,
Tulsa,State Auditor,Cindy Byrd,REP,720010,0,0,8,8,
Tulsa,State Auditor,Charlie Prater,REP,720010,0,0,1,1,
Tulsa,Attorney General,Mike Hunter,REP,720010,0,0,6,6,
Tulsa,Attorney General,Gentner Drummond,REP,720010,0,0,3,3,
Tulsa,Superintendent of Public Instruction,Joy Hofmeister,REP,720010,0,0,6,6,
Tulsa,Superintendent of Public Instruction,Linda Murphy,REP,720010,0,0,3,3,
Tulsa,Commissioner of Labor,Cathy Costello,REP,720010,0,0,5,5,
Tulsa,Commissioner of Labor,Leslie Osborn,REP,720010,0,0,2,2,
Tulsa,Corporation Commissioner,Bob Anthony,REP,720010,0,0,6,6,
Tulsa,Corporation Commissioner,Brian Bingman,REP,720010,0,0,3,3,
Tulsa,U.S. House,Tim Harris,REP,720010,0,0,8,8,01
Tulsa,U.S. House,Kevin Hern,REP,720010,0,0,1,1,01
Tulsa,Governor,Chris Powell,LIB,720010,0,0,0,0,
Tulsa,Governor,Rex Lawhorn,LIB,720010,0,0,0,0,
Tulsa,Corporation Commissioner,Ashley Nicole Mccray,DEM,720010,0,0,119,119,
Tulsa,Corporation Commissioner,Blake Cummings,DEM,720010,0,0,32,32,
Tulsa,U.S. House,Tim Gilpin,DEM,720010,0,0,87,87,01
Tulsa,U.S. House,Amanda Douglas,DEM,720010,0,0,65,65,01
Tulsa,Governor,Mick Cornett,REP,720011,0,0,12,12,
Tulsa,Governor,Kevin Stitt,REP,720011,0,0,26,26,
Tulsa,Lieutenant Governor,Dana Murphy,REP,720011,0,0,11,11,
Tulsa,Lieutenant Governor,Matt Pinnell,REP,720011,0,0,27,27,
Tulsa,State Auditor,Cindy Byrd,REP,720011,0,0,17,17,
Tulsa,State Auditor,Charlie Prater,REP,720011,0,0,21,21,
Tulsa,Attorney General,Mike Hunter,REP,720011,0,0,16,16,
Tulsa,Attorney General,Gentner Drummond,REP,720011,0,0,22,22,
Tulsa,Superintendent of Public Instruction,Joy Hofmeister,REP,720011,0,0,15,15,
Tulsa,Superintendent of Public Instruction,Linda Murphy,REP,720011,0,0,22,22,
Tulsa,Commissioner of Labor,Cathy Costello,REP,720011,0,0,23,23,
Tulsa,Commissioner of Labor,Leslie Osborn,REP,720011,0,0,15,15,
Tulsa,Corporation Commissioner,Bob Anthony,REP,720011,0,0,23,23,
Tulsa,Corporation Commissioner,Brian Bingman,REP,720011,0,0,15,15,
Tulsa,U.S. House,Tim Harris,REP,720011,0,0,15,15,01
Tulsa,U.S. House,Kevin Hern,REP,720011,0,0,23,23,01
Tulsa,Governor,Chris Powell,LIB,720011,0,0,0,0,
Tulsa,Governor,Rex Lawhorn,LIB,720011,0,0,0,0,
Tulsa,Corporation Commissioner,Ashley Nicole Mccray,DEM,720011,0,0,35,35,
Tulsa,Corporation Commissioner,Blake Cummings,DEM,720011,0,0,16,16,
Tulsa,U.S. House,Tim Gilpin,DEM,720011,0,0,23,23,01
Tulsa,U.S. House,Amanda Douglas,DEM,720011,0,0,27,27,01
Tulsa,Governor,Mick Cornett,REP,720012,0,0,14,14,
Tulsa,Governor,Kevin Stitt,REP,720012,0,0,22,22,
Tulsa,Lieutenant Governor,Dana Murphy,REP,720012,0,0,15,15,
Tulsa,Lieutenant Governor,Matt Pinnell,REP,720012,0,0,19,19,
Tulsa,State Auditor,Cindy Byrd,REP,720012,0,0,19,19,
Tulsa,State Auditor,Charlie Prater,REP,720012,0,0,16,16,
Tulsa,Attorney General,Mike Hunter,REP,720012,0,0,12,12,
Tulsa,Attorney General,Gentner Drummond,REP,720012,0,0,23,23,
Tulsa,Superintendent of Public Instruction,Joy Hofmeister,REP,720012,0,0,18,18,
Tulsa,Superintendent of Public Instruction,Linda Murphy,REP,720012,0,0,15,15,
Tulsa,Commissioner of Labor,Cathy Costello,REP,720012,0,0,19,19,
Tulsa,Commissioner of Labor,Leslie Osborn,REP,720012,0,0,12,12,
Tulsa,Corporation Commissioner,Bob Anthony,REP,720012,0,0,21,21,
Tulsa,Corporation Commissioner,Brian Bingman,REP,720012,0,0,13,13,
Tulsa,U.S. House,Tim Harris,REP,720012,0,0,8,8,01
Tulsa,U.S. House,Kevin Hern,REP,720012,0,0,26,26,01
Tulsa,Governor,Chris Powell,LIB,720012,0,0,0,0,
Tulsa,Governor,Rex Lawhorn,LIB,720012,0,0,0,0,
Tulsa,Corporation Commissioner,Ashley Nicole Mccray,DEM,720012,0,0,32,32,
Tulsa,Corporation Commissioner,Blake Cummings,DEM,720012,0,0,15,15,
Tulsa,U.S. House,Tim Gilpin,DEM,720012,0,0,27,27,01
Tulsa,U.S. House,Amanda Douglas,DEM,720012,0,0,20,20,01
Tulsa,Governor,Mick Cornett,REP,720013,0,0,5,5,
Tulsa,Governor,Kevin Stitt,REP,720013,0,0,9,9,
Tulsa,Lieutenant Governor,Dana Murphy,REP,720013,0,0,4,4,
Tulsa,Lieutenant Governor,Matt Pinnell,REP,720013,0,0,9,9,
Tulsa,State Auditor,Cindy Byrd,REP,720013,0,0,8,8,
Tulsa,State Auditor,Charlie Prater,REP,720013,0,0,5,5,
Tulsa,Attorney General,Mike Hunter,REP,720013,0,0,9,9,
Tulsa,Attorney General,Gentner Drummond,REP,720013,0,0,5,5,
Tulsa,Superintendent of Public Instruction,Joy Hofmeister,REP,720013,0,0,5,5,
Tulsa,Superintendent of Public Instruction,Linda Murphy,REP,720013,0,0,7,7,
Tulsa,Commissioner of Labor,Cathy Costello,REP,720013,0,0,6,6,
Tulsa,Commissioner of Labor,Leslie Osborn,REP,720013,0,0,6,6,
Tulsa,Corporation Commissioner,Bob Anthony,REP,720013,0,0,7,7,
Tulsa,Corporation Commissioner,Brian Bingman,REP,720013,0,0,5,5,
Tulsa,U.S. House,Tim Harris,REP,720013,0,0,6,6,01
Tulsa,U.S. House,Kevin Hern,REP,720013,0,0,8,8,01
Tulsa,Governor,Chris Powell,LIB,720013,0,0,0,0,
Tulsa,Governor,Rex Lawhorn,LIB,720013,0,0,0,0,
Tulsa,Corporation Commissioner,Ashley Nicole Mccray,DEM,720013,0,0,229,229,
Tulsa,Corporation Commissioner,Blake Cummings,DEM,720013,0,0,94,94,
Tulsa,U.S. House,Tim Gilpin,DEM,720013,0,0,181,181,01
Tulsa,U.S. House,Amanda Douglas,DEM,720013,0,0,144,144,01
Tulsa,Governor,Mick Cornett,REP,720014,0,0,12,12,
Tulsa,Governor,Kevin Stitt,REP,720014,0,0,13,13,
Tulsa,Lieutenant Governor,Dana Murphy,REP,720014,0,0,11,11,
Tulsa,Lieutenant Governor,Matt Pinnell,REP,720014,0,0,14,14,
Tulsa,State Auditor,Cindy Byrd,REP,720014,0,0,13,13,
Tulsa,State Auditor,Charlie Prater,REP,720014,0,0,11,11,
Tulsa,Attorney General,Mike Hunter,REP,720014,0,0,14,14,
Tulsa,Attorney General,Gentner Drummond,REP,720014,0,0,11,11,
Tulsa,Superintendent of Public Instruction,Joy Hofmeister,REP,720014,0,0,13,13,
Tulsa,Superintendent of Public Instruction,Linda Murphy,REP,720014,0,0,12,12,
Tulsa,Commissioner of Labor,Cathy Costello,REP,720014,0,0,15,15,
Tulsa,Commissioner of Labor,Leslie Osborn,REP,720014,0,0,10,10,
Tulsa,Corporation Commissioner,Bob Anthony,REP,720014,0,0,17,17,
Tulsa,Corporation Commissioner,Brian Bingman,REP,720014,0,0,8,8,
Tulsa,U.S. House,Tim Harris,REP,720014,0,0,14,14,01
Tulsa,U.S. House,Kevin Hern,REP,720014,0,0,11,11,01
Tulsa,Governor,Chris Powell,LIB,720014,0,0,0,0,
Tulsa,Governor,Rex Lawhorn,LIB,720014,0,0,0,0,
Tulsa,Corporation Commissioner,Ashley Nicole Mccray,DEM,720014,0,0,167,167,
Tulsa,Corporation Commissioner,Blake Cummings,DEM,720014,0,0,60,60,
Tulsa,U.S. House,Tim Gilpin,DEM,720014,0,0,121,121,01
Tulsa,U.S. House,Amanda Douglas,DEM,720014,0,0,112,112,01
Tulsa,Governor,Mick Cornett,REP,720015,0,0,3,3,
Tulsa,Governor,Kevin Stitt,REP,720015,0,0,18,18,
Tulsa,Lieutenant Governor,Dana Murphy,REP,720015,0,0,4,4,
Tulsa,Lieutenant Governor,Matt Pinnell,REP,720015,0,0,16,16,
Tulsa,State Auditor,Cindy Byrd,REP,720015,0,0,8,8,
Tulsa,State Auditor,Charlie Prater,REP,720015,0,0,12,12,
Tulsa,Attorney General,Mike Hunter,REP,720015,0,0,7,7,
Tulsa,Attorney General,Gentner Drummond,REP,720015,0,0,13,13,
Tulsa,Superintendent of Public Instruction,Joy Hofmeister,REP,720015,0,0,12,12,
Tulsa,Superintendent of Public Instruction,Linda Murphy,REP,720015,0,0,7,7,
Tulsa,Commissioner of Labor,Cathy Costello,REP,720015,0,0,12,12,
Tulsa,Commissioner of Labor,Leslie Osborn,REP,720015,0,0,9,9,
Tulsa,Corporation Commissioner,Bob Anthony,REP,720015,0,0,12,12,
Tulsa,Corporation Commissioner,Brian Bingman,REP,720015,0,0,7,7,
Tulsa,U.S. House,Tim Harris,REP,720015,0,0,4,4,01
Tulsa,U.S. House,Kevin Hern,REP,720015,0,0,16,16,01
Tulsa,Governor,Chris Powell,LIB,720015,0,0,0,0,
Tulsa,Governor,Rex Lawhorn,LIB,720015,0,0,0,0,
Tulsa,Corporation Commissioner,Ashley Nicole Mccray,DEM,720015,0,0,76,76,
Tulsa,Corporation Commissioner,Blake Cummings,DEM,720015,0,0,28,28,
Tulsa,U.S. House,Tim Gilpin,DEM,720015,0,0,51,51,01
Tulsa,U.S. House,Amanda Douglas,DEM,720015,0,0,57,57,01
Tulsa,Governor,Mick Cornett,REP,720016,0,0,12,12,
Tulsa,Governor,Kevin Stitt,REP,720016,0,0,17,17,
Tulsa,Lieutenant Governor,Dana Murphy,REP,720016,0,0,9,9,
Tulsa,Lieutenant Governor,Matt Pinnell,REP,720016,0,0,19,19,
Tulsa,State Auditor,Cindy Byrd,REP,720016,0,0,15,15,
Tulsa,State Auditor,Charlie Prater,REP,720016,0,0,13,13,
Tulsa,Attorney General,Mike Hunter,REP,720016,0,0,15,15,
Tulsa,Attorney General,Gentner Drummond,REP,720016,0,0,14,14,
Tulsa,Superintendent of Public Instruction,Joy Hofmeister,REP,720016,0,0,20,20,
Tulsa,Superintendent of Public Instruction,Linda Murphy,REP,720016,0,0,7,7,
Tulsa,Commissioner of Labor,Cathy Costello,REP,720016,0,0,11,11,
Tulsa,Commissioner of Labor,Leslie Osborn,REP,720016,0,0,16,16,
Tulsa,Corporation Commissioner,Bob Anthony,REP,720016,0,0,15,15,
Tulsa,Corporation Commissioner,Brian Bingman,REP,720016,0,0,12,12,
Tulsa,U.S. House,Tim Harris,REP,720016,0,0,11,11,01
Tulsa,U.S. House,Kevin Hern,REP,720016,0,0,18,18,01
Tulsa,Governor,Chris Powell,LIB,720016,0,0,0,0,
Tulsa,Governor,Rex Lawhorn,LIB,720016,0,0,0,0,
Tulsa,Corporation Commissioner,Ashley Nicole Mccray,DEM,720016,0,0,13,13,
Tulsa,Corporation Commissioner,Blake Cummings,DEM,720016,0,0,4,4,
Tulsa,U.S. House,Tim Gilpin,DEM,720016,0,0,9,9,01
Tulsa,U.S. House,Amanda Douglas,DEM,720016,0,0,8,8,01
Tulsa,Governor,Mick Cornett,REP,720017,0,0,8,8,
Tulsa,Governor,Kevin Stitt,REP,720017,0,0,23,23,
Tulsa,Lieutenant Governor,Dana Murphy,REP,720017,0,0,11,11,
Tulsa,Lieutenant Governor,Matt Pinnell,REP,720017,0,0,20,20,
Tulsa,State Auditor,Cindy Byrd,REP,720017,0,0,14,14,
Tulsa,State Auditor,Charlie Prater,REP,720017,0,0,14,14,
Tulsa,Attorney General,Mike Hunter,REP,720017,0,0,12,12,
Tulsa,Attorney General,Gentner Drummond,REP,720017,0,0,19,19,
Tulsa,Superintendent of Public Instruction,Joy Hofmeister,REP,720017,0,0,13,13,
Tulsa,Superintendent of Public Instruction,Linda Murphy,REP,720017,0,0,18,18,
Tulsa,Commissioner of Labor,Cathy Costello,REP,720017,0,0,7,7,
Tulsa,Commissioner of Labor,Leslie Osborn,REP,720017,0,0,23,23,
Tulsa,Corporation Commissioner,Bob Anthony,REP,720017,0,0,19,19,
Tulsa,Corporation Commissioner,Brian Bingman,REP,720017,0,0,12,12,
Tulsa,U.S. House,Tim Harris,REP,720017,0,0,10,10,01
Tulsa,U.S. House,Kevin Hern,REP,720017,0,0,21,21,01
Tulsa,Governor,Chris Powell,LIB,720017,0,0,0,0,
Tulsa,Governor,Rex Lawhorn,LIB,720017,0,0,0,0,
Tulsa,Corporation Commissioner,Ashley Nicole Mccray,DEM,720017,0,0,18,18,
Tulsa,Corporation Commissioner,Blake Cummings,DEM,720017,0,0,9,9,
Tulsa,U.S. House,Tim Gilpin,DEM,720017,0,0,16,16,01
Tulsa,U.S. House,Amanda Douglas,DEM,720017,0,0,11,11,01
Tulsa,Governor,Mick Cornett,REP,720018,0,0,17,17,
Tulsa,Governor,Kevin Stitt,REP,720018,0,0,30,30,
Tulsa,Lieutenant Governor,Dana Murphy,REP,720018,0,0,19,19,
Tulsa,Lieutenant Governor,Matt Pinnell,REP,720018,0,0,28,28,
Tulsa,State Auditor,Cindy Byrd,REP,720018,0,0,18,18,
Tulsa,State Auditor,Charlie Prater,REP,720018,0,0,29,29,
Tulsa,Attorney General,Mike Hunter,REP,720018,0,0,17,17,
Tulsa,Attorney General,Gentner Drummond,REP,720018,0,0,30,30,
Tulsa,Superintendent of Public Instruction,Joy Hofmeister,REP,720018,0,0,24,24,
Tulsa,Superintendent of Public Instruction,Linda Murphy,REP,720018,0,0,23,23,
Tulsa,Commissioner of Labor,Cathy Costello,REP,720018,0,0,19,19,
Tulsa,Commissioner of Labor,Leslie Osborn,REP,720018,0,0,28,28,
Tulsa,Corporation Commissioner,Bob Anthony,REP,720018,0,0,21,21,
Tulsa,Corporation Commissioner,Brian Bingman,REP,720018,0,0,26,26,
Tulsa,U.S. House,Tim Harris,REP,720018,0,0,15,15,01
Tulsa,U.S. House,Kevin Hern,REP,720018,0,0,32,32,01
Tulsa,Governor,Chris Powell,LIB,720018,0,0,0,0,
Tulsa,Governor,Rex Lawhorn,LIB,720018,0,0,0,0,
Tulsa,Corporation Commissioner,Ashley Nicole Mccray,DEM,720018,0,0,36,36,
Tulsa,Corporation Commissioner,Blake Cummings,DEM,720018,0,0,16,16,
Tulsa,U.S. House,Tim Gilpin,DEM,720018,0,0,33,33,01
Tulsa,U.S. House,Amanda Douglas,DEM,720018,0,0,19,19,01
Tulsa,Governor,Mick Cornett,REP,720019,0,0,17,17,
Tulsa,Governor,Kevin Stitt,REP,720019,0,0,31,31,
Tulsa,Lieutenant Governor,Dana Murphy,REP,720019,0,0,23,23,
Tulsa,Lieutenant Governor,Matt Pinnell,REP,720019,0,0,25,25,
Tulsa,State Auditor,Cindy Byrd,REP,720019,0,0,21,21,
Tulsa,State Auditor,Charlie Prater,REP,720019,0,0,24,24,
Tulsa,Attorney General,Mike Hunter,REP,720019,0,0,25,25,
Tulsa,Attorney General,Gentner Drummond,REP,720019,0,0,22,22,
Tulsa,Superintendent of Public Instruction,Joy Hofmeister,REP,720019,0,0,31,31,
Tulsa,Superintendent of Public Instruction,Linda Murphy,REP,720019,0,0,16,16,
Tulsa,Commissioner of Labor,Cathy Costello,REP,720019,0,0,22,22,
Tulsa,Commissioner of Labor,Leslie Osborn,REP,720019,0,0,24,24,
Tulsa,Corporation Commissioner,Bob Anthony,REP,720019,0,0,21,21,
Tulsa,Corporation Commissioner,Brian Bingman,REP,720019,0,0,26,26,
Tulsa,U.S. House,Tim Harris,REP,720019,0,0,17,17,01
Tulsa,U.S. House,Kevin Hern,REP,720019,0,0,31,31,01
Tulsa,Governor,Chris Powell,LIB,720019,0,0,0,0,
Tulsa,Governor,Rex Lawhorn,LIB,720019,0,0,0,0,
Tulsa,Corporation Commissioner,Ashley Nicole Mccray,DEM,720019,0,0,33,33,
Tulsa,Corporation Commissioner,Blake Cummings,DEM,720019,0,0,15,15,
Tulsa,U.S. House,Tim Gilpin,DEM,720019,0,0,30,30,01
Tulsa,U.S. House,Amanda Douglas,DEM,720019,0,0,19,19,01
Tulsa,Governor,Mick Cornett,REP,720020,0,0,19,19,
Tulsa,Governor,Kevin Stitt,REP,720020,0,0,44,44,
Tulsa,Lieutenant Governor,Dana Murphy,REP,720020,0,0,28,28,
Tulsa,Lieutenant Governor,Matt Pinnell,REP,720020,0,0,32,32,
Tulsa,State Auditor,Cindy Byrd,REP,720020,0,0,30,30,
Tulsa,State Auditor,Charlie Prater,REP,720020,0,0,32,32,
Tulsa,Attorney General,Mike Hunter,REP,720020,0,0,32,32,
Tulsa,Attorney General,Gentner Drummond,REP,720020,0,0,29,29,
Tulsa,Superintendent of Public Instruction,Joy Hofmeister,REP,720020,0,0,26,26,
Tulsa,Superintendent of Public Instruction,Linda Murphy,REP,720020,0,0,36,36,
Tulsa,Commissioner of Labor,Cathy Costello,REP,720020,0,0,29,29,
Tulsa,Commissioner of Labor,Leslie Osborn,REP,720020,0,0,31,31,
Tulsa,Corporation Commissioner,Bob Anthony,REP,720020,0,0,33,33,
Tulsa,Corporation Commissioner,Brian Bingman,REP,720020,0,0,29,29,
Tulsa,U.S. House,Tim Harris,REP,720020,0,0,26,26,01
Tulsa,U.S. House,Kevin Hern,REP,720020,0,0,37,37,01
Tulsa,Governor,Chris Powell,LIB,720020,0,0,0,0,
Tulsa,Governor,Rex Lawhorn,LIB,720020,0,0,0,0,
Tulsa,Corporation Commissioner,Ashley Nicole Mccray,DEM,720020,0,0,58,58,
Tulsa,Corporation Commissioner,Blake Cummings,DEM,720020,0,0,23,23,
Tulsa,U.S. House,Tim Gilpin,DEM,720020,0,0,46,46,01
Tulsa,U.S. House,Amanda Douglas,DEM,720020,0,0,37,37,01
Tulsa,Governor,Mick Cornett,REP,720021,0,0,4,4,
Tulsa,Governor,Kevin Stitt,REP,720021,0,0,12,12,
Tulsa,Lieutenant Governor,Dana Murphy,REP,720021,0,0,8,8,
Tulsa,Lieutenant Governor,Matt Pinnell,REP,720021,0,0,8,8,
Tulsa,State Auditor,Cindy Byrd,REP,720021,0,0,6,6,
Tulsa,State Auditor,Charlie Prater,REP,720021,0,0,9,9,
Tulsa,Attorney General,Mike Hunter,REP,720021,0,0,4,4,
Tulsa,Attorney General,Gentner Drummond,REP,720021,0,0,12,12,
Tulsa,Superintendent of Public Instruction,Joy Hofmeister,REP,720021,0,0,4,4,
Tulsa,Superintendent of Public Instruction,Linda Murphy,REP,720021,0,0,12,12,
Tulsa,Commissioner of Labor,Cathy Costello,REP,720021,0,0,11,11,
Tulsa,Commissioner of Labor,Leslie Osborn,REP,720021,0,0,3,3,
Tulsa,Corporation Commissioner,Bob Anthony,REP,720021,0,0,7,7,
Tulsa,Corporation Commissioner,Brian Bingman,REP,720021,0,0,9,9,
Tulsa,U.S. House,Tim Harris,REP,720021,0,0,7,7,01
Tulsa,U.S. House,Kevin Hern,REP,720021,0,0,9,9,01
Tulsa,Governor,Chris Powell,LIB,720021,0,0,0,0,
Tulsa,Governor,Rex Lawhorn,LIB,720021,0,0,0,0,
Tulsa,Corporation Commissioner,Ashley Nicole Mccray,DEM,720021,0,0,0,0,
Tulsa,Corporation Commissioner,Blake Cummings,DEM,720021,0,0,0,0,
Tulsa,U.S. House,Tim Gilpin,DEM,720021,0,0,0,0,01
Tulsa,U.S. House,Amanda Douglas,DEM,720021,0,0,0,0,01
Tulsa,Governor,Mick Cornett,REP,720022,0,0,28,28,
Tulsa,Governor,Kevin Stitt,REP,720022,0,0,50,50,
Tulsa,Lieutenant Governor,Dana Murphy,REP,720022,0,0,33,33,
Tulsa,Lieutenant Governor,Matt Pinnell,REP,720022,0,0,45,45,
Tulsa,State Auditor,Cindy Byrd,REP,720022,0,0,30,30,
Tulsa,State Auditor,Charlie Prater,REP,720022,0,0,47,47,
Tulsa,Attorney General,Mike Hunter,REP,720022,0,0,38,38,
Tulsa,Attorney General,Gentner Drummond,REP,720022,0,0,40,40,
Tulsa,Superintendent of Public Instruction,Joy Hofmeister,REP,720022,0,0,50,50,
Tulsa,Superintendent of Public Instruction,Linda Murphy,REP,720022,0,0,31,31,
Tulsa,Commissioner of Labor,Cathy Costello,REP,720022,0,0,28,28,
Tulsa,Commissioner of Labor,Leslie Osborn,REP,720022,0,0,50,50,
Tulsa,Corporation Commissioner,Bob Anthony,REP,720022,0,0,48,48,
Tulsa,Corporation Commissioner,Brian Bingman,REP,720022,0,0,32,32,
Tulsa,U.S. House,Tim Harris,REP,720022,0,0,28,28,01
Tulsa,U.S. House,Kevin Hern,REP,720022,0,0,52,52,01
Tulsa,Governor,Chris Powell,LIB,720022,0,0,0,0,
Tulsa,Governor,Rex Lawhorn,LIB,720022,0,0,0,0,
Tulsa,Corporation Commissioner,Ashley Nicole Mccray,DEM,720022,0,0,38,38,
Tulsa,Corporation Commissioner,Blake Cummings,DEM,720022,0,0,23,23,
Tulsa,U.S. House,Tim Gilpin,DEM,720022,0,0,34,34,01
Tulsa,U.S. House,Amanda Douglas,DEM,720022,0,0,26,26,01
Tulsa,Governor,Mick Cornett,REP,720023,0,0,12,12,
Tulsa,Governor,Kevin Stitt,REP,720023,0,0,31,31,
Tulsa,Lieutenant Governor,Dana Murphy,REP,720023,0,0,14,14,
Tulsa,Lieutenant Governor,Matt Pinnell,REP,720023,0,0,28,28,
Tulsa,State Auditor,Cindy Byrd,REP,720023,0,0,21,21,
Tulsa,State Auditor,Charlie Prater,REP,720023,0,0,22,22,
Tulsa,Attorney General,Mike Hunter,REP,720023,0,0,17,17,
Tulsa,Attorney General,Gentner Drummond,REP,720023,0,0,25,25,
Tulsa,Superintendent of Public Instruction,Joy Hofmeister,REP,720023,0,0,17,17,
Tulsa,Superintendent of Public Instruction,Linda Murphy,REP,720023,0,0,26,26,
Tulsa,Commissioner of Labor,Cathy Costello,REP,720023,0,0,22,22,
Tulsa,Commissioner of Labor,Leslie Osborn,REP,720023,0,0,21,21,
Tulsa,Corporation Commissioner,Bob Anthony,REP,720023,0,0,20,20,
Tulsa,Corporation Commissioner,Brian Bingman,REP,720023,0,0,19,19,
Tulsa,U.S. House,Tim Harris,REP,720023,0,0,13,13,01
Tulsa,U.S. House,Kevin Hern,REP,720023,0,0,30,30,01
Tulsa,Governor,Chris Powell,LIB,720023,0,0,0,0,
Tulsa,Governor,Rex Lawhorn,LIB,720023,0,0,0,0,
Tulsa,Corporation Commissioner,Ashley Nicole Mccray,DEM,720023,0,0,13,13,
Tulsa,Corporation Commissioner,Blake Cummings,DEM,720023,0,0,5,5,
Tulsa,U.S. House,Tim Gilpin,DEM,720023,0,0,9,9,01
Tulsa,U.S. House,Amanda Douglas,DEM,720023,0,0,9,9,01
Tulsa,Governor,Mick Cornett,REP,720024,0,0,21,21,
Tulsa,Governor,Kevin Stitt,REP,720024,0,0,54,54,
Tulsa,Lieutenant Governor,Dana Murphy,REP,720024,0,0,21,21,
Tulsa,Lieutenant Governor,Matt Pinnell,REP,720024,0,0,54,54,
Tulsa,State Auditor,Cindy Byrd,REP,720024,0,0,30,30,
Tulsa,State Auditor,Charlie Prater,REP,720024,0,0,45,45,
Tulsa,Attorney General,Mike Hunter,REP,720024,0,0,25,25,
Tulsa,Attorney General,Gentner Drummond,REP,720024,0,0,49,49,
Tulsa,Superintendent of Public Instruction,Joy Hofmeister,REP,720024,0,0,38,38,
Tulsa,Superintendent of Public Instruction,Linda Murphy,REP,720024,0,0,37,37,
Tulsa,Commissioner of Labor,Cathy Costello,REP,720024,0,0,33,33,
Tulsa,Commissioner of Labor,Leslie Osborn,REP,720024,0,0,41,41,
Tulsa,Corporation Commissioner,Bob Anthony,REP,720024,0,0,34,34,
Tulsa,Corporation Commissioner,Brian Bingman,REP,720024,0,0,40,40,
Tulsa,U.S. House,Tim Harris,REP,720024,0,0,32,32,01
Tulsa,U.S. House,Kevin Hern,REP,720024,0,0,43,43,01
Tulsa,Governor,Chris Powell,LIB,720024,0,0,0,0,
Tulsa,Governor,Rex Lawhorn,LIB,720024,0,0,0,0,
Tulsa,Corporation Commissioner,Ashley Nicole Mccray,DEM,720024,0,0,40,40,
Tulsa,Corporation Commissioner,Blake Cummings,DEM,720024,0,0,24,24,
Tulsa,U.S. House,Tim Gilpin,DEM,720024,0,0,40,40,01
Tulsa,U.S. House,Amanda Douglas,DEM,720024,0,0,25,25,01
Tulsa,Governor,Mick Cornett,REP,720025,0,0,10,10,
Tulsa,Governor,Kevin Stitt,REP,720025,0,0,37,37,
Tulsa,Lieutenant Governor,Dana Murphy,REP,720025,0,0,21,21,
Tulsa,Lieutenant Governor,Matt Pinnell,REP,720025,0,0,26,26,
Tulsa,State Auditor,Cindy Byrd,REP,720025,0,0,25,25,
Tulsa,State Auditor,Charlie Prater,REP,720025,0,0,22,22,
Tulsa,Attorney General,Mike Hunter,REP,720025,0,0,16,16,
Tulsa,Attorney General,Gentner Drummond,REP,720025,0,0,31,31,
Tulsa,Superintendent of Public Instruction,Joy Hofmeister,REP,720025,0,0,20,20,
Tulsa,Superintendent of Public Instruction,Linda Murphy,REP,720025,0,0,27,27,
Tulsa,Commissioner of Labor,Cathy Costello,REP,720025,0,0,26,26,
Tulsa,Commissioner of Labor,Leslie Osborn,REP,720025,0,0,20,20,
Tulsa,Corporation Commissioner,Bob Anthony,REP,720025,0,0,27,27,
Tulsa,Corporation Commissioner,Brian Bingman,REP,720025,0,0,20,20,
Tulsa,U.S. House,Tim Harris,REP,720025,0,0,19,19,01
Tulsa,U.S. House,Kevin Hern,REP,720025,0,0,28,28,01
Tulsa,Governor,Chris Powell,LIB,720025,0,0,1,1,
Tulsa,Governor,Rex Lawhorn,LIB,720025,0,0,0,0,
Tulsa,Corporation Commissioner,Ashley Nicole Mccray,DEM,720025,0,0,23,23,
Tulsa,Corporation Commissioner,Blake Cummings,DEM,720025,0,0,13,13,
Tulsa,U.S. House,Tim Gilpin,DEM,720025,0,0,21,21,01
Tulsa,U.S. House,Amanda Douglas,DEM,720025,0,0,15,15,01
Tulsa,Governor,Mick Cornett,REP,720026,0,0,16,16,
Tulsa,Governor,Kevin Stitt,REP,720026,0,0,21,21,
Tulsa,Lieutenant Governor,Dana Murphy,REP,720026,0,0,18,18,
Tulsa,Lieutenant Governor,Matt Pinnell,REP,720026,0,0,19,19,
Tulsa,State Auditor,Cindy Byrd,REP,720026,0,0,14,14,
Tulsa,State Auditor,Charlie Prater,REP,720026,0,0,21,21,
Tulsa,Attorney General,Mike Hunter,REP,720026,0,0,14,14,
Tulsa,Attorney General,Gentner Drummond,REP,720026,0,0,23,23,
Tulsa,Superintendent of Public Instruction,Joy Hofmeister,REP,720026,0,0,17,17,
Tulsa,Superintendent of Public Instruction,Linda Murphy,REP,720026,0,0,20,20,
Tulsa,Commissioner of Labor,Cathy Costello,REP,720026,0,0,17,17,
Tulsa,Commissioner of Labor,Leslie Osborn,REP,720026,0,0,20,20,
Tulsa,Corporation Commissioner,Bob Anthony,REP,720026,0,0,14,14,
Tulsa,Corporation Commissioner,Brian Bingman,REP,720026,0,0,23,23,
Tulsa,U.S. House,Tim Harris,REP,720026,0,0,13,13,01
Tulsa,U.S. House,Kevin Hern,REP,720026,0,0,24,24,01
Tulsa,Governor,Chris Powell,LIB,720026,0,0,0,0,
Tulsa,Governor,Rex Lawhorn,LIB,720026,0,0,1,1,
Tulsa,Corporation Commissioner,Ashley Nicole Mccray,DEM,720026,0,0,34,34,
Tulsa,Corporation Commissioner,Blake Cummings,DEM,720026,0,0,24,24,
Tulsa,U.S. House,Tim Gilpin,DEM,720026,0,0,31,31,01
Tulsa,U.S. House,Amanda Douglas,DEM,720026,0,0,28,28,01
Tulsa,Governor,Mick Cornett,REP,720027,0,0,16,16,
Tulsa,Governor,Kevin Stitt,REP,720027,0,0,27,27,
Tulsa,Lieutenant Governor,Dana Murphy,REP,720027,0,0,9,9,
Tulsa,Lieutenant Governor,Matt Pinnell,REP,720027,0,0,32,32,
Tulsa,State Auditor,Cindy Byrd,REP,720027,0,0,13,13,
Tulsa,State Auditor,Charlie Prater,REP,720027,0,0,27,27,
Tulsa,Attorney General,Mike Hunter,REP,720027,0,0,20,20,
Tulsa,Attorney General,Gentner Drummond,REP,720027,0,0,23,23,
Tulsa,Superintendent of Public Instruction,Joy Hofmeister,REP,720027,0,0,24,24,
Tulsa,Superintendent of Public Instruction,Linda Murphy,REP,720027,0,0,18,18,
Tulsa,Commissioner of Labor,Cathy Costello,REP,720027,0,0,20,20,
Tulsa,Commissioner of Labor,Leslie Osborn,REP,720027,0,0,22,22,
Tulsa,Corporation Commissioner,Bob Anthony,REP,720027,0,0,18,18,
Tulsa,Corporation Commissioner,Brian Bingman,REP,720027,0,0,24,24,
Tulsa,U.S. House,Tim Harris,REP,720027,0,0,20,20,01
Tulsa,U.S. House,Kevin Hern,REP,720027,0,0,22,22,01
Tulsa,Governor,Chris Powell,LIB,720027,0,0,0,0,
Tulsa,Governor,Rex Lawhorn,LIB,720027,0,0,0,0,
Tulsa,Corporation Commissioner,Ashley Nicole Mccray,DEM,720027,0,0,17,17,
Tulsa,Corporation Commissioner,Blake Cummings,DEM,720027,0,0,15,15,
Tulsa,U.S. House,Tim Gilpin,DEM,720027,0,0,18,18,01
Tulsa,U.S. House,Amanda Douglas,DEM,720027,0,0,14,14,01
Tulsa,Governor,Mick Cornett,REP,720028,0,0,27,27,
Tulsa,Governor,Kevin Stitt,REP,720028,0,0,59,59,
Tulsa,Lieutenant Governor,Dana Murphy,REP,720028,0,0,28,28,
Tulsa,Lieutenant Governor,Matt Pinnell,REP,720028,0,0,58,58,
Tulsa,State Auditor,Cindy Byrd,REP,720028,0,0,38,38,
Tulsa,State Auditor,Charlie Prater,REP,720028,0,0,46,46,
Tulsa,Attorney General,Mike Hunter,REP,720028,0,0,43,43,
Tulsa,Attorney General,Gentner Drummond,REP,720028,0,0,43,43,
Tulsa,Superintendent of Public Instruction,Joy Hofmeister,REP,720028,0,0,47,47,
Tulsa,Superintendent of Public Instruction,Linda Murphy,REP,720028,0,0,37,37,
Tulsa,Commissioner of Labor,Cathy Costello,REP,720028,0,0,29,29,
Tulsa,Commissioner of Labor,Leslie Osborn,REP,720028,0,0,55,55,
Tulsa,Corporation Commissioner,Bob Anthony,REP,720028,0,0,49,49,
Tulsa,Corporation Commissioner,Brian Bingman,REP,720028,0,0,37,37,
Tulsa,U.S. House,Tim Harris,REP,720028,0,0,32,32,01
Tulsa,U.S. House,Kevin Hern,REP,720028,0,0,54,54,01
Tulsa,Governor,Chris Powell,LIB,720028,0,0,0,0,
Tulsa,Governor,Rex Lawhorn,LIB,720028,0,0,0,0,
Tulsa,Corporation Commissioner,Ashley Nicole Mccray,DEM,720028,0,0,37,37,
Tulsa,Corporation Commissioner,Blake Cummings,DEM,720028,0,0,32,32,
Tulsa,U.S. House,Tim Gilpin,DEM,720028,0,0,39,39,01
Tulsa,U.S. House,Amanda Douglas,DEM,720028,0,0,30,30,01
Tulsa,Governor,Mick Cornett,REP,720029,0,0,25,25,
Tulsa,Governor,Kevin Stitt,REP,720029,0,0,51,51,
Tulsa,Lieutenant Governor,Dana Murphy,REP,720029,0,0,25,25,
Tulsa,Lieutenant Governor,Matt Pinnell,REP,720029,0,0,50,50,
Tulsa,State Auditor,Cindy Byrd,REP,720029,0,0,39,39,
Tulsa,State Auditor,Charlie Prater,REP,720029,0,0,36,36,
Tulsa,Attorney General,Mike Hunter,REP,720029,0,0,28,28,
Tulsa,Attorney General,Gentner Drummond,REP,720029,0,0,46,46,
Tulsa,Superintendent of Public Instruction,Joy Hofmeister,REP,720029,0,0,44,44,
Tulsa,Superintendent of Public Instruction,Linda Murphy,REP,720029,0,0,31,31,
Tulsa,Commissioner of Labor,Cathy Costello,REP,720029,0,0,34,34,
Tulsa,Commissioner of Labor,Leslie Osborn,REP,720029,0,0,39,39,
Tulsa,Corporation Commissioner,Bob Anthony,REP,720029,0,0,38,38,
Tulsa,Corporation Commissioner,Brian Bingman,REP,720029,0,0,37,37,
Tulsa,U.S. House,Tim Harris,REP,720029,0,0,30,30,01
Tulsa,U.S. House,Kevin Hern,REP,720029,0,0,46,46,01
Tulsa,Governor,Chris Powell,LIB,720029,0,0,1,1,
Tulsa,Governor,Rex Lawhorn,LIB,720029,0,0,1,1,
Tulsa,Corporation Commissioner,Ashley Nicole Mccray,DEM,720029,0,0,27,27,
Tulsa,Corporation Commissioner,Blake Cummings,DEM,720029,0,0,18,18,
Tulsa,U.S. House,Tim Gilpin,DEM,720029,0,0,25,25,01
Tulsa,U.S. House,Amanda Douglas,DEM,720029,0,0,21,21,01
Tulsa,Governor,Mick Cornett,REP,720030,0,0,49,49,
Tulsa,Governor,Kevin Stitt,REP,720030,0,0,44,44,
Tulsa,Lieutenant Governor,Dana Murphy,REP,720030,0,0,37,37,
Tulsa,Lieutenant Governor,Matt Pinnell,REP,720030,0,0,52,52,
Tulsa,State Auditor,Cindy Byrd,REP,720030,0,0,50,50,
Tulsa,State Auditor,Charlie Prater,REP,720030,0,0,32,32,
Tulsa,Attorney General,Mike Hunter,REP,720030,0,0,48,48,
Tulsa,Attorney General,Gentner Drummond,REP,720030,0,0,43,43,
Tulsa,Superintendent of Public Instruction,Joy Hofmeister,REP,720030,0,0,51,51,
Tulsa,Superintendent of Public Instruction,Linda Murphy,REP,720030,0,0,37,37,
Tulsa,Commissioner of Labor,Cathy Costello,REP,720030,0,0,41,41,
Tulsa,Commissioner of Labor,Leslie Osborn,REP,720030,0,0,45,45,
Tulsa,Corporation Commissioner,Bob Anthony,REP,720030,0,0,47,47,
Tulsa,Corporation Commissioner,Brian Bingman,REP,720030,0,0,39,39,
Tulsa,U.S. House,Tim Harris,REP,720030,0,0,49,49,01
Tulsa,U.S. House,Kevin Hern,REP,720030,0,0,44,44,01
Tulsa,Governor,Chris Powell,LIB,720030,0,0,0,0,
Tulsa,Governor,Rex Lawhorn,LIB,720030,0,0,1,1,
Tulsa,Corporation Commissioner,Ashley Nicole Mccray,DEM,720030,0,0,111,111,
Tulsa,Corporation Commissioner,Blake Cummings,DEM,720030,0,0,33,33,
Tulsa,U.S. House,Tim Gilpin,DEM,720030,0,0,90,90,01
Tulsa,U.S. House,Amanda Douglas,DEM,720030,0,0,62,62,01
Tulsa,Governor,Mick Cornett,REP,720031,0,0,12,12,
Tulsa,Governor,Kevin Stitt,REP,720031,0,0,19,19,
Tulsa,Lieutenant Governor,Dana Murphy,REP,720031,0,0,11,11,
Tulsa,Lieutenant Governor,Matt Pinnell,REP,720031,0,0,20,20,
Tulsa,State Auditor,Cindy Byrd,REP,720031,0,0,18,18,
Tulsa,State Auditor,Charlie Prater,REP,720031,0,0,13,13,
Tulsa,Attorney General,Mike Hunter,REP,720031,0,0,19,19,
Tulsa,Attorney General,Gentner Drummond,REP,720031,0,0,12,12,
Tulsa,Superintendent of Public Instruction,Joy Hofmeister,REP,720031,0,0,20,20,
Tulsa,Superintendent of Public Instruction,Linda Murphy,REP,720031,0,0,11,11,
Tulsa,Commissioner of Labor,Cathy Costello,REP,720031,0,0,26,26,
Tulsa,Commissioner of Labor,Leslie Osborn,REP,720031,0,0,4,4,
Tulsa,Corporation Commissioner,Bob Anthony,REP,720031,0,0,17,17,
Tulsa,Corporation Commissioner,Brian Bingman,REP,720031,0,0,12,12,
Tulsa,U.S. House,Tim Harris,REP,720031,0,0,19,19,01
Tulsa,U.S. House,Kevin Hern,REP,720031,0,0,12,12,01
Tulsa,Governor,Chris Powell,LIB,720031,0,0,0,0,
Tulsa,Governor,Rex Lawhorn,LIB,720031,0,0,0,0,
Tulsa,Corporation Commissioner,Ashley Nicole Mccray,DEM,720031,0,0,32,32,
Tulsa,Corporation Commissioner,Blake Cummings,DEM,720031,0,0,8,8,
Tulsa,U.S. House,Tim Gilpin,DEM,720031,0,0,28,28,01
Tulsa,U.S. House,Amanda Douglas,DEM,720031,0,0,12,12,01
Tulsa,Governor,Mick Cornett,REP,720032,0,0,18,18,
Tulsa,Governor,Kevin Stitt,REP,720032,0,0,25,25,
Tulsa,Lieutenant Governor,Dana Murphy,REP,720032,0,0,13,13,
Tulsa,Lieutenant Governor,Matt Pinnell,REP,720032,0,0,30,30,
Tulsa,State Auditor,Cindy Byrd,REP,720032,0,0,21,21,
Tulsa,State Auditor,Charlie Prater,REP,720032,0,0,21,21,
Tulsa,Attorney General,Mike Hunter,REP,720032,0,0,18,18,
Tulsa,Attorney General,Gentner Drummond,REP,720032,0,0,25,25,
Tulsa,Superintendent of Public Instruction,Joy Hofmeister,REP,720032,0,0,28,28,
Tulsa,Superintendent of Public Instruction,Linda Murphy,REP,720032,0,0,16,16,
Tulsa,Commissioner of Labor,Cathy Costello,REP,720032,0,0,24,24,
Tulsa,Commissioner of Labor,Leslie Osborn,REP,720032,0,0,17,17,
Tulsa,Corporation Commissioner,Bob Anthony,REP,720032,0,0,23,23,
Tulsa,Corporation Commissioner,Brian Bingman,REP,720032,0,0,18,18,
Tulsa,U.S. House,Tim Harris,REP,720032,0,0,24,24,01
Tulsa,U.S. House,Kevin Hern,REP,720032,0,0,18,18,01
Tulsa,Governor,Chris Powell,LIB,720032,0,0,1,1,
Tulsa,Governor,Rex Lawhorn,LIB,720032,0,0,0,0,
Tulsa,Corporation Commissioner,Ashley Nicole Mccray,DEM,720032,0,0,85,85,
Tulsa,Corporation Commissioner,Blake Cummings,DEM,720032,0,0,18,18,
Tulsa,U.S. House,Tim Gilpin,DEM,720032,0,0,63,63,01
Tulsa,U.S. House,Amanda Douglas,DEM,720032,0,0,43,43,01
Tulsa,Governor,Mick Cornett,REP,720033,0,0,25,25,
Tulsa,Governor,Kevin Stitt,REP,720033,0,0,28,28,
Tulsa,Lieutenant Governor,Dana Murphy,REP,720033,0,0,21,21,
Tulsa,Lieutenant Governor,Matt Pinnell,REP,720033,0,0,30,30,
Tulsa,State Auditor,Cindy Byrd,REP,720033,0,0,26,26,
Tulsa,State Auditor,Charlie Prater,REP,720033,0,0,21,21,
Tulsa,Attorney General,Mike Hunter,REP,720033,0,0,26,26,
Tulsa,Attorney General,Gentner Drummond,REP,720033,0,0,25,25,
Tulsa,Superintendent of Public Instruction,Joy Hofmeister,REP,720033,0,0,24,24,
Tulsa,Superintendent of Public Instruction,Linda Murphy,REP,720033,0,0,26,26,
Tulsa,Commissioner of Labor,Cathy Costello,REP,720033,0,0,28,28,
Tulsa,Commissioner of Labor,Leslie Osborn,REP,720033,0,0,23,23,
Tulsa,Corporation Commissioner,Bob Anthony,REP,720033,0,0,29,29,
Tulsa,Corporation Commissioner,Brian Bingman,REP,720033,0,0,17,17,
Tulsa,U.S. House,Tim Harris,REP,720033,0,0,31,31,01
Tulsa,U.S. House,Kevin Hern,REP,720033,0,0,21,21,01
Tulsa,Governor,Chris Powell,LIB,720033,0,0,0,0,
Tulsa,Governor,Rex Lawhorn,LIB,720033,0,0,0,0,
Tulsa,Corporation Commissioner,Ashley Nicole Mccray,DEM,720033,0,0,61,61,
Tulsa,Corporation Commissioner,Blake Cummings,DEM,720033,0,0,13,13,
Tulsa,U.S. House,Tim Gilpin,DEM,720033,0,0,54,54,01
Tulsa,U.S. House,Amanda Douglas,DEM,720033,0,0,23,23,01
Tulsa,Governor,Mick Cornett,REP,720034,0,0,13,13,
Tulsa,Governor,Kevin Stitt,REP,720034,0,0,24,24,
Tulsa,Lieutenant Governor,Dana Murphy,REP,720034,0,0,15,15,
Tulsa,Lieutenant Governor,Matt Pinnell,REP,720034,0,0,22,22,
Tulsa,State Auditor,Cindy Byrd,REP,720034,0,0,20,20,
Tulsa,State Auditor,Charlie Prater,REP,720034,0,0,11,11,
Tulsa,Attorney General,Mike Hunter,REP,720034,0,0,12,12,
Tulsa,Attorney General,Gentner Drummond,REP,720034,0,0,23,23,
Tulsa,Superintendent of Public Instruction,Joy Hofmeister,REP,720034,0,0,21,21,
Tulsa,Superintendent of Public Instruction,Linda Murphy,REP,720034,0,0,14,14,
Tulsa,Commissioner of Labor,Cathy Costello,REP,720034,0,0,16,16,
Tulsa,Commissioner of Labor,Leslie Osborn,REP,720034,0,0,16,16,
Tulsa,Corporation Commissioner,Bob Anthony,REP,720034,0,0,15,15,
Tulsa,Corporation Commissioner,Brian Bingman,REP,720034,0,0,16,16,
Tulsa,U.S. House,Tim Harris,REP,720034,0,0,16,16,01
Tulsa,U.S. House,Kevin Hern,REP,720034,0,0,19,19,01
Tulsa,Governor,Chris Powell,LIB,720034,0,0,0,0,
Tulsa,Governor,Rex Lawhorn,LIB,720034,0,0,1,1,
Tulsa,Corporation Commissioner,Ashley Nicole Mccray,DEM,720034,0,0,43,43,
Tulsa,Corporation Commissioner,Blake Cummings,DEM,720034,0,0,15,15,
Tulsa,U.S. House,Tim Gilpin,DEM,720034,0,0,47,47,01
Tulsa,U.S. House,Amanda Douglas,DEM,720034,0,0,14,14,01
Tulsa,Governor,Mick Cornett,REP,720035,0,0,79,79,
Tulsa,Governor,Kevin Stitt,REP,720035,0,0,90,90,
Tulsa,Lieutenant Governor,Dana Murphy,REP,720035,0,0,69,69,
Tulsa,Lieutenant Governor,Matt Pinnell,REP,720035,0,0,96,96,
Tulsa,State Auditor,Cindy Byrd,REP,720035,0,0,80,80,
Tulsa,State Auditor,Charlie Prater,REP,720035,0,0,82,82,
Tulsa,Attorney General,Mike Hunter,REP,720035,0,0,79,79,
Tulsa,Attorney General,Gentner Drummond,REP,720035,0,0,86,86,
Tulsa,Superintendent of Public Instruction,Joy Hofmeister,REP,720035,0,0,84,84,
Tulsa,Superintendent of Public Instruction,Linda Murphy,REP,720035,0,0,79,79,
Tulsa,Commissioner of Labor,Cathy Costello,REP,720035,0,0,75,75,
Tulsa,Commissioner of Labor,Leslie Osborn,REP,720035,0,0,85,85,
Tulsa,Corporation Commissioner,Bob Anthony,REP,720035,0,0,83,83,
Tulsa,Corporation Commissioner,Brian Bingman,REP,720035,0,0,81,81,
Tulsa,U.S. House,Tim Harris,REP,720035,0,0,69,69,01
Tulsa,U.S. House,Kevin Hern,REP,720035,0,0,96,96,01
Tulsa,Governor,Chris Powell,LIB,720035,0,0,1,1,
Tulsa,Governor,Rex Lawhorn,LIB,720035,0,0,0,0,
Tulsa,Corporation Commissioner,Ashley Nicole Mccray,DEM,720035,0,0,153,153,
Tulsa,Corporation Commissioner,Blake Cummings,DEM,720035,0,0,42,42,
Tulsa,U.S. House,Tim Gilpin,DEM,720035,0,0,138,138,01
Tulsa,U.S. House,Amanda Douglas,DEM,720035,0,0,60,60,01
Tulsa,Governor,Mick Cornett,REP,720036,0,0,59,59,
Tulsa,Governor,Kevin Stitt,REP,720036,0,0,104,104,
Tulsa,Lieutenant Governor,Dana Murphy,REP,720036,0,0,65,65,
Tulsa,Lieutenant Governor,Matt Pinnell,REP,720036,0,0,91,91,
Tulsa,State Auditor,Cindy Byrd,REP,720036,0,0,74,74,
Tulsa,State Auditor,Charlie Prater,REP,720036,0,0,80,80,
Tulsa,Attorney General,Mike Hunter,REP,720036,0,0,74,74,
Tulsa,Attorney General,Gentner Drummond,REP,720036,0,0,87,87,
Tulsa,Superintendent of Public Instruction,Joy Hofmeister,REP,720036,0,0,84,84,
Tulsa,Superintendent of Public Instruction,Linda Murphy,REP,720036,0,0,74,74,
Tulsa,Commissioner of Labor,Cathy Costello,REP,720036,0,0,80,80,
Tulsa,Commissioner of Labor,Leslie Osborn,REP,720036,0,0,74,74,
Tulsa,Corporation Commissioner,Bob Anthony,REP,720036,0,0,89,89,
Tulsa,Corporation Commissioner,Brian Bingman,REP,720036,0,0,65,65,
Tulsa,U.S. House,Tim Harris,REP,720036,0,0,66,66,01
Tulsa,U.S. House,Kevin Hern,REP,720036,0,0,95,95,01
Tulsa,Governor,Chris Powell,LIB,720036,0,0,0,0,
Tulsa,Governor,Rex Lawhorn,LIB,720036,0,0,1,1,
Tulsa,Corporation Commissioner,Ashley Nicole Mccray,DEM,720036,0,0,131,131,
Tulsa,Corporation Commissioner,Blake Cummings,DEM,720036,0,0,45,45,
Tulsa,U.S. House,Tim Gilpin,DEM,720036,0,0,118,118,01
Tulsa,U.S. House,Amanda Douglas,DEM,720036,0,0,59,59,01
Tulsa,Governor,Mick Cornett,REP,720037,0,0,10,10,
Tulsa,Governor,Kevin Stitt,REP,720037,0,0,4,4,
Tulsa,Lieutenant Governor,Dana Murphy,REP,720037,0,0,8,8,
Tulsa,Lieutenant Governor,Matt Pinnell,REP,720037,0,0,5,5,
Tulsa,State Auditor,Cindy Byrd,REP,720037,0,0,6,6,
Tulsa,State Auditor,Charlie Prater,REP,720037,0,0,7,7,
Tulsa,Attorney General,Mike Hunter,REP,720037,0,0,2,2,
Tulsa,Attorney General,Gentner Drummond,REP,720037,0,0,10,10,
Tulsa,Superintendent of Public Instruction,Joy Hofmeister,REP,720037,0,0,9,9,
Tulsa,Superintendent of Public Instruction,Linda Murphy,REP,720037,0,0,6,6,
Tulsa,Commissioner of Labor,Cathy Costello,REP,720037,0,0,6,6,
Tulsa,Commissioner of Labor,Leslie Osborn,REP,720037,0,0,7,7,
Tulsa,Corporation Commissioner,Bob Anthony,REP,720037,0,0,0,0,
Tulsa,Corporation Commissioner,Brian Bingman,REP,720037,0,0,13,13,
Tulsa,U.S. House,Tim Harris,REP,720037,0,0,6,6,01
Tulsa,U.S. House,Kevin Hern,REP,720037,0,0,8,8,01
Tulsa,Governor,Chris Powell,LIB,720037,0,0,0,0,
Tulsa,Governor,Rex Lawhorn,LIB,720037,0,0,0,0,
Tulsa,Corporation Commissioner,Ashley Nicole Mccray,DEM,720037,0,0,51,51,
Tulsa,Corporation Commissioner,Blake Cummings,DEM,720037,0,0,15,15,
Tulsa,U.S. House,Tim Gilpin,DEM,720037,0,0,41,41,01
Tulsa,U.S. House,Amanda Douglas,DEM,720037,0,0,27,27,01
Tulsa,Governor,Mick Cornett,REP,720038,0,0,25,25,
Tulsa,Governor,Kevin Stitt,REP,720038,0,0,64,64,
Tulsa,Lieutenant Governor,Dana Murphy,REP,720038,0,0,25,25,
Tulsa,Lieutenant Governor,Matt Pinnell,REP,720038,0,0,63,63,
Tulsa,State Auditor,Cindy Byrd,REP,720038,0,0,42,42,
Tulsa,State Auditor,Charlie Prater,REP,720038,0,0,44,44,
Tulsa,Attorney General,Mike Hunter,REP,720038,0,0,30,30,
Tulsa,Attorney General,Gentner Drummond,REP,720038,0,0,56,56,
Tulsa,Superintendent of Public Instruction,Joy Hofmeister,REP,720038,0,0,52,52,
Tulsa,Superintendent of Public Instruction,Linda Murphy,REP,720038,0,0,34,34,
Tulsa,Commissioner of Labor,Cathy Costello,REP,720038,0,0,38,38,
Tulsa,Commissioner of Labor,Leslie Osborn,REP,720038,0,0,48,48,
Tulsa,Corporation Commissioner,Bob Anthony,REP,720038,0,0,35,35,
Tulsa,Corporation Commissioner,Brian Bingman,REP,720038,0,0,51,51,
Tulsa,U.S. House,Tim Harris,REP,720038,0,0,28,28,01
Tulsa,U.S. House,Kevin Hern,REP,720038,0,0,60,60,01
Tulsa,Governor,Chris Powell,LIB,720038,0,0,0,0,
Tulsa,Governor,Rex Lawhorn,LIB,720038,0,0,0,0,
Tulsa,Corporation Commissioner,Ashley Nicole Mccray,DEM,720038,0,0,41,41,
Tulsa,Corporation Commissioner,Blake Cummings,DEM,720038,0,0,14,14,
Tulsa,U.S. House,Tim Gilpin,DEM,720038,0,0,33,33,01
Tulsa,U.S. House,Amanda Douglas,DEM,720038,0,0,22,22,01
Tulsa,Governor,Mick Cornett,REP,720039,0,0,30,30,
Tulsa,Governor,Kevin Stitt,REP,720039,0,0,78,78,
Tulsa,Lieutenant Governor,Dana Murphy,REP,720039,0,0,39,39,
Tulsa,Lieutenant Governor,Matt Pinnell,REP,720039,0,0,64,64,
Tulsa,State Auditor,Cindy Byrd,REP,720039,0,0,55,55,
Tulsa,State Auditor,Charlie Prater,REP,720039,0,0,46,46,
Tulsa,Attorney General,Mike Hunter,REP,720039,0,0,43,43,
Tulsa,Attorney General,Gentner Drummond,REP,720039,0,0,59,59,
Tulsa,Superintendent of Public Instruction,Joy Hofmeister,REP,720039,0,0,58,58,
Tulsa,Superintendent of Public Instruction,Linda Murphy,REP,720039,0,0,43,43,
Tulsa,Commissioner of Labor,Cathy Costello,REP,720039,0,0,44,44,
Tulsa,Commissioner of Labor,Leslie Osborn,REP,720039,0,0,57,57,
Tulsa,Corporation Commissioner,Bob Anthony,REP,720039,0,0,53,53,
Tulsa,Corporation Commissioner,Brian Bingman,REP,720039,0,0,48,48,
Tulsa,U.S. House,Tim Harris,REP,720039,0,0,37,37,01
Tulsa,U.S. House,Kevin Hern,REP,720039,0,0,66,66,01
Tulsa,Governor,Chris Powell,LIB,720039,0,0,1,1,
Tulsa,Governor,Rex Lawhorn,LIB,720039,0,0,1,1,
Tulsa,Corporation Commissioner,Ashley Nicole Mccray,DEM,720039,0,0,53,53,
Tulsa,Corporation Commissioner,Blake Cummings,DEM,720039,0,0,32,32,
Tulsa,U.S. House,Tim Gilpin,DEM,720039,0,0,48,48,01
Tulsa,U.S. House,Amanda Douglas,DEM,720039,0,0,41,41,01
Tulsa,Governor,Mick Cornett,REP,720040,0,0,17,17,
Tulsa,Governor,Kevin Stitt,REP,720040,0,0,19,19,
Tulsa,Lieutenant Governor,Dana Murphy,REP,720040,0,0,18,18,
Tulsa,Lieutenant Governor,Matt Pinnell,REP,720040,0,0,16,16,
Tulsa,State Auditor,Cindy Byrd,REP,720040,0,0,18,18,
Tulsa,State Auditor,Charlie Prater,REP,720040,0,0,16,16,
Tulsa,Attorney General,Mike Hunter,REP,720040,0,0,17,17,
Tulsa,Attorney General,Gentner Drummond,REP,720040,0,0,17,17,
Tulsa,Superintendent of Public Instruction,Joy Hofmeister,REP,720040,0,0,19,19,
Tulsa,Superintendent of Public Instruction,Linda Murphy,REP,720040,0,0,15,15,
Tulsa,Commissioner of Labor,Cathy Costello,REP,720040,0,0,17,17,
Tulsa,Commissioner of Labor,Leslie Osborn,REP,720040,0,0,16,16,
Tulsa,Corporation Commissioner,Bob Anthony,REP,720040,0,0,18,18,
Tulsa,Corporation Commissioner,Brian Bingman,REP,720040,0,0,16,16,
Tulsa,U.S. House,Tim Harris,REP,720040,0,0,26,26,01
Tulsa,U.S. House,Kevin Hern,REP,720040,0,0,10,10,01
Tulsa,Governor,Chris Powell,LIB,720040,0,0,1,1,
Tulsa,Governor,Rex Lawhorn,LIB,720040,0,0,0,0,
Tulsa,Corporation Commissioner,Ashley Nicole Mccray,DEM,720040,0,0,20,20,
Tulsa,Corporation Commissioner,Blake Cummings,DEM,720040,0,0,17,17,
Tulsa,U.S. House,Tim Gilpin,DEM,720040,0,0,24,24,01
Tulsa,U.S. House,Amanda Douglas,DEM,720040,0,0,13,13,01
Tulsa,Governor,Mick Cornett,REP,720041,0,0,22,22,
Tulsa,Governor,Kevin Stitt,REP,720041,0,0,38,38,
Tulsa,Lieutenant Governor,Dana Murphy,REP,720041,0,0,32,32,
Tulsa,Lieutenant Governor,Matt Pinnell,REP,720041,0,0,28,28,
Tulsa,State Auditor,Cindy Byrd,REP,720041,0,0,36,36,
Tulsa,State Auditor,Charlie Prater,REP,720041,0,0,21,21,
Tulsa,Attorney General,Mike Hunter,REP,720041,0,0,33,33,
Tulsa,Attorney General,Gentner Drummond,REP,720041,0,0,25,25,
Tulsa,Superintendent of Public Instruction,Joy Hofmeister,REP,720041,0,0,33,33,
Tulsa,Superintendent of Public Instruction,Linda Murphy,REP,720041,0,0,23,23,
Tulsa,Commissioner of Labor,Cathy Costello,REP,720041,0,0,32,32,
Tulsa,Commissioner of Labor,Leslie Osborn,REP,720041,0,0,27,27,
Tulsa,Corporation Commissioner,Bob Anthony,REP,720041,0,0,35,35,
Tulsa,Corporation Commissioner,Brian Bingman,REP,720041,0,0,23,23,
Tulsa,U.S. House,Tim Harris,REP,720041,0,0,30,30,01
Tulsa,U.S. House,Kevin Hern,REP,720041,0,0,30,30,01
Tulsa,Governor,Chris Powell,LIB,720041,0,0,0,0,
Tulsa,Governor,Rex Lawhorn,LIB,720041,0,0,0,0,
Tulsa,Corporation Commissioner,Ashley Nicole Mccray,DEM,720041,0,0,21,21,
Tulsa,Corporation Commissioner,Blake Cummings,DEM,720041,0,0,9,9,
Tulsa,U.S. House,Tim Gilpin,DEM,720041,0,0,12,12,01
Tulsa,U.S. House,Amanda Douglas,DEM,720041,0,0,17,17,01
Tulsa,Governor,Mick Cornett,REP,720042,0,0,26,26,
Tulsa,Governor,Kevin Stitt,REP,720042,0,0,63,63,
Tulsa,Lieutenant Governor,Dana Murphy,REP,720042,0,0,32,32,
Tulsa,Lieutenant Governor,Matt Pinnell,REP,720042,0,0,55,55,
Tulsa,State Auditor,Cindy Byrd,REP,720042,0,0,40,40,
Tulsa,State Auditor,Charlie Prater,REP,720042,0,0,43,43,
Tulsa,Attorney General,Mike Hunter,REP,720042,0,0,46,46,
Tulsa,Attorney General,Gentner Drummond,REP,720042,0,0,42,42,
Tulsa,Superintendent of Public Instruction,Joy Hofmeister,REP,720042,0,0,45,45,
Tulsa,Superintendent of Public Instruction,Linda Murphy,REP,720042,0,0,40,40,
Tulsa,Commissioner of Labor,Cathy Costello,REP,720042,0,0,43,43,
Tulsa,Commissioner of Labor,Leslie Osborn,REP,720042,0,0,41,41,
Tulsa,Corporation Commissioner,Bob Anthony,REP,720042,0,0,35,35,
Tulsa,Corporation Commissioner,Brian Bingman,REP,720042,0,0,51,51,
Tulsa,U.S. House,Tim Harris,REP,720042,0,0,28,28,01
Tulsa,U.S. House,Kevin Hern,REP,720042,0,0,58,58,01
Tulsa,Governor,Chris Powell,LIB,720042,0,0,0,0,
Tulsa,Governor,Rex Lawhorn,LIB,720042,0,0,0,0,
Tulsa,Corporation Commissioner,Ashley Nicole Mccray,DEM,720042,0,0,26,26,
Tulsa,Corporation Commissioner,Blake Cummings,DEM,720042,0,0,19,19,
Tulsa,U.S. House,Tim Gilpin,DEM,720042,0,0,30,30,01
Tulsa,U.S. House,Amanda Douglas,DEM,720042,0,0,16,16,01
Tulsa,Governor,Mick Cornett,REP,720043,0,0,29,29,
Tulsa,Governor,Kevin Stitt,REP,720043,0,0,63,63,
Tulsa,Lieutenant Governor,Dana Murphy,REP,720043,0,0,34,34,
Tulsa,Lieutenant Governor,Matt Pinnell,REP,720043,0,0,59,59,
Tulsa,State Auditor,Cindy Byrd,REP,720043,0,0,47,47,
Tulsa,State Auditor,Charlie Prater,REP,720043,0,0,44,44,
Tulsa,Attorney General,Mike Hunter,REP,720043,0,0,49,49,
Tulsa,Attorney General,Gentner Drummond,REP,720043,0,0,45,45,
Tulsa,Superintendent of Public Instruction,Joy Hofmeister,REP,720043,0,0,52,52,
Tulsa,Superintendent of Public Instruction,Linda Murphy,REP,720043,0,0,41,41,
Tulsa,Commissioner of Labor,Cathy Costello,REP,720043,0,0,54,54,
Tulsa,Commissioner of Labor,Leslie Osborn,REP,720043,0,0,38,38,
Tulsa,Corporation Commissioner,Bob Anthony,REP,720043,0,0,53,53,
Tulsa,Corporation Commissioner,Brian Bingman,REP,720043,0,0,38,38,
Tulsa,U.S. House,Tim Harris,REP,720043,0,0,31,31,01
Tulsa,U.S. House,Kevin Hern,REP,720043,0,0,62,62,01
Tulsa,Governor,Chris Powell,LIB,720043,0,0,0,0,
Tulsa,Governor,Rex Lawhorn,LIB,720043,0,0,0,0,
Tulsa,Corporation Commissioner,Ashley Nicole Mccray,DEM,720043,0,0,34,34,
Tulsa,Corporation Commissioner,Blake Cummings,DEM,720043,0,0,12,12,
Tulsa,U.S. House,Tim Gilpin,DEM,720043,0,0,29,29,01
Tulsa,U.S. House,Amanda Douglas,DEM,720043,0,0,18,18,01
Tulsa,Governor,Mick Cornett,REP,720044,0,0,55,55,
Tulsa,Governor,Kevin Stitt,REP,720044,0,0,118,118,
Tulsa,Lieutenant Governor,Dana Murphy,REP,720044,0,0,64,64,
Tulsa,Lieutenant Governor,Matt Pinnell,REP,720044,0,0,106,106,
Tulsa,State Auditor,Cindy Byrd,REP,720044,0,0,83,83,
Tulsa,State Auditor,Charlie Prater,REP,720044,0,0,83,83,
Tulsa,Attorney General,Mike Hunter,REP,720044,0,0,72,72,
Tulsa,Attorney General,Gentner Drummond,REP,720044,0,0,100,100,
Tulsa,Superintendent of Public Instruction,Joy Hofmeister,REP,720044,0,0,78,78,
Tulsa,Superintendent of Public Instruction,Linda Murphy,REP,720044,0,0,93,93,
Tulsa,Commissioner of Labor,Cathy Costello,REP,720044,0,0,77,77,
Tulsa,Commissioner of Labor,Leslie Osborn,REP,720044,0,0,89,89,
Tulsa,Corporation Commissioner,Bob Anthony,REP,720044,0,0,92,92,
Tulsa,Corporation Commissioner,Brian Bingman,REP,720044,0,0,77,77,
Tulsa,U.S. House,Tim Harris,REP,720044,0,0,82,82,01
Tulsa,U.S. House,Kevin Hern,REP,720044,0,0,88,88,01
Tulsa,Governor,Chris Powell,LIB,720044,0,0,0,0,
Tulsa,Governor,Rex Lawhorn,LIB,720044,0,0,2,2,
Tulsa,Corporation Commissioner,Ashley Nicole Mccray,DEM,720044,0,0,30,30,
Tulsa,Corporation Commissioner,Blake Cummings,DEM,720044,0,0,21,21,
Tulsa,U.S. House,Tim Gilpin,DEM,720044,0,0,33,33,01
Tulsa,U.S. House,Amanda Douglas,DEM,720044,0,0,20,20,01
Tulsa,Governor,Mick Cornett,REP,720045,0,0,0,0,
Tulsa,Governor,Kevin Stitt,REP,720045,0,0,2,2,
Tulsa,Lieutenant Governor,Dana Murphy,REP,720045,0,0,1,1,
Tulsa,Lieutenant Governor,Matt Pinnell,REP,720045,0,0,1,1,
Tulsa,State Auditor,Cindy Byrd,REP,720045,0,0,0,0,
Tulsa,State Auditor,Charlie Prater,REP,720045,0,0,2,2,
Tulsa,Attorney General,Mike Hunter,REP,720045,0,0,0,0,
Tulsa,Attorney General,Gentner Drummond,REP,720045,0,0,2,2,
Tulsa,Superintendent of Public Instruction,Joy Hofmeister,REP,720045,0,0,2,2,
Tulsa,Superintendent of Public Instruction,Linda Murphy,REP,720045,0,0,0,0,
Tulsa,Commissioner of Labor,Cathy Costello,REP,720045,0,0,2,2,
Tulsa,Commissioner of Labor,Leslie Osborn,REP,720045,0,0,0,0,
Tulsa,Corporation Commissioner,Bob Anthony,REP,720045,0,0,1,1,
Tulsa,Corporation Commissioner,Brian Bingman,REP,720045,0,0,1,1,
Tulsa,U.S. House,Tim Harris,REP,720045,0,0,0,0,01
Tulsa,U.S. House,Kevin Hern,REP,720045,0,0,2,2,01
Tulsa,State Senate,John Haste,REP,720045,0,0,2,2,36
Tulsa,State Senate,Bill Day,REP,720045,0,0,0,0,36
Tulsa,Governor,Chris Powell,LIB,720045,0,0,0,0,
Tulsa,Governor,Rex Lawhorn,LIB,720045,0,0,0,0,
Tulsa,Corporation Commissioner,Ashley Nicole Mccray,DEM,720045,0,0,0,0,
Tulsa,Corporation Commissioner,Blake Cummings,DEM,720045,0,0,0,0,
Tulsa,U.S. House,Tim Gilpin,DEM,720045,0,0,0,0,01
Tulsa,U.S. House,Amanda Douglas,DEM,720045,0,0,0,0,01
Tulsa,Governor,Mick Cornett,REP,720046,0,0,110,110,
Tulsa,Governor,Kevin Stitt,REP,720046,0,0,103,103,
Tulsa,Lieutenant Governor,Dana Murphy,REP,720046,0,0,86,86,
Tulsa,Lieutenant Governor,Matt Pinnell,REP,720046,0,0,117,117,
Tulsa,State Auditor,Cindy Byrd,REP,720046,0,0,95,95,
Tulsa,State Auditor,Charlie Prater,REP,720046,0,0,92,92,
Tulsa,Attorney General,Mike Hunter,REP,720046,0,0,74,74,
Tulsa,Attorney General,Gentner Drummond,REP,720046,0,0,137,137,
Tulsa,Superintendent of Public Instruction,Joy Hofmeister,REP,720046,0,0,117,117,
Tulsa,Superintendent of Public Instruction,Linda Murphy,REP,720046,0,0,86,86,
Tulsa,Commissioner of Labor,Cathy Costello,REP,720046,0,0,98,98,
Tulsa,Commissioner of Labor,Leslie Osborn,REP,720046,0,0,98,98,
Tulsa,Corporation Commissioner,Bob Anthony,REP,720046,0,0,89,89,
Tulsa,Corporation Commissioner,Brian Bingman,REP,720046,0,0,101,101,
Tulsa,U.S. House,Tim Harris,REP,720046,0,0,106,106,01
Tulsa,U.S. House,Kevin Hern,REP,720046,0,0,100,100,01
Tulsa,State House,Jadine Nollan,REP,720046,0,0,108,108,66
Tulsa,State House,Brian Jackson,REP,720046,0,0,84,84,66
Tulsa,Governor,Chris Powell,LIB,720046,0,0,3,3,
Tulsa,Governor,Rex Lawhorn,LIB,720046,0,0,0,0,
Tulsa,Corporation Commissioner,Ashley Nicole Mccray,DEM,720046,0,0,247,247,
Tulsa,Corporation Commissioner,Blake Cummings,DEM,720046,0,0,75,75,
Tulsa,U.S. House,Tim Gilpin,DEM,720046,0,0,250,250,01
Tulsa,U.S. House,Amanda Douglas,DEM,720046,0,0,83,83,01
Tulsa,Governor,Mick Cornett,REP,720047,0,0,9,9,
Tulsa,Governor,Kevin Stitt,REP,720047,0,0,8,8,
Tulsa,Lieutenant Governor,Dana Murphy,REP,720047,0,0,7,7,
Tulsa,Lieutenant Governor,Matt Pinnell,REP,720047,0,0,10,10,
Tulsa,State Auditor,Cindy Byrd,REP,720047,0,0,12,12,
Tulsa,State Auditor,Charlie Prater,REP,720047,0,0,4,4,
Tulsa,Attorney General,Mike Hunter,REP,720047,0,0,10,10,
Tulsa,Attorney General,Gentner Drummond,REP,720047,0,0,6,6,
Tulsa,Superintendent of Public Instruction,Joy Hofmeister,REP,720047,0,0,10,10,
Tulsa,Superintendent of Public Instruction,Linda Murphy,REP,720047,0,0,6,6,
Tulsa,Commissioner of Labor,Cathy Costello,REP,720047,0,0,8,8,
Tulsa,Commissioner of Labor,Leslie Osborn,REP,720047,0,0,6,6,
Tulsa,Corporation Commissioner,Bob Anthony,REP,720047,0,0,5,5,
Tulsa,Corporation Commissioner,Brian Bingman,REP,720047,0,0,9,9,
Tulsa,U.S. House,Tim Harris,REP,720047,0,0,9,9,01
Tulsa,U.S. House,Kevin Hern,REP,720047,0,0,7,7,01
Tulsa,Governor,Chris Powell,LIB,720047,0,0,0,0,
Tulsa,Governor,Rex Lawhorn,LIB,720047,0,0,1,1,
Tulsa,Corporation Commissioner,Ashley Nicole Mccray,DEM,720047,0,0,29,29,
Tulsa,Corporation Commissioner,Blake Cummings,DEM,720047,0,0,7,7,
Tulsa,U.S. House,Tim Gilpin,DEM,720047,0,0,23,23,01
Tulsa,U.S. House,Amanda Douglas,DEM,720047,0,0,13,13,01
Tulsa,Governor,Mick Cornett,REP,720048,0,0,88,88,
Tulsa,Governor,Kevin Stitt,REP,720048,0,0,78,78,
Tulsa,Lieutenant Governor,Dana Murphy,REP,720048,0,0,77,77,
Tulsa,Lieutenant Governor,Matt Pinnell,REP,720048,0,0,81,81,
Tulsa,State Auditor,Cindy Byrd,REP,720048,0,0,75,75,
Tulsa,State Auditor,Charlie Prater,REP,720048,0,0,67,67,
Tulsa,Attorney General,Mike Hunter,REP,720048,0,0,69,69,
Tulsa,Attorney General,Gentner Drummond,REP,720048,0,0,91,91,
Tulsa,Superintendent of Public Instruction,Joy Hofmeister,REP,720048,0,0,104,104,
Tulsa,Superintendent of Public Instruction,Linda Murphy,REP,720048,0,0,46,46,
Tulsa,Commissioner of Labor,Cathy Costello,REP,720048,0,0,68,68,
Tulsa,Commissioner of Labor,Leslie Osborn,REP,720048,0,0,83,83,
Tulsa,Corporation Commissioner,Bob Anthony,REP,720048,0,0,79,79,
Tulsa,Corporation Commissioner,Brian Bingman,REP,720048,0,0,69,69,
Tulsa,U.S. House,Tim Harris,REP,720048,0,0,93,93,01
Tulsa,U.S. House,Kevin Hern,REP,720048,0,0,67,67,01
Tulsa,Governor,Chris Powell,LIB,720048,0,0,0,0,
Tulsa,Governor,Rex Lawhorn,LIB,720048,0,0,1,1,
Tulsa,Corporation Commissioner,Ashley Nicole Mccray,DEM,720048,0,0,201,201,
Tulsa,Corporation Commissioner,Blake Cummings,DEM,720048,0,0,41,41,
Tulsa,U.S. House,Tim Gilpin,DEM,720048,0,0,190,190,01
Tulsa,U.S. House,Amanda Douglas,DEM,720048,0,0,68,68,01
Tulsa,Governor,Mick Cornett,REP,720049,0,0,17,17,
Tulsa,Governor,Kevin Stitt,REP,720049,0,0,29,29,
Tulsa,Lieutenant Governor,Dana Murphy,REP,720049,0,0,27,27,
Tulsa,Lieutenant Governor,Matt Pinnell,REP,720049,0,0,19,19,
Tulsa,State Auditor,Cindy Byrd,REP,720049,0,0,22,22,
Tulsa,State Auditor,Charlie Prater,REP,720049,0,0,22,22,
Tulsa,Attorney General,Mike Hunter,REP,720049,0,0,24,24,
Tulsa,Attorney General,Gentner Drummond,REP,720049,0,0,22,22,
Tulsa,Superintendent of Public Instruction,Joy Hofmeister,REP,720049,0,0,28,28,
Tulsa,Superintendent of Public Instruction,Linda Murphy,REP,720049,0,0,18,18,
Tulsa,Commissioner of Labor,Cathy Costello,REP,720049,0,0,23,23,
Tulsa,Commissioner of Labor,Leslie Osborn,REP,720049,0,0,22,22,
Tulsa,Corporation Commissioner,Bob Anthony,REP,720049,0,0,25,25,
Tulsa,Corporation Commissioner,Brian Bingman,REP,720049,0,0,19,19,
Tulsa,U.S. House,Tim Harris,REP,720049,0,0,20,20,01
Tulsa,U.S. House,Kevin Hern,REP,720049,0,0,24,24,01
Tulsa,Governor,Chris Powell,LIB,720049,0,0,0,0,
Tulsa,Governor,Rex Lawhorn,LIB,720049,0,0,0,0,
Tulsa,Corporation Commissioner,Ashley Nicole Mccray,DEM,720049,0,0,86,86,
Tulsa,Corporation Commissioner,Blake Cummings,DEM,720049,0,0,17,17,
Tulsa,U.S. House,Tim Gilpin,DEM,720049,0,0,66,66,01
Tulsa,U.S. House,Amanda Douglas,DEM,720049,0,0,39,39,01
Tulsa,Governor,Mick Cornett,REP,720050,0,0,49,49,
Tulsa,Governor,Kevin Stitt,REP,720050,0,0,43,43,
Tulsa,Lieutenant Governor,Dana Murphy,REP,720050,0,0,30,30,
Tulsa,Lieutenant Governor,Matt Pinnell,REP,720050,0,0,58,58,
Tulsa,State Auditor,Cindy Byrd,REP,720050,0,0,43,43,
Tulsa,State Auditor,Charlie Prater,REP,720050,0,0,35,35,
Tulsa,Attorney General,Mike Hunter,REP,720050,0,0,38,38,
Tulsa,Attorney General,Gentner Drummond,REP,720050,0,0,49,49,
Tulsa,Superintendent of Public Instruction,Joy Hofmeister,REP,720050,0,0,53,53,
Tulsa,Superintendent of Public Instruction,Linda Murphy,REP,720050,0,0,34,34,
Tulsa,Commissioner of Labor,Cathy Costello,REP,720050,0,0,44,44,
Tulsa,Commissioner of Labor,Leslie Osborn,REP,720050,0,0,37,37,
Tulsa,Corporation Commissioner,Bob Anthony,REP,720050,0,0,42,42,
Tulsa,Corporation Commissioner,Brian Bingman,REP,720050,0,0,41,41,
Tulsa,U.S. House,Tim Harris,REP,720050,0,0,52,52,01
Tulsa,U.S. House,Kevin Hern,REP,720050,0,0,39,39,01
Tulsa,Governor,Chris Powell,LIB,720050,0,0,0,0,
Tulsa,Governor,Rex Lawhorn,LIB,720050,0,0,0,0,
Tulsa,Corporation Commissioner,Ashley Nicole Mccray,DEM,720050,0,0,115,115,
Tulsa,Corporation Commissioner,Blake Cummings,DEM,720050,0,0,32,32,
Tulsa,U.S. House,Tim Gilpin,DEM,720050,0,0,125,125,01
Tulsa,U.S. House,Amanda Douglas,DEM,720050,0,0,29,29,01
Tulsa,Governor,Mick Cornett,REP,720051,0,0,51,51,
Tulsa,Governor,Kevin Stitt,REP,720051,0,0,65,65,
Tulsa,Lieutenant Governor,Dana Murphy,REP,720051,0,0,52,52,
Tulsa,Lieutenant Governor,Matt Pinnell,REP,720051,0,0,57,57,
Tulsa,State Auditor,Cindy Byrd,REP,720051,0,0,62,62,
Tulsa,State Auditor,Charlie Prater,REP,720051,0,0,40,40,
Tulsa,Attorney General,Mike Hunter,REP,720051,0,0,47,47,
Tulsa,Attorney General,Gentner Drummond,REP,720051,0,0,66,66,
Tulsa,Superintendent of Public Instruction,Joy Hofmeister,REP,720051,0,0,53,53,
Tulsa,Superintendent of Public Instruction,Linda Murphy,REP,720051,0,0,55,55,
Tulsa,Commissioner of Labor,Cathy Costello,REP,720051,0,0,50,50,
Tulsa,Commissioner of Labor,Leslie Osborn,REP,720051,0,0,52,52,
Tulsa,Corporation Commissioner,Bob Anthony,REP,720051,0,0,54,54,
Tulsa,Corporation Commissioner,Brian Bingman,REP,720051,0,0,50,50,
Tulsa,U.S. House,Tim Harris,REP,720051,0,0,56,56,01
Tulsa,U.S. House,Kevin Hern,REP,720051,0,0,55,55,01
Tulsa,Governor,Chris Powell,LIB,720051,0,0,0,0,
Tulsa,Governor,Rex Lawhorn,LIB,720051,0,0,2,2,
Tulsa,Corporation Commissioner,Ashley Nicole Mccray,DEM,720051,0,0,131,131,
Tulsa,Corporation Commissioner,Blake Cummings,DEM,720051,0,0,42,42,
Tulsa,U.S. House,Tim Gilpin,DEM,720051,0,0,127,127,01
Tulsa,U.S. House,Amanda Douglas,DEM,720051,0,0,53,53,01
Tulsa,Governor,Mick Cornett,REP,720052,0,0,127,127,
Tulsa,Governor,Kevin Stitt,REP,720052,0,0,126,126,
Tulsa,Lieutenant Governor,Dana Murphy,REP,720052,0,0,102,102,
Tulsa,Lieutenant Governor,Matt Pinnell,REP,720052,0,0,141,141,
Tulsa,State Auditor,Cindy Byrd,REP,720052,0,0,131,131,
Tulsa,State Auditor,Charlie Prater,REP,720052,0,0,93,93,
Tulsa,Attorney General,Mike Hunter,REP,720052,0,0,113,113,
Tulsa,Attorney General,Gentner Drummond,REP,720052,0,0,134,134,
Tulsa,Superintendent of Public Instruction,Joy Hofmeister,REP,720052,0,0,132,132,
Tulsa,Superintendent of Public Instruction,Linda Murphy,REP,720052,0,0,101,101,
Tulsa,Commissioner of Labor,Cathy Costello,REP,720052,0,0,125,125,
Tulsa,Commissioner of Labor,Leslie Osborn,REP,720052,0,0,104,104,
Tulsa,Corporation Commissioner,Bob Anthony,REP,720052,0,0,138,138,
Tulsa,Corporation Commissioner,Brian Bingman,REP,720052,0,0,89,89,
Tulsa,U.S. House,Tim Harris,REP,720052,0,0,125,125,01
Tulsa,U.S. House,Kevin Hern,REP,720052,0,0,120,120,01
Tulsa,Governor,Chris Powell,LIB,720052,0,0,0,0,
Tulsa,Governor,Rex Lawhorn,LIB,720052,0,0,1,1,
Tulsa,Corporation Commissioner,Ashley Nicole Mccray,DEM,720052,0,0,258,258,
Tulsa,Corporation Commissioner,Blake Cummings,DEM,720052,0,0,58,58,
Tulsa,U.S. House,Tim Gilpin,DEM,720052,0,0,267,267,01
Tulsa,U.S. House,Amanda Douglas,DEM,720052,0,0,69,69,01
Tulsa,Governor,Mick Cornett,REP,720053,0,0,65,65,
Tulsa,Governor,Kevin Stitt,REP,720053,0,0,114,114,
Tulsa,Lieutenant Governor,Dana Murphy,REP,720053,0,0,68,68,
Tulsa,Lieutenant Governor,Matt Pinnell,REP,720053,0,0,107,107,
Tulsa,State Auditor,Cindy Byrd,REP,720053,0,0,81,81,
Tulsa,State Auditor,Charlie Prater,REP,720053,0,0,92,92,
Tulsa,Attorney General,Mike Hunter,REP,720053,0,0,84,84,
Tulsa,Attorney General,Gentner Drummond,REP,720053,0,0,93,93,
Tulsa,Superintendent of Public Instruction,Joy Hofmeister,REP,720053,0,0,98,98,
Tulsa,Superintendent of Public Instruction,Linda Murphy,REP,720053,0,0,80,80,
Tulsa,Commissioner of Labor,Cathy Costello,REP,720053,0,0,80,80,
Tulsa,Commissioner of Labor,Leslie Osborn,REP,720053,0,0,90,90,
Tulsa,Corporation Commissioner,Bob Anthony,REP,720053,0,0,77,77,
Tulsa,Corporation Commissioner,Brian Bingman,REP,720053,0,0,98,98,
Tulsa,U.S. House,Tim Harris,REP,720053,0,0,77,77,01
Tulsa,U.S. House,Kevin Hern,REP,720053,0,0,103,103,01
Tulsa,Governor,Chris Powell,LIB,720053,0,0,1,1,
Tulsa,Governor,Rex Lawhorn,LIB,720053,0,0,0,0,
Tulsa,Corporation Commissioner,Ashley Nicole Mccray,DEM,720053,0,0,62,62,
Tulsa,Corporation Commissioner,Blake Cummings,DEM,720053,0,0,40,40,
Tulsa,U.S. House,Tim Gilpin,DEM,720053,0,0,64,64,01
Tulsa,U.S. House,Amanda Douglas,DEM,720053,0,0,39,39,01
Tulsa,Governor,Mick Cornett,REP,720054,0,0,88,88,
Tulsa,Governor,Kevin Stitt,REP,720054,0,0,112,112,
Tulsa,Lieutenant Governor,Dana Murphy,REP,720054,0,0,71,71,
Tulsa,Lieutenant Governor,Matt Pinnell,REP,720054,0,0,123,123,
Tulsa,State Auditor,Cindy Byrd,REP,720054,0,0,106,106,
Tulsa,State Auditor,Charlie Prater,REP,720054,0,0,79,79,
Tulsa,Attorney General,Mike Hunter,REP,720054,0,0,105,105,
Tulsa,Attorney General,Gentner Drummond,REP,720054,0,0,90,90,
Tulsa,Superintendent of Public Instruction,Joy Hofmeister,REP,720054,0,0,87,87,
Tulsa,Superintendent of Public Instruction,Linda Murphy,REP,720054,0,0,109,109,
Tulsa,Commissioner of Labor,Cathy Costello,REP,720054,0,0,117,117,
Tulsa,Commissioner of Labor,Leslie Osborn,REP,720054,0,0,75,75,
Tulsa,Corporation Commissioner,Bob Anthony,REP,720054,0,0,96,96,
Tulsa,Corporation Commissioner,Brian Bingman,REP,720054,0,0,89,89,
Tulsa,U.S. House,Tim Harris,REP,720054,0,0,97,97,01
Tulsa,U.S. House,Kevin Hern,REP,720054,0,0,102,102,01
Tulsa,Governor,Chris Powell,LIB,720054,0,0,1,1,
Tulsa,Governor,Rex Lawhorn,LIB,720054,0,0,0,0,
Tulsa,Corporation Commissioner,Ashley Nicole Mccray,DEM,720054,0,0,201,201,
Tulsa,Corporation Commissioner,Blake Cummings,DEM,720054,0,0,65,65,
Tulsa,U.S. House,Tim Gilpin,DEM,720054,0,0,186,186,01
Tulsa,U.S. House,Amanda Douglas,DEM,720054,0,0,87,87,01
Tulsa,Governor,Mick Cornett,REP,720055,0,0,37,37,
Tulsa,Governor,Kevin Stitt,REP,720055,0,0,78,78,
Tulsa,Lieutenant Governor,Dana Murphy,REP,720055,0,0,47,47,
Tulsa,Lieutenant Governor,Matt Pinnell,REP,720055,0,0,60,60,
Tulsa,State Auditor,Cindy Byrd,REP,720055,0,0,63,63,
Tulsa,State Auditor,Charlie Prater,REP,720055,0,0,45,45,
Tulsa,Attorney General,Mike Hunter,REP,720055,0,0,49,49,
Tulsa,Attorney General,Gentner Drummond,REP,720055,0,0,61,61,
Tulsa,Superintendent of Public Instruction,Joy Hofmeister,REP,720055,0,0,60,60,
Tulsa,Superintendent of Public Instruction,Linda Murphy,REP,720055,0,0,51,51,
Tulsa,Commissioner of Labor,Cathy Costello,REP,720055,0,0,54,54,
Tulsa,Commissioner of Labor,Leslie Osborn,REP,720055,0,0,51,51,
Tulsa,Corporation Commissioner,Bob Anthony,REP,720055,0,0,60,60,
Tulsa,Corporation Commissioner,Brian Bingman,REP,720055,0,0,48,48,
Tulsa,U.S. House,Tim Harris,REP,720055,0,0,43,43,01
Tulsa,U.S. House,Kevin Hern,REP,720055,0,0,69,69,01
Tulsa,Governor,Chris Powell,LIB,720055,0,0,0,0,
Tulsa,Governor,Rex Lawhorn,LIB,720055,0,0,1,1,
Tulsa,Corporation Commissioner,Ashley Nicole Mccray,DEM,720055,0,0,75,75,
Tulsa,Corporation Commissioner,Blake Cummings,DEM,720055,0,0,24,24,
Tulsa,U.S. House,Tim Gilpin,DEM,720055,0,0,54,54,01
Tulsa,U.S. House,Amanda Douglas,DEM,720055,0,0,46,46,01
Tulsa,Governor,Mick Cornett,REP,720056,0,0,64,64,
Tulsa,Governor,Kevin Stitt,REP,720056,0,0,113,113,
Tulsa,Lieutenant Governor,Dana Murphy,REP,720056,0,0,73,73,
Tulsa,Lieutenant Governor,Matt Pinnell,REP,720056,0,0,102,102,
Tulsa,State Auditor,Cindy Byrd,REP,720056,0,0,98,98,
Tulsa,State Auditor,Charlie Prater,REP,720056,0,0,69,69,
Tulsa,Attorney General,Mike Hunter,REP,720056,0,0,74,74,
Tulsa,Attorney General,Gentner Drummond,REP,720056,0,0,99,99,
Tulsa,Superintendent of Public Instruction,Joy Hofmeister,REP,720056,0,0,82,82,
Tulsa,Superintendent of Public Instruction,Linda Murphy,REP,720056,0,0,87,87,
Tulsa,Commissioner of Labor,Cathy Costello,REP,720056,0,0,94,94,
Tulsa,Commissioner of Labor,Leslie Osborn,REP,720056,0,0,75,75,
Tulsa,Corporation Commissioner,Bob Anthony,REP,720056,0,0,85,85,
Tulsa,Corporation Commissioner,Brian Bingman,REP,720056,0,0,80,80,
Tulsa,U.S. House,Tim Harris,REP,720056,0,0,79,79,01
Tulsa,U.S. House,Kevin Hern,REP,720056,0,0,97,97,01
Tulsa,Governor,Chris Powell,LIB,720056,0,0,1,1,
Tulsa,Governor,Rex Lawhorn,LIB,720056,0,0,0,0,
Tulsa,Corporation Commissioner,Ashley Nicole Mccray,DEM,720056,0,0,57,57,
Tulsa,Corporation Commissioner,Blake Cummings,DEM,720056,0,0,29,29,
Tulsa,U.S. House,Tim Gilpin,DEM,720056,0,0,49,49,01
Tulsa,U.S. House,Amanda Douglas,DEM,720056,0,0,36,36,01
Tulsa,Governor,Mick Cornett,REP,720057,0,0,15,15,
Tulsa,Governor,Kevin Stitt,REP,720057,0,0,53,53,
Tulsa,Lieutenant Governor,Dana Murphy,REP,720057,0,0,22,22,
Tulsa,Lieutenant Governor,Matt Pinnell,REP,720057,0,0,45,45,
Tulsa,State Auditor,Cindy Byrd,REP,720057,0,0,31,31,
Tulsa,State Auditor,Charlie Prater,REP,720057,0,0,31,31,
Tulsa,Attorney General,Mike Hunter,REP,720057,0,0,34,34,
Tulsa,Attorney General,Gentner Drummond,REP,720057,0,0,34,34,
Tulsa,Superintendent of Public Instruction,Joy Hofmeister,REP,720057,0,0,25,25,
Tulsa,Superintendent of Public Instruction,Linda Murphy,REP,720057,0,0,43,43,
Tulsa,Commissioner of Labor,Cathy Costello,REP,720057,0,0,34,34,
Tulsa,Commissioner of Labor,Leslie Osborn,REP,720057,0,0,34,34,
Tulsa,Corporation Commissioner,Bob Anthony,REP,720057,0,0,29,29,
Tulsa,Corporation Commissioner,Brian Bingman,REP,720057,0,0,36,36,
Tulsa,U.S. House,Tim Harris,REP,720057,0,0,32,32,01
Tulsa,U.S. House,Kevin Hern,REP,720057,0,0,35,35,01
Tulsa,Governor,Chris Powell,LIB,720057,0,0,2,2,
Tulsa,Governor,Rex Lawhorn,LIB,720057,0,0,0,0,
Tulsa,Corporation Commissioner,Ashley Nicole Mccray,DEM,720057,0,0,22,22,
Tulsa,Corporation Commissioner,Blake Cummings,DEM,720057,0,0,5,5,
Tulsa,U.S. House,Tim Gilpin,DEM,720057,0,0,14,14,01
Tulsa,U.S. House,Amanda Douglas,DEM,720057,0,0,13,13,01
Tulsa,Governor,Mick Cornett,REP,720058,0,0,39,39,
Tulsa,Governor,Kevin Stitt,REP,720058,0,0,76,76,
Tulsa,Lieutenant Governor,Dana Murphy,REP,720058,0,0,34,34,
Tulsa,Lieutenant Governor,Matt Pinnell,REP,720058,0,0,82,82,
Tulsa,State Auditor,Cindy Byrd,REP,720058,0,0,49,49,
Tulsa,State Auditor,Charlie Prater,REP,720058,0,0,62,62,
Tulsa,Attorney General,Mike Hunter,REP,720058,0,0,58,58,
Tulsa,Attorney General,Gentner Drummond,REP,720058,0,0,57,57,
Tulsa,Superintendent of Public Instruction,Joy Hofmeister,REP,720058,0,0,57,57,
Tulsa,Superintendent of Public Instruction,Linda Murphy,REP,720058,0,0,56,56,
Tulsa,Commissioner of Labor,Cathy Costello,REP,720058,0,0,60,60,
Tulsa,Commissioner of Labor,Leslie Osborn,REP,720058,0,0,52,52,
Tulsa,Corporation Commissioner,Bob Anthony,REP,720058,0,0,63,63,
Tulsa,Corporation Commissioner,Brian Bingman,REP,720058,0,0,49,49,
Tulsa,U.S. House,Tim Harris,REP,720058,0,0,51,51,01
Tulsa,U.S. House,Kevin Hern,REP,720058,0,0,63,63,01
Tulsa,Governor,Chris Powell,LIB,720058,0,0,0,0,
Tulsa,Governor,Rex Lawhorn,LIB,720058,0,0,0,0,
Tulsa,Corporation Commissioner,Ashley Nicole Mccray,DEM,720058,0,0,35,35,
Tulsa,Corporation Commissioner,Blake Cummings,DEM,720058,0,0,16,16,
Tulsa,U.S. House,Tim Gilpin,DEM,720058,0,0,36,36,01
Tulsa,U.S. House,Amanda Douglas,DEM,720058,0,0,15,15,01
Tulsa,Governor,Mick Cornett,REP,720059,0,0,29,29,
Tulsa,Governor,Kevin Stitt,REP,720059,0,0,55,55,
Tulsa,Lieutenant Governor,Dana Murphy,REP,720059,0,0,26,26,
Tulsa,Lieutenant Governor,Matt Pinnell,REP,720059,0,0,57,57,
Tulsa,State Auditor,Cindy Byrd,REP,720059,0,0,40,40,
Tulsa,State Auditor,Charlie Prater,REP,720059,0,0,44,44,
Tulsa,Attorney General,Mike Hunter,REP,720059,0,0,35,35,
Tulsa,Attorney General,Gentner Drummond,REP,720059,0,0,48,48,
Tulsa,Superintendent of Public Instruction,Joy Hofmeister,REP,720059,0,0,43,43,
Tulsa,Superintendent of Public Instruction,Linda Murphy,REP,720059,0,0,40,40,
Tulsa,Commissioner of Labor,Cathy Costello,REP,720059,0,0,43,43,
Tulsa,Commissioner of Labor,Leslie Osborn,REP,720059,0,0,39,39,
Tulsa,Corporation Commissioner,Bob Anthony,REP,720059,0,0,40,40,
Tulsa,Corporation Commissioner,Brian Bingman,REP,720059,0,0,44,44,
Tulsa,U.S. House,Tim Harris,REP,720059,0,0,37,37,01
Tulsa,U.S. House,Kevin Hern,REP,720059,0,0,48,48,01
Tulsa,Governor,Chris Powell,LIB,720059,0,0,0,0,
Tulsa,Governor,Rex Lawhorn,LIB,720059,0,0,0,0,
Tulsa,Corporation Commissioner,Ashley Nicole Mccray,DEM,720059,0,0,31,31,
Tulsa,Corporation Commissioner,Blake Cummings,DEM,720059,0,0,16,16,
Tulsa,U.S. House,Tim Gilpin,DEM,720059,0,0,29,29,01
Tulsa,U.S. House,Amanda Douglas,DEM,720059,0,0,19,19,01
Tulsa,Governor,Mick Cornett,REP,720060,0,0,39,39,
Tulsa,Governor,Kevin Stitt,REP,720060,0,0,59,59,
Tulsa,Lieutenant Governor,Dana Murphy,REP,720060,0,0,36,36,
Tulsa,Lieutenant Governor,Matt Pinnell,REP,720060,0,0,61,61,
Tulsa,State Auditor,Cindy Byrd,REP,720060,0,0,53,53,
Tulsa,State Auditor,Charlie Prater,REP,720060,0,0,43,43,
Tulsa,Attorney General,Mike Hunter,REP,720060,0,0,42,42,
Tulsa,Attorney General,Gentner Drummond,REP,720060,0,0,56,56,
Tulsa,Superintendent of Public Instruction,Joy Hofmeister,REP,720060,0,0,46,46,
Tulsa,Superintendent of Public Instruction,Linda Murphy,REP,720060,0,0,51,51,
Tulsa,Commissioner of Labor,Cathy Costello,REP,720060,0,0,50,50,
Tulsa,Commissioner of Labor,Leslie Osborn,REP,720060,0,0,47,47,
Tulsa,Corporation Commissioner,Bob Anthony,REP,720060,0,0,52,52,
Tulsa,Corporation Commissioner,Brian Bingman,REP,720060,0,0,43,43,
Tulsa,U.S. House,Tim Harris,REP,720060,0,0,35,35,01
Tulsa,U.S. House,Kevin Hern,REP,720060,0,0,64,64,01
Tulsa,State Senate,John Haste,REP,720060,0,0,58,58,36
Tulsa,State Senate,Bill Day,REP,720060,0,0,37,37,36
Tulsa,Governor,Chris Powell,LIB,720060,0,0,0,0,
Tulsa,Governor,Rex Lawhorn,LIB,720060,0,0,0,0,
Tulsa,Corporation Commissioner,Ashley Nicole Mccray,DEM,720060,0,0,57,57,
Tulsa,Corporation Commissioner,Blake Cummings,DEM,720060,0,0,27,27,
Tulsa,U.S. House,Tim Gilpin,DEM,720060,0,0,47,47,01
Tulsa,U.S. House,Amanda Douglas,DEM,720060,0,0,37,37,01
Tulsa,Governor,Mick Cornett,REP,720061,0,0,45,45,
Tulsa,Governor,Kevin Stitt,REP,720061,0,0,85,85,
Tulsa,Lieutenant Governor,Dana Murphy,REP,720061,0,0,54,54,
Tulsa,Lieutenant Governor,Matt Pinnell,REP,720061,0,0,77,77,
Tulsa,State Auditor,Cindy Byrd,REP,720061,0,0,69,69,
Tulsa,State Auditor,Charlie Prater,REP,720061,0,0,56,56,
Tulsa,Attorney General,Mike Hunter,REP,720061,0,0,62,62,
Tulsa,Attorney General,Gentner Drummond,REP,720061,0,0,66,66,
Tulsa,Superintendent of Public Instruction,Joy Hofmeister,REP,720061,0,0,69,69,
Tulsa,Superintendent of Public Instruction,Linda Murphy,REP,720061,0,0,59,59,
Tulsa,Commissioner of Labor,Cathy Costello,REP,720061,0,0,49,49,
Tulsa,Commissioner of Labor,Leslie Osborn,REP,720061,0,0,78,78,
Tulsa,Corporation Commissioner,Bob Anthony,REP,720061,0,0,69,69,
Tulsa,Corporation Commissioner,Brian Bingman,REP,720061,0,0,58,58,
Tulsa,U.S. House,Tim Harris,REP,720061,0,0,47,47,01
Tulsa,U.S. House,Kevin Hern,REP,720061,0,0,83,83,01
Tulsa,State Senate,John Haste,REP,720061,0,0,74,74,36
Tulsa,State Senate,Bill Day,REP,720061,0,0,54,54,36
Tulsa,Governor,Chris Powell,LIB,720061,0,0,0,0,
Tulsa,Governor,Rex Lawhorn,LIB,720061,0,0,0,0,
Tulsa,Corporation Commissioner,Ashley Nicole Mccray,DEM,720061,0,0,52,52,
Tulsa,Corporation Commissioner,Blake Cummings,DEM,720061,0,0,24,24,
Tulsa,U.S. House,Tim Gilpin,DEM,720061,0,0,45,45,01
Tulsa,U.S. House,Amanda Douglas,DEM,720061,0,0,32,32,01
Tulsa,Governor,Mick Cornett,REP,720062,0,0,228,228,
Tulsa,Governor,Kevin Stitt,REP,720062,0,0,189,189,
Tulsa,Lieutenant Governor,Dana Murphy,REP,720062,0,0,194,194,
Tulsa,Lieutenant Governor,Matt Pinnell,REP,720062,0,0,207,207,
Tulsa,State Auditor,Cindy Byrd,REP,720062,0,0,229,229,
Tulsa,State Auditor,Charlie Prater,REP,720062,0,0,137,137,
Tulsa,Attorney General,Mike Hunter,REP,720062,0,0,170,170,
Tulsa,Attorney General,Gentner Drummond,REP,720062,0,0,233,233,
Tulsa,Superintendent of Public Instruction,Joy Hofmeister,REP,720062,0,0,264,264,
Tulsa,Superintendent of Public Instruction,Linda Murphy,REP,720062,0,0,134,134,
Tulsa,Commissioner of Labor,Cathy Costello,REP,720062,0,0,181,181,
Tulsa,Commissioner of Labor,Leslie Osborn,REP,720062,0,0,199,199,
Tulsa,Corporation Commissioner,Bob Anthony,REP,720062,0,0,233,233,
Tulsa,Corporation Commissioner,Brian Bingman,REP,720062,0,0,149,149,
Tulsa,U.S. House,Tim Harris,REP,720062,0,0,254,254,01
Tulsa,U.S. House,Kevin Hern,REP,720062,0,0,158,158,01
Tulsa,State House,Cheryl Baber,REP,720062,0,0,235,235,71
Tulsa,State House,Beverly Atteberry,REP,720062,0,0,127,127,71
Tulsa,Governor,Chris Powell,LIB,720062,0,0,0,0,
Tulsa,Governor,Rex Lawhorn,LIB,720062,0,0,1,1,
Tulsa,Corporation Commissioner,Ashley Nicole Mccray,DEM,720062,0,0,235,235,
Tulsa,Corporation Commissioner,Blake Cummings,DEM,720062,0,0,108,108,
Tulsa,U.S. House,Tim Gilpin,DEM,720062,0,0,295,295,01
Tulsa,U.S. House,Amanda Douglas,DEM,720062,0,0,69,69,01
Tulsa,Governor,Mick Cornett,REP,720063,0,0,45,45,
Tulsa,Governor,Kevin Stitt,REP,720063,0,0,69,69,
Tulsa,Lieutenant Governor,Dana Murphy,REP,720063,0,0,48,48,
Tulsa,Lieutenant Governor,Matt Pinnell,REP,720063,0,0,61,61,
Tulsa,State Auditor,Cindy Byrd,REP,720063,0,0,48,48,
Tulsa,State Auditor,Charlie Prater,REP,720063,0,0,51,51,
Tulsa,Attorney General,Mike Hunter,REP,720063,0,0,56,56,
Tulsa,Attorney General,Gentner Drummond,REP,720063,0,0,56,56,
Tulsa,Superintendent of Public Instruction,Joy Hofmeister,REP,720063,0,0,70,70,
Tulsa,Superintendent of Public Instruction,Linda Murphy,REP,720063,0,0,38,38,
Tulsa,Commissioner of Labor,Cathy Costello,REP,720063,0,0,52,52,
Tulsa,Commissioner of Labor,Leslie Osborn,REP,720063,0,0,51,51,
Tulsa,Corporation Commissioner,Bob Anthony,REP,720063,0,0,58,58,
Tulsa,Corporation Commissioner,Brian Bingman,REP,720063,0,0,44,44,
Tulsa,U.S. House,Tim Harris,REP,720063,0,0,54,54,01
Tulsa,U.S. House,Kevin Hern,REP,720063,0,0,55,55,01
Tulsa,State House,Cheryl Baber,REP,720063,0,0,53,53,71
Tulsa,State House,Beverly Atteberry,REP,720063,0,0,49,49,71
Tulsa,Governor,Chris Powell,LIB,720063,0,0,0,0,
Tulsa,Governor,Rex Lawhorn,LIB,720063,0,0,0,0,
Tulsa,Corporation Commissioner,Ashley Nicole Mccray,DEM,720063,0,0,85,85,
Tulsa,Corporation Commissioner,Blake Cummings,DEM,720063,0,0,21,21,
Tulsa,U.S. House,Tim Gilpin,DEM,720063,0,0,76,76,01
Tulsa,U.S. House,Amanda Douglas,DEM,720063,0,0,31,31,01
Tulsa,Governor,Mick Cornett,REP,720064,0,0,80,80,
Tulsa,Governor,Kevin Stitt,REP,720064,0,0,87,87,
Tulsa,Lieutenant Governor,Dana Murphy,REP,720064,0,0,74,74,
Tulsa,Lieutenant Governor,Matt Pinnell,REP,720064,0,0,91,91,
Tulsa,State Auditor,Cindy Byrd,REP,720064,0,0,89,89,
Tulsa,State Auditor,Charlie Prater,REP,720064,0,0,67,67,
Tulsa,Attorney General,Mike Hunter,REP,720064,0,0,72,72,
Tulsa,Attorney General,Gentner Drummond,REP,720064,0,0,93,93,
Tulsa,Superintendent of Public Instruction,Joy Hofmeister,REP,720064,0,0,96,96,
Tulsa,Superintendent of Public Instruction,Linda Murphy,REP,720064,0,0,62,62,
Tulsa,Commissioner of Labor,Cathy Costello,REP,720064,0,0,74,74,
Tulsa,Commissioner of Labor,Leslie Osborn,REP,720064,0,0,82,82,
Tulsa,Corporation Commissioner,Bob Anthony,REP,720064,0,0,83,83,
Tulsa,Corporation Commissioner,Brian Bingman,REP,720064,0,0,71,71,
Tulsa,U.S. House,Tim Harris,REP,720064,0,0,81,81,01
Tulsa,U.S. House,Kevin Hern,REP,720064,0,0,85,85,01
Tulsa,State House,Cheryl Baber,REP,720064,0,0,68,68,71
Tulsa,State House,Beverly Atteberry,REP,720064,0,0,86,86,71
Tulsa,Governor,Chris Powell,LIB,720064,0,0,1,1,
Tulsa,Governor,Rex Lawhorn,LIB,720064,0,0,0,0,
Tulsa,Corporation Commissioner,Ashley Nicole Mccray,DEM,720064,0,0,108,108,
Tulsa,Corporation Commissioner,Blake Cummings,DEM,720064,0,0,32,32,
Tulsa,U.S. House,Tim Gilpin,DEM,720064,0,0,97,97,01
Tulsa,U.S. House,Amanda Douglas,DEM,720064,0,0,44,44,01
Tulsa,Governor,Mick Cornett,REP,720065,0,0,181,181,
Tulsa,Governor,Kevin Stitt,REP,720065,0,0,166,166,
Tulsa,Lieutenant Governor,Dana Murphy,REP,720065,0,0,122,122,
Tulsa,Lieutenant Governor,Matt Pinnell,REP,720065,0,0,203,203,
Tulsa,State Auditor,Cindy Byrd,REP,720065,0,0,175,175,
Tulsa,State Auditor,Charlie Prater,REP,720065,0,0,114,114,
Tulsa,Attorney General,Mike Hunter,REP,720065,0,0,136,136,
Tulsa,Attorney General,Gentner Drummond,REP,720065,0,0,202,202,
Tulsa,Superintendent of Public Instruction,Joy Hofmeister,REP,720065,0,0,229,229,
Tulsa,Superintendent of Public Instruction,Linda Murphy,REP,720065,0,0,96,96,
Tulsa,Commissioner of Labor,Cathy Costello,REP,720065,0,0,135,135,
Tulsa,Commissioner of Labor,Leslie Osborn,REP,720065,0,0,156,156,
Tulsa,Corporation Commissioner,Bob Anthony,REP,720065,0,0,162,162,
Tulsa,Corporation Commissioner,Brian Bingman,REP,720065,0,0,145,145,
Tulsa,U.S. House,Tim Harris,REP,720065,0,0,174,174,01
Tulsa,U.S. House,Kevin Hern,REP,720065,0,0,167,167,01
Tulsa,State House,Cheryl Baber,REP,720065,0,0,204,204,71
Tulsa,State House,Beverly Atteberry,REP,720065,0,0,75,75,71
Tulsa,Governor,Chris Powell,LIB,720065,0,0,0,0,
Tulsa,Governor,Rex Lawhorn,LIB,720065,0,0,0,0,
Tulsa,Corporation Commissioner,Ashley Nicole Mccray,DEM,720065,0,0,104,104,
Tulsa,Corporation Commissioner,Blake Cummings,DEM,720065,0,0,46,46,
Tulsa,U.S. House,Tim Gilpin,DEM,720065,0,0,132,132,01
Tulsa,U.S. House,Amanda Douglas,DEM,720065,0,0,30,30,01
Tulsa,Governor,Mick Cornett,REP,720066,0,0,181,181,
Tulsa,Governor,Kevin Stitt,REP,720066,0,0,144,144,
Tulsa,Lieutenant Governor,Dana Murphy,REP,720066,0,0,136,136,
Tulsa,Lieutenant Governor,Matt Pinnell,REP,720066,0,0,175,175,
Tulsa,State Auditor,Cindy Byrd,REP,720066,0,0,175,175,
Tulsa,State Auditor,Charlie Prater,REP,720066,0,0,119,119,
Tulsa,Attorney General,Mike Hunter,REP,720066,0,0,128,128,
Tulsa,Attorney General,Gentner Drummond,REP,720066,0,0,185,185,
Tulsa,Superintendent of Public Instruction,Joy Hofmeister,REP,720066,0,0,216,216,
Tulsa,Superintendent of Public Instruction,Linda Murphy,REP,720066,0,0,94,94,
Tulsa,Commissioner of Labor,Cathy Costello,REP,720066,0,0,122,122,
Tulsa,Commissioner of Labor,Leslie Osborn,REP,720066,0,0,173,173,
Tulsa,Corporation Commissioner,Bob Anthony,REP,720066,0,0,172,172,
Tulsa,Corporation Commissioner,Brian Bingman,REP,720066,0,0,131,131,
Tulsa,U.S. House,Tim Harris,REP,720066,0,0,159,159,01
Tulsa,U.S. House,Kevin Hern,REP,720066,0,0,156,156,01
Tulsa,State House,Cheryl Baber,REP,720066,0,0,221,221,71
Tulsa,State House,Beverly Atteberry,REP,720066,0,0,69,69,71
Tulsa,Governor,Chris Powell,LIB,720066,0,0,1,1,
Tulsa,Governor,Rex Lawhorn,LIB,720066,0,0,0,0,
Tulsa,Corporation Commissioner,Ashley Nicole Mccray,DEM,720066,0,0,104,104,
Tulsa,Corporation Commissioner,Blake Cummings,DEM,720066,0,0,41,41,
Tulsa,U.S. House,Tim Gilpin,DEM,720066,0,0,131,131,01
Tulsa,U.S. House,Amanda Douglas,DEM,720066,0,0,22,22,01
Tulsa,Governor,Mick Cornett,REP,720067,0,0,128,128,
Tulsa,Governor,Kevin Stitt,REP,720067,0,0,124,124,
Tulsa,Lieutenant Governor,Dana Murphy,REP,720067,0,0,107,107,
Tulsa,Lieutenant Governor,Matt Pinnell,REP,720067,0,0,140,140,
Tulsa,State Auditor,Cindy Byrd,REP,720067,0,0,132,132,
Tulsa,State Auditor,Charlie Prater,REP,720067,0,0,87,87,
Tulsa,Attorney General,Mike Hunter,REP,720067,0,0,118,118,
Tulsa,Attorney General,Gentner Drummond,REP,720067,0,0,127,127,
Tulsa,Superintendent of Public Instruction,Joy Hofmeister,REP,720067,0,0,172,172,
Tulsa,Superintendent of Public Instruction,Linda Murphy,REP,720067,0,0,69,69,
Tulsa,Commissioner of Labor,Cathy Costello,REP,720067,0,0,92,92,
Tulsa,Commissioner of Labor,Leslie Osborn,REP,720067,0,0,133,133,
Tulsa,Corporation Commissioner,Bob Anthony,REP,720067,0,0,115,115,
Tulsa,Corporation Commissioner,Brian Bingman,REP,720067,0,0,113,113,
Tulsa,U.S. House,Tim Harris,REP,720067,0,0,136,136,01
Tulsa,U.S. House,Kevin Hern,REP,720067,0,0,110,110,01
Tulsa,State House,Cheryl Baber,REP,720067,0,0,176,176,71
Tulsa,State House,Beverly Atteberry,REP,720067,0,0,47,47,71
Tulsa,Governor,Chris Powell,LIB,720067,0,0,0,0,
Tulsa,Governor,Rex Lawhorn,LIB,720067,0,0,0,0,
Tulsa,Corporation Commissioner,Ashley Nicole Mccray,DEM,720067,0,0,97,97,
Tulsa,Corporation Commissioner,Blake Cummings,DEM,720067,0,0,35,35,
Tulsa,U.S. House,Tim Gilpin,DEM,720067,0,0,111,111,01
Tulsa,U.S. House,Amanda Douglas,DEM,720067,0,0,27,27,01
Tulsa,Governor,Mick Cornett,REP,720068,0,0,39,39,
Tulsa,Governor,Kevin Stitt,REP,720068,0,0,73,73,
Tulsa,Lieutenant Governor,Dana Murphy,REP,720068,0,0,41,41,
Tulsa,Lieutenant Governor,Matt Pinnell,REP,720068,0,0,65,65,
Tulsa,State Auditor,Cindy Byrd,REP,720068,0,0,54,54,
Tulsa,State Auditor,Charlie Prater,REP,720068,0,0,51,51,
Tulsa,Attorney General,Mike Hunter,REP,720068,0,0,44,44,
Tulsa,Attorney General,Gentner Drummond,REP,720068,0,0,68,68,
Tulsa,Superintendent of Public Instruction,Joy Hofmeister,REP,720068,0,0,58,58,
Tulsa,Superintendent of Public Instruction,Linda Murphy,REP,720068,0,0,51,51,
Tulsa,Commissioner of Labor,Cathy Costello,REP,720068,0,0,52,52,
Tulsa,Commissioner of Labor,Leslie Osborn,REP,720068,0,0,54,54,
Tulsa,Corporation Commissioner,Bob Anthony,REP,720068,0,0,51,51,
Tulsa,Corporation Commissioner,Brian Bingman,REP,720068,0,0,57,57,
Tulsa,U.S. House,Tim Harris,REP,720068,0,0,49,49,01
Tulsa,U.S. House,Kevin Hern,REP,720068,0,0,61,61,01
Tulsa,State House,Cheryl Baber,REP,720068,0,0,50,50,71
Tulsa,State House,Beverly Atteberry,REP,720068,0,0,57,57,71
Tulsa,Governor,Chris Powell,LIB,720068,0,0,0,0,
Tulsa,Governor,Rex Lawhorn,LIB,720068,0,0,0,0,
Tulsa,Corporation Commissioner,Ashley Nicole Mccray,DEM,720068,0,0,89,89,
Tulsa,Corporation Commissioner,Blake Cummings,DEM,720068,0,0,34,34,
Tulsa,U.S. House,Tim Gilpin,DEM,720068,0,0,68,68,01
Tulsa,U.S. House,Amanda Douglas,DEM,720068,0,0,57,57,01
Tulsa,Governor,Mick Cornett,REP,720069,0,0,158,158,
Tulsa,Governor,Kevin Stitt,REP,720069,0,0,154,154,
Tulsa,Lieutenant Governor,Dana Murphy,REP,720069,0,0,141,141,
Tulsa,Lieutenant Governor,Matt Pinnell,REP,720069,0,0,164,164,
Tulsa,State Auditor,Cindy Byrd,REP,720069,0,0,172,172,
Tulsa,State Auditor,Charlie Prater,REP,720069,0,0,126,126,
Tulsa,Attorney General,Mike Hunter,REP,720069,0,0,134,134,
Tulsa,Attorney General,Gentner Drummond,REP,720069,0,0,175,175,
Tulsa,Superintendent of Public Instruction,Joy Hofmeister,REP,720069,0,0,197,197,
Tulsa,Superintendent of Public Instruction,Linda Murphy,REP,720069,0,0,100,100,
Tulsa,Commissioner of Labor,Cathy Costello,REP,720069,0,0,143,143,
Tulsa,Commissioner of Labor,Leslie Osborn,REP,720069,0,0,152,152,
Tulsa,Corporation Commissioner,Bob Anthony,REP,720069,0,0,144,144,
Tulsa,Corporation Commissioner,Brian Bingman,REP,720069,0,0,153,153,
Tulsa,U.S. House,Tim Harris,REP,720069,0,0,152,152,01
Tulsa,U.S. House,Kevin Hern,REP,720069,0,0,155,155,01
Tulsa,State House,Cheryl Baber,REP,720069,0,0,180,180,71
Tulsa,State House,Beverly Atteberry,REP,720069,0,0,106,106,71
Tulsa,Governor,Chris Powell,LIB,720069,0,0,0,0,
Tulsa,Governor,Rex Lawhorn,LIB,720069,0,0,0,0,
Tulsa,Corporation Commissioner,Ashley Nicole Mccray,DEM,720069,0,0,136,136,
Tulsa,Corporation Commissioner,Blake Cummings,DEM,720069,0,0,48,48,
Tulsa,U.S. House,Tim Gilpin,DEM,720069,0,0,134,134,01
Tulsa,U.S. House,Amanda Douglas,DEM,720069,0,0,57,57,01
Tulsa,Governor,Mick Cornett,REP,720070,0,0,16,16,
Tulsa,Governor,Kevin Stitt,REP,720070,0,0,33,33,
Tulsa,Lieutenant Governor,Dana Murphy,REP,720070,0,0,15,15,
Tulsa,Lieutenant Governor,Matt Pinnell,REP,720070,0,0,32,32,
Tulsa,State Auditor,Cindy Byrd,REP,720070,0,0,23,23,
Tulsa,State Auditor,Charlie Prater,REP,720070,0,0,25,25,
Tulsa,Attorney General,Mike Hunter,REP,720070,0,0,15,15,
Tulsa,Attorney General,Gentner Drummond,REP,720070,0,0,33,33,
Tulsa,Superintendent of Public Instruction,Joy Hofmeister,REP,720070,0,0,19,19,
Tulsa,Superintendent of Public Instruction,Linda Murphy,REP,720070,0,0,28,28,
Tulsa,Commissioner of Labor,Cathy Costello,REP,720070,0,0,25,25,
Tulsa,Commissioner of Labor,Leslie Osborn,REP,720070,0,0,24,24,
Tulsa,Corporation Commissioner,Bob Anthony,REP,720070,0,0,26,26,
Tulsa,Corporation Commissioner,Brian Bingman,REP,720070,0,0,22,22,
Tulsa,U.S. House,Tim Harris,REP,720070,0,0,28,28,01
Tulsa,U.S. House,Kevin Hern,REP,720070,0,0,21,21,01
Tulsa,Governor,Chris Powell,LIB,720070,0,0,0,0,
Tulsa,Governor,Rex Lawhorn,LIB,720070,0,0,0,0,
Tulsa,Corporation Commissioner,Ashley Nicole Mccray,DEM,720070,0,0,17,17,
Tulsa,Corporation Commissioner,Blake Cummings,DEM,720070,0,0,5,5,
Tulsa,U.S. House,Tim Gilpin,DEM,720070,0,0,10,10,01
Tulsa,U.S. House,Amanda Douglas,DEM,720070,0,0,12,12,01
Tulsa,Governor,Mick Cornett,REP,720071,0,0,269,269,
Tulsa,Governor,Kevin Stitt,REP,720071,0,0,301,301,
Tulsa,Lieutenant Governor,Dana Murphy,REP,720071,0,0,245,245,
Tulsa,Lieutenant Governor,Matt Pinnell,REP,720071,0,0,305,305,
Tulsa,State Auditor,Cindy Byrd,REP,720071,0,0,321,321,
Tulsa,State Auditor,Charlie Prater,REP,720071,0,0,194,194,
Tulsa,Attorney General,Mike Hunter,REP,720071,0,0,273,273,
Tulsa,Attorney General,Gentner Drummond,REP,720071,0,0,288,288,
Tulsa,Superintendent of Public Instruction,Joy Hofmeister,REP,720071,0,0,376,376,
Tulsa,Superintendent of Public Instruction,Linda Murphy,REP,720071,0,0,166,166,
Tulsa,Commissioner of Labor,Cathy Costello,REP,720071,0,0,252,252,
Tulsa,Commissioner of Labor,Leslie Osborn,REP,720071,0,0,264,264,
Tulsa,Corporation Commissioner,Bob Anthony,REP,720071,0,0,282,282,
Tulsa,Corporation Commissioner,Brian Bingman,REP,720071,0,0,250,250,
Tulsa,U.S. House,Tim Harris,REP,720071,0,0,310,310,01
Tulsa,U.S. House,Kevin Hern,REP,720071,0,0,253,253,01
Tulsa,Governor,Chris Powell,LIB,720071,0,0,1,1,
Tulsa,Governor,Rex Lawhorn,LIB,720071,0,0,0,0,
Tulsa,Corporation Commissioner,Ashley Nicole Mccray,DEM,720071,0,0,235,235,
Tulsa,Corporation Commissioner,Blake Cummings,DEM,720071,0,0,72,72,
Tulsa,U.S. House,Tim Gilpin,DEM,720071,0,0,251,251,01
Tulsa,U.S. House,Amanda Douglas,DEM,720071,0,0,73,73,01
Tulsa,Governor,Mick Cornett,REP,720072,0,0,125,125,
Tulsa,Governor,Kevin Stitt,REP,720072,0,0,111,111,
Tulsa,Lieutenant Governor,Dana Murphy,REP,720072,0,0,98,98,
Tulsa,Lieutenant Governor,Matt Pinnell,REP,720072,0,0,125,125,
Tulsa,State Auditor,Cindy Byrd,REP,720072,0,0,137,137,
Tulsa,State Auditor,Charlie Prater,REP,720072,0,0,80,80,
Tulsa,Attorney General,Mike Hunter,REP,720072,0,0,89,89,
Tulsa,Attorney General,Gentner Drummond,REP,720072,0,0,144,144,
Tulsa,Superintendent of Public Instruction,Joy Hofmeister,REP,720072,0,0,140,140,
Tulsa,Superintendent of Public Instruction,Linda Murphy,REP,720072,0,0,88,88,
Tulsa,Commissioner of Labor,Cathy Costello,REP,720072,0,0,93,93,
Tulsa,Commissioner of Labor,Leslie Osborn,REP,720072,0,0,125,125,
Tulsa,Corporation Commissioner,Bob Anthony,REP,720072,0,0,112,112,
Tulsa,Corporation Commissioner,Brian Bingman,REP,720072,0,0,109,109,
Tulsa,U.S. House,Tim Harris,REP,720072,0,0,131,131,01
Tulsa,U.S. House,Kevin Hern,REP,720072,0,0,105,105,01
Tulsa,Governor,Chris Powell,LIB,720072,0,0,0,0,
Tulsa,Governor,Rex Lawhorn,LIB,720072,0,0,0,0,
Tulsa,Corporation Commissioner,Ashley Nicole Mccray,DEM,720072,0,0,88,88,
Tulsa,Corporation Commissioner,Blake Cummings,DEM,720072,0,0,36,36,
Tulsa,U.S. House,Tim Gilpin,DEM,720072,0,0,113,113,01
Tulsa,U.S. House,Amanda Douglas,DEM,720072,0,0,18,18,01
Tulsa,Governor,Mick Cornett,REP,720073,0,0,129,129,
Tulsa,Governor,Kevin Stitt,REP,720073,0,0,153,153,
Tulsa,Lieutenant Governor,Dana Murphy,REP,720073,0,0,102,102,
Tulsa,Lieutenant Governor,Matt Pinnell,REP,720073,0,0,175,175,
Tulsa,State Auditor,Cindy Byrd,REP,720073,0,0,149,149,
Tulsa,State Auditor,Charlie Prater,REP,720073,0,0,118,118,
Tulsa,Attorney General,Mike Hunter,REP,720073,0,0,124,124,
Tulsa,Attorney General,Gentner Drummond,REP,720073,0,0,150,150,
Tulsa,Superintendent of Public Instruction,Joy Hofmeister,REP,720073,0,0,185,185,
Tulsa,Superintendent of Public Instruction,Linda Murphy,REP,720073,0,0,91,91,
Tulsa,Commissioner of Labor,Cathy Costello,REP,720073,0,0,116,116,
Tulsa,Commissioner of Labor,Leslie Osborn,REP,720073,0,0,150,150,
Tulsa,Corporation Commissioner,Bob Anthony,REP,720073,0,0,152,152,
Tulsa,Corporation Commissioner,Brian Bingman,REP,720073,0,0,120,120,
Tulsa,U.S. House,Tim Harris,REP,720073,0,0,154,154,01
Tulsa,U.S. House,Kevin Hern,REP,720073,0,0,127,127,01
Tulsa,Governor,Chris Powell,LIB,720073,0,0,0,0,
Tulsa,Governor,Rex Lawhorn,LIB,720073,0,0,0,0,
Tulsa,Corporation Commissioner,Ashley Nicole Mccray,DEM,720073,0,0,60,60,
Tulsa,Corporation Commissioner,Blake Cummings,DEM,720073,0,0,34,34,
Tulsa,U.S. House,Tim Gilpin,DEM,720073,0,0,79,79,01
Tulsa,U.S. House,Amanda Douglas,DEM,720073,0,0,20,20,01
Tulsa,Governor,Mick Cornett,REP,720074,0,0,158,158,
Tulsa,Governor,Kevin Stitt,REP,720074,0,0,185,185,
Tulsa,Lieutenant Governor,Dana Murphy,REP,720074,0,0,141,141,
Tulsa,Lieutenant Governor,Matt Pinnell,REP,720074,0,0,189,189,
Tulsa,State Auditor,Cindy Byrd,REP,720074,0,0,182,182,
Tulsa,State Auditor,Charlie Prater,REP,720074,0,0,121,121,
Tulsa,Attorney General,Mike Hunter,REP,720074,0,0,162,162,
Tulsa,Attorney General,Gentner Drummond,REP,720074,0,0,175,175,
Tulsa,Superintendent of Public Instruction,Joy Hofmeister,REP,720074,0,0,223,223,
Tulsa,Superintendent of Public Instruction,Linda Murphy,REP,720074,0,0,110,110,
Tulsa,Commissioner of Labor,Cathy Costello,REP,720074,0,0,147,147,
Tulsa,Commissioner of Labor,Leslie Osborn,REP,720074,0,0,164,164,
Tulsa,Corporation Commissioner,Bob Anthony,REP,720074,0,0,182,182,
Tulsa,Corporation Commissioner,Brian Bingman,REP,720074,0,0,141,141,
Tulsa,U.S. House,Tim Harris,REP,720074,0,0,167,167,01
Tulsa,U.S. House,Kevin Hern,REP,720074,0,0,171,171,01
Tulsa,Governor,Chris Powell,LIB,720074,0,0,0,0,
Tulsa,Governor,Rex Lawhorn,LIB,720074,0,0,0,0,
Tulsa,Corporation Commissioner,Ashley Nicole Mccray,DEM,720074,0,0,93,93,
Tulsa,Corporation Commissioner,Blake Cummings,DEM,720074,0,0,27,27,
Tulsa,U.S. House,Tim Gilpin,DEM,720074,0,0,88,88,01
Tulsa,U.S. House,Amanda Douglas,DEM,720074,0,0,36,36,01
Tulsa,Governor,Mick Cornett,REP,720075,0,0,39,39,
Tulsa,Governor,Kevin Stitt,REP,720075,0,0,55,55,
Tulsa,Lieutenant Governor,Dana Murphy,REP,720075,0,0,37,37,
Tulsa,Lieutenant Governor,Matt Pinnell,REP,720075,0,0,55,55,
Tulsa,State Auditor,Cindy Byrd,REP,720075,0,0,48,48,
Tulsa,State Auditor,Charlie Prater,REP,720075,0,0,41,41,
Tulsa,Attorney General,Mike Hunter,REP,720075,0,0,47,47,
Tulsa,Attorney General,Gentner Drummond,REP,720075,0,0,46,46,
Tulsa,Superintendent of Public Instruction,Joy Hofmeister,REP,720075,0,0,50,50,
Tulsa,Superintendent of Public Instruction,Linda Murphy,REP,720075,0,0,41,41,
Tulsa,Commissioner of Labor,Cathy Costello,REP,720075,0,0,45,45,
Tulsa,Commissioner of Labor,Leslie Osborn,REP,720075,0,0,39,39,
Tulsa,Corporation Commissioner,Bob Anthony,REP,720075,0,0,38,38,
Tulsa,Corporation Commissioner,Brian Bingman,REP,720075,0,0,46,46,
Tulsa,U.S. House,Tim Harris,REP,720075,0,0,53,53,01
Tulsa,U.S. House,Kevin Hern,REP,720075,0,0,40,40,01
Tulsa,Governor,Chris Powell,LIB,720075,0,0,0,0,
Tulsa,Governor,Rex Lawhorn,LIB,720075,0,0,1,1,
Tulsa,Corporation Commissioner,Ashley Nicole Mccray,DEM,720075,0,0,100,100,
Tulsa,Corporation Commissioner,Blake Cummings,DEM,720075,0,0,24,24,
Tulsa,U.S. House,Tim Gilpin,DEM,720075,0,0,91,91,01
Tulsa,U.S. House,Amanda Douglas,DEM,720075,0,0,35,35,01
Tulsa,Governor,Mick Cornett,REP,720076,0,0,71,71,
Tulsa,Governor,Kevin Stitt,REP,720076,0,0,82,82,
Tulsa,Lieutenant Governor,Dana Murphy,REP,720076,0,0,60,60,
Tulsa,Lieutenant Governor,Matt Pinnell,REP,720076,0,0,87,87,
Tulsa,State Auditor,Cindy Byrd,REP,720076,0,0,73,73,
Tulsa,State Auditor,Charlie Prater,REP,720076,0,0,61,61,
Tulsa,Attorney General,Mike Hunter,REP,720076,0,0,57,57,
Tulsa,Attorney General,Gentner Drummond,REP,720076,0,0,95,95,
Tulsa,Superintendent of Public Instruction,Joy Hofmeister,REP,720076,0,0,78,78,
Tulsa,Superintendent of Public Instruction,Linda Murphy,REP,720076,0,0,70,70,
Tulsa,Commissioner of Labor,Cathy Costello,REP,720076,0,0,54,54,
Tulsa,Commissioner of Labor,Leslie Osborn,REP,720076,0,0,84,84,
Tulsa,Corporation Commissioner,Bob Anthony,REP,720076,0,0,73,73,
Tulsa,Corporation Commissioner,Brian Bingman,REP,720076,0,0,67,67,
Tulsa,U.S. House,Tim Harris,REP,720076,0,0,83,83,01
Tulsa,U.S. House,Kevin Hern,REP,720076,0,0,66,66,01
Tulsa,Governor,Chris Powell,LIB,720076,0,0,0,0,
Tulsa,Governor,Rex Lawhorn,LIB,720076,0,0,1,1,
Tulsa,Corporation Commissioner,Ashley Nicole Mccray,DEM,720076,0,0,121,121,
Tulsa,Corporation Commissioner,Blake Cummings,DEM,720076,0,0,41,41,
Tulsa,U.S. House,Tim Gilpin,DEM,720076,0,0,110,110,01
Tulsa,U.S. House,Amanda Douglas,DEM,720076,0,0,57,57,01
Tulsa,Governor,Mick Cornett,REP,720077,0,0,84,84,
Tulsa,Governor,Kevin Stitt,REP,720077,0,0,112,112,
Tulsa,Lieutenant Governor,Dana Murphy,REP,720077,0,0,80,80,
Tulsa,Lieutenant Governor,Matt Pinnell,REP,720077,0,0,111,111,
Tulsa,State Auditor,Cindy Byrd,REP,720077,0,0,105,105,
Tulsa,State Auditor,Charlie Prater,REP,720077,0,0,76,76,
Tulsa,Attorney General,Mike Hunter,REP,720077,0,0,89,89,
Tulsa,Attorney General,Gentner Drummond,REP,720077,0,0,102,102,
Tulsa,Superintendent of Public Instruction,Joy Hofmeister,REP,720077,0,0,109,109,
Tulsa,Superintendent of Public Instruction,Linda Murphy,REP,720077,0,0,75,75,
Tulsa,Commissioner of Labor,Cathy Costello,REP,720077,0,0,95,95,
Tulsa,Commissioner of Labor,Leslie Osborn,REP,720077,0,0,93,93,
Tulsa,Corporation Commissioner,Bob Anthony,REP,720077,0,0,110,110,
Tulsa,Corporation Commissioner,Brian Bingman,REP,720077,0,0,74,74,
Tulsa,U.S. House,Tim Harris,REP,720077,0,0,99,99,01
Tulsa,U.S. House,Kevin Hern,REP,720077,0,0,94,94,01
Tulsa,Governor,Chris Powell,LIB,720077,0,0,2,2,
Tulsa,Governor,Rex Lawhorn,LIB,720077,0,0,0,0,
Tulsa,Corporation Commissioner,Ashley Nicole Mccray,DEM,720077,0,0,145,145,
Tulsa,Corporation Commissioner,Blake Cummings,DEM,720077,0,0,42,42,
Tulsa,U.S. House,Tim Gilpin,DEM,720077,0,0,133,133,01
Tulsa,U.S. House,Amanda Douglas,DEM,720077,0,0,57,57,01
Tulsa,Governor,Mick Cornett,REP,720078,0,0,86,86,
Tulsa,Governor,Kevin Stitt,REP,720078,0,0,128,128,
Tulsa,Lieutenant Governor,Dana Murphy,REP,720078,0,0,75,75,
Tulsa,Lieutenant Governor,Matt Pinnell,REP,720078,0,0,129,129,
Tulsa,State Auditor,Cindy Byrd,REP,720078,0,0,117,117,
Tulsa,State Auditor,Charlie Prater,REP,720078,0,0,89,89,
Tulsa,Attorney General,Mike Hunter,REP,720078,0,0,95,95,
Tulsa,Attorney General,Gentner Drummond,REP,720078,0,0,114,114,
Tulsa,Superintendent of Public Instruction,Joy Hofmeister,REP,720078,0,0,109,109,
Tulsa,Superintendent of Public Instruction,Linda Murphy,REP,720078,0,0,102,102,
Tulsa,Commissioner of Labor,Cathy Costello,REP,720078,0,0,103,103,
Tulsa,Commissioner of Labor,Leslie Osborn,REP,720078,0,0,104,104,
Tulsa,Corporation Commissioner,Bob Anthony,REP,720078,0,0,101,101,
Tulsa,Corporation Commissioner,Brian Bingman,REP,720078,0,0,101,101,
Tulsa,U.S. House,Tim Harris,REP,720078,0,0,86,86,01
Tulsa,U.S. House,Kevin Hern,REP,720078,0,0,123,123,01
Tulsa,Governor,Chris Powell,LIB,720078,0,0,1,1,
Tulsa,Governor,Rex Lawhorn,LIB,720078,0,0,0,0,
Tulsa,Corporation Commissioner,Ashley Nicole Mccray,DEM,720078,0,0,86,86,
Tulsa,Corporation Commissioner,Blake Cummings,DEM,720078,0,0,33,33,
Tulsa,U.S. House,Tim Gilpin,DEM,720078,0,0,80,80,01
Tulsa,U.S. House,Amanda Douglas,DEM,720078,0,0,41,41,01
Tulsa,Governor,Mick Cornett,REP,720079,0,0,101,101,
Tulsa,Governor,Kevin Stitt,REP,720079,0,0,114,114,
Tulsa,Lieutenant Governor,Dana Murphy,REP,720079,0,0,89,89,
Tulsa,Lieutenant Governor,Matt Pinnell,REP,720079,0,0,124,124,
Tulsa,State Auditor,Cindy Byrd,REP,720079,0,0,104,104,
Tulsa,State Auditor,Charlie Prater,REP,720079,0,0,104,104,
Tulsa,Attorney General,Mike Hunter,REP,720079,0,0,111,111,
Tulsa,Attorney General,Gentner Drummond,REP,720079,0,0,102,102,
Tulsa,Superintendent of Public Instruction,Joy Hofmeister,REP,720079,0,0,125,125,
Tulsa,Superintendent of Public Instruction,Linda Murphy,REP,720079,0,0,88,88,
Tulsa,Commissioner of Labor,Cathy Costello,REP,720079,0,0,108,108,
Tulsa,Commissioner of Labor,Leslie Osborn,REP,720079,0,0,97,97,
Tulsa,Corporation Commissioner,Bob Anthony,REP,720079,0,0,108,108,
Tulsa,Corporation Commissioner,Brian Bingman,REP,720079,0,0,99,99,
Tulsa,U.S. House,Tim Harris,REP,720079,0,0,110,110,01
Tulsa,U.S. House,Kevin Hern,REP,720079,0,0,102,102,01
Tulsa,Governor,Chris Powell,LIB,720079,0,0,1,1,
Tulsa,Governor,Rex Lawhorn,LIB,720079,0,0,1,1,
Tulsa,Corporation Commissioner,Ashley Nicole Mccray,DEM,720079,0,0,123,123,
Tulsa,Corporation Commissioner,Blake Cummings,DEM,720079,0,0,48,48,
Tulsa,U.S. House,Tim Gilpin,DEM,720079,0,0,111,111,01
Tulsa,U.S. House,Amanda Douglas,DEM,720079,0,0,65,65,01
Tulsa,Governor,Mick Cornett,REP,720080,0,0,30,30,
Tulsa,Governor,Kevin Stitt,REP,720080,0,0,30,30,
Tulsa,Lieutenant Governor,Dana Murphy,REP,720080,0,0,25,25,
Tulsa,Lieutenant Governor,Matt Pinnell,REP,720080,0,0,31,31,
Tulsa,State Auditor,Cindy Byrd,REP,720080,0,0,35,35,
Tulsa,State Auditor,Charlie Prater,REP,720080,0,0,20,20,
Tulsa,Attorney General,Mike Hunter,REP,720080,0,0,26,26,
Tulsa,Attorney General,Gentner Drummond,REP,720080,0,0,32,32,
Tulsa,Superintendent of Public Instruction,Joy Hofmeister,REP,720080,0,0,33,33,
Tulsa,Superintendent of Public Instruction,Linda Murphy,REP,720080,0,0,23,23,
Tulsa,Commissioner of Labor,Cathy Costello,REP,720080,0,0,21,21,
Tulsa,Commissioner of Labor,Leslie Osborn,REP,720080,0,0,32,32,
Tulsa,Corporation Commissioner,Bob Anthony,REP,720080,0,0,23,23,
Tulsa,Corporation Commissioner,Brian Bingman,REP,720080,0,0,32,32,
Tulsa,U.S. House,Tim Harris,REP,720080,0,0,36,36,01
Tulsa,U.S. House,Kevin Hern,REP,720080,0,0,22,22,01
Tulsa,Governor,Chris Powell,LIB,720080,0,0,0,0,
Tulsa,Governor,Rex Lawhorn,LIB,720080,0,0,0,0,
Tulsa,Corporation Commissioner,Ashley Nicole Mccray,DEM,720080,0,0,15,15,
Tulsa,Corporation Commissioner,Blake Cummings,DEM,720080,0,0,4,4,
Tulsa,U.S. House,Tim Gilpin,DEM,720080,0,0,15,15,01
Tulsa,U.S. House,Amanda Douglas,DEM,720080,0,0,4,4,01
Tulsa,Governor,Mick Cornett,REP,720081,0,0,157,157,
Tulsa,Governor,Kevin Stitt,REP,720081,0,0,168,168,
Tulsa,Lieutenant Governor,Dana Murphy,REP,720081,0,0,154,154,
Tulsa,Lieutenant Governor,Matt Pinnell,REP,720081,0,0,165,165,
Tulsa,State Auditor,Cindy Byrd,REP,720081,0,0,198,198,
Tulsa,State Auditor,Charlie Prater,REP,720081,0,0,113,113,
Tulsa,Attorney General,Mike Hunter,REP,720081,0,0,123,123,
Tulsa,Attorney General,Gentner Drummond,REP,720081,0,0,196,196,
Tulsa,Superintendent of Public Instruction,Joy Hofmeister,REP,720081,0,0,198,198,
Tulsa,Superintendent of Public Instruction,Linda Murphy,REP,720081,0,0,118,118,
Tulsa,Commissioner of Labor,Cathy Costello,REP,720081,0,0,144,144,
Tulsa,Commissioner of Labor,Leslie Osborn,REP,720081,0,0,163,163,
Tulsa,Corporation Commissioner,Bob Anthony,REP,720081,0,0,173,173,
Tulsa,Corporation Commissioner,Brian Bingman,REP,720081,0,0,138,138,
Tulsa,U.S. House,Tim Harris,REP,720081,0,0,198,198,01
Tulsa,U.S. House,Kevin Hern,REP,720081,0,0,126,126,01
Tulsa,Governor,Chris Powell,LIB,720081,0,0,0,0,
Tulsa,Governor,Rex Lawhorn,LIB,720081,0,0,0,0,
Tulsa,Corporation Commissioner,Ashley Nicole Mccray,DEM,720081,0,0,127,127,
Tulsa,Corporation Commissioner,Blake Cummings,DEM,720081,0,0,41,41,
Tulsa,U.S. House,Tim Gilpin,DEM,720081,0,0,128,128,01
Tulsa,U.S. House,Amanda Douglas,DEM,720081,0,0,45,45,01
Tulsa,Governor,Mick Cornett,REP,720082,0,0,82,82,
Tulsa,Governor,Kevin Stitt,REP,720082,0,0,79,79,
Tulsa,Lieutenant Governor,Dana Murphy,REP,720082,0,0,79,79,
Tulsa,Lieutenant Governor,Matt Pinnell,REP,720082,0,0,79,79,
Tulsa,State Auditor,Cindy Byrd,REP,720082,0,0,88,88,
Tulsa,State Auditor,Charlie Prater,REP,720082,0,0,64,64,
Tulsa,Attorney General,Mike Hunter,REP,720082,0,0,70,70,
Tulsa,Attorney General,Gentner Drummond,REP,720082,0,0,89,89,
Tulsa,Superintendent of Public Instruction,Joy Hofmeister,REP,720082,0,0,103,103,
Tulsa,Superintendent of Public Instruction,Linda Murphy,REP,720082,0,0,54,54,
Tulsa,Commissioner of Labor,Cathy Costello,REP,720082,0,0,65,65,
Tulsa,Commissioner of Labor,Leslie Osborn,REP,720082,0,0,87,87,
Tulsa,Corporation Commissioner,Bob Anthony,REP,720082,0,0,93,93,
Tulsa,Corporation Commissioner,Brian Bingman,REP,720082,0,0,65,65,
Tulsa,U.S. House,Tim Harris,REP,720082,0,0,90,90,01
Tulsa,U.S. House,Kevin Hern,REP,720082,0,0,71,71,01
Tulsa,Governor,Chris Powell,LIB,720082,0,0,1,1,
Tulsa,Governor,Rex Lawhorn,LIB,720082,0,0,0,0,
Tulsa,Corporation Commissioner,Ashley Nicole Mccray,DEM,720082,0,0,62,62,
Tulsa,Corporation Commissioner,Blake Cummings,DEM,720082,0,0,26,26,
Tulsa,U.S. House,Tim Gilpin,DEM,720082,0,0,62,62,01
Tulsa,U.S. House,Amanda Douglas,DEM,720082,0,0,27,27,01
Tulsa,Governor,Mick Cornett,REP,720083,0,0,68,68,
Tulsa,Governor,Kevin Stitt,REP,720083,0,0,74,74,
Tulsa,Lieutenant Governor,Dana Murphy,REP,720083,0,0,55,55,
Tulsa,Lieutenant Governor,Matt Pinnell,REP,720083,0,0,83,83,
Tulsa,State Auditor,Cindy Byrd,REP,720083,0,0,72,72,
Tulsa,State Auditor,Charlie Prater,REP,720083,0,0,62,62,
Tulsa,Attorney General,Mike Hunter,REP,720083,0,0,62,62,
Tulsa,Attorney General,Gentner Drummond,REP,720083,0,0,78,78,
Tulsa,Superintendent of Public Instruction,Joy Hofmeister,REP,720083,0,0,86,86,
Tulsa,Superintendent of Public Instruction,Linda Murphy,REP,720083,0,0,55,55,
Tulsa,Commissioner of Labor,Cathy Costello,REP,720083,0,0,74,74,
Tulsa,Commissioner of Labor,Leslie Osborn,REP,720083,0,0,60,60,
Tulsa,Corporation Commissioner,Bob Anthony,REP,720083,0,0,69,69,
Tulsa,Corporation Commissioner,Brian Bingman,REP,720083,0,0,64,64,
Tulsa,U.S. House,Tim Harris,REP,720083,0,0,69,69,01
Tulsa,U.S. House,Kevin Hern,REP,720083,0,0,70,70,01
Tulsa,Governor,Chris Powell,LIB,720083,0,0,0,0,
Tulsa,Governor,Rex Lawhorn,LIB,720083,0,0,0,0,
Tulsa,Corporation Commissioner,Ashley Nicole Mccray,DEM,720083,0,0,104,104,
Tulsa,Corporation Commissioner,Blake Cummings,DEM,720083,0,0,33,33,
Tulsa,U.S. House,Tim Gilpin,DEM,720083,0,0,103,103,01
Tulsa,U.S. House,Amanda Douglas,DEM,720083,0,0,38,38,01
Tulsa,Governor,Mick Cornett,REP,720084,0,0,94,94,
Tulsa,Governor,Kevin Stitt,REP,720084,0,0,97,97,
Tulsa,Lieutenant Governor,Dana Murphy,REP,720084,0,0,62,62,
Tulsa,Lieutenant Governor,Matt Pinnell,REP,720084,0,0,122,122,
Tulsa,State Auditor,Cindy Byrd,REP,720084,0,0,89,89,
Tulsa,State Auditor,Charlie Prater,REP,720084,0,0,84,84,
Tulsa,Attorney General,Mike Hunter,REP,720084,0,0,82,82,
Tulsa,Attorney General,Gentner Drummond,REP,720084,0,0,103,103,
Tulsa,Superintendent of Public Instruction,Joy Hofmeister,REP,720084,0,0,97,97,
Tulsa,Superintendent of Public Instruction,Linda Murphy,REP,720084,0,0,85,85,
Tulsa,Commissioner of Labor,Cathy Costello,REP,720084,0,0,80,80,
Tulsa,Commissioner of Labor,Leslie Osborn,REP,720084,0,0,95,95,
Tulsa,Corporation Commissioner,Bob Anthony,REP,720084,0,0,99,99,
Tulsa,Corporation Commissioner,Brian Bingman,REP,720084,0,0,73,73,
Tulsa,U.S. House,Tim Harris,REP,720084,0,0,113,113,01
Tulsa,U.S. House,Kevin Hern,REP,720084,0,0,73,73,01
Tulsa,Governor,Chris Powell,LIB,720084,0,0,0,0,
Tulsa,Governor,Rex Lawhorn,LIB,720084,0,0,0,0,
Tulsa,Corporation Commissioner,Ashley Nicole Mccray,DEM,720084,0,0,71,71,
Tulsa,Corporation Commissioner,Blake Cummings,DEM,720084,0,0,22,22,
Tulsa,U.S. House,Tim Gilpin,DEM,720084,0,0,73,73,01
Tulsa,U.S. House,Amanda Douglas,DEM,720084,0,0,24,24,01
Tulsa,Governor,Mick Cornett,REP,720085,0,0,23,23,
Tulsa,Governor,Kevin Stitt,REP,720085,0,0,30,30,
Tulsa,Lieutenant Governor,Dana Murphy,REP,720085,0,0,22,22,
Tulsa,Lieutenant Governor,Matt Pinnell,REP,720085,0,0,30,30,
Tulsa,State Auditor,Cindy Byrd,REP,720085,0,0,23,23,
Tulsa,State Auditor,Charlie Prater,REP,720085,0,0,26,26,
Tulsa,Attorney General,Mike Hunter,REP,720085,0,0,27,27,
Tulsa,Attorney General,Gentner Drummond,REP,720085,0,0,25,25,
Tulsa,Superintendent of Public Instruction,Joy Hofmeister,REP,720085,0,0,33,33,
Tulsa,Superintendent of Public Instruction,Linda Murphy,REP,720085,0,0,17,17,
Tulsa,Commissioner of Labor,Cathy Costello,REP,720085,0,0,25,25,
Tulsa,Commissioner of Labor,Leslie Osborn,REP,720085,0,0,26,26,
Tulsa,Corporation Commissioner,Bob Anthony,REP,720085,0,0,23,23,
Tulsa,Corporation Commissioner,Brian Bingman,REP,720085,0,0,26,26,
Tulsa,U.S. House,Tim Harris,REP,720085,0,0,37,37,01
Tulsa,U.S. House,Kevin Hern,REP,720085,0,0,15,15,01
Tulsa,Governor,Chris Powell,LIB,720085,0,0,0,0,
Tulsa,Governor,Rex Lawhorn,LIB,720085,0,0,0,0,
Tulsa,Corporation Commissioner,Ashley Nicole Mccray,DEM,720085,0,0,39,39,
Tulsa,Corporation Commissioner,Blake Cummings,DEM,720085,0,0,11,11,
Tulsa,U.S. House,Tim Gilpin,DEM,720085,0,0,27,27,01
Tulsa,U.S. House,Amanda Douglas,DEM,720085,0,0,24,24,01
Tulsa,Governor,Mick Cornett,REP,720086,0,0,76,76,
Tulsa,Governor,Kevin Stitt,REP,720086,0,0,123,123,
Tulsa,Lieutenant Governor,Dana Murphy,REP,720086,0,0,74,74,
Tulsa,Lieutenant Governor,Matt Pinnell,REP,720086,0,0,123,123,
Tulsa,State Auditor,Cindy Byrd,REP,720086,0,0,103,103,
Tulsa,State Auditor,Charlie Prater,REP,720086,0,0,86,86,
Tulsa,Attorney General,Mike Hunter,REP,720086,0,0,96,96,
Tulsa,Attorney General,Gentner Drummond,REP,720086,0,0,102,102,
Tulsa,Superintendent of Public Instruction,Joy Hofmeister,REP,720086,0,0,106,106,
Tulsa,Superintendent of Public Instruction,Linda Murphy,REP,720086,0,0,91,91,
Tulsa,Commissioner of Labor,Cathy Costello,REP,720086,0,0,94,94,
Tulsa,Commissioner of Labor,Leslie Osborn,REP,720086,0,0,99,99,
Tulsa,Corporation Commissioner,Bob Anthony,REP,720086,0,0,106,106,
Tulsa,Corporation Commissioner,Brian Bingman,REP,720086,0,0,85,85,
Tulsa,U.S. House,Tim Harris,REP,720086,0,0,91,91,01
Tulsa,U.S. House,Kevin Hern,REP,720086,0,0,107,107,01
Tulsa,Governor,Chris Powell,LIB,720086,0,0,1,1,
Tulsa,Governor,Rex Lawhorn,LIB,720086,0,0,0,0,
Tulsa,Corporation Commissioner,Ashley Nicole Mccray,DEM,720086,0,0,56,56,
Tulsa,Corporation Commissioner,Blake Cummings,DEM,720086,0,0,16,16,
Tulsa,U.S. House,Tim Gilpin,DEM,720086,0,0,36,36,01
Tulsa,U.S. House,Amanda Douglas,DEM,720086,0,0,36,36,01
Tulsa,Governor,Mick Cornett,REP,720087,0,0,98,98,
Tulsa,Governor,Kevin Stitt,REP,720087,0,0,137,137,
Tulsa,Lieutenant Governor,Dana Murphy,REP,720087,0,0,80,80,
Tulsa,Lieutenant Governor,Matt Pinnell,REP,720087,0,0,153,153,
Tulsa,State Auditor,Cindy Byrd,REP,720087,0,0,121,121,
Tulsa,State Auditor,Charlie Prater,REP,720087,0,0,108,108,
Tulsa,Attorney General,Mike Hunter,REP,720087,0,0,101,101,
Tulsa,Attorney General,Gentner Drummond,REP,720087,0,0,131,131,
Tulsa,Superintendent of Public Instruction,Joy Hofmeister,REP,720087,0,0,137,137,
Tulsa,Superintendent of Public Instruction,Linda Murphy,REP,720087,0,0,92,92,
Tulsa,Commissioner of Labor,Cathy Costello,REP,720087,0,0,92,92,
Tulsa,Commissioner of Labor,Leslie Osborn,REP,720087,0,0,131,131,
Tulsa,Corporation Commissioner,Bob Anthony,REP,720087,0,0,109,109,
Tulsa,Corporation Commissioner,Brian Bingman,REP,720087,0,0,118,118,
Tulsa,U.S. House,Tim Harris,REP,720087,0,0,109,109,01
Tulsa,U.S. House,Kevin Hern,REP,720087,0,0,124,124,01
Tulsa,State House,Karen Gilbert,REP,720087,0,0,142,142,79
Tulsa,State House,Dan Hicks,REP,720087,0,0,91,91,79
Tulsa,Governor,Chris Powell,LIB,720087,0,0,0,0,
Tulsa,Governor,Rex Lawhorn,LIB,720087,0,0,0,0,
Tulsa,Corporation Commissioner,Ashley Nicole Mccray,DEM,720087,0,0,79,79,
Tulsa,Corporation Commissioner,Blake Cummings,DEM,720087,0,0,27,27,
Tulsa,U.S. House,Tim Gilpin,DEM,720087,0,0,58,58,01
Tulsa,U.S. House,Amanda Douglas,DEM,720087,0,0,50,50,01
Tulsa,Governor,Mick Cornett,REP,720088,0,0,26,26,
Tulsa,Governor,Kevin Stitt,REP,720088,0,0,20,20,
Tulsa,Lieutenant Governor,Dana Murphy,REP,720088,0,0,25,25,
Tulsa,Lieutenant Governor,Matt Pinnell,REP,720088,0,0,20,20,
Tulsa,State Auditor,Cindy Byrd,REP,720088,0,0,27,27,
Tulsa,State Auditor,Charlie Prater,REP,720088,0,0,17,17,
Tulsa,Attorney General,Mike Hunter,REP,720088,0,0,28,28,
Tulsa,Attorney General,Gentner Drummond,REP,720088,0,0,17,17,
Tulsa,Superintendent of Public Instruction,Joy Hofmeister,REP,720088,0,0,24,24,
Tulsa,Superintendent of Public Instruction,Linda Murphy,REP,720088,0,0,21,21,
Tulsa,Commissioner of Labor,Cathy Costello,REP,720088,0,0,26,26,
Tulsa,Commissioner of Labor,Leslie Osborn,REP,720088,0,0,19,19,
Tulsa,Corporation Commissioner,Bob Anthony,REP,720088,0,0,28,28,
Tulsa,Corporation Commissioner,Brian Bingman,REP,720088,0,0,16,16,
Tulsa,U.S. House,Tim Harris,REP,720088,0,0,32,32,01
Tulsa,U.S. House,Kevin Hern,REP,720088,0,0,13,13,01
Tulsa,Governor,Chris Powell,LIB,720088,0,0,0,0,
Tulsa,Governor,Rex Lawhorn,LIB,720088,0,0,0,0,
Tulsa,Corporation Commissioner,Ashley Nicole Mccray,DEM,720088,0,0,16,16,
Tulsa,Corporation Commissioner,Blake Cummings,DEM,720088,0,0,11,11,
Tulsa,U.S. House,Tim Gilpin,DEM,720088,0,0,17,17,01
Tulsa,U.S. House,Amanda Douglas,DEM,720088,0,0,10,10,01
Tulsa,Governor,Mick Cornett,REP,720089,0,0,27,27,
Tulsa,Governor,Kevin Stitt,REP,720089,0,0,47,47,
Tulsa,Lieutenant Governor,Dana Murphy,REP,720089,0,0,32,32,
Tulsa,Lieutenant Governor,Matt Pinnell,REP,720089,0,0,41,41,
Tulsa,State Auditor,Cindy Byrd,REP,720089,0,0,41,41,
Tulsa,State Auditor,Charlie Prater,REP,720089,0,0,32,32,
Tulsa,Attorney General,Mike Hunter,REP,720089,0,0,28,28,
Tulsa,Attorney General,Gentner Drummond,REP,720089,0,0,44,44,
Tulsa,Superintendent of Public Instruction,Joy Hofmeister,REP,720089,0,0,34,34,
Tulsa,Superintendent of Public Instruction,Linda Murphy,REP,720089,0,0,38,38,
Tulsa,Commissioner of Labor,Cathy Costello,REP,720089,0,0,37,37,
Tulsa,Commissioner of Labor,Leslie Osborn,REP,720089,0,0,34,34,
Tulsa,Corporation Commissioner,Bob Anthony,REP,720089,0,0,38,38,
Tulsa,Corporation Commissioner,Brian Bingman,REP,720089,0,0,32,32,
Tulsa,U.S. House,Tim Harris,REP,720089,0,0,36,36,01
Tulsa,U.S. House,Kevin Hern,REP,720089,0,0,38,38,01
Tulsa,Governor,Chris Powell,LIB,720089,0,0,1,1,
Tulsa,Governor,Rex Lawhorn,LIB,720089,0,0,1,1,
Tulsa,Corporation Commissioner,Ashley Nicole Mccray,DEM,720089,0,0,35,35,
Tulsa,Corporation Commissioner,Blake Cummings,DEM,720089,0,0,15,15,
Tulsa,U.S. House,Tim Gilpin,DEM,720089,0,0,30,30,01
Tulsa,U.S. House,Amanda Douglas,DEM,720089,0,0,20,20,01
Tulsa,Governor,Mick Cornett,REP,720090,0,0,15,15,
Tulsa,Governor,Kevin Stitt,REP,720090,0,0,22,22,
Tulsa,Lieutenant Governor,Dana Murphy,REP,720090,0,0,15,15,
Tulsa,Lieutenant Governor,Matt Pinnell,REP,720090,0,0,22,22,
Tulsa,State Auditor,Cindy Byrd,REP,720090,0,0,16,16,
Tulsa,State Auditor,Charlie Prater,REP,720090,0,0,20,20,
Tulsa,Attorney General,Mike Hunter,REP,720090,0,0,12,12,
Tulsa,Attorney General,Gentner Drummond,REP,720090,0,0,24,24,
Tulsa,Superintendent of Public Instruction,Joy Hofmeister,REP,720090,0,0,21,21,
Tulsa,Superintendent of Public Instruction,Linda Murphy,REP,720090,0,0,15,15,
Tulsa,Commissioner of Labor,Cathy Costello,REP,720090,0,0,12,12,
Tulsa,Commissioner of Labor,Leslie Osborn,REP,720090,0,0,23,23,
Tulsa,Corporation Commissioner,Bob Anthony,REP,720090,0,0,18,18,
Tulsa,Corporation Commissioner,Brian Bingman,REP,720090,0,0,17,17,
Tulsa,U.S. House,Tim Harris,REP,720090,0,0,13,13,01
Tulsa,U.S. House,Kevin Hern,REP,720090,0,0,24,24,01
Tulsa,State Senate,John Haste,REP,720090,0,0,13,13,36
Tulsa,State Senate,Bill Day,REP,720090,0,0,19,19,36
Tulsa,Governor,Chris Powell,LIB,720090,0,0,0,0,
Tulsa,Governor,Rex Lawhorn,LIB,720090,0,0,0,0,
Tulsa,Corporation Commissioner,Ashley Nicole Mccray,DEM,720090,0,0,16,16,
Tulsa,Corporation Commissioner,Blake Cummings,DEM,720090,0,0,7,7,
Tulsa,U.S. House,Tim Gilpin,DEM,720090,0,0,10,10,01
Tulsa,U.S. House,Amanda Douglas,DEM,720090,0,0,13,13,01
Tulsa,Governor,Mick Cornett,REP,720091,0,0,40,40,
Tulsa,Governor,Kevin Stitt,REP,720091,0,0,62,62,
Tulsa,Lieutenant Governor,Dana Murphy,REP,720091,0,0,46,46,
Tulsa,Lieutenant Governor,Matt Pinnell,REP,720091,0,0,49,49,
Tulsa,State Auditor,Cindy Byrd,REP,720091,0,0,55,55,
Tulsa,State Auditor,Charlie Prater,REP,720091,0,0,40,40,
Tulsa,Attorney General,Mike Hunter,REP,720091,0,0,48,48,
Tulsa,Attorney General,Gentner Drummond,REP,720091,0,0,49,49,
Tulsa,Superintendent of Public Instruction,Joy Hofmeister,REP,720091,0,0,47,47,
Tulsa,Superintendent of Public Instruction,Linda Murphy,REP,720091,0,0,51,51,
Tulsa,Commissioner of Labor,Cathy Costello,REP,720091,0,0,45,45,
Tulsa,Commissioner of Labor,Leslie Osborn,REP,720091,0,0,48,48,
Tulsa,Corporation Commissioner,Bob Anthony,REP,720091,0,0,58,58,
Tulsa,Corporation Commissioner,Brian Bingman,REP,720091,0,0,38,38,
Tulsa,U.S. House,Tim Harris,REP,720091,0,0,45,45,01
Tulsa,U.S. House,Kevin Hern,REP,720091,0,0,55,55,01
Tulsa,State House,Karen Gilbert,REP,720091,0,0,56,56,79
Tulsa,State House,Dan Hicks,REP,720091,0,0,45,45,79
Tulsa,Governor,Chris Powell,LIB,720091,0,0,1,1,
Tulsa,Governor,Rex Lawhorn,LIB,720091,0,0,0,0,
Tulsa,Corporation Commissioner,Ashley Nicole Mccray,DEM,720091,0,0,44,44,
Tulsa,Corporation Commissioner,Blake Cummings,DEM,720091,0,0,15,15,
Tulsa,U.S. House,Tim Gilpin,DEM,720091,0,0,27,27,01
Tulsa,U.S. House,Amanda Douglas,DEM,720091,0,0,32,32,01
Tulsa,Governor,Mick Cornett,REP,720092,0,0,33,33,
Tulsa,Governor,Kevin Stitt,REP,720092,0,0,75,75,
Tulsa,Lieutenant Governor,Dana Murphy,REP,720092,0,0,48,48,
Tulsa,Lieutenant Governor,Matt Pinnell,REP,720092,0,0,57,57,
Tulsa,State Auditor,Cindy Byrd,REP,720092,0,0,58,58,
Tulsa,State Auditor,Charlie Prater,REP,720092,0,0,44,44,
Tulsa,Attorney General,Mike Hunter,REP,720092,0,0,46,46,
Tulsa,Attorney General,Gentner Drummond,REP,720092,0,0,56,56,
Tulsa,Superintendent of Public Instruction,Joy Hofmeister,REP,720092,0,0,50,50,
Tulsa,Superintendent of Public Instruction,Linda Murphy,REP,720092,0,0,53,53,
Tulsa,Commissioner of Labor,Cathy Costello,REP,720092,0,0,43,43,
Tulsa,Commissioner of Labor,Leslie Osborn,REP,720092,0,0,59,59,
Tulsa,Corporation Commissioner,Bob Anthony,REP,720092,0,0,47,47,
Tulsa,Corporation Commissioner,Brian Bingman,REP,720092,0,0,56,56,
Tulsa,U.S. House,Tim Harris,REP,720092,0,0,42,42,01
Tulsa,U.S. House,Kevin Hern,REP,720092,0,0,64,64,01
Tulsa,Governor,Chris Powell,LIB,720092,0,0,2,2,
Tulsa,Governor,Rex Lawhorn,LIB,720092,0,0,0,0,
Tulsa,Corporation Commissioner,Ashley Nicole Mccray,DEM,720092,0,0,39,39,
Tulsa,Corporation Commissioner,Blake Cummings,DEM,720092,0,0,12,12,
Tulsa,U.S. House,Tim Gilpin,DEM,720092,0,0,28,28,01
Tulsa,U.S. House,Amanda Douglas,DEM,720092,0,0,23,23,01
Tulsa,Governor,Mick Cornett,REP,720093,0,0,39,39,
Tulsa,Governor,Kevin Stitt,REP,720093,0,0,51,51,
Tulsa,Lieutenant Governor,Dana Murphy,REP,720093,0,0,30,30,
Tulsa,Lieutenant Governor,Matt Pinnell,REP,720093,0,0,56,56,
Tulsa,State Auditor,Cindy Byrd,REP,720093,0,0,47,47,
Tulsa,State Auditor,Charlie Prater,REP,720093,0,0,35,35,
Tulsa,Attorney General,Mike Hunter,REP,720093,0,0,30,30,
Tulsa,Attorney General,Gentner Drummond,REP,720093,0,0,58,58,
Tulsa,Superintendent of Public Instruction,Joy Hofmeister,REP,720093,0,0,53,53,
Tulsa,Superintendent of Public Instruction,Linda Murphy,REP,720093,0,0,30,30,
Tulsa,Commissioner of Labor,Cathy Costello,REP,720093,0,0,47,47,
Tulsa,Commissioner of Labor,Leslie Osborn,REP,720093,0,0,37,37,
Tulsa,Corporation Commissioner,Bob Anthony,REP,720093,0,0,44,44,
Tulsa,Corporation Commissioner,Brian Bingman,REP,720093,0,0,39,39,
Tulsa,U.S. House,Tim Harris,REP,720093,0,0,35,35,01
Tulsa,U.S. House,Kevin Hern,REP,720093,0,0,55,55,01
Tulsa,Governor,Chris Powell,LIB,720093,0,0,0,0,
Tulsa,Governor,Rex Lawhorn,LIB,720093,0,0,1,1,
Tulsa,Corporation Commissioner,Ashley Nicole Mccray,DEM,720093,0,0,36,36,
Tulsa,Corporation Commissioner,Blake Cummings,DEM,720093,0,0,18,18,
Tulsa,U.S. House,Tim Gilpin,DEM,720093,0,0,29,29,01
Tulsa,U.S. House,Amanda Douglas,DEM,720093,0,0,24,24,01
Tulsa,Governor,Mick Cornett,REP,720094,0,0,58,58,
Tulsa,Governor,Kevin Stitt,REP,720094,0,0,107,107,
Tulsa,Lieutenant Governor,Dana Murphy,REP,720094,0,0,65,65,
Tulsa,Lieutenant Governor,Matt Pinnell,REP,720094,0,0,98,98,
Tulsa,State Auditor,Cindy Byrd,REP,720094,0,0,75,75,
Tulsa,State Auditor,Charlie Prater,REP,720094,0,0,78,78,
Tulsa,Attorney General,Mike Hunter,REP,720094,0,0,61,61,
Tulsa,Attorney General,Gentner Drummond,REP,720094,0,0,101,101,
Tulsa,Superintendent of Public Instruction,Joy Hofmeister,REP,720094,0,0,98,98,
Tulsa,Superintendent of Public Instruction,Linda Murphy,REP,720094,0,0,59,59,
Tulsa,Commissioner of Labor,Cathy Costello,REP,720094,0,0,77,77,
Tulsa,Commissioner of Labor,Leslie Osborn,REP,720094,0,0,79,79,
Tulsa,Corporation Commissioner,Bob Anthony,REP,720094,0,0,75,75,
Tulsa,Corporation Commissioner,Brian Bingman,REP,720094,0,0,81,81,
Tulsa,U.S. House,Tim Harris,REP,720094,0,0,69,69,01
Tulsa,U.S. House,Kevin Hern,REP,720094,0,0,92,92,01
Tulsa,Governor,Chris Powell,LIB,720094,0,0,3,3,
Tulsa,Governor,Rex Lawhorn,LIB,720094,0,0,0,0,
Tulsa,Corporation Commissioner,Ashley Nicole Mccray,DEM,720094,0,0,47,47,
Tulsa,Corporation Commissioner,Blake Cummings,DEM,720094,0,0,23,23,
Tulsa,U.S. House,Tim Gilpin,DEM,720094,0,0,45,45,01
Tulsa,U.S. House,Amanda Douglas,DEM,720094,0,0,24,24,01
Tulsa,Governor,Mick Cornett,REP,720095,0,0,52,52,
Tulsa,Governor,Kevin Stitt,REP,720095,0,0,119,119,
Tulsa,Lieutenant Governor,Dana Murphy,REP,720095,0,0,69,69,
Tulsa,Lieutenant Governor,Matt Pinnell,REP,720095,0,0,100,100,
Tulsa,State Auditor,Cindy Byrd,REP,720095,0,0,89,89,
Tulsa,State Auditor,Charlie Prater,REP,720095,0,0,71,71,
Tulsa,Attorney General,Mike Hunter,REP,720095,0,0,84,84,
Tulsa,Attorney General,Gentner Drummond,REP,720095,0,0,88,88,
Tulsa,Superintendent of Public Instruction,Joy Hofmeister,REP,720095,0,0,92,92,
Tulsa,Superintendent of Public Instruction,Linda Murphy,REP,720095,0,0,78,78,
Tulsa,Commissioner of Labor,Cathy Costello,REP,720095,0,0,87,87,
Tulsa,Commissioner of Labor,Leslie Osborn,REP,720095,0,0,77,77,
Tulsa,Corporation Commissioner,Bob Anthony,REP,720095,0,0,93,93,
Tulsa,Corporation Commissioner,Brian Bingman,REP,720095,0,0,72,72,
Tulsa,U.S. House,Tim Harris,REP,720095,0,0,70,70,01
Tulsa,U.S. House,Kevin Hern,REP,720095,0,0,98,98,01
Tulsa,Governor,Chris Powell,LIB,720095,0,0,1,1,
Tulsa,Governor,Rex Lawhorn,LIB,720095,0,0,1,1,
Tulsa,Corporation Commissioner,Ashley Nicole Mccray,DEM,720095,0,0,47,47,
Tulsa,Corporation Commissioner,Blake Cummings,DEM,720095,0,0,13,13,
Tulsa,U.S. House,Tim Gilpin,DEM,720095,0,0,27,27,01
Tulsa,U.S. House,Amanda Douglas,DEM,720095,0,0,33,33,01
Tulsa,Governor,Mick Cornett,REP,720096,0,0,28,28,
Tulsa,Governor,Kevin Stitt,REP,720096,0,0,67,67,
Tulsa,Lieutenant Governor,Dana Murphy,REP,720096,0,0,32,32,
Tulsa,Lieutenant Governor,Matt Pinnell,REP,720096,0,0,63,63,
Tulsa,State Auditor,Cindy Byrd,REP,720096,0,0,50,50,
Tulsa,State Auditor,Charlie Prater,REP,720096,0,0,44,44,
Tulsa,Attorney General,Mike Hunter,REP,720096,0,0,49,49,
Tulsa,Attorney General,Gentner Drummond,REP,720096,0,0,46,46,
Tulsa,Superintendent of Public Instruction,Joy Hofmeister,REP,720096,0,0,60,60,
Tulsa,Superintendent of Public Instruction,Linda Murphy,REP,720096,0,0,35,35,
Tulsa,Commissioner of Labor,Cathy Costello,REP,720096,0,0,41,41,
Tulsa,Commissioner of Labor,Leslie Osborn,REP,720096,0,0,52,52,
Tulsa,Corporation Commissioner,Bob Anthony,REP,720096,0,0,49,49,
Tulsa,Corporation Commissioner,Brian Bingman,REP,720096,0,0,47,47,
Tulsa,U.S. House,Tim Harris,REP,720096,0,0,40,40,01
Tulsa,U.S. House,Kevin Hern,REP,720096,0,0,56,56,01
Tulsa,Governor,Chris Powell,LIB,720096,0,0,0,0,
Tulsa,Governor,Rex Lawhorn,LIB,720096,0,0,0,0,
Tulsa,Corporation Commissioner,Ashley Nicole Mccray,DEM,720096,0,0,43,43,
Tulsa,Corporation Commissioner,Blake Cummings,DEM,720096,0,0,16,16,
Tulsa,U.S. House,Tim Gilpin,DEM,720096,0,0,36,36,01
Tulsa,U.S. House,Amanda Douglas,DEM,720096,0,0,23,23,01
Tulsa,Governor,Mick Cornett,REP,720097,0,0,58,58,
Tulsa,Governor,Kevin Stitt,REP,720097,0,0,97,97,
Tulsa,Lieutenant Governor,Dana Murphy,REP,720097,0,0,61,61,
Tulsa,Lieutenant Governor,Matt Pinnell,REP,720097,0,0,94,94,
Tulsa,State Auditor,Cindy Byrd,REP,720097,0,0,77,77,
Tulsa,State Auditor,Charlie Prater,REP,720097,0,0,73,73,
Tulsa,Attorney General,Mike Hunter,REP,720097,0,0,78,78,
Tulsa,Attorney General,Gentner Drummond,REP,720097,0,0,78,78,
Tulsa,Superintendent of Public Instruction,Joy Hofmeister,REP,720097,0,0,75,75,
Tulsa,Superintendent of Public Instruction,Linda Murphy,REP,720097,0,0,78,78,
Tulsa,Commissioner of Labor,Cathy Costello,REP,720097,0,0,84,84,
Tulsa,Commissioner of Labor,Leslie Osborn,REP,720097,0,0,68,68,
Tulsa,Corporation Commissioner,Bob Anthony,REP,720097,0,0,88,88,
Tulsa,Corporation Commissioner,Brian Bingman,REP,720097,0,0,62,62,
Tulsa,U.S. House,Tim Harris,REP,720097,0,0,82,82,01
Tulsa,U.S. House,Kevin Hern,REP,720097,0,0,73,73,01
Tulsa,Governor,Chris Powell,LIB,720097,0,0,0,0,
Tulsa,Governor,Rex Lawhorn,LIB,720097,0,0,0,0,
Tulsa,Corporation Commissioner,Ashley Nicole Mccray,DEM,720097,0,0,42,42,
Tulsa,Corporation Commissioner,Blake Cummings,DEM,720097,0,0,14,14,
Tulsa,U.S. House,Tim Gilpin,DEM,720097,0,0,30,30,01
Tulsa,U.S. House,Amanda Douglas,DEM,720097,0,0,27,27,01
Tulsa,Governor,Mick Cornett,REP,720098,0,0,37,37,
Tulsa,Governor,Kevin Stitt,REP,720098,0,0,67,67,
Tulsa,Lieutenant Governor,Dana Murphy,REP,720098,0,0,40,40,
Tulsa,Lieutenant Governor,Matt Pinnell,REP,720098,0,0,62,62,
Tulsa,State Auditor,Cindy Byrd,REP,720098,0,0,52,52,
Tulsa,State Auditor,Charlie Prater,REP,720098,0,0,49,49,
Tulsa,Attorney General,Mike Hunter,REP,720098,0,0,42,42,
Tulsa,Attorney General,Gentner Drummond,REP,720098,0,0,60,60,
Tulsa,Superintendent of Public Instruction,Joy Hofmeister,REP,720098,0,0,50,50,
Tulsa,Superintendent of Public Instruction,Linda Murphy,REP,720098,0,0,52,52,
Tulsa,Commissioner of Labor,Cathy Costello,REP,720098,0,0,39,39,
Tulsa,Commissioner of Labor,Leslie Osborn,REP,720098,0,0,62,62,
Tulsa,Corporation Commissioner,Bob Anthony,REP,720098,0,0,49,49,
Tulsa,Corporation Commissioner,Brian Bingman,REP,720098,0,0,54,54,
Tulsa,U.S. House,Tim Harris,REP,720098,0,0,47,47,01
Tulsa,U.S. House,Kevin Hern,REP,720098,0,0,57,57,01
Tulsa,State Senate,John Haste,REP,720098,0,0,46,46,36
Tulsa,State Senate,Bill Day,REP,720098,0,0,55,55,36
Tulsa,Governor,Chris Powell,LIB,720098,0,0,0,0,
Tulsa,Governor,Rex Lawhorn,LIB,720098,0,0,0,0,
Tulsa,Corporation Commissioner,Ashley Nicole Mccray,DEM,720098,0,0,48,48,
Tulsa,Corporation Commissioner,Blake Cummings,DEM,720098,0,0,23,23,
Tulsa,U.S. House,Tim Gilpin,DEM,720098,0,0,34,34,01
Tulsa,U.S. House,Amanda Douglas,DEM,720098,0,0,37,37,01
Tulsa,Governor,Mick Cornett,REP,720099,0,0,18,18,
Tulsa,Governor,Kevin Stitt,REP,720099,0,0,60,60,
Tulsa,Lieutenant Governor,Dana Murphy,REP,720099,0,0,33,33,
Tulsa,Lieutenant Governor,Matt Pinnell,REP,720099,0,0,43,43,
Tulsa,State Auditor,Cindy Byrd,REP,720099,0,0,43,43,
Tulsa,State Auditor,Charlie Prater,REP,720099,0,0,30,30,
Tulsa,Attorney General,Mike Hunter,REP,720099,0,0,34,34,
Tulsa,Attorney General,Gentner Drummond,REP,720099,0,0,44,44,
Tulsa,Superintendent of Public Instruction,Joy Hofmeister,REP,720099,0,0,39,39,
Tulsa,Superintendent of Public Instruction,Linda Murphy,REP,720099,0,0,39,39,
Tulsa,Commissioner of Labor,Cathy Costello,REP,720099,0,0,34,34,
Tulsa,Commissioner of Labor,Leslie Osborn,REP,720099,0,0,39,39,
Tulsa,Corporation Commissioner,Bob Anthony,REP,720099,0,0,41,41,
Tulsa,Corporation Commissioner,Brian Bingman,REP,720099,0,0,33,33,
Tulsa,U.S. House,Tim Harris,REP,720099,0,0,36,36,01
Tulsa,U.S. House,Kevin Hern,REP,720099,0,0,41,41,01
Tulsa,State Senate,John Haste,REP,720099,0,0,40,40,36
Tulsa,State Senate,Bill Day,REP,720099,0,0,34,34,36
Tulsa,Governor,Chris Powell,LIB,720099,0,0,0,0,
Tulsa,Governor,Rex Lawhorn,LIB,720099,0,0,0,0,
Tulsa,Corporation Commissioner,Ashley Nicole Mccray,DEM,720099,0,0,42,42,
Tulsa,Corporation Commissioner,Blake Cummings,DEM,720099,0,0,12,12,
Tulsa,U.S. House,Tim Gilpin,DEM,720099,0,0,33,33,01
Tulsa,U.S. House,Amanda Douglas,DEM,720099,0,0,21,21,01
Tulsa,Governor,Mick Cornett,REP,720100,0,0,24,24,
Tulsa,Governor,Kevin Stitt,REP,720100,0,0,35,35,
Tulsa,Lieutenant Governor,Dana Murphy,REP,720100,0,0,24,24,
Tulsa,Lieutenant Governor,Matt Pinnell,REP,720100,0,0,33,33,
Tulsa,State Auditor,Cindy Byrd,REP,720100,0,0,31,31,
Tulsa,State Auditor,Charlie Prater,REP,720100,0,0,23,23,
Tulsa,Attorney General,Mike Hunter,REP,720100,0,0,29,29,
Tulsa,Attorney General,Gentner Drummond,REP,720100,0,0,29,29,
Tulsa,Superintendent of Public Instruction,Joy Hofmeister,REP,720100,0,0,35,35,
Tulsa,Superintendent of Public Instruction,Linda Murphy,REP,720100,0,0,23,23,
Tulsa,Commissioner of Labor,Cathy Costello,REP,720100,0,0,22,22,
Tulsa,Commissioner of Labor,Leslie Osborn,REP,720100,0,0,35,35,
Tulsa,Corporation Commissioner,Bob Anthony,REP,720100,0,0,30,30,
Tulsa,Corporation Commissioner,Brian Bingman,REP,720100,0,0,24,24,
Tulsa,U.S. House,Tim Harris,REP,720100,0,0,29,29,01
Tulsa,U.S. House,Kevin Hern,REP,720100,0,0,28,28,01
Tulsa,Governor,Chris Powell,LIB,720100,0,0,0,0,
Tulsa,Governor,Rex Lawhorn,LIB,720100,0,0,0,0,
Tulsa,Corporation Commissioner,Ashley Nicole Mccray,DEM,720100,0,0,17,17,
Tulsa,Corporation Commissioner,Blake Cummings,DEM,720100,0,0,8,8,
Tulsa,U.S. House,Tim Gilpin,DEM,720100,0,0,11,11,01
Tulsa,U.S. House,Amanda Douglas,DEM,720100,0,0,14,14,01
Tulsa,Governor,Mick Cornett,REP,720101,0,0,70,70,
Tulsa,Governor,Kevin Stitt,REP,720101,0,0,86,86,
Tulsa,Lieutenant Governor,Dana Murphy,REP,720101,0,0,57,57,
Tulsa,Lieutenant Governor,Matt Pinnell,REP,720101,0,0,92,92,
Tulsa,State Auditor,Cindy Byrd,REP,720101,0,0,85,85,
Tulsa,State Auditor,Charlie Prater,REP,720101,0,0,63,63,
Tulsa,Attorney General,Mike Hunter,REP,720101,0,0,74,74,
Tulsa,Attorney General,Gentner Drummond,REP,720101,0,0,77,77,
Tulsa,Superintendent of Public Instruction,Joy Hofmeister,REP,720101,0,0,76,76,
Tulsa,Superintendent of Public Instruction,Linda Murphy,REP,720101,0,0,77,77,
Tulsa,Commissioner of Labor,Cathy Costello,REP,720101,0,0,60,60,
Tulsa,Commissioner of Labor,Leslie Osborn,REP,720101,0,0,89,89,
Tulsa,Corporation Commissioner,Bob Anthony,REP,720101,0,0,65,65,
Tulsa,Corporation Commissioner,Brian Bingman,REP,720101,0,0,84,84,
Tulsa,U.S. House,Tim Harris,REP,720101,0,0,60,60,01
Tulsa,U.S. House,Kevin Hern,REP,720101,0,0,96,96,01
Tulsa,State Senate,John Haste,REP,720101,0,0,72,72,36
Tulsa,State Senate,Bill Day,REP,720101,0,0,77,77,36
Tulsa,Governor,Chris Powell,LIB,720101,0,0,0,0,
Tulsa,Governor,Rex Lawhorn,LIB,720101,0,0,0,0,
Tulsa,Corporation Commissioner,Ashley Nicole Mccray,DEM,720101,0,0,49,49,
Tulsa,Corporation Commissioner,Blake Cummings,DEM,720101,0,0,21,21,
Tulsa,U.S. House,Tim Gilpin,DEM,720101,0,0,36,36,01
Tulsa,U.S. House,Amanda Douglas,DEM,720101,0,0,34,34,01
Tulsa,Governor,Mick Cornett,REP,720102,0,0,41,41,
Tulsa,Governor,Kevin Stitt,REP,720102,0,0,74,74,
Tulsa,Lieutenant Governor,Dana Murphy,REP,720102,0,0,47,47,
Tulsa,Lieutenant Governor,Matt Pinnell,REP,720102,0,0,69,69,
Tulsa,State Auditor,Cindy Byrd,REP,720102,0,0,61,61,
Tulsa,State Auditor,Charlie Prater,REP,720102,0,0,52,52,
Tulsa,Attorney General,Mike Hunter,REP,720102,0,0,55,55,
Tulsa,Attorney General,Gentner Drummond,REP,720102,0,0,59,59,
Tulsa,Superintendent of Public Instruction,Joy Hofmeister,REP,720102,0,0,63,63,
Tulsa,Superintendent of Public Instruction,Linda Murphy,REP,720102,0,0,51,51,
Tulsa,Commissioner of Labor,Cathy Costello,REP,720102,0,0,48,48,
Tulsa,Commissioner of Labor,Leslie Osborn,REP,720102,0,0,65,65,
Tulsa,Corporation Commissioner,Bob Anthony,REP,720102,0,0,62,62,
Tulsa,Corporation Commissioner,Brian Bingman,REP,720102,0,0,51,51,
Tulsa,U.S. House,Tim Harris,REP,720102,0,0,50,50,01
Tulsa,U.S. House,Kevin Hern,REP,720102,0,0,66,66,01
Tulsa,State Senate,John Haste,REP,720102,0,0,61,61,36
Tulsa,State Senate,Bill Day,REP,720102,0,0,57,57,36
Tulsa,Governor,Chris Powell,LIB,720102,0,0,0,0,
Tulsa,Governor,Rex Lawhorn,LIB,720102,0,0,2,2,
Tulsa,Corporation Commissioner,Ashley Nicole Mccray,DEM,720102,0,0,49,49,
Tulsa,Corporation Commissioner,Blake Cummings,DEM,720102,0,0,24,24,
Tulsa,U.S. House,Tim Gilpin,DEM,720102,0,0,44,44,01
Tulsa,U.S. House,Amanda Douglas,DEM,720102,0,0,29,29,01
Tulsa,Governor,Mick Cornett,REP,720103,0,0,23,23,
Tulsa,Governor,Kevin Stitt,REP,720103,0,0,44,44,
Tulsa,Lieutenant Governor,Dana Murphy,REP,720103,0,0,27,27,
Tulsa,Lieutenant Governor,Matt Pinnell,REP,720103,0,0,39,39,
Tulsa,State Auditor,Cindy Byrd,REP,720103,0,0,36,36,
Tulsa,State Auditor,Charlie Prater,REP,720103,0,0,31,31,
Tulsa,Attorney General,Mike Hunter,REP,720103,0,0,32,32,
Tulsa,Attorney General,Gentner Drummond,REP,720103,0,0,36,36,
Tulsa,Superintendent of Public Instruction,Joy Hofmeister,REP,720103,0,0,37,37,
Tulsa,Superintendent of Public Instruction,Linda Murphy,REP,720103,0,0,30,30,
Tulsa,Commissioner of Labor,Cathy Costello,REP,720103,0,0,32,32,
Tulsa,Commissioner of Labor,Leslie Osborn,REP,720103,0,0,35,35,
Tulsa,Corporation Commissioner,Bob Anthony,REP,720103,0,0,31,31,
Tulsa,Corporation Commissioner,Brian Bingman,REP,720103,0,0,33,33,
Tulsa,U.S. House,Tim Harris,REP,720103,0,0,30,30,01
Tulsa,U.S. House,Kevin Hern,REP,720103,0,0,37,37,01
Tulsa,State Senate,John Haste,REP,720103,0,0,17,17,36
Tulsa,State Senate,Bill Day,REP,720103,0,0,50,50,36
Tulsa,Governor,Chris Powell,LIB,720103,0,0,0,0,
Tulsa,Governor,Rex Lawhorn,LIB,720103,0,0,0,0,
Tulsa,Corporation Commissioner,Ashley Nicole Mccray,DEM,720103,0,0,32,32,
Tulsa,Corporation Commissioner,Blake Cummings,DEM,720103,0,0,7,7,
Tulsa,U.S. House,Tim Gilpin,DEM,720103,0,0,20,20,01
Tulsa,U.S. House,Amanda Douglas,DEM,720103,0,0,18,18,01
Tulsa,Governor,Mick Cornett,REP,720104,0,0,39,39,
Tulsa,Governor,Kevin Stitt,REP,720104,0,0,76,76,
Tulsa,Lieutenant Governor,Dana Murphy,REP,720104,0,0,47,47,
Tulsa,Lieutenant Governor,Matt Pinnell,REP,720104,0,0,66,66,
Tulsa,State Auditor,Cindy Byrd,REP,720104,0,0,67,67,
Tulsa,State Auditor,Charlie Prater,REP,720104,0,0,43,43,
Tulsa,Attorney General,Mike Hunter,REP,720104,0,0,44,44,
Tulsa,Attorney General,Gentner Drummond,REP,720104,0,0,67,67,
Tulsa,Superintendent of Public Instruction,Joy Hofmeister,REP,720104,0,0,64,64,
Tulsa,Superintendent of Public Instruction,Linda Murphy,REP,720104,0,0,50,50,
Tulsa,Commissioner of Labor,Cathy Costello,REP,720104,0,0,64,64,
Tulsa,Commissioner of Labor,Leslie Osborn,REP,720104,0,0,49,49,
Tulsa,Corporation Commissioner,Bob Anthony,REP,720104,0,0,56,56,
Tulsa,Corporation Commissioner,Brian Bingman,REP,720104,0,0,55,55,
Tulsa,U.S. House,Tim Harris,REP,720104,0,0,52,52,01
Tulsa,U.S. House,Kevin Hern,REP,720104,0,0,59,59,01
Tulsa,State Senate,John Haste,REP,720104,0,0,50,50,36
Tulsa,State Senate,Bill Day,REP,720104,0,0,57,57,36
Tulsa,Governor,Chris Powell,LIB,720104,0,0,0,0,
Tulsa,Governor,Rex Lawhorn,LIB,720104,0,0,0,0,
Tulsa,Corporation Commissioner,Ashley Nicole Mccray,DEM,720104,0,0,47,47,
Tulsa,Corporation Commissioner,Blake Cummings,DEM,720104,0,0,16,16,
Tulsa,U.S. House,Tim Gilpin,DEM,720104,0,0,30,30,01
Tulsa,U.S. House,Amanda Douglas,DEM,720104,0,0,34,34,01
Tulsa,Governor,Mick Cornett,REP,720105,0,0,43,43,
Tulsa,Governor,Kevin Stitt,REP,720105,0,0,77,77,
Tulsa,Lieutenant Governor,Dana Murphy,REP,720105,0,0,46,46,
Tulsa,Lieutenant Governor,Matt Pinnell,REP,720105,0,0,74,74,
Tulsa,State Auditor,Cindy Byrd,REP,720105,0,0,50,50,
Tulsa,State Auditor,Charlie Prater,REP,720105,0,0,67,67,
Tulsa,Attorney General,Mike Hunter,REP,720105,0,0,50,50,
Tulsa,Attorney General,Gentner Drummond,REP,720105,0,0,69,69,
Tulsa,Superintendent of Public Instruction,Joy Hofmeister,REP,720105,0,0,70,70,
Tulsa,Superintendent of Public Instruction,Linda Murphy,REP,720105,0,0,47,47,
Tulsa,Commissioner of Labor,Cathy Costello,REP,720105,0,0,55,55,
Tulsa,Commissioner of Labor,Leslie Osborn,REP,720105,0,0,64,64,
Tulsa,Corporation Commissioner,Bob Anthony,REP,720105,0,0,61,61,
Tulsa,Corporation Commissioner,Brian Bingman,REP,720105,0,0,58,58,
Tulsa,U.S. House,Tim Harris,REP,720105,0,0,51,51,01
Tulsa,U.S. House,Kevin Hern,REP,720105,0,0,69,69,01
Tulsa,State Senate,John Haste,REP,720105,0,0,65,65,36
Tulsa,State Senate,Bill Day,REP,720105,0,0,54,54,36
Tulsa,Governor,Chris Powell,LIB,720105,0,0,0,0,
Tulsa,Governor,Rex Lawhorn,LIB,720105,0,0,0,0,
Tulsa,Corporation Commissioner,Ashley Nicole Mccray,DEM,720105,0,0,36,36,
Tulsa,Corporation Commissioner,Blake Cummings,DEM,720105,0,0,14,14,
Tulsa,U.S. House,Tim Gilpin,DEM,720105,0,0,32,32,01
Tulsa,U.S. House,Amanda Douglas,DEM,720105,0,0,19,19,01
Tulsa,Governor,Mick Cornett,REP,720106,0,0,25,25,
Tulsa,Governor,Kevin Stitt,REP,720106,0,0,55,55,
Tulsa,Lieutenant Governor,Dana Murphy,REP,720106,0,0,22,22,
Tulsa,Lieutenant Governor,Matt Pinnell,REP,720106,0,0,58,58,
Tulsa,State Auditor,Cindy Byrd,REP,720106,0,0,34,34,
Tulsa,State Auditor,Charlie Prater,REP,720106,0,0,39,39,
Tulsa,Attorney General,Mike Hunter,REP,720106,0,0,26,26,
Tulsa,Attorney General,Gentner Drummond,REP,720106,0,0,53,53,
Tulsa,Superintendent of Public Instruction,Joy Hofmeister,REP,720106,0,0,43,43,
Tulsa,Superintendent of Public Instruction,Linda Murphy,REP,720106,0,0,36,36,
Tulsa,Commissioner of Labor,Cathy Costello,REP,720106,0,0,37,37,
Tulsa,Commissioner of Labor,Leslie Osborn,REP,720106,0,0,40,40,
Tulsa,Corporation Commissioner,Bob Anthony,REP,720106,0,0,39,39,
Tulsa,Corporation Commissioner,Brian Bingman,REP,720106,0,0,36,36,
Tulsa,U.S. House,Tim Harris,REP,720106,0,0,42,42,01
Tulsa,U.S. House,Kevin Hern,REP,720106,0,0,37,37,01
Tulsa,State Senate,John Haste,REP,720106,0,0,41,41,36
Tulsa,State Senate,Bill Day,REP,720106,0,0,31,31,36
Tulsa,Governor,Chris Powell,LIB,720106,0,0,0,0,
Tulsa,Governor,Rex Lawhorn,LIB,720106,0,0,1,1,
Tulsa,Corporation Commissioner,Ashley Nicole Mccray,DEM,720106,0,0,31,31,
Tulsa,Corporation Commissioner,Blake Cummings,DEM,720106,0,0,13,13,
Tulsa,U.S. House,Tim Gilpin,DEM,720106,0,0,28,28,01
Tulsa,U.S. House,Amanda Douglas,DEM,720106,0,0,17,17,01
Tulsa,Governor,Mick Cornett,REP,720107,0,0,97,97,
Tulsa,Governor,Kevin Stitt,REP,720107,0,0,135,135,
Tulsa,Lieutenant Governor,Dana Murphy,REP,720107,0,0,100,100,
Tulsa,Lieutenant Governor,Matt Pinnell,REP,720107,0,0,127,127,
Tulsa,State Auditor,Cindy Byrd,REP,720107,0,0,129,129,
Tulsa,State Auditor,Charlie Prater,REP,720107,0,0,90,90,
Tulsa,Attorney General,Mike Hunter,REP,720107,0,0,112,112,
Tulsa,Attorney General,Gentner Drummond,REP,720107,0,0,117,117,
Tulsa,Superintendent of Public Instruction,Joy Hofmeister,REP,720107,0,0,140,140,
Tulsa,Superintendent of Public Instruction,Linda Murphy,REP,720107,0,0,86,86,
Tulsa,Commissioner of Labor,Cathy Costello,REP,720107,0,0,120,120,
Tulsa,Commissioner of Labor,Leslie Osborn,REP,720107,0,0,101,101,
Tulsa,Corporation Commissioner,Bob Anthony,REP,720107,0,0,122,122,
Tulsa,Corporation Commissioner,Brian Bingman,REP,720107,0,0,100,100,
Tulsa,U.S. House,Tim Harris,REP,720107,0,0,117,117,01
Tulsa,U.S. House,Kevin Hern,REP,720107,0,0,115,115,01
Tulsa,State House,Cheryl Baber,REP,720107,0,0,133,133,71
Tulsa,State House,Beverly Atteberry,REP,720107,0,0,79,79,71
Tulsa,Governor,Chris Powell,LIB,720107,0,0,1,1,
Tulsa,Governor,Rex Lawhorn,LIB,720107,0,0,0,0,
Tulsa,Corporation Commissioner,Ashley Nicole Mccray,DEM,720107,0,0,80,80,
Tulsa,Corporation Commissioner,Blake Cummings,DEM,720107,0,0,34,34,
Tulsa,U.S. House,Tim Gilpin,DEM,720107,0,0,71,71,01
Tulsa,U.S. House,Amanda Douglas,DEM,720107,0,0,45,45,01
Tulsa,Governor,Mick Cornett,REP,720108,0,0,56,56,
Tulsa,Governor,Kevin Stitt,REP,720108,0,0,71,71,
Tulsa,Lieutenant Governor,Dana Murphy,REP,720108,0,0,49,49,
Tulsa,Lieutenant Governor,Matt Pinnell,REP,720108,0,0,76,76,
Tulsa,State Auditor,Cindy Byrd,REP,720108,0,0,71,71,
Tulsa,State Auditor,Charlie Prater,REP,720108,0,0,49,49,
Tulsa,Attorney General,Mike Hunter,REP,720108,0,0,43,43,
Tulsa,Attorney General,Gentner Drummond,REP,720108,0,0,83,83,
Tulsa,Superintendent of Public Instruction,Joy Hofmeister,REP,720108,0,0,80,80,
Tulsa,Superintendent of Public Instruction,Linda Murphy,REP,720108,0,0,46,46,
Tulsa,Commissioner of Labor,Cathy Costello,REP,720108,0,0,53,53,
Tulsa,Commissioner of Labor,Leslie Osborn,REP,720108,0,0,71,71,
Tulsa,Corporation Commissioner,Bob Anthony,REP,720108,0,0,60,60,
Tulsa,Corporation Commissioner,Brian Bingman,REP,720108,0,0,62,62,
Tulsa,U.S. House,Tim Harris,REP,720108,0,0,57,57,01
Tulsa,U.S. House,Kevin Hern,REP,720108,0,0,72,72,01
Tulsa,State House,Cheryl Baber,REP,720108,0,0,63,63,71
Tulsa,State House,Beverly Atteberry,REP,720108,0,0,56,56,71
Tulsa,Governor,Chris Powell,LIB,720108,0,0,2,2,
Tulsa,Governor,Rex Lawhorn,LIB,720108,0,0,0,0,
Tulsa,Corporation Commissioner,Ashley Nicole Mccray,DEM,720108,0,0,50,50,
Tulsa,Corporation Commissioner,Blake Cummings,DEM,720108,0,0,14,14,
Tulsa,U.S. House,Tim Gilpin,DEM,720108,0,0,35,35,01
Tulsa,U.S. House,Amanda Douglas,DEM,720108,0,0,32,32,01
Tulsa,Governor,Mick Cornett,REP,720109,0,0,26,26,
Tulsa,Governor,Kevin Stitt,REP,720109,0,0,48,48,
Tulsa,Lieutenant Governor,Dana Murphy,REP,720109,0,0,25,25,
Tulsa,Lieutenant Governor,Matt Pinnell,REP,720109,0,0,48,48,
Tulsa,State Auditor,Cindy Byrd,REP,720109,0,0,40,40,
Tulsa,State Auditor,Charlie Prater,REP,720109,0,0,30,30,
Tulsa,Attorney General,Mike Hunter,REP,720109,0,0,38,38,
Tulsa,Attorney General,Gentner Drummond,REP,720109,0,0,34,34,
Tulsa,Superintendent of Public Instruction,Joy Hofmeister,REP,720109,0,0,42,42,
Tulsa,Superintendent of Public Instruction,Linda Murphy,REP,720109,0,0,28,28,
Tulsa,Commissioner of Labor,Cathy Costello,REP,720109,0,0,39,39,
Tulsa,Commissioner of Labor,Leslie Osborn,REP,720109,0,0,33,33,
Tulsa,Corporation Commissioner,Bob Anthony,REP,720109,0,0,41,41,
Tulsa,Corporation Commissioner,Brian Bingman,REP,720109,0,0,32,32,
Tulsa,U.S. House,Tim Harris,REP,720109,0,0,37,37,01
Tulsa,U.S. House,Kevin Hern,REP,720109,0,0,36,36,01
Tulsa,State House,Cheryl Baber,REP,720109,0,0,45,45,71
Tulsa,State House,Beverly Atteberry,REP,720109,0,0,26,26,71
Tulsa,Governor,Chris Powell,LIB,720109,0,0,1,1,
Tulsa,Governor,Rex Lawhorn,LIB,720109,0,0,0,0,
Tulsa,Corporation Commissioner,Ashley Nicole Mccray,DEM,720109,0,0,43,43,
Tulsa,Corporation Commissioner,Blake Cummings,DEM,720109,0,0,15,15,
Tulsa,U.S. House,Tim Gilpin,DEM,720109,0,0,32,32,01
Tulsa,U.S. House,Amanda Douglas,DEM,720109,0,0,27,27,01
Tulsa,Governor,Mick Cornett,REP,720110,0,0,26,26,
Tulsa,Governor,Kevin Stitt,REP,720110,0,0,63,63,
Tulsa,Lieutenant Governor,Dana Murphy,REP,720110,0,0,37,37,
Tulsa,Lieutenant Governor,Matt Pinnell,REP,720110,0,0,48,48,
Tulsa,State Auditor,Cindy Byrd,REP,720110,0,0,55,55,
Tulsa,State Auditor,Charlie Prater,REP,720110,0,0,27,27,
Tulsa,Attorney General,Mike Hunter,REP,720110,0,0,46,46,
Tulsa,Attorney General,Gentner Drummond,REP,720110,0,0,39,39,
Tulsa,Superintendent of Public Instruction,Joy Hofmeister,REP,720110,0,0,41,41,
Tulsa,Superintendent of Public Instruction,Linda Murphy,REP,720110,0,0,40,40,
Tulsa,Commissioner of Labor,Cathy Costello,REP,720110,0,0,52,52,
Tulsa,Commissioner of Labor,Leslie Osborn,REP,720110,0,0,27,27,
Tulsa,Corporation Commissioner,Bob Anthony,REP,720110,0,0,47,47,
Tulsa,Corporation Commissioner,Brian Bingman,REP,720110,0,0,34,34,
Tulsa,U.S. House,Tim Harris,REP,720110,0,0,47,47,01
Tulsa,U.S. House,Kevin Hern,REP,720110,0,0,42,42,01
Tulsa,State House,Cheryl Baber,REP,720110,0,0,40,40,71
Tulsa,State House,Beverly Atteberry,REP,720110,0,0,36,36,71
Tulsa,Governor,Chris Powell,LIB,720110,0,0,0,0,
Tulsa,Governor,Rex Lawhorn,LIB,720110,0,0,1,1,
Tulsa,Corporation Commissioner,Ashley Nicole Mccray,DEM,720110,0,0,48,48,
Tulsa,Corporation Commissioner,Blake Cummings,DEM,720110,0,0,8,8,
Tulsa,U.S. House,Tim Gilpin,DEM,720110,0,0,21,21,01
Tulsa,U.S. House,Amanda Douglas,DEM,720110,0,0,35,35,01
Tulsa,Governor,Mick Cornett,REP,720111,0,0,32,32,
Tulsa,Governor,Kevin Stitt,REP,720111,0,0,59,59,
Tulsa,Lieutenant Governor,Dana Murphy,REP,720111,0,0,35,35,
Tulsa,Lieutenant Governor,Matt Pinnell,REP,720111,0,0,54,54,
Tulsa,State Auditor,Cindy Byrd,REP,720111,0,0,51,51,
Tulsa,State Auditor,Charlie Prater,REP,720111,0,0,33,33,
Tulsa,Attorney General,Mike Hunter,REP,720111,0,0,42,42,
Tulsa,Attorney General,Gentner Drummond,REP,720111,0,0,49,49,
Tulsa,Superintendent of Public Instruction,Joy Hofmeister,REP,720111,0,0,55,55,
Tulsa,Superintendent of Public Instruction,Linda Murphy,REP,720111,0,0,33,33,
Tulsa,Commissioner of Labor,Cathy Costello,REP,720111,0,0,46,46,
Tulsa,Commissioner of Labor,Leslie Osborn,REP,720111,0,0,40,40,
Tulsa,Corporation Commissioner,Bob Anthony,REP,720111,0,0,52,52,
Tulsa,Corporation Commissioner,Brian Bingman,REP,720111,0,0,34,34,
Tulsa,U.S. House,Tim Harris,REP,720111,0,0,36,36,01
Tulsa,U.S. House,Kevin Hern,REP,720111,0,0,54,54,01
Tulsa,State House,Cheryl Baber,REP,720111,0,0,41,41,71
Tulsa,State House,Beverly Atteberry,REP,720111,0,0,41,41,71
Tulsa,Governor,Chris Powell,LIB,720111,0,0,0,0,
Tulsa,Governor,Rex Lawhorn,LIB,720111,0,0,0,0,
Tulsa,Corporation Commissioner,Ashley Nicole Mccray,DEM,720111,0,0,40,40,
Tulsa,Corporation Commissioner,Blake Cummings,DEM,720111,0,0,12,12,
Tulsa,U.S. House,Tim Gilpin,DEM,720111,0,0,35,35,01
Tulsa,U.S. House,Amanda Douglas,DEM,720111,0,0,19,19,01
Tulsa,Governor,Mick Cornett,REP,720112,0,0,14,14,
Tulsa,Governor,Kevin Stitt,REP,720112,0,0,48,48,
Tulsa,Lieutenant Governor,Dana Murphy,REP,720112,0,0,23,23,
Tulsa,Lieutenant Governor,Matt Pinnell,REP,720112,0,0,37,37,
Tulsa,State Auditor,Cindy Byrd,REP,720112,0,0,43,43,
Tulsa,State Auditor,Charlie Prater,REP,720112,0,0,15,15,
Tulsa,Attorney General,Mike Hunter,REP,720112,0,0,25,25,
Tulsa,Attorney General,Gentner Drummond,REP,720112,0,0,34,34,
Tulsa,Superintendent of Public Instruction,Joy Hofmeister,REP,720112,0,0,19,19,
Tulsa,Superintendent of Public Instruction,Linda Murphy,REP,720112,0,0,42,42,
Tulsa,Commissioner of Labor,Cathy Costello,REP,720112,0,0,38,38,
Tulsa,Commissioner of Labor,Leslie Osborn,REP,720112,0,0,22,22,
Tulsa,Corporation Commissioner,Bob Anthony,REP,720112,0,0,34,34,
Tulsa,Corporation Commissioner,Brian Bingman,REP,720112,0,0,26,26,
Tulsa,U.S. House,Tim Harris,REP,720112,0,0,28,28,01
Tulsa,U.S. House,Kevin Hern,REP,720112,0,0,33,33,01
Tulsa,State House,Cheryl Baber,REP,720112,0,0,31,31,71
Tulsa,State House,Beverly Atteberry,REP,720112,0,0,27,27,71
Tulsa,Governor,Chris Powell,LIB,720112,0,0,1,1,
Tulsa,Governor,Rex Lawhorn,LIB,720112,0,0,0,0,
Tulsa,Corporation Commissioner,Ashley Nicole Mccray,DEM,720112,0,0,31,31,
Tulsa,Corporation Commissioner,Blake Cummings,DEM,720112,0,0,7,7,
Tulsa,U.S. House,Tim Gilpin,DEM,720112,0,0,14,14,01
Tulsa,U.S. House,Amanda Douglas,DEM,720112,0,0,24,24,01
Tulsa,Governor,Mick Cornett,REP,720113,0,0,78,78,
Tulsa,Governor,Kevin Stitt,REP,720113,0,0,84,84,
Tulsa,Lieutenant Governor,Dana Murphy,REP,720113,0,0,46,46,
Tulsa,Lieutenant Governor,Matt Pinnell,REP,720113,0,0,111,111,
Tulsa,State Auditor,Cindy Byrd,REP,720113,0,0,67,67,
Tulsa,State Auditor,Charlie Prater,REP,720113,0,0,75,75,
Tulsa,Attorney General,Mike Hunter,REP,720113,0,0,69,69,
Tulsa,Attorney General,Gentner Drummond,REP,720113,0,0,87,87,
Tulsa,Superintendent of Public Instruction,Joy Hofmeister,REP,720113,0,0,96,96,
Tulsa,Superintendent of Public Instruction,Linda Murphy,REP,720113,0,0,57,57,
Tulsa,Commissioner of Labor,Cathy Costello,REP,720113,0,0,81,81,
Tulsa,Commissioner of Labor,Leslie Osborn,REP,720113,0,0,60,60,
Tulsa,Corporation Commissioner,Bob Anthony,REP,720113,0,0,87,87,
Tulsa,Corporation Commissioner,Brian Bingman,REP,720113,0,0,59,59,
Tulsa,U.S. House,Tim Harris,REP,720113,0,0,65,65,01
Tulsa,U.S. House,Kevin Hern,REP,720113,0,0,94,94,01
Tulsa,Governor,Chris Powell,LIB,720113,0,0,0,0,
Tulsa,Governor,Rex Lawhorn,LIB,720113,0,0,2,2,
Tulsa,Corporation Commissioner,Ashley Nicole Mccray,DEM,720113,0,0,42,42,
Tulsa,Corporation Commissioner,Blake Cummings,DEM,720113,0,0,20,20,
Tulsa,U.S. House,Tim Gilpin,DEM,720113,0,0,25,25,01
Tulsa,U.S. House,Amanda Douglas,DEM,720113,0,0,38,38,01
Tulsa,Governor,Mick Cornett,REP,720114,0,0,50,50,
Tulsa,Governor,Kevin Stitt,REP,720114,0,0,63,63,
Tulsa,Lieutenant Governor,Dana Murphy,REP,720114,0,0,43,43,
Tulsa,Lieutenant Governor,Matt Pinnell,REP,720114,0,0,65,65,
Tulsa,State Auditor,Cindy Byrd,REP,720114,0,0,63,63,
Tulsa,State Auditor,Charlie Prater,REP,720114,0,0,39,39,
Tulsa,Attorney General,Mike Hunter,REP,720114,0,0,56,56,
Tulsa,Attorney General,Gentner Drummond,REP,720114,0,0,56,56,
Tulsa,Superintendent of Public Instruction,Joy Hofmeister,REP,720114,0,0,63,63,
Tulsa,Superintendent of Public Instruction,Linda Murphy,REP,720114,0,0,43,43,
Tulsa,Commissioner of Labor,Cathy Costello,REP,720114,0,0,61,61,
Tulsa,Commissioner of Labor,Leslie Osborn,REP,720114,0,0,44,44,
Tulsa,Corporation Commissioner,Bob Anthony,REP,720114,0,0,63,63,
Tulsa,Corporation Commissioner,Brian Bingman,REP,720114,0,0,38,38,
Tulsa,U.S. House,Tim Harris,REP,720114,0,0,61,61,01
Tulsa,U.S. House,Kevin Hern,REP,720114,0,0,51,51,01
Tulsa,Governor,Chris Powell,LIB,720114,0,0,0,0,
Tulsa,Governor,Rex Lawhorn,LIB,720114,0,0,1,1,
Tulsa,Corporation Commissioner,Ashley Nicole Mccray,DEM,720114,0,0,47,47,
Tulsa,Corporation Commissioner,Blake Cummings,DEM,720114,0,0,11,11,
Tulsa,U.S. House,Tim Gilpin,DEM,720114,0,0,33,33,01
Tulsa,U.S. House,Amanda Douglas,DEM,720114,0,0,25,25,01
Tulsa,Governor,Mick Cornett,REP,720115,0,0,122,122,
Tulsa,Governor,Kevin Stitt,REP,720115,0,0,125,125,
Tulsa,Lieutenant Governor,Dana Murphy,REP,720115,0,0,106,106,
Tulsa,Lieutenant Governor,Matt Pinnell,REP,720115,0,0,135,135,
Tulsa,State Auditor,Cindy Byrd,REP,720115,0,0,135,135,
Tulsa,State Auditor,Charlie Prater,REP,720115,0,0,87,87,
Tulsa,Attorney General,Mike Hunter,REP,720115,0,0,111,111,
Tulsa,Attorney General,Gentner Drummond,REP,720115,0,0,129,129,
Tulsa,Superintendent of Public Instruction,Joy Hofmeister,REP,720115,0,0,160,160,
Tulsa,Superintendent of Public Instruction,Linda Murphy,REP,720115,0,0,75,75,
Tulsa,Commissioner of Labor,Cathy Costello,REP,720115,0,0,103,103,
Tulsa,Commissioner of Labor,Leslie Osborn,REP,720115,0,0,120,120,
Tulsa,Corporation Commissioner,Bob Anthony,REP,720115,0,0,131,131,
Tulsa,Corporation Commissioner,Brian Bingman,REP,720115,0,0,104,104,
Tulsa,U.S. House,Tim Harris,REP,720115,0,0,158,158,01
Tulsa,U.S. House,Kevin Hern,REP,720115,0,0,91,91,01
Tulsa,Governor,Chris Powell,LIB,720115,0,0,0,0,
Tulsa,Governor,Rex Lawhorn,LIB,720115,0,0,0,0,
Tulsa,Corporation Commissioner,Ashley Nicole Mccray,DEM,720115,0,0,28,28,
Tulsa,Corporation Commissioner,Blake Cummings,DEM,720115,0,0,8,8,
Tulsa,U.S. House,Tim Gilpin,DEM,720115,0,0,26,26,01
Tulsa,U.S. House,Amanda Douglas,DEM,720115,0,0,11,11,01
Tulsa,Governor,Mick Cornett,REP,720116,0,0,137,137,
Tulsa,Governor,Kevin Stitt,REP,720116,0,0,181,181,
Tulsa,Lieutenant Governor,Dana Murphy,REP,720116,0,0,150,150,
Tulsa,Lieutenant Governor,Matt Pinnell,REP,720116,0,0,154,154,
Tulsa,State Auditor,Cindy Byrd,REP,720116,0,0,167,167,
Tulsa,State Auditor,Charlie Prater,REP,720116,0,0,124,124,
Tulsa,Attorney General,Mike Hunter,REP,720116,0,0,129,129,
Tulsa,Attorney General,Gentner Drummond,REP,720116,0,0,184,184,
Tulsa,Superintendent of Public Instruction,Joy Hofmeister,REP,720116,0,0,222,222,
Tulsa,Superintendent of Public Instruction,Linda Murphy,REP,720116,0,0,87,87,
Tulsa,Commissioner of Labor,Cathy Costello,REP,720116,0,0,146,146,
Tulsa,Commissioner of Labor,Leslie Osborn,REP,720116,0,0,151,151,
Tulsa,Corporation Commissioner,Bob Anthony,REP,720116,0,0,167,167,
Tulsa,Corporation Commissioner,Brian Bingman,REP,720116,0,0,134,134,
Tulsa,U.S. House,Tim Harris,REP,720116,0,0,185,185,01
Tulsa,U.S. House,Kevin Hern,REP,720116,0,0,130,130,01
Tulsa,Governor,Chris Powell,LIB,720116,0,0,0,0,
Tulsa,Governor,Rex Lawhorn,LIB,720116,0,0,0,0,
Tulsa,Corporation Commissioner,Ashley Nicole Mccray,DEM,720116,0,0,40,40,
Tulsa,Corporation Commissioner,Blake Cummings,DEM,720116,0,0,19,19,
Tulsa,U.S. House,Tim Gilpin,DEM,720116,0,0,36,36,01
Tulsa,U.S. House,Amanda Douglas,DEM,720116,0,0,25,25,01
Tulsa,Governor,Mick Cornett,REP,720117,0,0,223,223,
Tulsa,Governor,Kevin Stitt,REP,720117,0,0,309,309,
Tulsa,Lieutenant Governor,Dana Murphy,REP,720117,0,0,215,215,
Tulsa,Lieutenant Governor,Matt Pinnell,REP,720117,0,0,301,301,
Tulsa,State Auditor,Cindy Byrd,REP,720117,0,0,278,278,
Tulsa,State Auditor,Charlie Prater,REP,720117,0,0,204,204,
Tulsa,Attorney General,Mike Hunter,REP,720117,0,0,252,252,
Tulsa,Attorney General,Gentner Drummond,REP,720117,0,0,263,263,
Tulsa,Superintendent of Public Instruction,Joy Hofmeister,REP,720117,0,0,327,327,
Tulsa,Superintendent of Public Instruction,Linda Murphy,REP,720117,0,0,183,183,
Tulsa,Commissioner of Labor,Cathy Costello,REP,720117,0,0,262,262,
Tulsa,Commissioner of Labor,Leslie Osborn,REP,720117,0,0,226,226,
Tulsa,Corporation Commissioner,Bob Anthony,REP,720117,0,0,308,308,
Tulsa,Corporation Commissioner,Brian Bingman,REP,720117,0,0,182,182,
Tulsa,U.S. House,Tim Harris,REP,720117,0,0,282,282,01
Tulsa,U.S. House,Kevin Hern,REP,720117,0,0,244,244,01
Tulsa,Governor,Chris Powell,LIB,720117,0,0,3,3,
Tulsa,Governor,Rex Lawhorn,LIB,720117,0,0,1,1,
Tulsa,Corporation Commissioner,Ashley Nicole Mccray,DEM,720117,0,0,98,98,
Tulsa,Corporation Commissioner,Blake Cummings,DEM,720117,0,0,29,29,
Tulsa,U.S. House,Tim Gilpin,DEM,720117,0,0,84,84,01
Tulsa,U.S. House,Amanda Douglas,DEM,720117,0,0,43,43,01
Tulsa,Governor,Mick Cornett,REP,720118,0,0,169,169,
Tulsa,Governor,Kevin Stitt,REP,720118,0,0,294,294,
Tulsa,Lieutenant Governor,Dana Murphy,REP,720118,0,0,170,170,
Tulsa,Lieutenant Governor,Matt Pinnell,REP,720118,0,0,276,276,
Tulsa,State Auditor,Cindy Byrd,REP,720118,0,0,255,255,
Tulsa,State Auditor,Charlie Prater,REP,720118,0,0,157,157,
Tulsa,Attorney General,Mike Hunter,REP,720118,0,0,200,200,
Tulsa,Attorney General,Gentner Drummond,REP,720118,0,0,243,243,
Tulsa,Superintendent of Public Instruction,Joy Hofmeister,REP,720118,0,0,284,284,
Tulsa,Superintendent of Public Instruction,Linda Murphy,REP,720118,0,0,165,165,
Tulsa,Commissioner of Labor,Cathy Costello,REP,720118,0,0,216,216,
Tulsa,Commissioner of Labor,Leslie Osborn,REP,720118,0,0,205,205,
Tulsa,Corporation Commissioner,Bob Anthony,REP,720118,0,0,253,253,
Tulsa,Corporation Commissioner,Brian Bingman,REP,720118,0,0,170,170,
Tulsa,U.S. House,Tim Harris,REP,720118,0,0,231,231,01
Tulsa,U.S. House,Kevin Hern,REP,720118,0,0,227,227,01
Tulsa,Governor,Chris Powell,LIB,720118,0,0,0,0,
Tulsa,Governor,Rex Lawhorn,LIB,720118,0,0,0,0,
Tulsa,Corporation Commissioner,Ashley Nicole Mccray,DEM,720118,0,0,69,69,
Tulsa,Corporation Commissioner,Blake Cummings,DEM,720118,0,0,15,15,
Tulsa,U.S. House,Tim Gilpin,DEM,720118,0,0,55,55,01
Tulsa,U.S. House,Amanda Douglas,DEM,720118,0,0,29,29,01
Tulsa,Governor,Mick Cornett,REP,720119,0,0,119,119,
Tulsa,Governor,Kevin Stitt,REP,720119,0,0,199,199,
Tulsa,Lieutenant Governor,Dana Murphy,REP,720119,0,0,115,115,
Tulsa,Lieutenant Governor,Matt Pinnell,REP,720119,0,0,187,187,
Tulsa,State Auditor,Cindy Byrd,REP,720119,0,0,164,164,
Tulsa,State Auditor,Charlie Prater,REP,720119,0,0,125,125,
Tulsa,Attorney General,Mike Hunter,REP,720119,0,0,150,150,
Tulsa,Attorney General,Gentner Drummond,REP,720119,0,0,162,162,
Tulsa,Superintendent of Public Instruction,Joy Hofmeister,REP,720119,0,0,226,226,
Tulsa,Superintendent of Public Instruction,Linda Murphy,REP,720119,0,0,84,84,
Tulsa,Commissioner of Labor,Cathy Costello,REP,720119,0,0,151,151,
Tulsa,Commissioner of Labor,Leslie Osborn,REP,720119,0,0,140,140,
Tulsa,Corporation Commissioner,Bob Anthony,REP,720119,0,0,179,179,
Tulsa,Corporation Commissioner,Brian Bingman,REP,720119,0,0,115,115,
Tulsa,U.S. House,Tim Harris,REP,720119,0,0,174,174,01
Tulsa,U.S. House,Kevin Hern,REP,720119,0,0,141,141,01
Tulsa,Governor,Chris Powell,LIB,720119,0,0,0,0,
Tulsa,Governor,Rex Lawhorn,LIB,720119,0,0,0,0,
Tulsa,Corporation Commissioner,Ashley Nicole Mccray,DEM,720119,0,0,40,40,
Tulsa,Corporation Commissioner,Blake Cummings,DEM,720119,0,0,13,13,
Tulsa,U.S. House,Tim Gilpin,DEM,720119,0,0,39,39,01
Tulsa,U.S. House,Amanda Douglas,DEM,720119,0,0,14,14,01
Tulsa,Governor,Mick Cornett,REP,720120,0,0,51,51,
Tulsa,Governor,Kevin Stitt,REP,720120,0,0,79,79,
Tulsa,Lieutenant Governor,Dana Murphy,REP,720120,0,0,51,51,
Tulsa,Lieutenant Governor,Matt Pinnell,REP,720120,0,0,74,74,
Tulsa,State Auditor,Cindy Byrd,REP,720120,0,0,78,78,
Tulsa,State Auditor,Charlie Prater,REP,720120,0,0,40,40,
Tulsa,Attorney General,Mike Hunter,REP,720120,0,0,65,65,
Tulsa,Attorney General,Gentner Drummond,REP,720120,0,0,65,65,
Tulsa,Superintendent of Public Instruction,Joy Hofmeister,REP,720120,0,0,62,62,
Tulsa,Superintendent of Public Instruction,Linda Murphy,REP,720120,0,0,59,59,
Tulsa,Commissioner of Labor,Cathy Costello,REP,720120,0,0,57,57,
Tulsa,Commissioner of Labor,Leslie Osborn,REP,720120,0,0,61,61,
Tulsa,Corporation Commissioner,Bob Anthony,REP,720120,0,0,68,68,
Tulsa,Corporation Commissioner,Brian Bingman,REP,720120,0,0,54,54,
Tulsa,U.S. House,Tim Harris,REP,720120,0,0,64,64,01
Tulsa,U.S. House,Kevin Hern,REP,720120,0,0,65,65,01
Tulsa,State House,Karen Gilbert,REP,720120,0,0,59,59,79
Tulsa,State House,Dan Hicks,REP,720120,0,0,64,64,79
Tulsa,Governor,Chris Powell,LIB,720120,0,0,1,1,
Tulsa,Governor,Rex Lawhorn,LIB,720120,0,0,0,0,
Tulsa,Corporation Commissioner,Ashley Nicole Mccray,DEM,720120,0,0,36,36,
Tulsa,Corporation Commissioner,Blake Cummings,DEM,720120,0,0,11,11,
Tulsa,U.S. House,Tim Gilpin,DEM,720120,0,0,23,23,01
Tulsa,U.S. House,Amanda Douglas,DEM,720120,0,0,24,24,01
Tulsa,Governor,Mick Cornett,REP,720121,0,0,122,122,
Tulsa,Governor,Kevin Stitt,REP,720121,0,0,114,114,
Tulsa,Lieutenant Governor,Dana Murphy,REP,720121,0,0,109,109,
Tulsa,Lieutenant Governor,Matt Pinnell,REP,720121,0,0,123,123,
Tulsa,State Auditor,Cindy Byrd,REP,720121,0,0,138,138,
Tulsa,State Auditor,Charlie Prater,REP,720121,0,0,86,86,
Tulsa,Attorney General,Mike Hunter,REP,720121,0,0,111,111,
Tulsa,Attorney General,Gentner Drummond,REP,720121,0,0,121,121,
Tulsa,Superintendent of Public Instruction,Joy Hofmeister,REP,720121,0,0,154,154,
Tulsa,Superintendent of Public Instruction,Linda Murphy,REP,720121,0,0,78,78,
Tulsa,Commissioner of Labor,Cathy Costello,REP,720121,0,0,103,103,
Tulsa,Commissioner of Labor,Leslie Osborn,REP,720121,0,0,119,119,
Tulsa,Corporation Commissioner,Bob Anthony,REP,720121,0,0,115,115,
Tulsa,Corporation Commissioner,Brian Bingman,REP,720121,0,0,110,110,
Tulsa,U.S. House,Tim Harris,REP,720121,0,0,151,151,01
Tulsa,U.S. House,Kevin Hern,REP,720121,0,0,86,86,01
Tulsa,Governor,Chris Powell,LIB,720121,0,0,1,1,
Tulsa,Governor,Rex Lawhorn,LIB,720121,0,0,0,0,
Tulsa,Corporation Commissioner,Ashley Nicole Mccray,DEM,720121,0,0,93,93,
Tulsa,Corporation Commissioner,Blake Cummings,DEM,720121,0,0,45,45,
Tulsa,U.S. House,Tim Gilpin,DEM,720121,0,0,113,113,01
Tulsa,U.S. House,Amanda Douglas,DEM,720121,0,0,30,30,01
Tulsa,Governor,Mick Cornett,REP,720122,0,0,73,73,
Tulsa,Governor,Kevin Stitt,REP,720122,0,0,85,85,
Tulsa,Lieutenant Governor,Dana Murphy,REP,720122,0,0,59,59,
Tulsa,Lieutenant Governor,Matt Pinnell,REP,720122,0,0,92,92,
Tulsa,State Auditor,Cindy Byrd,REP,720122,0,0,85,85,
Tulsa,State Auditor,Charlie Prater,REP,720122,0,0,61,61,
Tulsa,Attorney General,Mike Hunter,REP,720122,0,0,64,64,
Tulsa,Attorney General,Gentner Drummond,REP,720122,0,0,90,90,
Tulsa,Superintendent of Public Instruction,Joy Hofmeister,REP,720122,0,0,104,104,
Tulsa,Superintendent of Public Instruction,Linda Murphy,REP,720122,0,0,51,51,
Tulsa,Commissioner of Labor,Cathy Costello,REP,720122,0,0,60,60,
Tulsa,Commissioner of Labor,Leslie Osborn,REP,720122,0,0,89,89,
Tulsa,Corporation Commissioner,Bob Anthony,REP,720122,0,0,87,87,
Tulsa,Corporation Commissioner,Brian Bingman,REP,720122,0,0,64,64,
Tulsa,U.S. House,Tim Harris,REP,720122,0,0,79,79,01
Tulsa,U.S. House,Kevin Hern,REP,720122,0,0,76,76,01
Tulsa,Governor,Chris Powell,LIB,720122,0,0,1,1,
Tulsa,Governor,Rex Lawhorn,LIB,720122,0,0,1,1,
Tulsa,Corporation Commissioner,Ashley Nicole Mccray,DEM,720122,0,0,22,22,
Tulsa,Corporation Commissioner,Blake Cummings,DEM,720122,0,0,8,8,
Tulsa,U.S. House,Tim Gilpin,DEM,720122,0,0,27,27,01
Tulsa,U.S. House,Amanda Douglas,DEM,720122,0,0,3,3,01
Tulsa,Governor,Mick Cornett,REP,720123,0,0,181,181,
Tulsa,Governor,Kevin Stitt,REP,720123,0,0,183,183,
Tulsa,Lieutenant Governor,Dana Murphy,REP,720123,0,0,152,152,
Tulsa,Lieutenant Governor,Matt Pinnell,REP,720123,0,0,211,211,
Tulsa,State Auditor,Cindy Byrd,REP,720123,0,0,217,217,
Tulsa,State Auditor,Charlie Prater,REP,720123,0,0,119,119,
Tulsa,Attorney General,Mike Hunter,REP,720123,0,0,148,148,
Tulsa,Attorney General,Gentner Drummond,REP,720123,0,0,212,212,
Tulsa,Superintendent of Public Instruction,Joy Hofmeister,REP,720123,0,0,212,212,
Tulsa,Superintendent of Public Instruction,Linda Murphy,REP,720123,0,0,145,145,
Tulsa,Commissioner of Labor,Cathy Costello,REP,720123,0,0,187,187,
Tulsa,Commissioner of Labor,Leslie Osborn,REP,720123,0,0,158,158,
Tulsa,Corporation Commissioner,Bob Anthony,REP,720123,0,0,210,210,
Tulsa,Corporation Commissioner,Brian Bingman,REP,720123,0,0,136,136,
Tulsa,U.S. House,Tim Harris,REP,720123,0,0,177,177,01
Tulsa,U.S. House,Kevin Hern,REP,720123,0,0,185,185,01
Tulsa,Governor,Chris Powell,LIB,720123,0,0,0,0,
Tulsa,Governor,Rex Lawhorn,LIB,720123,0,0,0,0,
Tulsa,Corporation Commissioner,Ashley Nicole Mccray,DEM,720123,0,0,73,73,
Tulsa,Corporation Commissioner,Blake Cummings,DEM,720123,0,0,34,34,
Tulsa,U.S. House,Tim Gilpin,DEM,720123,0,0,74,74,01
Tulsa,U.S. House,Amanda Douglas,DEM,720123,0,0,36,36,01
Tulsa,Governor,Mick Cornett,REP,720124,0,0,139,139,
Tulsa,Governor,Kevin Stitt,REP,720124,0,0,195,195,
Tulsa,Lieutenant Governor,Dana Murphy,REP,720124,0,0,130,130,
Tulsa,Lieutenant Governor,Matt Pinnell,REP,720124,0,0,193,193,
Tulsa,State Auditor,Cindy Byrd,REP,720124,0,0,184,184,
Tulsa,State Auditor,Charlie Prater,REP,720124,0,0,116,116,
Tulsa,Attorney General,Mike Hunter,REP,720124,0,0,142,142,
Tulsa,Attorney General,Gentner Drummond,REP,720124,0,0,181,181,
Tulsa,Superintendent of Public Instruction,Joy Hofmeister,REP,720124,0,0,202,202,
Tulsa,Superintendent of Public Instruction,Linda Murphy,REP,720124,0,0,119,119,
Tulsa,Commissioner of Labor,Cathy Costello,REP,720124,0,0,166,166,
Tulsa,Commissioner of Labor,Leslie Osborn,REP,720124,0,0,143,143,
Tulsa,Corporation Commissioner,Bob Anthony,REP,720124,0,0,183,183,
Tulsa,Corporation Commissioner,Brian Bingman,REP,720124,0,0,129,129,
Tulsa,U.S. House,Tim Harris,REP,720124,0,0,161,161,01
Tulsa,U.S. House,Kevin Hern,REP,720124,0,0,168,168,01
Tulsa,Governor,Chris Powell,LIB,720124,0,0,2,2,
Tulsa,Governor,Rex Lawhorn,LIB,720124,0,0,0,0,
Tulsa,Corporation Commissioner,Ashley Nicole Mccray,DEM,720124,0,0,67,67,
Tulsa,Corporation Commissioner,Blake Cummings,DEM,720124,0,0,24,24,
Tulsa,U.S. House,Tim Gilpin,DEM,720124,0,0,69,69,01
Tulsa,U.S. House,Amanda Douglas,DEM,720124,0,0,24,24,01
Tulsa,Governor,Mick Cornett,REP,720125,0,0,144,144,
Tulsa,Governor,Kevin Stitt,REP,720125,0,0,148,148,
Tulsa,Lieutenant Governor,Dana Murphy,REP,720125,0,0,117,117,
Tulsa,Lieutenant Governor,Matt Pinnell,REP,720125,0,0,170,170,
Tulsa,State Auditor,Cindy Byrd,REP,720125,0,0,151,151,
Tulsa,State Auditor,Charlie Prater,REP,720125,0,0,121,121,
Tulsa,Attorney General,Mike Hunter,REP,720125,0,0,126,126,
Tulsa,Attorney General,Gentner Drummond,REP,720125,0,0,160,160,
Tulsa,Superintendent of Public Instruction,Joy Hofmeister,REP,720125,0,0,165,165,
Tulsa,Superintendent of Public Instruction,Linda Murphy,REP,720125,0,0,121,121,
Tulsa,Commissioner of Labor,Cathy Costello,REP,720125,0,0,132,132,
Tulsa,Commissioner of Labor,Leslie Osborn,REP,720125,0,0,143,143,
Tulsa,Corporation Commissioner,Bob Anthony,REP,720125,0,0,163,163,
Tulsa,Corporation Commissioner,Brian Bingman,REP,720125,0,0,113,113,
Tulsa,U.S. House,Tim Harris,REP,720125,0,0,171,171,01
Tulsa,U.S. House,Kevin Hern,REP,720125,0,0,116,116,01
Tulsa,State House,Karen Gilbert,REP,720125,0,0,162,162,79
Tulsa,State House,Dan Hicks,REP,720125,0,0,133,133,79
Tulsa,Governor,Chris Powell,LIB,720125,0,0,0,0,
Tulsa,Governor,Rex Lawhorn,LIB,720125,0,0,0,0,
Tulsa,Corporation Commissioner,Ashley Nicole Mccray,DEM,720125,0,0,76,76,
Tulsa,Corporation Commissioner,Blake Cummings,DEM,720125,0,0,27,27,
Tulsa,U.S. House,Tim Gilpin,DEM,720125,0,0,69,69,01
Tulsa,U.S. House,Amanda Douglas,DEM,720125,0,0,35,35,01
Tulsa,Governor,Mick Cornett,REP,720126,0,0,163,163,
Tulsa,Governor,Kevin Stitt,REP,720126,0,0,176,176,
Tulsa,Lieutenant Governor,Dana Murphy,REP,720126,0,0,158,158,
Tulsa,Lieutenant Governor,Matt Pinnell,REP,720126,0,0,167,167,
Tulsa,State Auditor,Cindy Byrd,REP,720126,0,0,187,187,
Tulsa,State Auditor,Charlie Prater,REP,720126,0,0,126,126,
Tulsa,Attorney General,Mike Hunter,REP,720126,0,0,143,143,
Tulsa,Attorney General,Gentner Drummond,REP,720126,0,0,191,191,
Tulsa,Superintendent of Public Instruction,Joy Hofmeister,REP,720126,0,0,225,225,
Tulsa,Superintendent of Public Instruction,Linda Murphy,REP,720126,0,0,101,101,
Tulsa,Commissioner of Labor,Cathy Costello,REP,720126,0,0,157,157,
Tulsa,Commissioner of Labor,Leslie Osborn,REP,720126,0,0,161,161,
Tulsa,Corporation Commissioner,Bob Anthony,REP,720126,0,0,204,204,
Tulsa,Corporation Commissioner,Brian Bingman,REP,720126,0,0,117,117,
Tulsa,U.S. House,Tim Harris,REP,720126,0,0,165,165,01
Tulsa,U.S. House,Kevin Hern,REP,720126,0,0,167,167,01
Tulsa,State House,Karen Gilbert,REP,720126,0,0,163,163,79
Tulsa,State House,Dan Hicks,REP,720126,0,0,157,157,79
Tulsa,Governor,Chris Powell,LIB,720126,0,0,0,0,
Tulsa,Governor,Rex Lawhorn,LIB,720126,0,0,0,0,
Tulsa,Corporation Commissioner,Ashley Nicole Mccray,DEM,720126,0,0,58,58,
Tulsa,Corporation Commissioner,Blake Cummings,DEM,720126,0,0,20,20,
Tulsa,U.S. House,Tim Gilpin,DEM,720126,0,0,53,53,01
Tulsa,U.S. House,Amanda Douglas,DEM,720126,0,0,26,26,01
Tulsa,Governor,Mick Cornett,REP,720127,0,0,80,80,
Tulsa,Governor,Kevin Stitt,REP,720127,0,0,102,102,
Tulsa,Lieutenant Governor,Dana Murphy,REP,720127,0,0,70,70,
Tulsa,Lieutenant Governor,Matt Pinnell,REP,720127,0,0,107,107,
Tulsa,State Auditor,Cindy Byrd,REP,720127,0,0,90,90,
Tulsa,State Auditor,Charlie Prater,REP,720127,0,0,71,71,
Tulsa,Attorney General,Mike Hunter,REP,720127,0,0,76,76,
Tulsa,Attorney General,Gentner Drummond,REP,720127,0,0,102,102,
Tulsa,Superintendent of Public Instruction,Joy Hofmeister,REP,720127,0,0,121,121,
Tulsa,Superintendent of Public Instruction,Linda Murphy,REP,720127,0,0,57,57,
Tulsa,Commissioner of Labor,Cathy Costello,REP,720127,0,0,83,83,
Tulsa,Commissioner of Labor,Leslie Osborn,REP,720127,0,0,86,86,
Tulsa,Corporation Commissioner,Bob Anthony,REP,720127,0,0,96,96,
Tulsa,Corporation Commissioner,Brian Bingman,REP,720127,0,0,73,73,
Tulsa,U.S. House,Tim Harris,REP,720127,0,0,97,97,01
Tulsa,U.S. House,Kevin Hern,REP,720127,0,0,80,80,01
Tulsa,State House,Karen Gilbert,REP,720127,0,0,90,90,79
Tulsa,State House,Dan Hicks,REP,720127,0,0,83,83,79
Tulsa,Governor,Chris Powell,LIB,720127,0,0,0,0,
Tulsa,Governor,Rex Lawhorn,LIB,720127,0,0,0,0,
Tulsa,Corporation Commissioner,Ashley Nicole Mccray,DEM,720127,0,0,37,37,
Tulsa,Corporation Commissioner,Blake Cummings,DEM,720127,0,0,7,7,
Tulsa,U.S. House,Tim Gilpin,DEM,720127,0,0,23,23,01
Tulsa,U.S. House,Amanda Douglas,DEM,720127,0,0,22,22,01
Tulsa,Governor,Mick Cornett,REP,720128,0,0,100,100,
Tulsa,Governor,Kevin Stitt,REP,720128,0,0,131,131,
Tulsa,Lieutenant Governor,Dana Murphy,REP,720128,0,0,97,97,
Tulsa,Lieutenant Governor,Matt Pinnell,REP,720128,0,0,131,131,
Tulsa,State Auditor,Cindy Byrd,REP,720128,0,0,120,120,
Tulsa,State Auditor,Charlie Prater,REP,720128,0,0,101,101,
Tulsa,Attorney General,Mike Hunter,REP,720128,0,0,105,105,
Tulsa,Attorney General,Gentner Drummond,REP,720128,0,0,120,120,
Tulsa,Superintendent of Public Instruction,Joy Hofmeister,REP,720128,0,0,141,141,
Tulsa,Superintendent of Public Instruction,Linda Murphy,REP,720128,0,0,87,87,
Tulsa,Commissioner of Labor,Cathy Costello,REP,720128,0,0,121,121,
Tulsa,Commissioner of Labor,Leslie Osborn,REP,720128,0,0,101,101,
Tulsa,Corporation Commissioner,Bob Anthony,REP,720128,0,0,124,124,
Tulsa,Corporation Commissioner,Brian Bingman,REP,720128,0,0,97,97,
Tulsa,U.S. House,Tim Harris,REP,720128,0,0,106,106,01
Tulsa,U.S. House,Kevin Hern,REP,720128,0,0,122,122,01
Tulsa,State House,Karen Gilbert,REP,720128,0,0,106,106,79
Tulsa,State House,Dan Hicks,REP,720128,0,0,120,120,79
Tulsa,Governor,Chris Powell,LIB,720128,0,0,0,0,
Tulsa,Governor,Rex Lawhorn,LIB,720128,0,0,0,0,
Tulsa,Corporation Commissioner,Ashley Nicole Mccray,DEM,720128,0,0,68,68,
Tulsa,Corporation Commissioner,Blake Cummings,DEM,720128,0,0,28,28,
Tulsa,U.S. House,Tim Gilpin,DEM,720128,0,0,60,60,01
Tulsa,U.S. House,Amanda Douglas,DEM,720128,0,0,37,37,01
Tulsa,Governor,Mick Cornett,REP,720129,0,0,134,134,
Tulsa,Governor,Kevin Stitt,REP,720129,0,0,145,145,
Tulsa,Lieutenant Governor,Dana Murphy,REP,720129,0,0,126,126,
Tulsa,Lieutenant Governor,Matt Pinnell,REP,720129,0,0,149,149,
Tulsa,State Auditor,Cindy Byrd,REP,720129,0,0,148,148,
Tulsa,State Auditor,Charlie Prater,REP,720129,0,0,114,114,
Tulsa,Attorney General,Mike Hunter,REP,720129,0,0,127,127,
Tulsa,Attorney General,Gentner Drummond,REP,720129,0,0,146,146,
Tulsa,Superintendent of Public Instruction,Joy Hofmeister,REP,720129,0,0,173,173,
Tulsa,Superintendent of Public Instruction,Linda Murphy,REP,720129,0,0,101,101,
Tulsa,Commissioner of Labor,Cathy Costello,REP,720129,0,0,124,124,
Tulsa,Commissioner of Labor,Leslie Osborn,REP,720129,0,0,143,143,
Tulsa,Corporation Commissioner,Bob Anthony,REP,720129,0,0,161,161,
Tulsa,Corporation Commissioner,Brian Bingman,REP,720129,0,0,110,110,
Tulsa,U.S. House,Tim Harris,REP,720129,0,0,141,141,01
Tulsa,U.S. House,Kevin Hern,REP,720129,0,0,131,131,01
Tulsa,State House,Karen Gilbert,REP,720129,0,0,139,139,79
Tulsa,State House,Dan Hicks,REP,720129,0,0,140,140,79
Tulsa,Governor,Chris Powell,LIB,720129,0,0,0,0,
Tulsa,Governor,Rex Lawhorn,LIB,720129,0,0,0,0,
Tulsa,Corporation Commissioner,Ashley Nicole Mccray,DEM,720129,0,0,72,72,
Tulsa,Corporation Commissioner,Blake Cummings,DEM,720129,0,0,22,22,
Tulsa,U.S. House,Tim Gilpin,DEM,720129,0,0,54,54,01
Tulsa,U.S. House,Amanda Douglas,DEM,720129,0,0,39,39,01
Tulsa,Governor,Mick Cornett,REP,720130,0,0,94,94,
Tulsa,Governor,Kevin Stitt,REP,720130,0,0,138,138,
Tulsa,Lieutenant Governor,Dana Murphy,REP,720130,0,0,86,86,
Tulsa,Lieutenant Governor,Matt Pinnell,REP,720130,0,0,133,133,
Tulsa,State Auditor,Cindy Byrd,REP,720130,0,0,120,120,
Tulsa,State Auditor,Charlie Prater,REP,720130,0,0,91,91,
Tulsa,Attorney General,Mike Hunter,REP,720130,0,0,106,106,
Tulsa,Attorney General,Gentner Drummond,REP,720130,0,0,111,111,
Tulsa,Superintendent of Public Instruction,Joy Hofmeister,REP,720130,0,0,135,135,
Tulsa,Superintendent of Public Instruction,Linda Murphy,REP,720130,0,0,87,87,
Tulsa,Commissioner of Labor,Cathy Costello,REP,720130,0,0,103,103,
Tulsa,Commissioner of Labor,Leslie Osborn,REP,720130,0,0,112,112,
Tulsa,Corporation Commissioner,Bob Anthony,REP,720130,0,0,110,110,
Tulsa,Corporation Commissioner,Brian Bingman,REP,720130,0,0,105,105,
Tulsa,U.S. House,Tim Harris,REP,720130,0,0,117,117,01
Tulsa,U.S. House,Kevin Hern,REP,720130,0,0,109,109,01
Tulsa,State House,Karen Gilbert,REP,720130,0,0,78,78,79
Tulsa,State House,Dan Hicks,REP,720130,0,0,146,146,79
Tulsa,Governor,Chris Powell,LIB,720130,0,0,1,1,
Tulsa,Governor,Rex Lawhorn,LIB,720130,0,0,0,0,
Tulsa,Corporation Commissioner,Ashley Nicole Mccray,DEM,720130,0,0,66,66,
Tulsa,Corporation Commissioner,Blake Cummings,DEM,720130,0,0,26,26,
Tulsa,U.S. House,Tim Gilpin,DEM,720130,0,0,53,53,01
Tulsa,U.S. House,Amanda Douglas,DEM,720130,0,0,40,40,01
Tulsa,Governor,Mick Cornett,REP,720131,0,0,6,6,
Tulsa,Governor,Kevin Stitt,REP,720131,0,0,5,5,
Tulsa,Lieutenant Governor,Dana Murphy,REP,720131,0,0,4,4,
Tulsa,Lieutenant Governor,Matt Pinnell,REP,720131,0,0,7,7,
Tulsa,State Auditor,Cindy Byrd,REP,720131,0,0,6,6,
Tulsa,State Auditor,Charlie Prater,REP,720131,0,0,5,5,
Tulsa,Attorney General,Mike Hunter,REP,720131,0,0,5,5,
Tulsa,Attorney General,Gentner Drummond,REP,720131,0,0,6,6,
Tulsa,Superintendent of Public Instruction,Joy Hofmeister,REP,720131,0,0,4,4,
Tulsa,Superintendent of Public Instruction,Linda Murphy,REP,720131,0,0,7,7,
Tulsa,Commissioner of Labor,Cathy Costello,REP,720131,0,0,5,5,
Tulsa,Commissioner of Labor,Leslie Osborn,REP,720131,0,0,6,6,
Tulsa,Corporation Commissioner,Bob Anthony,REP,720131,0,0,5,5,
Tulsa,Corporation Commissioner,Brian Bingman,REP,720131,0,0,6,6,
Tulsa,U.S. House,Tim Harris,REP,720131,0,0,9,9,01
Tulsa,U.S. House,Kevin Hern,REP,720131,0,0,2,2,01
Tulsa,State Senate,John Haste,REP,720131,0,0,5,5,36
Tulsa,State Senate,Bill Day,REP,720131,0,0,6,6,36
Tulsa,State House,Karen Gilbert,REP,720131,0,0,7,7,79
Tulsa,State House,Dan Hicks,REP,720131,0,0,4,4,79
Tulsa,Governor,Chris Powell,LIB,720131,0,0,0,0,
Tulsa,Governor,Rex Lawhorn,LIB,720131,0,0,0,0,
Tulsa,Corporation Commissioner,Ashley Nicole Mccray,DEM,720131,0,0,10,10,
Tulsa,Corporation Commissioner,Blake Cummings,DEM,720131,0,0,4,4,
Tulsa,U.S. House,Tim Gilpin,DEM,720131,0,0,7,7,01
Tulsa,U.S. House,Amanda Douglas,DEM,720131,0,0,7,7,01
Tulsa,Governor,Mick Cornett,REP,720132,0,0,129,129,
Tulsa,Governor,Kevin Stitt,REP,720132,0,0,185,185,
Tulsa,Lieutenant Governor,Dana Murphy,REP,720132,0,0,131,131,
Tulsa,Lieutenant Governor,Matt Pinnell,REP,720132,0,0,176,176,
Tulsa,State Auditor,Cindy Byrd,REP,720132,0,0,188,188,
Tulsa,State Auditor,Charlie Prater,REP,720132,0,0,108,108,
Tulsa,Attorney General,Mike Hunter,REP,720132,0,0,142,142,
Tulsa,Attorney General,Gentner Drummond,REP,720132,0,0,164,164,
Tulsa,Superintendent of Public Instruction,Joy Hofmeister,REP,720132,0,0,189,189,
Tulsa,Superintendent of Public Instruction,Linda Murphy,REP,720132,0,0,117,117,
Tulsa,Commissioner of Labor,Cathy Costello,REP,720132,0,0,140,140,
Tulsa,Commissioner of Labor,Leslie Osborn,REP,720132,0,0,157,157,
Tulsa,Corporation Commissioner,Bob Anthony,REP,720132,0,0,166,166,
Tulsa,Corporation Commissioner,Brian Bingman,REP,720132,0,0,133,133,
Tulsa,U.S. House,Tim Harris,REP,720132,0,0,154,154,01
Tulsa,U.S. House,Kevin Hern,REP,720132,0,0,153,153,01
Tulsa,State House,Karen Gilbert,REP,720132,0,0,151,151,79
Tulsa,State House,Dan Hicks,REP,720132,0,0,151,151,79
Tulsa,Governor,Chris Powell,LIB,720132,0,0,0,0,
Tulsa,Governor,Rex Lawhorn,LIB,720132,0,0,0,0,
Tulsa,Corporation Commissioner,Ashley Nicole Mccray,DEM,720132,0,0,58,58,
Tulsa,Corporation Commissioner,Blake Cummings,DEM,720132,0,0,18,18,
Tulsa,U.S. House,Tim Gilpin,DEM,720132,0,0,50,50,01
Tulsa,U.S. House,Amanda Douglas,DEM,720132,0,0,28,28,01
Tulsa,Governor,Mick Cornett,REP,720133,0,0,125,125,
Tulsa,Governor,Kevin Stitt,REP,720133,0,0,122,122,
Tulsa,Lieutenant Governor,Dana Murphy,REP,720133,0,0,115,115,
Tulsa,Lieutenant Governor,Matt Pinnell,REP,720133,0,0,123,123,
Tulsa,State Auditor,Cindy Byrd,REP,720133,0,0,110,110,
Tulsa,State Auditor,Charlie Prater,REP,720133,0,0,118,118,
Tulsa,Attorney General,Mike Hunter,REP,720133,0,0,113,113,
Tulsa,Attorney General,Gentner Drummond,REP,720133,0,0,127,127,
Tulsa,Superintendent of Public Instruction,Joy Hofmeister,REP,720133,0,0,166,166,
Tulsa,Superintendent of Public Instruction,Linda Murphy,REP,720133,0,0,70,70,
Tulsa,Commissioner of Labor,Cathy Costello,REP,720133,0,0,109,109,
Tulsa,Commissioner of Labor,Leslie Osborn,REP,720133,0,0,119,119,
Tulsa,Corporation Commissioner,Bob Anthony,REP,720133,0,0,129,129,
Tulsa,Corporation Commissioner,Brian Bingman,REP,720133,0,0,100,100,
Tulsa,U.S. House,Tim Harris,REP,720133,0,0,116,116,01
Tulsa,U.S. House,Kevin Hern,REP,720133,0,0,126,126,01
Tulsa,State House,Karen Gilbert,REP,720133,0,0,130,130,79
Tulsa,State House,Dan Hicks,REP,720133,0,0,106,106,79
Tulsa,Governor,Chris Powell,LIB,720133,0,0,0,0,
Tulsa,Governor,Rex Lawhorn,LIB,720133,0,0,1,1,
Tulsa,Corporation Commissioner,Ashley Nicole Mccray,DEM,720133,0,0,72,72,
Tulsa,Corporation Commissioner,Blake Cummings,DEM,720133,0,0,22,22,
Tulsa,U.S. House,Tim Gilpin,DEM,720133,0,0,66,66,01
Tulsa,U.S. House,Amanda Douglas,DEM,720133,0,0,29,29,01
Tulsa,Governor,Mick Cornett,REP,720134,0,0,118,118,
Tulsa,Governor,Kevin Stitt,REP,720134,0,0,157,157,
Tulsa,Lieutenant Governor,Dana Murphy,REP,720134,0,0,108,108,
Tulsa,Lieutenant Governor,Matt Pinnell,REP,720134,0,0,158,158,
Tulsa,State Auditor,Cindy Byrd,REP,720134,0,0,138,138,
Tulsa,State Auditor,Charlie Prater,REP,720134,0,0,114,114,
Tulsa,Attorney General,Mike Hunter,REP,720134,0,0,127,127,
Tulsa,Attorney General,Gentner Drummond,REP,720134,0,0,140,140,
Tulsa,Superintendent of Public Instruction,Joy Hofmeister,REP,720134,0,0,147,147,
Tulsa,Superintendent of Public Instruction,Linda Murphy,REP,720134,0,0,115,115,
Tulsa,Commissioner of Labor,Cathy Costello,REP,720134,0,0,132,132,
Tulsa,Commissioner of Labor,Leslie Osborn,REP,720134,0,0,123,123,
Tulsa,Corporation Commissioner,Bob Anthony,REP,720134,0,0,146,146,
Tulsa,Corporation Commissioner,Brian Bingman,REP,720134,0,0,112,112,
Tulsa,U.S. House,Tim Harris,REP,720134,0,0,124,124,01
Tulsa,U.S. House,Kevin Hern,REP,720134,0,0,145,145,01
Tulsa,Governor,Chris Powell,LIB,720134,0,0,0,0,
Tulsa,Governor,Rex Lawhorn,LIB,720134,0,0,0,0,
Tulsa,Corporation Commissioner,Ashley Nicole Mccray,DEM,720134,0,0,56,56,
Tulsa,Corporation Commissioner,Blake Cummings,DEM,720134,0,0,21,21,
Tulsa,U.S. House,Tim Gilpin,DEM,720134,0,0,42,42,01
Tulsa,U.S. House,Amanda Douglas,DEM,720134,0,0,35,35,01
Tulsa,Governor,Mick Cornett,REP,720135,0,0,110,110,
Tulsa,Governor,Kevin Stitt,REP,720135,0,0,202,202,
Tulsa,Lieutenant Governor,Dana Murphy,REP,720135,0,0,116,116,
Tulsa,Lieutenant Governor,Matt Pinnell,REP,720135,0,0,186,186,
Tulsa,State Auditor,Cindy Byrd,REP,720135,0,0,159,159,
Tulsa,State Auditor,Charlie Prater,REP,720135,0,0,130,130,
Tulsa,Attorney General,Mike Hunter,REP,720135,0,0,143,143,
Tulsa,Attorney General,Gentner Drummond,REP,720135,0,0,164,164,
Tulsa,Superintendent of Public Instruction,Joy Hofmeister,REP,720135,0,0,180,180,
Tulsa,Superintendent of Public Instruction,Linda Murphy,REP,720135,0,0,128,128,
Tulsa,Commissioner of Labor,Cathy Costello,REP,720135,0,0,135,135,
Tulsa,Commissioner of Labor,Leslie Osborn,REP,720135,0,0,157,157,
Tulsa,Corporation Commissioner,Bob Anthony,REP,720135,0,0,166,166,
Tulsa,Corporation Commissioner,Brian Bingman,REP,720135,0,0,120,120,
Tulsa,U.S. House,Tim Harris,REP,720135,0,0,152,152,01
Tulsa,U.S. House,Kevin Hern,REP,720135,0,0,154,154,01
Tulsa,Governor,Chris Powell,LIB,720135,0,0,0,0,
Tulsa,Governor,Rex Lawhorn,LIB,720135,0,0,0,0,
Tulsa,Corporation Commissioner,Ashley Nicole Mccray,DEM,720135,0,0,64,64,
Tulsa,Corporation Commissioner,Blake Cummings,DEM,720135,0,0,21,21,
Tulsa,U.S. House,Tim Gilpin,DEM,720135,0,0,44,44,01
Tulsa,U.S. House,Amanda Douglas,DEM,720135,0,0,41,41,01
Tulsa,Governor,Mick Cornett,REP,720136,0,0,102,102,
Tulsa,Governor,Kevin Stitt,REP,720136,0,0,157,157,
Tulsa,Lieutenant Governor,Dana Murphy,REP,720136,0,0,95,95,
Tulsa,Lieutenant Governor,Matt Pinnell,REP,720136,0,0,156,156,
Tulsa,State Auditor,Cindy Byrd,REP,720136,0,0,123,123,
Tulsa,State Auditor,Charlie Prater,REP,720136,0,0,121,121,
Tulsa,Attorney General,Mike Hunter,REP,720136,0,0,98,98,
Tulsa,Attorney General,Gentner Drummond,REP,720136,0,0,157,157,
Tulsa,Superintendent of Public Instruction,Joy Hofmeister,REP,720136,0,0,169,169,
Tulsa,Superintendent of Public Instruction,Linda Murphy,REP,720136,0,0,85,85,
Tulsa,Commissioner of Labor,Cathy Costello,REP,720136,0,0,125,125,
Tulsa,Commissioner of Labor,Leslie Osborn,REP,720136,0,0,121,121,
Tulsa,Corporation Commissioner,Bob Anthony,REP,720136,0,0,146,146,
Tulsa,Corporation Commissioner,Brian Bingman,REP,720136,0,0,98,98,
Tulsa,U.S. House,Tim Harris,REP,720136,0,0,132,132,01
Tulsa,U.S. House,Kevin Hern,REP,720136,0,0,125,125,01
Tulsa,Governor,Chris Powell,LIB,720136,0,0,1,1,
Tulsa,Governor,Rex Lawhorn,LIB,720136,0,0,0,0,
Tulsa,Corporation Commissioner,Ashley Nicole Mccray,DEM,720136,0,0,33,33,
Tulsa,Corporation Commissioner,Blake Cummings,DEM,720136,0,0,9,9,
Tulsa,U.S. House,Tim Gilpin,DEM,720136,0,0,31,31,01
Tulsa,U.S. House,Amanda Douglas,DEM,720136,0,0,13,13,01
Tulsa,Governor,Mick Cornett,REP,720137,0,0,38,38,
Tulsa,Governor,Kevin Stitt,REP,720137,0,0,69,69,
Tulsa,Lieutenant Governor,Dana Murphy,REP,720137,0,0,41,41,
Tulsa,Lieutenant Governor,Matt Pinnell,REP,720137,0,0,65,65,
Tulsa,State Auditor,Cindy Byrd,REP,720137,0,0,49,49,
Tulsa,State Auditor,Charlie Prater,REP,720137,0,0,55,55,
Tulsa,Attorney General,Mike Hunter,REP,720137,0,0,52,52,
Tulsa,Attorney General,Gentner Drummond,REP,720137,0,0,56,56,
Tulsa,Superintendent of Public Instruction,Joy Hofmeister,REP,720137,0,0,64,64,
Tulsa,Superintendent of Public Instruction,Linda Murphy,REP,720137,0,0,42,42,
Tulsa,Commissioner of Labor,Cathy Costello,REP,720137,0,0,48,48,
Tulsa,Commissioner of Labor,Leslie Osborn,REP,720137,0,0,58,58,
Tulsa,Corporation Commissioner,Bob Anthony,REP,720137,0,0,55,55,
Tulsa,Corporation Commissioner,Brian Bingman,REP,720137,0,0,52,52,
Tulsa,U.S. House,Tim Harris,REP,720137,0,0,61,61,01
Tulsa,U.S. House,Kevin Hern,REP,720137,0,0,47,47,01
Tulsa,State House,Karen Gilbert,REP,720137,0,0,37,37,79
Tulsa,State House,Dan Hicks,REP,720137,0,0,69,69,79
Tulsa,Governor,Chris Powell,LIB,720137,0,0,0,0,
Tulsa,Governor,Rex Lawhorn,LIB,720137,0,0,0,0,
Tulsa,Corporation Commissioner,Ashley Nicole Mccray,DEM,720137,0,0,32,32,
Tulsa,Corporation Commissioner,Blake Cummings,DEM,720137,0,0,9,9,
Tulsa,U.S. House,Tim Gilpin,DEM,720137,0,0,16,16,01
Tulsa,U.S. House,Amanda Douglas,DEM,720137,0,0,25,25,01
Tulsa,Governor,Mick Cornett,REP,720138,0,0,10,10,
Tulsa,Governor,Kevin Stitt,REP,720138,0,0,21,21,
Tulsa,Lieutenant Governor,Dana Murphy,REP,720138,0,0,16,16,
Tulsa,Lieutenant Governor,Matt Pinnell,REP,720138,0,0,15,15,
Tulsa,State Auditor,Cindy Byrd,REP,720138,0,0,18,18,
Tulsa,State Auditor,Charlie Prater,REP,720138,0,0,12,12,
Tulsa,Attorney General,Mike Hunter,REP,720138,0,0,15,15,
Tulsa,Attorney General,Gentner Drummond,REP,720138,0,0,16,16,
Tulsa,Superintendent of Public Instruction,Joy Hofmeister,REP,720138,0,0,13,13,
Tulsa,Superintendent of Public Instruction,Linda Murphy,REP,720138,0,0,18,18,
Tulsa,Commissioner of Labor,Cathy Costello,REP,720138,0,0,14,14,
Tulsa,Commissioner of Labor,Leslie Osborn,REP,720138,0,0,17,17,
Tulsa,Corporation Commissioner,Bob Anthony,REP,720138,0,0,21,21,
Tulsa,Corporation Commissioner,Brian Bingman,REP,720138,0,0,10,10,
Tulsa,U.S. House,Tim Harris,REP,720138,0,0,12,12,01
Tulsa,U.S. House,Kevin Hern,REP,720138,0,0,19,19,01
Tulsa,State House,Karen Gilbert,REP,720138,0,0,16,16,79
Tulsa,State House,Dan Hicks,REP,720138,0,0,15,15,79
Tulsa,Governor,Chris Powell,LIB,720138,0,0,0,0,
Tulsa,Governor,Rex Lawhorn,LIB,720138,0,0,0,0,
Tulsa,Corporation Commissioner,Ashley Nicole Mccray,DEM,720138,0,0,12,12,
Tulsa,Corporation Commissioner,Blake Cummings,DEM,720138,0,0,4,4,
Tulsa,U.S. House,Tim Gilpin,DEM,720138,0,0,10,10,01
Tulsa,U.S. House,Amanda Douglas,DEM,720138,0,0,6,6,01
Tulsa,Governor,Mick Cornett,REP,720139,0,0,14,14,
Tulsa,Governor,Kevin Stitt,REP,720139,0,0,28,28,
Tulsa,Lieutenant Governor,Dana Murphy,REP,720139,0,0,20,20,
Tulsa,Lieutenant Governor,Matt Pinnell,REP,720139,0,0,22,22,
Tulsa,State Auditor,Cindy Byrd,REP,720139,0,0,17,17,
Tulsa,State Auditor,Charlie Prater,REP,720139,0,0,22,22,
Tulsa,Attorney General,Mike Hunter,REP,720139,0,0,21,21,
Tulsa,Attorney General,Gentner Drummond,REP,720139,0,0,20,20,
Tulsa,Superintendent of Public Instruction,Joy Hofmeister,REP,720139,0,0,18,18,
Tulsa,Superintendent of Public Instruction,Linda Murphy,REP,720139,0,0,23,23,
Tulsa,Commissioner of Labor,Cathy Costello,REP,720139,0,0,20,20,
Tulsa,Commissioner of Labor,Leslie Osborn,REP,720139,0,0,18,18,
Tulsa,Corporation Commissioner,Bob Anthony,REP,720139,0,0,18,18,
Tulsa,Corporation Commissioner,Brian Bingman,REP,720139,0,0,21,21,
Tulsa,U.S. House,Tim Harris,REP,720139,0,0,21,21,01
Tulsa,U.S. House,Kevin Hern,REP,720139,0,0,21,21,01
Tulsa,State House,Lonnie Sims,REP,720139,0,0,16,16,68
Tulsa,State House,Nicole Nixon,REP,720139,0,0,24,24,68
Tulsa,Governor,Chris Powell,LIB,720139,0,0,0,0,
Tulsa,Governor,Rex Lawhorn,LIB,720139,0,0,0,0,
Tulsa,Corporation Commissioner,Ashley Nicole Mccray,DEM,720139,0,0,61,61,
Tulsa,Corporation Commissioner,Blake Cummings,DEM,720139,0,0,20,20,
Tulsa,U.S. House,Tim Gilpin,DEM,720139,0,0,37,37,01
Tulsa,U.S. House,Amanda Douglas,DEM,720139,0,0,44,44,01
Tulsa,State House,Angela Statum,DEM,720139,0,0,37,37,68
Tulsa,State House,Michael Ross,DEM,720139,0,0,43,43,68
Tulsa,Governor,Mick Cornett,REP,720140,0,0,24,24,
Tulsa,Governor,Kevin Stitt,REP,720140,0,0,29,29,
Tulsa,Lieutenant Governor,Dana Murphy,REP,720140,0,0,20,20,
Tulsa,Lieutenant Governor,Matt Pinnell,REP,720140,0,0,31,31,
Tulsa,State Auditor,Cindy Byrd,REP,720140,0,0,27,27,
Tulsa,State Auditor,Charlie Prater,REP,720140,0,0,23,23,
Tulsa,Attorney General,Mike Hunter,REP,720140,0,0,21,21,
Tulsa,Attorney General,Gentner Drummond,REP,720140,0,0,31,31,
Tulsa,Superintendent of Public Instruction,Joy Hofmeister,REP,720140,0,0,29,29,
Tulsa,Superintendent of Public Instruction,Linda Murphy,REP,720140,0,0,23,23,
Tulsa,Commissioner of Labor,Cathy Costello,REP,720140,0,0,25,25,
Tulsa,Commissioner of Labor,Leslie Osborn,REP,720140,0,0,24,24,
Tulsa,Corporation Commissioner,Bob Anthony,REP,720140,0,0,22,22,
Tulsa,Corporation Commissioner,Brian Bingman,REP,720140,0,0,26,26,
Tulsa,U.S. House,Tim Harris,REP,720140,0,0,26,26,01
Tulsa,U.S. House,Kevin Hern,REP,720140,0,0,25,25,01
Tulsa,State House,Jadine Nollan,REP,720140,0,0,27,27,66
Tulsa,State House,Brian Jackson,REP,720140,0,0,25,25,66
Tulsa,Governor,Chris Powell,LIB,720140,0,0,0,0,
Tulsa,Governor,Rex Lawhorn,LIB,720140,0,0,1,1,
Tulsa,Corporation Commissioner,Ashley Nicole Mccray,DEM,720140,0,0,93,93,
Tulsa,Corporation Commissioner,Blake Cummings,DEM,720140,0,0,23,23,
Tulsa,U.S. House,Tim Gilpin,DEM,720140,0,0,89,89,01
Tulsa,U.S. House,Amanda Douglas,DEM,720140,0,0,32,32,01
Tulsa,Governor,Mick Cornett,REP,720141,0,0,70,70,
Tulsa,Governor,Kevin Stitt,REP,720141,0,0,134,134,
Tulsa,Lieutenant Governor,Dana Murphy,REP,720141,0,0,66,66,
Tulsa,Lieutenant Governor,Matt Pinnell,REP,720141,0,0,130,130,
Tulsa,State Auditor,Cindy Byrd,REP,720141,0,0,86,86,
Tulsa,State Auditor,Charlie Prater,REP,720141,0,0,105,105,
Tulsa,Attorney General,Mike Hunter,REP,720141,0,0,94,94,
Tulsa,Attorney General,Gentner Drummond,REP,720141,0,0,104,104,
Tulsa,Superintendent of Public Instruction,Joy Hofmeister,REP,720141,0,0,99,99,
Tulsa,Superintendent of Public Instruction,Linda Murphy,REP,720141,0,0,94,94,
Tulsa,Commissioner of Labor,Cathy Costello,REP,720141,0,0,97,97,
Tulsa,Commissioner of Labor,Leslie Osborn,REP,720141,0,0,92,92,
Tulsa,Corporation Commissioner,Bob Anthony,REP,720141,0,0,97,97,
Tulsa,Corporation Commissioner,Brian Bingman,REP,720141,0,0,94,94,
Tulsa,U.S. House,Tim Harris,REP,720141,0,0,74,74,01
Tulsa,U.S. House,Kevin Hern,REP,720141,0,0,129,129,01
Tulsa,State House,Lonnie Sims,REP,720141,0,0,86,86,68
Tulsa,State House,Nicole Nixon,REP,720141,0,0,110,110,68
Tulsa,Governor,Chris Powell,LIB,720141,0,0,0,0,
Tulsa,Governor,Rex Lawhorn,LIB,720141,0,0,0,0,
Tulsa,Corporation Commissioner,Ashley Nicole Mccray,DEM,720141,0,0,86,86,
Tulsa,Corporation Commissioner,Blake Cummings,DEM,720141,0,0,38,38,
Tulsa,U.S. House,Tim Gilpin,DEM,720141,0,0,85,85,01
Tulsa,U.S. House,Amanda Douglas,DEM,720141,0,0,41,41,01
Tulsa,State House,Angela Statum,DEM,720141,0,0,52,52,68
Tulsa,State House,Michael Ross,DEM,720141,0,0,74,74,68
Tulsa,Governor,Mick Cornett,REP,720142,0,0,35,35,
Tulsa,Governor,Kevin Stitt,REP,720142,0,0,120,120,
Tulsa,Lieutenant Governor,Dana Murphy,REP,720142,0,0,61,61,
Tulsa,Lieutenant Governor,Matt Pinnell,REP,720142,0,0,92,92,
Tulsa,State Auditor,Cindy Byrd,REP,720142,0,0,53,53,
Tulsa,State Auditor,Charlie Prater,REP,720142,0,0,96,96,
Tulsa,Attorney General,Mike Hunter,REP,720142,0,0,58,58,
Tulsa,Attorney General,Gentner Drummond,REP,720142,0,0,94,94,
Tulsa,Superintendent of Public Instruction,Joy Hofmeister,REP,720142,0,0,102,102,
Tulsa,Superintendent of Public Instruction,Linda Murphy,REP,720142,0,0,49,49,
Tulsa,Commissioner of Labor,Cathy Costello,REP,720142,0,0,71,71,
Tulsa,Commissioner of Labor,Leslie Osborn,REP,720142,0,0,77,77,
Tulsa,Corporation Commissioner,Bob Anthony,REP,720142,0,0,68,68,
Tulsa,Corporation Commissioner,Brian Bingman,REP,720142,0,0,81,81,
Tulsa,U.S. House,Tim Harris,REP,720142,0,0,52,52,01
Tulsa,U.S. House,Kevin Hern,REP,720142,0,0,102,102,01
Tulsa,State House,Lonnie Sims,REP,720142,0,0,66,66,68
Tulsa,State House,Nicole Nixon,REP,720142,0,0,82,82,68
Tulsa,Governor,Chris Powell,LIB,720142,0,0,0,0,
Tulsa,Governor,Rex Lawhorn,LIB,720142,0,0,0,0,
Tulsa,Corporation Commissioner,Ashley Nicole Mccray,DEM,720142,0,0,36,36,
Tulsa,Corporation Commissioner,Blake Cummings,DEM,720142,0,0,22,22,
Tulsa,U.S. House,Tim Gilpin,DEM,720142,0,0,27,27,01
Tulsa,U.S. House,Amanda Douglas,DEM,720142,0,0,32,32,01
Tulsa,State House,Angela Statum,DEM,720142,0,0,30,30,68
Tulsa,State House,Michael Ross,DEM,720142,0,0,29,29,68
Tulsa,Governor,Mick Cornett,REP,720143,0,0,33,33,
Tulsa,Governor,Kevin Stitt,REP,720143,0,0,84,84,
Tulsa,Lieutenant Governor,Dana Murphy,REP,720143,0,0,41,41,
Tulsa,Lieutenant Governor,Matt Pinnell,REP,720143,0,0,74,74,
Tulsa,State Auditor,Cindy Byrd,REP,720143,0,0,54,54,
Tulsa,State Auditor,Charlie Prater,REP,720143,0,0,60,60,
Tulsa,Attorney General,Mike Hunter,REP,720143,0,0,47,47,
Tulsa,Attorney General,Gentner Drummond,REP,720143,0,0,69,69,
Tulsa,Superintendent of Public Instruction,Joy Hofmeister,REP,720143,0,0,54,54,
Tulsa,Superintendent of Public Instruction,Linda Murphy,REP,720143,0,0,61,61,
Tulsa,Commissioner of Labor,Cathy Costello,REP,720143,0,0,47,47,
Tulsa,Commissioner of Labor,Leslie Osborn,REP,720143,0,0,67,67,
Tulsa,Corporation Commissioner,Bob Anthony,REP,720143,0,0,54,54,
Tulsa,Corporation Commissioner,Brian Bingman,REP,720143,0,0,60,60,
Tulsa,U.S. House,Tim Harris,REP,720143,0,0,39,39,01
Tulsa,U.S. House,Kevin Hern,REP,720143,0,0,76,76,01
Tulsa,State House,Lonnie Sims,REP,720143,0,0,56,56,68
Tulsa,State House,Nicole Nixon,REP,720143,0,0,59,59,68
Tulsa,Governor,Chris Powell,LIB,720143,0,0,1,1,
Tulsa,Governor,Rex Lawhorn,LIB,720143,0,0,0,0,
Tulsa,Corporation Commissioner,Ashley Nicole Mccray,DEM,720143,0,0,39,39,
Tulsa,Corporation Commissioner,Blake Cummings,DEM,720143,0,0,17,17,
Tulsa,U.S. House,Tim Gilpin,DEM,720143,0,0,32,32,01
Tulsa,U.S. House,Amanda Douglas,DEM,720143,0,0,24,24,01
Tulsa,State House,Angela Statum,DEM,720143,0,0,30,30,68
Tulsa,State House,Michael Ross,DEM,720143,0,0,28,28,68
Tulsa,Governor,Mick Cornett,REP,720144,0,0,75,75,
Tulsa,Governor,Kevin Stitt,REP,720144,0,0,163,163,
Tulsa,Lieutenant Governor,Dana Murphy,REP,720144,0,0,98,98,
Tulsa,Lieutenant Governor,Matt Pinnell,REP,720144,0,0,133,133,
Tulsa,State Auditor,Cindy Byrd,REP,720144,0,0,126,126,
Tulsa,State Auditor,Charlie Prater,REP,720144,0,0,102,102,
Tulsa,Attorney General,Mike Hunter,REP,720144,0,0,121,121,
Tulsa,Attorney General,Gentner Drummond,REP,720144,0,0,116,116,
Tulsa,Superintendent of Public Instruction,Joy Hofmeister,REP,720144,0,0,114,114,
Tulsa,Superintendent of Public Instruction,Linda Murphy,REP,720144,0,0,119,119,
Tulsa,Commissioner of Labor,Cathy Costello,REP,720144,0,0,104,104,
Tulsa,Commissioner of Labor,Leslie Osborn,REP,720144,0,0,125,125,
Tulsa,Corporation Commissioner,Bob Anthony,REP,720144,0,0,126,126,
Tulsa,Corporation Commissioner,Brian Bingman,REP,720144,0,0,104,104,
Tulsa,U.S. House,Tim Harris,REP,720144,0,0,98,98,01
Tulsa,U.S. House,Kevin Hern,REP,720144,0,0,141,141,01
Tulsa,State House,Lonnie Sims,REP,720144,0,0,112,112,68
Tulsa,State House,Nicole Nixon,REP,720144,0,0,122,122,68
Tulsa,Governor,Chris Powell,LIB,720144,0,0,1,1,
Tulsa,Governor,Rex Lawhorn,LIB,720144,0,0,0,0,
Tulsa,Corporation Commissioner,Ashley Nicole Mccray,DEM,720144,0,0,92,92,
Tulsa,Corporation Commissioner,Blake Cummings,DEM,720144,0,0,48,48,
Tulsa,U.S. House,Tim Gilpin,DEM,720144,0,0,86,86,01
Tulsa,U.S. House,Amanda Douglas,DEM,720144,0,0,56,56,01
Tulsa,State House,Angela Statum,DEM,720144,0,0,71,71,68
Tulsa,State House,Michael Ross,DEM,720144,0,0,71,71,68
Tulsa,Governor,Mick Cornett,REP,720145,0,0,123,123,
Tulsa,Governor,Kevin Stitt,REP,720145,0,0,310,310,
Tulsa,Lieutenant Governor,Dana Murphy,REP,720145,0,0,143,143,
Tulsa,Lieutenant Governor,Matt Pinnell,REP,720145,0,0,274,274,
Tulsa,State Auditor,Cindy Byrd,REP,720145,0,0,230,230,
Tulsa,State Auditor,Charlie Prater,REP,720145,0,0,167,167,
Tulsa,Attorney General,Mike Hunter,REP,720145,0,0,200,200,
Tulsa,Attorney General,Gentner Drummond,REP,720145,0,0,220,220,
Tulsa,Superintendent of Public Instruction,Joy Hofmeister,REP,720145,0,0,256,256,
Tulsa,Superintendent of Public Instruction,Linda Murphy,REP,720145,0,0,153,153,
Tulsa,Commissioner of Labor,Cathy Costello,REP,720145,0,0,204,204,
Tulsa,Commissioner of Labor,Leslie Osborn,REP,720145,0,0,189,189,
Tulsa,Corporation Commissioner,Bob Anthony,REP,720145,0,0,205,205,
Tulsa,Corporation Commissioner,Brian Bingman,REP,720145,0,0,198,198,
Tulsa,U.S. House,Tim Harris,REP,720145,0,0,203,203,01
Tulsa,U.S. House,Kevin Hern,REP,720145,0,0,223,223,01
Tulsa,State House,Lonnie Sims,REP,720145,0,0,224,224,68
Tulsa,State House,Nicole Nixon,REP,720145,0,0,171,171,68
Tulsa,Governor,Chris Powell,LIB,720145,0,0,0,0,
Tulsa,Governor,Rex Lawhorn,LIB,720145,0,0,0,0,
Tulsa,Corporation Commissioner,Ashley Nicole Mccray,DEM,720145,0,0,45,45,
Tulsa,Corporation Commissioner,Blake Cummings,DEM,720145,0,0,25,25,
Tulsa,U.S. House,Tim Gilpin,DEM,720145,0,0,41,41,01
Tulsa,U.S. House,Amanda Douglas,DEM,720145,0,0,30,30,01
Tulsa,State House,Angela Statum,DEM,720145,0,0,28,28,68
Tulsa,State House,Michael Ross,DEM,720145,0,0,43,43,68
Tulsa,Governor,Mick Cornett,REP,720146,0,0,97,97,
Tulsa,Governor,Kevin Stitt,REP,720146,0,0,184,184,
Tulsa,Lieutenant Governor,Dana Murphy,REP,720146,0,0,107,107,
Tulsa,Lieutenant Governor,Matt Pinnell,REP,720146,0,0,171,171,
Tulsa,State Auditor,Cindy Byrd,REP,720146,0,0,156,156,
Tulsa,State Auditor,Charlie Prater,REP,720146,0,0,115,115,
Tulsa,Attorney General,Mike Hunter,REP,720146,0,0,113,113,
Tulsa,Attorney General,Gentner Drummond,REP,720146,0,0,165,165,
Tulsa,Superintendent of Public Instruction,Joy Hofmeister,REP,720146,0,0,165,165,
Tulsa,Superintendent of Public Instruction,Linda Murphy,REP,720146,0,0,111,111,
Tulsa,Commissioner of Labor,Cathy Costello,REP,720146,0,0,147,147,
Tulsa,Commissioner of Labor,Leslie Osborn,REP,720146,0,0,121,121,
Tulsa,Corporation Commissioner,Bob Anthony,REP,720146,0,0,148,148,
Tulsa,Corporation Commissioner,Brian Bingman,REP,720146,0,0,122,122,
Tulsa,U.S. House,Tim Harris,REP,720146,0,0,139,139,01
Tulsa,U.S. House,Kevin Hern,REP,720146,0,0,137,137,01
Tulsa,State House,Lonnie Sims,REP,720146,0,0,160,160,68
Tulsa,State House,Nicole Nixon,REP,720146,0,0,112,112,68
Tulsa,Governor,Chris Powell,LIB,720146,0,0,0,0,
Tulsa,Governor,Rex Lawhorn,LIB,720146,0,0,1,1,
Tulsa,Corporation Commissioner,Ashley Nicole Mccray,DEM,720146,0,0,76,76,
Tulsa,Corporation Commissioner,Blake Cummings,DEM,720146,0,0,31,31,
Tulsa,U.S. House,Tim Gilpin,DEM,720146,0,0,62,62,01
Tulsa,U.S. House,Amanda Douglas,DEM,720146,0,0,45,45,01
Tulsa,State House,Angela Statum,DEM,720146,0,0,47,47,68
Tulsa,State House,Michael Ross,DEM,720146,0,0,60,60,68
Tulsa,Governor,Mick Cornett,REP,720147,0,0,7,7,
Tulsa,Governor,Kevin Stitt,REP,720147,0,0,21,21,
Tulsa,Lieutenant Governor,Dana Murphy,REP,720147,0,0,15,15,
Tulsa,Lieutenant Governor,Matt Pinnell,REP,720147,0,0,12,12,
Tulsa,State Auditor,Cindy Byrd,REP,720147,0,0,14,14,
Tulsa,State Auditor,Charlie Prater,REP,720147,0,0,13,13,
Tulsa,Attorney General,Mike Hunter,REP,720147,0,0,11,11,
Tulsa,Attorney General,Gentner Drummond,REP,720147,0,0,16,16,
Tulsa,Superintendent of Public Instruction,Joy Hofmeister,REP,720147,0,0,12,12,
Tulsa,Superintendent of Public Instruction,Linda Murphy,REP,720147,0,0,14,14,
Tulsa,Commissioner of Labor,Cathy Costello,REP,720147,0,0,12,12,
Tulsa,Commissioner of Labor,Leslie Osborn,REP,720147,0,0,15,15,
Tulsa,Corporation Commissioner,Bob Anthony,REP,720147,0,0,13,13,
Tulsa,Corporation Commissioner,Brian Bingman,REP,720147,0,0,13,13,
Tulsa,U.S. House,Tim Harris,REP,720147,0,0,11,11,01
Tulsa,U.S. House,Kevin Hern,REP,720147,0,0,16,16,01
Tulsa,State House,Jadine Nollan,REP,720147,0,0,15,15,66
Tulsa,State House,Brian Jackson,REP,720147,0,0,12,12,66
Tulsa,Governor,Chris Powell,LIB,720147,0,0,0,0,
Tulsa,Governor,Rex Lawhorn,LIB,720147,0,0,1,1,
Tulsa,Corporation Commissioner,Ashley Nicole Mccray,DEM,720147,0,0,52,52,
Tulsa,Corporation Commissioner,Blake Cummings,DEM,720147,0,0,12,12,
Tulsa,U.S. House,Tim Gilpin,DEM,720147,0,0,33,33,01
Tulsa,U.S. House,Amanda Douglas,DEM,720147,0,0,32,32,01
Tulsa,Governor,Mick Cornett,REP,720148,0,0,35,35,
Tulsa,Governor,Kevin Stitt,REP,720148,0,0,76,76,
Tulsa,Lieutenant Governor,Dana Murphy,REP,720148,0,0,47,47,
Tulsa,Lieutenant Governor,Matt Pinnell,REP,720148,0,0,63,63,
Tulsa,State Auditor,Cindy Byrd,REP,720148,0,0,50,50,
Tulsa,State Auditor,Charlie Prater,REP,720148,0,0,59,59,
Tulsa,Attorney General,Mike Hunter,REP,720148,0,0,52,52,
Tulsa,Attorney General,Gentner Drummond,REP,720148,0,0,57,57,
Tulsa,Superintendent of Public Instruction,Joy Hofmeister,REP,720148,0,0,45,45,
Tulsa,Superintendent of Public Instruction,Linda Murphy,REP,720148,0,0,63,63,
Tulsa,Commissioner of Labor,Cathy Costello,REP,720148,0,0,53,53,
Tulsa,Commissioner of Labor,Leslie Osborn,REP,720148,0,0,56,56,
Tulsa,Corporation Commissioner,Bob Anthony,REP,720148,0,0,51,51,
Tulsa,Corporation Commissioner,Brian Bingman,REP,720148,0,0,57,57,
Tulsa,U.S. House,Tim Harris,REP,720148,0,0,39,39,01
Tulsa,U.S. House,Kevin Hern,REP,720148,0,0,74,74,01
Tulsa,State House,Jadine Nollan,REP,720148,0,0,66,66,66
Tulsa,State House,Brian Jackson,REP,720148,0,0,43,43,66
Tulsa,Governor,Chris Powell,LIB,720148,0,0,0,0,
Tulsa,Governor,Rex Lawhorn,LIB,720148,0,0,0,0,
Tulsa,Corporation Commissioner,Ashley Nicole Mccray,DEM,720148,0,0,47,47,
Tulsa,Corporation Commissioner,Blake Cummings,DEM,720148,0,0,17,17,
Tulsa,U.S. House,Tim Gilpin,DEM,720148,0,0,34,34,01
Tulsa,U.S. House,Amanda Douglas,DEM,720148,0,0,30,30,01
Tulsa,Governor,Mick Cornett,REP,720149,0,0,25,25,
Tulsa,Governor,Kevin Stitt,REP,720149,0,0,55,55,
Tulsa,Lieutenant Governor,Dana Murphy,REP,720149,0,0,35,35,
Tulsa,Lieutenant Governor,Matt Pinnell,REP,720149,0,0,44,44,
Tulsa,State Auditor,Cindy Byrd,REP,720149,0,0,39,39,
Tulsa,State Auditor,Charlie Prater,REP,720149,0,0,40,40,
Tulsa,Attorney General,Mike Hunter,REP,720149,0,0,31,31,
Tulsa,Attorney General,Gentner Drummond,REP,720149,0,0,46,46,
Tulsa,Superintendent of Public Instruction,Joy Hofmeister,REP,720149,0,0,42,42,
Tulsa,Superintendent of Public Instruction,Linda Murphy,REP,720149,0,0,36,36,
Tulsa,Commissioner of Labor,Cathy Costello,REP,720149,0,0,45,45,
Tulsa,Commissioner of Labor,Leslie Osborn,REP,720149,0,0,33,33,
Tulsa,Corporation Commissioner,Bob Anthony,REP,720149,0,0,30,30,
Tulsa,Corporation Commissioner,Brian Bingman,REP,720149,0,0,50,50,
Tulsa,U.S. House,Tim Harris,REP,720149,0,0,27,27,01
Tulsa,U.S. House,Kevin Hern,REP,720149,0,0,54,54,01
Tulsa,State House,Jadine Nollan,REP,720149,0,0,51,51,66
Tulsa,State House,Brian Jackson,REP,720149,0,0,27,27,66
Tulsa,Governor,Chris Powell,LIB,720149,0,0,0,0,
Tulsa,Governor,Rex Lawhorn,LIB,720149,0,0,0,0,
Tulsa,Corporation Commissioner,Ashley Nicole Mccray,DEM,720149,0,0,31,31,
Tulsa,Corporation Commissioner,Blake Cummings,DEM,720149,0,0,12,12,
Tulsa,U.S. House,Tim Gilpin,DEM,720149,0,0,25,25,01
Tulsa,U.S. House,Amanda Douglas,DEM,720149,0,0,19,19,01
Tulsa,Governor,Mick Cornett,REP,720150,0,0,234,234,
Tulsa,Governor,Kevin Stitt,REP,720150,0,0,379,379,
Tulsa,Lieutenant Governor,Dana Murphy,REP,720150,0,0,234,234,
Tulsa,Lieutenant Governor,Matt Pinnell,REP,720150,0,0,347,347,
Tulsa,State Auditor,Cindy Byrd,REP,720150,0,0,316,316,
Tulsa,State Auditor,Charlie Prater,REP,720150,0,0,226,226,
Tulsa,Attorney General,Mike Hunter,REP,720150,0,0,280,280,
Tulsa,Attorney General,Gentner Drummond,REP,720150,0,0,316,316,
Tulsa,Superintendent of Public Instruction,Joy Hofmeister,REP,720150,0,0,341,341,
Tulsa,Superintendent of Public Instruction,Linda Murphy,REP,720150,0,0,253,253,
Tulsa,Commissioner of Labor,Cathy Costello,REP,720150,0,0,299,299,
Tulsa,Commissioner of Labor,Leslie Osborn,REP,720150,0,0,264,264,
Tulsa,Corporation Commissioner,Bob Anthony,REP,720150,0,0,316,316,
Tulsa,Corporation Commissioner,Brian Bingman,REP,720150,0,0,250,250,
Tulsa,U.S. House,Tim Harris,REP,720150,0,0,301,301,01
Tulsa,U.S. House,Kevin Hern,REP,720150,0,0,299,299,01
Tulsa,State Senate,John Haste,REP,720150,0,0,303,303,36
Tulsa,State Senate,Bill Day,REP,720150,0,0,267,267,36
Tulsa,Governor,Chris Powell,LIB,720150,0,0,0,0,
Tulsa,Governor,Rex Lawhorn,LIB,720150,0,0,0,0,
Tulsa,Corporation Commissioner,Ashley Nicole Mccray,DEM,720150,0,0,103,103,
Tulsa,Corporation Commissioner,Blake Cummings,DEM,720150,0,0,32,32,
Tulsa,U.S. House,Tim Gilpin,DEM,720150,0,0,78,78,01
Tulsa,U.S. House,Amanda Douglas,DEM,720150,0,0,58,58,01
Tulsa,Governor,Mick Cornett,REP,720151,0,0,41,41,
Tulsa,Governor,Kevin Stitt,REP,720151,0,0,65,65,
Tulsa,Lieutenant Governor,Dana Murphy,REP,720151,0,0,41,41,
Tulsa,Lieutenant Governor,Matt Pinnell,REP,720151,0,0,63,63,
Tulsa,State Auditor,Cindy Byrd,REP,720151,0,0,44,44,
Tulsa,State Auditor,Charlie Prater,REP,720151,0,0,56,56,
Tulsa,Attorney General,Mike Hunter,REP,720151,0,0,50,50,
Tulsa,Attorney General,Gentner Drummond,REP,720151,0,0,55,55,
Tulsa,Superintendent of Public Instruction,Joy Hofmeister,REP,720151,0,0,62,62,
Tulsa,Superintendent of Public Instruction,Linda Murphy,REP,720151,0,0,40,40,
Tulsa,Commissioner of Labor,Cathy Costello,REP,720151,0,0,53,53,
Tulsa,Commissioner of Labor,Leslie Osborn,REP,720151,0,0,47,47,
Tulsa,Corporation Commissioner,Bob Anthony,REP,720151,0,0,61,61,
Tulsa,Corporation Commissioner,Brian Bingman,REP,720151,0,0,37,37,
Tulsa,U.S. House,Tim Harris,REP,720151,0,0,56,56,01
Tulsa,U.S. House,Kevin Hern,REP,720151,0,0,50,50,01
Tulsa,State House,Karen Gilbert,REP,720151,0,0,46,46,79
Tulsa,State House,Dan Hicks,REP,720151,0,0,59,59,79
Tulsa,Governor,Chris Powell,LIB,720151,0,0,0,0,
Tulsa,Governor,Rex Lawhorn,LIB,720151,0,0,0,0,
Tulsa,Corporation Commissioner,Ashley Nicole Mccray,DEM,720151,0,0,20,20,
Tulsa,Corporation Commissioner,Blake Cummings,DEM,720151,0,0,2,2,
Tulsa,U.S. House,Tim Gilpin,DEM,720151,0,0,10,10,01
Tulsa,U.S. House,Amanda Douglas,DEM,720151,0,0,13,13,01
Tulsa,Governor,Mick Cornett,REP,720152,0,0,129,129,
Tulsa,Governor,Kevin Stitt,REP,720152,0,0,178,178,
Tulsa,Lieutenant Governor,Dana Murphy,REP,720152,0,0,131,131,
Tulsa,Lieutenant Governor,Matt Pinnell,REP,720152,0,0,161,161,
Tulsa,State Auditor,Cindy Byrd,REP,720152,0,0,146,146,
Tulsa,State Auditor,Charlie Prater,REP,720152,0,0,133,133,
Tulsa,Attorney General,Mike Hunter,REP,720152,0,0,138,138,
Tulsa,Attorney General,Gentner Drummond,REP,720152,0,0,156,156,
Tulsa,Superintendent of Public Instruction,Joy Hofmeister,REP,720152,0,0,189,189,
Tulsa,Superintendent of Public Instruction,Linda Murphy,REP,720152,0,0,107,107,
Tulsa,Commissioner of Labor,Cathy Costello,REP,720152,0,0,126,126,
Tulsa,Commissioner of Labor,Leslie Osborn,REP,720152,0,0,156,156,
Tulsa,Corporation Commissioner,Bob Anthony,REP,720152,0,0,149,149,
Tulsa,Corporation Commissioner,Brian Bingman,REP,720152,0,0,133,133,
Tulsa,U.S. House,Tim Harris,REP,720152,0,0,124,124,01
Tulsa,U.S. House,Kevin Hern,REP,720152,0,0,169,169,01
Tulsa,State Senate,John Haste,REP,720152,0,0,133,133,36
Tulsa,State Senate,Bill Day,REP,720152,0,0,158,158,36
Tulsa,Governor,Chris Powell,LIB,720152,0,0,1,1,
Tulsa,Governor,Rex Lawhorn,LIB,720152,0,0,1,1,
Tulsa,Corporation Commissioner,Ashley Nicole Mccray,DEM,720152,0,0,53,53,
Tulsa,Corporation Commissioner,Blake Cummings,DEM,720152,0,0,26,26,
Tulsa,U.S. House,Tim Gilpin,DEM,720152,0,0,44,44,01
Tulsa,U.S. House,Amanda Douglas,DEM,720152,0,0,35,35,01
Tulsa,Governor,Mick Cornett,REP,720153,0,0,111,111,
Tulsa,Governor,Kevin Stitt,REP,720153,0,0,185,185,
Tulsa,Lieutenant Governor,Dana Murphy,REP,720153,0,0,99,99,
Tulsa,Lieutenant Governor,Matt Pinnell,REP,720153,0,0,189,189,
Tulsa,State Auditor,Cindy Byrd,REP,720153,0,0,174,174,
Tulsa,State Auditor,Charlie Prater,REP,720153,0,0,107,107,
Tulsa,Attorney General,Mike Hunter,REP,720153,0,0,137,137,
Tulsa,Attorney General,Gentner Drummond,REP,720153,0,0,154,154,
Tulsa,Superintendent of Public Instruction,Joy Hofmeister,REP,720153,0,0,163,163,
Tulsa,Superintendent of Public Instruction,Linda Murphy,REP,720153,0,0,127,127,
Tulsa,Commissioner of Labor,Cathy Costello,REP,720153,0,0,152,152,
Tulsa,Commissioner of Labor,Leslie Osborn,REP,720153,0,0,130,130,
Tulsa,Corporation Commissioner,Bob Anthony,REP,720153,0,0,164,164,
Tulsa,Corporation Commissioner,Brian Bingman,REP,720153,0,0,119,119,
Tulsa,U.S. House,Tim Harris,REP,720153,0,0,143,143,01
Tulsa,U.S. House,Kevin Hern,REP,720153,0,0,152,152,01
Tulsa,Governor,Chris Powell,LIB,720153,0,0,0,0,
Tulsa,Governor,Rex Lawhorn,LIB,720153,0,0,0,0,
Tulsa,Corporation Commissioner,Ashley Nicole Mccray,DEM,720153,0,0,40,40,
Tulsa,Corporation Commissioner,Blake Cummings,DEM,720153,0,0,12,12,
Tulsa,U.S. House,Tim Gilpin,DEM,720153,0,0,35,35,01
Tulsa,U.S. House,Amanda Douglas,DEM,720153,0,0,18,18,01
Tulsa,Governor,Mick Cornett,REP,720154,0,0,155,155,
Tulsa,Governor,Kevin Stitt,REP,720154,0,0,235,235,
Tulsa,Lieutenant Governor,Dana Murphy,REP,720154,0,0,153,153,
Tulsa,Lieutenant Governor,Matt Pinnell,REP,720154,0,0,231,231,
Tulsa,State Auditor,Cindy Byrd,REP,720154,0,0,209,209,
Tulsa,State Auditor,Charlie Prater,REP,720154,0,0,157,157,
Tulsa,Attorney General,Mike Hunter,REP,720154,0,0,189,189,
Tulsa,Attorney General,Gentner Drummond,REP,720154,0,0,193,193,
Tulsa,Superintendent of Public Instruction,Joy Hofmeister,REP,720154,0,0,259,259,
Tulsa,Superintendent of Public Instruction,Linda Murphy,REP,720154,0,0,125,125,
Tulsa,Commissioner of Labor,Cathy Costello,REP,720154,0,0,201,201,
Tulsa,Commissioner of Labor,Leslie Osborn,REP,720154,0,0,165,165,
Tulsa,Corporation Commissioner,Bob Anthony,REP,720154,0,0,230,230,
Tulsa,Corporation Commissioner,Brian Bingman,REP,720154,0,0,146,146,
Tulsa,U.S. House,Tim Harris,REP,720154,0,0,195,195,01
Tulsa,U.S. House,Kevin Hern,REP,720154,0,0,191,191,01
Tulsa,Governor,Chris Powell,LIB,720154,0,0,0,0,
Tulsa,Governor,Rex Lawhorn,LIB,720154,0,0,1,1,
Tulsa,Corporation Commissioner,Ashley Nicole Mccray,DEM,720154,0,0,54,54,
Tulsa,Corporation Commissioner,Blake Cummings,DEM,720154,0,0,23,23,
Tulsa,U.S. House,Tim Gilpin,DEM,720154,0,0,43,43,01
Tulsa,U.S. House,Amanda Douglas,DEM,720154,0,0,35,35,01
Tulsa,Governor,Mick Cornett,REP,720155,0,0,331,331,
Tulsa,Governor,Kevin Stitt,REP,720155,0,0,483,483,
Tulsa,Lieutenant Governor,Dana Murphy,REP,720155,0,0,286,286,
Tulsa,Lieutenant Governor,Matt Pinnell,REP,720155,0,0,481,481,
Tulsa,State Auditor,Cindy Byrd,REP,720155,0,0,426,426,
Tulsa,State Auditor,Charlie Prater,REP,720155,0,0,275,275,
Tulsa,Attorney General,Mike Hunter,REP,720155,0,0,376,376,
Tulsa,Attorney General,Gentner Drummond,REP,720155,0,0,412,412,
Tulsa,Superintendent of Public Instruction,Joy Hofmeister,REP,720155,0,0,565,565,
Tulsa,Superintendent of Public Instruction,Linda Murphy,REP,720155,0,0,215,215,
Tulsa,Commissioner of Labor,Cathy Costello,REP,720155,0,0,363,363,
Tulsa,Commissioner of Labor,Leslie Osborn,REP,720155,0,0,363,363,
Tulsa,Corporation Commissioner,Bob Anthony,REP,720155,0,0,376,376,
Tulsa,Corporation Commissioner,Brian Bingman,REP,720155,0,0,365,365,
Tulsa,U.S. House,Tim Harris,REP,720155,0,0,407,407,01
Tulsa,U.S. House,Kevin Hern,REP,720155,0,0,385,385,01
Tulsa,Governor,Chris Powell,LIB,720155,0,0,1,1,
Tulsa,Governor,Rex Lawhorn,LIB,720155,0,0,0,0,
Tulsa,Corporation Commissioner,Ashley Nicole Mccray,DEM,720155,0,0,46,46,
Tulsa,Corporation Commissioner,Blake Cummings,DEM,720155,0,0,30,30,
Tulsa,U.S. House,Tim Gilpin,DEM,720155,0,0,54,54,01
Tulsa,U.S. House,Amanda Douglas,DEM,720155,0,0,22,22,01
Tulsa,Governor,Mick Cornett,REP,720156,0,0,18,18,
Tulsa,Governor,Kevin Stitt,REP,720156,0,0,27,27,
Tulsa,Lieutenant Governor,Dana Murphy,REP,720156,0,0,18,18,
Tulsa,Lieutenant Governor,Matt Pinnell,REP,720156,0,0,26,26,
Tulsa,State Auditor,Cindy Byrd,REP,720156,0,0,26,26,
Tulsa,State Auditor,Charlie Prater,REP,720156,0,0,17,17,
Tulsa,Attorney General,Mike Hunter,REP,720156,0,0,16,16,
Tulsa,Attorney General,Gentner Drummond,REP,720156,0,0,28,28,
Tulsa,Superintendent of Public Instruction,Joy Hofmeister,REP,720156,0,0,21,21,
Tulsa,Superintendent of Public Instruction,Linda Murphy,REP,720156,0,0,23,23,
Tulsa,Commissioner of Labor,Cathy Costello,REP,720156,0,0,21,21,
Tulsa,Commissioner of Labor,Leslie Osborn,REP,720156,0,0,22,22,
Tulsa,Corporation Commissioner,Bob Anthony,REP,720156,0,0,22,22,
Tulsa,Corporation Commissioner,Brian Bingman,REP,720156,0,0,21,21,
Tulsa,U.S. House,Tim Harris,REP,720156,0,0,16,16,01
Tulsa,U.S. House,Kevin Hern,REP,720156,0,0,29,29,01
Tulsa,State House,Karen Gilbert,REP,720156,0,0,23,23,79
Tulsa,State House,Dan Hicks,REP,720156,0,0,21,21,79
Tulsa,Governor,Chris Powell,LIB,720156,0,0,0,0,
Tulsa,Governor,Rex Lawhorn,LIB,720156,0,0,0,0,
Tulsa,Corporation Commissioner,Ashley Nicole Mccray,DEM,720156,0,0,23,23,
Tulsa,Corporation Commissioner,Blake Cummings,DEM,720156,0,0,6,6,
Tulsa,U.S. House,Tim Gilpin,DEM,720156,0,0,13,13,01
Tulsa,U.S. House,Amanda Douglas,DEM,720156,0,0,16,16,01
Tulsa,Governor,Mick Cornett,REP,720157,0,0,284,284,
Tulsa,Governor,Kevin Stitt,REP,720157,0,0,374,374,
Tulsa,Lieutenant Governor,Dana Murphy,REP,720157,0,0,201,201,
Tulsa,Lieutenant Governor,Matt Pinnell,REP,720157,0,0,426,426,
Tulsa,State Auditor,Cindy Byrd,REP,720157,0,0,327,327,
Tulsa,State Auditor,Charlie Prater,REP,720157,0,0,268,268,
Tulsa,Attorney General,Mike Hunter,REP,720157,0,0,321,321,
Tulsa,Attorney General,Gentner Drummond,REP,720157,0,0,313,313,
Tulsa,Superintendent of Public Instruction,Joy Hofmeister,REP,720157,0,0,410,410,
Tulsa,Superintendent of Public Instruction,Linda Murphy,REP,720157,0,0,221,221,
Tulsa,Commissioner of Labor,Cathy Costello,REP,720157,0,0,328,328,
Tulsa,Commissioner of Labor,Leslie Osborn,REP,720157,0,0,269,269,
Tulsa,Corporation Commissioner,Bob Anthony,REP,720157,0,0,338,338,
Tulsa,Corporation Commissioner,Brian Bingman,REP,720157,0,0,273,273,
Tulsa,U.S. House,Tim Harris,REP,720157,0,0,310,310,01
Tulsa,U.S. House,Kevin Hern,REP,720157,0,0,323,323,01
Tulsa,Governor,Chris Powell,LIB,720157,0,0,0,0,
Tulsa,Governor,Rex Lawhorn,LIB,720157,0,0,0,0,
Tulsa,Corporation Commissioner,Ashley Nicole Mccray,DEM,720157,0,0,58,58,
Tulsa,Corporation Commissioner,Blake Cummings,DEM,720157,0,0,21,21,
Tulsa,U.S. House,Tim Gilpin,DEM,720157,0,0,44,44,01
Tulsa,U.S. House,Amanda Douglas,DEM,720157,0,0,40,40,01
Tulsa,Governor,Mick Cornett,REP,720158,0,0,102,102,
Tulsa,Governor,Kevin Stitt,REP,720158,0,0,181,181,
Tulsa,Lieutenant Governor,Dana Murphy,REP,720158,0,0,89,89,
Tulsa,Lieutenant Governor,Matt Pinnell,REP,720158,0,0,186,186,
Tulsa,State Auditor,Cindy Byrd,REP,720158,0,0,158,158,
Tulsa,State Auditor,Charlie Prater,REP,720158,0,0,104,104,
Tulsa,Attorney General,Mike Hunter,REP,720158,0,0,146,146,
Tulsa,Attorney General,Gentner Drummond,REP,720158,0,0,127,127,
Tulsa,Superintendent of Public Instruction,Joy Hofmeister,REP,720158,0,0,176,176,
Tulsa,Superintendent of Public Instruction,Linda Murphy,REP,720158,0,0,98,98,
Tulsa,Commissioner of Labor,Cathy Costello,REP,720158,0,0,148,148,
Tulsa,Commissioner of Labor,Leslie Osborn,REP,720158,0,0,112,112,
Tulsa,Corporation Commissioner,Bob Anthony,REP,720158,0,0,162,162,
Tulsa,Corporation Commissioner,Brian Bingman,REP,720158,0,0,106,106,
Tulsa,U.S. House,Tim Harris,REP,720158,0,0,152,152,01
Tulsa,U.S. House,Kevin Hern,REP,720158,0,0,125,125,01
Tulsa,Governor,Chris Powell,LIB,720158,0,0,1,1,
Tulsa,Governor,Rex Lawhorn,LIB,720158,0,0,0,0,
Tulsa,Corporation Commissioner,Ashley Nicole Mccray,DEM,720158,0,0,32,32,
Tulsa,Corporation Commissioner,Blake Cummings,DEM,720158,0,0,12,12,
Tulsa,U.S. House,Tim Gilpin,DEM,720158,0,0,32,32,01
Tulsa,U.S. House,Amanda Douglas,DEM,720158,0,0,15,15,01
Tulsa,Governor,Mick Cornett,REP,720159,0,0,112,112,
Tulsa,Governor,Kevin Stitt,REP,720159,0,0,174,174,
Tulsa,Lieutenant Governor,Dana Murphy,REP,720159,0,0,111,111,
Tulsa,Lieutenant Governor,Matt Pinnell,REP,720159,0,0,166,166,
Tulsa,State Auditor,Cindy Byrd,REP,720159,0,0,152,152,
Tulsa,State Auditor,Charlie Prater,REP,720159,0,0,106,106,
Tulsa,Attorney General,Mike Hunter,REP,720159,0,0,136,136,
Tulsa,Attorney General,Gentner Drummond,REP,720159,0,0,147,147,
Tulsa,Superintendent of Public Instruction,Joy Hofmeister,REP,720159,0,0,178,178,
Tulsa,Superintendent of Public Instruction,Linda Murphy,REP,720159,0,0,99,99,
Tulsa,Commissioner of Labor,Cathy Costello,REP,720159,0,0,134,134,
Tulsa,Commissioner of Labor,Leslie Osborn,REP,720159,0,0,133,133,
Tulsa,Corporation Commissioner,Bob Anthony,REP,720159,0,0,156,156,
Tulsa,Corporation Commissioner,Brian Bingman,REP,720159,0,0,103,103,
Tulsa,U.S. House,Tim Harris,REP,720159,0,0,133,133,01
Tulsa,U.S. House,Kevin Hern,REP,720159,0,0,147,147,01
Tulsa,Governor,Chris Powell,LIB,720159,0,0,0,0,
Tulsa,Governor,Rex Lawhorn,LIB,720159,0,0,0,0,
Tulsa,Corporation Commissioner,Ashley Nicole Mccray,DEM,720159,0,0,41,41,
Tulsa,Corporation Commissioner,Blake Cummings,DEM,720159,0,0,11,11,
Tulsa,U.S. House,Tim Gilpin,DEM,720159,0,0,33,33,01
Tulsa,U.S. House,Amanda Douglas,DEM,720159,0,0,20,20,01
Tulsa,Governor,Mick Cornett,REP,720160,0,0,159,159,
Tulsa,Governor,Kevin Stitt,REP,720160,0,0,167,167,
Tulsa,Lieutenant Governor,Dana Murphy,REP,720160,0,0,137,137,
Tulsa,Lieutenant Governor,Matt Pinnell,REP,720160,0,0,182,182,
Tulsa,State Auditor,Cindy Byrd,REP,720160,0,0,180,180,
Tulsa,State Auditor,Charlie Prater,REP,720160,0,0,120,120,
Tulsa,Attorney General,Mike Hunter,REP,720160,0,0,140,140,
Tulsa,Attorney General,Gentner Drummond,REP,720160,0,0,180,180,
Tulsa,Superintendent of Public Instruction,Joy Hofmeister,REP,720160,0,0,203,203,
Tulsa,Superintendent of Public Instruction,Linda Murphy,REP,720160,0,0,114,114,
Tulsa,Commissioner of Labor,Cathy Costello,REP,720160,0,0,167,167,
Tulsa,Commissioner of Labor,Leslie Osborn,REP,720160,0,0,146,146,
Tulsa,Corporation Commissioner,Bob Anthony,REP,720160,0,0,172,172,
Tulsa,Corporation Commissioner,Brian Bingman,REP,720160,0,0,134,134,
Tulsa,U.S. House,Tim Harris,REP,720160,0,0,176,176,01
Tulsa,U.S. House,Kevin Hern,REP,720160,0,0,141,141,01
Tulsa,Governor,Chris Powell,LIB,720160,0,0,4,4,
Tulsa,Governor,Rex Lawhorn,LIB,720160,0,0,0,0,
Tulsa,Corporation Commissioner,Ashley Nicole Mccray,DEM,720160,0,0,157,157,
Tulsa,Corporation Commissioner,Blake Cummings,DEM,720160,0,0,39,39,
Tulsa,U.S. House,Tim Gilpin,DEM,720160,0,0,154,154,01
Tulsa,U.S. House,Amanda Douglas,DEM,720160,0,0,43,43,01
Tulsa,Governor,Mick Cornett,REP,720161,0,0,15,15,
Tulsa,Governor,Kevin Stitt,REP,720161,0,0,32,32,
Tulsa,Lieutenant Governor,Dana Murphy,REP,720161,0,0,18,18,
Tulsa,Lieutenant Governor,Matt Pinnell,REP,720161,0,0,27,27,
Tulsa,State Auditor,Cindy Byrd,REP,720161,0,0,30,30,
Tulsa,State Auditor,Charlie Prater,REP,720161,0,0,15,15,
Tulsa,Attorney General,Mike Hunter,REP,720161,0,0,19,19,
Tulsa,Attorney General,Gentner Drummond,REP,720161,0,0,25,25,
Tulsa,Superintendent of Public Instruction,Joy Hofmeister,REP,720161,0,0,26,26,
Tulsa,Superintendent of Public Instruction,Linda Murphy,REP,720161,0,0,21,21,
Tulsa,Commissioner of Labor,Cathy Costello,REP,720161,0,0,21,21,
Tulsa,Commissioner of Labor,Leslie Osborn,REP,720161,0,0,25,25,
Tulsa,Corporation Commissioner,Bob Anthony,REP,720161,0,0,18,18,
Tulsa,Corporation Commissioner,Brian Bingman,REP,720161,0,0,25,25,
Tulsa,U.S. House,Tim Harris,REP,720161,0,0,16,16,01
Tulsa,U.S. House,Kevin Hern,REP,720161,0,0,29,29,01
Tulsa,State House,Cheryl Baber,REP,720161,0,0,19,19,71
Tulsa,State House,Beverly Atteberry,REP,720161,0,0,23,23,71
Tulsa,Governor,Chris Powell,LIB,720161,0,0,0,0,
Tulsa,Governor,Rex Lawhorn,LIB,720161,0,0,0,0,
Tulsa,Corporation Commissioner,Ashley Nicole Mccray,DEM,720161,0,0,44,44,
Tulsa,Corporation Commissioner,Blake Cummings,DEM,720161,0,0,14,14,
Tulsa,U.S. House,Tim Gilpin,DEM,720161,0,0,29,29,01
Tulsa,U.S. House,Amanda Douglas,DEM,720161,0,0,29,29,01
Tulsa,Governor,Mick Cornett,REP,720162,0,0,11,11,
Tulsa,Governor,Kevin Stitt,REP,720162,0,0,17,17,
Tulsa,Lieutenant Governor,Dana Murphy,REP,720162,0,0,9,9,
Tulsa,Lieutenant Governor,Matt Pinnell,REP,720162,0,0,19,19,
Tulsa,State Auditor,Cindy Byrd,REP,720162,0,0,17,17,
Tulsa,State Auditor,Charlie Prater,REP,720162,0,0,11,11,
Tulsa,Attorney General,Mike Hunter,REP,720162,0,0,17,17,
Tulsa,Attorney General,Gentner Drummond,REP,720162,0,0,10,10,
Tulsa,Superintendent of Public Instruction,Joy Hofmeister,REP,720162,0,0,11,11,
Tulsa,Superintendent of Public Instruction,Linda Murphy,REP,720162,0,0,17,17,
Tulsa,Commissioner of Labor,Cathy Costello,REP,720162,0,0,13,13,
Tulsa,Commissioner of Labor,Leslie Osborn,REP,720162,0,0,14,14,
Tulsa,Corporation Commissioner,Bob Anthony,REP,720162,0,0,14,14,
Tulsa,Corporation Commissioner,Brian Bingman,REP,720162,0,0,13,13,
Tulsa,U.S. House,Tim Harris,REP,720162,0,0,15,15,01
Tulsa,U.S. House,Kevin Hern,REP,720162,0,0,13,13,01
Tulsa,Governor,Chris Powell,LIB,720162,0,0,0,0,
Tulsa,Governor,Rex Lawhorn,LIB,720162,0,0,0,0,
Tulsa,Corporation Commissioner,Ashley Nicole Mccray,DEM,720162,0,0,1,1,
Tulsa,Corporation Commissioner,Blake Cummings,DEM,720162,0,0,0,0,
Tulsa,U.S. House,Tim Gilpin,DEM,720162,0,0,1,1,01
Tulsa,U.S. House,Amanda Douglas,DEM,720162,0,0,0,0,01
Tulsa,Governor,Mick Cornett,REP,720163,0,0,137,137,
Tulsa,Governor,Kevin Stitt,REP,720163,0,0,162,162,
Tulsa,Lieutenant Governor,Dana Murphy,REP,720163,0,0,133,133,
Tulsa,Lieutenant Governor,Matt Pinnell,REP,720163,0,0,161,161,
Tulsa,State Auditor,Cindy Byrd,REP,720163,0,0,172,172,
Tulsa,State Auditor,Charlie Prater,REP,720163,0,0,106,106,
Tulsa,Attorney General,Mike Hunter,REP,720163,0,0,125,125,
Tulsa,Attorney General,Gentner Drummond,REP,720163,0,0,170,170,
Tulsa,Superintendent of Public Instruction,Joy Hofmeister,REP,720163,0,0,192,192,
Tulsa,Superintendent of Public Instruction,Linda Murphy,REP,720163,0,0,103,103,
Tulsa,Commissioner of Labor,Cathy Costello,REP,720163,0,0,136,136,
Tulsa,Commissioner of Labor,Leslie Osborn,REP,720163,0,0,146,146,
Tulsa,Corporation Commissioner,Bob Anthony,REP,720163,0,0,161,161,
Tulsa,Corporation Commissioner,Brian Bingman,REP,720163,0,0,125,125,
Tulsa,U.S. House,Tim Harris,REP,720163,0,0,158,158,01
Tulsa,U.S. House,Kevin Hern,REP,720163,0,0,140,140,01
Tulsa,Governor,Chris Powell,LIB,720163,0,0,2,2,
Tulsa,Governor,Rex Lawhorn,LIB,720163,0,0,0,0,
Tulsa,Corporation Commissioner,Ashley Nicole Mccray,DEM,720163,0,0,85,85,
Tulsa,Corporation Commissioner,Blake Cummings,DEM,720163,0,0,39,39,
Tulsa,U.S. House,Tim Gilpin,DEM,720163,0,0,94,94,01
Tulsa,U.S. House,Amanda Douglas,DEM,720163,0,0,36,36,01
Tulsa,Governor,Mick Cornett,REP,720164,0,0,55,55,
Tulsa,Governor,Kevin Stitt,REP,720164,0,0,71,71,
Tulsa,Lieutenant Governor,Dana Murphy,REP,720164,0,0,51,51,
Tulsa,Lieutenant Governor,Matt Pinnell,REP,720164,0,0,67,67,
Tulsa,State Auditor,Cindy Byrd,REP,720164,0,0,62,62,
Tulsa,State Auditor,Charlie Prater,REP,720164,0,0,51,51,
Tulsa,Attorney General,Mike Hunter,REP,720164,0,0,46,46,
Tulsa,Attorney General,Gentner Drummond,REP,720164,0,0,72,72,
Tulsa,Superintendent of Public Instruction,Joy Hofmeister,REP,720164,0,0,76,76,
Tulsa,Superintendent of Public Instruction,Linda Murphy,REP,720164,0,0,45,45,
Tulsa,Commissioner of Labor,Cathy Costello,REP,720164,0,0,54,54,
Tulsa,Commissioner of Labor,Leslie Osborn,REP,720164,0,0,56,56,
Tulsa,Corporation Commissioner,Bob Anthony,REP,720164,0,0,68,68,
Tulsa,Corporation Commissioner,Brian Bingman,REP,720164,0,0,47,47,
Tulsa,U.S. House,Tim Harris,REP,720164,0,0,64,64,01
Tulsa,U.S. House,Kevin Hern,REP,720164,0,0,61,61,01
Tulsa,Governor,Chris Powell,LIB,720164,0,0,0,0,
Tulsa,Governor,Rex Lawhorn,LIB,720164,0,0,0,0,
Tulsa,Corporation Commissioner,Ashley Nicole Mccray,DEM,720164,0,0,32,32,
Tulsa,Corporation Commissioner,Blake Cummings,DEM,720164,0,0,16,16,
Tulsa,U.S. House,Tim Gilpin,DEM,720164,0,0,33,33,01
Tulsa,U.S. House,Amanda Douglas,DEM,720164,0,0,14,14,01
Tulsa,Governor,Mick Cornett,REP,720165,0,0,61,61,
Tulsa,Governor,Kevin Stitt,REP,720165,0,0,94,94,
Tulsa,Lieutenant Governor,Dana Murphy,REP,720165,0,0,63,63,
Tulsa,Lieutenant Governor,Matt Pinnell,REP,720165,0,0,91,91,
Tulsa,State Auditor,Cindy Byrd,REP,720165,0,0,78,78,
Tulsa,State Auditor,Charlie Prater,REP,720165,0,0,69,69,
Tulsa,Attorney General,Mike Hunter,REP,720165,0,0,70,70,
Tulsa,Attorney General,Gentner Drummond,REP,720165,0,0,85,85,
Tulsa,Superintendent of Public Instruction,Joy Hofmeister,REP,720165,0,0,90,90,
Tulsa,Superintendent of Public Instruction,Linda Murphy,REP,720165,0,0,65,65,
Tulsa,Commissioner of Labor,Cathy Costello,REP,720165,0,0,73,73,
Tulsa,Commissioner of Labor,Leslie Osborn,REP,720165,0,0,81,81,
Tulsa,Corporation Commissioner,Bob Anthony,REP,720165,0,0,85,85,
Tulsa,Corporation Commissioner,Brian Bingman,REP,720165,0,0,68,68,
Tulsa,U.S. House,Tim Harris,REP,720165,0,0,88,88,01
Tulsa,U.S. House,Kevin Hern,REP,720165,0,0,66,66,01
Tulsa,Governor,Chris Powell,LIB,720165,0,0,0,0,
Tulsa,Governor,Rex Lawhorn,LIB,720165,0,0,0,0,
Tulsa,Corporation Commissioner,Ashley Nicole Mccray,DEM,720165,0,0,14,14,
Tulsa,Corporation Commissioner,Blake Cummings,DEM,720165,0,0,9,9,
Tulsa,U.S. House,Tim Gilpin,DEM,720165,0,0,15,15,01
Tulsa,U.S. House,Amanda Douglas,DEM,720165,0,0,8,8,01
Tulsa,Governor,Mick Cornett,REP,720166,0,0,156,156,
Tulsa,Governor,Kevin Stitt,REP,720166,0,0,269,269,
Tulsa,Lieutenant Governor,Dana Murphy,REP,720166,0,0,156,156,
Tulsa,Lieutenant Governor,Matt Pinnell,REP,720166,0,0,257,257,
Tulsa,State Auditor,Cindy Byrd,REP,720166,0,0,237,237,
Tulsa,State Auditor,Charlie Prater,REP,720166,0,0,162,162,
Tulsa,Attorney General,Mike Hunter,REP,720166,0,0,203,203,
Tulsa,Attorney General,Gentner Drummond,REP,720166,0,0,216,216,
Tulsa,Superintendent of Public Instruction,Joy Hofmeister,REP,720166,0,0,249,249,
Tulsa,Superintendent of Public Instruction,Linda Murphy,REP,720166,0,0,163,163,
Tulsa,Commissioner of Labor,Cathy Costello,REP,720166,0,0,184,184,
Tulsa,Commissioner of Labor,Leslie Osborn,REP,720166,0,0,220,220,
Tulsa,Corporation Commissioner,Bob Anthony,REP,720166,0,0,237,237,
Tulsa,Corporation Commissioner,Brian Bingman,REP,720166,0,0,163,163,
Tulsa,U.S. House,Tim Harris,REP,720166,0,0,224,224,01
Tulsa,U.S. House,Kevin Hern,REP,720166,0,0,200,200,01
Tulsa,Governor,Chris Powell,LIB,720166,0,0,0,0,
Tulsa,Governor,Rex Lawhorn,LIB,720166,0,0,2,2,
Tulsa,Corporation Commissioner,Ashley Nicole Mccray,DEM,720166,0,0,78,78,
Tulsa,Corporation Commissioner,Blake Cummings,DEM,720166,0,0,18,18,
Tulsa,U.S. House,Tim Gilpin,DEM,720166,0,0,54,54,01
Tulsa,U.S. House,Amanda Douglas,DEM,720166,0,0,44,44,01
Tulsa,Governor,Mick Cornett,REP,720167,0,0,193,193,
Tulsa,Governor,Kevin Stitt,REP,720167,0,0,299,299,
Tulsa,Lieutenant Governor,Dana Murphy,REP,720167,0,0,175,175,
Tulsa,Lieutenant Governor,Matt Pinnell,REP,720167,0,0,296,296,
Tulsa,State Auditor,Cindy Byrd,REP,720167,0,0,263,263,
Tulsa,State Auditor,Charlie Prater,REP,720167,0,0,179,179,
Tulsa,Attorney General,Mike Hunter,REP,720167,0,0,231,231,
Tulsa,Attorney General,Gentner Drummond,REP,720167,0,0,241,241,
Tulsa,Superintendent of Public Instruction,Joy Hofmeister,REP,720167,0,0,358,358,
Tulsa,Superintendent of Public Instruction,Linda Murphy,REP,720167,0,0,116,116,
Tulsa,Commissioner of Labor,Cathy Costello,REP,720167,0,0,216,216,
Tulsa,Commissioner of Labor,Leslie Osborn,REP,720167,0,0,239,239,
Tulsa,Corporation Commissioner,Bob Anthony,REP,720167,0,0,268,268,
Tulsa,Corporation Commissioner,Brian Bingman,REP,720167,0,0,184,184,
Tulsa,U.S. House,Tim Harris,REP,720167,0,0,246,246,01
Tulsa,U.S. House,Kevin Hern,REP,720167,0,0,236,236,01
Tulsa,Governor,Chris Powell,LIB,720167,0,0,0,0,
Tulsa,Governor,Rex Lawhorn,LIB,720167,0,0,0,0,
Tulsa,Corporation Commissioner,Ashley Nicole Mccray,DEM,720167,0,0,43,43,
Tulsa,Corporation Commissioner,Blake Cummings,DEM,720167,0,0,11,11,
Tulsa,U.S. House,Tim Gilpin,DEM,720167,0,0,40,40,01
Tulsa,U.S. House,Amanda Douglas,DEM,720167,0,0,14,14,01
Tulsa,Governor,Mick Cornett,REP,720168,0,0,141,141,
Tulsa,Governor,Kevin Stitt,REP,720168,0,0,182,182,
Tulsa,Lieutenant Governor,Dana Murphy,REP,720168,0,0,130,130,
Tulsa,Lieutenant Governor,Matt Pinnell,REP,720168,0,0,184,184,
Tulsa,State Auditor,Cindy Byrd,REP,720168,0,0,189,189,
Tulsa,State Auditor,Charlie Prater,REP,720168,0,0,111,111,
Tulsa,Attorney General,Mike Hunter,REP,720168,0,0,175,175,
Tulsa,Attorney General,Gentner Drummond,REP,720168,0,0,146,146,
Tulsa,Superintendent of Public Instruction,Joy Hofmeister,REP,720168,0,0,190,190,
Tulsa,Superintendent of Public Instruction,Linda Murphy,REP,720168,0,0,127,127,
Tulsa,Commissioner of Labor,Cathy Costello,REP,720168,0,0,159,159,
Tulsa,Commissioner of Labor,Leslie Osborn,REP,720168,0,0,142,142,
Tulsa,Corporation Commissioner,Bob Anthony,REP,720168,0,0,179,179,
Tulsa,Corporation Commissioner,Brian Bingman,REP,720168,0,0,131,131,
Tulsa,U.S. House,Tim Harris,REP,720168,0,0,165,165,01
Tulsa,U.S. House,Kevin Hern,REP,720168,0,0,158,158,01
Tulsa,State House,Karen Gilbert,REP,720168,0,0,122,122,79
Tulsa,State House,Dan Hicks,REP,720168,0,0,193,193,79
Tulsa,Governor,Chris Powell,LIB,720168,0,0,2,2,
Tulsa,Governor,Rex Lawhorn,LIB,720168,0,0,0,0,
Tulsa,Corporation Commissioner,Ashley Nicole Mccray,DEM,720168,0,0,85,85,
Tulsa,Corporation Commissioner,Blake Cummings,DEM,720168,0,0,20,20,
Tulsa,U.S. House,Tim Gilpin,DEM,720168,0,0,76,76,01
Tulsa,U.S. House,Amanda Douglas,DEM,720168,0,0,32,32,01
Tulsa,Governor,Mick Cornett,REP,720169,0,0,90,90,
Tulsa,Governor,Kevin Stitt,REP,720169,0,0,110,110,
Tulsa,Lieutenant Governor,Dana Murphy,REP,720169,0,0,60,60,
Tulsa,Lieutenant Governor,Matt Pinnell,REP,720169,0,0,127,127,
Tulsa,State Auditor,Cindy Byrd,REP,720169,0,0,105,105,
Tulsa,State Auditor,Charlie Prater,REP,720169,0,0,79,79,
Tulsa,Attorney General,Mike Hunter,REP,720169,0,0,88,88,
Tulsa,Attorney General,Gentner Drummond,REP,720169,0,0,104,104,
Tulsa,Superintendent of Public Instruction,Joy Hofmeister,REP,720169,0,0,103,103,
Tulsa,Superintendent of Public Instruction,Linda Murphy,REP,720169,0,0,88,88,
Tulsa,Commissioner of Labor,Cathy Costello,REP,720169,0,0,78,78,
Tulsa,Commissioner of Labor,Leslie Osborn,REP,720169,0,0,105,105,
Tulsa,Corporation Commissioner,Bob Anthony,REP,720169,0,0,109,109,
Tulsa,Corporation Commissioner,Brian Bingman,REP,720169,0,0,79,79,
Tulsa,U.S. House,Tim Harris,REP,720169,0,0,85,85,01
Tulsa,U.S. House,Kevin Hern,REP,720169,0,0,112,112,01
Tulsa,State House,Karen Gilbert,REP,720169,0,0,89,89,79
Tulsa,State House,Dan Hicks,REP,720169,0,0,99,99,79
Tulsa,Governor,Chris Powell,LIB,720169,0,0,0,0,
Tulsa,Governor,Rex Lawhorn,LIB,720169,0,0,0,0,
Tulsa,Corporation Commissioner,Ashley Nicole Mccray,DEM,720169,0,0,50,50,
Tulsa,Corporation Commissioner,Blake Cummings,DEM,720169,0,0,17,17,
Tulsa,U.S. House,Tim Gilpin,DEM,720169,0,0,35,35,01
Tulsa,U.S. House,Amanda Douglas,DEM,720169,0,0,33,33,01
Tulsa,Governor,Mick Cornett,REP,720170,0,0,102,102,
Tulsa,Governor,Kevin Stitt,REP,720170,0,0,197,197,
Tulsa,Lieutenant Governor,Dana Murphy,REP,720170,0,0,105,105,
Tulsa,Lieutenant Governor,Matt Pinnell,REP,720170,0,0,183,183,
Tulsa,State Auditor,Cindy Byrd,REP,720170,0,0,141,141,
Tulsa,State Auditor,Charlie Prater,REP,720170,0,0,127,127,
Tulsa,Attorney General,Mike Hunter,REP,720170,0,0,141,141,
Tulsa,Attorney General,Gentner Drummond,REP,720170,0,0,142,142,
Tulsa,Superintendent of Public Instruction,Joy Hofmeister,REP,720170,0,0,174,174,
Tulsa,Superintendent of Public Instruction,Linda Murphy,REP,720170,0,0,109,109,
Tulsa,Commissioner of Labor,Cathy Costello,REP,720170,0,0,154,154,
Tulsa,Commissioner of Labor,Leslie Osborn,REP,720170,0,0,122,122,
Tulsa,Corporation Commissioner,Bob Anthony,REP,720170,0,0,163,163,
Tulsa,Corporation Commissioner,Brian Bingman,REP,720170,0,0,108,108,
Tulsa,U.S. House,Tim Harris,REP,720170,0,0,126,126,01
Tulsa,U.S. House,Kevin Hern,REP,720170,0,0,167,167,01
Tulsa,Governor,Chris Powell,LIB,720170,0,0,0,0,
Tulsa,Governor,Rex Lawhorn,LIB,720170,0,0,0,0,
Tulsa,Corporation Commissioner,Ashley Nicole Mccray,DEM,720170,0,0,15,15,
Tulsa,Corporation Commissioner,Blake Cummings,DEM,720170,0,0,14,14,
Tulsa,U.S. House,Tim Gilpin,DEM,720170,0,0,23,23,01
Tulsa,U.S. House,Amanda Douglas,DEM,720170,0,0,7,7,01
Tulsa,Governor,Mick Cornett,REP,720171,0,0,70,70,
Tulsa,Governor,Kevin Stitt,REP,720171,0,0,116,116,
Tulsa,Lieutenant Governor,Dana Murphy,REP,720171,0,0,72,72,
Tulsa,Lieutenant Governor,Matt Pinnell,REP,720171,0,0,104,104,
Tulsa,State Auditor,Cindy Byrd,REP,720171,0,0,110,110,
Tulsa,State Auditor,Charlie Prater,REP,720171,0,0,60,60,
Tulsa,Attorney General,Mike Hunter,REP,720171,0,0,89,89,
Tulsa,Attorney General,Gentner Drummond,REP,720171,0,0,90,90,
Tulsa,Superintendent of Public Instruction,Joy Hofmeister,REP,720171,0,0,125,125,
Tulsa,Superintendent of Public Instruction,Linda Murphy,REP,720171,0,0,56,56,
Tulsa,Commissioner of Labor,Cathy Costello,REP,720171,0,0,84,84,
Tulsa,Commissioner of Labor,Leslie Osborn,REP,720171,0,0,87,87,
Tulsa,Corporation Commissioner,Bob Anthony,REP,720171,0,0,100,100,
Tulsa,Corporation Commissioner,Brian Bingman,REP,720171,0,0,76,76,
Tulsa,U.S. House,Tim Harris,REP,720171,0,0,88,88,01
Tulsa,U.S. House,Kevin Hern,REP,720171,0,0,93,93,01
Tulsa,Governor,Chris Powell,LIB,720171,0,0,0,0,
Tulsa,Governor,Rex Lawhorn,LIB,720171,0,0,0,0,
Tulsa,Corporation Commissioner,Ashley Nicole Mccray,DEM,720171,0,0,35,35,
Tulsa,Corporation Commissioner,Blake Cummings,DEM,720171,0,0,8,8,
Tulsa,U.S. House,Tim Gilpin,DEM,720171,0,0,27,27,01
Tulsa,U.S. House,Amanda Douglas,DEM,720171,0,0,19,19,01
Tulsa,Governor,Mick Cornett,REP,720172,0,0,102,102,
Tulsa,Governor,Kevin Stitt,REP,720172,0,0,150,150,
Tulsa,Lieutenant Governor,Dana Murphy,REP,720172,0,0,103,103,
Tulsa,Lieutenant Governor,Matt Pinnell,REP,720172,0,0,140,140,
Tulsa,State Auditor,Cindy Byrd,REP,720172,0,0,134,134,
Tulsa,State Auditor,Charlie Prater,REP,720172,0,0,99,99,
Tulsa,Attorney General,Mike Hunter,REP,720172,0,0,124,124,
Tulsa,Attorney General,Gentner Drummond,REP,720172,0,0,123,123,
Tulsa,Superintendent of Public Instruction,Joy Hofmeister,REP,720172,0,0,145,145,
Tulsa,Superintendent of Public Instruction,Linda Murphy,REP,720172,0,0,97,97,
Tulsa,Commissioner of Labor,Cathy Costello,REP,720172,0,0,112,112,
Tulsa,Commissioner of Labor,Leslie Osborn,REP,720172,0,0,123,123,
Tulsa,Corporation Commissioner,Bob Anthony,REP,720172,0,0,133,133,
Tulsa,Corporation Commissioner,Brian Bingman,REP,720172,0,0,105,105,
Tulsa,U.S. House,Tim Harris,REP,720172,0,0,127,127,01
Tulsa,U.S. House,Kevin Hern,REP,720172,0,0,117,117,01
Tulsa,State House,Karen Gilbert,REP,720172,0,0,121,121,79
Tulsa,State House,Dan Hicks,REP,720172,0,0,117,117,79
Tulsa,Governor,Chris Powell,LIB,720172,0,0,0,0,
Tulsa,Governor,Rex Lawhorn,LIB,720172,0,0,0,0,
Tulsa,Corporation Commissioner,Ashley Nicole Mccray,DEM,720172,0,0,49,49,
Tulsa,Corporation Commissioner,Blake Cummings,DEM,720172,0,0,18,18,
Tulsa,U.S. House,Tim Gilpin,DEM,720172,0,0,38,38,01
Tulsa,U.S. House,Amanda Douglas,DEM,720172,0,0,29,29,01
Tulsa,Governor,Mick Cornett,REP,720173,0,0,152,152,
Tulsa,Governor,Kevin Stitt,REP,720173,0,0,212,212,
Tulsa,Lieutenant Governor,Dana Murphy,REP,720173,0,0,137,137,
Tulsa,Lieutenant Governor,Matt Pinnell,REP,720173,0,0,219,219,
Tulsa,State Auditor,Cindy Byrd,REP,720173,0,0,201,201,
Tulsa,State Auditor,Charlie Prater,REP,720173,0,0,138,138,
Tulsa,Attorney General,Mike Hunter,REP,720173,0,0,193,193,
Tulsa,Attorney General,Gentner Drummond,REP,720173,0,0,166,166,
Tulsa,Superintendent of Public Instruction,Joy Hofmeister,REP,720173,0,0,238,238,
Tulsa,Superintendent of Public Instruction,Linda Murphy,REP,720173,0,0,119,119,
Tulsa,Commissioner of Labor,Cathy Costello,REP,720173,0,0,186,186,
Tulsa,Commissioner of Labor,Leslie Osborn,REP,720173,0,0,159,159,
Tulsa,Corporation Commissioner,Bob Anthony,REP,720173,0,0,184,184,
Tulsa,Corporation Commissioner,Brian Bingman,REP,720173,0,0,162,162,
Tulsa,U.S. House,Tim Harris,REP,720173,0,0,204,204,01
Tulsa,U.S. House,Kevin Hern,REP,720173,0,0,151,151,01
Tulsa,Governor,Chris Powell,LIB,720173,0,0,1,1,
Tulsa,Governor,Rex Lawhorn,LIB,720173,0,0,0,0,
Tulsa,Corporation Commissioner,Ashley Nicole Mccray,DEM,720173,0,0,72,72,
Tulsa,Corporation Commissioner,Blake Cummings,DEM,720173,0,0,24,24,
Tulsa,U.S. House,Tim Gilpin,DEM,720173,0,0,70,70,01
Tulsa,U.S. House,Amanda Douglas,DEM,720173,0,0,30,30,01
Tulsa,Governor,Mick Cornett,REP,720174,0,0,0,0,
Tulsa,Governor,Kevin Stitt,REP,720174,0,0,0,0,
Tulsa,Lieutenant Governor,Dana Murphy,REP,720174,0,0,0,0,
Tulsa,Lieutenant Governor,Matt Pinnell,REP,720174,0,0,0,0,
Tulsa,State Auditor,Cindy Byrd,REP,720174,0,0,0,0,
Tulsa,State Auditor,Charlie Prater,REP,720174,0,0,0,0,
Tulsa,Attorney General,Mike Hunter,REP,720174,0,0,0,0,
Tulsa,Attorney General,Gentner Drummond,REP,720174,0,0,0,0,
Tulsa,Superintendent of Public Instruction,Joy Hofmeister,REP,720174,0,0,0,0,
Tulsa,Superintendent of Public Instruction,Linda Murphy,REP,720174,0,0,0,0,
Tulsa,Commissioner of Labor,Cathy Costello,REP,720174,0,0,0,0,
Tulsa,Commissioner of Labor,Leslie Osborn,REP,720174,0,0,0,0,
Tulsa,Corporation Commissioner,Bob Anthony,REP,720174,0,0,0,0,
Tulsa,Corporation Commissioner,Brian Bingman,REP,720174,0,0,0,0,
Tulsa,U.S. House,Tim Harris,REP,720174,0,0,0,0,01
Tulsa,U.S. House,Kevin Hern,REP,720174,0,0,0,0,01
Tulsa,Governor,Chris Powell,LIB,720174,0,0,0,0,
Tulsa,Governor,Rex Lawhorn,LIB,720174,0,0,0,0,
Tulsa,Corporation Commissioner,Ashley Nicole Mccray,DEM,720174,0,0,0,0,
Tulsa,Corporation Commissioner,Blake Cummings,DEM,720174,0,0,0,0,
Tulsa,U.S. House,Tim Gilpin,DEM,720174,0,0,0,0,01
Tulsa,U.S. House,Amanda Douglas,DEM,720174,0,0,0,0,01
Tulsa,Governor,Mick Cornett,REP,720175,0,0,0,0,
Tulsa,Governor,Kevin Stitt,REP,720175,0,0,0,0,
Tulsa,Lieutenant Governor,Dana Murphy,REP,720175,0,0,0,0,
Tulsa,Lieutenant Governor,Matt Pinnell,REP,720175,0,0,0,0,
Tulsa,State Auditor,Cindy Byrd,REP,720175,0,0,0,0,
Tulsa,State Auditor,Charlie Prater,REP,720175,0,0,0,0,
Tulsa,Attorney General,Mike Hunter,REP,720175,0,0,0,0,
Tulsa,Attorney General,Gentner Drummond,REP,720175,0,0,0,0,
Tulsa,Superintendent of Public Instruction,Joy Hofmeister,REP,720175,0,0,0,0,
Tulsa,Superintendent of Public Instruction,Linda Murphy,REP,720175,0,0,0,0,
Tulsa,Commissioner of Labor,Cathy Costello,REP,720175,0,0,0,0,
Tulsa,Commissioner of Labor,Leslie Osborn,REP,720175,0,0,0,0,
Tulsa,Corporation Commissioner,Bob Anthony,REP,720175,0,0,0,0,
Tulsa,Corporation Commissioner,Brian Bingman,REP,720175,0,0,0,0,
Tulsa,U.S. House,Tim Harris,REP,720175,0,0,0,0,01
Tulsa,U.S. House,Kevin Hern,REP,720175,0,0,0,0,01
Tulsa,Governor,Chris Powell,LIB,720175,0,0,0,0,
Tulsa,Governor,Rex Lawhorn,LIB,720175,0,0,0,0,
Tulsa,Corporation Commissioner,Ashley Nicole Mccray,DEM,720175,0,0,0,0,
Tulsa,Corporation Commissioner,Blake Cummings,DEM,720175,0,0,0,0,
Tulsa,U.S. House,Tim Gilpin,DEM,720175,0,0,0,0,01
Tulsa,U.S. House,Amanda Douglas,DEM,720175,0,0,0,0,01
Tulsa,Governor,Mick Cornett,REP,720176,0,0,0,0,
Tulsa,Governor,Kevin Stitt,REP,720176,0,0,0,0,
Tulsa,Lieutenant Governor,Dana Murphy,REP,720176,0,0,0,0,
Tulsa,Lieutenant Governor,Matt Pinnell,REP,720176,0,0,0,0,
Tulsa,State Auditor,Cindy Byrd,REP,720176,0,0,0,0,
Tulsa,State Auditor,Charlie Prater,REP,720176,0,0,0,0,
Tulsa,Attorney General,Mike Hunter,REP,720176,0,0,0,0,
Tulsa,Attorney General,Gentner Drummond,REP,720176,0,0,0,0,
Tulsa,Superintendent of Public Instruction,Joy Hofmeister,REP,720176,0,0,0,0,
Tulsa,Superintendent of Public Instruction,Linda Murphy,REP,720176,0,0,0,0,
Tulsa,Commissioner of Labor,Cathy Costello,REP,720176,0,0,0,0,
Tulsa,Commissioner of Labor,Leslie Osborn,REP,720176,0,0,0,0,
Tulsa,Corporation Commissioner,Bob Anthony,REP,720176,0,0,0,0,
Tulsa,Corporation Commissioner,Brian Bingman,REP,720176,0,0,0,0,
Tulsa,U.S. House,Tim Harris,REP,720176,0,0,0,0,01
Tulsa,U.S. House,Kevin Hern,REP,720176,0,0,0,0,01
Tulsa,Governor,Chris Powell,LIB,720176,0,0,0,0,
Tulsa,Governor,Rex Lawhorn,LIB,720176,0,0,0,0,
Tulsa,Corporation Commissioner,Ashley Nicole Mccray,DEM,720176,0,0,0,0,
Tulsa,Corporation Commissioner,Blake Cummings,DEM,720176,0,0,0,0,
Tulsa,U.S. House,Tim Gilpin,DEM,720176,0,0,0,0,01
Tulsa,U.S. House,Amanda Douglas,DEM,720176,0,0,0,0,01
Tulsa,Governor,Mick Cornett,REP,720351,0,0,207,207,
Tulsa,Governor,Kevin Stitt,REP,720351,0,0,335,335,
Tulsa,Lieutenant Governor,Dana Murphy,REP,720351,0,0,196,196,
Tulsa,Lieutenant Governor,Matt Pinnell,REP,720351,0,0,332,332,
Tulsa,State Auditor,Cindy Byrd,REP,720351,0,0,252,252,
Tulsa,State Auditor,Charlie Prater,REP,720351,0,0,251,251,
Tulsa,Attorney General,Mike Hunter,REP,720351,0,0,250,250,
Tulsa,Attorney General,Gentner Drummond,REP,720351,0,0,277,277,
Tulsa,Superintendent of Public Instruction,Joy Hofmeister,REP,720351,0,0,312,312,
Tulsa,Superintendent of Public Instruction,Linda Murphy,REP,720351,0,0,214,214,
Tulsa,Commissioner of Labor,Cathy Costello,REP,720351,0,0,237,237,
Tulsa,Commissioner of Labor,Leslie Osborn,REP,720351,0,0,269,269,
Tulsa,Corporation Commissioner,Bob Anthony,REP,720351,0,0,252,252,
Tulsa,Corporation Commissioner,Brian Bingman,REP,720351,0,0,259,259,
Tulsa,U.S. House,Tim Harris,REP,720351,0,0,198,198,01
Tulsa,U.S. House,Kevin Hern,REP,720351,0,0,335,335,01
Tulsa,Governor,Chris Powell,LIB,720351,0,0,0,0,
Tulsa,Governor,Rex Lawhorn,LIB,720351,0,0,0,0,
Tulsa,Corporation Commissioner,Ashley Nicole Mccray,DEM,720351,0,0,75,75,
Tulsa,Corporation Commissioner,Blake Cummings,DEM,720351,0,0,16,16,
Tulsa,U.S. House,Tim Gilpin,DEM,720351,0,0,38,38,01
Tulsa,U.S. House,Amanda Douglas,DEM,720351,0,0,53,53,01
Tulsa,Governor,Mick Cornett,REP,720352,0,0,74,74,
Tulsa,Governor,Kevin Stitt,REP,720352,0,0,186,186,
Tulsa,Lieutenant Governor,Dana Murphy,REP,720352,0,0,95,95,
Tulsa,Lieutenant Governor,Matt Pinnell,REP,720352,0,0,156,156,
Tulsa,State Auditor,Cindy Byrd,REP,720352,0,0,125,125,
Tulsa,State Auditor,Charlie Prater,REP,720352,0,0,120,120,
Tulsa,Attorney General,Mike Hunter,REP,720352,0,0,122,122,
Tulsa,Attorney General,Gentner Drummond,REP,720352,0,0,135,135,
Tulsa,Superintendent of Public Instruction,Joy Hofmeister,REP,720352,0,0,145,145,
Tulsa,Superintendent of Public Instruction,Linda Murphy,REP,720352,0,0,108,108,
Tulsa,Commissioner of Labor,Cathy Costello,REP,720352,0,0,118,118,
Tulsa,Commissioner of Labor,Leslie Osborn,REP,720352,0,0,129,129,
Tulsa,Corporation Commissioner,Bob Anthony,REP,720352,0,0,111,111,
Tulsa,Corporation Commissioner,Brian Bingman,REP,720352,0,0,137,137,
Tulsa,U.S. House,Tim Harris,REP,720352,0,0,82,82,01
Tulsa,U.S. House,Kevin Hern,REP,720352,0,0,174,174,01
Tulsa,State House,Mark Lawson,REP,720352,0,0,125,125,30
Tulsa,State House,Kent Glesener,REP,720352,0,0,117,117,30
Tulsa,Governor,Chris Powell,LIB,720352,0,0,0,0,
Tulsa,Governor,Rex Lawhorn,LIB,720352,0,0,0,0,
Tulsa,Corporation Commissioner,Ashley Nicole Mccray,DEM,720352,0,0,26,26,
Tulsa,Corporation Commissioner,Blake Cummings,DEM,720352,0,0,18,18,
Tulsa,U.S. House,Tim Gilpin,DEM,720352,0,0,21,21,01
Tulsa,U.S. House,Amanda Douglas,DEM,720352,0,0,23,23,01
Tulsa,Governor,Mick Cornett,REP,720353,0,0,26,26,
Tulsa,Governor,Kevin Stitt,REP,720353,0,0,45,45,
Tulsa,Lieutenant Governor,Dana Murphy,REP,720353,0,0,26,26,
Tulsa,Lieutenant Governor,Matt Pinnell,REP,720353,0,0,45,45,
Tulsa,State Auditor,Cindy Byrd,REP,720353,0,0,29,29,
Tulsa,State Auditor,Charlie Prater,REP,720353,0,0,41,41,
Tulsa,Attorney General,Mike Hunter,REP,720353,0,0,24,24,
Tulsa,Attorney General,Gentner Drummond,REP,720353,0,0,45,45,
Tulsa,Superintendent of Public Instruction,Joy Hofmeister,REP,720353,0,0,33,33,
Tulsa,Superintendent of Public Instruction,Linda Murphy,REP,720353,0,0,38,38,
Tulsa,Commissioner of Labor,Cathy Costello,REP,720353,0,0,28,28,
Tulsa,Commissioner of Labor,Leslie Osborn,REP,720353,0,0,39,39,
Tulsa,Corporation Commissioner,Bob Anthony,REP,720353,0,0,36,36,
Tulsa,Corporation Commissioner,Brian Bingman,REP,720353,0,0,33,33,
Tulsa,U.S. House,Tim Harris,REP,720353,0,0,23,23,01
Tulsa,U.S. House,Kevin Hern,REP,720353,0,0,49,49,01
Tulsa,Governor,Chris Powell,LIB,720353,0,0,0,0,
Tulsa,Governor,Rex Lawhorn,LIB,720353,0,0,0,0,
Tulsa,Corporation Commissioner,Ashley Nicole Mccray,DEM,720353,0,0,7,7,
Tulsa,Corporation Commissioner,Blake Cummings,DEM,720353,0,0,3,3,
Tulsa,U.S. House,Tim Gilpin,DEM,720353,0,0,5,5,01
Tulsa,U.S. House,Amanda Douglas,DEM,720353,0,0,5,5,01
Tulsa,Governor,Mick Cornett,REP,720354,0,0,9,9,
Tulsa,Governor,Kevin Stitt,REP,720354,0,0,43,43,
Tulsa,Lieutenant Governor,Dana Murphy,REP,720354,0,0,15,15,
Tulsa,Lieutenant Governor,Matt Pinnell,REP,720354,0,0,38,38,
Tulsa,State Auditor,Cindy Byrd,REP,720354,0,0,24,24,
Tulsa,State Auditor,Charlie Prater,REP,720354,0,0,25,25,
Tulsa,Attorney General,Mike Hunter,REP,720354,0,0,27,27,
Tulsa,Attorney General,Gentner Drummond,REP,720354,0,0,24,24,
Tulsa,Superintendent of Public Instruction,Joy Hofmeister,REP,720354,0,0,17,17,
Tulsa,Superintendent of Public Instruction,Linda Murphy,REP,720354,0,0,33,33,
Tulsa,Commissioner of Labor,Cathy Costello,REP,720354,0,0,26,26,
Tulsa,Commissioner of Labor,Leslie Osborn,REP,720354,0,0,23,23,
Tulsa,Corporation Commissioner,Bob Anthony,REP,720354,0,0,26,26,
Tulsa,Corporation Commissioner,Brian Bingman,REP,720354,0,0,25,25,
Tulsa,U.S. House,Tim Harris,REP,720354,0,0,19,19,01
Tulsa,U.S. House,Kevin Hern,REP,720354,0,0,34,34,01
Tulsa,State House,Stan May,REP,720354,0,0,26,26,80
Tulsa,State House,Mike Ritze,REP,720354,0,0,23,23,80
Tulsa,Governor,Chris Powell,LIB,720354,0,0,0,0,
Tulsa,Governor,Rex Lawhorn,LIB,720354,0,0,0,0,
Tulsa,Corporation Commissioner,Ashley Nicole Mccray,DEM,720354,0,0,5,5,
Tulsa,Corporation Commissioner,Blake Cummings,DEM,720354,0,0,3,3,
Tulsa,U.S. House,Tim Gilpin,DEM,720354,0,0,4,4,01
Tulsa,U.S. House,Amanda Douglas,DEM,720354,0,0,4,4,01
Tulsa,Governor,Mick Cornett,REP,720355,0,0,13,13,
Tulsa,Governor,Kevin Stitt,REP,720355,0,0,44,44,
Tulsa,Lieutenant Governor,Dana Murphy,REP,720355,0,0,17,17,
Tulsa,Lieutenant Governor,Matt Pinnell,REP,720355,0,0,36,36,
Tulsa,State Auditor,Cindy Byrd,REP,720355,0,0,27,27,
Tulsa,State Auditor,Charlie Prater,REP,720355,0,0,26,26,
Tulsa,Attorney General,Mike Hunter,REP,720355,0,0,19,19,
Tulsa,Attorney General,Gentner Drummond,REP,720355,0,0,37,37,
Tulsa,Superintendent of Public Instruction,Joy Hofmeister,REP,720355,0,0,29,29,
Tulsa,Superintendent of Public Instruction,Linda Murphy,REP,720355,0,0,26,26,
Tulsa,Commissioner of Labor,Cathy Costello,REP,720355,0,0,22,22,
Tulsa,Commissioner of Labor,Leslie Osborn,REP,720355,0,0,31,31,
Tulsa,Corporation Commissioner,Bob Anthony,REP,720355,0,0,28,28,
Tulsa,Corporation Commissioner,Brian Bingman,REP,720355,0,0,26,26,
Tulsa,U.S. House,Tim Harris,REP,720355,0,0,17,17,01
Tulsa,U.S. House,Kevin Hern,REP,720355,0,0,38,38,01
Tulsa,State House,Stan May,REP,720355,0,0,36,36,80
Tulsa,State House,Mike Ritze,REP,720355,0,0,17,17,80
Tulsa,Governor,Chris Powell,LIB,720355,0,0,0,0,
Tulsa,Governor,Rex Lawhorn,LIB,720355,0,0,0,0,
Tulsa,Corporation Commissioner,Ashley Nicole Mccray,DEM,720355,0,0,8,8,
Tulsa,Corporation Commissioner,Blake Cummings,DEM,720355,0,0,4,4,
Tulsa,U.S. House,Tim Gilpin,DEM,720355,0,0,7,7,01
Tulsa,U.S. House,Amanda Douglas,DEM,720355,0,0,5,5,01
Tulsa,Governor,Mick Cornett,REP,720356,0,0,33,33,
Tulsa,Governor,Kevin Stitt,REP,720356,0,0,52,52,
Tulsa,Lieutenant Governor,Dana Murphy,REP,720356,0,0,30,30,
Tulsa,Lieutenant Governor,Matt Pinnell,REP,720356,0,0,51,51,
Tulsa,State Auditor,Cindy Byrd,REP,720356,0,0,40,40,
Tulsa,State Auditor,Charlie Prater,REP,720356,0,0,39,39,
Tulsa,Attorney General,Mike Hunter,REP,720356,0,0,30,30,
Tulsa,Attorney General,Gentner Drummond,REP,720356,0,0,54,54,
Tulsa,Superintendent of Public Instruction,Joy Hofmeister,REP,720356,0,0,48,48,
Tulsa,Superintendent of Public Instruction,Linda Murphy,REP,720356,0,0,35,35,
Tulsa,Commissioner of Labor,Cathy Costello,REP,720356,0,0,29,29,
Tulsa,Commissioner of Labor,Leslie Osborn,REP,720356,0,0,51,51,
Tulsa,Corporation Commissioner,Bob Anthony,REP,720356,0,0,34,34,
Tulsa,Corporation Commissioner,Brian Bingman,REP,720356,0,0,44,44,
Tulsa,U.S. House,Tim Harris,REP,720356,0,0,33,33,01
Tulsa,U.S. House,Kevin Hern,REP,720356,0,0,50,50,01
Tulsa,State House,Mark Lawson,REP,720356,0,0,44,44,30
Tulsa,State House,Kent Glesener,REP,720356,0,0,33,33,30
Tulsa,Governor,Chris Powell,LIB,720356,0,0,0,0,
Tulsa,Governor,Rex Lawhorn,LIB,720356,0,0,0,0,
Tulsa,Corporation Commissioner,Ashley Nicole Mccray,DEM,720356,0,0,5,5,
Tulsa,Corporation Commissioner,Blake Cummings,DEM,720356,0,0,2,2,
Tulsa,U.S. House,Tim Gilpin,DEM,720356,0,0,2,2,01
Tulsa,U.S. House,Amanda Douglas,DEM,720356,0,0,5,5,01
Tulsa,Governor,Mick Cornett,REP,720400,0,0,174,174,
Tulsa,Governor,Kevin Stitt,REP,720400,0,0,360,360,
Tulsa,Lieutenant Governor,Dana Murphy,REP,720400,0,0,183,183,
Tulsa,Lieutenant Governor,Matt Pinnell,REP,720400,0,0,327,327,
Tulsa,State Auditor,Cindy Byrd,REP,720400,0,0,279,279,
Tulsa,State Auditor,Charlie Prater,REP,720400,0,0,202,202,
Tulsa,Attorney General,Mike Hunter,REP,720400,0,0,240,240,
Tulsa,Attorney General,Gentner Drummond,REP,720400,0,0,280,280,
Tulsa,Superintendent of Public Instruction,Joy Hofmeister,REP,720400,0,0,349,349,
Tulsa,Superintendent of Public Instruction,Linda Murphy,REP,720400,0,0,162,162,
Tulsa,Commissioner of Labor,Cathy Costello,REP,720400,0,0,261,261,
Tulsa,Commissioner of Labor,Leslie Osborn,REP,720400,0,0,232,232,
Tulsa,Corporation Commissioner,Bob Anthony,REP,720400,0,0,273,273,
Tulsa,Corporation Commissioner,Brian Bingman,REP,720400,0,0,220,220,
Tulsa,U.S. House,Tim Harris,REP,720400,0,0,219,219,01
Tulsa,U.S. House,Kevin Hern,REP,720400,0,0,309,309,01
Tulsa,Governor,Chris Powell,LIB,720400,0,0,0,0,
Tulsa,Governor,Rex Lawhorn,LIB,720400,0,0,1,1,
Tulsa,Corporation Commissioner,Ashley Nicole Mccray,DEM,720400,0,0,43,43,
Tulsa,Corporation Commissioner,Blake Cummings,DEM,720400,0,0,11,11,
Tulsa,U.S. House,Tim Gilpin,DEM,720400,0,0,29,29,01
Tulsa,U.S. House,Amanda Douglas,DEM,720400,0,0,25,25,01
Tulsa,Governor,Mick Cornett,REP,720401,0,0,186,186,
Tulsa,Governor,Kevin Stitt,REP,720401,0,0,381,381,
Tulsa,Lieutenant Governor,Dana Murphy,REP,720401,0,0,186,186,
Tulsa,Lieutenant Governor,Matt Pinnell,REP,720401,0,0,358,358,
Tulsa,State Auditor,Cindy Byrd,REP,720401,0,0,324,324,
Tulsa,State Auditor,Charlie Prater,REP,720401,0,0,186,186,
Tulsa,Attorney General,Mike Hunter,REP,720401,0,0,265,265,
Tulsa,Attorney General,Gentner Drummond,REP,720401,0,0,284,284,
Tulsa,Superintendent of Public Instruction,Joy Hofmeister,REP,720401,0,0,332,332,
Tulsa,Superintendent of Public Instruction,Linda Murphy,REP,720401,0,0,207,207,
Tulsa,Commissioner of Labor,Cathy Costello,REP,720401,0,0,292,292,
Tulsa,Commissioner of Labor,Leslie Osborn,REP,720401,0,0,221,221,
Tulsa,Corporation Commissioner,Bob Anthony,REP,720401,0,0,293,293,
Tulsa,Corporation Commissioner,Brian Bingman,REP,720401,0,0,221,221,
Tulsa,U.S. House,Tim Harris,REP,720401,0,0,257,257,01
Tulsa,U.S. House,Kevin Hern,REP,720401,0,0,291,291,01
Tulsa,Governor,Chris Powell,LIB,720401,0,0,0,0,
Tulsa,Governor,Rex Lawhorn,LIB,720401,0,0,0,0,
Tulsa,Corporation Commissioner,Ashley Nicole Mccray,DEM,720401,0,0,41,41,
Tulsa,Corporation Commissioner,Blake Cummings,DEM,720401,0,0,24,24,
Tulsa,U.S. House,Tim Gilpin,DEM,720401,0,0,49,49,01
Tulsa,U.S. House,Amanda Douglas,DEM,720401,0,0,18,18,01
Tulsa,Governor,Mick Cornett,REP,720402,0,0,96,96,
Tulsa,Governor,Kevin Stitt,REP,720402,0,0,176,176,
Tulsa,Lieutenant Governor,Dana Murphy,REP,720402,0,0,105,105,
Tulsa,Lieutenant Governor,Matt Pinnell,REP,720402,0,0,158,158,
Tulsa,State Auditor,Cindy Byrd,REP,720402,0,0,154,154,
Tulsa,State Auditor,Charlie Prater,REP,720402,0,0,99,99,
Tulsa,Attorney General,Mike Hunter,REP,720402,0,0,119,119,
Tulsa,Attorney General,Gentner Drummond,REP,720402,0,0,141,141,
Tulsa,Superintendent of Public Instruction,Joy Hofmeister,REP,720402,0,0,158,158,
Tulsa,Superintendent of Public Instruction,Linda Murphy,REP,720402,0,0,108,108,
Tulsa,Commissioner of Labor,Cathy Costello,REP,720402,0,0,132,132,
Tulsa,Commissioner of Labor,Leslie Osborn,REP,720402,0,0,122,122,
Tulsa,Corporation Commissioner,Bob Anthony,REP,720402,0,0,139,139,
Tulsa,Corporation Commissioner,Brian Bingman,REP,720402,0,0,109,109,
Tulsa,U.S. House,Tim Harris,REP,720402,0,0,107,107,01
Tulsa,U.S. House,Kevin Hern,REP,720402,0,0,153,153,01
Tulsa,Governor,Chris Powell,LIB,720402,0,0,0,0,
Tulsa,Governor,Rex Lawhorn,LIB,720402,0,0,1,1,
Tulsa,Corporation Commissioner,Ashley Nicole Mccray,DEM,720402,0,0,30,30,
Tulsa,Corporation Commissioner,Blake Cummings,DEM,720402,0,0,14,14,
Tulsa,U.S. House,Tim Gilpin,DEM,720402,0,0,23,23,01
Tulsa,U.S. House,Amanda Douglas,DEM,720402,0,0,22,22,01
Tulsa,Governor,Mick Cornett,REP,720403,0,0,174,174,
Tulsa,Governor,Kevin Stitt,REP,720403,0,0,393,393,
Tulsa,Lieutenant Governor,Dana Murphy,REP,720403,0,0,220,220,
Tulsa,Lieutenant Governor,Matt Pinnell,REP,720403,0,0,325,325,
Tulsa,State Auditor,Cindy Byrd,REP,720403,0,0,270,270,
Tulsa,State Auditor,Charlie Prater,REP,720403,0,0,264,264,
Tulsa,Attorney General,Mike Hunter,REP,720403,0,0,268,268,
Tulsa,Attorney General,Gentner Drummond,REP,720403,0,0,288,288,
Tulsa,Superintendent of Public Instruction,Joy Hofmeister,REP,720403,0,0,321,321,
Tulsa,Superintendent of Public Instruction,Linda Murphy,REP,720403,0,0,232,232,
Tulsa,Commissioner of Labor,Cathy Costello,REP,720403,0,0,293,293,
Tulsa,Commissioner of Labor,Leslie Osborn,REP,720403,0,0,241,241,
Tulsa,Corporation Commissioner,Bob Anthony,REP,720403,0,0,294,294,
Tulsa,Corporation Commissioner,Brian Bingman,REP,720403,0,0,226,226,
Tulsa,U.S. House,Tim Harris,REP,720403,0,0,241,241,01
Tulsa,U.S. House,Kevin Hern,REP,720403,0,0,319,319,01
Tulsa,State House,Stan May,REP,720403,0,0,307,307,80
Tulsa,State House,Mike Ritze,REP,720403,0,0,240,240,80
Tulsa,Governor,Chris Powell,LIB,720403,0,0,3,3,
Tulsa,Governor,Rex Lawhorn,LIB,720403,0,0,2,2,
Tulsa,Corporation Commissioner,Ashley Nicole Mccray,DEM,720403,0,0,110,110,
Tulsa,Corporation Commissioner,Blake Cummings,DEM,720403,0,0,24,24,
Tulsa,U.S. House,Tim Gilpin,DEM,720403,0,0,60,60,01
Tulsa,U.S. House,Amanda Douglas,DEM,720403,0,0,75,75,01
Tulsa,Governor,Mick Cornett,REP,720404,0,0,152,152,
Tulsa,Governor,Kevin Stitt,REP,720404,0,0,260,260,
Tulsa,Lieutenant Governor,Dana Murphy,REP,720404,0,0,172,172,
Tulsa,Lieutenant Governor,Matt Pinnell,REP,720404,0,0,230,230,
Tulsa,State Auditor,Cindy Byrd,REP,720404,0,0,212,212,
Tulsa,State Auditor,Charlie Prater,REP,720404,0,0,169,169,
Tulsa,Attorney General,Mike Hunter,REP,720404,0,0,171,171,
Tulsa,Attorney General,Gentner Drummond,REP,720404,0,0,228,228,
Tulsa,Superintendent of Public Instruction,Joy Hofmeister,REP,720404,0,0,251,251,
Tulsa,Superintendent of Public Instruction,Linda Murphy,REP,720404,0,0,147,147,
Tulsa,Commissioner of Labor,Cathy Costello,REP,720404,0,0,206,206,
Tulsa,Commissioner of Labor,Leslie Osborn,REP,720404,0,0,188,188,
Tulsa,Corporation Commissioner,Bob Anthony,REP,720404,0,0,220,220,
Tulsa,Corporation Commissioner,Brian Bingman,REP,720404,0,0,172,172,
Tulsa,U.S. House,Tim Harris,REP,720404,0,0,172,172,01
Tulsa,U.S. House,Kevin Hern,REP,720404,0,0,232,232,01
Tulsa,State House,Stan May,REP,720404,0,0,224,224,80
Tulsa,State House,Mike Ritze,REP,720404,0,0,165,165,80
Tulsa,Governor,Chris Powell,LIB,720404,0,0,0,0,
Tulsa,Governor,Rex Lawhorn,LIB,720404,0,0,0,0,
Tulsa,Corporation Commissioner,Ashley Nicole Mccray,DEM,720404,0,0,59,59,
Tulsa,Corporation Commissioner,Blake Cummings,DEM,720404,0,0,23,23,
Tulsa,U.S. House,Tim Gilpin,DEM,720404,0,0,33,33,01
Tulsa,U.S. House,Amanda Douglas,DEM,720404,0,0,49,49,01
Tulsa,Governor,Mick Cornett,REP,720405,0,0,27,27,
Tulsa,Governor,Kevin Stitt,REP,720405,0,0,40,40,
Tulsa,Lieutenant Governor,Dana Murphy,REP,720405,0,0,29,29,
Tulsa,Lieutenant Governor,Matt Pinnell,REP,720405,0,0,38,38,
Tulsa,State Auditor,Cindy Byrd,REP,720405,0,0,34,34,
Tulsa,State Auditor,Charlie Prater,REP,720405,0,0,30,30,
Tulsa,Attorney General,Mike Hunter,REP,720405,0,0,37,37,
Tulsa,Attorney General,Gentner Drummond,REP,720405,0,0,31,31,
Tulsa,Superintendent of Public Instruction,Joy Hofmeister,REP,720405,0,0,42,42,
Tulsa,Superintendent of Public Instruction,Linda Murphy,REP,720405,0,0,25,25,
Tulsa,Commissioner of Labor,Cathy Costello,REP,720405,0,0,28,28,
Tulsa,Commissioner of Labor,Leslie Osborn,REP,720405,0,0,37,37,
Tulsa,Corporation Commissioner,Bob Anthony,REP,720405,0,0,38,38,
Tulsa,Corporation Commissioner,Brian Bingman,REP,720405,0,0,27,27,
Tulsa,U.S. House,Tim Harris,REP,720405,0,0,36,36,01
Tulsa,U.S. House,Kevin Hern,REP,720405,0,0,32,32,01
Tulsa,State House,Stan May,REP,720405,0,0,39,39,80
Tulsa,State House,Mike Ritze,REP,720405,0,0,29,29,80
Tulsa,Governor,Chris Powell,LIB,720405,0,0,0,0,
Tulsa,Governor,Rex Lawhorn,LIB,720405,0,0,0,0,
Tulsa,Corporation Commissioner,Ashley Nicole Mccray,DEM,720405,0,0,15,15,
Tulsa,Corporation Commissioner,Blake Cummings,DEM,720405,0,0,3,3,
Tulsa,U.S. House,Tim Gilpin,DEM,720405,0,0,6,6,01
Tulsa,U.S. House,Amanda Douglas,DEM,720405,0,0,12,12,01
Tulsa,Governor,Mick Cornett,REP,720406,0,0,182,182,
Tulsa,Governor,Kevin Stitt,REP,720406,0,0,249,249,
Tulsa,Lieutenant Governor,Dana Murphy,REP,720406,0,0,156,156,
Tulsa,Lieutenant Governor,Matt Pinnell,REP,720406,0,0,257,257,
Tulsa,State Auditor,Cindy Byrd,REP,720406,0,0,211,211,
Tulsa,State Auditor,Charlie Prater,REP,720406,0,0,182,182,
Tulsa,Attorney General,Mike Hunter,REP,720406,0,0,184,184,
Tulsa,Attorney General,Gentner Drummond,REP,720406,0,0,221,221,
Tulsa,Superintendent of Public Instruction,Joy Hofmeister,REP,720406,0,0,280,280,
Tulsa,Superintendent of Public Instruction,Linda Murphy,REP,720406,0,0,135,135,
Tulsa,Commissioner of Labor,Cathy Costello,REP,720406,0,0,198,198,
Tulsa,Commissioner of Labor,Leslie Osborn,REP,720406,0,0,203,203,
Tulsa,Corporation Commissioner,Bob Anthony,REP,720406,0,0,230,230,
Tulsa,Corporation Commissioner,Brian Bingman,REP,720406,0,0,163,163,
Tulsa,U.S. House,Tim Harris,REP,720406,0,0,189,189,01
Tulsa,U.S. House,Kevin Hern,REP,720406,0,0,232,232,01
Tulsa,State House,Stan May,REP,720406,0,0,269,269,80
Tulsa,State House,Mike Ritze,REP,720406,0,0,143,143,80
Tulsa,Governor,Chris Powell,LIB,720406,0,0,0,0,
Tulsa,Governor,Rex Lawhorn,LIB,720406,0,0,0,0,
Tulsa,Corporation Commissioner,Ashley Nicole Mccray,DEM,720406,0,0,42,42,
Tulsa,Corporation Commissioner,Blake Cummings,DEM,720406,0,0,13,13,
Tulsa,U.S. House,Tim Gilpin,DEM,720406,0,0,37,37,01
Tulsa,U.S. House,Amanda Douglas,DEM,720406,0,0,20,20,01
Tulsa,Governor,Mick Cornett,REP,720407,0,0,168,168,
Tulsa,Governor,Kevin Stitt,REP,720407,0,0,280,280,
Tulsa,Lieutenant Governor,Dana Murphy,REP,720407,0,0,179,179,
Tulsa,Lieutenant Governor,Matt Pinnell,REP,720407,0,0,260,260,
Tulsa,State Auditor,Cindy Byrd,REP,720407,0,0,208,208,
Tulsa,State Auditor,Charlie Prater,REP,720407,0,0,216,216,
Tulsa,Attorney General,Mike Hunter,REP,720407,0,0,187,187,
Tulsa,Attorney General,Gentner Drummond,REP,720407,0,0,248,248,
Tulsa,Superintendent of Public Instruction,Joy Hofmeister,REP,720407,0,0,270,270,
Tulsa,Superintendent of Public Instruction,Linda Murphy,REP,720407,0,0,170,170,
Tulsa,Commissioner of Labor,Cathy Costello,REP,720407,0,0,208,208,
Tulsa,Commissioner of Labor,Leslie Osborn,REP,720407,0,0,216,216,
Tulsa,Corporation Commissioner,Bob Anthony,REP,720407,0,0,221,221,
Tulsa,Corporation Commissioner,Brian Bingman,REP,720407,0,0,199,199,
Tulsa,U.S. House,Tim Harris,REP,720407,0,0,191,191,01
Tulsa,U.S. House,Kevin Hern,REP,720407,0,0,253,253,01
Tulsa,State House,Stan May,REP,720407,0,0,252,252,80
Tulsa,State House,Mike Ritze,REP,720407,0,0,175,175,80
Tulsa,Governor,Chris Powell,LIB,720407,0,0,0,0,
Tulsa,Governor,Rex Lawhorn,LIB,720407,0,0,1,1,
Tulsa,Corporation Commissioner,Ashley Nicole Mccray,DEM,720407,0,0,49,49,
Tulsa,Corporation Commissioner,Blake Cummings,DEM,720407,0,0,9,9,
Tulsa,U.S. House,Tim Gilpin,DEM,720407,0,0,35,35,01
Tulsa,U.S. House,Amanda Douglas,DEM,720407,0,0,23,23,01
Tulsa,Governor,Mick Cornett,REP,720408,0,0,162,162,
Tulsa,Governor,Kevin Stitt,REP,720408,0,0,305,305,
Tulsa,Lieutenant Governor,Dana Murphy,REP,720408,0,0,169,169,
Tulsa,Lieutenant Governor,Matt Pinnell,REP,720408,0,0,286,286,
Tulsa,State Auditor,Cindy Byrd,REP,720408,0,0,230,230,
Tulsa,State Auditor,Charlie Prater,REP,720408,0,0,205,205,
Tulsa,Attorney General,Mike Hunter,REP,720408,0,0,180,180,
Tulsa,Attorney General,Gentner Drummond,REP,720408,0,0,281,281,
Tulsa,Superintendent of Public Instruction,Joy Hofmeister,REP,720408,0,0,273,273,
Tulsa,Superintendent of Public Instruction,Linda Murphy,REP,720408,0,0,175,175,
Tulsa,Commissioner of Labor,Cathy Costello,REP,720408,0,0,234,234,
Tulsa,Commissioner of Labor,Leslie Osborn,REP,720408,0,0,211,211,
Tulsa,Corporation Commissioner,Bob Anthony,REP,720408,0,0,243,243,
Tulsa,Corporation Commissioner,Brian Bingman,REP,720408,0,0,193,193,
Tulsa,U.S. House,Tim Harris,REP,720408,0,0,195,195,01
Tulsa,U.S. House,Kevin Hern,REP,720408,0,0,265,265,01
Tulsa,State House,Stan May,REP,720408,0,0,275,275,80
Tulsa,State House,Mike Ritze,REP,720408,0,0,180,180,80
Tulsa,Governor,Chris Powell,LIB,720408,0,0,1,1,
Tulsa,Governor,Rex Lawhorn,LIB,720408,0,0,0,0,
Tulsa,Corporation Commissioner,Ashley Nicole Mccray,DEM,720408,0,0,64,64,
Tulsa,Corporation Commissioner,Blake Cummings,DEM,720408,0,0,27,27,
Tulsa,U.S. House,Tim Gilpin,DEM,720408,0,0,48,48,01
Tulsa,U.S. House,Amanda Douglas,DEM,720408,0,0,47,47,01
Tulsa,Governor,Mick Cornett,REP,720409,0,0,149,149,
Tulsa,Governor,Kevin Stitt,REP,720409,0,0,239,239,
Tulsa,Lieutenant Governor,Dana Murphy,REP,720409,0,0,138,138,
Tulsa,Lieutenant Governor,Matt Pinnell,REP,720409,0,0,238,238,
Tulsa,State Auditor,Cindy Byrd,REP,720409,0,0,217,217,
Tulsa,State Auditor,Charlie Prater,REP,720409,0,0,148,148,
Tulsa,Attorney General,Mike Hunter,REP,720409,0,0,180,180,
Tulsa,Attorney General,Gentner Drummond,REP,720409,0,0,199,199,
Tulsa,Superintendent of Public Instruction,Joy Hofmeister,REP,720409,0,0,224,224,
Tulsa,Superintendent of Public Instruction,Linda Murphy,REP,720409,0,0,149,149,
Tulsa,Commissioner of Labor,Cathy Costello,REP,720409,0,0,181,181,
Tulsa,Commissioner of Labor,Leslie Osborn,REP,720409,0,0,181,181,
Tulsa,Corporation Commissioner,Bob Anthony,REP,720409,0,0,201,201,
Tulsa,Corporation Commissioner,Brian Bingman,REP,720409,0,0,160,160,
Tulsa,U.S. House,Tim Harris,REP,720409,0,0,186,186,01
Tulsa,U.S. House,Kevin Hern,REP,720409,0,0,197,197,01
Tulsa,State House,Stan May,REP,720409,0,0,212,212,80
Tulsa,State House,Mike Ritze,REP,720409,0,0,159,159,80
Tulsa,Governor,Chris Powell,LIB,720409,0,0,0,0,
Tulsa,Governor,Rex Lawhorn,LIB,720409,0,0,0,0,
Tulsa,Corporation Commissioner,Ashley Nicole Mccray,DEM,720409,0,0,39,39,
Tulsa,Corporation Commissioner,Blake Cummings,DEM,720409,0,0,13,13,
Tulsa,U.S. House,Tim Gilpin,DEM,720409,0,0,26,26,01
Tulsa,U.S. House,Amanda Douglas,DEM,720409,0,0,26,26,01
Tulsa,Governor,Mick Cornett,REP,720410,0,0,118,118,
Tulsa,Governor,Kevin Stitt,REP,720410,0,0,196,196,
Tulsa,Lieutenant Governor,Dana Murphy,REP,720410,0,0,114,114,
Tulsa,Lieutenant Governor,Matt Pinnell,REP,720410,0,0,191,191,
Tulsa,State Auditor,Cindy Byrd,REP,720410,0,0,150,150,
Tulsa,State Auditor,Charlie Prater,REP,720410,0,0,140,140,
Tulsa,Attorney General,Mike Hunter,REP,720410,0,0,145,145,
Tulsa,Attorney General,Gentner Drummond,REP,720410,0,0,158,158,
Tulsa,Superintendent of Public Instruction,Joy Hofmeister,REP,720410,0,0,217,217,
Tulsa,Superintendent of Public Instruction,Linda Murphy,REP,720410,0,0,81,81,
Tulsa,Commissioner of Labor,Cathy Costello,REP,720410,0,0,133,133,
Tulsa,Commissioner of Labor,Leslie Osborn,REP,720410,0,0,159,159,
Tulsa,Corporation Commissioner,Bob Anthony,REP,720410,0,0,160,160,
Tulsa,Corporation Commissioner,Brian Bingman,REP,720410,0,0,136,136,
Tulsa,U.S. House,Tim Harris,REP,720410,0,0,152,152,01
Tulsa,U.S. House,Kevin Hern,REP,720410,0,0,156,156,01
Tulsa,Governor,Chris Powell,LIB,720410,0,0,0,0,
Tulsa,Governor,Rex Lawhorn,LIB,720410,0,0,0,0,
Tulsa,Corporation Commissioner,Ashley Nicole Mccray,DEM,720410,0,0,24,24,
Tulsa,Corporation Commissioner,Blake Cummings,DEM,720410,0,0,9,9,
Tulsa,U.S. House,Tim Gilpin,DEM,720410,0,0,18,18,01
Tulsa,U.S. House,Amanda Douglas,DEM,720410,0,0,16,16,01
Tulsa,Governor,Mick Cornett,REP,720411,0,0,71,71,
Tulsa,Governor,Kevin Stitt,REP,720411,0,0,107,107,
Tulsa,Lieutenant Governor,Dana Murphy,REP,720411,0,0,58,58,
Tulsa,Lieutenant Governor,Matt Pinnell,REP,720411,0,0,114,114,
Tulsa,State Auditor,Cindy Byrd,REP,720411,0,0,80,80,
Tulsa,State Auditor,Charlie Prater,REP,720411,0,0,87,87,
Tulsa,Attorney General,Mike Hunter,REP,720411,0,0,83,83,
Tulsa,Attorney General,Gentner Drummond,REP,720411,0,0,89,89,
Tulsa,Superintendent of Public Instruction,Joy Hofmeister,REP,720411,0,0,83,83,
Tulsa,Superintendent of Public Instruction,Linda Murphy,REP,720411,0,0,89,89,
Tulsa,Commissioner of Labor,Cathy Costello,REP,720411,0,0,93,93,
Tulsa,Commissioner of Labor,Leslie Osborn,REP,720411,0,0,78,78,
Tulsa,Corporation Commissioner,Bob Anthony,REP,720411,0,0,81,81,
Tulsa,Corporation Commissioner,Brian Bingman,REP,720411,0,0,82,82,
Tulsa,U.S. House,Tim Harris,REP,720411,0,0,63,63,01
Tulsa,U.S. House,Kevin Hern,REP,720411,0,0,112,112,01
Tulsa,State House,Stan May,REP,720411,0,0,92,92,80
Tulsa,State House,Mike Ritze,REP,720411,0,0,78,78,80
Tulsa,Governor,Chris Powell,LIB,720411,0,0,0,0,
Tulsa,Governor,Rex Lawhorn,LIB,720411,0,0,3,3,
Tulsa,Corporation Commissioner,Ashley Nicole Mccray,DEM,720411,0,0,22,22,
Tulsa,Corporation Commissioner,Blake Cummings,DEM,720411,0,0,9,9,
Tulsa,U.S. House,Tim Gilpin,DEM,720411,0,0,18,18,01
Tulsa,U.S. House,Amanda Douglas,DEM,720411,0,0,13,13,01
Tulsa,Governor,Mick Cornett,REP,720451,0,0,66,66,
Tulsa,Governor,Kevin Stitt,REP,720451,0,0,115,115,
Tulsa,Lieutenant Governor,Dana Murphy,REP,720451,0,0,66,66,
Tulsa,Lieutenant Governor,Matt Pinnell,REP,720451,0,0,109,109,
Tulsa,State Auditor,Cindy Byrd,REP,720451,0,0,84,84,
Tulsa,State Auditor,Charlie Prater,REP,720451,0,0,89,89,
Tulsa,Attorney General,Mike Hunter,REP,720451,0,0,86,86,
Tulsa,Attorney General,Gentner Drummond,REP,720451,0,0,92,92,
Tulsa,Superintendent of Public Instruction,Joy Hofmeister,REP,720451,0,0,92,92,
Tulsa,Superintendent of Public Instruction,Linda Murphy,REP,720451,0,0,84,84,
Tulsa,Commissioner of Labor,Cathy Costello,REP,720451,0,0,85,85,
Tulsa,Commissioner of Labor,Leslie Osborn,REP,720451,0,0,89,89,
Tulsa,Corporation Commissioner,Bob Anthony,REP,720451,0,0,101,101,
Tulsa,Corporation Commissioner,Brian Bingman,REP,720451,0,0,71,71,
Tulsa,U.S. House,Tim Harris,REP,720451,0,0,74,74,01
Tulsa,U.S. House,Kevin Hern,REP,720451,0,0,103,103,01
Tulsa,State Senate,John Haste,REP,720451,0,0,111,111,36
Tulsa,State Senate,Bill Day,REP,720451,0,0,66,66,36
Tulsa,Governor,Chris Powell,LIB,720451,0,0,0,0,
Tulsa,Governor,Rex Lawhorn,LIB,720451,0,0,1,1,
Tulsa,Corporation Commissioner,Ashley Nicole Mccray,DEM,720451,0,0,41,41,
Tulsa,Corporation Commissioner,Blake Cummings,DEM,720451,0,0,21,21,
Tulsa,U.S. House,Tim Gilpin,DEM,720451,0,0,27,27,01
Tulsa,U.S. House,Amanda Douglas,DEM,720451,0,0,36,36,01
Tulsa,Governor,Mick Cornett,REP,720452,0,0,101,101,
Tulsa,Governor,Kevin Stitt,REP,720452,0,0,240,240,
Tulsa,Lieutenant Governor,Dana Murphy,REP,720452,0,0,126,126,
Tulsa,Lieutenant Governor,Matt Pinnell,REP,720452,0,0,208,208,
Tulsa,State Auditor,Cindy Byrd,REP,720452,0,0,168,168,
Tulsa,State Auditor,Charlie Prater,REP,720452,0,0,156,156,
Tulsa,Attorney General,Mike Hunter,REP,720452,0,0,147,147,
Tulsa,Attorney General,Gentner Drummond,REP,720452,0,0,186,186,
Tulsa,Superintendent of Public Instruction,Joy Hofmeister,REP,720452,0,0,185,185,
Tulsa,Superintendent of Public Instruction,Linda Murphy,REP,720452,0,0,145,145,
Tulsa,Commissioner of Labor,Cathy Costello,REP,720452,0,0,171,171,
Tulsa,Commissioner of Labor,Leslie Osborn,REP,720452,0,0,152,152,
Tulsa,Corporation Commissioner,Bob Anthony,REP,720452,0,0,178,178,
Tulsa,Corporation Commissioner,Brian Bingman,REP,720452,0,0,145,145,
Tulsa,U.S. House,Tim Harris,REP,720452,0,0,133,133,01
Tulsa,U.S. House,Kevin Hern,REP,720452,0,0,205,205,01
Tulsa,State House,Laura Steele,REP,720452,0,0,117,117,98
Tulsa,State House,Dean Davis,REP,720452,0,0,199,199,98
Tulsa,Governor,Chris Powell,LIB,720452,0,0,0,0,
Tulsa,Governor,Rex Lawhorn,LIB,720452,0,0,1,1,
Tulsa,Corporation Commissioner,Ashley Nicole Mccray,DEM,720452,0,0,107,107,
Tulsa,Corporation Commissioner,Blake Cummings,DEM,720452,0,0,42,42,
Tulsa,U.S. House,Tim Gilpin,DEM,720452,0,0,90,90,01
Tulsa,U.S. House,Amanda Douglas,DEM,720452,0,0,60,60,01
Tulsa,Governor,Mick Cornett,REP,720453,0,0,120,120,
Tulsa,Governor,Kevin Stitt,REP,720453,0,0,141,141,
Tulsa,Lieutenant Governor,Dana Murphy,REP,720453,0,0,95,95,
Tulsa,Lieutenant Governor,Matt Pinnell,REP,720453,0,0,156,156,
Tulsa,State Auditor,Cindy Byrd,REP,720453,0,0,127,127,
Tulsa,State Auditor,Charlie Prater,REP,720453,0,0,115,115,
Tulsa,Attorney General,Mike Hunter,REP,720453,0,0,130,130,
Tulsa,Attorney General,Gentner Drummond,REP,720453,0,0,129,129,
Tulsa,Superintendent of Public Instruction,Joy Hofmeister,REP,720453,0,0,146,146,
Tulsa,Superintendent of Public Instruction,Linda Murphy,REP,720453,0,0,109,109,
Tulsa,Commissioner of Labor,Cathy Costello,REP,720453,0,0,117,117,
Tulsa,Commissioner of Labor,Leslie Osborn,REP,720453,0,0,132,132,
Tulsa,Corporation Commissioner,Bob Anthony,REP,720453,0,0,119,119,
Tulsa,Corporation Commissioner,Brian Bingman,REP,720453,0,0,124,124,
Tulsa,U.S. House,Tim Harris,REP,720453,0,0,113,113,01
Tulsa,U.S. House,Kevin Hern,REP,720453,0,0,143,143,01
Tulsa,State Senate,John Haste,REP,720453,0,0,138,138,36
Tulsa,State Senate,Bill Day,REP,720453,0,0,114,114,36
Tulsa,State House,Laura Steele,REP,720453,0,0,86,86,98
Tulsa,State House,Dean Davis,REP,720453,0,0,164,164,98
Tulsa,Governor,Chris Powell,LIB,720453,0,0,0,0,
Tulsa,Governor,Rex Lawhorn,LIB,720453,0,0,1,1,
Tulsa,Corporation Commissioner,Ashley Nicole Mccray,DEM,720453,0,0,58,58,
Tulsa,Corporation Commissioner,Blake Cummings,DEM,720453,0,0,19,19,
Tulsa,U.S. House,Tim Gilpin,DEM,720453,0,0,41,41,01
Tulsa,U.S. House,Amanda Douglas,DEM,720453,0,0,41,41,01
Tulsa,Governor,Mick Cornett,REP,720454,0,0,139,139,
Tulsa,Governor,Kevin Stitt,REP,720454,0,0,217,217,
Tulsa,Lieutenant Governor,Dana Murphy,REP,720454,0,0,150,150,
Tulsa,Lieutenant Governor,Matt Pinnell,REP,720454,0,0,192,192,
Tulsa,State Auditor,Cindy Byrd,REP,720454,0,0,195,195,
Tulsa,State Auditor,Charlie Prater,REP,720454,0,0,134,134,
Tulsa,Attorney General,Mike Hunter,REP,720454,0,0,152,152,
Tulsa,Attorney General,Gentner Drummond,REP,720454,0,0,194,194,
Tulsa,Superintendent of Public Instruction,Joy Hofmeister,REP,720454,0,0,222,222,
Tulsa,Superintendent of Public Instruction,Linda Murphy,REP,720454,0,0,123,123,
Tulsa,Commissioner of Labor,Cathy Costello,REP,720454,0,0,172,172,
Tulsa,Commissioner of Labor,Leslie Osborn,REP,720454,0,0,163,163,
Tulsa,Corporation Commissioner,Bob Anthony,REP,720454,0,0,189,189,
Tulsa,Corporation Commissioner,Brian Bingman,REP,720454,0,0,147,147,
Tulsa,U.S. House,Tim Harris,REP,720454,0,0,167,167,01
Tulsa,U.S. House,Kevin Hern,REP,720454,0,0,180,180,01
Tulsa,Governor,Chris Powell,LIB,720454,0,0,0,0,
Tulsa,Governor,Rex Lawhorn,LIB,720454,0,0,0,0,
Tulsa,Corporation Commissioner,Ashley Nicole Mccray,DEM,720454,0,0,84,84,
Tulsa,Corporation Commissioner,Blake Cummings,DEM,720454,0,0,35,35,
Tulsa,U.S. House,Tim Gilpin,DEM,720454,0,0,62,62,01
Tulsa,U.S. House,Amanda Douglas,DEM,720454,0,0,57,57,01
Tulsa,Governor,Mick Cornett,REP,720455,0,0,31,31,
Tulsa,Governor,Kevin Stitt,REP,720455,0,0,83,83,
Tulsa,Lieutenant Governor,Dana Murphy,REP,720455,0,0,37,37,
Tulsa,Lieutenant Governor,Matt Pinnell,REP,720455,0,0,72,72,
Tulsa,State Auditor,Cindy Byrd,REP,720455,0,0,44,44,
Tulsa,State Auditor,Charlie Prater,REP,720455,0,0,60,60,
Tulsa,Attorney General,Mike Hunter,REP,720455,0,0,58,58,
Tulsa,Attorney General,Gentner Drummond,REP,720455,0,0,55,55,
Tulsa,Superintendent of Public Instruction,Joy Hofmeister,REP,720455,0,0,64,64,
Tulsa,Superintendent of Public Instruction,Linda Murphy,REP,720455,0,0,47,47,
Tulsa,Commissioner of Labor,Cathy Costello,REP,720455,0,0,50,50,
Tulsa,Commissioner of Labor,Leslie Osborn,REP,720455,0,0,55,55,
Tulsa,Corporation Commissioner,Bob Anthony,REP,720455,0,0,54,54,
Tulsa,Corporation Commissioner,Brian Bingman,REP,720455,0,0,51,51,
Tulsa,U.S. House,Tim Harris,REP,720455,0,0,57,57,01
Tulsa,U.S. House,Kevin Hern,REP,720455,0,0,54,54,01
Tulsa,Governor,Chris Powell,LIB,720455,0,0,0,0,
Tulsa,Governor,Rex Lawhorn,LIB,720455,0,0,0,0,
Tulsa,Corporation Commissioner,Ashley Nicole Mccray,DEM,720455,0,0,32,32,
Tulsa,Corporation Commissioner,Blake Cummings,DEM,720455,0,0,27,27,
Tulsa,U.S. House,Tim Gilpin,DEM,720455,0,0,33,33,01
Tulsa,U.S. House,Amanda Douglas,DEM,720455,0,0,28,28,01
Tulsa,Governor,Mick Cornett,REP,720456,0,0,72,72,
Tulsa,Governor,Kevin Stitt,REP,720456,0,0,166,166,
Tulsa,Lieutenant Governor,Dana Murphy,REP,720456,0,0,90,90,
Tulsa,Lieutenant Governor,Matt Pinnell,REP,720456,0,0,143,143,
Tulsa,State Auditor,Cindy Byrd,REP,720456,0,0,117,117,
Tulsa,State Auditor,Charlie Prater,REP,720456,0,0,106,106,
Tulsa,Attorney General,Mike Hunter,REP,720456,0,0,102,102,
Tulsa,Attorney General,Gentner Drummond,REP,720456,0,0,128,128,
Tulsa,Superintendent of Public Instruction,Joy Hofmeister,REP,720456,0,0,120,120,
Tulsa,Superintendent of Public Instruction,Linda Murphy,REP,720456,0,0,112,112,
Tulsa,Commissioner of Labor,Cathy Costello,REP,720456,0,0,128,128,
Tulsa,Commissioner of Labor,Leslie Osborn,REP,720456,0,0,99,99,
Tulsa,Corporation Commissioner,Bob Anthony,REP,720456,0,0,118,118,
Tulsa,Corporation Commissioner,Brian Bingman,REP,720456,0,0,104,104,
Tulsa,U.S. House,Tim Harris,REP,720456,0,0,121,121,01
Tulsa,U.S. House,Kevin Hern,REP,720456,0,0,113,113,01
Tulsa,Governor,Chris Powell,LIB,720456,0,0,0,0,
Tulsa,Governor,Rex Lawhorn,LIB,720456,0,0,1,1,
Tulsa,Corporation Commissioner,Ashley Nicole Mccray,DEM,720456,0,0,65,65,
Tulsa,Corporation Commissioner,Blake Cummings,DEM,720456,0,0,27,27,
Tulsa,U.S. House,Tim Gilpin,DEM,720456,0,0,39,39,01
Tulsa,U.S. House,Amanda Douglas,DEM,720456,0,0,54,54,01
Tulsa,Governor,Mick Cornett,REP,720457,0,0,1,1,
Tulsa,Governor,Kevin Stitt,REP,720457,0,0,3,3,
Tulsa,Lieutenant Governor,Dana Murphy,REP,720457,0,0,0,0,
Tulsa,Lieutenant Governor,Matt Pinnell,REP,720457,0,0,4,4,
Tulsa,State Auditor,Cindy Byrd,REP,720457,0,0,3,3,
Tulsa,State Auditor,Charlie Prater,REP,720457,0,0,1,1,
Tulsa,Attorney General,Mike Hunter,REP,720457,0,0,1,1,
Tulsa,Attorney General,Gentner Drummond,REP,720457,0,0,3,3,
Tulsa,Superintendent of Public Instruction,Joy Hofmeister,REP,720457,0,0,2,2,
Tulsa,Superintendent of Public Instruction,Linda Murphy,REP,720457,0,0,2,2,
Tulsa,Commissioner of Labor,Cathy Costello,REP,720457,0,0,2,2,
Tulsa,Commissioner of Labor,Leslie Osborn,REP,720457,0,0,2,2,
Tulsa,Corporation Commissioner,Bob Anthony,REP,720457,0,0,2,2,
Tulsa,Corporation Commissioner,Brian Bingman,REP,720457,0,0,2,2,
Tulsa,U.S. House,Tim Harris,REP,720457,0,0,3,3,01
Tulsa,U.S. House,Kevin Hern,REP,720457,0,0,1,1,01
Tulsa,State House,Laura Steele,REP,720457,0,0,2,2,98
Tulsa,State House,Dean Davis,REP,720457,0,0,2,2,98
Tulsa,Governor,Chris Powell,LIB,720457,0,0,0,0,
Tulsa,Governor,Rex Lawhorn,LIB,720457,0,0,0,0,
Tulsa,Corporation Commissioner,Ashley Nicole Mccray,DEM,720457,0,0,1,1,
Tulsa,Corporation Commissioner,Blake Cummings,DEM,720457,0,0,0,0,
Tulsa,U.S. House,Tim Gilpin,DEM,720457,0,0,0,0,01
Tulsa,U.S. House,Amanda Douglas,DEM,720457,0,0,1,1,01
Tulsa,Governor,Mick Cornett,REP,720458,0,0,189,189,
Tulsa,Governor,Kevin Stitt,REP,720458,0,0,335,335,
Tulsa,Lieutenant Governor,Dana Murphy,REP,720458,0,0,189,189,
Tulsa,Lieutenant Governor,Matt Pinnell,REP,720458,0,0,318,318,
Tulsa,State Auditor,Cindy Byrd,REP,720458,0,0,263,263,
Tulsa,State Auditor,Charlie Prater,REP,720458,0,0,233,233,
Tulsa,Attorney General,Mike Hunter,REP,720458,0,0,244,244,
Tulsa,Attorney General,Gentner Drummond,REP,720458,0,0,273,273,
Tulsa,Superintendent of Public Instruction,Joy Hofmeister,REP,720458,0,0,303,303,
Tulsa,Superintendent of Public Instruction,Linda Murphy,REP,720458,0,0,210,210,
Tulsa,Commissioner of Labor,Cathy Costello,REP,720458,0,0,269,269,
Tulsa,Commissioner of Labor,Leslie Osborn,REP,720458,0,0,225,225,
Tulsa,Corporation Commissioner,Bob Anthony,REP,720458,0,0,280,280,
Tulsa,Corporation Commissioner,Brian Bingman,REP,720458,0,0,213,213,
Tulsa,U.S. House,Tim Harris,REP,720458,0,0,267,267,01
Tulsa,U.S. House,Kevin Hern,REP,720458,0,0,251,251,01
Tulsa,Governor,Chris Powell,LIB,720458,0,0,2,2,
Tulsa,Governor,Rex Lawhorn,LIB,720458,0,0,0,0,
Tulsa,Corporation Commissioner,Ashley Nicole Mccray,DEM,720458,0,0,106,106,
Tulsa,Corporation Commissioner,Blake Cummings,DEM,720458,0,0,34,34,
Tulsa,U.S. House,Tim Gilpin,DEM,720458,0,0,77,77,01
Tulsa,U.S. House,Amanda Douglas,DEM,720458,0,0,65,65,01
Tulsa,Governor,Mick Cornett,REP,720459,0,0,55,55,
Tulsa,Governor,Kevin Stitt,REP,720459,0,0,135,135,
Tulsa,Lieutenant Governor,Dana Murphy,REP,720459,0,0,66,66,
Tulsa,Lieutenant Governor,Matt Pinnell,REP,720459,0,0,121,121,
Tulsa,State Auditor,Cindy Byrd,REP,720459,0,0,81,81,
Tulsa,State Auditor,Charlie Prater,REP,720459,0,0,100,100,
Tulsa,Attorney General,Mike Hunter,REP,720459,0,0,91,91,
Tulsa,Attorney General,Gentner Drummond,REP,720459,0,0,99,99,
Tulsa,Superintendent of Public Instruction,Joy Hofmeister,REP,720459,0,0,100,100,
Tulsa,Superintendent of Public Instruction,Linda Murphy,REP,720459,0,0,88,88,
Tulsa,Commissioner of Labor,Cathy Costello,REP,720459,0,0,95,95,
Tulsa,Commissioner of Labor,Leslie Osborn,REP,720459,0,0,90,90,
Tulsa,Corporation Commissioner,Bob Anthony,REP,720459,0,0,89,89,
Tulsa,Corporation Commissioner,Brian Bingman,REP,720459,0,0,93,93,
Tulsa,U.S. House,Tim Harris,REP,720459,0,0,75,75,01
Tulsa,U.S. House,Kevin Hern,REP,720459,0,0,115,115,01
Tulsa,State House,Stan May,REP,720459,0,0,87,87,80
Tulsa,State House,Mike Ritze,REP,720459,0,0,96,96,80
Tulsa,Governor,Chris Powell,LIB,720459,0,0,0,0,
Tulsa,Governor,Rex Lawhorn,LIB,720459,0,0,0,0,
Tulsa,Corporation Commissioner,Ashley Nicole Mccray,DEM,720459,0,0,36,36,
Tulsa,Corporation Commissioner,Blake Cummings,DEM,720459,0,0,16,16,
Tulsa,U.S. House,Tim Gilpin,DEM,720459,0,0,22,22,01
Tulsa,U.S. House,Amanda Douglas,DEM,720459,0,0,31,31,01
Tulsa,Governor,Mick Cornett,REP,720460,0,0,100,100,
Tulsa,Governor,Kevin Stitt,REP,720460,0,0,208,208,
Tulsa,Lieutenant Governor,Dana Murphy,REP,720460,0,0,135,135,
Tulsa,Lieutenant Governor,Matt Pinnell,REP,720460,0,0,168,168,
Tulsa,State Auditor,Cindy Byrd,REP,720460,0,0,149,149,
Tulsa,State Auditor,Charlie Prater,REP,720460,0,0,137,137,
Tulsa,Attorney General,Mike Hunter,REP,720460,0,0,142,142,
Tulsa,Attorney General,Gentner Drummond,REP,720460,0,0,155,155,
Tulsa,Superintendent of Public Instruction,Joy Hofmeister,REP,720460,0,0,184,184,
Tulsa,Superintendent of Public Instruction,Linda Murphy,REP,720460,0,0,115,115,
Tulsa,Commissioner of Labor,Cathy Costello,REP,720460,0,0,144,144,
Tulsa,Commissioner of Labor,Leslie Osborn,REP,720460,0,0,140,140,
Tulsa,Corporation Commissioner,Bob Anthony,REP,720460,0,0,155,155,
Tulsa,Corporation Commissioner,Brian Bingman,REP,720460,0,0,133,133,
Tulsa,U.S. House,Tim Harris,REP,720460,0,0,148,148,01
Tulsa,U.S. House,Kevin Hern,REP,720460,0,0,157,157,01
Tulsa,State House,Stan May,REP,720460,0,0,179,179,80
Tulsa,State House,Mike Ritze,REP,720460,0,0,110,110,80
Tulsa,Governor,Chris Powell,LIB,720460,0,0,0,0,
Tulsa,Governor,Rex Lawhorn,LIB,720460,0,0,0,0,
Tulsa,Corporation Commissioner,Ashley Nicole Mccray,DEM,720460,0,0,40,40,
Tulsa,Corporation Commissioner,Blake Cummings,DEM,720460,0,0,16,16,
Tulsa,U.S. House,Tim Gilpin,DEM,720460,0,0,28,28,01
Tulsa,U.S. House,Amanda Douglas,DEM,720460,0,0,28,28,01
Tulsa,Governor,Mick Cornett,REP,720461,0,0,78,78,
Tulsa,Governor,Kevin Stitt,REP,720461,0,0,150,150,
Tulsa,Lieutenant Governor,Dana Murphy,REP,720461,0,0,104,104,
Tulsa,Lieutenant Governor,Matt Pinnell,REP,720461,0,0,120,120,
Tulsa,State Auditor,Cindy Byrd,REP,720461,0,0,121,121,
Tulsa,State Auditor,Charlie Prater,REP,720461,0,0,102,102,
Tulsa,Attorney General,Mike Hunter,REP,720461,0,0,102,102,
Tulsa,Attorney General,Gentner Drummond,REP,720461,0,0,122,122,
Tulsa,Superintendent of Public Instruction,Joy Hofmeister,REP,720461,0,0,115,115,
Tulsa,Superintendent of Public Instruction,Linda Murphy,REP,720461,0,0,108,108,
Tulsa,Commissioner of Labor,Cathy Costello,REP,720461,0,0,127,127,
Tulsa,Commissioner of Labor,Leslie Osborn,REP,720461,0,0,94,94,
Tulsa,Corporation Commissioner,Bob Anthony,REP,720461,0,0,114,114,
Tulsa,Corporation Commissioner,Brian Bingman,REP,720461,0,0,102,102,
Tulsa,U.S. House,Tim Harris,REP,720461,0,0,97,97,01
Tulsa,U.S. House,Kevin Hern,REP,720461,0,0,128,128,01
Tulsa,State House,Stan May,REP,720461,0,0,122,122,80
Tulsa,State House,Mike Ritze,REP,720461,0,0,101,101,80
Tulsa,Governor,Chris Powell,LIB,720461,0,0,0,0,
Tulsa,Governor,Rex Lawhorn,LIB,720461,0,0,0,0,
Tulsa,Corporation Commissioner,Ashley Nicole Mccray,DEM,720461,0,0,55,55,
Tulsa,Corporation Commissioner,Blake Cummings,DEM,720461,0,0,19,19,
Tulsa,U.S. House,Tim Gilpin,DEM,720461,0,0,36,36,01
Tulsa,U.S. House,Amanda Douglas,DEM,720461,0,0,38,38,01
Tulsa,Governor,Mick Cornett,REP,720462,0,0,119,119,
Tulsa,Governor,Kevin Stitt,REP,720462,0,0,248,248,
Tulsa,Lieutenant Governor,Dana Murphy,REP,720462,0,0,138,138,
Tulsa,Lieutenant Governor,Matt Pinnell,REP,720462,0,0,221,221,
Tulsa,State Auditor,Cindy Byrd,REP,720462,0,0,206,206,
Tulsa,State Auditor,Charlie Prater,REP,720462,0,0,148,148,
Tulsa,Attorney General,Mike Hunter,REP,720462,0,0,164,164,
Tulsa,Attorney General,Gentner Drummond,REP,720462,0,0,195,195,
Tulsa,Superintendent of Public Instruction,Joy Hofmeister,REP,720462,0,0,205,205,
Tulsa,Superintendent of Public Instruction,Linda Murphy,REP,720462,0,0,151,151,
Tulsa,Commissioner of Labor,Cathy Costello,REP,720462,0,0,191,191,
Tulsa,Commissioner of Labor,Leslie Osborn,REP,720462,0,0,160,160,
Tulsa,Corporation Commissioner,Bob Anthony,REP,720462,0,0,191,191,
Tulsa,Corporation Commissioner,Brian Bingman,REP,720462,0,0,159,159,
Tulsa,U.S. House,Tim Harris,REP,720462,0,0,171,171,01
Tulsa,U.S. House,Kevin Hern,REP,720462,0,0,193,193,01
Tulsa,Governor,Chris Powell,LIB,720462,0,0,0,0,
Tulsa,Governor,Rex Lawhorn,LIB,720462,0,0,0,0,
Tulsa,Corporation Commissioner,Ashley Nicole Mccray,DEM,720462,0,0,90,90,
Tulsa,Corporation Commissioner,Blake Cummings,DEM,720462,0,0,34,34,
Tulsa,U.S. House,Tim Gilpin,DEM,720462,0,0,57,57,01
Tulsa,U.S. House,Amanda Douglas,DEM,720462,0,0,68,68,01
Tulsa,Governor,Mick Cornett,REP,720463,0,0,78,78,
Tulsa,Governor,Kevin Stitt,REP,720463,0,0,156,156,
Tulsa,Lieutenant Governor,Dana Murphy,REP,720463,0,0,94,94,
Tulsa,Lieutenant Governor,Matt Pinnell,REP,720463,0,0,129,129,
Tulsa,State Auditor,Cindy Byrd,REP,720463,0,0,128,128,
Tulsa,State Auditor,Charlie Prater,REP,720463,0,0,90,90,
Tulsa,Attorney General,Mike Hunter,REP,720463,0,0,108,108,
Tulsa,Attorney General,Gentner Drummond,REP,720463,0,0,121,121,
Tulsa,Superintendent of Public Instruction,Joy Hofmeister,REP,720463,0,0,112,112,
Tulsa,Superintendent of Public Instruction,Linda Murphy,REP,720463,0,0,113,113,
Tulsa,Commissioner of Labor,Cathy Costello,REP,720463,0,0,107,107,
Tulsa,Commissioner of Labor,Leslie Osborn,REP,720463,0,0,114,114,
Tulsa,Corporation Commissioner,Bob Anthony,REP,720463,0,0,113,113,
Tulsa,Corporation Commissioner,Brian Bingman,REP,720463,0,0,106,106,
Tulsa,U.S. House,Tim Harris,REP,720463,0,0,102,102,01
Tulsa,U.S. House,Kevin Hern,REP,720463,0,0,126,126,01
Tulsa,Governor,Chris Powell,LIB,720463,0,0,0,0,
Tulsa,Governor,Rex Lawhorn,LIB,720463,0,0,1,1,
Tulsa,Corporation Commissioner,Ashley Nicole Mccray,DEM,720463,0,0,62,62,
Tulsa,Corporation Commissioner,Blake Cummings,DEM,720463,0,0,25,25,
Tulsa,U.S. House,Tim Gilpin,DEM,720463,0,0,33,33,01
Tulsa,U.S. House,Amanda Douglas,DEM,720463,0,0,53,53,01
Tulsa,Governor,Mick Cornett,REP,720464,0,0,183,183,
Tulsa,Governor,Kevin Stitt,REP,720464,0,0,347,347,
Tulsa,Lieutenant Governor,Dana Murphy,REP,720464,0,0,204,204,
Tulsa,Lieutenant Governor,Matt Pinnell,REP,720464,0,0,310,310,
Tulsa,State Auditor,Cindy Byrd,REP,720464,0,0,276,276,
Tulsa,State Auditor,Charlie Prater,REP,720464,0,0,235,235,
Tulsa,Attorney General,Mike Hunter,REP,720464,0,0,235,235,
Tulsa,Attorney General,Gentner Drummond,REP,720464,0,0,283,283,
Tulsa,Superintendent of Public Instruction,Joy Hofmeister,REP,720464,0,0,296,296,
Tulsa,Superintendent of Public Instruction,Linda Murphy,REP,720464,0,0,221,221,
Tulsa,Commissioner of Labor,Cathy Costello,REP,720464,0,0,247,247,
Tulsa,Commissioner of Labor,Leslie Osborn,REP,720464,0,0,262,262,
Tulsa,Corporation Commissioner,Bob Anthony,REP,720464,0,0,269,269,
Tulsa,Corporation Commissioner,Brian Bingman,REP,720464,0,0,238,238,
Tulsa,U.S. House,Tim Harris,REP,720464,0,0,224,224,01
Tulsa,U.S. House,Kevin Hern,REP,720464,0,0,295,295,01
Tulsa,State House,Stan May,REP,720464,0,0,317,317,80
Tulsa,State House,Mike Ritze,REP,720464,0,0,199,199,80
Tulsa,Governor,Chris Powell,LIB,720464,0,0,1,1,
Tulsa,Governor,Rex Lawhorn,LIB,720464,0,0,1,1,
Tulsa,Corporation Commissioner,Ashley Nicole Mccray,DEM,720464,0,0,107,107,
Tulsa,Corporation Commissioner,Blake Cummings,DEM,720464,0,0,29,29,
Tulsa,U.S. House,Tim Gilpin,DEM,720464,0,0,59,59,01
Tulsa,U.S. House,Amanda Douglas,DEM,720464,0,0,78,78,01
Tulsa,Governor,Mick Cornett,REP,720465,0,0,107,107,
Tulsa,Governor,Kevin Stitt,REP,720465,0,0,173,173,
Tulsa,Lieutenant Governor,Dana Murphy,REP,720465,0,0,117,117,
Tulsa,Lieutenant Governor,Matt Pinnell,REP,720465,0,0,156,156,
Tulsa,State Auditor,Cindy Byrd,REP,720465,0,0,131,131,
Tulsa,State Auditor,Charlie Prater,REP,720465,0,0,131,131,
Tulsa,Attorney General,Mike Hunter,REP,720465,0,0,128,128,
Tulsa,Attorney General,Gentner Drummond,REP,720465,0,0,148,148,
Tulsa,Superintendent of Public Instruction,Joy Hofmeister,REP,720465,0,0,152,152,
Tulsa,Superintendent of Public Instruction,Linda Murphy,REP,720465,0,0,122,122,
Tulsa,Commissioner of Labor,Cathy Costello,REP,720465,0,0,146,146,
Tulsa,Commissioner of Labor,Leslie Osborn,REP,720465,0,0,123,123,
Tulsa,Corporation Commissioner,Bob Anthony,REP,720465,0,0,165,165,
Tulsa,Corporation Commissioner,Brian Bingman,REP,720465,0,0,100,100,
Tulsa,U.S. House,Tim Harris,REP,720465,0,0,135,135,01
Tulsa,U.S. House,Kevin Hern,REP,720465,0,0,146,146,01
Tulsa,State Senate,John Haste,REP,720465,0,0,150,150,36
Tulsa,State Senate,Bill Day,REP,720465,0,0,114,114,36
Tulsa,Governor,Chris Powell,LIB,720465,0,0,0,0,
Tulsa,Governor,Rex Lawhorn,LIB,720465,0,0,0,0,
Tulsa,Corporation Commissioner,Ashley Nicole Mccray,DEM,720465,0,0,84,84,
Tulsa,Corporation Commissioner,Blake Cummings,DEM,720465,0,0,21,21,
Tulsa,U.S. House,Tim Gilpin,DEM,720465,0,0,55,55,01
Tulsa,U.S. House,Amanda Douglas,DEM,720465,0,0,51,51,01
Tulsa,Governor,Mick Cornett,REP,720466,0,0,133,133,
Tulsa,Governor,Kevin Stitt,REP,720466,0,0,222,222,
Tulsa,Lieutenant Governor,Dana Murphy,REP,720466,0,0,138,138,
Tulsa,Lieutenant Governor,Matt Pinnell,REP,720466,0,0,210,210,
Tulsa,State Auditor,Cindy Byrd,REP,720466,0,0,168,168,
Tulsa,State Auditor,Charlie Prater,REP,720466,0,0,168,168,
Tulsa,Attorney General,Mike Hunter,REP,720466,0,0,153,153,
Tulsa,Attorney General,Gentner Drummond,REP,720466,0,0,198,198,
Tulsa,Superintendent of Public Instruction,Joy Hofmeister,REP,720466,0,0,204,204,
Tulsa,Superintendent of Public Instruction,Linda Murphy,REP,720466,0,0,139,139,
Tulsa,Commissioner of Labor,Cathy Costello,REP,720466,0,0,177,177,
Tulsa,Commissioner of Labor,Leslie Osborn,REP,720466,0,0,160,160,
Tulsa,Corporation Commissioner,Bob Anthony,REP,720466,0,0,186,186,
Tulsa,Corporation Commissioner,Brian Bingman,REP,720466,0,0,153,153,
Tulsa,U.S. House,Tim Harris,REP,720466,0,0,155,155,01
Tulsa,U.S. House,Kevin Hern,REP,720466,0,0,193,193,01
Tulsa,State Senate,John Haste,REP,720466,0,0,179,179,36
Tulsa,State Senate,Bill Day,REP,720466,0,0,162,162,36
Tulsa,State House,Laura Steele,REP,720466,0,0,104,104,98
Tulsa,State House,Dean Davis,REP,720466,0,0,226,226,98
Tulsa,Governor,Chris Powell,LIB,720466,0,0,0,0,
Tulsa,Governor,Rex Lawhorn,LIB,720466,0,0,1,1,
Tulsa,Corporation Commissioner,Ashley Nicole Mccray,DEM,720466,0,0,97,97,
Tulsa,Corporation Commissioner,Blake Cummings,DEM,720466,0,0,21,21,
Tulsa,U.S. House,Tim Gilpin,DEM,720466,0,0,57,57,01
Tulsa,U.S. House,Amanda Douglas,DEM,720466,0,0,62,62,01
Tulsa,Governor,Mick Cornett,REP,720467,0,0,55,55,
Tulsa,Governor,Kevin Stitt,REP,720467,0,0,79,79,
Tulsa,Lieutenant Governor,Dana Murphy,REP,720467,0,0,53,53,
Tulsa,Lieutenant Governor,Matt Pinnell,REP,720467,0,0,73,73,
Tulsa,State Auditor,Cindy Byrd,REP,720467,0,0,59,59,
Tulsa,State Auditor,Charlie Prater,REP,720467,0,0,63,63,
Tulsa,Attorney General,Mike Hunter,REP,720467,0,0,59,59,
Tulsa,Attorney General,Gentner Drummond,REP,720467,0,0,67,67,
Tulsa,Superintendent of Public Instruction,Joy Hofmeister,REP,720467,0,0,82,82,
Tulsa,Superintendent of Public Instruction,Linda Murphy,REP,720467,0,0,47,47,
Tulsa,Commissioner of Labor,Cathy Costello,REP,720467,0,0,52,52,
Tulsa,Commissioner of Labor,Leslie Osborn,REP,720467,0,0,71,71,
Tulsa,Corporation Commissioner,Bob Anthony,REP,720467,0,0,60,60,
Tulsa,Corporation Commissioner,Brian Bingman,REP,720467,0,0,63,63,
Tulsa,U.S. House,Tim Harris,REP,720467,0,0,51,51,01
Tulsa,U.S. House,Kevin Hern,REP,720467,0,0,77,77,01
Tulsa,State House,Stan May,REP,720467,0,0,75,75,80
Tulsa,State House,Mike Ritze,REP,720467,0,0,55,55,80
Tulsa,Governor,Chris Powell,LIB,720467,0,0,1,1,
Tulsa,Governor,Rex Lawhorn,LIB,720467,0,0,0,0,
Tulsa,Corporation Commissioner,Ashley Nicole Mccray,DEM,720467,0,0,19,19,
Tulsa,Corporation Commissioner,Blake Cummings,DEM,720467,0,0,5,5,
Tulsa,U.S. House,Tim Gilpin,DEM,720467,0,0,9,9,01
Tulsa,U.S. House,Amanda Douglas,DEM,720467,0,0,15,15,01
Tulsa,Governor,Mick Cornett,REP,720468,0,0,148,148,
Tulsa,Governor,Kevin Stitt,REP,720468,0,0,281,281,
Tulsa,Lieutenant Governor,Dana Murphy,REP,720468,0,0,159,159,
Tulsa,Lieutenant Governor,Matt Pinnell,REP,720468,0,0,255,255,
Tulsa,State Auditor,Cindy Byrd,REP,720468,0,0,220,220,
Tulsa,State Auditor,Charlie Prater,REP,720468,0,0,183,183,
Tulsa,Attorney General,Mike Hunter,REP,720468,0,0,184,184,
Tulsa,Attorney General,Gentner Drummond,REP,720468,0,0,238,238,
Tulsa,Superintendent of Public Instruction,Joy Hofmeister,REP,720468,0,0,248,248,
Tulsa,Superintendent of Public Instruction,Linda Murphy,REP,720468,0,0,168,168,
Tulsa,Commissioner of Labor,Cathy Costello,REP,720468,0,0,213,213,
Tulsa,Commissioner of Labor,Leslie Osborn,REP,720468,0,0,194,194,
Tulsa,Corporation Commissioner,Bob Anthony,REP,720468,0,0,237,237,
Tulsa,Corporation Commissioner,Brian Bingman,REP,720468,0,0,165,165,
Tulsa,U.S. House,Tim Harris,REP,720468,0,0,202,202,01
Tulsa,U.S. House,Kevin Hern,REP,720468,0,0,221,221,01
Tulsa,Governor,Chris Powell,LIB,720468,0,0,0,0,
Tulsa,Governor,Rex Lawhorn,LIB,720468,0,0,0,0,
Tulsa,Corporation Commissioner,Ashley Nicole Mccray,DEM,720468,0,0,85,85,
Tulsa,Corporation Commissioner,Blake Cummings,DEM,720468,0,0,29,29,
Tulsa,U.S. House,Tim Gilpin,DEM,720468,0,0,60,60,01
Tulsa,U.S. House,Amanda Douglas,DEM,720468,0,0,56,56,01
Tulsa,Governor,Mick Cornett,REP,720469,0,0,24,24,
Tulsa,Governor,Kevin Stitt,REP,720469,0,0,49,49,
Tulsa,Lieutenant Governor,Dana Murphy,REP,720469,0,0,25,25,
Tulsa,Lieutenant Governor,Matt Pinnell,REP,720469,0,0,45,45,
Tulsa,State Auditor,Cindy Byrd,REP,720469,0,0,33,33,
Tulsa,State Auditor,Charlie Prater,REP,720469,0,0,35,35,
Tulsa,Attorney General,Mike Hunter,REP,720469,0,0,35,35,
Tulsa,Attorney General,Gentner Drummond,REP,720469,0,0,35,35,
Tulsa,Superintendent of Public Instruction,Joy Hofmeister,REP,720469,0,0,28,28,
Tulsa,Superintendent of Public Instruction,Linda Murphy,REP,720469,0,0,41,41,
Tulsa,Commissioner of Labor,Cathy Costello,REP,720469,0,0,45,45,
Tulsa,Commissioner of Labor,Leslie Osborn,REP,720469,0,0,26,26,
Tulsa,Corporation Commissioner,Bob Anthony,REP,720469,0,0,36,36,
Tulsa,Corporation Commissioner,Brian Bingman,REP,720469,0,0,31,31,
Tulsa,U.S. House,Tim Harris,REP,720469,0,0,37,37,01
Tulsa,U.S. House,Kevin Hern,REP,720469,0,0,35,35,01
Tulsa,State Senate,John Haste,REP,720469,0,0,32,32,36
Tulsa,State Senate,Bill Day,REP,720469,0,0,38,38,36
Tulsa,State House,Laura Steele,REP,720469,0,0,24,24,98
Tulsa,State House,Dean Davis,REP,720469,0,0,41,41,98
Tulsa,Governor,Chris Powell,LIB,720469,0,0,0,0,
Tulsa,Governor,Rex Lawhorn,LIB,720469,0,0,0,0,
Tulsa,Corporation Commissioner,Ashley Nicole Mccray,DEM,720469,0,0,29,29,
Tulsa,Corporation Commissioner,Blake Cummings,DEM,720469,0,0,10,10,
Tulsa,U.S. House,Tim Gilpin,DEM,720469,0,0,16,16,01
Tulsa,U.S. House,Amanda Douglas,DEM,720469,0,0,23,23,01
Tulsa,Governor,Mick Cornett,REP,720470,0,0,163,163,
Tulsa,Governor,Kevin Stitt,REP,720470,0,0,250,250,
Tulsa,Lieutenant Governor,Dana Murphy,REP,720470,0,0,166,166,
Tulsa,Lieutenant Governor,Matt Pinnell,REP,720470,0,0,227,227,
Tulsa,State Auditor,Cindy Byrd,REP,720470,0,0,191,191,
Tulsa,State Auditor,Charlie Prater,REP,720470,0,0,172,172,
Tulsa,Attorney General,Mike Hunter,REP,720470,0,0,185,185,
Tulsa,Attorney General,Gentner Drummond,REP,720470,0,0,212,212,
Tulsa,Superintendent of Public Instruction,Joy Hofmeister,REP,720470,0,0,251,251,
Tulsa,Superintendent of Public Instruction,Linda Murphy,REP,720470,0,0,148,148,
Tulsa,Commissioner of Labor,Cathy Costello,REP,720470,0,0,179,179,
Tulsa,Commissioner of Labor,Leslie Osborn,REP,720470,0,0,196,196,
Tulsa,Corporation Commissioner,Bob Anthony,REP,720470,0,0,209,209,
Tulsa,Corporation Commissioner,Brian Bingman,REP,720470,0,0,173,173,
Tulsa,U.S. House,Tim Harris,REP,720470,0,0,201,201,01
Tulsa,U.S. House,Kevin Hern,REP,720470,0,0,198,198,01
Tulsa,Governor,Chris Powell,LIB,720470,0,0,1,1,
Tulsa,Governor,Rex Lawhorn,LIB,720470,0,0,1,1,
Tulsa,Corporation Commissioner,Ashley Nicole Mccray,DEM,720470,0,0,68,68,
Tulsa,Corporation Commissioner,Blake Cummings,DEM,720470,0,0,33,33,
Tulsa,U.S. House,Tim Gilpin,DEM,720470,0,0,51,51,01
Tulsa,U.S. House,Amanda Douglas,DEM,720470,0,0,51,51,01
Tulsa,Governor,Mick Cornett,REP,720471,0,0,84,84,
Tulsa,Governor,Kevin Stitt,REP,720471,0,0,162,162,
Tulsa,Lieutenant Governor,Dana Murphy,REP,720471,0,0,73,73,
Tulsa,Lieutenant Governor,Matt Pinnell,REP,720471,0,0,163,163,
Tulsa,State Auditor,Cindy Byrd,REP,720471,0,0,134,134,
Tulsa,State Auditor,Charlie Prater,REP,720471,0,0,98,98,
Tulsa,Attorney General,Mike Hunter,REP,720471,0,0,110,110,
Tulsa,Attorney General,Gentner Drummond,REP,720471,0,0,132,132,
Tulsa,Superintendent of Public Instruction,Joy Hofmeister,REP,720471,0,0,142,142,
Tulsa,Superintendent of Public Instruction,Linda Murphy,REP,720471,0,0,96,96,
Tulsa,Commissioner of Labor,Cathy Costello,REP,720471,0,0,105,105,
Tulsa,Commissioner of Labor,Leslie Osborn,REP,720471,0,0,125,125,
Tulsa,Corporation Commissioner,Bob Anthony,REP,720471,0,0,136,136,
Tulsa,Corporation Commissioner,Brian Bingman,REP,720471,0,0,94,94,
Tulsa,U.S. House,Tim Harris,REP,720471,0,0,112,112,01
Tulsa,U.S. House,Kevin Hern,REP,720471,0,0,127,127,01
Tulsa,Governor,Chris Powell,LIB,720471,0,0,0,0,
Tulsa,Governor,Rex Lawhorn,LIB,720471,0,0,0,0,
Tulsa,Corporation Commissioner,Ashley Nicole Mccray,DEM,720471,0,0,35,35,
Tulsa,Corporation Commissioner,Blake Cummings,DEM,720471,0,0,12,12,
Tulsa,U.S. House,Tim Gilpin,DEM,720471,0,0,26,26,01
Tulsa,U.S. House,Amanda Douglas,DEM,720471,0,0,22,22,01
Tulsa,Governor,Mick Cornett,REP,720472,0,0,76,76,
Tulsa,Governor,Kevin Stitt,REP,720472,0,0,114,114,
Tulsa,Lieutenant Governor,Dana Murphy,REP,720472,0,0,71,71,
Tulsa,Lieutenant Governor,Matt Pinnell,REP,720472,0,0,108,108,
Tulsa,State Auditor,Cindy Byrd,REP,720472,0,0,93,93,
Tulsa,State Auditor,Charlie Prater,REP,720472,0,0,85,85,
Tulsa,Attorney General,Mike Hunter,REP,720472,0,0,89,89,
Tulsa,Attorney General,Gentner Drummond,REP,720472,0,0,98,98,
Tulsa,Superintendent of Public Instruction,Joy Hofmeister,REP,720472,0,0,101,101,
Tulsa,Superintendent of Public Instruction,Linda Murphy,REP,720472,0,0,82,82,
Tulsa,Commissioner of Labor,Cathy Costello,REP,720472,0,0,97,97,
Tulsa,Commissioner of Labor,Leslie Osborn,REP,720472,0,0,81,81,
Tulsa,Corporation Commissioner,Bob Anthony,REP,720472,0,0,101,101,
Tulsa,Corporation Commissioner,Brian Bingman,REP,720472,0,0,81,81,
Tulsa,U.S. House,Tim Harris,REP,720472,0,0,91,91,01
Tulsa,U.S. House,Kevin Hern,REP,720472,0,0,95,95,01
Tulsa,State House,Stan May,REP,720472,0,0,115,115,80
Tulsa,State House,Mike Ritze,REP,720472,0,0,69,69,80
Tulsa,Governor,Chris Powell,LIB,720472,0,0,0,0,
Tulsa,Governor,Rex Lawhorn,LIB,720472,0,0,0,0,
Tulsa,Corporation Commissioner,Ashley Nicole Mccray,DEM,720472,0,0,31,31,
Tulsa,Corporation Commissioner,Blake Cummings,DEM,720472,0,0,7,7,
Tulsa,U.S. House,Tim Gilpin,DEM,720472,0,0,17,17,01
Tulsa,U.S. House,Amanda Douglas,DEM,720472,0,0,21,21,01
Tulsa,Governor,Mick Cornett,REP,720473,0,0,87,87,
Tulsa,Governor,Kevin Stitt,REP,720473,0,0,154,154,
Tulsa,Lieutenant Governor,Dana Murphy,REP,720473,0,0,99,99,
Tulsa,Lieutenant Governor,Matt Pinnell,REP,720473,0,0,134,134,
Tulsa,State Auditor,Cindy Byrd,REP,720473,0,0,114,114,
Tulsa,State Auditor,Charlie Prater,REP,720473,0,0,113,113,
Tulsa,Attorney General,Mike Hunter,REP,720473,0,0,111,111,
Tulsa,Attorney General,Gentner Drummond,REP,720473,0,0,124,124,
Tulsa,Superintendent of Public Instruction,Joy Hofmeister,REP,720473,0,0,140,140,
Tulsa,Superintendent of Public Instruction,Linda Murphy,REP,720473,0,0,95,95,
Tulsa,Commissioner of Labor,Cathy Costello,REP,720473,0,0,115,115,
Tulsa,Commissioner of Labor,Leslie Osborn,REP,720473,0,0,116,116,
Tulsa,Corporation Commissioner,Bob Anthony,REP,720473,0,0,130,130,
Tulsa,Corporation Commissioner,Brian Bingman,REP,720473,0,0,98,98,
Tulsa,U.S. House,Tim Harris,REP,720473,0,0,119,119,01
Tulsa,U.S. House,Kevin Hern,REP,720473,0,0,117,117,01
Tulsa,State House,Stan May,REP,720473,0,0,122,122,80
Tulsa,State House,Mike Ritze,REP,720473,0,0,112,112,80
Tulsa,Governor,Chris Powell,LIB,720473,0,0,0,0,
Tulsa,Governor,Rex Lawhorn,LIB,720473,0,0,0,0,
Tulsa,Corporation Commissioner,Ashley Nicole Mccray,DEM,720473,0,0,55,55,
Tulsa,Corporation Commissioner,Blake Cummings,DEM,720473,0,0,18,18,
Tulsa,U.S. House,Tim Gilpin,DEM,720473,0,0,36,36,01
Tulsa,U.S. House,Amanda Douglas,DEM,720473,0,0,39,39,01
Tulsa,Governor,Mick Cornett,REP,720474,0,0,147,147,
Tulsa,Governor,Kevin Stitt,REP,720474,0,0,248,248,
Tulsa,Lieutenant Governor,Dana Murphy,REP,720474,0,0,173,173,
Tulsa,Lieutenant Governor,Matt Pinnell,REP,720474,0,0,217,217,
Tulsa,State Auditor,Cindy Byrd,REP,720474,0,0,204,204,
Tulsa,State Auditor,Charlie Prater,REP,720474,0,0,175,175,
Tulsa,Attorney General,Mike Hunter,REP,720474,0,0,195,195,
Tulsa,Attorney General,Gentner Drummond,REP,720474,0,0,194,194,
Tulsa,Superintendent of Public Instruction,Joy Hofmeister,REP,720474,0,0,228,228,
Tulsa,Superintendent of Public Instruction,Linda Murphy,REP,720474,0,0,163,163,
Tulsa,Commissioner of Labor,Cathy Costello,REP,720474,0,0,202,202,
Tulsa,Commissioner of Labor,Leslie Osborn,REP,720474,0,0,178,178,
Tulsa,Corporation Commissioner,Bob Anthony,REP,720474,0,0,193,193,
Tulsa,Corporation Commissioner,Brian Bingman,REP,720474,0,0,186,186,
Tulsa,U.S. House,Tim Harris,REP,720474,0,0,196,196,01
Tulsa,U.S. House,Kevin Hern,REP,720474,0,0,197,197,01
Tulsa,Governor,Chris Powell,LIB,720474,0,0,0,0,
Tulsa,Governor,Rex Lawhorn,LIB,720474,0,0,0,0,
Tulsa,Corporation Commissioner,Ashley Nicole Mccray,DEM,720474,0,0,106,106,
Tulsa,Corporation Commissioner,Blake Cummings,DEM,720474,0,0,24,24,
Tulsa,U.S. House,Tim Gilpin,DEM,720474,0,0,62,62,01
Tulsa,U.S. House,Amanda Douglas,DEM,720474,0,0,70,70,01
Tulsa,Governor,Mick Cornett,REP,720475,0,0,208,208,
Tulsa,Governor,Kevin Stitt,REP,720475,0,0,289,289,
Tulsa,Lieutenant Governor,Dana Murphy,REP,720475,0,0,196,196,
Tulsa,Lieutenant Governor,Matt Pinnell,REP,720475,0,0,287,287,
Tulsa,State Auditor,Cindy Byrd,REP,720475,0,0,233,233,
Tulsa,State Auditor,Charlie Prater,REP,720475,0,0,224,224,
Tulsa,Attorney General,Mike Hunter,REP,720475,0,0,242,242,
Tulsa,Attorney General,Gentner Drummond,REP,720475,0,0,243,243,
Tulsa,Superintendent of Public Instruction,Joy Hofmeister,REP,720475,0,0,298,298,
Tulsa,Superintendent of Public Instruction,Linda Murphy,REP,720475,0,0,179,179,
Tulsa,Commissioner of Labor,Cathy Costello,REP,720475,0,0,232,232,
Tulsa,Commissioner of Labor,Leslie Osborn,REP,720475,0,0,222,222,
Tulsa,Corporation Commissioner,Bob Anthony,REP,720475,0,0,243,243,
Tulsa,Corporation Commissioner,Brian Bingman,REP,720475,0,0,223,223,
Tulsa,U.S. House,Tim Harris,REP,720475,0,0,223,223,01
Tulsa,U.S. House,Kevin Hern,REP,720475,0,0,266,266,01
Tulsa,State Senate,John Haste,REP,720475,0,0,227,227,36
Tulsa,State Senate,Bill Day,REP,720475,0,0,247,247,36
Tulsa,Governor,Chris Powell,LIB,720475,0,0,2,2,
Tulsa,Governor,Rex Lawhorn,LIB,720475,0,0,1,1,
Tulsa,Corporation Commissioner,Ashley Nicole Mccray,DEM,720475,0,0,117,117,
Tulsa,Corporation Commissioner,Blake Cummings,DEM,720475,0,0,31,31,
Tulsa,U.S. House,Tim Gilpin,DEM,720475,0,0,76,76,01
Tulsa,U.S. House,Amanda Douglas,DEM,720475,0,0,75,75,01
Tulsa,Governor,Mick Cornett,REP,720476,0,0,81,81,
Tulsa,Governor,Kevin Stitt,REP,720476,0,0,119,119,
Tulsa,Lieutenant Governor,Dana Murphy,REP,720476,0,0,62,62,
Tulsa,Lieutenant Governor,Matt Pinnell,REP,720476,0,0,127,127,
Tulsa,State Auditor,Cindy Byrd,REP,720476,0,0,100,100,
Tulsa,State Auditor,Charlie Prater,REP,720476,0,0,83,83,
Tulsa,Attorney General,Mike Hunter,REP,720476,0,0,86,86,
Tulsa,Attorney General,Gentner Drummond,REP,720476,0,0,106,106,
Tulsa,Superintendent of Public Instruction,Joy Hofmeister,REP,720476,0,0,118,118,
Tulsa,Superintendent of Public Instruction,Linda Murphy,REP,720476,0,0,75,75,
Tulsa,Commissioner of Labor,Cathy Costello,REP,720476,0,0,92,92,
Tulsa,Commissioner of Labor,Leslie Osborn,REP,720476,0,0,93,93,
Tulsa,Corporation Commissioner,Bob Anthony,REP,720476,0,0,108,108,
Tulsa,Corporation Commissioner,Brian Bingman,REP,720476,0,0,77,77,
Tulsa,U.S. House,Tim Harris,REP,720476,0,0,81,81,01
Tulsa,U.S. House,Kevin Hern,REP,720476,0,0,117,117,01
Tulsa,State House,Laura Steele,REP,720476,0,0,73,73,98
Tulsa,State House,Dean Davis,REP,720476,0,0,110,110,98
Tulsa,Governor,Chris Powell,LIB,720476,0,0,1,1,
Tulsa,Governor,Rex Lawhorn,LIB,720476,0,0,0,0,
Tulsa,Corporation Commissioner,Ashley Nicole Mccray,DEM,720476,0,0,37,37,
Tulsa,Corporation Commissioner,Blake Cummings,DEM,720476,0,0,24,24,
Tulsa,U.S. House,Tim Gilpin,DEM,720476,0,0,27,27,01
Tulsa,U.S. House,Amanda Douglas,DEM,720476,0,0,34,34,01
Tulsa,Governor,Mick Cornett,REP,720501,0,0,72,72,
Tulsa,Governor,Kevin Stitt,REP,720501,0,0,154,154,
Tulsa,Lieutenant Governor,Dana Murphy,REP,720501,0,0,89,89,
Tulsa,Lieutenant Governor,Matt Pinnell,REP,720501,0,0,129,129,
Tulsa,State Auditor,Cindy Byrd,REP,720501,0,0,87,87,
Tulsa,State Auditor,Charlie Prater,REP,720501,0,0,123,123,
Tulsa,Attorney General,Mike Hunter,REP,720501,0,0,63,63,
Tulsa,Attorney General,Gentner Drummond,REP,720501,0,0,155,155,
Tulsa,Superintendent of Public Instruction,Joy Hofmeister,REP,720501,0,0,137,137,
Tulsa,Superintendent of Public Instruction,Linda Murphy,REP,720501,0,0,86,86,
Tulsa,Commissioner of Labor,Cathy Costello,REP,720501,0,0,118,118,
Tulsa,Commissioner of Labor,Leslie Osborn,REP,720501,0,0,96,96,
Tulsa,Corporation Commissioner,Bob Anthony,REP,720501,0,0,92,92,
Tulsa,Corporation Commissioner,Brian Bingman,REP,720501,0,0,121,121,
Tulsa,U.S. House,Tim Harris,REP,720501,0,0,74,74,01
Tulsa,U.S. House,Kevin Hern,REP,720501,0,0,145,145,01
Tulsa,State House,Sean Roberts,REP,720501,0,0,118,118,36
Tulsa,State House,Louise Redcorn,REP,720501,0,0,100,100,36
Tulsa,Governor,Chris Powell,LIB,720501,0,0,1,1,
Tulsa,Governor,Rex Lawhorn,LIB,720501,0,0,0,0,
Tulsa,Corporation Commissioner,Ashley Nicole Mccray,DEM,720501,0,0,26,26,
Tulsa,Corporation Commissioner,Blake Cummings,DEM,720501,0,0,11,11,
Tulsa,U.S. House,Tim Gilpin,DEM,720501,0,0,21,21,01
Tulsa,U.S. House,Amanda Douglas,DEM,720501,0,0,16,16,01
Tulsa,Governor,Mick Cornett,REP,720502,0,0,121,121,
Tulsa,Governor,Kevin Stitt,REP,720502,0,0,215,215,
Tulsa,Lieutenant Governor,Dana Murphy,REP,720502,0,0,141,141,
Tulsa,Lieutenant Governor,Matt Pinnell,REP,720502,0,0,185,185,
Tulsa,State Auditor,Cindy Byrd,REP,720502,0,0,150,150,
Tulsa,State Auditor,Charlie Prater,REP,720502,0,0,177,177,
Tulsa,Attorney General,Mike Hunter,REP,720502,0,0,124,124,
Tulsa,Attorney General,Gentner Drummond,REP,720502,0,0,208,208,
Tulsa,Superintendent of Public Instruction,Joy Hofmeister,REP,720502,0,0,180,180,
Tulsa,Superintendent of Public Instruction,Linda Murphy,REP,720502,0,0,151,151,
Tulsa,Commissioner of Labor,Cathy Costello,REP,720502,0,0,152,152,
Tulsa,Commissioner of Labor,Leslie Osborn,REP,720502,0,0,172,172,
Tulsa,Corporation Commissioner,Bob Anthony,REP,720502,0,0,162,162,
Tulsa,Corporation Commissioner,Brian Bingman,REP,720502,0,0,159,159,
Tulsa,U.S. House,Tim Harris,REP,720502,0,0,120,120,01
Tulsa,U.S. House,Kevin Hern,REP,720502,0,0,209,209,01
Tulsa,Governor,Chris Powell,LIB,720502,0,0,2,2,
Tulsa,Governor,Rex Lawhorn,LIB,720502,0,0,1,1,
Tulsa,Corporation Commissioner,Ashley Nicole Mccray,DEM,720502,0,0,53,53,
Tulsa,Corporation Commissioner,Blake Cummings,DEM,720502,0,0,38,38,
Tulsa,U.S. House,Tim Gilpin,DEM,720502,0,0,52,52,01
Tulsa,U.S. House,Amanda Douglas,DEM,720502,0,0,38,38,01
Tulsa,Governor,Mick Cornett,REP,720503,0,0,55,55,
Tulsa,Governor,Kevin Stitt,REP,720503,0,0,155,155,
Tulsa,Lieutenant Governor,Dana Murphy,REP,720503,0,0,78,78,
Tulsa,Lieutenant Governor,Matt Pinnell,REP,720503,0,0,131,131,
Tulsa,State Auditor,Cindy Byrd,REP,720503,0,0,93,93,
Tulsa,State Auditor,Charlie Prater,REP,720503,0,0,109,109,
Tulsa,Attorney General,Mike Hunter,REP,720503,0,0,87,87,
Tulsa,Attorney General,Gentner Drummond,REP,720503,0,0,119,119,
Tulsa,Superintendent of Public Instruction,Joy Hofmeister,REP,720503,0,0,120,120,
Tulsa,Superintendent of Public Instruction,Linda Murphy,REP,720503,0,0,88,88,
Tulsa,Commissioner of Labor,Cathy Costello,REP,720503,0,0,95,95,
Tulsa,Commissioner of Labor,Leslie Osborn,REP,720503,0,0,106,106,
Tulsa,Corporation Commissioner,Bob Anthony,REP,720503,0,0,109,109,
Tulsa,Corporation Commissioner,Brian Bingman,REP,720503,0,0,96,96,
Tulsa,U.S. House,Tim Harris,REP,720503,0,0,74,74,01
Tulsa,U.S. House,Kevin Hern,REP,720503,0,0,136,136,01
Tulsa,Governor,Chris Powell,LIB,720503,0,0,0,0,
Tulsa,Governor,Rex Lawhorn,LIB,720503,0,0,0,0,
Tulsa,Corporation Commissioner,Ashley Nicole Mccray,DEM,720503,0,0,36,36,
Tulsa,Corporation Commissioner,Blake Cummings,DEM,720503,0,0,21,21,
Tulsa,U.S. House,Tim Gilpin,DEM,720503,0,0,24,24,01
Tulsa,U.S. House,Amanda Douglas,DEM,720503,0,0,33,33,01
Tulsa,Governor,Mick Cornett,REP,720504,0,0,105,105,
Tulsa,Governor,Kevin Stitt,REP,720504,0,0,187,187,
Tulsa,Lieutenant Governor,Dana Murphy,REP,720504,0,0,115,115,
Tulsa,Lieutenant Governor,Matt Pinnell,REP,720504,0,0,174,174,
Tulsa,State Auditor,Cindy Byrd,REP,720504,0,0,119,119,
Tulsa,State Auditor,Charlie Prater,REP,720504,0,0,165,165,
Tulsa,Attorney General,Mike Hunter,REP,720504,0,0,112,112,
Tulsa,Attorney General,Gentner Drummond,REP,720504,0,0,177,177,
Tulsa,Superintendent of Public Instruction,Joy Hofmeister,REP,720504,0,0,151,151,
Tulsa,Superintendent of Public Instruction,Linda Murphy,REP,720504,0,0,133,133,
Tulsa,Commissioner of Labor,Cathy Costello,REP,720504,0,0,137,137,
Tulsa,Commissioner of Labor,Leslie Osborn,REP,720504,0,0,146,146,
Tulsa,Corporation Commissioner,Bob Anthony,REP,720504,0,0,146,146,
Tulsa,Corporation Commissioner,Brian Bingman,REP,720504,0,0,136,136,
Tulsa,U.S. House,Tim Harris,REP,720504,0,0,103,103,01
Tulsa,U.S. House,Kevin Hern,REP,720504,0,0,189,189,01
Tulsa,Governor,Chris Powell,LIB,720504,0,0,0,0,
Tulsa,Governor,Rex Lawhorn,LIB,720504,0,0,0,0,
Tulsa,Corporation Commissioner,Ashley Nicole Mccray,DEM,720504,0,0,45,45,
Tulsa,Corporation Commissioner,Blake Cummings,DEM,720504,0,0,26,26,
Tulsa,U.S. House,Tim Gilpin,DEM,720504,0,0,32,32,01
Tulsa,U.S. House,Amanda Douglas,DEM,720504,0,0,39,39,01
Tulsa,Governor,Mick Cornett,REP,720551,0,0,18,18,
Tulsa,Governor,Kevin Stitt,REP,720551,0,0,38,38,
Tulsa,Lieutenant Governor,Dana Murphy,REP,720551,0,0,25,25,
Tulsa,Lieutenant Governor,Matt Pinnell,REP,720551,0,0,31,31,
Tulsa,State Auditor,Cindy Byrd,REP,720551,0,0,22,22,
Tulsa,State Auditor,Charlie Prater,REP,720551,0,0,30,30,
Tulsa,Attorney General,Mike Hunter,REP,720551,0,0,21,21,
Tulsa,Attorney General,Gentner Drummond,REP,720551,0,0,35,35,
Tulsa,Superintendent of Public Instruction,Joy Hofmeister,REP,720551,0,0,21,21,
Tulsa,Superintendent of Public Instruction,Linda Murphy,REP,720551,0,0,32,32,
Tulsa,Commissioner of Labor,Cathy Costello,REP,720551,0,0,24,24,
Tulsa,Commissioner of Labor,Leslie Osborn,REP,720551,0,0,28,28,
Tulsa,Corporation Commissioner,Bob Anthony,REP,720551,0,0,28,28,
Tulsa,Corporation Commissioner,Brian Bingman,REP,720551,0,0,26,26,
Tulsa,U.S. House,Tim Harris,REP,720551,0,0,23,23,01
Tulsa,U.S. House,Kevin Hern,REP,720551,0,0,32,32,01
Tulsa,Governor,Chris Powell,LIB,720551,0,0,0,0,
Tulsa,Governor,Rex Lawhorn,LIB,720551,0,0,0,0,
Tulsa,Corporation Commissioner,Ashley Nicole Mccray,DEM,720551,0,0,16,16,
Tulsa,Corporation Commissioner,Blake Cummings,DEM,720551,0,0,8,8,
Tulsa,U.S. House,Tim Gilpin,DEM,720551,0,0,15,15,01
Tulsa,U.S. House,Amanda Douglas,DEM,720551,0,0,9,9,01
Tulsa,Governor,Mick Cornett,REP,720552,0,0,32,32,
Tulsa,Governor,Kevin Stitt,REP,720552,0,0,74,74,
Tulsa,Lieutenant Governor,Dana Murphy,REP,720552,0,0,37,37,
Tulsa,Lieutenant Governor,Matt Pinnell,REP,720552,0,0,67,67,
Tulsa,State Auditor,Cindy Byrd,REP,720552,0,0,54,54,
Tulsa,State Auditor,Charlie Prater,REP,720552,0,0,44,44,
Tulsa,Attorney General,Mike Hunter,REP,720552,0,0,38,38,
Tulsa,Attorney General,Gentner Drummond,REP,720552,0,0,68,68,
Tulsa,Superintendent of Public Instruction,Joy Hofmeister,REP,720552,0,0,62,62,
Tulsa,Superintendent of Public Instruction,Linda Murphy,REP,720552,0,0,41,41,
Tulsa,Commissioner of Labor,Cathy Costello,REP,720552,0,0,45,45,
Tulsa,Commissioner of Labor,Leslie Osborn,REP,720552,0,0,59,59,
Tulsa,Corporation Commissioner,Bob Anthony,REP,720552,0,0,48,48,
Tulsa,Corporation Commissioner,Brian Bingman,REP,720552,0,0,54,54,
Tulsa,U.S. House,Tim Harris,REP,720552,0,0,49,49,01
Tulsa,U.S. House,Kevin Hern,REP,720552,0,0,57,57,01
Tulsa,State House,Sean Roberts,REP,720552,0,0,45,45,36
Tulsa,State House,Louise Redcorn,REP,720552,0,0,58,58,36
Tulsa,Governor,Chris Powell,LIB,720552,0,0,0,0,
Tulsa,Governor,Rex Lawhorn,LIB,720552,0,0,0,0,
Tulsa,Corporation Commissioner,Ashley Nicole Mccray,DEM,720552,0,0,17,17,
Tulsa,Corporation Commissioner,Blake Cummings,DEM,720552,0,0,19,19,
Tulsa,U.S. House,Tim Gilpin,DEM,720552,0,0,23,23,01
Tulsa,U.S. House,Amanda Douglas,DEM,720552,0,0,13,13,01
Tulsa,Governor,Mick Cornett,REP,720553,0,0,26,26,
Tulsa,Governor,Kevin Stitt,REP,720553,0,0,49,49,
Tulsa,Lieutenant Governor,Dana Murphy,REP,720553,0,0,23,23,
Tulsa,Lieutenant Governor,Matt Pinnell,REP,720553,0,0,52,52,
Tulsa,State Auditor,Cindy Byrd,REP,720553,0,0,36,36,
Tulsa,State Auditor,Charlie Prater,REP,720553,0,0,39,39,
Tulsa,Attorney General,Mike Hunter,REP,720553,0,0,29,29,
Tulsa,Attorney General,Gentner Drummond,REP,720553,0,0,46,46,
Tulsa,Superintendent of Public Instruction,Joy Hofmeister,REP,720553,0,0,41,41,
Tulsa,Superintendent of Public Instruction,Linda Murphy,REP,720553,0,0,33,33,
Tulsa,Commissioner of Labor,Cathy Costello,REP,720553,0,0,36,36,
Tulsa,Commissioner of Labor,Leslie Osborn,REP,720553,0,0,39,39,
Tulsa,Corporation Commissioner,Bob Anthony,REP,720553,0,0,33,33,
Tulsa,Corporation Commissioner,Brian Bingman,REP,720553,0,0,42,42,
Tulsa,U.S. House,Tim Harris,REP,720553,0,0,29,29,01
Tulsa,U.S. House,Kevin Hern,REP,720553,0,0,46,46,01
Tulsa,Governor,Chris Powell,LIB,720553,0,0,0,0,
Tulsa,Governor,Rex Lawhorn,LIB,720553,0,0,0,0,
Tulsa,Corporation Commissioner,Ashley Nicole Mccray,DEM,720553,0,0,10,10,
Tulsa,Corporation Commissioner,Blake Cummings,DEM,720553,0,0,9,9,
Tulsa,U.S. House,Tim Gilpin,DEM,720553,0,0,11,11,01
Tulsa,U.S. House,Amanda Douglas,DEM,720553,0,0,8,8,01
Tulsa,Governor,Mick Cornett,REP,720700,0,0,189,189,
Tulsa,Governor,Kevin Stitt,REP,720700,0,0,300,300,
Tulsa,Lieutenant Governor,Dana Murphy,REP,720700,0,0,167,167,
Tulsa,Lieutenant Governor,Matt Pinnell,REP,720700,0,0,312,312,
Tulsa,State Auditor,Cindy Byrd,REP,720700,0,0,266,266,
Tulsa,State Auditor,Charlie Prater,REP,720700,0,0,182,182,
Tulsa,Attorney General,Mike Hunter,REP,720700,0,0,225,225,
Tulsa,Attorney General,Gentner Drummond,REP,720700,0,0,251,251,
Tulsa,Superintendent of Public Instruction,Joy Hofmeister,REP,720700,0,0,324,324,
Tulsa,Superintendent of Public Instruction,Linda Murphy,REP,720700,0,0,151,151,
Tulsa,Commissioner of Labor,Cathy Costello,REP,720700,0,0,234,234,
Tulsa,Commissioner of Labor,Leslie Osborn,REP,720700,0,0,220,220,
Tulsa,Corporation Commissioner,Bob Anthony,REP,720700,0,0,252,252,
Tulsa,Corporation Commissioner,Brian Bingman,REP,720700,0,0,202,202,
Tulsa,U.S. House,Tim Harris,REP,720700,0,0,232,232,01
Tulsa,U.S. House,Kevin Hern,REP,720700,0,0,251,251,01
Tulsa,Governor,Chris Powell,LIB,720700,0,0,0,0,
Tulsa,Governor,Rex Lawhorn,LIB,720700,0,0,0,0,
Tulsa,Corporation Commissioner,Ashley Nicole Mccray,DEM,720700,0,0,60,60,
Tulsa,Corporation Commissioner,Blake Cummings,DEM,720700,0,0,26,26,
Tulsa,U.S. House,Tim Gilpin,DEM,720700,0,0,46,46,01
Tulsa,U.S. House,Amanda Douglas,DEM,720700,0,0,41,41,01
Tulsa,Governor,Mick Cornett,REP,720701,0,0,181,181,
Tulsa,Governor,Kevin Stitt,REP,720701,0,0,266,266,
Tulsa,Lieutenant Governor,Dana Murphy,REP,720701,0,0,156,156,
Tulsa,Lieutenant Governor,Matt Pinnell,REP,720701,0,0,283,283,
Tulsa,State Auditor,Cindy Byrd,REP,720701,0,0,252,252,
Tulsa,State Auditor,Charlie Prater,REP,720701,0,0,170,170,
Tulsa,Attorney General,Mike Hunter,REP,720701,0,0,206,206,
Tulsa,Attorney General,Gentner Drummond,REP,720701,0,0,230,230,
Tulsa,Superintendent of Public Instruction,Joy Hofmeister,REP,720701,0,0,286,286,
Tulsa,Superintendent of Public Instruction,Linda Murphy,REP,720701,0,0,145,145,
Tulsa,Commissioner of Labor,Cathy Costello,REP,720701,0,0,210,210,
Tulsa,Commissioner of Labor,Leslie Osborn,REP,720701,0,0,208,208,
Tulsa,Corporation Commissioner,Bob Anthony,REP,720701,0,0,196,196,
Tulsa,Corporation Commissioner,Brian Bingman,REP,720701,0,0,222,222,
Tulsa,U.S. House,Tim Harris,REP,720701,0,0,215,215,01
Tulsa,U.S. House,Kevin Hern,REP,720701,0,0,218,218,01
Tulsa,State House,Lonnie Sims,REP,720701,0,0,277,277,68
Tulsa,State House,Nicole Nixon,REP,720701,0,0,157,157,68
Tulsa,Governor,Chris Powell,LIB,720701,0,0,0,0,
Tulsa,Governor,Rex Lawhorn,LIB,720701,0,0,0,0,
Tulsa,Corporation Commissioner,Ashley Nicole Mccray,DEM,720701,0,0,93,93,
Tulsa,Corporation Commissioner,Blake Cummings,DEM,720701,0,0,30,30,
Tulsa,U.S. House,Tim Gilpin,DEM,720701,0,0,63,63,01
Tulsa,U.S. House,Amanda Douglas,DEM,720701,0,0,62,62,01
Tulsa,State House,Angela Statum,DEM,720701,0,0,50,50,68
Tulsa,State House,Michael Ross,DEM,720701,0,0,76,76,68
Tulsa,Governor,Mick Cornett,REP,720702,0,0,70,70,
Tulsa,Governor,Kevin Stitt,REP,720702,0,0,161,161,
Tulsa,Lieutenant Governor,Dana Murphy,REP,720702,0,0,64,64,
Tulsa,Lieutenant Governor,Matt Pinnell,REP,720702,0,0,161,161,
Tulsa,State Auditor,Cindy Byrd,REP,720702,0,0,131,131,
Tulsa,State Auditor,Charlie Prater,REP,720702,0,0,89,89,
Tulsa,Attorney General,Mike Hunter,REP,720702,0,0,104,104,
Tulsa,Attorney General,Gentner Drummond,REP,720702,0,0,121,121,
Tulsa,Superintendent of Public Instruction,Joy Hofmeister,REP,720702,0,0,130,130,
Tulsa,Superintendent of Public Instruction,Linda Murphy,REP,720702,0,0,93,93,
Tulsa,Commissioner of Labor,Cathy Costello,REP,720702,0,0,128,128,
Tulsa,Commissioner of Labor,Leslie Osborn,REP,720702,0,0,91,91,
Tulsa,Corporation Commissioner,Bob Anthony,REP,720702,0,0,132,132,
Tulsa,Corporation Commissioner,Brian Bingman,REP,720702,0,0,82,82,
Tulsa,U.S. House,Tim Harris,REP,720702,0,0,97,97,01
Tulsa,U.S. House,Kevin Hern,REP,720702,0,0,130,130,01
Tulsa,Governor,Chris Powell,LIB,720702,0,0,0,0,
Tulsa,Governor,Rex Lawhorn,LIB,720702,0,0,0,0,
Tulsa,Corporation Commissioner,Ashley Nicole Mccray,DEM,720702,0,0,60,60,
Tulsa,Corporation Commissioner,Blake Cummings,DEM,720702,0,0,21,21,
Tulsa,U.S. House,Tim Gilpin,DEM,720702,0,0,53,53,01
Tulsa,U.S. House,Amanda Douglas,DEM,720702,0,0,31,31,01
Tulsa,Governor,Mick Cornett,REP,720703,0,0,159,159,
Tulsa,Governor,Kevin Stitt,REP,720703,0,0,339,339,
Tulsa,Lieutenant Governor,Dana Murphy,REP,720703,0,0,161,161,
Tulsa,Lieutenant Governor,Matt Pinnell,REP,720703,0,0,319,319,
Tulsa,State Auditor,Cindy Byrd,REP,720703,0,0,263,263,
Tulsa,State Auditor,Charlie Prater,REP,720703,0,0,189,189,
Tulsa,Attorney General,Mike Hunter,REP,720703,0,0,227,227,
Tulsa,Attorney General,Gentner Drummond,REP,720703,0,0,250,250,
Tulsa,Superintendent of Public Instruction,Joy Hofmeister,REP,720703,0,0,301,301,
Tulsa,Superintendent of Public Instruction,Linda Murphy,REP,720703,0,0,180,180,
Tulsa,Commissioner of Labor,Cathy Costello,REP,720703,0,0,232,232,
Tulsa,Commissioner of Labor,Leslie Osborn,REP,720703,0,0,215,215,
Tulsa,Corporation Commissioner,Bob Anthony,REP,720703,0,0,225,225,
Tulsa,Corporation Commissioner,Brian Bingman,REP,720703,0,0,232,232,
Tulsa,U.S. House,Tim Harris,REP,720703,0,0,235,235,01
Tulsa,U.S. House,Kevin Hern,REP,720703,0,0,240,240,01
Tulsa,State House,Lonnie Sims,REP,720703,0,0,349,349,68
Tulsa,State House,Nicole Nixon,REP,720703,0,0,127,127,68
Tulsa,Governor,Chris Powell,LIB,720703,0,0,0,0,
Tulsa,Governor,Rex Lawhorn,LIB,720703,0,0,0,0,
Tulsa,Corporation Commissioner,Ashley Nicole Mccray,DEM,720703,0,0,110,110,
Tulsa,Corporation Commissioner,Blake Cummings,DEM,720703,0,0,47,47,
Tulsa,U.S. House,Tim Gilpin,DEM,720703,0,0,102,102,01
Tulsa,U.S. House,Amanda Douglas,DEM,720703,0,0,56,56,01
Tulsa,State House,Angela Statum,DEM,720703,0,0,55,55,68
Tulsa,State House,Michael Ross,DEM,720703,0,0,103,103,68
Tulsa,Governor,Mick Cornett,REP,720704,0,0,227,227,
Tulsa,Governor,Kevin Stitt,REP,720704,0,0,366,366,
Tulsa,Lieutenant Governor,Dana Murphy,REP,720704,0,0,202,202,
Tulsa,Lieutenant Governor,Matt Pinnell,REP,720704,0,0,359,359,
Tulsa,State Auditor,Cindy Byrd,REP,720704,0,0,318,318,
Tulsa,State Auditor,Charlie Prater,REP,720704,0,0,217,217,
Tulsa,Attorney General,Mike Hunter,REP,720704,0,0,264,264,
Tulsa,Attorney General,Gentner Drummond,REP,720704,0,0,314,314,
Tulsa,Superintendent of Public Instruction,Joy Hofmeister,REP,720704,0,0,375,375,
Tulsa,Superintendent of Public Instruction,Linda Murphy,REP,720704,0,0,193,193,
Tulsa,Commissioner of Labor,Cathy Costello,REP,720704,0,0,271,271,
Tulsa,Commissioner of Labor,Leslie Osborn,REP,720704,0,0,270,270,
Tulsa,Corporation Commissioner,Bob Anthony,REP,720704,0,0,276,276,
Tulsa,Corporation Commissioner,Brian Bingman,REP,720704,0,0,257,257,
Tulsa,U.S. House,Tim Harris,REP,720704,0,0,269,269,01
Tulsa,U.S. House,Kevin Hern,REP,720704,0,0,312,312,01
Tulsa,Governor,Chris Powell,LIB,720704,0,0,0,0,
Tulsa,Governor,Rex Lawhorn,LIB,720704,0,0,0,0,
Tulsa,Corporation Commissioner,Ashley Nicole Mccray,DEM,720704,0,0,53,53,
Tulsa,Corporation Commissioner,Blake Cummings,DEM,720704,0,0,31,31,
Tulsa,U.S. House,Tim Gilpin,DEM,720704,0,0,42,42,01
Tulsa,U.S. House,Amanda Douglas,DEM,720704,0,0,43,43,01
Tulsa,Governor,Mick Cornett,REP,720705,0,0,66,66,
Tulsa,Governor,Kevin Stitt,REP,720705,0,0,138,138,
Tulsa,Lieutenant Governor,Dana Murphy,REP,720705,0,0,64,64,
Tulsa,Lieutenant Governor,Matt Pinnell,REP,720705,0,0,133,133,
Tulsa,State Auditor,Cindy Byrd,REP,720705,0,0,88,88,
Tulsa,State Auditor,Charlie Prater,REP,720705,0,0,102,102,
Tulsa,Attorney General,Mike Hunter,REP,720705,0,0,90,90,
Tulsa,Attorney General,Gentner Drummond,REP,720705,0,0,108,108,
Tulsa,Superintendent of Public Instruction,Joy Hofmeister,REP,720705,0,0,113,113,
Tulsa,Superintendent of Public Instruction,Linda Murphy,REP,720705,0,0,86,86,
Tulsa,Commissioner of Labor,Cathy Costello,REP,720705,0,0,99,99,
Tulsa,Commissioner of Labor,Leslie Osborn,REP,720705,0,0,94,94,
Tulsa,Corporation Commissioner,Bob Anthony,REP,720705,0,0,79,79,
Tulsa,Corporation Commissioner,Brian Bingman,REP,720705,0,0,114,114,
Tulsa,U.S. House,Tim Harris,REP,720705,0,0,64,64,01
Tulsa,U.S. House,Kevin Hern,REP,720705,0,0,135,135,01
Tulsa,State House,Mark Lawson,REP,720705,0,0,86,86,30
Tulsa,State House,Kent Glesener,REP,720705,0,0,110,110,30
Tulsa,Governor,Chris Powell,LIB,720705,0,0,0,0,
Tulsa,Governor,Rex Lawhorn,LIB,720705,0,0,0,0,
Tulsa,Corporation Commissioner,Ashley Nicole Mccray,DEM,720705,0,0,40,40,
Tulsa,Corporation Commissioner,Blake Cummings,DEM,720705,0,0,16,16,
Tulsa,U.S. House,Tim Gilpin,DEM,720705,0,0,33,33,01
Tulsa,U.S. House,Amanda Douglas,DEM,720705,0,0,23,23,01
Tulsa,Governor,Mick Cornett,REP,720706,0,0,133,133,
Tulsa,Governor,Kevin Stitt,REP,720706,0,0,297,297,
Tulsa,Lieutenant Governor,Dana Murphy,REP,720706,0,0,151,151,
Tulsa,Lieutenant Governor,Matt Pinnell,REP,720706,0,0,268,268,
Tulsa,State Auditor,Cindy Byrd,REP,720706,0,0,206,206,
Tulsa,State Auditor,Charlie Prater,REP,720706,0,0,206,206,
Tulsa,Attorney General,Mike Hunter,REP,720706,0,0,189,189,
Tulsa,Attorney General,Gentner Drummond,REP,720706,0,0,233,233,
Tulsa,Superintendent of Public Instruction,Joy Hofmeister,REP,720706,0,0,221,221,
Tulsa,Superintendent of Public Instruction,Linda Murphy,REP,720706,0,0,203,203,
Tulsa,Commissioner of Labor,Cathy Costello,REP,720706,0,0,197,197,
Tulsa,Commissioner of Labor,Leslie Osborn,REP,720706,0,0,215,215,
Tulsa,Corporation Commissioner,Bob Anthony,REP,720706,0,0,165,165,
Tulsa,Corporation Commissioner,Brian Bingman,REP,720706,0,0,247,247,
Tulsa,U.S. House,Tim Harris,REP,720706,0,0,138,138,01
Tulsa,U.S. House,Kevin Hern,REP,720706,0,0,285,285,01
Tulsa,State House,Lonnie Sims,REP,720706,0,0,230,230,68
Tulsa,State House,Nicole Nixon,REP,720706,0,0,180,180,68
Tulsa,Governor,Chris Powell,LIB,720706,0,0,1,1,
Tulsa,Governor,Rex Lawhorn,LIB,720706,0,0,1,1,
Tulsa,Corporation Commissioner,Ashley Nicole Mccray,DEM,720706,0,0,77,77,
Tulsa,Corporation Commissioner,Blake Cummings,DEM,720706,0,0,22,22,
Tulsa,U.S. House,Tim Gilpin,DEM,720706,0,0,54,54,01
Tulsa,U.S. House,Amanda Douglas,DEM,720706,0,0,45,45,01
Tulsa,State House,Angela Statum,DEM,720706,0,0,47,47,68
Tulsa,State House,Michael Ross,DEM,720706,0,0,51,51,68
Tulsa,Governor,Mick Cornett,REP,720707,0,0,63,63,
Tulsa,Governor,Kevin Stitt,REP,720707,0,0,120,120,
Tulsa,Lieutenant Governor,Dana Murphy,REP,720707,0,0,77,77,
Tulsa,Lieutenant Governor,Matt Pinnell,REP,720707,0,0,101,101,
Tulsa,State Auditor,Cindy Byrd,REP,720707,0,0,85,85,
Tulsa,State Auditor,Charlie Prater,REP,720707,0,0,87,87,
Tulsa,Attorney General,Mike Hunter,REP,720707,0,0,94,94,
Tulsa,Attorney General,Gentner Drummond,REP,720707,0,0,86,86,
Tulsa,Superintendent of Public Instruction,Joy Hofmeister,REP,720707,0,0,118,118,
Tulsa,Superintendent of Public Instruction,Linda Murphy,REP,720707,0,0,62,62,
Tulsa,Commissioner of Labor,Cathy Costello,REP,720707,0,0,77,77,
Tulsa,Commissioner of Labor,Leslie Osborn,REP,720707,0,0,95,95,
Tulsa,Corporation Commissioner,Bob Anthony,REP,720707,0,0,79,79,
Tulsa,Corporation Commissioner,Brian Bingman,REP,720707,0,0,96,96,
Tulsa,U.S. House,Tim Harris,REP,720707,0,0,66,66,01
Tulsa,U.S. House,Kevin Hern,REP,720707,0,0,115,115,01
Tulsa,State House,Lonnie Sims,REP,720707,0,0,103,103,68
Tulsa,State House,Nicole Nixon,REP,720707,0,0,65,65,68
Tulsa,Governor,Chris Powell,LIB,720707,0,0,0,0,
Tulsa,Governor,Rex Lawhorn,LIB,720707,0,0,0,0,
Tulsa,Corporation Commissioner,Ashley Nicole Mccray,DEM,720707,0,0,34,34,
Tulsa,Corporation Commissioner,Blake Cummings,DEM,720707,0,0,15,15,
Tulsa,U.S. House,Tim Gilpin,DEM,720707,0,0,24,24,01
Tulsa,U.S. House,Amanda Douglas,DEM,720707,0,0,25,25,01
Tulsa,State House,Angela Statum,DEM,720707,0,0,29,29,68
Tulsa,State House,Michael Ross,DEM,720707,0,0,20,20,68
Tulsa,Governor,Mick Cornett,REP,720708,0,0,90,90,
Tulsa,Governor,Kevin Stitt,REP,720708,0,0,181,181,
Tulsa,Lieutenant Governor,Dana Murphy,REP,720708,0,0,104,104,
Tulsa,Lieutenant Governor,Matt Pinnell,REP,720708,0,0,158,158,
Tulsa,State Auditor,Cindy Byrd,REP,720708,0,0,120,120,
Tulsa,State Auditor,Charlie Prater,REP,720708,0,0,132,132,
Tulsa,Attorney General,Mike Hunter,REP,720708,0,0,126,126,
Tulsa,Attorney General,Gentner Drummond,REP,720708,0,0,140,140,
Tulsa,Superintendent of Public Instruction,Joy Hofmeister,REP,720708,0,0,148,148,
Tulsa,Superintendent of Public Instruction,Linda Murphy,REP,720708,0,0,114,114,
Tulsa,Commissioner of Labor,Cathy Costello,REP,720708,0,0,100,100,
Tulsa,Commissioner of Labor,Leslie Osborn,REP,720708,0,0,153,153,
Tulsa,Corporation Commissioner,Bob Anthony,REP,720708,0,0,115,115,
Tulsa,Corporation Commissioner,Brian Bingman,REP,720708,0,0,136,136,
Tulsa,U.S. House,Tim Harris,REP,720708,0,0,116,116,01
Tulsa,U.S. House,Kevin Hern,REP,720708,0,0,151,151,01
Tulsa,State House,Mark Lawson,REP,720708,0,0,122,122,30
Tulsa,State House,Kent Glesener,REP,720708,0,0,133,133,30
Tulsa,Governor,Chris Powell,LIB,720708,0,0,0,0,
Tulsa,Governor,Rex Lawhorn,LIB,720708,0,0,0,0,
Tulsa,Corporation Commissioner,Ashley Nicole Mccray,DEM,720708,0,0,33,33,
Tulsa,Corporation Commissioner,Blake Cummings,DEM,720708,0,0,17,17,
Tulsa,U.S. House,Tim Gilpin,DEM,720708,0,0,24,24,01
Tulsa,U.S. House,Amanda Douglas,DEM,720708,0,0,27,27,01
Tulsa,Governor,Mick Cornett,REP,720709,0,0,123,123,
Tulsa,Governor,Kevin Stitt,REP,720709,0,0,241,241,
Tulsa,Lieutenant Governor,Dana Murphy,REP,720709,0,0,118,118,
Tulsa,Lieutenant Governor,Matt Pinnell,REP,720709,0,0,241,241,
Tulsa,State Auditor,Cindy Byrd,REP,720709,0,0,190,190,
Tulsa,State Auditor,Charlie Prater,REP,720709,0,0,146,146,
Tulsa,Attorney General,Mike Hunter,REP,720709,0,0,187,187,
Tulsa,Attorney General,Gentner Drummond,REP,720709,0,0,171,171,
Tulsa,Superintendent of Public Instruction,Joy Hofmeister,REP,720709,0,0,219,219,
Tulsa,Superintendent of Public Instruction,Linda Murphy,REP,720709,0,0,143,143,
Tulsa,Commissioner of Labor,Cathy Costello,REP,720709,0,0,183,183,
Tulsa,Commissioner of Labor,Leslie Osborn,REP,720709,0,0,162,162,
Tulsa,Corporation Commissioner,Bob Anthony,REP,720709,0,0,181,181,
Tulsa,Corporation Commissioner,Brian Bingman,REP,720709,0,0,168,168,
Tulsa,U.S. House,Tim Harris,REP,720709,0,0,159,159,01
Tulsa,U.S. House,Kevin Hern,REP,720709,0,0,202,202,01
Tulsa,Governor,Chris Powell,LIB,720709,0,0,1,1,
Tulsa,Governor,Rex Lawhorn,LIB,720709,0,0,2,2,
Tulsa,Corporation Commissioner,Ashley Nicole Mccray,DEM,720709,0,0,60,60,
Tulsa,Corporation Commissioner,Blake Cummings,DEM,720709,0,0,29,29,
Tulsa,U.S. House,Tim Gilpin,DEM,720709,0,0,45,45,01
Tulsa,U.S. House,Amanda Douglas,DEM,720709,0,0,45,45,01
Tulsa,Governor,Mick Cornett,REP,720710,0,0,25,25,
Tulsa,Governor,Kevin Stitt,REP,720710,0,0,111,111,
Tulsa,Lieutenant Governor,Dana Murphy,REP,720710,0,0,31,31,
Tulsa,Lieutenant Governor,Matt Pinnell,REP,720710,0,0,97,97,
Tulsa,State Auditor,Cindy Byrd,REP,720710,0,0,61,61,
Tulsa,State Auditor,Charlie Prater,REP,720710,0,0,64,64,
Tulsa,Attorney General,Mike Hunter,REP,720710,0,0,53,53,
Tulsa,Attorney General,Gentner Drummond,REP,720710,0,0,82,82,
Tulsa,Superintendent of Public Instruction,Joy Hofmeister,REP,720710,0,0,74,74,
Tulsa,Superintendent of Public Instruction,Linda Murphy,REP,720710,0,0,52,52,
Tulsa,Commissioner of Labor,Cathy Costello,REP,720710,0,0,66,66,
Tulsa,Commissioner of Labor,Leslie Osborn,REP,720710,0,0,58,58,
Tulsa,Corporation Commissioner,Bob Anthony,REP,720710,0,0,57,57,
Tulsa,Corporation Commissioner,Brian Bingman,REP,720710,0,0,75,75,
Tulsa,U.S. House,Tim Harris,REP,720710,0,0,54,54,01
Tulsa,U.S. House,Kevin Hern,REP,720710,0,0,80,80,01
Tulsa,State House,Mark Lawson,REP,720710,0,0,51,51,30
Tulsa,State House,Kent Glesener,REP,720710,0,0,71,71,30
Tulsa,Governor,Chris Powell,LIB,720710,0,0,0,0,
Tulsa,Governor,Rex Lawhorn,LIB,720710,0,0,0,0,
Tulsa,Corporation Commissioner,Ashley Nicole Mccray,DEM,720710,0,0,8,8,
Tulsa,Corporation Commissioner,Blake Cummings,DEM,720710,0,0,6,6,
Tulsa,U.S. House,Tim Gilpin,DEM,720710,0,0,5,5,01
Tulsa,U.S. House,Amanda Douglas,DEM,720710,0,0,9,9,01
Tulsa,Governor,Mick Cornett,REP,720750,0,0,101,101,
Tulsa,Governor,Kevin Stitt,REP,720750,0,0,182,182,
Tulsa,Lieutenant Governor,Dana Murphy,REP,720750,0,0,88,88,
Tulsa,Lieutenant Governor,Matt Pinnell,REP,720750,0,0,190,190,
Tulsa,State Auditor,Cindy Byrd,REP,720750,0,0,120,120,
Tulsa,State Auditor,Charlie Prater,REP,720750,0,0,151,151,
Tulsa,Attorney General,Mike Hunter,REP,720750,0,0,139,139,
Tulsa,Attorney General,Gentner Drummond,REP,720750,0,0,143,143,
Tulsa,Superintendent of Public Instruction,Joy Hofmeister,REP,720750,0,0,182,182,
Tulsa,Superintendent of Public Instruction,Linda Murphy,REP,720750,0,0,98,98,
Tulsa,Commissioner of Labor,Cathy Costello,REP,720750,0,0,139,139,
Tulsa,Commissioner of Labor,Leslie Osborn,REP,720750,0,0,137,137,
Tulsa,Corporation Commissioner,Bob Anthony,REP,720750,0,0,149,149,
Tulsa,Corporation Commissioner,Brian Bingman,REP,720750,0,0,128,128,
Tulsa,U.S. House,Tim Harris,REP,720750,0,0,108,108,01
Tulsa,U.S. House,Kevin Hern,REP,720750,0,0,175,175,01
Tulsa,Governor,Chris Powell,LIB,720750,0,0,0,0,
Tulsa,Governor,Rex Lawhorn,LIB,720750,0,0,0,0,
Tulsa,Corporation Commissioner,Ashley Nicole Mccray,DEM,720750,0,0,38,38,
Tulsa,Corporation Commissioner,Blake Cummings,DEM,720750,0,0,18,18,
Tulsa,U.S. House,Tim Gilpin,DEM,720750,0,0,26,26,01
Tulsa,U.S. House,Amanda Douglas,DEM,720750,0,0,30,30,01
Tulsa,Governor,Mick Cornett,REP,720751,0,0,123,123,
Tulsa,Governor,Kevin Stitt,REP,720751,0,0,226,226,
Tulsa,Lieutenant Governor,Dana Murphy,REP,720751,0,0,132,132,
Tulsa,Lieutenant Governor,Matt Pinnell,REP,720751,0,0,210,210,
Tulsa,State Auditor,Cindy Byrd,REP,720751,0,0,180,180,
Tulsa,State Auditor,Charlie Prater,REP,720751,0,0,142,142,
Tulsa,Attorney General,Mike Hunter,REP,720751,0,0,165,165,
Tulsa,Attorney General,Gentner Drummond,REP,720751,0,0,175,175,
Tulsa,Superintendent of Public Instruction,Joy Hofmeister,REP,720751,0,0,188,188,
Tulsa,Superintendent of Public Instruction,Linda Murphy,REP,720751,0,0,150,150,
Tulsa,Commissioner of Labor,Cathy Costello,REP,720751,0,0,157,157,
Tulsa,Commissioner of Labor,Leslie Osborn,REP,720751,0,0,176,176,
Tulsa,Corporation Commissioner,Bob Anthony,REP,720751,0,0,169,169,
Tulsa,Corporation Commissioner,Brian Bingman,REP,720751,0,0,160,160,
Tulsa,U.S. House,Tim Harris,REP,720751,0,0,167,167,01
Tulsa,U.S. House,Kevin Hern,REP,720751,0,0,176,176,01
Tulsa,Governor,Chris Powell,LIB,720751,0,0,0,0,
Tulsa,Governor,Rex Lawhorn,LIB,720751,0,0,0,0,
Tulsa,Corporation Commissioner,Ashley Nicole Mccray,DEM,720751,0,0,42,42,
Tulsa,Corporation Commissioner,Blake Cummings,DEM,720751,0,0,27,27,
Tulsa,U.S. House,Tim Gilpin,DEM,720751,0,0,47,47,01
Tulsa,U.S. House,Amanda Douglas,DEM,720751,0,0,23,23,01
Tulsa,Governor,Mick Cornett,REP,720752,0,0,103,103,
Tulsa,Governor,Kevin Stitt,REP,720752,0,0,186,186,
Tulsa,Lieutenant Governor,Dana Murphy,REP,720752,0,0,116,116,
Tulsa,Lieutenant Governor,Matt Pinnell,REP,720752,0,0,169,169,
Tulsa,State Auditor,Cindy Byrd,REP,720752,0,0,147,147,
Tulsa,State Auditor,Charlie Prater,REP,720752,0,0,129,129,
Tulsa,Attorney General,Mike Hunter,REP,720752,0,0,120,120,
Tulsa,Attorney General,Gentner Drummond,REP,720752,0,0,166,166,
Tulsa,Superintendent of Public Instruction,Joy Hofmeister,REP,720752,0,0,160,160,
Tulsa,Superintendent of Public Instruction,Linda Murphy,REP,720752,0,0,122,122,
Tulsa,Commissioner of Labor,Cathy Costello,REP,720752,0,0,132,132,
Tulsa,Commissioner of Labor,Leslie Osborn,REP,720752,0,0,146,146,
Tulsa,Corporation Commissioner,Bob Anthony,REP,720752,0,0,150,150,
Tulsa,Corporation Commissioner,Brian Bingman,REP,720752,0,0,128,128,
Tulsa,U.S. House,Tim Harris,REP,720752,0,0,124,124,01
Tulsa,U.S. House,Kevin Hern,REP,720752,0,0,165,165,01
Tulsa,State House,Sean Roberts,REP,720752,0,0,175,175,36
Tulsa,State House,Louise Redcorn,REP,720752,0,0,105,105,36
Tulsa,Governor,Chris Powell,LIB,720752,0,0,1,1,
Tulsa,Governor,Rex Lawhorn,LIB,720752,0,0,0,0,
Tulsa,Corporation Commissioner,Ashley Nicole Mccray,DEM,720752,0,0,45,45,
Tulsa,Corporation Commissioner,Blake Cummings,DEM,720752,0,0,21,21,
Tulsa,U.S. House,Tim Gilpin,DEM,720752,0,0,30,30,01
Tulsa,U.S. House,Amanda Douglas,DEM,720752,0,0,36,36,01
Tulsa,Governor,Mick Cornett,REP,720753,0,0,52,52,
Tulsa,Governor,Kevin Stitt,REP,720753,0,0,86,86,
Tulsa,Lieutenant Governor,Dana Murphy,REP,720753,0,0,50,50,
Tulsa,Lieutenant Governor,Matt Pinnell,REP,720753,0,0,86,86,
Tulsa,State Auditor,Cindy Byrd,REP,720753,0,0,67,67,
Tulsa,State Auditor,Charlie Prater,REP,720753,0,0,68,68,
Tulsa,Attorney General,Mike Hunter,REP,720753,0,0,60,60,
Tulsa,Attorney General,Gentner Drummond,REP,720753,0,0,77,77,
Tulsa,Superintendent of Public Instruction,Joy Hofmeister,REP,720753,0,0,69,69,
Tulsa,Superintendent of Public Instruction,Linda Murphy,REP,720753,0,0,67,67,
Tulsa,Commissioner of Labor,Cathy Costello,REP,720753,0,0,70,70,
Tulsa,Commissioner of Labor,Leslie Osborn,REP,720753,0,0,67,67,
Tulsa,Corporation Commissioner,Bob Anthony,REP,720753,0,0,56,56,
Tulsa,Corporation Commissioner,Brian Bingman,REP,720753,0,0,76,76,
Tulsa,U.S. House,Tim Harris,REP,720753,0,0,47,47,01
Tulsa,U.S. House,Kevin Hern,REP,720753,0,0,92,92,01
Tulsa,Governor,Chris Powell,LIB,720753,0,0,0,0,
Tulsa,Governor,Rex Lawhorn,LIB,720753,0,0,0,0,
Tulsa,Corporation Commissioner,Ashley Nicole Mccray,DEM,720753,0,0,44,44,
Tulsa,Corporation Commissioner,Blake Cummings,DEM,720753,0,0,24,24,
Tulsa,U.S. House,Tim Gilpin,DEM,720753,0,0,38,38,01
Tulsa,U.S. House,Amanda Douglas,DEM,720753,0,0,31,31,01
Tulsa,Governor,Mick Cornett,REP,720754,0,0,115,115,
Tulsa,Governor,Kevin Stitt,REP,720754,0,0,218,218,
Tulsa,Lieutenant Governor,Dana Murphy,REP,720754,0,0,119,119,
Tulsa,Lieutenant Governor,Matt Pinnell,REP,720754,0,0,204,204,
Tulsa,State Auditor,Cindy Byrd,REP,720754,0,0,148,148,
Tulsa,State Auditor,Charlie Prater,REP,720754,0,0,171,171,
Tulsa,Attorney General,Mike Hunter,REP,720754,0,0,157,157,
Tulsa,Attorney General,Gentner Drummond,REP,720754,0,0,168,168,
Tulsa,Superintendent of Public Instruction,Joy Hofmeister,REP,720754,0,0,167,167,
Tulsa,Superintendent of Public Instruction,Linda Murphy,REP,720754,0,0,156,156,
Tulsa,Commissioner of Labor,Cathy Costello,REP,720754,0,0,156,156,
Tulsa,Commissioner of Labor,Leslie Osborn,REP,720754,0,0,168,168,
Tulsa,Corporation Commissioner,Bob Anthony,REP,720754,0,0,161,161,
Tulsa,Corporation Commissioner,Brian Bingman,REP,720754,0,0,154,154,
Tulsa,U.S. House,Tim Harris,REP,720754,0,0,129,129,01
Tulsa,U.S. House,Kevin Hern,REP,720754,0,0,198,198,01
Tulsa,Governor,Chris Powell,LIB,720754,0,0,0,0,
Tulsa,Governor,Rex Lawhorn,LIB,720754,0,0,0,0,
Tulsa,Corporation Commissioner,Ashley Nicole Mccray,DEM,720754,0,0,37,37,
Tulsa,Corporation Commissioner,Blake Cummings,DEM,720754,0,0,24,24,
Tulsa,U.S. House,Tim Gilpin,DEM,720754,0,0,23,23,01
Tulsa,U.S. House,Amanda Douglas,DEM,720754,0,0,38,38,01
Tulsa,Governor,Mick Cornett,REP,720755,0,0,189,189,
Tulsa,Governor,Kevin Stitt,REP,720755,0,0,293,293,
Tulsa,Lieutenant Governor,Dana Murphy,REP,720755,0,0,201,201,
Tulsa,Lieutenant Governor,Matt Pinnell,REP,720755,0,0,266,266,
Tulsa,State Auditor,Cindy Byrd,REP,720755,0,0,221,221,
Tulsa,State Auditor,Charlie Prater,REP,720755,0,0,228,228,
Tulsa,Attorney General,Mike Hunter,REP,720755,0,0,178,178,
Tulsa,Attorney General,Gentner Drummond,REP,720755,0,0,293,293,
Tulsa,Superintendent of Public Instruction,Joy Hofmeister,REP,720755,0,0,266,266,
Tulsa,Superintendent of Public Instruction,Linda Murphy,REP,720755,0,0,197,197,
Tulsa,Commissioner of Labor,Cathy Costello,REP,720755,0,0,234,234,
Tulsa,Commissioner of Labor,Leslie Osborn,REP,720755,0,0,214,214,
Tulsa,Corporation Commissioner,Bob Anthony,REP,720755,0,0,211,211,
Tulsa,Corporation Commissioner,Brian Bingman,REP,720755,0,0,235,235,
Tulsa,U.S. House,Tim Harris,REP,720755,0,0,198,198,01
Tulsa,U.S. House,Kevin Hern,REP,720755,0,0,273,273,01
Tulsa,Governor,Chris Powell,LIB,720755,0,0,1,1,
Tulsa,Governor,Rex Lawhorn,LIB,720755,0,0,0,0,
Tulsa,Corporation Commissioner,Ashley Nicole Mccray,DEM,720755,0,0,79,79,
Tulsa,Corporation Commissioner,Blake Cummings,DEM,720755,0,0,26,26,
Tulsa,U.S. House,Tim Gilpin,DEM,720755,0,0,51,51,01
Tulsa,U.S. House,Amanda Douglas,DEM,720755,0,0,54,54,01
Tulsa,Governor,Mick Cornett,REP,720756,0,0,9,9,
Tulsa,Governor,Kevin Stitt,REP,720756,0,0,10,10,
Tulsa,Lieutenant Governor,Dana Murphy,REP,720756,0,0,6,6,
Tulsa,Lieutenant Governor,Matt Pinnell,REP,720756,0,0,13,13,
Tulsa,State Auditor,Cindy Byrd,REP,720756,0,0,10,10,
Tulsa,State Auditor,Charlie Prater,REP,720756,0,0,8,8,
Tulsa,Attorney General,Mike Hunter,REP,720756,0,0,12,12,
Tulsa,Attorney General,Gentner Drummond,REP,720756,0,0,7,7,
Tulsa,Superintendent of Public Instruction,Joy Hofmeister,REP,720756,0,0,11,11,
Tulsa,Superintendent of Public Instruction,Linda Murphy,REP,720756,0,0,8,8,
Tulsa,Commissioner of Labor,Cathy Costello,REP,720756,0,0,7,7,
Tulsa,Commissioner of Labor,Leslie Osborn,REP,720756,0,0,12,12,
Tulsa,Corporation Commissioner,Bob Anthony,REP,720756,0,0,8,8,
Tulsa,Corporation Commissioner,Brian Bingman,REP,720756,0,0,11,11,
Tulsa,U.S. House,Tim Harris,REP,720756,0,0,8,8,01
Tulsa,U.S. House,Kevin Hern,REP,720756,0,0,11,11,01
Tulsa,Governor,Chris Powell,LIB,720756,0,0,0,0,
Tulsa,Governor,Rex Lawhorn,LIB,720756,0,0,0,0,
Tulsa,Corporation Commissioner,Ashley Nicole Mccray,DEM,720756,0,0,4,4,
Tulsa,Corporation Commissioner,Blake Cummings,DEM,720756,0,0,2,2,
Tulsa,U.S. House,Tim Gilpin,DEM,720756,0,0,2,2,01
Tulsa,U.S. House,Amanda Douglas,DEM,720756,0,0,4,4,01
Tulsa,Governor,Mick Cornett,REP,720757,0,0,169,169,
Tulsa,Governor,Kevin Stitt,REP,720757,0,0,365,365,
Tulsa,Lieutenant Governor,Dana Murphy,REP,720757,0,0,200,200,
Tulsa,Lieutenant Governor,Matt Pinnell,REP,720757,0,0,322,322,
Tulsa,State Auditor,Cindy Byrd,REP,720757,0,0,240,240,
Tulsa,State Auditor,Charlie Prater,REP,720757,0,0,264,264,
Tulsa,Attorney General,Mike Hunter,REP,720757,0,0,209,209,
Tulsa,Attorney General,Gentner Drummond,REP,720757,0,0,313,313,
Tulsa,Superintendent of Public Instruction,Joy Hofmeister,REP,720757,0,0,303,303,
Tulsa,Superintendent of Public Instruction,Linda Murphy,REP,720757,0,0,220,220,
Tulsa,Commissioner of Labor,Cathy Costello,REP,720757,0,0,251,251,
Tulsa,Commissioner of Labor,Leslie Osborn,REP,720757,0,0,248,248,
Tulsa,Corporation Commissioner,Bob Anthony,REP,720757,0,0,277,277,
Tulsa,Corporation Commissioner,Brian Bingman,REP,720757,0,0,228,228,
Tulsa,U.S. House,Tim Harris,REP,720757,0,0,263,263,01
Tulsa,U.S. House,Kevin Hern,REP,720757,0,0,266,266,01
Tulsa,Governor,Chris Powell,LIB,720757,0,0,2,2,
Tulsa,Governor,Rex Lawhorn,LIB,720757,0,0,0,0,
Tulsa,Corporation Commissioner,Ashley Nicole Mccray,DEM,720757,0,0,61,61,
Tulsa,Corporation Commissioner,Blake Cummings,DEM,720757,0,0,23,23,
Tulsa,U.S. House,Tim Gilpin,DEM,720757,0,0,54,54,01
Tulsa,U.S. House,Amanda Douglas,DEM,720757,0,0,32,32,01
Tulsa,Governor,Mick Cornett,REP,720758,0,0,59,59,
Tulsa,Governor,Kevin Stitt,REP,720758,0,0,96,96,
Tulsa,Lieutenant Governor,Dana Murphy,REP,720758,0,0,63,63,
Tulsa,Lieutenant Governor,Matt Pinnell,REP,720758,0,0,87,87,
Tulsa,State Auditor,Cindy Byrd,REP,720758,0,0,67,67,
Tulsa,State Auditor,Charlie Prater,REP,720758,0,0,74,74,
Tulsa,Attorney General,Mike Hunter,REP,720758,0,0,62,62,
Tulsa,Attorney General,Gentner Drummond,REP,720758,0,0,91,91,
Tulsa,Superintendent of Public Instruction,Joy Hofmeister,REP,720758,0,0,81,81,
Tulsa,Superintendent of Public Instruction,Linda Murphy,REP,720758,0,0,64,64,
Tulsa,Commissioner of Labor,Cathy Costello,REP,720758,0,0,64,64,
Tulsa,Commissioner of Labor,Leslie Osborn,REP,720758,0,0,79,79,
Tulsa,Corporation Commissioner,Bob Anthony,REP,720758,0,0,77,77,
Tulsa,Corporation Commissioner,Brian Bingman,REP,720758,0,0,64,64,
Tulsa,U.S. House,Tim Harris,REP,720758,0,0,53,53,01
Tulsa,U.S. House,Kevin Hern,REP,720758,0,0,99,99,01
Tulsa,State House,Sean Roberts,REP,720758,0,0,91,91,36
Tulsa,State House,Louise Redcorn,REP,720758,0,0,53,53,36
Tulsa,Governor,Chris Powell,LIB,720758,0,0,0,0,
Tulsa,Governor,Rex Lawhorn,LIB,720758,0,0,0,0,
Tulsa,Corporation Commissioner,Ashley Nicole Mccray,DEM,720758,0,0,19,19,
Tulsa,Corporation Commissioner,Blake Cummings,DEM,720758,0,0,7,7,
Tulsa,U.S. House,Tim Gilpin,DEM,720758,0,0,15,15,01
Tulsa,U.S. House,Amanda Douglas,DEM,720758,0,0,11,11,01
Tulsa,Governor,Mick Cornett,REP,720759,0,0,87,87,
Tulsa,Governor,Kevin Stitt,REP,720759,0,0,153,153,
Tulsa,Lieutenant Governor,Dana Murphy,REP,720759,0,0,110,110,
Tulsa,Lieutenant Governor,Matt Pinnell,REP,720759,0,0,118,118,
Tulsa,State Auditor,Cindy Byrd,REP,720759,0,0,115,115,
Tulsa,State Auditor,Charlie Prater,REP,720759,0,0,106,106,
Tulsa,Attorney General,Mike Hunter,REP,720759,0,0,109,109,
Tulsa,Attorney General,Gentner Drummond,REP,720759,0,0,128,128,
Tulsa,Superintendent of Public Instruction,Joy Hofmeister,REP,720759,0,0,141,141,
Tulsa,Superintendent of Public Instruction,Linda Murphy,REP,720759,0,0,94,94,
Tulsa,Commissioner of Labor,Cathy Costello,REP,720759,0,0,120,120,
Tulsa,Commissioner of Labor,Leslie Osborn,REP,720759,0,0,109,109,
Tulsa,Corporation Commissioner,Bob Anthony,REP,720759,0,0,127,127,
Tulsa,Corporation Commissioner,Brian Bingman,REP,720759,0,0,101,101,
Tulsa,U.S. House,Tim Harris,REP,720759,0,0,79,79,01
Tulsa,U.S. House,Kevin Hern,REP,720759,0,0,157,157,01
Tulsa,Governor,Chris Powell,LIB,720759,0,0,0,0,
Tulsa,Governor,Rex Lawhorn,LIB,720759,0,0,0,0,
Tulsa,Corporation Commissioner,Ashley Nicole Mccray,DEM,720759,0,0,40,40,
Tulsa,Corporation Commissioner,Blake Cummings,DEM,720759,0,0,13,13,
Tulsa,U.S. House,Tim Gilpin,DEM,720759,0,0,30,30,01
Tulsa,U.S. House,Amanda Douglas,DEM,720759,0,0,23,23,01
Tulsa,Governor,Mick Cornett,REP,720760,0,0,92,92,
Tulsa,Governor,Kevin Stitt,REP,720760,0,0,162,162,
Tulsa,Lieutenant Governor,Dana Murphy,REP,720760,0,0,108,108,
Tulsa,Lieutenant Governor,Matt Pinnell,REP,720760,0,0,141,141,
Tulsa,State Auditor,Cindy Byrd,REP,720760,0,0,122,122,
Tulsa,State Auditor,Charlie Prater,REP,720760,0,0,114,114,
Tulsa,Attorney General,Mike Hunter,REP,720760,0,0,125,125,
Tulsa,Attorney General,Gentner Drummond,REP,720760,0,0,130,130,
Tulsa,Superintendent of Public Instruction,Joy Hofmeister,REP,720760,0,0,125,125,
Tulsa,Superintendent of Public Instruction,Linda Murphy,REP,720760,0,0,122,122,
Tulsa,Commissioner of Labor,Cathy Costello,REP,720760,0,0,150,150,
Tulsa,Commissioner of Labor,Leslie Osborn,REP,720760,0,0,92,92,
Tulsa,Corporation Commissioner,Bob Anthony,REP,720760,0,0,133,133,
Tulsa,Corporation Commissioner,Brian Bingman,REP,720760,0,0,112,112,
Tulsa,U.S. House,Tim Harris,REP,720760,0,0,88,88,01
Tulsa,U.S. House,Kevin Hern,REP,720760,0,0,165,165,01
Tulsa,Governor,Chris Powell,LIB,720760,0,0,1,1,
Tulsa,Governor,Rex Lawhorn,LIB,720760,0,0,0,0,
Tulsa,Corporation Commissioner,Ashley Nicole Mccray,DEM,720760,0,0,32,32,
Tulsa,Corporation Commissioner,Blake Cummings,DEM,720760,0,0,19,19,
Tulsa,U.S. House,Tim Gilpin,DEM,720760,0,0,24,24,01
Tulsa,U.S. House,Amanda Douglas,DEM,720760,0,0,26,26,01
Tulsa,Governor,Mick Cornett,REP,720801,0,0,80,80,
Tulsa,Governor,Kevin Stitt,REP,720801,0,0,138,138,
Tulsa,Lieutenant Governor,Dana Murphy,REP,720801,0,0,86,86,
Tulsa,Lieutenant Governor,Matt Pinnell,REP,720801,0,0,125,125,
Tulsa,State Auditor,Cindy Byrd,REP,720801,0,0,101,101,
Tulsa,State Auditor,Charlie Prater,REP,720801,0,0,111,111,
Tulsa,Attorney General,Mike Hunter,REP,720801,0,0,82,82,
Tulsa,Attorney General,Gentner Drummond,REP,720801,0,0,134,134,
Tulsa,Superintendent of Public Instruction,Joy Hofmeister,REP,720801,0,0,125,125,
Tulsa,Superintendent of Public Instruction,Linda Murphy,REP,720801,0,0,90,90,
Tulsa,Commissioner of Labor,Cathy Costello,REP,720801,0,0,102,102,
Tulsa,Commissioner of Labor,Leslie Osborn,REP,720801,0,0,110,110,
Tulsa,Corporation Commissioner,Bob Anthony,REP,720801,0,0,111,111,
Tulsa,Corporation Commissioner,Brian Bingman,REP,720801,0,0,100,100,
Tulsa,U.S. House,Tim Harris,REP,720801,0,0,92,92,01
Tulsa,U.S. House,Kevin Hern,REP,720801,0,0,123,123,01
Tulsa,State House,Jadine Nollan,REP,720801,0,0,125,125,66
Tulsa,State House,Brian Jackson,REP,720801,0,0,85,85,66
Tulsa,Governor,Chris Powell,LIB,720801,0,0,0,0,
Tulsa,Governor,Rex Lawhorn,LIB,720801,0,0,1,1,
Tulsa,Corporation Commissioner,Ashley Nicole Mccray,DEM,720801,0,0,26,26,
Tulsa,Corporation Commissioner,Blake Cummings,DEM,720801,0,0,13,13,
Tulsa,U.S. House,Tim Gilpin,DEM,720801,0,0,26,26,01
Tulsa,U.S. House,Amanda Douglas,DEM,720801,0,0,13,13,01
Tulsa,Governor,Mick Cornett,REP,720802,0,0,23,23,
Tulsa,Governor,Kevin Stitt,REP,720802,0,0,91,91,
Tulsa,Lieutenant Governor,Dana Murphy,REP,720802,0,0,44,44,
Tulsa,Lieutenant Governor,Matt Pinnell,REP,720802,0,0,67,67,
Tulsa,State Auditor,Cindy Byrd,REP,720802,0,0,49,49,
Tulsa,State Auditor,Charlie Prater,REP,720802,0,0,60,60,
Tulsa,Attorney General,Mike Hunter,REP,720802,0,0,39,39,
Tulsa,Attorney General,Gentner Drummond,REP,720802,0,0,73,73,
Tulsa,Superintendent of Public Instruction,Joy Hofmeister,REP,720802,0,0,62,62,
Tulsa,Superintendent of Public Instruction,Linda Murphy,REP,720802,0,0,52,52,
Tulsa,Commissioner of Labor,Cathy Costello,REP,720802,0,0,55,55,
Tulsa,Commissioner of Labor,Leslie Osborn,REP,720802,0,0,55,55,
Tulsa,Corporation Commissioner,Bob Anthony,REP,720802,0,0,58,58,
Tulsa,Corporation Commissioner,Brian Bingman,REP,720802,0,0,51,51,
Tulsa,U.S. House,Tim Harris,REP,720802,0,0,38,38,01
Tulsa,U.S. House,Kevin Hern,REP,720802,0,0,74,74,01
Tulsa,State House,Lonnie Sims,REP,720802,0,0,61,61,68
Tulsa,State House,Nicole Nixon,REP,720802,0,0,49,49,68
Tulsa,Governor,Chris Powell,LIB,720802,0,0,0,0,
Tulsa,Governor,Rex Lawhorn,LIB,720802,0,0,0,0,
Tulsa,Corporation Commissioner,Ashley Nicole Mccray,DEM,720802,0,0,29,29,
Tulsa,Corporation Commissioner,Blake Cummings,DEM,720802,0,0,13,13,
Tulsa,U.S. House,Tim Gilpin,DEM,720802,0,0,22,22,01
Tulsa,U.S. House,Amanda Douglas,DEM,720802,0,0,20,20,01
Tulsa,State House,Angela Statum,DEM,720802,0,0,24,24,68
Tulsa,State House,Michael Ross,DEM,720802,0,0,17,17,68
Tulsa,Governor,Mick Cornett,REP,720851,0,0,113,113,
Tulsa,Governor,Kevin Stitt,REP,720851,0,0,146,146,
Tulsa,Lieutenant Governor,Dana Murphy,REP,720851,0,0,120,120,
Tulsa,Lieutenant Governor,Matt Pinnell,REP,720851,0,0,131,131,
Tulsa,State Auditor,Cindy Byrd,REP,720851,0,0,129,129,
Tulsa,State Auditor,Charlie Prater,REP,720851,0,0,115,115,
Tulsa,Attorney General,Mike Hunter,REP,720851,0,0,103,103,
Tulsa,Attorney General,Gentner Drummond,REP,720851,0,0,150,150,
Tulsa,Superintendent of Public Instruction,Joy Hofmeister,REP,720851,0,0,148,148,
Tulsa,Superintendent of Public Instruction,Linda Murphy,REP,720851,0,0,102,102,
Tulsa,Commissioner of Labor,Cathy Costello,REP,720851,0,0,105,105,
Tulsa,Commissioner of Labor,Leslie Osborn,REP,720851,0,0,136,136,
Tulsa,Corporation Commissioner,Bob Anthony,REP,720851,0,0,111,111,
Tulsa,Corporation Commissioner,Brian Bingman,REP,720851,0,0,126,126,
Tulsa,U.S. House,Tim Harris,REP,720851,0,0,117,117,01
Tulsa,U.S. House,Kevin Hern,REP,720851,0,0,135,135,01
Tulsa,State House,Jadine Nollan,REP,720851,0,0,169,169,66
Tulsa,State House,Brian Jackson,REP,720851,0,0,89,89,66
Tulsa,Governor,Chris Powell,LIB,720851,0,0,0,0,
Tulsa,Governor,Rex Lawhorn,LIB,720851,0,0,0,0,
Tulsa,Corporation Commissioner,Ashley Nicole Mccray,DEM,720851,0,0,67,67,
Tulsa,Corporation Commissioner,Blake Cummings,DEM,720851,0,0,30,30,
Tulsa,U.S. House,Tim Gilpin,DEM,720851,0,0,67,67,01
Tulsa,U.S. House,Amanda Douglas,DEM,720851,0,0,32,32,01
Tulsa,Governor,Mick Cornett,REP,720852,0,0,35,35,
Tulsa,Governor,Kevin Stitt,REP,720852,0,0,69,69,
Tulsa,Lieutenant Governor,Dana Murphy,REP,720852,0,0,32,32,
Tulsa,Lieutenant Governor,Matt Pinnell,REP,720852,0,0,67,67,
Tulsa,State Auditor,Cindy Byrd,REP,720852,0,0,40,40,
Tulsa,State Auditor,Charlie Prater,REP,720852,0,0,58,58,
Tulsa,Attorney General,Mike Hunter,REP,720852,0,0,40,40,
Tulsa,Attorney General,Gentner Drummond,REP,720852,0,0,63,63,
Tulsa,Superintendent of Public Instruction,Joy Hofmeister,REP,720852,0,0,59,59,
Tulsa,Superintendent of Public Instruction,Linda Murphy,REP,720852,0,0,40,40,
Tulsa,Commissioner of Labor,Cathy Costello,REP,720852,0,0,48,48,
Tulsa,Commissioner of Labor,Leslie Osborn,REP,720852,0,0,49,49,
Tulsa,Corporation Commissioner,Bob Anthony,REP,720852,0,0,44,44,
Tulsa,Corporation Commissioner,Brian Bingman,REP,720852,0,0,55,55,
Tulsa,U.S. House,Tim Harris,REP,720852,0,0,32,32,01
Tulsa,U.S. House,Kevin Hern,REP,720852,0,0,68,68,01
Tulsa,State House,Jadine Nollan,REP,720852,0,0,62,62,66
Tulsa,State House,Brian Jackson,REP,720852,0,0,39,39,66
Tulsa,Governor,Chris Powell,LIB,720852,0,0,0,0,
Tulsa,Governor,Rex Lawhorn,LIB,720852,0,0,0,0,
Tulsa,Corporation Commissioner,Ashley Nicole Mccray,DEM,720852,0,0,48,48,
Tulsa,Corporation Commissioner,Blake Cummings,DEM,720852,0,0,14,14,
Tulsa,U.S. House,Tim Gilpin,DEM,720852,0,0,33,33,01
Tulsa,U.S. House,Amanda Douglas,DEM,720852,0,0,30,30,01
Tulsa,Governor,Mick Cornett,REP,720853,0,0,62,62,
Tulsa,Governor,Kevin Stitt,REP,720853,0,0,92,92,
Tulsa,Lieutenant Governor,Dana Murphy,REP,720853,0,0,64,64,
Tulsa,Lieutenant Governor,Matt Pinnell,REP,720853,0,0,87,87,
Tulsa,State Auditor,Cindy Byrd,REP,720853,0,0,70,70,
Tulsa,State Auditor,Charlie Prater,REP,720853,0,0,76,76,
Tulsa,Attorney General,Mike Hunter,REP,720853,0,0,75,75,
Tulsa,Attorney General,Gentner Drummond,REP,720853,0,0,79,79,
Tulsa,Superintendent of Public Instruction,Joy Hofmeister,REP,720853,0,0,80,80,
Tulsa,Superintendent of Public Instruction,Linda Murphy,REP,720853,0,0,70,70,
Tulsa,Commissioner of Labor,Cathy Costello,REP,720853,0,0,67,67,
Tulsa,Commissioner of Labor,Leslie Osborn,REP,720853,0,0,83,83,
Tulsa,Corporation Commissioner,Bob Anthony,REP,720853,0,0,86,86,
Tulsa,Corporation Commissioner,Brian Bingman,REP,720853,0,0,65,65,
Tulsa,U.S. House,Tim Harris,REP,720853,0,0,66,66,01
Tulsa,U.S. House,Kevin Hern,REP,720853,0,0,86,86,01
Tulsa,State House,Jadine Nollan,REP,720853,0,0,99,99,66
Tulsa,State House,Brian Jackson,REP,720853,0,0,56,56,66
Tulsa,Governor,Chris Powell,LIB,720853,0,0,0,0,
Tulsa,Governor,Rex Lawhorn,LIB,720853,0,0,0,0,
Tulsa,Corporation Commissioner,Ashley Nicole Mccray,DEM,720853,0,0,22,22,
Tulsa,Corporation Commissioner,Blake Cummings,DEM,720853,0,0,22,22,
Tulsa,U.S. House,Tim Gilpin,DEM,720853,0,0,21,21,01
Tulsa,U.S. House,Amanda Douglas,DEM,720853,0,0,23,23,01
Tulsa,Governor,Mick Cornett,REP,720854,0,0,134,134,
Tulsa,Governor,Kevin Stitt,REP,720854,0,0,273,273,
Tulsa,Lieutenant Governor,Dana Murphy,REP,720854,0,0,143,143,
Tulsa,Lieutenant Governor,Matt Pinnell,REP,720854,0,0,246,246,
Tulsa,State Auditor,Cindy Byrd,REP,720854,0,0,188,188,
Tulsa,State Auditor,Charlie Prater,REP,720854,0,0,192,192,
Tulsa,Attorney General,Mike Hunter,REP,720854,0,0,163,163,
Tulsa,Attorney General,Gentner Drummond,REP,720854,0,0,241,241,
Tulsa,Superintendent of Public Instruction,Joy Hofmeister,REP,720854,0,0,248,248,
Tulsa,Superintendent of Public Instruction,Linda Murphy,REP,720854,0,0,155,155,
Tulsa,Commissioner of Labor,Cathy Costello,REP,720854,0,0,179,179,
Tulsa,Commissioner of Labor,Leslie Osborn,REP,720854,0,0,205,205,
Tulsa,Corporation Commissioner,Bob Anthony,REP,720854,0,0,191,191,
Tulsa,Corporation Commissioner,Brian Bingman,REP,720854,0,0,197,197,
Tulsa,U.S. House,Tim Harris,REP,720854,0,0,174,174,01
Tulsa,U.S. House,Kevin Hern,REP,720854,0,0,228,228,01
Tulsa,State House,Jadine Nollan,REP,720854,0,0,239,239,66
Tulsa,State House,Brian Jackson,REP,720854,0,0,167,167,66
Tulsa,Governor,Chris Powell,LIB,720854,0,0,0,0,
Tulsa,Governor,Rex Lawhorn,LIB,720854,0,0,0,0,
Tulsa,Corporation Commissioner,Ashley Nicole Mccray,DEM,720854,0,0,78,78,
Tulsa,Corporation Commissioner,Blake Cummings,DEM,720854,0,0,25,25,
Tulsa,U.S. House,Tim Gilpin,DEM,720854,0,0,65,65,01
Tulsa,U.S. House,Amanda Douglas,DEM,720854,0,0,40,40,01
Tulsa,Governor,Mick Cornett,REP,720855,0,0,133,133,
Tulsa,Governor,Kevin Stitt,REP,720855,0,0,279,279,
Tulsa,Lieutenant Governor,Dana Murphy,REP,720855,0,0,163,163,
Tulsa,Lieutenant Governor,Matt Pinnell,REP,720855,0,0,236,236,
Tulsa,State Auditor,Cindy Byrd,REP,720855,0,0,204,204,
Tulsa,State Auditor,Charlie Prater,REP,720855,0,0,178,178,
Tulsa,Attorney General,Mike Hunter,REP,720855,0,0,160,160,
Tulsa,Attorney General,Gentner Drummond,REP,720855,0,0,247,247,
Tulsa,Superintendent of Public Instruction,Joy Hofmeister,REP,720855,0,0,248,248,
Tulsa,Superintendent of Public Instruction,Linda Murphy,REP,720855,0,0,160,160,
Tulsa,Commissioner of Labor,Cathy Costello,REP,720855,0,0,155,155,
Tulsa,Commissioner of Labor,Leslie Osborn,REP,720855,0,0,233,233,
Tulsa,Corporation Commissioner,Bob Anthony,REP,720855,0,0,185,185,
Tulsa,Corporation Commissioner,Brian Bingman,REP,720855,0,0,206,206,
Tulsa,U.S. House,Tim Harris,REP,720855,0,0,162,162,01
Tulsa,U.S. House,Kevin Hern,REP,720855,0,0,243,243,01
Tulsa,State House,Jadine Nollan,REP,720855,0,0,238,238,66
Tulsa,State House,Brian Jackson,REP,720855,0,0,168,168,66
Tulsa,Governor,Chris Powell,LIB,720855,0,0,0,0,
Tulsa,Governor,Rex Lawhorn,LIB,720855,0,0,2,2,
Tulsa,Corporation Commissioner,Ashley Nicole Mccray,DEM,720855,0,0,53,53,
Tulsa,Corporation Commissioner,Blake Cummings,DEM,720855,0,0,24,24,
Tulsa,U.S. House,Tim Gilpin,DEM,720855,0,0,46,46,01
Tulsa,U.S. House,Amanda Douglas,DEM,720855,0,0,32,32,01
Tulsa,Governor,Mick Cornett,REP,720856,0,0,139,139,
Tulsa,Governor,Kevin Stitt,REP,720856,0,0,270,270,
Tulsa,Lieutenant Governor,Dana Murphy,REP,720856,0,0,169,169,
Tulsa,Lieutenant Governor,Matt Pinnell,REP,720856,0,0,231,231,
Tulsa,State Auditor,Cindy Byrd,REP,720856,0,0,211,211,
Tulsa,State Auditor,Charlie Prater,REP,720856,0,0,180,180,
Tulsa,Attorney General,Mike Hunter,REP,720856,0,0,165,165,
Tulsa,Attorney General,Gentner Drummond,REP,720856,0,0,242,242,
Tulsa,Superintendent of Public Instruction,Joy Hofmeister,REP,720856,0,0,248,248,
Tulsa,Superintendent of Public Instruction,Linda Murphy,REP,720856,0,0,150,150,
Tulsa,Commissioner of Labor,Cathy Costello,REP,720856,0,0,203,203,
Tulsa,Commissioner of Labor,Leslie Osborn,REP,720856,0,0,188,188,
Tulsa,Corporation Commissioner,Bob Anthony,REP,720856,0,0,188,188,
Tulsa,Corporation Commissioner,Brian Bingman,REP,720856,0,0,209,209,
Tulsa,U.S. House,Tim Harris,REP,720856,0,0,169,169,01
Tulsa,U.S. House,Kevin Hern,REP,720856,0,0,238,238,01
Tulsa,State House,Jadine Nollan,REP,720856,0,0,224,224,66
Tulsa,State House,Brian Jackson,REP,720856,0,0,177,177,66
Tulsa,Governor,Chris Powell,LIB,720856,0,0,0,0,
Tulsa,Governor,Rex Lawhorn,LIB,720856,0,0,0,0,
Tulsa,Corporation Commissioner,Ashley Nicole Mccray,DEM,720856,0,0,66,66,
Tulsa,Corporation Commissioner,Blake Cummings,DEM,720856,0,0,29,29,
Tulsa,U.S. House,Tim Gilpin,DEM,720856,0,0,38,38,01
Tulsa,U.S. House,Amanda Douglas,DEM,720856,0,0,56,56,01
Tulsa,Governor,Mick Cornett,REP,720857,0,0,73,73,
Tulsa,Governor,Kevin Stitt,REP,720857,0,0,113,113,
Tulsa,Lieutenant Governor,Dana Murphy,REP,720857,0,0,83,83,
Tulsa,Lieutenant Governor,Matt Pinnell,REP,720857,0,0,99,99,
Tulsa,State Auditor,Cindy Byrd,REP,720857,0,0,78,78,
Tulsa,State Auditor,Charlie Prater,REP,720857,0,0,98,98,
Tulsa,Attorney General,Mike Hunter,REP,720857,0,0,79,79,
Tulsa,Attorney General,Gentner Drummond,REP,720857,0,0,106,106,
Tulsa,Superintendent of Public Instruction,Joy Hofmeister,REP,720857,0,0,110,110,
Tulsa,Superintendent of Public Instruction,Linda Murphy,REP,720857,0,0,71,71,
Tulsa,Commissioner of Labor,Cathy Costello,REP,720857,0,0,94,94,
Tulsa,Commissioner of Labor,Leslie Osborn,REP,720857,0,0,84,84,
Tulsa,Corporation Commissioner,Bob Anthony,REP,720857,0,0,79,79,
Tulsa,Corporation Commissioner,Brian Bingman,REP,720857,0,0,98,98,
Tulsa,U.S. House,Tim Harris,REP,720857,0,0,58,58,01
Tulsa,U.S. House,Kevin Hern,REP,720857,0,0,124,124,01
Tulsa,State House,Jadine Nollan,REP,720857,0,0,110,110,66
Tulsa,State House,Brian Jackson,REP,720857,0,0,76,76,66
Tulsa,Governor,Chris Powell,LIB,720857,0,0,0,0,
Tulsa,Governor,Rex Lawhorn,LIB,720857,0,0,0,0,
Tulsa,Corporation Commissioner,Ashley Nicole Mccray,DEM,720857,0,0,46,46,
Tulsa,Corporation Commissioner,Blake Cummings,DEM,720857,0,0,23,23,
Tulsa,U.S. House,Tim Gilpin,DEM,720857,0,0,43,43,01
Tulsa,U.S. House,Amanda Douglas,DEM,720857,0,0,27,27,01
Tulsa,Governor,Mick Cornett,REP,720858,0,0,40,40,
Tulsa,Governor,Kevin Stitt,REP,720858,0,0,108,108,
Tulsa,Lieutenant Governor,Dana Murphy,REP,720858,0,0,55,55,
Tulsa,Lieutenant Governor,Matt Pinnell,REP,720858,0,0,91,91,
Tulsa,State Auditor,Cindy Byrd,REP,720858,0,0,64,64,
Tulsa,State Auditor,Charlie Prater,REP,720858,0,0,78,78,
Tulsa,Attorney General,Mike Hunter,REP,720858,0,0,53,53,
Tulsa,Attorney General,Gentner Drummond,REP,720858,0,0,92,92,
Tulsa,Superintendent of Public Instruction,Joy Hofmeister,REP,720858,0,0,76,76,
Tulsa,Superintendent of Public Instruction,Linda Murphy,REP,720858,0,0,70,70,
Tulsa,Commissioner of Labor,Cathy Costello,REP,720858,0,0,67,67,
Tulsa,Commissioner of Labor,Leslie Osborn,REP,720858,0,0,76,76,
Tulsa,Corporation Commissioner,Bob Anthony,REP,720858,0,0,59,59,
Tulsa,Corporation Commissioner,Brian Bingman,REP,720858,0,0,82,82,
Tulsa,U.S. House,Tim Harris,REP,720858,0,0,51,51,01
Tulsa,U.S. House,Kevin Hern,REP,720858,0,0,95,95,01
Tulsa,Governor,Chris Powell,LIB,720858,0,0,0,0,
Tulsa,Governor,Rex Lawhorn,LIB,720858,0,0,1,1,
Tulsa,Corporation Commissioner,Ashley Nicole Mccray,DEM,720858,0,0,17,17,
Tulsa,Corporation Commissioner,Blake Cummings,DEM,720858,0,0,13,13,
Tulsa,U.S. House,Tim Gilpin,DEM,720858,0,0,21,21,01
Tulsa,U.S. House,Amanda Douglas,DEM,720858,0,0,9,9,01
Tulsa,Governor,Mick Cornett,REP,720880,0,0,82,82,
Tulsa,Governor,Kevin Stitt,REP,720880,0,0,210,210,
Tulsa,Lieutenant Governor,Dana Murphy,REP,720880,0,0,135,135,
Tulsa,Lieutenant Governor,Matt Pinnell,REP,720880,0,0,156,156,
Tulsa,State Auditor,Cindy Byrd,REP,720880,0,0,159,159,
Tulsa,State Auditor,Charlie Prater,REP,720880,0,0,123,123,
Tulsa,Attorney General,Mike Hunter,REP,720880,0,0,123,123,
Tulsa,Attorney General,Gentner Drummond,REP,720880,0,0,168,168,
Tulsa,Superintendent of Public Instruction,Joy Hofmeister,REP,720880,0,0,162,162,
Tulsa,Superintendent of Public Instruction,Linda Murphy,REP,720880,0,0,127,127,
Tulsa,Commissioner of Labor,Cathy Costello,REP,720880,0,0,140,140,
Tulsa,Commissioner of Labor,Leslie Osborn,REP,720880,0,0,143,143,
Tulsa,Corporation Commissioner,Bob Anthony,REP,720880,0,0,136,136,
Tulsa,Corporation Commissioner,Brian Bingman,REP,720880,0,0,146,146,
Tulsa,U.S. House,Tim Harris,REP,720880,0,0,91,91,01
Tulsa,U.S. House,Kevin Hern,REP,720880,0,0,200,200,01
Tulsa,Governor,Chris Powell,LIB,720880,0,0,2,2,
Tulsa,Governor,Rex Lawhorn,LIB,720880,0,0,0,0,
Tulsa,Corporation Commissioner,Ashley Nicole Mccray,DEM,720880,0,0,46,46,
Tulsa,Corporation Commissioner,Blake Cummings,DEM,720880,0,0,22,22,
Tulsa,U.S. House,Tim Gilpin,DEM,720880,0,0,36,36,01
Tulsa,U.S. House,Amanda Douglas,DEM,720880,0,0,33,33,01
Tulsa,Governor,Mick Cornett,REP,720881,0,0,68,68,
Tulsa,Governor,Kevin Stitt,REP,720881,0,0,124,124,
Tulsa,Lieutenant Governor,Dana Murphy,REP,720881,0,0,69,69,
Tulsa,Lieutenant Governor,Matt Pinnell,REP,720881,0,0,114,114,
Tulsa,State Auditor,Cindy Byrd,REP,720881,0,0,84,84,
Tulsa,State Auditor,Charlie Prater,REP,720881,0,0,96,96,
Tulsa,Attorney General,Mike Hunter,REP,720881,0,0,69,69,
Tulsa,Attorney General,Gentner Drummond,REP,720881,0,0,118,118,
Tulsa,Superintendent of Public Instruction,Joy Hofmeister,REP,720881,0,0,106,106,
Tulsa,Superintendent of Public Instruction,Linda Murphy,REP,720881,0,0,85,85,
Tulsa,Commissioner of Labor,Cathy Costello,REP,720881,0,0,95,95,
Tulsa,Commissioner of Labor,Leslie Osborn,REP,720881,0,0,90,90,
Tulsa,Corporation Commissioner,Bob Anthony,REP,720881,0,0,87,87,
Tulsa,Corporation Commissioner,Brian Bingman,REP,720881,0,0,96,96,
Tulsa,U.S. House,Tim Harris,REP,720881,0,0,80,80,01
Tulsa,U.S. House,Kevin Hern,REP,720881,0,0,111,111,01
Tulsa,State House,Jadine Nollan,REP,720881,0,0,111,111,66
Tulsa,State House,Brian Jackson,REP,720881,0,0,75,75,66
Tulsa,Governor,Chris Powell,LIB,720881,0,0,0,0,
Tulsa,Governor,Rex Lawhorn,LIB,720881,0,0,0,0,
Tulsa,Corporation Commissioner,Ashley Nicole Mccray,DEM,720881,0,0,56,56,
Tulsa,Corporation Commissioner,Blake Cummings,DEM,720881,0,0,19,19,
Tulsa,U.S. House,Tim Gilpin,DEM,720881,0,0,39,39,01
Tulsa,U.S. House,Amanda Douglas,DEM,720881,0,0,36,36,01
Tulsa,Governor,Mick Cornett,REP,720900,0,0,133,133,
Tulsa,Governor,Kevin Stitt,REP,720900,0,0,227,227,
Tulsa,Lieutenant Governor,Dana Murphy,REP,720900,0,0,140,140,
Tulsa,Lieutenant Governor,Matt Pinnell,REP,720900,0,0,210,210,
Tulsa,State Auditor,Cindy Byrd,REP,720900,0,0,188,188,
Tulsa,State Auditor,Charlie Prater,REP,720900,0,0,154,154,
Tulsa,Attorney General,Mike Hunter,REP,720900,0,0,150,150,
Tulsa,Attorney General,Gentner Drummond,REP,720900,0,0,203,203,
Tulsa,Superintendent of Public Instruction,Joy Hofmeister,REP,720900,0,0,180,180,
Tulsa,Superintendent of Public Instruction,Linda Murphy,REP,720900,0,0,172,172,
Tulsa,Commissioner of Labor,Cathy Costello,REP,720900,0,0,171,171,
Tulsa,Commissioner of Labor,Leslie Osborn,REP,720900,0,0,174,174,
Tulsa,Corporation Commissioner,Bob Anthony,REP,720900,0,0,178,178,
Tulsa,Corporation Commissioner,Brian Bingman,REP,720900,0,0,175,175,
Tulsa,U.S. House,Tim Harris,REP,720900,0,0,137,137,01
Tulsa,U.S. House,Kevin Hern,REP,720900,0,0,216,216,01
Tulsa,State House,Sean Roberts,REP,720900,0,0,187,187,36
Tulsa,State House,Louise Redcorn,REP,720900,0,0,162,162,36
Tulsa,Governor,Chris Powell,LIB,720900,0,0,0,0,
Tulsa,Governor,Rex Lawhorn,LIB,720900,0,0,0,0,
Tulsa,Corporation Commissioner,Ashley Nicole Mccray,DEM,720900,0,0,47,47,
Tulsa,Corporation Commissioner,Blake Cummings,DEM,720900,0,0,25,25,
Tulsa,U.S. House,Tim Gilpin,DEM,720900,0,0,28,28,01
Tulsa,U.S. House,Amanda Douglas,DEM,720900,0,0,44,44,01
Tulsa,Governor,Mick Cornett,REP,729999,1155,1016,0,2171,
Tulsa,Governor,Kevin Stitt,REP,729999,1466,1482,0,2948,
Tulsa,Lieutenant Governor,Dana Murphy,REP,729999,968,937,0,1905,
Tulsa,Lieutenant Governor,Matt Pinnell,REP,729999,1556,1495,0,3051,
Tulsa,State Auditor,Cindy Byrd,REP,729999,1484,1367,0,2851,
Tulsa,State Auditor,Charlie Prater,REP,729999,898,959,0,1857,
Tulsa,Attorney General,Mike Hunter,REP,729999,1180,1125,0,2305,
Tulsa,Attorney General,Gentner Drummond,REP,729999,1395,1338,0,2733,
Tulsa,Superintendent of Public Instruction,Joy Hofmeister,REP,729999,1544,1459,0,3003,
Tulsa,Superintendent of Public Instruction,Linda Murphy,REP,729999,1009,975,0,1984,
Tulsa,Commissioner of Labor,Cathy Costello,REP,729999,1363,1222,0,2585,
Tulsa,Commissioner of Labor,Leslie Osborn,REP,729999,1065,1136,0,2201,
Tulsa,Corporation Commissioner,Bob Anthony,REP,729999,1492,1461,0,2953,
Tulsa,Corporation Commissioner,Brian Bingman,REP,729999,1012,923,0,1935,
Tulsa,U.S. House,Tim Harris,REP,729999,1404,1292,0,2696,01
Tulsa,U.S. House,Kevin Hern,REP,729999,1174,1174,0,2348,01
Tulsa,State Senate,John Haste,REP,729999,93,57,0,150,36
Tulsa,State Senate,Bill Day,REP,729999,63,61,0,124,36
Tulsa,State House,Mark Lawson,REP,729999,20,18,0,38,30
Tulsa,State House,Kent Glesener,REP,729999,14,7,0,21,30
Tulsa,State House,Sean Roberts,REP,729999,15,15,0,30,36
Tulsa,State House,Louise Redcorn,REP,729999,21,9,0,30,36
Tulsa,State House,Jadine Nollan,REP,729999,61,54,0,115,66
Tulsa,State House,Brian Jackson,REP,729999,39,32,0,71,66
Tulsa,State House,Lonnie Sims,REP,729999,77,81,0,158,68
Tulsa,State House,Nicole Nixon,REP,729999,52,47,0,99,68
Tulsa,State House,Cheryl Baber,REP,729999,117,87,0,204,71
Tulsa,State House,Beverly Atteberry,REP,729999,57,48,0,105,71
Tulsa,State House,Karen Gilbert,REP,729999,125,78,0,203,79
Tulsa,State House,Dan Hicks,REP,729999,99,103,0,202,79
Tulsa,State House,Stan May,REP,729999,133,126,0,259,80
Tulsa,State House,Mike Ritze,REP,729999,98,76,0,174,80
Tulsa,State House,Laura Steele,REP,729999,24,18,0,42,98
Tulsa,State House,Dean Davis,REP,729999,19,17,0,36,98
Tulsa,Governor,Chris Powell,LIB,729999,5,6,0,11,
Tulsa,Governor,Rex Lawhorn,LIB,729999,1,3,0,4,
Tulsa,Corporation Commissioner,Ashley Nicole Mccray,DEM,729999,1021,855,0,1876,
Tulsa,Corporation Commissioner,Blake Cummings,DEM,729999,333,319,0,652,
Tulsa,U.S. House,Tim Gilpin,DEM,729999,791,784,0,1575,01
Tulsa,U.S. House,Amanda Douglas,DEM,729999,593,416,0,1009,01
Tulsa,State House,Angela Statum,DEM,729999,32,29,0,61,68
Tulsa,State House,Michael Ross,DEM,729999,34,30,0,64,68
Wagoner,Governor,Mick Cornett,REP,730101,3,0,55,58,
Wagoner,Governor,Kevin Stitt,REP,730101,5,3,86,94,
Wagoner,Lieutenant Governor,Dana Murphy,REP,730101,3,2,62,67,
Wagoner,Lieutenant Governor,Matt Pinnell,REP,730101,5,1,77,83,
Wagoner,State Auditor,Cindy Byrd,REP,730101,6,3,71,80,
Wagoner,State Auditor,Charlie Prater,REP,730101,2,0,65,67,
Wagoner,Attorney General,Mike Hunter,REP,730101,4,1,62,67,
Wagoner,Attorney General,Gentner Drummond,REP,730101,4,2,77,83,
Wagoner,Superintendent of Public Instruction,Joy Hofmeister,REP,730101,5,0,81,86,
Wagoner,Superintendent of Public Instruction,Linda Murphy,REP,730101,3,3,60,66,
Wagoner,Commissioner of Labor,Cathy Costello,REP,730101,5,3,61,69,
Wagoner,Commissioner of Labor,Leslie Osborn,REP,730101,1,0,77,78,
Wagoner,Corporation Commissioner,Bob Anthony,REP,730101,3,2,67,72,
Wagoner,Corporation Commissioner,Brian Bingman,REP,730101,3,1,70,74,
Wagoner,U.S. House,Tim Harris,REP,730101,2,1,48,51,01
Wagoner,U.S. House,Kevin Hern,REP,730101,6,2,95,103,01
Wagoner,Governor,Chris Powell,LIB,730101,0,0,0,0,
Wagoner,Governor,Rex Lawhorn,LIB,730101,0,0,2,2,
Wagoner,Corporation Commissioner,Ashley Nicole Mccray,DEM,730101,0,0,28,28,
Wagoner,Corporation Commissioner,Blake Cummings,DEM,730101,3,1,24,28,
Wagoner,U.S. House,Tim Gilpin,DEM,730101,1,1,29,31,01
Wagoner,U.S. House,Amanda Douglas,DEM,730101,2,0,24,26,01
Wagoner,Governor,Mick Cornett,REP,730102,3,3,61,67,
Wagoner,Governor,Kevin Stitt,REP,730102,1,6,166,173,
Wagoner,Lieutenant Governor,Dana Murphy,REP,730102,0,2,82,84,
Wagoner,Lieutenant Governor,Matt Pinnell,REP,730102,4,7,141,152,
Wagoner,State Auditor,Cindy Byrd,REP,730102,0,4,96,100,
Wagoner,State Auditor,Charlie Prater,REP,730102,3,3,116,122,
Wagoner,Attorney General,Mike Hunter,REP,730102,0,4,88,92,
Wagoner,Attorney General,Gentner Drummond,REP,730102,4,4,136,144,
Wagoner,Superintendent of Public Instruction,Joy Hofmeister,REP,730102,2,4,109,115,
Wagoner,Superintendent of Public Instruction,Linda Murphy,REP,730102,2,4,110,116,
Wagoner,Commissioner of Labor,Cathy Costello,REP,730102,0,7,116,123,
Wagoner,Commissioner of Labor,Leslie Osborn,REP,730102,3,2,100,105,
Wagoner,Corporation Commissioner,Bob Anthony,REP,730102,1,4,111,116,
Wagoner,Corporation Commissioner,Brian Bingman,REP,730102,3,4,106,113,
Wagoner,U.S. House,Tim Harris,REP,730102,2,4,67,73,01
Wagoner,U.S. House,Kevin Hern,REP,730102,2,5,157,164,01
Wagoner,Governor,Chris Powell,LIB,730102,0,0,0,0,
Wagoner,Governor,Rex Lawhorn,LIB,730102,0,0,0,0,
Wagoner,Corporation Commissioner,Ashley Nicole Mccray,DEM,730102,1,1,39,41,
Wagoner,Corporation Commissioner,Blake Cummings,DEM,730102,1,0,15,16,
Wagoner,U.S. House,Tim Gilpin,DEM,730102,1,0,23,24,01
Wagoner,U.S. House,Amanda Douglas,DEM,730102,1,1,31,33,01
Wagoner,Governor,Mick Cornett,REP,730103,2,5,140,147,
Wagoner,Governor,Kevin Stitt,REP,730103,12,6,257,275,
Wagoner,Lieutenant Governor,Dana Murphy,REP,730103,6,4,154,164,
Wagoner,Lieutenant Governor,Matt Pinnell,REP,730103,8,6,236,250,
Wagoner,State Auditor,Cindy Byrd,REP,730103,6,4,190,200,
Wagoner,State Auditor,Charlie Prater,REP,730103,8,6,193,207,
Wagoner,Attorney General,Mike Hunter,REP,730103,8,4,202,214,
Wagoner,Attorney General,Gentner Drummond,REP,730103,6,7,190,203,
Wagoner,Superintendent of Public Instruction,Joy Hofmeister,REP,730103,7,6,186,199,
Wagoner,Superintendent of Public Instruction,Linda Murphy,REP,730103,7,5,203,215,
Wagoner,Commissioner of Labor,Cathy Costello,REP,730103,11,4,193,208,
Wagoner,Commissioner of Labor,Leslie Osborn,REP,730103,3,7,192,202,
Wagoner,Corporation Commissioner,Bob Anthony,REP,730103,7,4,210,221,
Wagoner,Corporation Commissioner,Brian Bingman,REP,730103,7,6,172,185,
Wagoner,U.S. House,Tim Harris,REP,730103,4,7,155,166,01
Wagoner,U.S. House,Kevin Hern,REP,730103,10,4,236,250,01
Wagoner,State House,Laura Steele,REP,730103,8,4,131,143,98
Wagoner,State House,Dean Davis,REP,730103,6,7,251,264,98
Wagoner,Governor,Chris Powell,LIB,730103,0,0,0,0,
Wagoner,Governor,Rex Lawhorn,LIB,730103,0,0,1,1,
Wagoner,Corporation Commissioner,Ashley Nicole Mccray,DEM,730103,5,3,90,98,
Wagoner,Corporation Commissioner,Blake Cummings,DEM,730103,1,1,41,43,
Wagoner,U.S. House,Tim Gilpin,DEM,730103,4,4,57,65,01
Wagoner,U.S. House,Amanda Douglas,DEM,730103,2,0,74,76,01
Wagoner,Governor,Mick Cornett,REP,730104,0,0,0,0,
Wagoner,Governor,Kevin Stitt,REP,730104,0,0,0,0,
Wagoner,Lieutenant Governor,Dana Murphy,REP,730104,0,0,0,0,
Wagoner,Lieutenant Governor,Matt Pinnell,REP,730104,0,0,0,0,
Wagoner,State Auditor,Cindy Byrd,REP,730104,0,0,0,0,
Wagoner,State Auditor,Charlie Prater,REP,730104,0,0,0,0,
Wagoner,Attorney General,Mike Hunter,REP,730104,0,0,0,0,
Wagoner,Attorney General,Gentner Drummond,REP,730104,0,0,0,0,
Wagoner,Superintendent of Public Instruction,Joy Hofmeister,REP,730104,0,0,0,0,
Wagoner,Superintendent of Public Instruction,Linda Murphy,REP,730104,0,0,0,0,
Wagoner,Commissioner of Labor,Cathy Costello,REP,730104,0,0,0,0,
Wagoner,Commissioner of Labor,Leslie Osborn,REP,730104,0,0,0,0,
Wagoner,Corporation Commissioner,Bob Anthony,REP,730104,0,0,0,0,
Wagoner,Corporation Commissioner,Brian Bingman,REP,730104,0,0,0,0,
Wagoner,U.S. House,Tim Harris,REP,730104,0,0,0,0,01
Wagoner,U.S. House,Kevin Hern,REP,730104,0,0,0,0,01
Wagoner,Governor,Chris Powell,LIB,730104,0,0,0,0,
Wagoner,Governor,Rex Lawhorn,LIB,730104,0,0,0,0,
Wagoner,Corporation Commissioner,Ashley Nicole Mccray,DEM,730104,0,0,0,0,
Wagoner,Corporation Commissioner,Blake Cummings,DEM,730104,0,0,0,0,
Wagoner,U.S. House,Tim Gilpin,DEM,730104,0,0,0,0,01
Wagoner,U.S. House,Amanda Douglas,DEM,730104,0,0,0,0,01
Wagoner,Governor,Mick Cornett,REP,730105,0,0,0,0,
Wagoner,Governor,Kevin Stitt,REP,730105,0,0,1,1,
Wagoner,Lieutenant Governor,Dana Murphy,REP,730105,0,0,1,1,
Wagoner,Lieutenant Governor,Matt Pinnell,REP,730105,0,0,0,0,
Wagoner,State Auditor,Cindy Byrd,REP,730105,0,0,1,1,
Wagoner,State Auditor,Charlie Prater,REP,730105,0,0,0,0,
Wagoner,Attorney General,Mike Hunter,REP,730105,0,0,1,1,
Wagoner,Attorney General,Gentner Drummond,REP,730105,0,0,0,0,
Wagoner,Superintendent of Public Instruction,Joy Hofmeister,REP,730105,0,0,0,0,
Wagoner,Superintendent of Public Instruction,Linda Murphy,REP,730105,0,0,1,1,
Wagoner,Commissioner of Labor,Cathy Costello,REP,730105,0,0,0,0,
Wagoner,Commissioner of Labor,Leslie Osborn,REP,730105,0,0,1,1,
Wagoner,Corporation Commissioner,Bob Anthony,REP,730105,0,0,1,1,
Wagoner,Corporation Commissioner,Brian Bingman,REP,730105,0,0,0,0,
Wagoner,U.S. House,Tim Harris,REP,730105,0,0,0,0,01
Wagoner,U.S. House,Kevin Hern,REP,730105,0,0,1,1,01
Wagoner,State Senate,John Haste,REP,730105,0,0,0,0,36
Wagoner,State Senate,Bill Day,REP,730105,0,0,1,1,36
Wagoner,Governor,Chris Powell,LIB,730105,0,0,0,0,
Wagoner,Governor,Rex Lawhorn,LIB,730105,0,0,0,0,
Wagoner,Corporation Commissioner,Ashley Nicole Mccray,DEM,730105,0,0,0,0,
Wagoner,Corporation Commissioner,Blake Cummings,DEM,730105,0,0,0,0,
Wagoner,U.S. House,Tim Gilpin,DEM,730105,0,0,0,0,01
Wagoner,U.S. House,Amanda Douglas,DEM,730105,0,0,0,0,01
Wagoner,Governor,Mick Cornett,REP,730106,5,16,166,187,
Wagoner,Governor,Kevin Stitt,REP,730106,6,20,309,335,
Wagoner,Lieutenant Governor,Dana Murphy,REP,730106,2,14,153,169,
Wagoner,Lieutenant Governor,Matt Pinnell,REP,730106,9,21,308,338,
Wagoner,State Auditor,Cindy Byrd,REP,730106,8,18,221,247,
Wagoner,State Auditor,Charlie Prater,REP,730106,3,12,225,240,
Wagoner,Attorney General,Mike Hunter,REP,730106,8,18,211,237,
Wagoner,Attorney General,Gentner Drummond,REP,730106,4,18,246,268,
Wagoner,Superintendent of Public Instruction,Joy Hofmeister,REP,730106,5,21,252,278,
Wagoner,Superintendent of Public Instruction,Linda Murphy,REP,730106,7,12,202,221,
Wagoner,Commissioner of Labor,Cathy Costello,REP,730106,8,16,222,246,
Wagoner,Commissioner of Labor,Leslie Osborn,REP,730106,2,16,223,241,
Wagoner,Corporation Commissioner,Bob Anthony,REP,730106,5,19,232,256,
Wagoner,Corporation Commissioner,Brian Bingman,REP,730106,3,15,213,231,
Wagoner,U.S. House,Tim Harris,REP,730106,6,20,189,215,01
Wagoner,U.S. House,Kevin Hern,REP,730106,6,15,275,296,01
Wagoner,State Senate,John Haste,REP,730106,7,16,223,246,36
Wagoner,State Senate,Bill Day,REP,730106,4,18,236,258,36
Wagoner,State House,Laura Steele,REP,730106,3,2,138,143,98
Wagoner,State House,Dean Davis,REP,730106,8,30,314,352,98
Wagoner,Governor,Chris Powell,LIB,730106,0,0,3,3,
Wagoner,Governor,Rex Lawhorn,LIB,730106,0,0,1,1,
Wagoner,Corporation Commissioner,Ashley Nicole Mccray,DEM,730106,4,13,108,125,
Wagoner,Corporation Commissioner,Blake Cummings,DEM,730106,0,5,35,40,
Wagoner,U.S. House,Tim Gilpin,DEM,730106,3,9,58,70,01
Wagoner,U.S. House,Amanda Douglas,DEM,730106,1,10,85,96,01
Wagoner,Governor,Mick Cornett,REP,730107,3,29,146,178,
Wagoner,Governor,Kevin Stitt,REP,730107,8,48,276,332,
Wagoner,Lieutenant Governor,Dana Murphy,REP,730107,3,38,180,221,
Wagoner,Lieutenant Governor,Matt Pinnell,REP,730107,8,39,235,282,
Wagoner,State Auditor,Cindy Byrd,REP,730107,5,38,171,214,
Wagoner,State Auditor,Charlie Prater,REP,730107,4,37,223,264,
Wagoner,Attorney General,Mike Hunter,REP,730107,4,29,184,217,
Wagoner,Attorney General,Gentner Drummond,REP,730107,7,48,230,285,
Wagoner,Superintendent of Public Instruction,Joy Hofmeister,REP,730107,9,43,222,274,
Wagoner,Superintendent of Public Instruction,Linda Murphy,REP,730107,2,32,183,217,
Wagoner,Commissioner of Labor,Cathy Costello,REP,730107,8,38,207,253,
Wagoner,Commissioner of Labor,Leslie Osborn,REP,730107,3,37,193,233,
Wagoner,Corporation Commissioner,Bob Anthony,REP,730107,6,52,224,282,
Wagoner,Corporation Commissioner,Brian Bingman,REP,730107,4,24,180,208,
Wagoner,U.S. House,Tim Harris,REP,730107,4,36,168,208,01
Wagoner,U.S. House,Kevin Hern,REP,730107,7,40,251,298,01
Wagoner,State Senate,John Haste,REP,730107,8,42,194,244,36
Wagoner,State Senate,Bill Day,REP,730107,3,34,214,251,36
Wagoner,State House,Laura Steele,REP,730107,5,18,134,157,98
Wagoner,State House,Dean Davis,REP,730107,5,57,258,320,98
Wagoner,Governor,Chris Powell,LIB,730107,0,0,0,0,
Wagoner,Governor,Rex Lawhorn,LIB,730107,0,0,0,0,
Wagoner,Corporation Commissioner,Ashley Nicole Mccray,DEM,730107,6,13,87,106,
Wagoner,Corporation Commissioner,Blake Cummings,DEM,730107,4,14,23,41,
Wagoner,U.S. House,Tim Gilpin,DEM,730107,9,15,47,71,01
Wagoner,U.S. House,Amanda Douglas,DEM,730107,1,12,63,76,01
Wagoner,Governor,Mick Cornett,REP,730108,0,8,88,96,
Wagoner,Governor,Kevin Stitt,REP,730108,7,22,167,196,
Wagoner,Lieutenant Governor,Dana Murphy,REP,730108,2,12,103,117,
Wagoner,Lieutenant Governor,Matt Pinnell,REP,730108,5,18,139,162,
Wagoner,State Auditor,Cindy Byrd,REP,730108,5,11,107,123,
Wagoner,State Auditor,Charlie Prater,REP,730108,0,19,129,148,
Wagoner,Attorney General,Mike Hunter,REP,730108,4,16,113,133,
Wagoner,Attorney General,Gentner Drummond,REP,730108,3,15,134,152,
Wagoner,Superintendent of Public Instruction,Joy Hofmeister,REP,730108,5,17,139,161,
Wagoner,Superintendent of Public Instruction,Linda Murphy,REP,730108,2,14,106,122,
Wagoner,Commissioner of Labor,Cathy Costello,REP,730108,3,13,121,137,
Wagoner,Commissioner of Labor,Leslie Osborn,REP,730108,2,18,115,135,
Wagoner,Corporation Commissioner,Bob Anthony,REP,730108,4,21,118,143,
Wagoner,Corporation Commissioner,Brian Bingman,REP,730108,3,8,118,129,
Wagoner,U.S. House,Tim Harris,REP,730108,2,18,95,115,01
Wagoner,U.S. House,Kevin Hern,REP,730108,5,12,155,172,01
Wagoner,State Senate,John Haste,REP,730108,6,17,134,157,36
Wagoner,State Senate,Bill Day,REP,730108,1,14,112,127,36
Wagoner,Governor,Chris Powell,LIB,730108,0,0,0,0,
Wagoner,Governor,Rex Lawhorn,LIB,730108,0,1,0,1,
Wagoner,Corporation Commissioner,Ashley Nicole Mccray,DEM,730108,7,3,35,45,
Wagoner,Corporation Commissioner,Blake Cummings,DEM,730108,0,2,23,25,
Wagoner,U.S. House,Tim Gilpin,DEM,730108,4,3,32,39,01
Wagoner,U.S. House,Amanda Douglas,DEM,730108,3,2,26,31,01
Wagoner,Governor,Mick Cornett,REP,730109,2,13,96,111,
Wagoner,Governor,Kevin Stitt,REP,730109,10,21,224,255,
Wagoner,Lieutenant Governor,Dana Murphy,REP,730109,4,5,126,135,
Wagoner,Lieutenant Governor,Matt Pinnell,REP,730109,8,28,191,227,
Wagoner,State Auditor,Cindy Byrd,REP,730109,10,14,154,178,
Wagoner,State Auditor,Charlie Prater,REP,730109,2,19,154,175,
Wagoner,Attorney General,Mike Hunter,REP,730109,3,13,127,143,
Wagoner,Attorney General,Gentner Drummond,REP,730109,9,21,190,220,
Wagoner,Superintendent of Public Instruction,Joy Hofmeister,REP,730109,3,16,169,188,
Wagoner,Superintendent of Public Instruction,Linda Murphy,REP,730109,9,18,144,171,
Wagoner,Commissioner of Labor,Cathy Costello,REP,730109,6,19,164,189,
Wagoner,Commissioner of Labor,Leslie Osborn,REP,730109,6,15,146,167,
Wagoner,Corporation Commissioner,Bob Anthony,REP,730109,8,21,140,169,
Wagoner,Corporation Commissioner,Brian Bingman,REP,730109,4,11,169,184,
Wagoner,U.S. House,Tim Harris,REP,730109,7,17,111,135,01
Wagoner,U.S. House,Kevin Hern,REP,730109,4,17,208,229,01
Wagoner,Governor,Chris Powell,LIB,730109,0,0,0,0,
Wagoner,Governor,Rex Lawhorn,LIB,730109,0,0,0,0,
Wagoner,Corporation Commissioner,Ashley Nicole Mccray,DEM,730109,2,3,30,35,
Wagoner,Corporation Commissioner,Blake Cummings,DEM,730109,0,1,17,18,
Wagoner,U.S. House,Tim Gilpin,DEM,730109,1,2,28,31,01
Wagoner,U.S. House,Amanda Douglas,DEM,730109,1,2,19,22,01
Wagoner,Governor,Mick Cornett,REP,730201,5,3,75,83,
Wagoner,Governor,Kevin Stitt,REP,730201,5,6,184,195,
Wagoner,Lieutenant Governor,Dana Murphy,REP,730201,4,2,100,106,
Wagoner,Lieutenant Governor,Matt Pinnell,REP,730201,6,7,152,165,
Wagoner,State Auditor,Cindy Byrd,REP,730201,5,5,108,118,
Wagoner,State Auditor,Charlie Prater,REP,730201,5,4,139,148,
Wagoner,Attorney General,Mike Hunter,REP,730201,5,4,114,123,
Wagoner,Attorney General,Gentner Drummond,REP,730201,4,5,142,151,
Wagoner,Superintendent of Public Instruction,Joy Hofmeister,REP,730201,7,4,128,139,
Wagoner,Superintendent of Public Instruction,Linda Murphy,REP,730201,2,5,125,132,
Wagoner,Commissioner of Labor,Cathy Costello,REP,730201,4,4,111,119,
Wagoner,Commissioner of Labor,Leslie Osborn,REP,730201,6,4,137,147,
Wagoner,Corporation Commissioner,Bob Anthony,REP,730201,3,7,114,124,
Wagoner,Corporation Commissioner,Brian Bingman,REP,730201,6,2,135,143,
Wagoner,U.S. House,Tim Harris,REP,730201,6,2,93,101,01
Wagoner,U.S. House,Kevin Hern,REP,730201,4,7,162,173,01
Wagoner,Governor,Chris Powell,LIB,730201,0,0,0,0,
Wagoner,Governor,Rex Lawhorn,LIB,730201,0,0,0,0,
Wagoner,Corporation Commissioner,Ashley Nicole Mccray,DEM,730201,0,0,42,42,
Wagoner,Corporation Commissioner,Blake Cummings,DEM,730201,1,2,18,21,
Wagoner,U.S. House,Tim Gilpin,DEM,730201,1,0,30,31,01
Wagoner,U.S. House,Amanda Douglas,DEM,730201,0,2,30,32,01
Wagoner,Governor,Mick Cornett,REP,730202,3,6,109,118,
Wagoner,Governor,Kevin Stitt,REP,730202,3,7,203,213,
Wagoner,Lieutenant Governor,Dana Murphy,REP,730202,5,5,138,148,
Wagoner,Lieutenant Governor,Matt Pinnell,REP,730202,1,8,172,181,
Wagoner,State Auditor,Cindy Byrd,REP,730202,5,7,148,160,
Wagoner,State Auditor,Charlie Prater,REP,730202,1,6,154,161,
Wagoner,Attorney General,Mike Hunter,REP,730202,0,3,124,127,
Wagoner,Attorney General,Gentner Drummond,REP,730202,6,10,185,201,
Wagoner,Superintendent of Public Instruction,Joy Hofmeister,REP,730202,3,8,157,168,
Wagoner,Superintendent of Public Instruction,Linda Murphy,REP,730202,3,5,149,157,
Wagoner,Commissioner of Labor,Cathy Costello,REP,730202,2,10,146,158,
Wagoner,Commissioner of Labor,Leslie Osborn,REP,730202,3,3,160,166,
Wagoner,Corporation Commissioner,Bob Anthony,REP,730202,6,8,152,166,
Wagoner,Corporation Commissioner,Brian Bingman,REP,730202,0,5,154,159,
Wagoner,U.S. House,Tim Harris,REP,730202,4,6,92,102,01
Wagoner,U.S. House,Kevin Hern,REP,730202,2,7,219,228,01
Wagoner,Governor,Chris Powell,LIB,730202,0,0,0,0,
Wagoner,Governor,Rex Lawhorn,LIB,730202,0,0,0,0,
Wagoner,Corporation Commissioner,Ashley Nicole Mccray,DEM,730202,5,3,30,38,
Wagoner,Corporation Commissioner,Blake Cummings,DEM,730202,4,0,17,21,
Wagoner,U.S. House,Tim Gilpin,DEM,730202,4,2,24,30,01
Wagoner,U.S. House,Amanda Douglas,DEM,730202,5,1,23,29,01
Wagoner,Governor,Mick Cornett,REP,730203,4,8,98,110,
Wagoner,Governor,Kevin Stitt,REP,730203,3,11,147,161,
Wagoner,Lieutenant Governor,Dana Murphy,REP,730203,2,6,81,89,
Wagoner,Lieutenant Governor,Matt Pinnell,REP,730203,5,13,163,181,
Wagoner,State Auditor,Cindy Byrd,REP,730203,6,11,95,112,
Wagoner,State Auditor,Charlie Prater,REP,730203,1,8,140,149,
Wagoner,Attorney General,Mike Hunter,REP,730203,4,10,102,116,
Wagoner,Attorney General,Gentner Drummond,REP,730203,3,9,143,155,
Wagoner,Superintendent of Public Instruction,Joy Hofmeister,REP,730203,5,6,120,131,
Wagoner,Superintendent of Public Instruction,Linda Murphy,REP,730203,2,13,122,137,
Wagoner,Commissioner of Labor,Cathy Costello,REP,730203,3,10,104,117,
Wagoner,Commissioner of Labor,Leslie Osborn,REP,730203,4,9,137,150,
Wagoner,Corporation Commissioner,Bob Anthony,REP,730203,3,10,130,143,
Wagoner,Corporation Commissioner,Brian Bingman,REP,730203,4,8,113,125,
Wagoner,U.S. House,Tim Harris,REP,730203,3,6,73,82,01
Wagoner,U.S. House,Kevin Hern,REP,730203,4,13,170,187,01
Wagoner,Governor,Chris Powell,LIB,730203,1,0,0,1,
Wagoner,Governor,Rex Lawhorn,LIB,730203,0,0,0,0,
Wagoner,Corporation Commissioner,Ashley Nicole Mccray,DEM,730203,3,4,80,87,
Wagoner,Corporation Commissioner,Blake Cummings,DEM,730203,1,3,52,56,
Wagoner,U.S. House,Tim Gilpin,DEM,730203,2,6,71,79,01
Wagoner,U.S. House,Amanda Douglas,DEM,730203,3,1,59,63,01
Wagoner,Governor,Mick Cornett,REP,730204,0,1,44,45,
Wagoner,Governor,Kevin Stitt,REP,730204,2,4,131,137,
Wagoner,Lieutenant Governor,Dana Murphy,REP,730204,1,2,53,56,
Wagoner,Lieutenant Governor,Matt Pinnell,REP,730204,1,3,117,121,
Wagoner,State Auditor,Cindy Byrd,REP,730204,1,5,63,69,
Wagoner,State Auditor,Charlie Prater,REP,730204,1,0,105,106,
Wagoner,Attorney General,Mike Hunter,REP,730204,0,2,67,69,
Wagoner,Attorney General,Gentner Drummond,REP,730204,2,3,105,110,
Wagoner,Superintendent of Public Instruction,Joy Hofmeister,REP,730204,0,2,79,81,
Wagoner,Superintendent of Public Instruction,Linda Murphy,REP,730204,2,3,94,99,
Wagoner,Commissioner of Labor,Cathy Costello,REP,730204,1,2,69,72,
Wagoner,Commissioner of Labor,Leslie Osborn,REP,730204,1,3,100,104,
Wagoner,Corporation Commissioner,Bob Anthony,REP,730204,1,3,76,80,
Wagoner,Corporation Commissioner,Brian Bingman,REP,730204,0,2,96,98,
Wagoner,U.S. House,Tim Harris,REP,730204,0,2,54,56,01
Wagoner,U.S. House,Kevin Hern,REP,730204,2,3,121,126,01
Wagoner,Governor,Chris Powell,LIB,730204,0,0,1,1,
Wagoner,Governor,Rex Lawhorn,LIB,730204,0,0,0,0,
Wagoner,Corporation Commissioner,Ashley Nicole Mccray,DEM,730204,0,2,37,39,
Wagoner,Corporation Commissioner,Blake Cummings,DEM,730204,0,1,29,30,
Wagoner,U.S. House,Tim Gilpin,DEM,730204,0,2,34,36,01
Wagoner,U.S. House,Amanda Douglas,DEM,730204,0,0,32,32,01
Wagoner,Governor,Mick Cornett,REP,730205,0,1,11,12,
Wagoner,Governor,Kevin Stitt,REP,730205,1,2,28,31,
Wagoner,Lieutenant Governor,Dana Murphy,REP,730205,1,0,17,18,
Wagoner,Lieutenant Governor,Matt Pinnell,REP,730205,0,3,24,27,
Wagoner,State Auditor,Cindy Byrd,REP,730205,0,2,9,11,
Wagoner,State Auditor,Charlie Prater,REP,730205,1,1,29,31,
Wagoner,Attorney General,Mike Hunter,REP,730205,0,3,17,20,
Wagoner,Attorney General,Gentner Drummond,REP,730205,1,0,24,25,
Wagoner,Superintendent of Public Instruction,Joy Hofmeister,REP,730205,1,1,16,18,
Wagoner,Superintendent of Public Instruction,Linda Murphy,REP,730205,0,2,23,25,
Wagoner,Commissioner of Labor,Cathy Costello,REP,730205,0,3,12,15,
Wagoner,Commissioner of Labor,Leslie Osborn,REP,730205,1,0,28,29,
Wagoner,Corporation Commissioner,Bob Anthony,REP,730205,1,3,13,17,
Wagoner,Corporation Commissioner,Brian Bingman,REP,730205,0,0,24,24,
Wagoner,U.S. House,Tim Harris,REP,730205,0,2,11,13,01
Wagoner,U.S. House,Kevin Hern,REP,730205,1,1,30,32,01
Wagoner,Governor,Chris Powell,LIB,730205,0,0,0,0,
Wagoner,Governor,Rex Lawhorn,LIB,730205,0,0,0,0,
Wagoner,Corporation Commissioner,Ashley Nicole Mccray,DEM,730205,0,3,7,10,
Wagoner,Corporation Commissioner,Blake Cummings,DEM,730205,0,2,3,5,
Wagoner,U.S. House,Tim Gilpin,DEM,730205,0,4,2,6,01
Wagoner,U.S. House,Amanda Douglas,DEM,730205,0,1,8,9,01
Wagoner,Governor,Mick Cornett,REP,730206,0,0,5,5,
Wagoner,Governor,Kevin Stitt,REP,730206,0,3,8,11,
Wagoner,Lieutenant Governor,Dana Murphy,REP,730206,0,0,5,5,
Wagoner,Lieutenant Governor,Matt Pinnell,REP,730206,0,3,8,11,
Wagoner,State Auditor,Cindy Byrd,REP,730206,0,1,5,6,
Wagoner,State Auditor,Charlie Prater,REP,730206,0,2,8,10,
Wagoner,Attorney General,Mike Hunter,REP,730206,0,0,3,3,
Wagoner,Attorney General,Gentner Drummond,REP,730206,0,3,10,13,
Wagoner,Superintendent of Public Instruction,Joy Hofmeister,REP,730206,0,0,3,3,
Wagoner,Superintendent of Public Instruction,Linda Murphy,REP,730206,0,3,10,13,
Wagoner,Commissioner of Labor,Cathy Costello,REP,730206,0,1,6,7,
Wagoner,Commissioner of Labor,Leslie Osborn,REP,730206,0,2,7,9,
Wagoner,Corporation Commissioner,Bob Anthony,REP,730206,0,2,5,7,
Wagoner,Corporation Commissioner,Brian Bingman,REP,730206,0,1,8,9,
Wagoner,U.S. House,Tim Harris,REP,730206,0,0,8,8,01
Wagoner,U.S. House,Kevin Hern,REP,730206,0,3,5,8,01
Wagoner,Governor,Chris Powell,LIB,730206,0,0,0,0,
Wagoner,Governor,Rex Lawhorn,LIB,730206,0,0,0,0,
Wagoner,Corporation Commissioner,Ashley Nicole Mccray,DEM,730206,0,0,2,2,
Wagoner,Corporation Commissioner,Blake Cummings,DEM,730206,0,0,5,5,
Wagoner,U.S. House,Tim Gilpin,DEM,730206,0,0,2,2,01
Wagoner,U.S. House,Amanda Douglas,DEM,730206,0,0,4,4,01
Wagoner,Governor,Mick Cornett,REP,730207,0,1,8,9,
Wagoner,Governor,Kevin Stitt,REP,730207,2,1,26,29,
Wagoner,Lieutenant Governor,Dana Murphy,REP,730207,0,0,13,13,
Wagoner,Lieutenant Governor,Matt Pinnell,REP,730207,2,2,20,24,
Wagoner,State Auditor,Cindy Byrd,REP,730207,0,2,16,18,
Wagoner,State Auditor,Charlie Prater,REP,730207,2,0,18,20,
Wagoner,Attorney General,Mike Hunter,REP,730207,2,2,16,20,
Wagoner,Attorney General,Gentner Drummond,REP,730207,0,0,18,18,
Wagoner,Superintendent of Public Instruction,Joy Hofmeister,REP,730207,0,0,17,17,
Wagoner,Superintendent of Public Instruction,Linda Murphy,REP,730207,2,2,14,18,
Wagoner,Commissioner of Labor,Cathy Costello,REP,730207,2,0,16,18,
Wagoner,Commissioner of Labor,Leslie Osborn,REP,730207,0,2,15,17,
Wagoner,Corporation Commissioner,Bob Anthony,REP,730207,2,0,11,13,
Wagoner,Corporation Commissioner,Brian Bingman,REP,730207,0,2,20,22,
Wagoner,U.S. House,Tim Harris,REP,730207,0,0,4,4,01
Wagoner,U.S. House,Kevin Hern,REP,730207,2,2,29,33,01
Wagoner,Governor,Chris Powell,LIB,730207,0,0,0,0,
Wagoner,Governor,Rex Lawhorn,LIB,730207,0,0,0,0,
Wagoner,Corporation Commissioner,Ashley Nicole Mccray,DEM,730207,0,1,34,35,
Wagoner,Corporation Commissioner,Blake Cummings,DEM,730207,3,1,19,23,
Wagoner,U.S. House,Tim Gilpin,DEM,730207,1,1,19,21,01
Wagoner,U.S. House,Amanda Douglas,DEM,730207,2,1,33,36,01
Wagoner,Governor,Mick Cornett,REP,730208,4,12,77,93,
Wagoner,Governor,Kevin Stitt,REP,730208,4,13,188,205,
Wagoner,Lieutenant Governor,Dana Murphy,REP,730208,2,7,91,100,
Wagoner,Lieutenant Governor,Matt Pinnell,REP,730208,6,18,171,195,
Wagoner,State Auditor,Cindy Byrd,REP,730208,6,10,113,129,
Wagoner,State Auditor,Charlie Prater,REP,730208,2,15,147,164,
Wagoner,Attorney General,Mike Hunter,REP,730208,3,13,105,121,
Wagoner,Attorney General,Gentner Drummond,REP,730208,5,12,157,174,
Wagoner,Superintendent of Public Instruction,Joy Hofmeister,REP,730208,8,11,133,152,
Wagoner,Superintendent of Public Instruction,Linda Murphy,REP,730208,0,14,131,145,
Wagoner,Commissioner of Labor,Cathy Costello,REP,730208,6,13,121,140,
Wagoner,Commissioner of Labor,Leslie Osborn,REP,730208,2,12,137,151,
Wagoner,Corporation Commissioner,Bob Anthony,REP,730208,5,17,127,149,
Wagoner,Corporation Commissioner,Brian Bingman,REP,730208,3,8,135,146,
Wagoner,U.S. House,Tim Harris,REP,730208,3,8,90,101,01
Wagoner,U.S. House,Kevin Hern,REP,730208,5,17,176,198,01
Wagoner,Governor,Chris Powell,LIB,730208,0,0,0,0,
Wagoner,Governor,Rex Lawhorn,LIB,730208,0,0,0,0,
Wagoner,Corporation Commissioner,Ashley Nicole Mccray,DEM,730208,0,9,108,117,
Wagoner,Corporation Commissioner,Blake Cummings,DEM,730208,0,9,81,90,
Wagoner,U.S. House,Tim Gilpin,DEM,730208,0,15,118,133,01
Wagoner,U.S. House,Amanda Douglas,DEM,730208,0,3,71,74,01
Wagoner,Governor,Mick Cornett,REP,730209,0,3,34,37,
Wagoner,Governor,Kevin Stitt,REP,730209,0,1,58,59,
Wagoner,Lieutenant Governor,Dana Murphy,REP,730209,0,3,32,35,
Wagoner,Lieutenant Governor,Matt Pinnell,REP,730209,0,1,58,59,
Wagoner,State Auditor,Cindy Byrd,REP,730209,0,1,43,44,
Wagoner,State Auditor,Charlie Prater,REP,730209,0,3,42,45,
Wagoner,Attorney General,Mike Hunter,REP,730209,0,3,35,38,
Wagoner,Attorney General,Gentner Drummond,REP,730209,0,1,55,56,
Wagoner,Superintendent of Public Instruction,Joy Hofmeister,REP,730209,0,4,52,56,
Wagoner,Superintendent of Public Instruction,Linda Murphy,REP,730209,0,0,35,35,
Wagoner,Commissioner of Labor,Cathy Costello,REP,730209,0,1,34,35,
Wagoner,Commissioner of Labor,Leslie Osborn,REP,730209,0,3,53,56,
Wagoner,Corporation Commissioner,Bob Anthony,REP,730209,0,3,44,47,
Wagoner,Corporation Commissioner,Brian Bingman,REP,730209,0,1,45,46,
Wagoner,U.S. House,Tim Harris,REP,730209,0,1,17,18,01
Wagoner,U.S. House,Kevin Hern,REP,730209,0,3,74,77,01
Wagoner,Governor,Chris Powell,LIB,730209,0,0,0,0,
Wagoner,Governor,Rex Lawhorn,LIB,730209,0,0,0,0,
Wagoner,Corporation Commissioner,Ashley Nicole Mccray,DEM,730209,1,0,18,19,
Wagoner,Corporation Commissioner,Blake Cummings,DEM,730209,0,0,11,11,
Wagoner,U.S. House,Tim Gilpin,DEM,730209,1,0,22,23,01
Wagoner,U.S. House,Amanda Douglas,DEM,730209,0,0,7,7,01
Wagoner,Governor,Mick Cornett,REP,730210,5,1,54,60,
Wagoner,Governor,Kevin Stitt,REP,730210,4,6,131,141,
Wagoner,Lieutenant Governor,Dana Murphy,REP,730210,2,2,56,60,
Wagoner,Lieutenant Governor,Matt Pinnell,REP,730210,7,4,125,136,
Wagoner,State Auditor,Cindy Byrd,REP,730210,6,4,86,96,
Wagoner,State Auditor,Charlie Prater,REP,730210,3,1,87,91,
Wagoner,Attorney General,Mike Hunter,REP,730210,7,2,88,97,
Wagoner,Attorney General,Gentner Drummond,REP,730210,2,5,95,102,
Wagoner,Superintendent of Public Instruction,Joy Hofmeister,REP,730210,3,2,94,99,
Wagoner,Superintendent of Public Instruction,Linda Murphy,REP,730210,6,5,89,100,
Wagoner,Commissioner of Labor,Cathy Costello,REP,730210,3,2,75,80,
Wagoner,Commissioner of Labor,Leslie Osborn,REP,730210,6,3,104,113,
Wagoner,Corporation Commissioner,Bob Anthony,REP,730210,5,4,73,82,
Wagoner,Corporation Commissioner,Brian Bingman,REP,730210,4,1,104,109,
Wagoner,U.S. House,Tim Harris,REP,730210,1,4,44,49,01
Wagoner,U.S. House,Kevin Hern,REP,730210,8,3,140,151,01
Wagoner,Governor,Chris Powell,LIB,730210,0,0,1,1,
Wagoner,Governor,Rex Lawhorn,LIB,730210,0,0,0,0,
Wagoner,Corporation Commissioner,Ashley Nicole Mccray,DEM,730210,2,4,51,57,
Wagoner,Corporation Commissioner,Blake Cummings,DEM,730210,0,1,44,45,
Wagoner,U.S. House,Tim Gilpin,DEM,730210,2,4,51,57,01
Wagoner,U.S. House,Amanda Douglas,DEM,730210,1,1,44,46,01
Wagoner,Governor,Mick Cornett,REP,730301,6,23,149,178,
Wagoner,Governor,Kevin Stitt,REP,730301,11,39,253,303,
Wagoner,Lieutenant Governor,Dana Murphy,REP,730301,6,26,149,181,
Wagoner,Lieutenant Governor,Matt Pinnell,REP,730301,11,36,244,291,
Wagoner,State Auditor,Cindy Byrd,REP,730301,7,29,188,224,
Wagoner,State Auditor,Charlie Prater,REP,730301,10,30,181,221,
Wagoner,Attorney General,Mike Hunter,REP,730301,8,35,187,230,
Wagoner,Attorney General,Gentner Drummond,REP,730301,9,27,209,245,
Wagoner,Superintendent of Public Instruction,Joy Hofmeister,REP,730301,6,37,222,265,
Wagoner,Superintendent of Public Instruction,Linda Murphy,REP,730301,10,26,162,198,
Wagoner,Commissioner of Labor,Cathy Costello,REP,730301,8,29,195,232,
Wagoner,Commissioner of Labor,Leslie Osborn,REP,730301,9,32,186,227,
Wagoner,Corporation Commissioner,Bob Anthony,REP,730301,6,27,219,252,
Wagoner,Corporation Commissioner,Brian Bingman,REP,730301,11,32,163,206,
Wagoner,U.S. House,Tim Harris,REP,730301,10,22,179,211,01
Wagoner,U.S. House,Kevin Hern,REP,730301,7,40,220,267,01
Wagoner,State Senate,John Haste,REP,730301,11,38,200,249,36
Wagoner,State Senate,Bill Day,REP,730301,6,25,191,222,36
Wagoner,State House,Laura Steele,REP,730301,5,20,112,137,98
Wagoner,State House,Dean Davis,REP,730301,12,40,269,321,98
Wagoner,Governor,Chris Powell,LIB,730301,0,0,0,0,
Wagoner,Governor,Rex Lawhorn,LIB,730301,0,0,2,2,
Wagoner,Corporation Commissioner,Ashley Nicole Mccray,DEM,730301,1,4,64,69,
Wagoner,Corporation Commissioner,Blake Cummings,DEM,730301,1,7,28,36,
Wagoner,U.S. House,Tim Gilpin,DEM,730301,1,6,41,48,01
Wagoner,U.S. House,Amanda Douglas,DEM,730301,1,5,52,58,01
Wagoner,Governor,Mick Cornett,REP,730302,4,64,175,243,
Wagoner,Governor,Kevin Stitt,REP,730302,16,82,335,433,
Wagoner,Lieutenant Governor,Dana Murphy,REP,730302,11,60,187,258,
Wagoner,Lieutenant Governor,Matt Pinnell,REP,730302,9,80,307,396,
Wagoner,State Auditor,Cindy Byrd,REP,730302,16,76,254,346,
Wagoner,State Auditor,Charlie Prater,REP,730302,4,64,223,291,
Wagoner,Attorney General,Mike Hunter,REP,730302,12,64,238,314,
Wagoner,Attorney General,Gentner Drummond,REP,730302,8,77,259,344,
Wagoner,Superintendent of Public Instruction,Joy Hofmeister,REP,730302,3,87,300,390,
Wagoner,Superintendent of Public Instruction,Linda Murphy,REP,730302,17,51,188,256,
Wagoner,Commissioner of Labor,Cathy Costello,REP,730302,13,60,227,300,
Wagoner,Commissioner of Labor,Leslie Osborn,REP,730302,7,80,249,336,
Wagoner,Corporation Commissioner,Bob Anthony,REP,730302,12,78,240,330,
Wagoner,Corporation Commissioner,Brian Bingman,REP,730302,8,61,240,309,
Wagoner,U.S. House,Tim Harris,REP,730302,13,67,199,279,01
Wagoner,U.S. House,Kevin Hern,REP,730302,7,78,300,385,01
Wagoner,State Senate,John Haste,REP,730302,14,90,271,375,36
Wagoner,State Senate,Bill Day,REP,730302,6,56,226,288,36
Wagoner,State House,Laura Steele,REP,730302,11,39,126,176,98
Wagoner,State House,Dean Davis,REP,730302,9,103,363,475,98
Wagoner,Governor,Chris Powell,LIB,730302,0,0,1,1,
Wagoner,Governor,Rex Lawhorn,LIB,730302,0,0,0,0,
Wagoner,Corporation Commissioner,Ashley Nicole Mccray,DEM,730302,9,18,59,86,
Wagoner,Corporation Commissioner,Blake Cummings,DEM,730302,2,11,31,44,
Wagoner,U.S. House,Tim Gilpin,DEM,730302,6,19,51,76,01
Wagoner,U.S. House,Amanda Douglas,DEM,730302,5,10,40,55,01
Wagoner,Governor,Mick Cornett,REP,730303,0,5,67,72,
Wagoner,Governor,Kevin Stitt,REP,730303,1,23,129,153,
Wagoner,Lieutenant Governor,Dana Murphy,REP,730303,0,7,81,88,
Wagoner,Lieutenant Governor,Matt Pinnell,REP,730303,1,21,112,134,
Wagoner,State Auditor,Cindy Byrd,REP,730303,0,21,92,113,
Wagoner,State Auditor,Charlie Prater,REP,730303,1,6,94,101,
Wagoner,Attorney General,Mike Hunter,REP,730303,0,11,91,102,
Wagoner,Attorney General,Gentner Drummond,REP,730303,1,16,101,118,
Wagoner,Superintendent of Public Instruction,Joy Hofmeister,REP,730303,1,11,114,126,
Wagoner,Superintendent of Public Instruction,Linda Murphy,REP,730303,0,16,79,95,
Wagoner,Commissioner of Labor,Cathy Costello,REP,730303,1,16,86,103,
Wagoner,Commissioner of Labor,Leslie Osborn,REP,730303,0,9,101,110,
Wagoner,Corporation Commissioner,Bob Anthony,REP,730303,0,10,93,103,
Wagoner,Corporation Commissioner,Brian Bingman,REP,730303,1,18,90,109,
Wagoner,U.S. House,Tim Harris,REP,730303,1,19,90,110,01
Wagoner,U.S. House,Kevin Hern,REP,730303,0,9,105,114,01
Wagoner,State Senate,John Haste,REP,730303,1,21,125,147,36
Wagoner,State Senate,Bill Day,REP,730303,0,7,70,77,36
Wagoner,Governor,Chris Powell,LIB,730303,0,0,0,0,
Wagoner,Governor,Rex Lawhorn,LIB,730303,0,0,0,0,
Wagoner,Corporation Commissioner,Ashley Nicole Mccray,DEM,730303,1,1,20,22,
Wagoner,Corporation Commissioner,Blake Cummings,DEM,730303,1,4,12,17,
Wagoner,U.S. House,Tim Gilpin,DEM,730303,1,4,17,22,01
Wagoner,U.S. House,Amanda Douglas,DEM,730303,2,1,15,18,01
Wagoner,Governor,Mick Cornett,REP,730304,0,7,77,84,
Wagoner,Governor,Kevin Stitt,REP,730304,1,3,184,188,
Wagoner,Lieutenant Governor,Dana Murphy,REP,730304,1,4,109,114,
Wagoner,Lieutenant Governor,Matt Pinnell,REP,730304,0,6,148,154,
Wagoner,State Auditor,Cindy Byrd,REP,730304,0,5,106,111,
Wagoner,State Auditor,Charlie Prater,REP,730304,1,5,140,146,
Wagoner,Attorney General,Mike Hunter,REP,730304,1,3,122,126,
Wagoner,Attorney General,Gentner Drummond,REP,730304,0,7,134,141,
Wagoner,Superintendent of Public Instruction,Joy Hofmeister,REP,730304,0,7,150,157,
Wagoner,Superintendent of Public Instruction,Linda Murphy,REP,730304,1,3,108,112,
Wagoner,Commissioner of Labor,Cathy Costello,REP,730304,1,2,133,136,
Wagoner,Commissioner of Labor,Leslie Osborn,REP,730304,0,8,122,130,
Wagoner,Corporation Commissioner,Bob Anthony,REP,730304,0,4,147,151,
Wagoner,Corporation Commissioner,Brian Bingman,REP,730304,1,6,108,115,
Wagoner,U.S. House,Tim Harris,REP,730304,1,4,97,102,01
Wagoner,U.S. House,Kevin Hern,REP,730304,0,6,160,166,01
Wagoner,State House,Laura Steele,REP,730304,1,5,77,83,98
Wagoner,State House,Dean Davis,REP,730304,0,5,178,183,98
Wagoner,Governor,Chris Powell,LIB,730304,0,0,1,1,
Wagoner,Governor,Rex Lawhorn,LIB,730304,0,0,6,6,
Wagoner,Corporation Commissioner,Ashley Nicole Mccray,DEM,730304,3,0,46,49,
Wagoner,Corporation Commissioner,Blake Cummings,DEM,730304,2,2,18,22,
Wagoner,U.S. House,Tim Gilpin,DEM,730304,2,1,29,32,01
Wagoner,U.S. House,Amanda Douglas,DEM,730304,3,1,35,39,01
Wagoner,Governor,Mick Cornett,REP,730305,3,2,12,17,
Wagoner,Governor,Kevin Stitt,REP,730305,2,0,20,22,
Wagoner,Lieutenant Governor,Dana Murphy,REP,730305,3,1,15,19,
Wagoner,Lieutenant Governor,Matt Pinnell,REP,730305,2,1,17,20,
Wagoner,State Auditor,Cindy Byrd,REP,730305,3,2,11,16,
Wagoner,State Auditor,Charlie Prater,REP,730305,2,0,21,23,
Wagoner,Attorney General,Mike Hunter,REP,730305,3,2,8,13,
Wagoner,Attorney General,Gentner Drummond,REP,730305,2,0,24,26,
Wagoner,Superintendent of Public Instruction,Joy Hofmeister,REP,730305,4,2,11,17,
Wagoner,Superintendent of Public Instruction,Linda Murphy,REP,730305,1,0,20,21,
Wagoner,Commissioner of Labor,Cathy Costello,REP,730305,3,1,12,16,
Wagoner,Commissioner of Labor,Leslie Osborn,REP,730305,1,1,20,22,
Wagoner,Corporation Commissioner,Bob Anthony,REP,730305,4,2,17,23,
Wagoner,Corporation Commissioner,Brian Bingman,REP,730305,0,0,15,15,
Wagoner,U.S. House,Tim Harris,REP,730305,5,2,14,21,01
Wagoner,U.S. House,Kevin Hern,REP,730305,0,0,18,18,01
Wagoner,Governor,Chris Powell,LIB,730305,0,0,0,0,
Wagoner,Governor,Rex Lawhorn,LIB,730305,0,0,0,0,
Wagoner,Corporation Commissioner,Ashley Nicole Mccray,DEM,730305,0,0,2,2,
Wagoner,Corporation Commissioner,Blake Cummings,DEM,730305,0,0,0,0,
Wagoner,U.S. House,Tim Gilpin,DEM,730305,0,0,0,0,01
Wagoner,U.S. House,Amanda Douglas,DEM,730305,0,0,2,2,01
Wagoner,Governor,Mick Cornett,REP,730306,6,7,147,160,
Wagoner,Governor,Kevin Stitt,REP,730306,13,15,316,344,
Wagoner,Lieutenant Governor,Dana Murphy,REP,730306,7,12,195,214,
Wagoner,Lieutenant Governor,Matt Pinnell,REP,730306,12,7,251,270,
Wagoner,State Auditor,Cindy Byrd,REP,730306,15,13,230,258,
Wagoner,State Auditor,Charlie Prater,REP,730306,4,8,211,223,
Wagoner,Attorney General,Mike Hunter,REP,730306,10,7,218,235,
Wagoner,Attorney General,Gentner Drummond,REP,730306,8,14,239,261,
Wagoner,Superintendent of Public Instruction,Joy Hofmeister,REP,730306,13,10,252,275,
Wagoner,Superintendent of Public Instruction,Linda Murphy,REP,730306,6,12,206,224,
Wagoner,Commissioner of Labor,Cathy Costello,REP,730306,10,12,248,270,
Wagoner,Commissioner of Labor,Leslie Osborn,REP,730306,9,10,203,222,
Wagoner,Corporation Commissioner,Bob Anthony,REP,730306,10,16,238,264,
Wagoner,Corporation Commissioner,Brian Bingman,REP,730306,9,5,206,220,
Wagoner,U.S. House,Tim Harris,REP,730306,13,7,205,225,01
Wagoner,U.S. House,Kevin Hern,REP,730306,6,13,254,273,01
Wagoner,State House,Stan May,REP,730306,11,11,251,273,80
Wagoner,State House,Mike Ritze,REP,730306,8,11,201,220,80
Wagoner,Governor,Chris Powell,LIB,730306,0,0,1,1,
Wagoner,Governor,Rex Lawhorn,LIB,730306,0,0,0,0,
Wagoner,Corporation Commissioner,Ashley Nicole Mccray,DEM,730306,3,0,67,70,
Wagoner,Corporation Commissioner,Blake Cummings,DEM,730306,2,0,32,34,
Wagoner,U.S. House,Tim Gilpin,DEM,730306,2,0,36,38,01
Wagoner,U.S. House,Amanda Douglas,DEM,730306,3,0,66,69,01
Wagoner,Governor,Mick Cornett,REP,730307,3,4,99,106,
Wagoner,Governor,Kevin Stitt,REP,730307,9,14,213,236,
Wagoner,Lieutenant Governor,Dana Murphy,REP,730307,4,9,99,112,
Wagoner,Lieutenant Governor,Matt Pinnell,REP,730307,8,9,205,222,
Wagoner,State Auditor,Cindy Byrd,REP,730307,7,10,133,150,
Wagoner,State Auditor,Charlie Prater,REP,730307,5,6,160,171,
Wagoner,Attorney General,Mike Hunter,REP,730307,4,5,124,133,
Wagoner,Attorney General,Gentner Drummond,REP,730307,8,12,184,204,
Wagoner,Superintendent of Public Instruction,Joy Hofmeister,REP,730307,4,7,147,158,
Wagoner,Superintendent of Public Instruction,Linda Murphy,REP,730307,8,10,157,175,
Wagoner,Commissioner of Labor,Cathy Costello,REP,730307,11,7,148,166,
Wagoner,Commissioner of Labor,Leslie Osborn,REP,730307,1,9,145,155,
Wagoner,Corporation Commissioner,Bob Anthony,REP,730307,6,10,137,153,
Wagoner,Corporation Commissioner,Brian Bingman,REP,730307,6,6,161,173,
Wagoner,U.S. House,Tim Harris,REP,730307,5,12,105,122,01
Wagoner,U.S. House,Kevin Hern,REP,730307,7,6,202,215,01
Wagoner,Governor,Chris Powell,LIB,730307,0,0,0,0,
Wagoner,Governor,Rex Lawhorn,LIB,730307,0,0,0,0,
Wagoner,Corporation Commissioner,Ashley Nicole Mccray,DEM,730307,2,0,27,29,
Wagoner,Corporation Commissioner,Blake Cummings,DEM,730307,1,2,19,22,
Wagoner,U.S. House,Tim Gilpin,DEM,730307,3,1,25,29,01
Wagoner,U.S. House,Amanda Douglas,DEM,730307,0,1,21,22,01
Wagoner,Governor,Mick Cornett,REP,730308,5,1,59,65,
Wagoner,Governor,Kevin Stitt,REP,730308,3,7,162,172,
Wagoner,Lieutenant Governor,Dana Murphy,REP,730308,3,3,70,76,
Wagoner,Lieutenant Governor,Matt Pinnell,REP,730308,4,5,147,156,
Wagoner,State Auditor,Cindy Byrd,REP,730308,6,3,98,107,
Wagoner,State Auditor,Charlie Prater,REP,730308,2,4,116,122,
Wagoner,Attorney General,Mike Hunter,REP,730308,5,1,95,101,
Wagoner,Attorney General,Gentner Drummond,REP,730308,3,7,126,136,
Wagoner,Superintendent of Public Instruction,Joy Hofmeister,REP,730308,6,5,125,136,
Wagoner,Superintendent of Public Instruction,Linda Murphy,REP,730308,2,3,95,100,
Wagoner,Commissioner of Labor,Cathy Costello,REP,730308,4,3,108,115,
Wagoner,Commissioner of Labor,Leslie Osborn,REP,730308,4,4,107,115,
Wagoner,Corporation Commissioner,Bob Anthony,REP,730308,6,4,99,109,
Wagoner,Corporation Commissioner,Brian Bingman,REP,730308,2,4,118,124,
Wagoner,U.S. House,Tim Harris,REP,730308,4,2,97,103,01
Wagoner,U.S. House,Kevin Hern,REP,730308,4,6,125,135,01
Wagoner,Governor,Chris Powell,LIB,730308,0,0,1,1,
Wagoner,Governor,Rex Lawhorn,LIB,730308,0,0,1,1,
Wagoner,Corporation Commissioner,Ashley Nicole Mccray,DEM,730308,1,3,22,26,
Wagoner,Corporation Commissioner,Blake Cummings,DEM,730308,2,1,24,27,
Wagoner,U.S. House,Tim Gilpin,DEM,730308,3,4,30,37,01
Wagoner,U.S. House,Amanda Douglas,DEM,730308,0,0,17,17,01
Wagoner,Governor,Mick Cornett,REP,730309,3,2,67,72,
Wagoner,Governor,Kevin Stitt,REP,730309,3,7,144,154,
Wagoner,Lieutenant Governor,Dana Murphy,REP,730309,3,3,85,91,
Wagoner,Lieutenant Governor,Matt Pinnell,REP,730309,3,6,122,131,
Wagoner,State Auditor,Cindy Byrd,REP,730309,1,4,102,107,
Wagoner,State Auditor,Charlie Prater,REP,730309,5,4,100,109,
Wagoner,Attorney General,Mike Hunter,REP,730309,5,5,83,93,
Wagoner,Attorney General,Gentner Drummond,REP,730309,2,4,127,133,
Wagoner,Superintendent of Public Instruction,Joy Hofmeister,REP,730309,4,6,104,114,
Wagoner,Superintendent of Public Instruction,Linda Murphy,REP,730309,2,3,104,109,
Wagoner,Commissioner of Labor,Cathy Costello,REP,730309,3,4,104,111,
Wagoner,Commissioner of Labor,Leslie Osborn,REP,730309,3,5,102,110,
Wagoner,Corporation Commissioner,Bob Anthony,REP,730309,2,2,90,94,
Wagoner,Corporation Commissioner,Brian Bingman,REP,730309,4,7,113,124,
Wagoner,U.S. House,Tim Harris,REP,730309,3,3,71,77,01
Wagoner,U.S. House,Kevin Hern,REP,730309,4,6,140,150,01
Wagoner,Governor,Chris Powell,LIB,730309,0,0,0,0,
Wagoner,Governor,Rex Lawhorn,LIB,730309,0,0,1,1,
Wagoner,Corporation Commissioner,Ashley Nicole Mccray,DEM,730309,2,0,36,38,
Wagoner,Corporation Commissioner,Blake Cummings,DEM,730309,1,1,20,22,
Wagoner,U.S. House,Tim Gilpin,DEM,730309,3,1,28,32,01
Wagoner,U.S. House,Amanda Douglas,DEM,730309,1,0,28,29,01
Wagoner,Governor,Mick Cornett,REP,730310,1,0,21,22,
Wagoner,Governor,Kevin Stitt,REP,730310,2,1,92,95,
Wagoner,Lieutenant Governor,Dana Murphy,REP,730310,0,0,29,29,
Wagoner,Lieutenant Governor,Matt Pinnell,REP,730310,3,1,84,88,
Wagoner,State Auditor,Cindy Byrd,REP,730310,1,2,51,54,
Wagoner,State Auditor,Charlie Prater,REP,730310,2,0,60,62,
Wagoner,Attorney General,Mike Hunter,REP,730310,0,0,36,36,
Wagoner,Attorney General,Gentner Drummond,REP,730310,3,1,78,82,
Wagoner,Superintendent of Public Instruction,Joy Hofmeister,REP,730310,1,0,59,60,
Wagoner,Superintendent of Public Instruction,Linda Murphy,REP,730310,2,1,54,57,
Wagoner,Commissioner of Labor,Cathy Costello,REP,730310,1,0,50,51,
Wagoner,Commissioner of Labor,Leslie Osborn,REP,730310,2,1,61,64,
Wagoner,Corporation Commissioner,Bob Anthony,REP,730310,2,0,67,69,
Wagoner,Corporation Commissioner,Brian Bingman,REP,730310,1,1,44,46,
Wagoner,U.S. House,Tim Harris,REP,730310,1,0,40,41,01
Wagoner,U.S. House,Kevin Hern,REP,730310,2,1,74,77,01
Wagoner,Governor,Chris Powell,LIB,730310,0,0,0,0,
Wagoner,Governor,Rex Lawhorn,LIB,730310,0,0,0,0,
Wagoner,Corporation Commissioner,Ashley Nicole Mccray,DEM,730310,0,0,17,17,
Wagoner,Corporation Commissioner,Blake Cummings,DEM,730310,0,0,16,16,
Wagoner,U.S. House,Tim Gilpin,DEM,730310,0,0,18,18,01
Wagoner,U.S. House,Amanda Douglas,DEM,730310,0,0,15,15,01
Wagoner,Governor,Mick Cornett,REP,730311,1,1,24,26,
Wagoner,Governor,Kevin Stitt,REP,730311,0,0,41,41,
Wagoner,Lieutenant Governor,Dana Murphy,REP,730311,2,0,21,23,
Wagoner,Lieutenant Governor,Matt Pinnell,REP,730311,0,1,41,42,
Wagoner,State Auditor,Cindy Byrd,REP,730311,2,0,25,27,
Wagoner,State Auditor,Charlie Prater,REP,730311,0,1,36,37,
Wagoner,Attorney General,Mike Hunter,REP,730311,0,0,32,32,
Wagoner,Attorney General,Gentner Drummond,REP,730311,2,1,31,34,
Wagoner,Superintendent of Public Instruction,Joy Hofmeister,REP,730311,2,1,33,36,
Wagoner,Superintendent of Public Instruction,Linda Murphy,REP,730311,0,0,30,30,
Wagoner,Commissioner of Labor,Cathy Costello,REP,730311,2,1,30,33,
Wagoner,Commissioner of Labor,Leslie Osborn,REP,730311,0,0,32,32,
Wagoner,Corporation Commissioner,Bob Anthony,REP,730311,2,1,32,35,
Wagoner,Corporation Commissioner,Brian Bingman,REP,730311,0,0,30,30,
Wagoner,U.S. House,Tim Harris,REP,730311,1,0,24,25,01
Wagoner,U.S. House,Kevin Hern,REP,730311,1,1,40,42,01
Wagoner,Governor,Chris Powell,LIB,730311,0,0,0,0,
Wagoner,Governor,Rex Lawhorn,LIB,730311,0,0,0,0,
Wagoner,Corporation Commissioner,Ashley Nicole Mccray,DEM,730311,0,0,8,8,
Wagoner,Corporation Commissioner,Blake Cummings,DEM,730311,0,0,9,9,
Wagoner,U.S. House,Tim Gilpin,DEM,730311,0,0,5,5,01
Wagoner,U.S. House,Amanda Douglas,DEM,730311,0,0,12,12,01
Wagoner,Governor,Mick Cornett,REP,730312,0,2,51,53,
Wagoner,Governor,Kevin Stitt,REP,730312,0,5,113,118,
Wagoner,Lieutenant Governor,Dana Murphy,REP,730312,0,6,50,56,
Wagoner,Lieutenant Governor,Matt Pinnell,REP,730312,0,1,112,113,
Wagoner,State Auditor,Cindy Byrd,REP,730312,0,7,72,79,
Wagoner,State Auditor,Charlie Prater,REP,730312,0,0,87,87,
Wagoner,Attorney General,Mike Hunter,REP,730312,0,4,69,73,
Wagoner,Attorney General,Gentner Drummond,REP,730312,0,3,93,96,
Wagoner,Superintendent of Public Instruction,Joy Hofmeister,REP,730312,0,5,76,81,
Wagoner,Superintendent of Public Instruction,Linda Murphy,REP,730312,0,2,86,88,
Wagoner,Commissioner of Labor,Cathy Costello,REP,730312,0,3,64,67,
Wagoner,Commissioner of Labor,Leslie Osborn,REP,730312,0,4,97,101,
Wagoner,Corporation Commissioner,Bob Anthony,REP,730312,0,4,77,81,
Wagoner,Corporation Commissioner,Brian Bingman,REP,730312,0,3,84,87,
Wagoner,U.S. House,Tim Harris,REP,730312,0,2,61,63,01
Wagoner,U.S. House,Kevin Hern,REP,730312,0,5,102,107,01
Wagoner,Governor,Chris Powell,LIB,730312,0,0,0,0,
Wagoner,Governor,Rex Lawhorn,LIB,730312,0,0,0,0,
Wagoner,Corporation Commissioner,Ashley Nicole Mccray,DEM,730312,2,2,43,47,
Wagoner,Corporation Commissioner,Blake Cummings,DEM,730312,1,0,35,36,
Wagoner,U.S. House,Tim Gilpin,DEM,730312,1,2,33,36,01
Wagoner,U.S. House,Amanda Douglas,DEM,730312,2,0,45,47,01
Wagoner,Governor,Mick Cornett,REP,730313,0,2,17,19,
Wagoner,Governor,Kevin Stitt,REP,730313,6,0,38,44,
Wagoner,Lieutenant Governor,Dana Murphy,REP,730313,0,2,22,24,
Wagoner,Lieutenant Governor,Matt Pinnell,REP,730313,5,0,34,39,
Wagoner,State Auditor,Cindy Byrd,REP,730313,5,0,21,26,
Wagoner,State Auditor,Charlie Prater,REP,730313,1,2,31,34,
Wagoner,Attorney General,Mike Hunter,REP,730313,0,2,31,33,
Wagoner,Attorney General,Gentner Drummond,REP,730313,5,0,25,30,
Wagoner,Superintendent of Public Instruction,Joy Hofmeister,REP,730313,0,2,27,29,
Wagoner,Superintendent of Public Instruction,Linda Murphy,REP,730313,6,0,29,35,
Wagoner,Commissioner of Labor,Cathy Costello,REP,730313,4,2,32,38,
Wagoner,Commissioner of Labor,Leslie Osborn,REP,730313,2,0,21,23,
Wagoner,Corporation Commissioner,Bob Anthony,REP,730313,4,0,30,34,
Wagoner,Corporation Commissioner,Brian Bingman,REP,730313,2,2,24,28,
Wagoner,U.S. House,Tim Harris,REP,730313,1,0,19,20,01
Wagoner,U.S. House,Kevin Hern,REP,730313,5,2,36,43,01
Wagoner,Governor,Chris Powell,LIB,730313,0,0,0,0,
Wagoner,Governor,Rex Lawhorn,LIB,730313,0,0,0,0,
Wagoner,Corporation Commissioner,Ashley Nicole Mccray,DEM,730313,0,2,23,25,
Wagoner,Corporation Commissioner,Blake Cummings,DEM,730313,0,1,16,17,
Wagoner,U.S. House,Tim Gilpin,DEM,730313,0,0,22,22,01
Wagoner,U.S. House,Amanda Douglas,DEM,730313,0,3,17,20,01
Washington,Governor,Mick Cornett,REP,740011,4,11,128,143,
Washington,Governor,Kevin Stitt,REP,740011,3,5,156,164,
Washington,Lieutenant Governor,Dana Murphy,REP,740011,7,10,126,143,
Washington,Lieutenant Governor,Matt Pinnell,REP,740011,0,6,153,159,
Washington,State Auditor,Cindy Byrd,REP,740011,5,8,140,153,
Washington,State Auditor,Charlie Prater,REP,740011,1,6,121,128,
Washington,Attorney General,Mike Hunter,REP,740011,0,6,130,136,
Washington,Attorney General,Gentner Drummond,REP,740011,7,10,149,166,
Washington,Superintendent of Public Instruction,Joy Hofmeister,REP,740011,7,11,171,189,
Washington,Superintendent of Public Instruction,Linda Murphy,REP,740011,0,4,107,111,
Washington,Commissioner of Labor,Cathy Costello,REP,740011,6,6,141,153,
Washington,Commissioner of Labor,Leslie Osborn,REP,740011,1,9,128,138,
Washington,Corporation Commissioner,Bob Anthony,REP,740011,4,7,150,161,
Washington,Corporation Commissioner,Brian Bingman,REP,740011,3,8,111,122,
Washington,U.S. House,Tim Harris,REP,740011,4,9,108,121,01
Washington,U.S. House,Kevin Hern,REP,740011,3,7,170,180,01
Washington,Governor,Chris Powell,LIB,740011,0,0,0,0,
Washington,Governor,Rex Lawhorn,LIB,740011,0,0,1,1,
Washington,Corporation Commissioner,Ashley Nicole Mccray,DEM,740011,3,3,39,45,
Washington,Corporation Commissioner,Blake Cummings,DEM,740011,0,0,13,13,
Washington,U.S. House,Tim Gilpin,DEM,740011,2,2,26,30,01
Washington,U.S. House,Amanda Douglas,DEM,740011,1,1,26,28,01
Washington,Governor,Mick Cornett,REP,740012,0,5,40,45,
Washington,Governor,Kevin Stitt,REP,740012,0,3,41,44,
Washington,Lieutenant Governor,Dana Murphy,REP,740012,0,3,36,39,
Washington,Lieutenant Governor,Matt Pinnell,REP,740012,0,5,44,49,
Washington,State Auditor,Cindy Byrd,REP,740012,0,2,45,47,
Washington,State Auditor,Charlie Prater,REP,740012,0,5,32,37,
Washington,Attorney General,Mike Hunter,REP,740012,0,4,41,45,
Washington,Attorney General,Gentner Drummond,REP,740012,0,4,39,43,
Washington,Superintendent of Public Instruction,Joy Hofmeister,REP,740012,0,4,51,55,
Washington,Superintendent of Public Instruction,Linda Murphy,REP,740012,0,3,29,32,
Washington,Commissioner of Labor,Cathy Costello,REP,740012,0,1,39,40,
Washington,Commissioner of Labor,Leslie Osborn,REP,740012,0,6,42,48,
Washington,Corporation Commissioner,Bob Anthony,REP,740012,0,4,48,52,
Washington,Corporation Commissioner,Brian Bingman,REP,740012,0,3,32,35,
Washington,U.S. House,Tim Harris,REP,740012,0,4,38,42,01
Washington,U.S. House,Kevin Hern,REP,740012,0,4,44,48,01
Washington,Governor,Chris Powell,LIB,740012,0,0,0,0,
Washington,Governor,Rex Lawhorn,LIB,740012,0,0,0,0,
Washington,Corporation Commissioner,Ashley Nicole Mccray,DEM,740012,1,0,8,9,
Washington,Corporation Commissioner,Blake Cummings,DEM,740012,1,0,4,5,
Washington,U.S. House,Tim Gilpin,DEM,740012,1,0,9,10,01
Washington,U.S. House,Amanda Douglas,DEM,740012,1,0,3,4,01
Washington,Governor,Mick Cornett,REP,740013,2,5,104,111,
Washington,Governor,Kevin Stitt,REP,740013,1,2,172,175,
Washington,Lieutenant Governor,Dana Murphy,REP,740013,2,1,106,109,
Washington,Lieutenant Governor,Matt Pinnell,REP,740013,1,6,160,167,
Washington,State Auditor,Cindy Byrd,REP,740013,1,2,146,149,
Washington,State Auditor,Charlie Prater,REP,740013,2,5,118,125,
Washington,Attorney General,Mike Hunter,REP,740013,0,6,126,132,
Washington,Attorney General,Gentner Drummond,REP,740013,3,1,142,146,
Washington,Superintendent of Public Instruction,Joy Hofmeister,REP,740013,0,6,150,156,
Washington,Superintendent of Public Instruction,Linda Murphy,REP,740013,2,1,119,122,
Washington,Commissioner of Labor,Cathy Costello,REP,740013,2,6,137,145,
Washington,Commissioner of Labor,Leslie Osborn,REP,740013,1,1,124,126,
Washington,Corporation Commissioner,Bob Anthony,REP,740013,3,6,125,134,
Washington,Corporation Commissioner,Brian Bingman,REP,740013,0,1,136,137,
Washington,U.S. House,Tim Harris,REP,740013,1,4,83,88,01
Washington,U.S. House,Kevin Hern,REP,740013,2,3,184,189,01
Washington,State House,Travis Dunlap,REP,740013,1,5,122,128,10
Washington,State House,Judd Strom,REP,740013,2,2,154,158,10
Washington,Governor,Chris Powell,LIB,740013,0,1,1,2,
Washington,Governor,Rex Lawhorn,LIB,740013,0,0,0,0,
Washington,Corporation Commissioner,Ashley Nicole Mccray,DEM,740013,0,3,37,40,
Washington,Corporation Commissioner,Blake Cummings,DEM,740013,0,2,25,27,
Washington,U.S. House,Tim Gilpin,DEM,740013,0,5,31,36,01
Washington,U.S. House,Amanda Douglas,DEM,740013,0,0,32,32,01
Washington,Governor,Mick Cornett,REP,740015,2,11,125,138,
Washington,Governor,Kevin Stitt,REP,740015,0,7,187,194,
Washington,Lieutenant Governor,Dana Murphy,REP,740015,1,7,121,129,
Washington,Lieutenant Governor,Matt Pinnell,REP,740015,1,9,185,195,
Washington,State Auditor,Cindy Byrd,REP,740015,1,8,150,159,
Washington,State Auditor,Charlie Prater,REP,740015,1,6,154,161,
Washington,Attorney General,Mike Hunter,REP,740015,3,9,145,157,
Washington,Attorney General,Gentner Drummond,REP,740015,0,8,161,169,
Washington,Superintendent of Public Instruction,Joy Hofmeister,REP,740015,2,5,179,186,
Washington,Superintendent of Public Instruction,Linda Murphy,REP,740015,1,11,127,139,
Washington,Commissioner of Labor,Cathy Costello,REP,740015,1,8,151,160,
Washington,Commissioner of Labor,Leslie Osborn,REP,740015,1,6,151,158,
Washington,Corporation Commissioner,Bob Anthony,REP,740015,1,7,156,164,
Washington,Corporation Commissioner,Brian Bingman,REP,740015,1,7,144,152,
Washington,U.S. House,Tim Harris,REP,740015,2,10,122,134,01
Washington,U.S. House,Kevin Hern,REP,740015,0,5,188,193,01
Washington,State House,Travis Dunlap,REP,740015,1,6,133,140,10
Washington,State House,Judd Strom,REP,740015,2,12,180,194,10
Washington,Governor,Chris Powell,LIB,740015,0,0,0,0,
Washington,Governor,Rex Lawhorn,LIB,740015,0,0,0,0,
Washington,Corporation Commissioner,Ashley Nicole Mccray,DEM,740015,1,5,29,35,
Washington,Corporation Commissioner,Blake Cummings,DEM,740015,1,1,24,26,
Washington,U.S. House,Tim Gilpin,DEM,740015,1,6,33,40,01
Washington,U.S. House,Amanda Douglas,DEM,740015,1,0,20,21,01
Washington,Governor,Mick Cornett,REP,740022,19,42,360,421,
Washington,Governor,Kevin Stitt,REP,740022,14,30,393,437,
Washington,Lieutenant Governor,Dana Murphy,REP,740022,15,27,307,349,
Washington,Lieutenant Governor,Matt Pinnell,REP,740022,16,41,428,485,
Washington,State Auditor,Cindy Byrd,REP,740022,15,46,413,474,
Washington,State Auditor,Charlie Prater,REP,740022,12,20,302,334,
Washington,Attorney General,Mike Hunter,REP,740022,17,37,393,447,
Washington,Attorney General,Gentner Drummond,REP,740022,15,30,349,394,
Washington,Superintendent of Public Instruction,Joy Hofmeister,REP,740022,26,46,500,572,
Washington,Superintendent of Public Instruction,Linda Murphy,REP,740022,7,24,229,260,
Washington,Commissioner of Labor,Cathy Costello,REP,740022,18,40,396,454,
Washington,Commissioner of Labor,Leslie Osborn,REP,740022,14,26,328,368,
Washington,Corporation Commissioner,Bob Anthony,REP,740022,16,44,407,467,
Washington,Corporation Commissioner,Brian Bingman,REP,740022,16,22,295,333,
Washington,U.S. House,Tim Harris,REP,740022,18,39,322,379,01
Washington,U.S. House,Kevin Hern,REP,740022,15,29,419,463,01
Washington,Governor,Chris Powell,LIB,740022,0,0,0,0,
Washington,Governor,Rex Lawhorn,LIB,740022,0,0,3,3,
Washington,Corporation Commissioner,Ashley Nicole Mccray,DEM,740022,8,15,76,99,
Washington,Corporation Commissioner,Blake Cummings,DEM,740022,3,4,39,46,
Washington,U.S. House,Tim Gilpin,DEM,740022,7,16,80,103,01
Washington,U.S. House,Amanda Douglas,DEM,740022,4,3,36,43,01
Washington,Governor,Mick Cornett,REP,740027,2,1,37,40,
Washington,Governor,Kevin Stitt,REP,740027,0,5,99,104,
Washington,Lieutenant Governor,Dana Murphy,REP,740027,0,3,57,60,
Washington,Lieutenant Governor,Matt Pinnell,REP,740027,2,2,74,78,
Washington,State Auditor,Cindy Byrd,REP,740027,1,3,85,89,
Washington,State Auditor,Charlie Prater,REP,740027,0,2,43,45,
Washington,Attorney General,Mike Hunter,REP,740027,0,3,69,72,
Washington,Attorney General,Gentner Drummond,REP,740027,1,3,65,69,
Washington,Superintendent of Public Instruction,Joy Hofmeister,REP,740027,2,4,65,71,
Washington,Superintendent of Public Instruction,Linda Murphy,REP,740027,0,2,64,66,
Washington,Commissioner of Labor,Cathy Costello,REP,740027,0,4,60,64,
Washington,Commissioner of Labor,Leslie Osborn,REP,740027,1,2,65,68,
Washington,Corporation Commissioner,Bob Anthony,REP,740027,0,5,70,75,
Washington,Corporation Commissioner,Brian Bingman,REP,740027,1,0,52,53,
Washington,U.S. House,Tim Harris,REP,740027,0,1,53,54,01
Washington,U.S. House,Kevin Hern,REP,740027,1,3,78,82,01
Washington,State House,Travis Dunlap,REP,740027,0,5,66,71,10
Washington,State House,Judd Strom,REP,740027,2,1,70,73,10
Washington,Governor,Chris Powell,LIB,740027,0,0,0,0,
Washington,Governor,Rex Lawhorn,LIB,740027,0,0,0,0,
Washington,Corporation Commissioner,Ashley Nicole Mccray,DEM,740027,1,1,20,22,
Washington,Corporation Commissioner,Blake Cummings,DEM,740027,0,1,4,5,
Washington,U.S. House,Tim Gilpin,DEM,740027,0,2,15,17,01
Washington,U.S. House,Amanda Douglas,DEM,740027,1,0,10,11,01
Washington,Governor,Mick Cornett,REP,740028,8,35,269,312,
Washington,Governor,Kevin Stitt,REP,740028,9,26,350,385,
Washington,Lieutenant Governor,Dana Murphy,REP,740028,6,26,222,254,
Washington,Lieutenant Governor,Matt Pinnell,REP,740028,10,33,382,425,
Washington,State Auditor,Cindy Byrd,REP,740028,6,40,307,353,
Washington,State Auditor,Charlie Prater,REP,740028,10,20,282,312,
Washington,Attorney General,Mike Hunter,REP,740028,9,21,295,325,
Washington,Attorney General,Gentner Drummond,REP,740028,8,39,313,360,
Washington,Superintendent of Public Instruction,Joy Hofmeister,REP,740028,7,40,367,414,
Washington,Superintendent of Public Instruction,Linda Murphy,REP,740028,10,21,244,275,
Washington,Commissioner of Labor,Cathy Costello,REP,740028,10,31,285,326,
Washington,Commissioner of Labor,Leslie Osborn,REP,740028,6,28,310,344,
Washington,Corporation Commissioner,Bob Anthony,REP,740028,9,36,299,344,
Washington,Corporation Commissioner,Brian Bingman,REP,740028,7,22,296,325,
Washington,U.S. House,Tim Harris,REP,740028,10,34,226,270,01
Washington,U.S. House,Kevin Hern,REP,740028,6,26,385,417,01
Washington,Governor,Chris Powell,LIB,740028,0,0,1,1,
Washington,Governor,Rex Lawhorn,LIB,740028,0,0,1,1,
Washington,Corporation Commissioner,Ashley Nicole Mccray,DEM,740028,0,8,81,89,
Washington,Corporation Commissioner,Blake Cummings,DEM,740028,1,4,34,39,
Washington,U.S. House,Tim Gilpin,DEM,740028,0,12,71,83,01
Washington,U.S. House,Amanda Douglas,DEM,740028,1,1,44,46,01
Washington,Governor,Mick Cornett,REP,740031,2,13,174,189,
Washington,Governor,Kevin Stitt,REP,740031,6,22,206,234,
Washington,Lieutenant Governor,Dana Murphy,REP,740031,5,18,158,181,
Washington,Lieutenant Governor,Matt Pinnell,REP,740031,3,15,211,229,
Washington,State Auditor,Cindy Byrd,REP,740031,5,21,207,233,
Washington,State Auditor,Charlie Prater,REP,740031,2,11,152,165,
Washington,Attorney General,Mike Hunter,REP,740031,2,22,181,205,
Washington,Attorney General,Gentner Drummond,REP,740031,6,13,193,212,
Washington,Superintendent of Public Instruction,Joy Hofmeister,REP,740031,0,20,206,226,
Washington,Superintendent of Public Instruction,Linda Murphy,REP,740031,8,14,165,187,
Washington,Commissioner of Labor,Cathy Costello,REP,740031,2,19,198,219,
Washington,Commissioner of Labor,Leslie Osborn,REP,740031,5,14,168,187,
Washington,Corporation Commissioner,Bob Anthony,REP,740031,2,23,203,228,
Washington,Corporation Commissioner,Brian Bingman,REP,740031,6,12,166,184,
Washington,U.S. House,Tim Harris,REP,740031,3,13,145,161,01
Washington,U.S. House,Kevin Hern,REP,740031,5,21,229,255,01
Washington,Governor,Chris Powell,LIB,740031,0,0,1,1,
Washington,Governor,Rex Lawhorn,LIB,740031,0,0,0,0,
Washington,Corporation Commissioner,Ashley Nicole Mccray,DEM,740031,4,21,105,130,
Washington,Corporation Commissioner,Blake Cummings,DEM,740031,1,6,34,41,
Washington,U.S. House,Tim Gilpin,DEM,740031,1,17,81,99,01
Washington,U.S. House,Amanda Douglas,DEM,740031,4,10,59,73,01
Washington,Governor,Mick Cornett,REP,740033,0,0,21,21,
Washington,Governor,Kevin Stitt,REP,740033,1,1,43,45,
Washington,Lieutenant Governor,Dana Murphy,REP,740033,0,0,15,15,
Washington,Lieutenant Governor,Matt Pinnell,REP,740033,1,1,49,51,
Washington,State Auditor,Cindy Byrd,REP,740033,1,0,32,33,
Washington,State Auditor,Charlie Prater,REP,740033,0,1,31,32,
Washington,Attorney General,Mike Hunter,REP,740033,0,0,33,33,
Washington,Attorney General,Gentner Drummond,REP,740033,1,1,31,33,
Washington,Superintendent of Public Instruction,Joy Hofmeister,REP,740033,0,0,38,38,
Washington,Superintendent of Public Instruction,Linda Murphy,REP,740033,1,1,25,27,
Washington,Commissioner of Labor,Cathy Costello,REP,740033,1,0,26,27,
Washington,Commissioner of Labor,Leslie Osborn,REP,740033,0,1,37,38,
Washington,Corporation Commissioner,Bob Anthony,REP,740033,1,0,34,35,
Washington,Corporation Commissioner,Brian Bingman,REP,740033,0,1,28,29,
Washington,U.S. House,Tim Harris,REP,740033,1,0,21,22,01
Washington,U.S. House,Kevin Hern,REP,740033,0,1,43,44,01
Washington,Governor,Chris Powell,LIB,740033,0,0,1,1,
Washington,Governor,Rex Lawhorn,LIB,740033,0,0,0,0,
Washington,Corporation Commissioner,Ashley Nicole Mccray,DEM,740033,2,4,31,37,
Washington,Corporation Commissioner,Blake Cummings,DEM,740033,1,1,12,14,
Washington,U.S. House,Tim Gilpin,DEM,740033,1,3,14,18,01
Washington,U.S. House,Amanda Douglas,DEM,740033,2,2,29,33,01
Washington,Governor,Mick Cornett,REP,740046,1,1,33,35,
Washington,Governor,Kevin Stitt,REP,740046,2,3,69,74,
Washington,Lieutenant Governor,Dana Murphy,REP,740046,1,3,36,40,
Washington,Lieutenant Governor,Matt Pinnell,REP,740046,2,1,65,68,
Washington,State Auditor,Cindy Byrd,REP,740046,2,3,47,52,
Washington,State Auditor,Charlie Prater,REP,740046,1,1,54,56,
Washington,Attorney General,Mike Hunter,REP,740046,0,2,48,50,
Washington,Attorney General,Gentner Drummond,REP,740046,3,2,53,58,
Washington,Superintendent of Public Instruction,Joy Hofmeister,REP,740046,0,1,49,50,
Washington,Superintendent of Public Instruction,Linda Murphy,REP,740046,3,3,51,57,
Washington,Commissioner of Labor,Cathy Costello,REP,740046,3,1,45,49,
Washington,Commissioner of Labor,Leslie Osborn,REP,740046,0,3,54,57,
Washington,Corporation Commissioner,Bob Anthony,REP,740046,2,2,49,53,
Washington,Corporation Commissioner,Brian Bingman,REP,740046,1,2,50,53,
Washington,U.S. House,Tim Harris,REP,740046,3,2,41,46,01
Washington,U.S. House,Kevin Hern,REP,740046,0,2,60,62,01
Washington,State House,Travis Dunlap,REP,740046,3,3,62,68,10
Washington,State House,Judd Strom,REP,740046,0,1,41,42,10
Washington,Governor,Chris Powell,LIB,740046,0,0,0,0,
Washington,Governor,Rex Lawhorn,LIB,740046,0,0,0,0,
Washington,Corporation Commissioner,Ashley Nicole Mccray,DEM,740046,0,0,25,25,
Washington,Corporation Commissioner,Blake Cummings,DEM,740046,0,2,17,19,
Washington,U.S. House,Tim Gilpin,DEM,740046,0,2,19,21,01
Washington,U.S. House,Amanda Douglas,DEM,740046,0,0,23,23,01
Washington,Governor,Mick Cornett,REP,740048,2,7,75,84,
Washington,Governor,Kevin Stitt,REP,740048,3,3,105,111,
Washington,Lieutenant Governor,Dana Murphy,REP,740048,2,6,57,65,
Washington,Lieutenant Governor,Matt Pinnell,REP,740048,3,4,121,128,
Washington,State Auditor,Cindy Byrd,REP,740048,1,7,92,100,
Washington,State Auditor,Charlie Prater,REP,740048,4,2,84,90,
Washington,Attorney General,Mike Hunter,REP,740048,1,5,75,81,
Washington,Attorney General,Gentner Drummond,REP,740048,4,5,101,110,
Washington,Superintendent of Public Instruction,Joy Hofmeister,REP,740048,3,7,105,115,
Washington,Superintendent of Public Instruction,Linda Murphy,REP,740048,1,3,70,74,
Washington,Commissioner of Labor,Cathy Costello,REP,740048,2,6,89,97,
Washington,Commissioner of Labor,Leslie Osborn,REP,740048,2,3,87,92,
Washington,Corporation Commissioner,Bob Anthony,REP,740048,3,4,84,91,
Washington,Corporation Commissioner,Brian Bingman,REP,740048,2,5,90,97,
Washington,U.S. House,Tim Harris,REP,740048,1,2,76,79,01
Washington,U.S. House,Kevin Hern,REP,740048,4,7,104,115,01
Washington,State House,Travis Dunlap,REP,740048,4,2,83,89,10
Washington,State House,Judd Strom,REP,740048,1,8,96,105,10
Washington,Governor,Chris Powell,LIB,740048,0,0,0,0,
Washington,Governor,Rex Lawhorn,LIB,740048,0,0,2,2,
Washington,Corporation Commissioner,Ashley Nicole Mccray,DEM,740048,4,0,25,29,
Washington,Corporation Commissioner,Blake Cummings,DEM,740048,3,0,13,16,
Washington,U.S. House,Tim Gilpin,DEM,740048,2,0,14,16,01
Washington,U.S. House,Amanda Douglas,DEM,740048,5,0,24,29,01
Washington,Governor,Mick Cornett,REP,740051,5,18,181,204,
Washington,Governor,Kevin Stitt,REP,740051,3,12,248,263,
Washington,Lieutenant Governor,Dana Murphy,REP,740051,3,12,169,184,
Washington,Lieutenant Governor,Matt Pinnell,REP,740051,5,18,251,274,
Washington,State Auditor,Cindy Byrd,REP,740051,8,16,235,259,
Washington,State Auditor,Charlie Prater,REP,740051,0,14,177,191,
Washington,Attorney General,Mike Hunter,REP,740051,6,9,194,209,
Washington,Attorney General,Gentner Drummond,REP,740051,2,20,225,247,
Washington,Superintendent of Public Instruction,Joy Hofmeister,REP,740051,5,23,255,283,
Washington,Superintendent of Public Instruction,Linda Murphy,REP,740051,3,7,169,179,
Washington,Commissioner of Labor,Cathy Costello,REP,740051,4,13,227,244,
Washington,Commissioner of Labor,Leslie Osborn,REP,740051,4,17,185,206,
Washington,Corporation Commissioner,Bob Anthony,REP,740051,3,18,225,246,
Washington,Corporation Commissioner,Brian Bingman,REP,740051,5,10,179,194,
Washington,U.S. House,Tim Harris,REP,740051,5,12,174,191,01
Washington,U.S. House,Kevin Hern,REP,740051,3,18,250,271,01
Washington,State House,Travis Dunlap,REP,740051,4,9,183,196,10
Washington,State House,Judd Strom,REP,740051,4,22,247,273,10
Washington,Governor,Chris Powell,LIB,740051,0,0,0,0,
Washington,Governor,Rex Lawhorn,LIB,740051,0,0,0,0,
Washington,Corporation Commissioner,Ashley Nicole Mccray,DEM,740051,4,2,51,57,
Washington,Corporation Commissioner,Blake Cummings,DEM,740051,0,1,22,23,
Washington,U.S. House,Tim Gilpin,DEM,740051,1,3,48,52,01
Washington,U.S. House,Amanda Douglas,DEM,740051,3,0,25,28,01
Washington,Governor,Mick Cornett,REP,740054,12,12,212,236,
Washington,Governor,Kevin Stitt,REP,740054,9,4,260,273,
Washington,Lieutenant Governor,Dana Murphy,REP,740054,12,7,173,192,
Washington,Lieutenant Governor,Matt Pinnell,REP,740054,9,10,291,310,
Washington,State Auditor,Cindy Byrd,REP,740054,6,9,266,281,
Washington,State Auditor,Charlie Prater,REP,740054,14,7,191,212,
Washington,Attorney General,Mike Hunter,REP,740054,13,7,231,251,
Washington,Attorney General,Gentner Drummond,REP,740054,8,9,236,253,
Washington,Superintendent of Public Instruction,Joy Hofmeister,REP,740054,16,12,281,309,
Washington,Superintendent of Public Instruction,Linda Murphy,REP,740054,5,4,182,191,
Washington,Commissioner of Labor,Cathy Costello,REP,740054,10,7,248,265,
Washington,Commissioner of Labor,Leslie Osborn,REP,740054,11,9,206,226,
Washington,Corporation Commissioner,Bob Anthony,REP,740054,16,9,256,281,
Washington,Corporation Commissioner,Brian Bingman,REP,740054,5,8,200,213,
Washington,U.S. House,Tim Harris,REP,740054,16,11,201,228,01
Washington,U.S. House,Kevin Hern,REP,740054,5,5,265,275,01
Washington,Governor,Chris Powell,LIB,740054,0,0,0,0,
Washington,Governor,Rex Lawhorn,LIB,740054,0,0,0,0,
Washington,Corporation Commissioner,Ashley Nicole Mccray,DEM,740054,1,5,60,66,
Washington,Corporation Commissioner,Blake Cummings,DEM,740054,1,4,28,33,
Washington,U.S. House,Tim Gilpin,DEM,740054,1,7,49,57,01
Washington,U.S. House,Amanda Douglas,DEM,740054,1,2,39,42,01
Washington,Governor,Mick Cornett,REP,740062,6,4,99,109,
Washington,Governor,Kevin Stitt,REP,740062,7,3,222,232,
Washington,Lieutenant Governor,Dana Murphy,REP,740062,3,2,108,113,
Washington,Lieutenant Governor,Matt Pinnell,REP,740062,10,5,211,226,
Washington,State Auditor,Cindy Byrd,REP,740062,9,6,138,153,
Washington,State Auditor,Charlie Prater,REP,740062,3,1,175,179,
Washington,Attorney General,Mike Hunter,REP,740062,10,5,144,159,
Washington,Attorney General,Gentner Drummond,REP,740062,3,2,177,182,
Washington,Superintendent of Public Instruction,Joy Hofmeister,REP,740062,3,4,180,187,
Washington,Superintendent of Public Instruction,Linda Murphy,REP,740062,10,3,137,150,
Washington,Commissioner of Labor,Cathy Costello,REP,740062,10,3,151,164,
Washington,Commissioner of Labor,Leslie Osborn,REP,740062,3,4,163,170,
Washington,Corporation Commissioner,Bob Anthony,REP,740062,9,5,147,161,
Washington,Corporation Commissioner,Brian Bingman,REP,740062,4,2,169,175,
Washington,U.S. House,Tim Harris,REP,740062,10,5,100,115,01
Washington,U.S. House,Kevin Hern,REP,740062,3,2,217,222,01
Washington,State House,Travis Dunlap,REP,740062,10,3,122,135,10
Washington,State House,Judd Strom,REP,740062,3,4,198,205,10
Washington,Governor,Chris Powell,LIB,740062,0,0,1,1,
Washington,Governor,Rex Lawhorn,LIB,740062,0,0,1,1,
Washington,Corporation Commissioner,Ashley Nicole Mccray,DEM,740062,4,0,44,48,
Washington,Corporation Commissioner,Blake Cummings,DEM,740062,3,0,26,29,
Washington,U.S. House,Tim Gilpin,DEM,740062,3,0,28,31,01
Washington,U.S. House,Amanda Douglas,DEM,740062,4,0,43,47,01
Washington,Governor,Mick Cornett,REP,740071,1,0,87,88,
Washington,Governor,Kevin Stitt,REP,740071,1,2,167,170,
Washington,Lieutenant Governor,Dana Murphy,REP,740071,1,0,84,85,
Washington,Lieutenant Governor,Matt Pinnell,REP,740071,1,2,165,168,
Washington,State Auditor,Cindy Byrd,REP,740071,1,2,105,108,
Washington,State Auditor,Charlie Prater,REP,740071,1,0,136,137,
Washington,Attorney General,Mike Hunter,REP,740071,0,1,90,91,
Washington,Attorney General,Gentner Drummond,REP,740071,2,1,160,163,
Washington,Superintendent of Public Instruction,Joy Hofmeister,REP,740071,1,0,133,134,
Washington,Superintendent of Public Instruction,Linda Murphy,REP,740071,1,2,111,114,
Washington,Commissioner of Labor,Cathy Costello,REP,740071,1,2,100,103,
Washington,Commissioner of Labor,Leslie Osborn,REP,740071,1,0,141,142,
Washington,Corporation Commissioner,Bob Anthony,REP,740071,1,0,104,105,
Washington,Corporation Commissioner,Brian Bingman,REP,740071,1,2,141,144,
Washington,U.S. House,Tim Harris,REP,740071,0,0,68,68,01
Washington,U.S. House,Kevin Hern,REP,740071,2,2,182,186,01
Washington,State House,Travis Dunlap,REP,740071,0,1,72,73,10
Washington,State House,Judd Strom,REP,740071,2,1,181,184,10
Washington,Governor,Chris Powell,LIB,740071,0,0,0,0,
Washington,Governor,Rex Lawhorn,LIB,740071,0,0,0,0,
Washington,Corporation Commissioner,Ashley Nicole Mccray,DEM,740071,0,1,34,35,
Washington,Corporation Commissioner,Blake Cummings,DEM,740071,0,0,27,27,
Washington,U.S. House,Tim Gilpin,DEM,740071,0,1,38,39,01
Washington,U.S. House,Amanda Douglas,DEM,740071,0,0,23,23,01
Washington,Governor,Mick Cornett,REP,740073,2,0,56,58,
Washington,Governor,Kevin Stitt,REP,740073,3,6,105,114,
Washington,Lieutenant Governor,Dana Murphy,REP,740073,2,2,39,43,
Washington,Lieutenant Governor,Matt Pinnell,REP,740073,3,4,118,125,
Washington,State Auditor,Cindy Byrd,REP,740073,2,2,78,82,
Washington,State Auditor,Charlie Prater,REP,740073,3,4,77,84,
Washington,Attorney General,Mike Hunter,REP,740073,2,2,66,70,
Washington,Attorney General,Gentner Drummond,REP,740073,3,4,92,99,
Washington,Superintendent of Public Instruction,Joy Hofmeister,REP,740073,1,4,97,102,
Washington,Superintendent of Public Instruction,Linda Murphy,REP,740073,4,2,60,66,
Washington,Commissioner of Labor,Cathy Costello,REP,740073,2,4,72,78,
Washington,Commissioner of Labor,Leslie Osborn,REP,740073,3,2,82,87,
Washington,Corporation Commissioner,Bob Anthony,REP,740073,5,5,65,75,
Washington,Corporation Commissioner,Brian Bingman,REP,740073,0,1,89,90,
Washington,U.S. House,Tim Harris,REP,740073,2,4,39,45,01
Washington,U.S. House,Kevin Hern,REP,740073,3,2,118,123,01
Washington,State House,Travis Dunlap,REP,740073,1,1,67,69,10
Washington,State House,Judd Strom,REP,740073,4,5,92,101,10
Washington,Governor,Chris Powell,LIB,740073,0,0,0,0,
Washington,Governor,Rex Lawhorn,LIB,740073,0,0,0,0,
Washington,Corporation Commissioner,Ashley Nicole Mccray,DEM,740073,0,1,12,13,
Washington,Corporation Commissioner,Blake Cummings,DEM,740073,0,0,10,10,
Washington,U.S. House,Tim Gilpin,DEM,740073,0,0,10,10,01
Washington,U.S. House,Amanda Douglas,DEM,740073,0,1,12,13,01
Washington,Governor,Mick Cornett,REP,740074,1,3,59,63,
Washington,Governor,Kevin Stitt,REP,740074,2,3,90,95,
Washington,Lieutenant Governor,Dana Murphy,REP,740074,0,4,58,62,
Washington,Lieutenant Governor,Matt Pinnell,REP,740074,3,2,92,97,
Washington,State Auditor,Cindy Byrd,REP,740074,3,6,70,79,
Washington,State Auditor,Charlie Prater,REP,740074,0,0,77,77,
Washington,Attorney General,Mike Hunter,REP,740074,3,4,69,76,
Washington,Attorney General,Gentner Drummond,REP,740074,0,2,81,83,
Washington,Superintendent of Public Instruction,Joy Hofmeister,REP,740074,2,4,82,88,
Washington,Superintendent of Public Instruction,Linda Murphy,REP,740074,1,2,67,70,
Washington,Commissioner of Labor,Cathy Costello,REP,740074,1,3,75,79,
Washington,Commissioner of Labor,Leslie Osborn,REP,740074,2,3,74,79,
Washington,Corporation Commissioner,Bob Anthony,REP,740074,1,2,69,72,
Washington,Corporation Commissioner,Brian Bingman,REP,740074,2,4,77,83,
Washington,U.S. House,Tim Harris,REP,740074,3,3,45,51,01
Washington,U.S. House,Kevin Hern,REP,740074,0,2,105,107,01
Washington,State House,Travis Dunlap,REP,740074,2,1,53,56,10
Washington,State House,Judd Strom,REP,740074,1,5,97,103,10
Washington,Governor,Chris Powell,LIB,740074,0,0,0,0,
Washington,Governor,Rex Lawhorn,LIB,740074,0,0,0,0,
Washington,Corporation Commissioner,Ashley Nicole Mccray,DEM,740074,0,1,13,14,
Washington,Corporation Commissioner,Blake Cummings,DEM,740074,1,0,7,8,
Washington,U.S. House,Tim Gilpin,DEM,740074,1,0,7,8,01
Washington,U.S. House,Amanda Douglas,DEM,740074,0,1,13,14,01
Washington,Governor,Mick Cornett,REP,740075,1,4,81,86,
Washington,Governor,Kevin Stitt,REP,740075,3,9,144,156,
Washington,Lieutenant Governor,Dana Murphy,REP,740075,3,3,104,110,
Washington,Lieutenant Governor,Matt Pinnell,REP,740075,1,10,120,131,
Washington,State Auditor,Cindy Byrd,REP,740075,3,8,123,134,
Washington,State Auditor,Charlie Prater,REP,740075,1,4,95,100,
Washington,Attorney General,Mike Hunter,REP,740075,4,5,112,121,
Washington,Attorney General,Gentner Drummond,REP,740075,0,8,112,120,
Washington,Superintendent of Public Instruction,Joy Hofmeister,REP,740075,2,6,111,119,
Washington,Superintendent of Public Instruction,Linda Murphy,REP,740075,2,7,109,118,
Washington,Commissioner of Labor,Cathy Costello,REP,740075,2,9,105,116,
Washington,Commissioner of Labor,Leslie Osborn,REP,740075,2,4,111,117,
Washington,Corporation Commissioner,Bob Anthony,REP,740075,2,6,113,121,
Washington,Corporation Commissioner,Brian Bingman,REP,740075,2,7,110,119,
Washington,U.S. House,Tim Harris,REP,740075,2,8,98,108,01
Washington,U.S. House,Kevin Hern,REP,740075,2,5,124,131,01
Washington,Governor,Chris Powell,LIB,740075,0,0,0,0,
Washington,Governor,Rex Lawhorn,LIB,740075,0,0,0,0,
Washington,Corporation Commissioner,Ashley Nicole Mccray,DEM,740075,2,1,19,22,
Washington,Corporation Commissioner,Blake Cummings,DEM,740075,0,0,11,11,
Washington,U.S. House,Tim Gilpin,DEM,740075,1,0,22,23,01
Washington,U.S. House,Amanda Douglas,DEM,740075,1,1,9,11,01
Washington,Governor,Mick Cornett,REP,740076,0,2,48,50,
Washington,Governor,Kevin Stitt,REP,740076,3,3,89,95,
Washington,Lieutenant Governor,Dana Murphy,REP,740076,0,2,36,38,
Washington,Lieutenant Governor,Matt Pinnell,REP,740076,3,3,98,104,
Washington,State Auditor,Cindy Byrd,REP,740076,2,2,47,51,
Washington,State Auditor,Charlie Prater,REP,740076,1,3,81,85,
Washington,Attorney General,Mike Hunter,REP,740076,0,3,52,55,
Washington,Attorney General,Gentner Drummond,REP,740076,3,2,84,89,
Washington,Superintendent of Public Instruction,Joy Hofmeister,REP,740076,2,4,82,88,
Washington,Superintendent of Public Instruction,Linda Murphy,REP,740076,1,1,53,55,
Washington,Commissioner of Labor,Cathy Costello,REP,740076,3,4,54,61,
Washington,Commissioner of Labor,Leslie Osborn,REP,740076,0,1,76,77,
Washington,Corporation Commissioner,Bob Anthony,REP,740076,1,3,62,66,
Washington,Corporation Commissioner,Brian Bingman,REP,740076,2,2,72,76,
Washington,U.S. House,Tim Harris,REP,740076,0,2,45,47,01
Washington,U.S. House,Kevin Hern,REP,740076,3,3,91,97,01
Washington,Governor,Chris Powell,LIB,740076,0,0,0,0,
Washington,Governor,Rex Lawhorn,LIB,740076,0,0,0,0,
Washington,Corporation Commissioner,Ashley Nicole Mccray,DEM,740076,0,1,20,21,
Washington,Corporation Commissioner,Blake Cummings,DEM,740076,0,0,12,12,
Washington,U.S. House,Tim Gilpin,DEM,740076,0,0,21,21,01
Washington,U.S. House,Amanda Douglas,DEM,740076,0,1,12,13,01
Washington,Governor,Mick Cornett,REP,740077,1,3,49,53,
Washington,Governor,Kevin Stitt,REP,740077,3,4,132,139,
Washington,Lieutenant Governor,Dana Murphy,REP,740077,0,3,45,48,
Washington,Lieutenant Governor,Matt Pinnell,REP,740077,4,4,134,142,
Washington,State Auditor,Cindy Byrd,REP,740077,0,4,71,75,
Washington,State Auditor,Charlie Prater,REP,740077,4,3,105,112,
Washington,Attorney General,Mike Hunter,REP,740077,1,1,62,64,
Washington,Attorney General,Gentner Drummond,REP,740077,3,6,119,128,
Washington,Superintendent of Public Instruction,Joy Hofmeister,REP,740077,2,4,101,107,
Washington,Superintendent of Public Instruction,Linda Murphy,REP,740077,2,3,77,82,
Washington,Commissioner of Labor,Cathy Costello,REP,740077,2,6,81,89,
Washington,Commissioner of Labor,Leslie Osborn,REP,740077,2,1,95,98,
Washington,Corporation Commissioner,Bob Anthony,REP,740077,3,3,81,87,
Washington,Corporation Commissioner,Brian Bingman,REP,740077,1,4,95,100,
Washington,U.S. House,Tim Harris,REP,740077,1,2,57,60,01
Washington,U.S. House,Kevin Hern,REP,740077,3,5,123,131,01
Washington,Governor,Chris Powell,LIB,740077,0,0,0,0,
Washington,Governor,Rex Lawhorn,LIB,740077,0,0,0,0,
Washington,Corporation Commissioner,Ashley Nicole Mccray,DEM,740077,0,2,19,21,
Washington,Corporation Commissioner,Blake Cummings,DEM,740077,1,0,23,24,
Washington,U.S. House,Tim Gilpin,DEM,740077,1,1,21,23,01
Washington,U.S. House,Amanda Douglas,DEM,740077,0,1,21,22,01
Washington,Governor,Mick Cornett,REP,740078,1,0,38,39,
Washington,Governor,Kevin Stitt,REP,740078,0,0,114,114,
Washington,Lieutenant Governor,Dana Murphy,REP,740078,0,0,54,54,
Washington,Lieutenant Governor,Matt Pinnell,REP,740078,1,0,94,95,
Washington,State Auditor,Cindy Byrd,REP,740078,0,0,59,59,
Washington,State Auditor,Charlie Prater,REP,740078,1,0,85,86,
Washington,Attorney General,Mike Hunter,REP,740078,0,0,53,53,
Washington,Attorney General,Gentner Drummond,REP,740078,1,0,98,99,
Washington,Superintendent of Public Instruction,Joy Hofmeister,REP,740078,1,0,79,80,
Washington,Superintendent of Public Instruction,Linda Murphy,REP,740078,0,0,70,70,
Washington,Commissioner of Labor,Cathy Costello,REP,740078,0,0,63,63,
Washington,Commissioner of Labor,Leslie Osborn,REP,740078,1,0,82,83,
Washington,Corporation Commissioner,Bob Anthony,REP,740078,1,0,60,61,
Washington,Corporation Commissioner,Brian Bingman,REP,740078,0,0,89,89,
Washington,U.S. House,Tim Harris,REP,740078,1,0,47,48,01
Washington,U.S. House,Kevin Hern,REP,740078,0,0,105,105,01
Washington,State House,Travis Dunlap,REP,740078,1,0,81,82,10
Washington,State House,Judd Strom,REP,740078,0,0,68,68,10
Washington,Governor,Chris Powell,LIB,740078,0,0,0,0,
Washington,Governor,Rex Lawhorn,LIB,740078,0,0,0,0,
Washington,Corporation Commissioner,Ashley Nicole Mccray,DEM,740078,5,0,31,36,
Washington,Corporation Commissioner,Blake Cummings,DEM,740078,0,0,18,18,
Washington,U.S. House,Tim Gilpin,DEM,740078,3,0,29,32,01
Washington,U.S. House,Amanda Douglas,DEM,740078,2,0,20,22,01
Washington,Governor,Mick Cornett,REP,740079,0,2,54,56,
Washington,Governor,Kevin Stitt,REP,740079,2,2,129,133,
Washington,Lieutenant Governor,Dana Murphy,REP,740079,0,0,53,53,
Washington,Lieutenant Governor,Matt Pinnell,REP,740079,2,4,130,136,
Washington,State Auditor,Cindy Byrd,REP,740079,0,3,93,96,
Washington,State Auditor,Charlie Prater,REP,740079,1,1,88,90,
Washington,Attorney General,Mike Hunter,REP,740079,1,2,67,70,
Washington,Attorney General,Gentner Drummond,REP,740079,1,2,114,117,
Washington,Superintendent of Public Instruction,Joy Hofmeister,REP,740079,0,2,88,90,
Washington,Superintendent of Public Instruction,Linda Murphy,REP,740079,2,2,93,97,
Washington,Commissioner of Labor,Cathy Costello,REP,740079,1,2,85,88,
Washington,Commissioner of Labor,Leslie Osborn,REP,740079,1,2,94,97,
Washington,Corporation Commissioner,Bob Anthony,REP,740079,1,1,76,78,
Washington,Corporation Commissioner,Brian Bingman,REP,740079,1,3,104,108,
Washington,U.S. House,Tim Harris,REP,740079,0,1,52,53,01
Washington,U.S. House,Kevin Hern,REP,740079,2,3,130,135,01
Washington,State House,Travis Dunlap,REP,740079,1,1,81,83,10
Washington,State House,Judd Strom,REP,740079,1,3,100,104,10
Washington,Governor,Chris Powell,LIB,740079,0,0,1,1,
Washington,Governor,Rex Lawhorn,LIB,740079,0,0,1,1,
Washington,Corporation Commissioner,Ashley Nicole Mccray,DEM,740079,2,0,17,19,
Washington,Corporation Commissioner,Blake Cummings,DEM,740079,0,1,27,28,
Washington,U.S. House,Tim Gilpin,DEM,740079,1,1,28,30,01
Washington,U.S. House,Amanda Douglas,DEM,740079,1,0,16,17,01
Washington,Governor,Mick Cornett,REP,740711,2,12,35,49,
Washington,Governor,Kevin Stitt,REP,740711,1,1,32,34,
Washington,Lieutenant Governor,Dana Murphy,REP,740711,1,6,29,36,
Washington,Lieutenant Governor,Matt Pinnell,REP,740711,2,7,38,47,
Washington,State Auditor,Cindy Byrd,REP,740711,2,5,34,41,
Washington,State Auditor,Charlie Prater,REP,740711,1,8,31,40,
Washington,Attorney General,Mike Hunter,REP,740711,3,5,35,43,
Washington,Attorney General,Gentner Drummond,REP,740711,0,8,31,39,
Washington,Superintendent of Public Instruction,Joy Hofmeister,REP,740711,3,12,49,64,
Washington,Superintendent of Public Instruction,Linda Murphy,REP,740711,0,1,17,18,
Washington,Commissioner of Labor,Cathy Costello,REP,740711,0,5,33,38,
Washington,Commissioner of Labor,Leslie Osborn,REP,740711,3,8,32,43,
Washington,Corporation Commissioner,Bob Anthony,REP,740711,3,5,40,48,
Washington,Corporation Commissioner,Brian Bingman,REP,740711,0,8,25,33,
Washington,U.S. House,Tim Harris,REP,740711,0,8,18,26,01
Washington,U.S. House,Kevin Hern,REP,740711,3,5,49,57,01
Washington,State House,Travis Dunlap,REP,740711,0,4,22,26,10
Washington,State House,Judd Strom,REP,740711,3,9,44,56,10
Washington,Governor,Chris Powell,LIB,740711,0,0,0,0,
Washington,Governor,Rex Lawhorn,LIB,740711,0,0,0,0,
Washington,Corporation Commissioner,Ashley Nicole Mccray,DEM,740711,0,0,1,1,
Washington,Corporation Commissioner,Blake Cummings,DEM,740711,1,0,1,2,
Washington,U.S. House,Tim Gilpin,DEM,740711,0,0,1,1,01
Washington,U.S. House,Amanda Douglas,DEM,740711,1,0,0,1,01
Washita,Governor,Mick Cornett,REP,750003,0,0,17,17,
Washita,Governor,Kevin Stitt,REP,750003,0,0,23,23,
Washita,Lieutenant Governor,Dana Murphy,REP,750003,0,0,18,18,
Washita,Lieutenant Governor,Matt Pinnell,REP,750003,0,0,21,21,
Washita,State Auditor,Cindy Byrd,REP,750003,0,0,19,19,
Washita,State Auditor,Charlie Prater,REP,750003,0,0,19,19,
Washita,Attorney General,Mike Hunter,REP,750003,0,0,18,18,
Washita,Attorney General,Gentner Drummond,REP,750003,0,0,20,20,
Washita,Superintendent of Public Instruction,Joy Hofmeister,REP,750003,0,0,26,26,
Washita,Superintendent of Public Instruction,Linda Murphy,REP,750003,0,0,14,14,
Washita,Commissioner of Labor,Cathy Costello,REP,750003,0,0,14,14,
Washita,Commissioner of Labor,Leslie Osborn,REP,750003,0,0,22,22,
Washita,Corporation Commissioner,Bob Anthony,REP,750003,0,0,19,19,
Washita,Corporation Commissioner,Brian Bingman,REP,750003,0,0,20,20,
Washita,Governor,Chris Powell,LIB,750003,0,0,0,0,
Washita,Governor,Rex Lawhorn,LIB,750003,0,0,0,0,
Washita,Corporation Commissioner,Ashley Nicole Mccray,DEM,750003,0,0,2,2,
Washita,Corporation Commissioner,Blake Cummings,DEM,750003,1,0,3,4,
Washita,Governor,Mick Cornett,REP,750004,7,5,69,81,
Washita,Governor,Kevin Stitt,REP,750004,0,10,71,81,
Washita,Lieutenant Governor,Dana Murphy,REP,750004,2,8,73,83,
Washita,Lieutenant Governor,Matt Pinnell,REP,750004,4,6,66,76,
Washita,State Auditor,Cindy Byrd,REP,750004,1,8,71,80,
Washita,State Auditor,Charlie Prater,REP,750004,5,6,65,76,
Washita,Attorney General,Mike Hunter,REP,750004,5,5,75,85,
Washita,Attorney General,Gentner Drummond,REP,750004,2,10,63,75,
Washita,Superintendent of Public Instruction,Joy Hofmeister,REP,750004,5,10,92,107,
Washita,Superintendent of Public Instruction,Linda Murphy,REP,750004,2,5,46,53,
Washita,Commissioner of Labor,Cathy Costello,REP,750004,3,5,60,68,
Washita,Commissioner of Labor,Leslie Osborn,REP,750004,4,9,76,89,
Washita,Corporation Commissioner,Bob Anthony,REP,750004,5,4,63,72,
Washita,Corporation Commissioner,Brian Bingman,REP,750004,2,11,76,89,
Washita,Governor,Chris Powell,LIB,750004,0,0,0,0,
Washita,Governor,Rex Lawhorn,LIB,750004,0,0,1,1,
Washita,Corporation Commissioner,Ashley Nicole Mccray,DEM,750004,5,2,35,42,
Washita,Corporation Commissioner,Blake Cummings,DEM,750004,4,6,35,45,
Washita,Governor,Mick Cornett,REP,750007,3,0,33,36,
Washita,Governor,Kevin Stitt,REP,750007,1,0,74,75,
Washita,Lieutenant Governor,Dana Murphy,REP,750007,0,0,52,52,
Washita,Lieutenant Governor,Matt Pinnell,REP,750007,4,1,50,55,
Washita,State Auditor,Cindy Byrd,REP,750007,1,0,37,38,
Washita,State Auditor,Charlie Prater,REP,750007,3,0,64,67,
Washita,Attorney General,Mike Hunter,REP,750007,2,0,52,54,
Washita,Attorney General,Gentner Drummond,REP,750007,2,0,51,53,
Washita,Superintendent of Public Instruction,Joy Hofmeister,REP,750007,2,0,49,51,
Washita,Superintendent of Public Instruction,Linda Murphy,REP,750007,2,0,52,54,
Washita,Commissioner of Labor,Cathy Costello,REP,750007,2,0,43,45,
Washita,Commissioner of Labor,Leslie Osborn,REP,750007,2,1,59,62,
Washita,Corporation Commissioner,Bob Anthony,REP,750007,2,0,56,58,
Washita,Corporation Commissioner,Brian Bingman,REP,750007,2,1,45,48,
Washita,Governor,Chris Powell,LIB,750007,0,0,0,0,
Washita,Governor,Rex Lawhorn,LIB,750007,0,0,1,1,
Washita,Corporation Commissioner,Ashley Nicole Mccray,DEM,750007,0,1,8,9,
Washita,Corporation Commissioner,Blake Cummings,DEM,750007,0,1,11,12,
Washita,Governor,Mick Cornett,REP,750009,0,0,7,7,
Washita,Governor,Kevin Stitt,REP,750009,0,2,25,27,
Washita,Lieutenant Governor,Dana Murphy,REP,750009,0,1,17,18,
Washita,Lieutenant Governor,Matt Pinnell,REP,750009,0,1,15,16,
Washita,State Auditor,Cindy Byrd,REP,750009,0,0,13,13,
Washita,State Auditor,Charlie Prater,REP,750009,0,2,19,21,
Washita,Attorney General,Mike Hunter,REP,750009,0,0,18,18,
Washita,Attorney General,Gentner Drummond,REP,750009,0,2,14,16,
Washita,Superintendent of Public Instruction,Joy Hofmeister,REP,750009,0,0,18,18,
Washita,Superintendent of Public Instruction,Linda Murphy,REP,750009,0,2,14,16,
Washita,Commissioner of Labor,Cathy Costello,REP,750009,0,2,19,21,
Washita,Commissioner of Labor,Leslie Osborn,REP,750009,0,0,11,11,
Washita,Corporation Commissioner,Bob Anthony,REP,750009,0,2,20,22,
Washita,Corporation Commissioner,Brian Bingman,REP,750009,0,0,10,10,
Washita,Governor,Chris Powell,LIB,750009,0,0,0,0,
Washita,Governor,Rex Lawhorn,LIB,750009,0,0,0,0,
Washita,Corporation Commissioner,Ashley Nicole Mccray,DEM,750009,0,1,6,7,
Washita,Corporation Commissioner,Blake Cummings,DEM,750009,0,1,6,7,
Washita,Governor,Mick Cornett,REP,750012,2,1,33,36,
Washita,Governor,Kevin Stitt,REP,750012,1,0,30,31,
Washita,Lieutenant Governor,Dana Murphy,REP,750012,2,0,29,31,
Washita,Lieutenant Governor,Matt Pinnell,REP,750012,1,1,33,35,
Washita,State Auditor,Cindy Byrd,REP,750012,3,1,23,27,
Washita,State Auditor,Charlie Prater,REP,750012,0,0,38,38,
Washita,Attorney General,Mike Hunter,REP,750012,2,1,23,26,
Washita,Attorney General,Gentner Drummond,REP,750012,1,0,39,40,
Washita,Superintendent of Public Instruction,Joy Hofmeister,REP,750012,0,0,34,34,
Washita,Superintendent of Public Instruction,Linda Murphy,REP,750012,3,1,28,32,
Washita,Commissioner of Labor,Cathy Costello,REP,750012,1,0,19,20,
Washita,Commissioner of Labor,Leslie Osborn,REP,750012,2,1,43,46,
Washita,Corporation Commissioner,Bob Anthony,REP,750012,1,1,33,35,
Washita,Corporation Commissioner,Brian Bingman,REP,750012,2,0,30,32,
Washita,Governor,Chris Powell,LIB,750012,0,0,0,0,
Washita,Governor,Rex Lawhorn,LIB,750012,0,0,0,0,
Washita,Corporation Commissioner,Ashley Nicole Mccray,DEM,750012,0,0,6,6,
Washita,Corporation Commissioner,Blake Cummings,DEM,750012,0,0,9,9,
Washita,Governor,Mick Cornett,REP,750014,2,0,38,40,
Washita,Governor,Kevin Stitt,REP,750014,2,0,65,67,
Washita,Lieutenant Governor,Dana Murphy,REP,750014,1,0,38,39,
Washita,Lieutenant Governor,Matt Pinnell,REP,750014,3,0,63,66,
Washita,State Auditor,Cindy Byrd,REP,750014,2,0,37,39,
Washita,State Auditor,Charlie Prater,REP,750014,2,0,61,63,
Washita,Attorney General,Mike Hunter,REP,750014,1,0,55,56,
Washita,Attorney General,Gentner Drummond,REP,750014,3,0,46,49,
Washita,Superintendent of Public Instruction,Joy Hofmeister,REP,750014,4,0,55,59,
Washita,Superintendent of Public Instruction,Linda Murphy,REP,750014,0,0,46,46,
Washita,Commissioner of Labor,Cathy Costello,REP,750014,2,0,38,40,
Washita,Commissioner of Labor,Leslie Osborn,REP,750014,2,0,63,65,
Washita,Corporation Commissioner,Bob Anthony,REP,750014,1,0,46,47,
Washita,Corporation Commissioner,Brian Bingman,REP,750014,3,0,55,58,
Washita,Governor,Chris Powell,LIB,750014,0,0,0,0,
Washita,Governor,Rex Lawhorn,LIB,750014,0,0,0,0,
Washita,Corporation Commissioner,Ashley Nicole Mccray,DEM,750014,1,0,28,29,
Washita,Corporation Commissioner,Blake Cummings,DEM,750014,1,0,38,39,
Washita,Governor,Mick Cornett,REP,750016,3,4,25,32,
Washita,Governor,Kevin Stitt,REP,750016,4,0,48,52,
Washita,Lieutenant Governor,Dana Murphy,REP,750016,5,1,31,37,
Washita,Lieutenant Governor,Matt Pinnell,REP,750016,2,3,40,45,
Washita,State Auditor,Cindy Byrd,REP,750016,5,1,34,40,
Washita,State Auditor,Charlie Prater,REP,750016,2,3,39,44,
Washita,Attorney General,Mike Hunter,REP,750016,3,0,33,36,
Washita,Attorney General,Gentner Drummond,REP,750016,4,4,40,48,
Washita,Superintendent of Public Instruction,Joy Hofmeister,REP,750016,3,4,41,48,
Washita,Superintendent of Public Instruction,Linda Murphy,REP,750016,4,0,32,36,
Washita,Commissioner of Labor,Cathy Costello,REP,750016,1,0,32,33,
Washita,Commissioner of Labor,Leslie Osborn,REP,750016,6,4,40,50,
Washita,Corporation Commissioner,Bob Anthony,REP,750016,1,1,23,25,
Washita,Corporation Commissioner,Brian Bingman,REP,750016,6,3,47,56,
Washita,Governor,Chris Powell,LIB,750016,0,0,0,0,
Washita,Governor,Rex Lawhorn,LIB,750016,0,0,0,0,
Washita,Corporation Commissioner,Ashley Nicole Mccray,DEM,750016,3,0,17,20,
Washita,Corporation Commissioner,Blake Cummings,DEM,750016,0,2,18,20,
Washita,Governor,Mick Cornett,REP,750017,0,1,17,18,
Washita,Governor,Kevin Stitt,REP,750017,1,1,25,27,
Washita,Lieutenant Governor,Dana Murphy,REP,750017,0,1,12,13,
Washita,Lieutenant Governor,Matt Pinnell,REP,750017,1,1,26,28,
Washita,State Auditor,Cindy Byrd,REP,750017,0,1,15,16,
Washita,State Auditor,Charlie Prater,REP,750017,1,1,25,27,
Washita,Attorney General,Mike Hunter,REP,750017,0,1,16,17,
Washita,Attorney General,Gentner Drummond,REP,750017,1,1,23,25,
Washita,Superintendent of Public Instruction,Joy Hofmeister,REP,750017,0,1,23,24,
Washita,Superintendent of Public Instruction,Linda Murphy,REP,750017,1,1,18,20,
Washita,Commissioner of Labor,Cathy Costello,REP,750017,0,1,17,18,
Washita,Commissioner of Labor,Leslie Osborn,REP,750017,1,1,23,25,
Washita,Corporation Commissioner,Bob Anthony,REP,750017,1,0,17,18,
Washita,Corporation Commissioner,Brian Bingman,REP,750017,0,2,21,23,
Washita,Governor,Chris Powell,LIB,750017,0,0,0,0,
Washita,Governor,Rex Lawhorn,LIB,750017,0,0,0,0,
Washita,Corporation Commissioner,Ashley Nicole Mccray,DEM,750017,0,0,12,12,
Washita,Corporation Commissioner,Blake Cummings,DEM,750017,0,0,13,13,
Washita,Governor,Mick Cornett,REP,750018,2,1,31,34,
Washita,Governor,Kevin Stitt,REP,750018,1,0,32,33,
Washita,Lieutenant Governor,Dana Murphy,REP,750018,1,0,25,26,
Washita,Lieutenant Governor,Matt Pinnell,REP,750018,1,1,36,38,
Washita,State Auditor,Cindy Byrd,REP,750018,2,0,37,39,
Washita,State Auditor,Charlie Prater,REP,750018,0,1,25,26,
Washita,Attorney General,Mike Hunter,REP,750018,1,1,31,33,
Washita,Attorney General,Gentner Drummond,REP,750018,2,0,30,32,
Washita,Superintendent of Public Instruction,Joy Hofmeister,REP,750018,1,1,40,42,
Washita,Superintendent of Public Instruction,Linda Murphy,REP,750018,2,0,22,24,
Washita,Commissioner of Labor,Cathy Costello,REP,750018,2,0,19,21,
Washita,Commissioner of Labor,Leslie Osborn,REP,750018,1,1,41,43,
Washita,Corporation Commissioner,Bob Anthony,REP,750018,1,1,36,38,
Washita,Corporation Commissioner,Brian Bingman,REP,750018,1,0,24,25,
Washita,Governor,Chris Powell,LIB,750018,0,0,1,1,
Washita,Governor,Rex Lawhorn,LIB,750018,0,0,0,0,
Washita,Corporation Commissioner,Ashley Nicole Mccray,DEM,750018,1,0,9,10,
Washita,Corporation Commissioner,Blake Cummings,DEM,750018,1,0,10,11,
Washita,Governor,Mick Cornett,REP,750019,0,3,19,22,
Washita,Governor,Kevin Stitt,REP,750019,4,0,27,31,
Washita,Lieutenant Governor,Dana Murphy,REP,750019,1,0,16,17,
Washita,Lieutenant Governor,Matt Pinnell,REP,750019,3,2,30,35,
Washita,State Auditor,Cindy Byrd,REP,750019,3,1,16,20,
Washita,State Auditor,Charlie Prater,REP,750019,1,2,28,31,
Washita,Attorney General,Mike Hunter,REP,750019,2,3,23,28,
Washita,Attorney General,Gentner Drummond,REP,750019,0,0,23,23,
Washita,Superintendent of Public Instruction,Joy Hofmeister,REP,750019,1,3,26,30,
Washita,Superintendent of Public Instruction,Linda Murphy,REP,750019,3,0,19,22,
Washita,Commissioner of Labor,Cathy Costello,REP,750019,2,0,27,29,
Washita,Commissioner of Labor,Leslie Osborn,REP,750019,2,2,19,23,
Washita,Corporation Commissioner,Bob Anthony,REP,750019,4,0,22,26,
Washita,Corporation Commissioner,Brian Bingman,REP,750019,0,3,23,26,
Washita,Governor,Chris Powell,LIB,750019,0,0,0,0,
Washita,Governor,Rex Lawhorn,LIB,750019,0,0,0,0,
Washita,Corporation Commissioner,Ashley Nicole Mccray,DEM,750019,1,0,18,19,
Washita,Corporation Commissioner,Blake Cummings,DEM,750019,0,0,20,20,
Washita,Governor,Mick Cornett,REP,750020,0,0,21,21,
Washita,Governor,Kevin Stitt,REP,750020,0,0,39,39,
Washita,Lieutenant Governor,Dana Murphy,REP,750020,0,0,25,25,
Washita,Lieutenant Governor,Matt Pinnell,REP,750020,0,0,36,36,
Washita,State Auditor,Cindy Byrd,REP,750020,0,0,28,28,
Washita,State Auditor,Charlie Prater,REP,750020,0,0,32,32,
Washita,Attorney General,Mike Hunter,REP,750020,0,0,30,30,
Washita,Attorney General,Gentner Drummond,REP,750020,0,0,31,31,
Washita,Superintendent of Public Instruction,Joy Hofmeister,REP,750020,0,0,30,30,
Washita,Superintendent of Public Instruction,Linda Murphy,REP,750020,0,0,30,30,
Washita,Commissioner of Labor,Cathy Costello,REP,750020,0,0,21,21,
Washita,Commissioner of Labor,Leslie Osborn,REP,750020,0,0,40,40,
Washita,Corporation Commissioner,Bob Anthony,REP,750020,0,0,26,26,
Washita,Corporation Commissioner,Brian Bingman,REP,750020,0,0,34,34,
Washita,Governor,Chris Powell,LIB,750020,0,0,0,0,
Washita,Governor,Rex Lawhorn,LIB,750020,0,0,0,0,
Washita,Corporation Commissioner,Ashley Nicole Mccray,DEM,750020,1,0,14,15,
Washita,Corporation Commissioner,Blake Cummings,DEM,750020,2,1,15,18,
Washita,Governor,Mick Cornett,REP,750030,6,4,23,33,
Washita,Governor,Kevin Stitt,REP,750030,2,2,24,28,
Washita,Lieutenant Governor,Dana Murphy,REP,750030,5,2,30,37,
Washita,Lieutenant Governor,Matt Pinnell,REP,750030,3,4,15,22,
Washita,State Auditor,Cindy Byrd,REP,750030,3,1,26,30,
Washita,State Auditor,Charlie Prater,REP,750030,5,5,20,30,
Washita,Attorney General,Mike Hunter,REP,750030,7,6,23,36,
Washita,Attorney General,Gentner Drummond,REP,750030,1,0,24,25,
Washita,Superintendent of Public Instruction,Joy Hofmeister,REP,750030,3,3,30,36,
Washita,Superintendent of Public Instruction,Linda Murphy,REP,750030,5,3,16,24,
Washita,Commissioner of Labor,Cathy Costello,REP,750030,1,4,19,24,
Washita,Commissioner of Labor,Leslie Osborn,REP,750030,7,2,26,35,
Washita,Corporation Commissioner,Bob Anthony,REP,750030,3,3,27,33,
Washita,Corporation Commissioner,Brian Bingman,REP,750030,5,3,19,27,
Washita,Governor,Chris Powell,LIB,750030,0,0,1,1,
Washita,Governor,Rex Lawhorn,LIB,750030,0,0,0,0,
Washita,Corporation Commissioner,Ashley Nicole Mccray,DEM,750030,1,4,11,16,
Washita,Corporation Commissioner,Blake Cummings,DEM,750030,1,0,25,26,
Woods,Governor,Mick Cornett,REP,760001,3,23,140,166,
Woods,Governor,Kevin Stitt,REP,760001,2,19,106,127,
Woods,Lieutenant Governor,Dana Murphy,REP,760001,3,21,121,145,
Woods,Lieutenant Governor,Matt Pinnell,REP,760001,2,20,121,143,
Woods,State Auditor,Cindy Byrd,REP,760001,3,15,110,128,
Woods,State Auditor,Charlie Prater,REP,760001,2,25,129,156,
Woods,Attorney General,Mike Hunter,REP,760001,4,22,103,129,
Woods,Attorney General,Gentner Drummond,REP,760001,1,19,140,160,
Woods,Superintendent of Public Instruction,Joy Hofmeister,REP,760001,3,31,156,190,
Woods,Superintendent of Public Instruction,Linda Murphy,REP,760001,2,10,89,101,
Woods,Commissioner of Labor,Cathy Costello,REP,760001,4,16,116,136,
Woods,Commissioner of Labor,Leslie Osborn,REP,760001,1,26,123,150,
Woods,Corporation Commissioner,Bob Anthony,REP,760001,2,24,120,146,
Woods,Corporation Commissioner,Brian Bingman,REP,760001,3,17,119,139,
Woods,Governor,Chris Powell,LIB,760001,0,0,0,0,
Woods,Governor,Rex Lawhorn,LIB,760001,0,0,0,0,
Woods,Corporation Commissioner,Ashley Nicole Mccray,DEM,760001,0,2,17,19,
Woods,Corporation Commissioner,Blake Cummings,DEM,760001,0,9,17,26,
Woods,Governor,Mick Cornett,REP,760002,3,3,67,73,
Woods,Governor,Kevin Stitt,REP,760002,3,1,103,107,
Woods,Lieutenant Governor,Dana Murphy,REP,760002,4,1,83,88,
Woods,Lieutenant Governor,Matt Pinnell,REP,760002,2,3,86,91,
Woods,State Auditor,Cindy Byrd,REP,760002,2,0,64,66,
Woods,State Auditor,Charlie Prater,REP,760002,3,4,101,108,
Woods,Attorney General,Mike Hunter,REP,760002,3,2,75,80,
Woods,Attorney General,Gentner Drummond,REP,760002,3,2,94,99,
Woods,Superintendent of Public Instruction,Joy Hofmeister,REP,760002,2,1,111,114,
Woods,Superintendent of Public Instruction,Linda Murphy,REP,760002,4,3,59,66,
Woods,Commissioner of Labor,Cathy Costello,REP,760002,6,0,67,73,
Woods,Commissioner of Labor,Leslie Osborn,REP,760002,0,4,98,102,
Woods,Corporation Commissioner,Bob Anthony,REP,760002,5,4,92,101,
Woods,Corporation Commissioner,Brian Bingman,REP,760002,1,0,74,75,
Woods,Governor,Chris Powell,LIB,760002,0,0,0,0,
Woods,Governor,Rex Lawhorn,LIB,760002,0,0,0,0,
Woods,Corporation Commissioner,Ashley Nicole Mccray,DEM,760002,0,1,13,14,
Woods,Corporation Commissioner,Blake Cummings,DEM,760002,2,1,6,9,
Woods,Governor,Mick Cornett,REP,760003,1,3,45,49,
Woods,Governor,Kevin Stitt,REP,760003,0,5,71,76,
Woods,Lieutenant Governor,Dana Murphy,REP,760003,0,5,48,53,
Woods,Lieutenant Governor,Matt Pinnell,REP,760003,1,3,66,70,
Woods,State Auditor,Cindy Byrd,REP,760003,0,4,44,48,
Woods,State Auditor,Charlie Prater,REP,760003,1,2,68,71,
Woods,Attorney General,Mike Hunter,REP,760003,1,5,49,55,
Woods,Attorney General,Gentner Drummond,REP,760003,0,3,66,69,
Woods,Superintendent of Public Instruction,Joy Hofmeister,REP,760003,0,4,64,68,
Woods,Superintendent of Public Instruction,Linda Murphy,REP,760003,1,4,51,56,
Woods,Commissioner of Labor,Cathy Costello,REP,760003,0,4,37,41,
Woods,Commissioner of Labor,Leslie Osborn,REP,760003,1,3,77,81,
Woods,Corporation Commissioner,Bob Anthony,REP,760003,1,3,59,63,
Woods,Corporation Commissioner,Brian Bingman,REP,760003,0,5,54,59,
Woods,Governor,Chris Powell,LIB,760003,0,0,0,0,
Woods,Governor,Rex Lawhorn,LIB,760003,0,0,0,0,
Woods,Corporation Commissioner,Ashley Nicole Mccray,DEM,760003,2,4,12,18,
Woods,Corporation Commissioner,Blake Cummings,DEM,760003,2,1,7,10,
Woods,Governor,Mick Cornett,REP,760004,2,4,17,23,
Woods,Governor,Kevin Stitt,REP,760004,1,0,36,37,
Woods,Lieutenant Governor,Dana Murphy,REP,760004,2,3,34,39,
Woods,Lieutenant Governor,Matt Pinnell,REP,760004,2,2,19,23,
Woods,State Auditor,Cindy Byrd,REP,760004,2,2,23,27,
Woods,State Auditor,Charlie Prater,REP,760004,1,2,30,33,
Woods,Attorney General,Mike Hunter,REP,760004,1,1,22,24,
Woods,Attorney General,Gentner Drummond,REP,760004,3,3,31,37,
Woods,Superintendent of Public Instruction,Joy Hofmeister,REP,760004,1,2,34,37,
Woods,Superintendent of Public Instruction,Linda Murphy,REP,760004,3,3,19,25,
Woods,Commissioner of Labor,Cathy Costello,REP,760004,3,2,19,24,
Woods,Commissioner of Labor,Leslie Osborn,REP,760004,1,2,32,35,
Woods,Corporation Commissioner,Bob Anthony,REP,760004,4,3,27,34,
Woods,Corporation Commissioner,Brian Bingman,REP,760004,0,2,25,27,
Woods,Governor,Chris Powell,LIB,760004,0,0,0,0,
Woods,Governor,Rex Lawhorn,LIB,760004,0,0,0,0,
Woods,Corporation Commissioner,Ashley Nicole Mccray,DEM,760004,0,0,8,8,
Woods,Corporation Commissioner,Blake Cummings,DEM,760004,1,0,6,7,
Woods,Governor,Mick Cornett,REP,760005,15,20,148,183,
Woods,Governor,Kevin Stitt,REP,760005,5,26,102,133,
Woods,Lieutenant Governor,Dana Murphy,REP,760005,10,24,143,177,
Woods,Lieutenant Governor,Matt Pinnell,REP,760005,8,21,100,129,
Woods,State Auditor,Cindy Byrd,REP,760005,8,17,129,154,
Woods,State Auditor,Charlie Prater,REP,760005,9,27,113,149,
Woods,Attorney General,Mike Hunter,REP,760005,9,22,129,160,
Woods,Attorney General,Gentner Drummond,REP,760005,8,22,117,147,
Woods,Superintendent of Public Instruction,Joy Hofmeister,REP,760005,11,29,152,192,
Woods,Superintendent of Public Instruction,Linda Murphy,REP,760005,7,16,92,115,
Woods,Commissioner of Labor,Cathy Costello,REP,760005,6,13,114,133,
Woods,Commissioner of Labor,Leslie Osborn,REP,760005,10,32,131,173,
Woods,Corporation Commissioner,Bob Anthony,REP,760005,10,29,136,175,
Woods,Corporation Commissioner,Brian Bingman,REP,760005,6,16,107,129,
Woods,Governor,Chris Powell,LIB,760005,0,0,0,0,
Woods,Governor,Rex Lawhorn,LIB,760005,0,0,1,1,
Woods,Corporation Commissioner,Ashley Nicole Mccray,DEM,760005,3,3,32,38,
Woods,Corporation Commissioner,Blake Cummings,DEM,760005,2,4,17,23,
Woods,Governor,Mick Cornett,REP,760008,2,0,31,33,
Woods,Governor,Kevin Stitt,REP,760008,3,0,69,72,
Woods,Lieutenant Governor,Dana Murphy,REP,760008,2,0,54,56,
Woods,Lieutenant Governor,Matt Pinnell,REP,760008,3,0,46,49,
Woods,State Auditor,Cindy Byrd,REP,760008,3,0,36,39,
Woods,State Auditor,Charlie Prater,REP,760008,2,0,63,65,
Woods,Attorney General,Mike Hunter,REP,760008,1,0,52,53,
Woods,Attorney General,Gentner Drummond,REP,760008,4,0,48,52,
Woods,Superintendent of Public Instruction,Joy Hofmeister,REP,760008,2,0,49,51,
Woods,Superintendent of Public Instruction,Linda Murphy,REP,760008,3,0,50,53,
Woods,Commissioner of Labor,Cathy Costello,REP,760008,3,0,47,50,
Woods,Commissioner of Labor,Leslie Osborn,REP,760008,2,0,52,54,
Woods,Corporation Commissioner,Bob Anthony,REP,760008,3,0,52,55,
Woods,Corporation Commissioner,Brian Bingman,REP,760008,2,0,48,50,
Woods,Governor,Chris Powell,LIB,760008,0,0,0,0,
Woods,Governor,Rex Lawhorn,LIB,760008,0,0,0,0,
Woods,Corporation Commissioner,Ashley Nicole Mccray,DEM,760008,1,0,3,4,
Woods,Corporation Commissioner,Blake Cummings,DEM,760008,1,0,8,9,
Woodward,Governor,Mick Cornett,REP,770101,2,4,69,75,
Woodward,Governor,Kevin Stitt,REP,770101,3,13,112,128,
Woodward,Lieutenant Governor,Dana Murphy,REP,770101,4,8,99,111,
Woodward,Lieutenant Governor,Matt Pinnell,REP,770101,1,10,82,93,
Woodward,State Auditor,Cindy Byrd,REP,770101,4,11,73,88,
Woodward,State Auditor,Charlie Prater,REP,770101,1,7,104,112,
Woodward,Attorney General,Mike Hunter,REP,770101,1,9,98,108,
Woodward,Attorney General,Gentner Drummond,REP,770101,4,9,81,94,
Woodward,Superintendent of Public Instruction,Joy Hofmeister,REP,770101,4,16,86,106,
Woodward,Superintendent of Public Instruction,Linda Murphy,REP,770101,1,2,91,94,
Woodward,Commissioner of Labor,Cathy Costello,REP,770101,3,13,79,95,
Woodward,Commissioner of Labor,Leslie Osborn,REP,770101,2,5,101,108,
Woodward,Corporation Commissioner,Bob Anthony,REP,770101,1,10,84,95,
Woodward,Corporation Commissioner,Brian Bingman,REP,770101,4,8,95,107,
Woodward,Governor,Chris Powell,LIB,770101,0,0,0,0,
Woodward,Governor,Rex Lawhorn,LIB,770101,0,0,1,1,
Woodward,Corporation Commissioner,Ashley Nicole Mccray,DEM,770101,2,4,33,39,
Woodward,Corporation Commissioner,Blake Cummings,DEM,770101,0,0,24,24,
Woodward,Governor,Mick Cornett,REP,770102,1,5,54,60,
Woodward,Governor,Kevin Stitt,REP,770102,3,4,48,55,
Woodward,Lieutenant Governor,Dana Murphy,REP,770102,3,7,59,69,
Woodward,Lieutenant Governor,Matt Pinnell,REP,770102,1,2,41,44,
Woodward,State Auditor,Cindy Byrd,REP,770102,2,4,43,49,
Woodward,State Auditor,Charlie Prater,REP,770102,2,5,55,62,
Woodward,Attorney General,Mike Hunter,REP,770102,2,6,56,64,
Woodward,Attorney General,Gentner Drummond,REP,770102,1,2,43,46,
Woodward,Superintendent of Public Instruction,Joy Hofmeister,REP,770102,2,5,51,58,
Woodward,Superintendent of Public Instruction,Linda Murphy,REP,770102,2,4,49,55,
Woodward,Commissioner of Labor,Cathy Costello,REP,770102,2,4,44,50,
Woodward,Commissioner of Labor,Leslie Osborn,REP,770102,1,5,54,60,
Woodward,Corporation Commissioner,Bob Anthony,REP,770102,2,8,42,52,
Woodward,Corporation Commissioner,Brian Bingman,REP,770102,2,1,58,61,
Woodward,Governor,Chris Powell,LIB,770102,0,0,0,0,
Woodward,Governor,Rex Lawhorn,LIB,770102,0,0,1,1,
Woodward,Corporation Commissioner,Ashley Nicole Mccray,DEM,770102,0,0,21,21,
Woodward,Corporation Commissioner,Blake Cummings,DEM,770102,0,0,12,12,
Woodward,Governor,Mick Cornett,REP,770104,2,0,0,2,
Woodward,Governor,Kevin Stitt,REP,770104,0,0,0,0,
Woodward,Lieutenant Governor,Dana Murphy,REP,770104,2,0,0,2,
Woodward,Lieutenant Governor,Matt Pinnell,REP,770104,0,0,0,0,
Woodward,State Auditor,Cindy Byrd,REP,770104,2,0,0,2,
Woodward,State Auditor,Charlie Prater,REP,770104,0,0,0,0,
Woodward,Attorney General,Mike Hunter,REP,770104,0,0,0,0,
Woodward,Attorney General,Gentner Drummond,REP,770104,2,0,0,2,
Woodward,Superintendent of Public Instruction,Joy Hofmeister,REP,770104,2,0,0,2,
Woodward,Superintendent of Public Instruction,Linda Murphy,REP,770104,0,0,0,0,
Woodward,Commissioner of Labor,Cathy Costello,REP,770104,2,0,0,2,
Woodward,Commissioner of Labor,Leslie Osborn,REP,770104,0,0,0,0,
Woodward,Corporation Commissioner,Bob Anthony,REP,770104,2,0,0,2,
Woodward,Corporation Commissioner,Brian Bingman,REP,770104,0,0,0,0,
Woodward,Governor,Chris Powell,LIB,770104,0,0,0,0,
Woodward,Governor,Rex Lawhorn,LIB,770104,0,0,0,0,
Woodward,Corporation Commissioner,Ashley Nicole Mccray,DEM,770104,0,0,0,0,
Woodward,Corporation Commissioner,Blake Cummings,DEM,770104,0,0,0,0,
Woodward,Governor,Mick Cornett,REP,770105,2,7,101,110,
Woodward,Governor,Kevin Stitt,REP,770105,3,2,144,149,
Woodward,Lieutenant Governor,Dana Murphy,REP,770105,2,4,143,149,
Woodward,Lieutenant Governor,Matt Pinnell,REP,770105,3,5,103,111,
Woodward,State Auditor,Cindy Byrd,REP,770105,1,6,141,148,
Woodward,State Auditor,Charlie Prater,REP,770105,4,3,101,108,
Woodward,Attorney General,Mike Hunter,REP,770105,3,5,115,123,
Woodward,Attorney General,Gentner Drummond,REP,770105,2,4,129,135,
Woodward,Superintendent of Public Instruction,Joy Hofmeister,REP,770105,4,5,144,153,
Woodward,Superintendent of Public Instruction,Linda Murphy,REP,770105,1,3,96,100,
Woodward,Commissioner of Labor,Cathy Costello,REP,770105,2,3,106,111,
Woodward,Commissioner of Labor,Leslie Osborn,REP,770105,3,6,134,143,
Woodward,Corporation Commissioner,Bob Anthony,REP,770105,3,4,146,153,
Woodward,Corporation Commissioner,Brian Bingman,REP,770105,2,5,95,102,
Woodward,Governor,Chris Powell,LIB,770105,0,0,0,0,
Woodward,Governor,Rex Lawhorn,LIB,770105,0,0,0,0,
Woodward,Corporation Commissioner,Ashley Nicole Mccray,DEM,770105,1,1,15,17,
Woodward,Corporation Commissioner,Blake Cummings,DEM,770105,2,0,17,19,
Woodward,Governor,Mick Cornett,REP,770106,2,0,9,11,
Woodward,Governor,Kevin Stitt,REP,770106,1,1,23,25,
Woodward,Lieutenant Governor,Dana Murphy,REP,770106,3,0,17,20,
Woodward,Lieutenant Governor,Matt Pinnell,REP,770106,0,1,15,16,
Woodward,State Auditor,Cindy Byrd,REP,770106,0,0,17,17,
Woodward,State Auditor,Charlie Prater,REP,770106,2,1,15,18,
Woodward,Attorney General,Mike Hunter,REP,770106,3,1,23,27,
Woodward,Attorney General,Gentner Drummond,REP,770106,0,0,9,9,
Woodward,Superintendent of Public Instruction,Joy Hofmeister,REP,770106,1,0,17,18,
Woodward,Superintendent of Public Instruction,Linda Murphy,REP,770106,2,1,15,18,
Woodward,Commissioner of Labor,Cathy Costello,REP,770106,3,0,16,19,
Woodward,Commissioner of Labor,Leslie Osborn,REP,770106,0,1,16,17,
Woodward,Corporation Commissioner,Bob Anthony,REP,770106,1,0,20,21,
Woodward,Corporation Commissioner,Brian Bingman,REP,770106,2,1,12,15,
Woodward,Governor,Chris Powell,LIB,770106,0,0,0,0,
Woodward,Governor,Rex Lawhorn,LIB,770106,0,0,0,0,
Woodward,Corporation Commissioner,Ashley Nicole Mccray,DEM,770106,0,1,3,4,
Woodward,Corporation Commissioner,Blake Cummings,DEM,770106,0,0,0,0,
Woodward,Governor,Mick Cornett,REP,770201,6,27,123,156,
Woodward,Governor,Kevin Stitt,REP,770201,6,27,166,199,
Woodward,Lieutenant Governor,Dana Murphy,REP,770201,9,31,152,192,
Woodward,Lieutenant Governor,Matt Pinnell,REP,770201,3,22,132,157,
Woodward,State Auditor,Cindy Byrd,REP,770201,5,27,145,177,
Woodward,State Auditor,Charlie Prater,REP,770201,6,24,132,162,
Woodward,Attorney General,Mike Hunter,REP,770201,8,36,150,194,
Woodward,Attorney General,Gentner Drummond,REP,770201,4,16,134,154,
Woodward,Superintendent of Public Instruction,Joy Hofmeister,REP,770201,9,30,157,196,
Woodward,Superintendent of Public Instruction,Linda Murphy,REP,770201,3,23,122,148,
Woodward,Commissioner of Labor,Cathy Costello,REP,770201,7,17,108,132,
Woodward,Commissioner of Labor,Leslie Osborn,REP,770201,5,35,167,207,
Woodward,Corporation Commissioner,Bob Anthony,REP,770201,9,28,146,183,
Woodward,Corporation Commissioner,Brian Bingman,REP,770201,3,24,132,159,
Woodward,Governor,Chris Powell,LIB,770201,0,0,1,1,
Woodward,Governor,Rex Lawhorn,LIB,770201,0,0,0,0,
Woodward,Corporation Commissioner,Ashley Nicole Mccray,DEM,770201,2,12,54,68,
Woodward,Corporation Commissioner,Blake Cummings,DEM,770201,1,2,28,31,
Woodward,Governor,Mick Cornett,REP,770202,9,25,200,234,
Woodward,Governor,Kevin Stitt,REP,770202,3,24,253,280,
Woodward,Lieutenant Governor,Dana Murphy,REP,770202,6,35,257,298,
Woodward,Lieutenant Governor,Matt Pinnell,REP,770202,6,14,194,214,
Woodward,State Auditor,Cindy Byrd,REP,770202,5,25,228,258,
Woodward,State Auditor,Charlie Prater,REP,770202,7,20,206,233,
Woodward,Attorney General,Mike Hunter,REP,770202,2,30,264,296,
Woodward,Attorney General,Gentner Drummond,REP,770202,10,18,174,202,
Woodward,Superintendent of Public Instruction,Joy Hofmeister,REP,770202,8,31,282,321,
Woodward,Superintendent of Public Instruction,Linda Murphy,REP,770202,4,17,163,184,
Woodward,Commissioner of Labor,Cathy Costello,REP,770202,7,23,179,209,
Woodward,Commissioner of Labor,Leslie Osborn,REP,770202,5,25,257,287,
Woodward,Corporation Commissioner,Bob Anthony,REP,770202,7,39,241,287,
Woodward,Corporation Commissioner,Brian Bingman,REP,770202,5,9,201,215,
Woodward,Governor,Chris Powell,LIB,770202,0,0,0,0,
Woodward,Governor,Rex Lawhorn,LIB,770202,0,0,0,0,
Woodward,Corporation Commissioner,Ashley Nicole Mccray,DEM,770202,1,6,75,82,
Woodward,Corporation Commissioner,Blake Cummings,DEM,770202,3,6,55,64,
Woodward,Governor,Mick Cornett,REP,770203,1,3,58,62,
Woodward,Governor,Kevin Stitt,REP,770203,5,12,144,161,
Woodward,Lieutenant Governor,Dana Murphy,REP,770203,4,9,106,119,
Woodward,Lieutenant Governor,Matt Pinnell,REP,770203,2,6,96,104,
Woodward,State Auditor,Cindy Byrd,REP,770203,2,11,70,83,
Woodward,State Auditor,Charlie Prater,REP,770203,4,3,126,133,
Woodward,Attorney General,Mike Hunter,REP,770203,5,9,93,107,
Woodward,Attorney General,Gentner Drummond,REP,770203,1,6,106,113,
Woodward,Superintendent of Public Instruction,Joy Hofmeister,REP,770203,5,5,121,131,
Woodward,Superintendent of Public Instruction,Linda Murphy,REP,770203,1,10,78,89,
Woodward,Commissioner of Labor,Cathy Costello,REP,770203,3,8,75,86,
Woodward,Commissioner of Labor,Leslie Osborn,REP,770203,3,7,123,133,
Woodward,Corporation Commissioner,Bob Anthony,REP,770203,3,8,102,113,
Woodward,Corporation Commissioner,Brian Bingman,REP,770203,3,6,96,105,
Woodward,Governor,Chris Powell,LIB,770203,0,0,0,0,
Woodward,Governor,Rex Lawhorn,LIB,770203,0,0,1,1,
Woodward,Corporation Commissioner,Ashley Nicole Mccray,DEM,770203,1,2,29,32,
Woodward,Corporation Commissioner,Blake Cummings,DEM,770203,0,2,34,36,
Woodward,Governor,Mick Cornett,REP,770204,2,2,32,36,
Woodward,Governor,Kevin Stitt,REP,770204,3,4,57,64,
Woodward,Lieutenant Governor,Dana Murphy,REP,770204,3,0,39,42,
Woodward,Lieutenant Governor,Matt Pinnell,REP,770204,2,6,50,58,
Woodward,State Auditor,Cindy Byrd,REP,770204,0,2,31,33,
Woodward,State Auditor,Charlie Prater,REP,770204,4,4,53,61,
Woodward,Attorney General,Mike Hunter,REP,770204,3,3,44,50,
Woodward,Attorney General,Gentner Drummond,REP,770204,1,3,44,48,
Woodward,Superintendent of Public Instruction,Joy Hofmeister,REP,770204,4,4,39,47,
Woodward,Superintendent of Public Instruction,Linda Murphy,REP,770204,0,2,46,48,
Woodward,Commissioner of Labor,Cathy Costello,REP,770204,0,2,33,35,
Woodward,Commissioner of Labor,Leslie Osborn,REP,770204,4,4,52,60,
Woodward,Corporation Commissioner,Bob Anthony,REP,770204,0,5,46,51,
Woodward,Corporation Commissioner,Brian Bingman,REP,770204,4,1,41,46,
Woodward,Governor,Chris Powell,LIB,770204,0,0,0,0,
Woodward,Governor,Rex Lawhorn,LIB,770204,0,0,0,0,
Woodward,Corporation Commissioner,Ashley Nicole Mccray,DEM,770204,0,0,10,10,
Woodward,Corporation Commissioner,Blake Cummings,DEM,770204,0,0,16,16,
Woodward,Governor,Mick Cornett,REP,770301,0,9,42,51,
Woodward,Governor,Kevin Stitt,REP,770301,0,4,54,58,
Woodward,Lieutenant Governor,Dana Murphy,REP,770301,1,7,49,57,
Woodward,Lieutenant Governor,Matt Pinnell,REP,770301,0,6,45,51,
Woodward,State Auditor,Cindy Byrd,REP,770301,0,6,40,46,
Woodward,State Auditor,Charlie Prater,REP,770301,0,6,53,59,
Woodward,Attorney General,Mike Hunter,REP,770301,0,7,49,56,
Woodward,Attorney General,Gentner Drummond,REP,770301,0,5,48,53,
Woodward,Superintendent of Public Instruction,Joy Hofmeister,REP,770301,1,8,57,66,
Woodward,Superintendent of Public Instruction,Linda Murphy,REP,770301,0,4,37,41,
Woodward,Commissioner of Labor,Cathy Costello,REP,770301,0,8,43,51,
Woodward,Commissioner of Labor,Leslie Osborn,REP,770301,0,4,53,57,
Woodward,Corporation Commissioner,Bob Anthony,REP,770301,0,5,41,46,
Woodward,Corporation Commissioner,Brian Bingman,REP,770301,0,7,54,61,
Woodward,Governor,Chris Powell,LIB,770301,0,0,0,0,
Woodward,Governor,Rex Lawhorn,LIB,770301,0,0,0,0,
Woodward,Corporation Commissioner,Ashley Nicole Mccray,DEM,770301,1,3,16,20,
Woodward,Corporation Commissioner,Blake Cummings,DEM,770301,0,0,5,5,
Woodward,Governor,Mick Cornett,REP,770302,2,6,29,37,
Woodward,Governor,Kevin Stitt,REP,770302,3,11,47,61,
Woodward,Lieutenant Governor,Dana Murphy,REP,770302,4,9,47,60,
Woodward,Lieutenant Governor,Matt Pinnell,REP,770302,1,7,28,36,
Woodward,State Auditor,Cindy Byrd,REP,770302,2,7,36,45,
Woodward,State Auditor,Charlie Prater,REP,770302,3,10,36,49,
Woodward,Attorney General,Mike Hunter,REP,770302,1,8,30,39,
Woodward,Attorney General,Gentner Drummond,REP,770302,4,9,44,57,
Woodward,Superintendent of Public Instruction,Joy Hofmeister,REP,770302,5,11,46,62,
Woodward,Superintendent of Public Instruction,Linda Murphy,REP,770302,0,5,28,33,
Woodward,Commissioner of Labor,Cathy Costello,REP,770302,0,5,29,34,
Woodward,Commissioner of Labor,Leslie Osborn,REP,770302,5,11,45,61,
Woodward,Corporation Commissioner,Bob Anthony,REP,770302,2,11,36,49,
Woodward,Corporation Commissioner,Brian Bingman,REP,770302,3,5,37,45,
Woodward,Governor,Chris Powell,LIB,770302,0,0,0,0,
Woodward,Governor,Rex Lawhorn,LIB,770302,0,0,0,0,
Woodward,Corporation Commissioner,Ashley Nicole Mccray,DEM,770302,0,5,7,12,
Woodward,Corporation Commissioner,Blake Cummings,DEM,770302,0,5,9,14,
Woodward,Governor,Mick Cornett,REP,770303,0,0,0,0,
Woodward,Governor,Kevin Stitt,REP,770303,0,1,0,1,
Woodward,Lieutenant Governor,Dana Murphy,REP,770303,0,1,0,1,
Woodward,Lieutenant Governor,Matt Pinnell,REP,770303,0,0,0,0,
Woodward,State Auditor,Cindy Byrd,REP,770303,0,0,0,0,
Woodward,State Auditor,Charlie Prater,REP,770303,0,0,0,0,
Woodward,Attorney General,Mike Hunter,REP,770303,0,0,0,0,
Woodward,Attorney General,Gentner Drummond,REP,770303,0,1,0,1,
Woodward,Superintendent of Public Instruction,Joy Hofmeister,REP,770303,0,1,0,1,
Woodward,Superintendent of Public Instruction,Linda Murphy,REP,770303,0,0,0,0,
Woodward,Commissioner of Labor,Cathy Costello,REP,770303,0,0,0,0,
Woodward,Commissioner of Labor,Leslie Osborn,REP,770303,0,0,0,0,
Woodward,Corporation Commissioner,Bob Anthony,REP,770303,0,1,0,1,
Woodward,Corporation Commissioner,Brian Bingman,REP,770303,0,0,0,0,
Woodward,Governor,Chris Powell,LIB,770303,0,0,0,0,
Woodward,Governor,Rex Lawhorn,LIB,770303,0,0,0,0,
Woodward,Corporation Commissioner,Ashley Nicole Mccray,DEM,770303,0,1,0,1,
Woodward,Corporation Commissioner,Blake Cummings,DEM,770303,0,0,0,0,
Woodward,Governor,Mick Cornett,REP,770304,0,3,24,27,
Woodward,Governor,Kevin Stitt,REP,770304,1,2,44,47,
Woodward,Lieutenant Governor,Dana Murphy,REP,770304,1,4,34,39,
Woodward,Lieutenant Governor,Matt Pinnell,REP,770304,0,1,33,34,
Woodward,State Auditor,Cindy Byrd,REP,770304,1,4,34,39,
Woodward,State Auditor,Charlie Prater,REP,770304,0,1,32,33,
Woodward,Attorney General,Mike Hunter,REP,770304,0,2,41,43,
Woodward,Attorney General,Gentner Drummond,REP,770304,1,2,26,29,
Woodward,Superintendent of Public Instruction,Joy Hofmeister,REP,770304,1,2,27,30,
Woodward,Superintendent of Public Instruction,Linda Murphy,REP,770304,0,3,40,43,
Woodward,Commissioner of Labor,Cathy Costello,REP,770304,0,2,30,32,
Woodward,Commissioner of Labor,Leslie Osborn,REP,770304,1,3,35,39,
Woodward,Corporation Commissioner,Bob Anthony,REP,770304,0,4,36,40,
Woodward,Corporation Commissioner,Brian Bingman,REP,770304,1,1,29,31,
Woodward,Governor,Chris Powell,LIB,770304,0,0,0,0,
Woodward,Governor,Rex Lawhorn,LIB,770304,0,0,0,0,
Woodward,Corporation Commissioner,Ashley Nicole Mccray,DEM,770304,0,0,15,15,
Woodward,Corporation Commissioner,Blake Cummings,DEM,770304,0,0,4,4,
Woodward,Governor,Mick Cornett,REP,770306,5,29,198,232,
Woodward,Governor,Kevin Stitt,REP,770306,6,40,308,354,
Woodward,Lieutenant Governor,Dana Murphy,REP,770306,9,43,300,352,
Woodward,Lieutenant Governor,Matt Pinnell,REP,770306,1,25,208,234,
Woodward,State Auditor,Cindy Byrd,REP,770306,9,33,237,279,
Woodward,State Auditor,Charlie Prater,REP,770306,1,34,259,294,
Woodward,Attorney General,Mike Hunter,REP,770306,5,45,269,319,
Woodward,Attorney General,Gentner Drummond,REP,770306,6,23,241,270,
Woodward,Superintendent of Public Instruction,Joy Hofmeister,REP,770306,7,39,303,349,
Woodward,Superintendent of Public Instruction,Linda Murphy,REP,770306,3,29,198,230,
Woodward,Commissioner of Labor,Cathy Costello,REP,770306,5,37,220,262,
Woodward,Commissioner of Labor,Leslie Osborn,REP,770306,5,29,276,310,
Woodward,Corporation Commissioner,Bob Anthony,REP,770306,7,36,275,318,
Woodward,Corporation Commissioner,Brian Bingman,REP,770306,3,32,226,261,
Woodward,Governor,Chris Powell,LIB,770306,0,0,0,0,
Woodward,Governor,Rex Lawhorn,LIB,770306,0,0,0,0,
Woodward,Corporation Commissioner,Ashley Nicole Mccray,DEM,770306,0,6,60,66,
Woodward,Corporation Commissioner,Blake Cummings,DEM,770306,1,9,43,53,
Woodward,Governor,Mick Cornett,REP,770307,0,1,20,21,
Woodward,Governor,Kevin Stitt,REP,770307,0,0,17,17,
Woodward,Lieutenant Governor,Dana Murphy,REP,770307,0,1,27,28,
Woodward,Lieutenant Governor,Matt Pinnell,REP,770307,0,0,10,10,
Woodward,State Auditor,Cindy Byrd,REP,770307,0,1,12,13,
Woodward,State Auditor,Charlie Prater,REP,770307,0,0,25,25,
Woodward,Attorney General,Mike Hunter,REP,770307,0,1,19,20,
Woodward,Attorney General,Gentner Drummond,REP,770307,0,0,18,18,
Woodward,Superintendent of Public Instruction,Joy Hofmeister,REP,770307,0,1,19,20,
Woodward,Superintendent of Public Instruction,Linda Murphy,REP,770307,0,0,18,18,
Woodward,Commissioner of Labor,Cathy Costello,REP,770307,0,0,16,16,
Woodward,Commissioner of Labor,Leslie Osborn,REP,770307,0,0,21,21,
Woodward,Corporation Commissioner,Bob Anthony,REP,770307,0,1,21,22,
Woodward,Corporation Commissioner,Brian Bingman,REP,770307,0,0,15,15,
Woodward,State House,Kenton Patzkowsky,REP,770307,0,1,17,18,61
Woodward,State House,Brad Raven,REP,770307,0,0,19,19,61
Woodward,Governor,Chris Powell,LIB,770307,0,0,0,0,
Woodward,Governor,Rex Lawhorn,LIB,770307,0,0,0,0,
Woodward,Corporation Commissioner,Ashley Nicole Mccray,DEM,770307,0,0,8,8,
Woodward,Corporation Commissioner,Blake Cummings,DEM,770307,0,0,7,7,
