county,office,candidate,party,precinct,mail_votes,early_votes,elec_day_votes,votes,district
CADDO,PROPOSITION NO. 1 CYRIL PUBLIC SCHOOLS,FOR THE PROPOSITION - YES,,80509,0,0,1,1,PROPOSITION NO. 1 CYRIL PUBLIC SCHOOLS
CADDO,PROPOSITION NO. 1 CYRIL PUBLIC SCHOOLS,AGAINST THE PROPOSITION - NO,,80509,0,0,1,1,PROPOSITION NO. 1 CYRIL PUBLIC SCHOOLS
CADDO,PROPOSITION NO. 2 CYRIL PUBLIC SCHOOLS,FOR THE PROPOSITION - YES,,80509,0,0,1,1,PROPOSITION NO. 2 CYRIL PUBLIC SCHOOLS
CADDO,PROPOSITION NO. 2 CYRIL PUBLIC SCHOOLS,AGAINST THE PROPOSITION - NO,,80509,0,0,1,1,PROPOSITION NO. 2 CYRIL PUBLIC SCHOOLS
CADDO,PROPOSITION TOWN OF CYRIL,FOR THE PROPOSITION - YES,,80510,2,0,85,87,
CADDO,PROPOSITION TOWN OF CYRIL,AGAINST THE PROPOSITION - NO,,80510,0,0,1,1,
CADDO,PROPOSITION NO. 1 CYRIL PUBLIC SCHOOLS,FOR THE PROPOSITION - YES,,80510,2,0,103,105,PROPOSITION NO. 1 CYRIL PUBLIC SCHOOLS
CADDO,PROPOSITION NO. 1 CYRIL PUBLIC SCHOOLS,AGAINST THE PROPOSITION - NO,,80510,0,0,13,13,PROPOSITION NO. 1 CYRIL PUBLIC SCHOOLS
CADDO,PROPOSITION NO. 2 CYRIL PUBLIC SCHOOLS,FOR THE PROPOSITION - YES,,80510,2,0,103,105,PROPOSITION NO. 2 CYRIL PUBLIC SCHOOLS
CADDO,PROPOSITION NO. 2 CYRIL PUBLIC SCHOOLS,AGAINST THE PROPOSITION - NO,,80510,0,0,12,12,PROPOSITION NO. 2 CYRIL PUBLIC SCHOOLS
CADDO,PROPOSITION NO. 1 GRACEMONT PUBLIC SCHOOLS,FOR THE PROPOSITION - YES,,80810,0,1,15,16,PROPOSITION NO. 1 GRACEMONT PUBLIC SCHOOLS
CADDO,PROPOSITION NO. 1 GRACEMONT PUBLIC SCHOOLS,AGAINST THE PROPOSITION - NO,,80810,0,0,3,3,PROPOSITION NO. 1 GRACEMONT PUBLIC SCHOOLS
CADDO,PROPOSITION NO. 2 GRACEMONT PUBLIC SCHOOLS,FOR THE PROPOSITION - YES,,80810,0,1,15,16,PROPOSITION NO. 2 GRACEMONT PUBLIC SCHOOLS
CADDO,PROPOSITION NO. 2 GRACEMONT PUBLIC SCHOOLS,AGAINST THE PROPOSITION - NO,,80810,0,0,3,3,PROPOSITION NO. 2 GRACEMONT PUBLIC SCHOOLS
CADDO,PROPOSITION NO. 1 GRACEMONT PUBLIC SCHOOLS,FOR THE PROPOSITION - YES,,80811,0,5,29,34,PROPOSITION NO. 1 GRACEMONT PUBLIC SCHOOLS
CADDO,PROPOSITION NO. 1 GRACEMONT PUBLIC SCHOOLS,AGAINST THE PROPOSITION - NO,,80811,0,2,7,9,PROPOSITION NO. 1 GRACEMONT PUBLIC SCHOOLS
CADDO,PROPOSITION NO. 2 GRACEMONT PUBLIC SCHOOLS,FOR THE PROPOSITION - YES,,80811,0,5,31,36,PROPOSITION NO. 2 GRACEMONT PUBLIC SCHOOLS
CADDO,PROPOSITION NO. 2 GRACEMONT PUBLIC SCHOOLS,AGAINST THE PROPOSITION - NO,,80811,0,2,4,6,PROPOSITION NO. 2 GRACEMONT PUBLIC SCHOOLS
CADDO,PROPOSITION NO. 1 GRACEMONT PUBLIC SCHOOLS,FOR THE PROPOSITION - YES,,81009,0,3,0,3,PROPOSITION NO. 1 GRACEMONT PUBLIC SCHOOLS
CADDO,PROPOSITION NO. 1 GRACEMONT PUBLIC SCHOOLS,AGAINST THE PROPOSITION - NO,,81009,0,0,0,0,PROPOSITION NO. 1 GRACEMONT PUBLIC SCHOOLS
CADDO,PROPOSITION NO. 2 GRACEMONT PUBLIC SCHOOLS,FOR THE PROPOSITION - YES,,81009,0,3,0,3,PROPOSITION NO. 2 GRACEMONT PUBLIC SCHOOLS
CADDO,PROPOSITION NO. 2 GRACEMONT PUBLIC SCHOOLS,AGAINST THE PROPOSITION - NO,,81009,0,0,0,0,PROPOSITION NO. 2 GRACEMONT PUBLIC SCHOOLS
CADDO,PROPOSITION NO. 1 GRACEMONT PUBLIC SCHOOLS,FOR THE PROPOSITION - YES,,81010,0,0,0,0,PROPOSITION NO. 1 GRACEMONT PUBLIC SCHOOLS
CADDO,PROPOSITION NO. 1 GRACEMONT PUBLIC SCHOOLS,AGAINST THE PROPOSITION - NO,,81010,0,0,0,0,PROPOSITION NO. 1 GRACEMONT PUBLIC SCHOOLS
CADDO,PROPOSITION NO. 2 GRACEMONT PUBLIC SCHOOLS,FOR THE PROPOSITION - YES,,81010,0,0,0,0,PROPOSITION NO. 2 GRACEMONT PUBLIC SCHOOLS
CADDO,PROPOSITION NO. 2 GRACEMONT PUBLIC SCHOOLS,AGAINST THE PROPOSITION - NO,,81010,0,0,0,0,PROPOSITION NO. 2 GRACEMONT PUBLIC SCHOOLS
CARTER,PROPOSITION NO. 1,FOR THE PROPOSITION - YES,,100001,0,1,33,34,PROPOSITION NO. 1
CARTER,PROPOSITION NO. 1,AGAINST THE PROPOSITION - NO,,100001,0,0,12,12,PROPOSITION NO. 1
CARTER,PROPOSITION NO. 2,FOR THE PROPOSITION - YES,,100001,0,1,33,34,PROPOSITION NO. 2
CARTER,PROPOSITION NO. 2,AGAINST THE PROPOSITION - NO,,100001,0,0,13,13,PROPOSITION NO. 2
CARTER,PROPOSITION NO. 1,FOR THE PROPOSITION - YES,,100002,15,1,72,88,PROPOSITION NO. 1
CARTER,PROPOSITION NO. 1,AGAINST THE PROPOSITION - NO,,100002,2,3,29,34,PROPOSITION NO. 1
CARTER,PROPOSITION NO. 2,FOR THE PROPOSITION - YES,,100002,13,1,79,93,PROPOSITION NO. 2
CARTER,PROPOSITION NO. 2,AGAINST THE PROPOSITION - NO,,100002,3,3,26,32,PROPOSITION NO. 2
CARTER,PROPOSITION NO. 1,FOR THE PROPOSITION - YES,,100007,1,0,13,14,PROPOSITION NO. 1
CARTER,PROPOSITION NO. 1,AGAINST THE PROPOSITION - NO,,100007,0,0,0,0,PROPOSITION NO. 1
CARTER,PROPOSITION NO. 2,FOR THE PROPOSITION - YES,,100007,1,0,12,13,PROPOSITION NO. 2
CARTER,PROPOSITION NO. 2,AGAINST THE PROPOSITION - NO,,100007,0,0,1,1,PROPOSITION NO. 2
CARTER,PROPOSITION NO. 1,FOR THE PROPOSITION - YES,,100011,2,3,53,58,PROPOSITION NO. 1
CARTER,PROPOSITION NO. 1,AGAINST THE PROPOSITION - NO,,100011,0,1,13,14,PROPOSITION NO. 1
CARTER,PROPOSITION NO. 2,FOR THE PROPOSITION - YES,,100011,2,3,47,52,PROPOSITION NO. 2
CARTER,PROPOSITION NO. 2,AGAINST THE PROPOSITION - NO,,100011,0,1,19,20,PROPOSITION NO. 2
CARTER,PROPOSITION NO. 1,FOR THE PROPOSITION - YES,,100014,2,2,27,31,PROPOSITION NO. 1
CARTER,PROPOSITION NO. 1,AGAINST THE PROPOSITION - NO,,100014,1,0,12,13,PROPOSITION NO. 1
CARTER,PROPOSITION NO. 2,FOR THE PROPOSITION - YES,,100014,2,2,28,32,PROPOSITION NO. 2
CARTER,PROPOSITION NO. 2,AGAINST THE PROPOSITION - NO,,100014,1,0,11,12,PROPOSITION NO. 2
CARTER,PROPOSITION NO. 1,FOR THE PROPOSITION - YES,,100015,3,1,71,75,PROPOSITION NO. 1
CARTER,PROPOSITION NO. 1,AGAINST THE PROPOSITION - NO,,100015,2,5,20,27,PROPOSITION NO. 1
CARTER,PROPOSITION NO. 2,FOR THE PROPOSITION - YES,,100015,3,2,64,69,PROPOSITION NO. 2
CARTER,PROPOSITION NO. 2,AGAINST THE PROPOSITION - NO,,100015,2,5,28,35,PROPOSITION NO. 2
CARTER,PROPOSITION NO. 1,FOR THE PROPOSITION - YES,,100017,1,3,67,71,PROPOSITION NO. 1
CARTER,PROPOSITION NO. 1,AGAINST THE PROPOSITION - NO,,100017,1,0,13,14,PROPOSITION NO. 1
CARTER,PROPOSITION NO. 2,FOR THE PROPOSITION - YES,,100017,1,4,65,70,PROPOSITION NO. 2
CARTER,PROPOSITION NO. 2,AGAINST THE PROPOSITION - NO,,100017,1,0,13,14,PROPOSITION NO. 2
CARTER,PROPOSITION NO. 1,FOR THE PROPOSITION - YES,,100019,10,19,281,310,PROPOSITION NO. 1
CARTER,PROPOSITION NO. 1,AGAINST THE PROPOSITION - NO,,100019,2,4,44,50,PROPOSITION NO. 1
CARTER,PROPOSITION NO. 2,FOR THE PROPOSITION - YES,,100019,8,20,274,302,PROPOSITION NO. 2
CARTER,PROPOSITION NO. 2,AGAINST THE PROPOSITION - NO,,100019,4,4,52,60,PROPOSITION NO. 2
CARTER,PROPOSITION NO. 1,FOR THE PROPOSITION - YES,,100020,0,3,78,81,PROPOSITION NO. 1
CARTER,PROPOSITION NO. 1,AGAINST THE PROPOSITION - NO,,100020,0,0,21,21,PROPOSITION NO. 1
CARTER,PROPOSITION NO. 2,FOR THE PROPOSITION - YES,,100020,0,2,77,79,PROPOSITION NO. 2
CARTER,PROPOSITION NO. 2,AGAINST THE PROPOSITION - NO,,100020,0,1,24,25,PROPOSITION NO. 2
CARTER,PROPOSITION NO. 1,FOR THE PROPOSITION - YES,,100024,4,4,77,85,PROPOSITION NO. 1
CARTER,PROPOSITION NO. 1,AGAINST THE PROPOSITION - NO,,100024,1,0,21,22,PROPOSITION NO. 1
CARTER,PROPOSITION NO. 2,FOR THE PROPOSITION - YES,,100024,4,4,76,84,PROPOSITION NO. 2
CARTER,PROPOSITION NO. 2,AGAINST THE PROPOSITION - NO,,100024,1,0,23,24,PROPOSITION NO. 2
CARTER,PROPOSITION TOWN OF SPRINGER,FOR THE PROPOSITION - YES,,100024,0,0,0,0,
CARTER,PROPOSITION TOWN OF SPRINGER,AGAINST THE PROPOSITION - NO,,100024,0,0,0,0,
CARTER,PROPOSITION NO. 1,FOR THE PROPOSITION - YES,,100025,0,0,23,23,PROPOSITION NO. 1
CARTER,PROPOSITION NO. 1,AGAINST THE PROPOSITION - NO,,100025,0,0,7,7,PROPOSITION NO. 1
CARTER,PROPOSITION NO. 2,FOR THE PROPOSITION - YES,,100025,0,0,19,19,PROPOSITION NO. 2
CARTER,PROPOSITION NO. 2,AGAINST THE PROPOSITION - NO,,100025,0,0,11,11,PROPOSITION NO. 2
CARTER,PROPOSITION NO. 1,FOR THE PROPOSITION - YES,,100026,2,0,27,29,PROPOSITION NO. 1
CARTER,PROPOSITION NO. 1,AGAINST THE PROPOSITION - NO,,100026,0,0,2,2,PROPOSITION NO. 1
CARTER,PROPOSITION NO. 2,FOR THE PROPOSITION - YES,,100026,0,0,29,29,PROPOSITION NO. 2
CARTER,PROPOSITION NO. 2,AGAINST THE PROPOSITION - NO,,100026,2,0,3,5,PROPOSITION NO. 2
CARTER,PROPOSITION TOWN OF SPRINGER,FOR THE PROPOSITION - YES,,100026,0,0,1,1,
CARTER,PROPOSITION TOWN OF SPRINGER,AGAINST THE PROPOSITION - NO,,100026,0,0,0,0,
CARTER,PROPOSITION NO. 1,FOR THE PROPOSITION - YES,,100030,0,1,18,19,PROPOSITION NO. 1
CARTER,PROPOSITION NO. 1,AGAINST THE PROPOSITION - NO,,100030,2,0,6,8,PROPOSITION NO. 1
CARTER,PROPOSITION NO. 2,FOR THE PROPOSITION - YES,,100030,1,1,20,22,PROPOSITION NO. 2
CARTER,PROPOSITION NO. 2,AGAINST THE PROPOSITION - NO,,100030,1,0,4,5,PROPOSITION NO. 2
CARTER,PROPOSITION NO. 1,FOR THE PROPOSITION - YES,,100031,3,4,114,121,PROPOSITION NO. 1
CARTER,PROPOSITION NO. 1,AGAINST THE PROPOSITION - NO,,100031,1,1,40,42,PROPOSITION NO. 1
CARTER,PROPOSITION NO. 2,FOR THE PROPOSITION - YES,,100031,4,4,116,124,PROPOSITION NO. 2
CARTER,PROPOSITION NO. 2,AGAINST THE PROPOSITION - NO,,100031,0,1,38,39,PROPOSITION NO. 2
CARTER,PROPOSITION NO. 1,FOR THE PROPOSITION - YES,,100032,0,0,6,6,PROPOSITION NO. 1
CARTER,PROPOSITION NO. 1,AGAINST THE PROPOSITION - NO,,100032,0,0,15,15,PROPOSITION NO. 1
CARTER,PROPOSITION NO. 2,FOR THE PROPOSITION - YES,,100032,0,0,7,7,PROPOSITION NO. 2
CARTER,PROPOSITION NO. 2,AGAINST THE PROPOSITION - NO,,100032,0,0,14,14,PROPOSITION NO. 2
CARTER,PROPOSITION NO. 1,FOR THE PROPOSITION - YES,,100033,0,6,54,60,PROPOSITION NO. 1
CARTER,PROPOSITION NO. 1,AGAINST THE PROPOSITION - NO,,100033,1,0,23,24,PROPOSITION NO. 1
CARTER,PROPOSITION NO. 2,FOR THE PROPOSITION - YES,,100033,1,4,49,54,PROPOSITION NO. 2
CARTER,PROPOSITION NO. 2,AGAINST THE PROPOSITION - NO,,100033,0,0,21,21,PROPOSITION NO. 2
CARTER,PROPOSITION TOWN OF SPRINGER,FOR THE PROPOSITION - YES,,100033,0,2,27,29,
CARTER,PROPOSITION TOWN OF SPRINGER,AGAINST THE PROPOSITION - NO,,100033,0,2,28,30,
CARTER,PROPOSITION NO. 1,FOR THE PROPOSITION - YES,,100034,1,3,55,59,PROPOSITION NO. 1
CARTER,PROPOSITION NO. 1,AGAINST THE PROPOSITION - NO,,100034,0,1,8,9,PROPOSITION NO. 1
CARTER,PROPOSITION NO. 2,FOR THE PROPOSITION - YES,,100034,1,3,52,56,PROPOSITION NO. 2
CARTER,PROPOSITION NO. 2,AGAINST THE PROPOSITION - NO,,100034,0,1,15,16,PROPOSITION NO. 2
CARTER,PROPOSITION NO. 1,FOR THE PROPOSITION - YES,,100039,0,0,20,20,PROPOSITION NO. 1
CARTER,PROPOSITION NO. 1,AGAINST THE PROPOSITION - NO,,100039,0,0,3,3,PROPOSITION NO. 1
CARTER,PROPOSITION NO. 2,FOR THE PROPOSITION - YES,,100039,0,0,22,22,PROPOSITION NO. 2
CARTER,PROPOSITION NO. 2,AGAINST THE PROPOSITION - NO,,100039,0,0,2,2,PROPOSITION NO. 2
CARTER,PROPOSITION NO. 1,FOR THE PROPOSITION - YES,,100041,0,1,187,188,PROPOSITION NO. 1
CARTER,PROPOSITION NO. 1,AGAINST THE PROPOSITION - NO,,100041,2,0,39,41,PROPOSITION NO. 1
CARTER,PROPOSITION NO. 2,FOR THE PROPOSITION - YES,,100041,2,1,186,189,PROPOSITION NO. 2
CARTER,PROPOSITION NO. 2,AGAINST THE PROPOSITION - NO,,100041,0,0,39,39,PROPOSITION NO. 2
CARTER,PROPOSITION CITY OF HEALDTON,FOR THE PROPOSITION - YES,,100041,2,1,158,161,
CARTER,PROPOSITION CITY OF HEALDTON,AGAINST THE PROPOSITION - NO,,100041,0,0,71,71,
CARTER,PROPOSITION NO. 1,FOR THE PROPOSITION - YES,,100051,0,0,14,14,PROPOSITION NO. 1
CARTER,PROPOSITION NO. 1,AGAINST THE PROPOSITION - NO,,100051,0,0,9,9,PROPOSITION NO. 1
CARTER,PROPOSITION NO. 2,FOR THE PROPOSITION - YES,,100051,0,0,13,13,PROPOSITION NO. 2
CARTER,PROPOSITION NO. 2,AGAINST THE PROPOSITION - NO,,100051,0,0,10,10,PROPOSITION NO. 2
CARTER,PROPOSITION NO. 1,FOR THE PROPOSITION - YES,,100052,0,0,14,14,PROPOSITION NO. 1
CARTER,PROPOSITION NO. 1,AGAINST THE PROPOSITION - NO,,100052,0,0,17,17,PROPOSITION NO. 1
CARTER,PROPOSITION NO. 2,FOR THE PROPOSITION - YES,,100052,0,0,16,16,PROPOSITION NO. 2
CARTER,PROPOSITION NO. 2,AGAINST THE PROPOSITION - NO,,100052,0,0,15,15,PROPOSITION NO. 2
CARTER,PROPOSITION NO. 1,FOR THE PROPOSITION - YES,,100061,0,1,33,34,PROPOSITION NO. 1
CARTER,PROPOSITION NO. 1,AGAINST THE PROPOSITION - NO,,100061,2,0,5,7,PROPOSITION NO. 1
CARTER,PROPOSITION NO. 2,FOR THE PROPOSITION - YES,,100061,2,1,33,36,PROPOSITION NO. 2
CARTER,PROPOSITION NO. 2,AGAINST THE PROPOSITION - NO,,100061,0,0,6,6,PROPOSITION NO. 2
CARTER,PROPOSITION NO. 1,FOR THE PROPOSITION - YES,,100062,3,8,74,85,PROPOSITION NO. 1
CARTER,PROPOSITION NO. 1,AGAINST THE PROPOSITION - NO,,100062,1,0,13,14,PROPOSITION NO. 1
CARTER,PROPOSITION NO. 2,FOR THE PROPOSITION - YES,,100062,3,6,77,86,PROPOSITION NO. 2
CARTER,PROPOSITION NO. 2,AGAINST THE PROPOSITION - NO,,100062,1,2,13,16,PROPOSITION NO. 2
CARTER,PROPOSITION NO. 1,FOR THE PROPOSITION - YES,,100063,1,4,84,89,PROPOSITION NO. 1
CARTER,PROPOSITION NO. 1,AGAINST THE PROPOSITION - NO,,100063,0,1,28,29,PROPOSITION NO. 1
CARTER,PROPOSITION NO. 2,FOR THE PROPOSITION - YES,,100063,1,5,91,97,PROPOSITION NO. 2
CARTER,PROPOSITION NO. 2,AGAINST THE PROPOSITION - NO,,100063,0,1,26,27,PROPOSITION NO. 2
CARTER,PROPOSITION NO. 1,FOR THE PROPOSITION - YES,,100071,3,0,69,72,PROPOSITION NO. 1
CARTER,PROPOSITION NO. 1,AGAINST THE PROPOSITION - NO,,100071,0,0,14,14,PROPOSITION NO. 1
CARTER,PROPOSITION NO. 2,FOR THE PROPOSITION - YES,,100071,3,0,71,74,PROPOSITION NO. 2
CARTER,PROPOSITION NO. 2,AGAINST THE PROPOSITION - NO,,100071,0,0,14,14,PROPOSITION NO. 2
CARTER,PROPOSITION CITY OF HEALDTON,FOR THE PROPOSITION - YES,,100071,0,0,2,2,
CARTER,PROPOSITION CITY OF HEALDTON,AGAINST THE PROPOSITION - NO,,100071,0,0,0,0,
CHEROKEE,PROPOSITION LOCUST GROVE PUBLIC SCHOOLS,FOR THE PROPOSITION - YES,,110014,0,0,0,0,
CHEROKEE,PROPOSITION LOCUST GROVE PUBLIC SCHOOLS,AGAINST THE PROPOSITION - NO,,110014,1,0,0,1,
CHEROKEE,PROPOSITION LOCUST GROVE PUBLIC SCHOOLS,FOR THE PROPOSITION - YES,,110016,0,0,5,5,
CHEROKEE,PROPOSITION LOCUST GROVE PUBLIC SCHOOLS,AGAINST THE PROPOSITION - NO,,110016,0,0,0,0,
CHOCTAW,PROPOSITION RATTAN PUBLIC SCHOOLS,FOR THE PROPOSITION - YES,,120319,0,0,26,26,
CHOCTAW,PROPOSITION RATTAN PUBLIC SCHOOLS,AGAINST THE PROPOSITION - NO,,120319,0,0,49,49,
CLEVELAND,PROPOSITION NO. 1 MIDWEST CITY-DEL CITY PUBLIC SCHOOLS,FOR THE PROPOSITION - YES,,140078,11,0,54,65,PROPOSITION NO. 1 MIDWEST CITY-DEL CITY PUBLIC SCHOOLS
CLEVELAND,PROPOSITION NO. 1 MIDWEST CITY-DEL CITY PUBLIC SCHOOLS,AGAINST THE PROPOSITION - NO,,140078,5,0,8,13,PROPOSITION NO. 1 MIDWEST CITY-DEL CITY PUBLIC SCHOOLS
CLEVELAND,PROPOSITION NO. 2 MIDWEST CITY-DEL CITY PUBLIC SCHOOLS,FOR THE PROPOSITION - YES,,140078,10,0,50,60,PROPOSITION NO. 2 MIDWEST CITY-DEL CITY PUBLIC SCHOOLS
CLEVELAND,PROPOSITION NO. 2 MIDWEST CITY-DEL CITY PUBLIC SCHOOLS,AGAINST THE PROPOSITION - NO,,140078,6,0,12,18,PROPOSITION NO. 2 MIDWEST CITY-DEL CITY PUBLIC SCHOOLS
CLEVELAND,PROPOSITION NO. 1 MIDWEST CITY-DEL CITY PUBLIC SCHOOLS,FOR THE PROPOSITION - YES,,140087,0,0,4,4,PROPOSITION NO. 1 MIDWEST CITY-DEL CITY PUBLIC SCHOOLS
CLEVELAND,PROPOSITION NO. 1 MIDWEST CITY-DEL CITY PUBLIC SCHOOLS,AGAINST THE PROPOSITION - NO,,140087,2,0,0,2,PROPOSITION NO. 1 MIDWEST CITY-DEL CITY PUBLIC SCHOOLS
CLEVELAND,PROPOSITION NO. 2 MIDWEST CITY-DEL CITY PUBLIC SCHOOLS,FOR THE PROPOSITION - YES,,140087,0,0,4,4,PROPOSITION NO. 2 MIDWEST CITY-DEL CITY PUBLIC SCHOOLS
CLEVELAND,PROPOSITION NO. 2 MIDWEST CITY-DEL CITY PUBLIC SCHOOLS,AGAINST THE PROPOSITION - NO,,140087,2,0,0,2,PROPOSITION NO. 2 MIDWEST CITY-DEL CITY PUBLIC SCHOOLS
COMANCHE,PROPOSITION NO. 1 CYRIL PUBLIC SCHOOLS,FOR THE PROPOSITION - YES,,160040,0,0,0,0,PROPOSITION NO. 1 CYRIL PUBLIC SCHOOLS
COMANCHE,PROPOSITION NO. 1 CYRIL PUBLIC SCHOOLS,AGAINST THE PROPOSITION - NO,,160040,0,0,0,0,PROPOSITION NO. 1 CYRIL PUBLIC SCHOOLS
COMANCHE,PROPOSITION NO. 2 CYRIL PUBLIC SCHOOLS,FOR THE PROPOSITION - YES,,160040,0,0,0,0,PROPOSITION NO. 2 CYRIL PUBLIC SCHOOLS
COMANCHE,PROPOSITION NO. 2 CYRIL PUBLIC SCHOOLS,AGAINST THE PROPOSITION - NO,,160040,0,0,0,0,PROPOSITION NO. 2 CYRIL PUBLIC SCHOOLS
DELAWARE,PROPOSITION TURKEY FORD PUBLIC SCHOOL,FOR THE PROPOSITION - YES,,210006,0,0,32,32,
DELAWARE,PROPOSITION TURKEY FORD PUBLIC SCHOOL,AGAINST THE PROPOSITION - NO,,210006,0,0,0,0,
JEFFERSON,PROPOSITION RYAN PUBLIC SCHOOLS,FOR THE PROPOSITION - YES,,340006,11,1,163,175,
JEFFERSON,PROPOSITION RYAN PUBLIC SCHOOLS,AGAINST THE PROPOSITION - NO,,340006,1,1,42,44,
JEFFERSON,PROPOSITION RYAN PUBLIC SCHOOLS,FOR THE PROPOSITION - YES,,340007,0,0,0,0,
JEFFERSON,PROPOSITION RYAN PUBLIC SCHOOLS,AGAINST THE PROPOSITION - NO,,340007,0,0,0,0,
JEFFERSON,PROPOSITION RYAN PUBLIC SCHOOLS,FOR THE PROPOSITION - YES,,340008,0,0,0,0,
JEFFERSON,PROPOSITION RYAN PUBLIC SCHOOLS,AGAINST THE PROPOSITION - NO,,340008,0,0,0,0,
JEFFERSON,PROPOSITION RYAN PUBLIC SCHOOLS,FOR THE PROPOSITION - YES,,340010,0,0,2,2,
JEFFERSON,PROPOSITION RYAN PUBLIC SCHOOLS,AGAINST THE PROPOSITION - NO,,340010,0,0,7,7,
JOHNSTON,PROPOSITION CITY OF TISHOMINGO,FOR THE PROPOSITION - YES,,350001,0,0,0,0,
JOHNSTON,PROPOSITION CITY OF TISHOMINGO,AGAINST THE PROPOSITION - NO,,350001,0,0,0,0,
JOHNSTON,PROPOSITION CITY OF TISHOMINGO,FOR THE PROPOSITION - YES,,350002,0,0,16,16,
JOHNSTON,PROPOSITION CITY OF TISHOMINGO,AGAINST THE PROPOSITION - NO,,350002,0,2,2,4,
JOHNSTON,PROPOSITION CITY OF TISHOMINGO,FOR THE PROPOSITION - YES,,350003,1,0,10,11,
JOHNSTON,PROPOSITION CITY OF TISHOMINGO,AGAINST THE PROPOSITION - NO,,350003,0,2,4,6,
JOHNSTON,PROPOSITION CITY OF TISHOMINGO,FOR THE PROPOSITION - YES,,350004,2,5,18,25,
JOHNSTON,PROPOSITION CITY OF TISHOMINGO,AGAINST THE PROPOSITION - NO,,350004,0,0,9,9,
KAY,PROPOSITION PECKHAM PUBLIC SCHOOL,FOR THE PROPOSITION - YES,,360202,0,0,0,0,
KAY,PROPOSITION PECKHAM PUBLIC SCHOOL,AGAINST THE PROPOSITION - NO,,360202,0,0,0,0,
KAY,PROPOSITION SHIDLER PUBLIC SCHOOLS,FOR THE PROPOSITION - YES,,360400,0,0,2,2,
KAY,PROPOSITION SHIDLER PUBLIC SCHOOLS,AGAINST THE PROPOSITION - NO,,360400,2,0,3,5,
KAY,PROPOSITION SHIDLER PUBLIC SCHOOLS,FOR THE PROPOSITION - YES,,360401,0,0,0,0,
KAY,PROPOSITION SHIDLER PUBLIC SCHOOLS,AGAINST THE PROPOSITION - NO,,360401,0,0,0,0,
KAY,PROPOSITION PECKHAM PUBLIC SCHOOL,FOR THE PROPOSITION - YES,,360403,0,0,13,13,
KAY,PROPOSITION PECKHAM PUBLIC SCHOOL,AGAINST THE PROPOSITION - NO,,360403,0,2,0,2,
KAY,PROPOSITION PECKHAM PUBLIC SCHOOL,FOR THE PROPOSITION - YES,,360404,0,4,41,45,
KAY,PROPOSITION PECKHAM PUBLIC SCHOOL,AGAINST THE PROPOSITION - NO,,360404,0,0,12,12,
KAY,PROPOSITION PECKHAM PUBLIC SCHOOL,FOR THE PROPOSITION - YES,,360409,0,1,8,9,
KAY,PROPOSITION PECKHAM PUBLIC SCHOOL,AGAINST THE PROPOSITION - NO,,360409,0,0,8,8,
KAY,PROPOSITION CITY OF PONCA CITY,FOR THE PROPOSITION - YES,,360411,0,0,0,0,
KAY,PROPOSITION CITY OF PONCA CITY,AGAINST THE PROPOSITION - NO,,360411,0,0,0,0,
KAY,PROPOSITION SHIDLER PUBLIC SCHOOLS,FOR THE PROPOSITION - YES,,360412,0,0,20,20,
KAY,PROPOSITION SHIDLER PUBLIC SCHOOLS,AGAINST THE PROPOSITION - NO,,360412,0,0,66,66,
KAY,PROPOSITION CITY OF PONCA CITY,FOR THE PROPOSITION - YES,,360413,1,0,24,25,
KAY,PROPOSITION CITY OF PONCA CITY,AGAINST THE PROPOSITION - NO,,360413,0,0,4,4,
KAY,PROPOSITION CITY OF PONCA CITY,FOR THE PROPOSITION - YES,,360419,2,1,6,9,
KAY,PROPOSITION CITY OF PONCA CITY,AGAINST THE PROPOSITION - NO,,360419,0,0,4,4,
KAY,PROPOSITION CITY OF PONCA CITY,FOR THE PROPOSITION - YES,,360420,0,2,0,2,
KAY,PROPOSITION CITY OF PONCA CITY,AGAINST THE PROPOSITION - NO,,360420,0,0,0,0,
KAY,PROPOSITION PECKHAM PUBLIC SCHOOL,FOR THE PROPOSITION - YES,,360420,0,0,2,2,
KAY,PROPOSITION PECKHAM PUBLIC SCHOOL,AGAINST THE PROPOSITION - NO,,360420,0,0,0,0,
KAY,PROPOSITION CITY OF PONCA CITY,FOR THE PROPOSITION - YES,,360503,0,0,32,32,
KAY,PROPOSITION CITY OF PONCA CITY,AGAINST THE PROPOSITION - NO,,360503,0,1,3,4,
KAY,PROPOSITION CITY OF PONCA CITY,FOR THE PROPOSITION - YES,,360507,0,0,11,11,
KAY,PROPOSITION CITY OF PONCA CITY,AGAINST THE PROPOSITION - NO,,360507,0,2,6,8,
KAY,PROPOSITION CITY OF PONCA CITY,FOR THE PROPOSITION - YES,,360516,0,1,6,7,
KAY,PROPOSITION CITY OF PONCA CITY,AGAINST THE PROPOSITION - NO,,360516,0,1,11,12,
KAY,PROPOSITION CITY OF PONCA CITY,FOR THE PROPOSITION - YES,,360517,0,2,26,28,
KAY,PROPOSITION CITY OF PONCA CITY,AGAINST THE PROPOSITION - NO,,360517,0,0,6,6,
KAY,PROPOSITION CITY OF PONCA CITY,FOR THE PROPOSITION - YES,,360527,2,0,33,35,
KAY,PROPOSITION CITY OF PONCA CITY,AGAINST THE PROPOSITION - NO,,360527,1,1,9,11,
KAY,PROPOSITION CITY OF PONCA CITY,FOR THE PROPOSITION - YES,,360530,2,3,20,25,
KAY,PROPOSITION CITY OF PONCA CITY,AGAINST THE PROPOSITION - NO,,360530,0,0,8,8,
KAY,PROPOSITION CITY OF PONCA CITY,FOR THE PROPOSITION - YES,,360532,0,2,59,61,
KAY,PROPOSITION CITY OF PONCA CITY,AGAINST THE PROPOSITION - NO,,360532,0,1,16,17,
KAY,PROPOSITION CITY OF PONCA CITY,FOR THE PROPOSITION - YES,,360533,0,3,39,42,
KAY,PROPOSITION CITY OF PONCA CITY,AGAINST THE PROPOSITION - NO,,360533,2,0,17,19,
KAY,PROPOSITION CITY OF PONCA CITY,FOR THE PROPOSITION - YES,,360534,3,2,68,73,
KAY,PROPOSITION CITY OF PONCA CITY,AGAINST THE PROPOSITION - NO,,360534,0,0,19,19,
KAY,PROPOSITION CITY OF PONCA CITY,FOR THE PROPOSITION - YES,,360535,2,4,87,93,
KAY,PROPOSITION CITY OF PONCA CITY,AGAINST THE PROPOSITION - NO,,360535,0,0,18,18,
MCCLAIN,PROPOSITION NO. 1 PURCELL PUBLIC SCHOOLS,FOR THE PROPOSITION - YES,,440006,2,11,170,183,PROPOSITION NO. 1 PURCELL PUBLIC SCHOOLS
MCCLAIN,PROPOSITION NO. 1 PURCELL PUBLIC SCHOOLS,AGAINST THE PROPOSITION - NO,,440006,2,6,58,66,PROPOSITION NO. 1 PURCELL PUBLIC SCHOOLS
MCCLAIN,PROPOSITION NO. 2 PURCELL PUBLIC SCHOOLS,FOR THE PROPOSITION - YES,,440006,1,12,181,194,PROPOSITION NO. 2 PURCELL PUBLIC SCHOOLS
MCCLAIN,PROPOSITION NO. 2 PURCELL PUBLIC SCHOOLS,AGAINST THE PROPOSITION - NO,,440006,3,5,49,57,PROPOSITION NO. 2 PURCELL PUBLIC SCHOOLS
MCCLAIN,PROPOSITION NO. 1 PURCELL PUBLIC SCHOOLS,FOR THE PROPOSITION - YES,,440007,2,3,31,36,PROPOSITION NO. 1 PURCELL PUBLIC SCHOOLS
MCCLAIN,PROPOSITION NO. 1 PURCELL PUBLIC SCHOOLS,AGAINST THE PROPOSITION - NO,,440007,0,1,7,8,PROPOSITION NO. 1 PURCELL PUBLIC SCHOOLS
MCCLAIN,PROPOSITION NO. 2 PURCELL PUBLIC SCHOOLS,FOR THE PROPOSITION - YES,,440007,2,3,31,36,PROPOSITION NO. 2 PURCELL PUBLIC SCHOOLS
MCCLAIN,PROPOSITION NO. 2 PURCELL PUBLIC SCHOOLS,AGAINST THE PROPOSITION - NO,,440007,0,1,8,9,PROPOSITION NO. 2 PURCELL PUBLIC SCHOOLS
MCCLAIN,PROPOSITION NO. 1 PURCELL PUBLIC SCHOOLS,FOR THE PROPOSITION - YES,,440008,0,0,2,2,PROPOSITION NO. 1 PURCELL PUBLIC SCHOOLS
MCCLAIN,PROPOSITION NO. 1 PURCELL PUBLIC SCHOOLS,AGAINST THE PROPOSITION - NO,,440008,0,0,0,0,PROPOSITION NO. 1 PURCELL PUBLIC SCHOOLS
MCCLAIN,PROPOSITION NO. 2 PURCELL PUBLIC SCHOOLS,FOR THE PROPOSITION - YES,,440008,0,0,2,2,PROPOSITION NO. 2 PURCELL PUBLIC SCHOOLS
MCCLAIN,PROPOSITION NO. 2 PURCELL PUBLIC SCHOOLS,AGAINST THE PROPOSITION - NO,,440008,0,0,0,0,PROPOSITION NO. 2 PURCELL PUBLIC SCHOOLS
MCCLAIN,PROPOSITION NO. 1 PURCELL PUBLIC SCHOOLS,FOR THE PROPOSITION - YES,,440020,0,2,6,8,PROPOSITION NO. 1 PURCELL PUBLIC SCHOOLS
MCCLAIN,PROPOSITION NO. 1 PURCELL PUBLIC SCHOOLS,AGAINST THE PROPOSITION - NO,,440020,0,0,2,2,PROPOSITION NO. 1 PURCELL PUBLIC SCHOOLS
MCCLAIN,PROPOSITION NO. 2 PURCELL PUBLIC SCHOOLS,FOR THE PROPOSITION - YES,,440020,0,2,6,8,PROPOSITION NO. 2 PURCELL PUBLIC SCHOOLS
MCCLAIN,PROPOSITION NO. 2 PURCELL PUBLIC SCHOOLS,AGAINST THE PROPOSITION - NO,,440020,0,0,2,2,PROPOSITION NO. 2 PURCELL PUBLIC SCHOOLS
MCCLAIN,PROPOSITION NO. 1 PURCELL PUBLIC SCHOOLS,FOR THE PROPOSITION - YES,,440021,1,8,90,99,PROPOSITION NO. 1 PURCELL PUBLIC SCHOOLS
MCCLAIN,PROPOSITION NO. 1 PURCELL PUBLIC SCHOOLS,AGAINST THE PROPOSITION - NO,,440021,0,3,48,51,PROPOSITION NO. 1 PURCELL PUBLIC SCHOOLS
MCCLAIN,PROPOSITION NO. 2 PURCELL PUBLIC SCHOOLS,FOR THE PROPOSITION - YES,,440021,1,9,97,107,PROPOSITION NO. 2 PURCELL PUBLIC SCHOOLS
MCCLAIN,PROPOSITION NO. 2 PURCELL PUBLIC SCHOOLS,AGAINST THE PROPOSITION - NO,,440021,0,1,42,43,PROPOSITION NO. 2 PURCELL PUBLIC SCHOOLS
MCCLAIN,PROPOSITION NO. 1 PURCELL PUBLIC SCHOOLS,FOR THE PROPOSITION - YES,,440023,5,7,201,213,PROPOSITION NO. 1 PURCELL PUBLIC SCHOOLS
MCCLAIN,PROPOSITION NO. 1 PURCELL PUBLIC SCHOOLS,AGAINST THE PROPOSITION - NO,,440023,3,7,82,92,PROPOSITION NO. 1 PURCELL PUBLIC SCHOOLS
MCCLAIN,PROPOSITION NO. 2 PURCELL PUBLIC SCHOOLS,FOR THE PROPOSITION - YES,,440023,5,8,213,226,PROPOSITION NO. 2 PURCELL PUBLIC SCHOOLS
MCCLAIN,PROPOSITION NO. 2 PURCELL PUBLIC SCHOOLS,AGAINST THE PROPOSITION - NO,,440023,3,6,73,82,PROPOSITION NO. 2 PURCELL PUBLIC SCHOOLS
MCCLAIN,PROPOSITION NO. 1 PURCELL PUBLIC SCHOOLS,FOR THE PROPOSITION - YES,,440024,16,7,184,207,PROPOSITION NO. 1 PURCELL PUBLIC SCHOOLS
MCCLAIN,PROPOSITION NO. 1 PURCELL PUBLIC SCHOOLS,AGAINST THE PROPOSITION - NO,,440024,2,7,86,95,PROPOSITION NO. 1 PURCELL PUBLIC SCHOOLS
MCCLAIN,PROPOSITION NO. 2 PURCELL PUBLIC SCHOOLS,FOR THE PROPOSITION - YES,,440024,15,7,187,209,PROPOSITION NO. 2 PURCELL PUBLIC SCHOOLS
MCCLAIN,PROPOSITION NO. 2 PURCELL PUBLIC SCHOOLS,AGAINST THE PROPOSITION - NO,,440024,3,7,85,95,PROPOSITION NO. 2 PURCELL PUBLIC SCHOOLS
MCCLAIN,PROPOSITION NO. 1 PURCELL PUBLIC SCHOOLS,FOR THE PROPOSITION - YES,,440026,0,0,10,10,PROPOSITION NO. 1 PURCELL PUBLIC SCHOOLS
MCCLAIN,PROPOSITION NO. 1 PURCELL PUBLIC SCHOOLS,AGAINST THE PROPOSITION - NO,,440026,0,0,1,1,PROPOSITION NO. 1 PURCELL PUBLIC SCHOOLS
MCCLAIN,PROPOSITION NO. 2 PURCELL PUBLIC SCHOOLS,FOR THE PROPOSITION - YES,,440026,0,0,11,11,PROPOSITION NO. 2 PURCELL PUBLIC SCHOOLS
MCCLAIN,PROPOSITION NO. 2 PURCELL PUBLIC SCHOOLS,AGAINST THE PROPOSITION - NO,,440026,0,0,1,1,PROPOSITION NO. 2 PURCELL PUBLIC SCHOOLS
MAJOR,PROPOSITION MOORELAND PUBLIC SCHOOLS,FOR THE PROPOSITION - YES,,470009,0,0,0,0,
MAJOR,PROPOSITION MOORELAND PUBLIC SCHOOLS,AGAINST THE PROPOSITION - NO,,470009,0,0,0,0,
MAYES,PROPOSITION LOCUST GROVE PUBLIC SCHOOLS,FOR THE PROPOSITION - YES,,490025,0,0,8,8,
MAYES,PROPOSITION LOCUST GROVE PUBLIC SCHOOLS,AGAINST THE PROPOSITION - NO,,490025,2,0,18,20,
MAYES,PROPOSITION LOCUST GROVE PUBLIC SCHOOLS,FOR THE PROPOSITION - YES,,490026,0,1,1,2,
MAYES,PROPOSITION LOCUST GROVE PUBLIC SCHOOLS,AGAINST THE PROPOSITION - NO,,490026,1,0,0,1,
MAYES,PROPOSITION LOCUST GROVE PUBLIC SCHOOLS,FOR THE PROPOSITION - YES,,490037,0,0,51,51,
MAYES,PROPOSITION LOCUST GROVE PUBLIC SCHOOLS,AGAINST THE PROPOSITION - NO,,490037,4,0,23,27,
MAYES,PROPOSITION LOCUST GROVE PUBLIC SCHOOLS,FOR THE PROPOSITION - YES,,490038,0,0,18,18,
MAYES,PROPOSITION LOCUST GROVE PUBLIC SCHOOLS,AGAINST THE PROPOSITION - NO,,490038,1,0,8,9,
MAYES,PROPOSITION LOCUST GROVE PUBLIC SCHOOLS,FOR THE PROPOSITION - YES,,490039,1,1,91,93,
MAYES,PROPOSITION LOCUST GROVE PUBLIC SCHOOLS,AGAINST THE PROPOSITION - NO,,490039,0,0,32,32,
MAYES,PROPOSITION LOCUST GROVE PUBLIC SCHOOLS,FOR THE PROPOSITION - YES,,490311,0,0,32,32,
MAYES,PROPOSITION LOCUST GROVE PUBLIC SCHOOLS,AGAINST THE PROPOSITION - NO,,490311,0,0,14,14,
MURRAY,PROPOSITION ROFF PUBLIC SCHOOLS,FOR THE PROPOSITION - YES,,500017,0,1,18,19,
MURRAY,PROPOSITION ROFF PUBLIC SCHOOLS,AGAINST THE PROPOSITION - NO,,500017,0,1,8,9,
MUSKOGEE,PROPOSITION HILLDALE PUBLIC SCHOOLS,FOR THE PROPOSITION - YES,,510009,0,9,39,48,
MUSKOGEE,PROPOSITION HILLDALE PUBLIC SCHOOLS,AGAINST THE PROPOSITION - NO,,510009,0,8,13,21,
MUSKOGEE,PROPOSITION HILLDALE PUBLIC SCHOOLS,FOR THE PROPOSITION - YES,,510011,0,0,1,1,
MUSKOGEE,PROPOSITION HILLDALE PUBLIC SCHOOLS,AGAINST THE PROPOSITION - NO,,510011,0,0,0,0,
MUSKOGEE,PROPOSITION HILLDALE PUBLIC SCHOOLS,FOR THE PROPOSITION - YES,,510013,0,5,37,42,
MUSKOGEE,PROPOSITION HILLDALE PUBLIC SCHOOLS,AGAINST THE PROPOSITION - NO,,510013,0,3,19,22,
MUSKOGEE,PROPOSITION HILLDALE PUBLIC SCHOOLS,FOR THE PROPOSITION - YES,,510046,8,22,246,276,
MUSKOGEE,PROPOSITION HILLDALE PUBLIC SCHOOLS,AGAINST THE PROPOSITION - NO,,510046,5,8,119,132,
MUSKOGEE,PROPOSITION HILLDALE PUBLIC SCHOOLS,FOR THE PROPOSITION - YES,,510047,1,15,76,92,
MUSKOGEE,PROPOSITION HILLDALE PUBLIC SCHOOLS,AGAINST THE PROPOSITION - NO,,510047,0,4,62,66,
MUSKOGEE,PROPOSITION HILLDALE PUBLIC SCHOOLS,FOR THE PROPOSITION - YES,,510055,3,43,269,315,
MUSKOGEE,PROPOSITION HILLDALE PUBLIC SCHOOLS,AGAINST THE PROPOSITION - NO,,510055,2,19,147,168,
MUSKOGEE,PROPOSITION HILLDALE PUBLIC SCHOOLS,FOR THE PROPOSITION - YES,,510061,0,3,10,13,
MUSKOGEE,PROPOSITION HILLDALE PUBLIC SCHOOLS,AGAINST THE PROPOSITION - NO,,510061,0,0,6,6,
OKLAHOMA,PROPOSITION NO. 1 PUTNAM CITY PUBLIC SCHOOLS,FOR THE PROPOSITION - YES,,550001,0,0,20,20,PROPOSITION NO. 1 PUTNAM CITY PUBLIC SCHOOLS
OKLAHOMA,PROPOSITION NO. 1 PUTNAM CITY PUBLIC SCHOOLS,AGAINST THE PROPOSITION - NO,,550001,0,0,2,2,PROPOSITION NO. 1 PUTNAM CITY PUBLIC SCHOOLS
OKLAHOMA,PROPOSITION NO. 2 PUTNAM CITY PUBLIC SCHOOLS,FOR THE PROPOSITION - YES,,550001,0,0,20,20,PROPOSITION NO. 2 PUTNAM CITY PUBLIC SCHOOLS
OKLAHOMA,PROPOSITION NO. 2 PUTNAM CITY PUBLIC SCHOOLS,AGAINST THE PROPOSITION - NO,,550001,0,0,2,2,PROPOSITION NO. 2 PUTNAM CITY PUBLIC SCHOOLS
OKLAHOMA,PROPOSITION NO. 1 PUTNAM CITY PUBLIC SCHOOLS,FOR THE PROPOSITION - YES,,550002,0,0,33,33,PROPOSITION NO. 1 PUTNAM CITY PUBLIC SCHOOLS
OKLAHOMA,PROPOSITION NO. 1 PUTNAM CITY PUBLIC SCHOOLS,AGAINST THE PROPOSITION - NO,,550002,0,0,12,12,PROPOSITION NO. 1 PUTNAM CITY PUBLIC SCHOOLS
OKLAHOMA,PROPOSITION NO. 2 PUTNAM CITY PUBLIC SCHOOLS,FOR THE PROPOSITION - YES,,550002,0,0,33,33,PROPOSITION NO. 2 PUTNAM CITY PUBLIC SCHOOLS
OKLAHOMA,PROPOSITION NO. 2 PUTNAM CITY PUBLIC SCHOOLS,AGAINST THE PROPOSITION - NO,,550002,0,0,12,12,PROPOSITION NO. 2 PUTNAM CITY PUBLIC SCHOOLS
OKLAHOMA,PROPOSITION NO. 1 PUTNAM CITY PUBLIC SCHOOLS,FOR THE PROPOSITION - YES,,550003,0,0,46,46,PROPOSITION NO. 1 PUTNAM CITY PUBLIC SCHOOLS
OKLAHOMA,PROPOSITION NO. 1 PUTNAM CITY PUBLIC SCHOOLS,AGAINST THE PROPOSITION - NO,,550003,0,0,10,10,PROPOSITION NO. 1 PUTNAM CITY PUBLIC SCHOOLS
OKLAHOMA,PROPOSITION NO. 2 PUTNAM CITY PUBLIC SCHOOLS,FOR THE PROPOSITION - YES,,550003,0,0,47,47,PROPOSITION NO. 2 PUTNAM CITY PUBLIC SCHOOLS
OKLAHOMA,PROPOSITION NO. 2 PUTNAM CITY PUBLIC SCHOOLS,AGAINST THE PROPOSITION - NO,,550003,0,0,8,8,PROPOSITION NO. 2 PUTNAM CITY PUBLIC SCHOOLS
OKLAHOMA,PROPOSITION NO. 1 PUTNAM CITY PUBLIC SCHOOLS,FOR THE PROPOSITION - YES,,550004,0,0,55,55,PROPOSITION NO. 1 PUTNAM CITY PUBLIC SCHOOLS
OKLAHOMA,PROPOSITION NO. 1 PUTNAM CITY PUBLIC SCHOOLS,AGAINST THE PROPOSITION - NO,,550004,0,0,21,21,PROPOSITION NO. 1 PUTNAM CITY PUBLIC SCHOOLS
OKLAHOMA,PROPOSITION NO. 2 PUTNAM CITY PUBLIC SCHOOLS,FOR THE PROPOSITION - YES,,550004,0,0,54,54,PROPOSITION NO. 2 PUTNAM CITY PUBLIC SCHOOLS
OKLAHOMA,PROPOSITION NO. 2 PUTNAM CITY PUBLIC SCHOOLS,AGAINST THE PROPOSITION - NO,,550004,0,0,21,21,PROPOSITION NO. 2 PUTNAM CITY PUBLIC SCHOOLS
OKLAHOMA,PROPOSITION NO. 1 PUTNAM CITY PUBLIC SCHOOLS,FOR THE PROPOSITION - YES,,550005,0,0,30,30,PROPOSITION NO. 1 PUTNAM CITY PUBLIC SCHOOLS
OKLAHOMA,PROPOSITION NO. 1 PUTNAM CITY PUBLIC SCHOOLS,AGAINST THE PROPOSITION - NO,,550005,0,0,12,12,PROPOSITION NO. 1 PUTNAM CITY PUBLIC SCHOOLS
OKLAHOMA,PROPOSITION NO. 2 PUTNAM CITY PUBLIC SCHOOLS,FOR THE PROPOSITION - YES,,550005,0,0,31,31,PROPOSITION NO. 2 PUTNAM CITY PUBLIC SCHOOLS
OKLAHOMA,PROPOSITION NO. 2 PUTNAM CITY PUBLIC SCHOOLS,AGAINST THE PROPOSITION - NO,,550005,0,0,11,11,PROPOSITION NO. 2 PUTNAM CITY PUBLIC SCHOOLS
OKLAHOMA,PROPOSITION NO. 1 PUTNAM CITY PUBLIC SCHOOLS,FOR THE PROPOSITION - YES,,550006,0,0,25,25,PROPOSITION NO. 1 PUTNAM CITY PUBLIC SCHOOLS
OKLAHOMA,PROPOSITION NO. 1 PUTNAM CITY PUBLIC SCHOOLS,AGAINST THE PROPOSITION - NO,,550006,0,0,9,9,PROPOSITION NO. 1 PUTNAM CITY PUBLIC SCHOOLS
OKLAHOMA,PROPOSITION NO. 2 PUTNAM CITY PUBLIC SCHOOLS,FOR THE PROPOSITION - YES,,550006,0,0,27,27,PROPOSITION NO. 2 PUTNAM CITY PUBLIC SCHOOLS
OKLAHOMA,PROPOSITION NO. 2 PUTNAM CITY PUBLIC SCHOOLS,AGAINST THE PROPOSITION - NO,,550006,0,0,8,8,PROPOSITION NO. 2 PUTNAM CITY PUBLIC SCHOOLS
OKLAHOMA,PROPOSITION NO. 1 PUTNAM CITY PUBLIC SCHOOLS,FOR THE PROPOSITION - YES,,550007,0,0,48,48,PROPOSITION NO. 1 PUTNAM CITY PUBLIC SCHOOLS
OKLAHOMA,PROPOSITION NO. 1 PUTNAM CITY PUBLIC SCHOOLS,AGAINST THE PROPOSITION - NO,,550007,0,0,14,14,PROPOSITION NO. 1 PUTNAM CITY PUBLIC SCHOOLS
OKLAHOMA,PROPOSITION NO. 2 PUTNAM CITY PUBLIC SCHOOLS,FOR THE PROPOSITION - YES,,550007,0,0,46,46,PROPOSITION NO. 2 PUTNAM CITY PUBLIC SCHOOLS
OKLAHOMA,PROPOSITION NO. 2 PUTNAM CITY PUBLIC SCHOOLS,AGAINST THE PROPOSITION - NO,,550007,0,0,15,15,PROPOSITION NO. 2 PUTNAM CITY PUBLIC SCHOOLS
OKLAHOMA,PROPOSITION NO. 1 PUTNAM CITY PUBLIC SCHOOLS,FOR THE PROPOSITION - YES,,550008,0,0,11,11,PROPOSITION NO. 1 PUTNAM CITY PUBLIC SCHOOLS
OKLAHOMA,PROPOSITION NO. 1 PUTNAM CITY PUBLIC SCHOOLS,AGAINST THE PROPOSITION - NO,,550008,0,0,5,5,PROPOSITION NO. 1 PUTNAM CITY PUBLIC SCHOOLS
OKLAHOMA,PROPOSITION NO. 2 PUTNAM CITY PUBLIC SCHOOLS,FOR THE PROPOSITION - YES,,550008,0,0,10,10,PROPOSITION NO. 2 PUTNAM CITY PUBLIC SCHOOLS
OKLAHOMA,PROPOSITION NO. 2 PUTNAM CITY PUBLIC SCHOOLS,AGAINST THE PROPOSITION - NO,,550008,0,0,6,6,PROPOSITION NO. 2 PUTNAM CITY PUBLIC SCHOOLS
OKLAHOMA,PROPOSITION NO. 1 PUTNAM CITY PUBLIC SCHOOLS,FOR THE PROPOSITION - YES,,550009,0,0,2,2,PROPOSITION NO. 1 PUTNAM CITY PUBLIC SCHOOLS
OKLAHOMA,PROPOSITION NO. 1 PUTNAM CITY PUBLIC SCHOOLS,AGAINST THE PROPOSITION - NO,,550009,0,0,0,0,PROPOSITION NO. 1 PUTNAM CITY PUBLIC SCHOOLS
OKLAHOMA,PROPOSITION NO. 2 PUTNAM CITY PUBLIC SCHOOLS,FOR THE PROPOSITION - YES,,550009,0,0,2,2,PROPOSITION NO. 2 PUTNAM CITY PUBLIC SCHOOLS
OKLAHOMA,PROPOSITION NO. 2 PUTNAM CITY PUBLIC SCHOOLS,AGAINST THE PROPOSITION - NO,,550009,0,0,0,0,PROPOSITION NO. 2 PUTNAM CITY PUBLIC SCHOOLS
OKLAHOMA,PROPOSITION NO. 1 PUTNAM CITY PUBLIC SCHOOLS,FOR THE PROPOSITION - YES,,550010,0,0,5,5,PROPOSITION NO. 1 PUTNAM CITY PUBLIC SCHOOLS
OKLAHOMA,PROPOSITION NO. 1 PUTNAM CITY PUBLIC SCHOOLS,AGAINST THE PROPOSITION - NO,,550010,0,0,4,4,PROPOSITION NO. 1 PUTNAM CITY PUBLIC SCHOOLS
OKLAHOMA,PROPOSITION NO. 2 PUTNAM CITY PUBLIC SCHOOLS,FOR THE PROPOSITION - YES,,550010,0,0,6,6,PROPOSITION NO. 2 PUTNAM CITY PUBLIC SCHOOLS
OKLAHOMA,PROPOSITION NO. 2 PUTNAM CITY PUBLIC SCHOOLS,AGAINST THE PROPOSITION - NO,,550010,0,0,3,3,PROPOSITION NO. 2 PUTNAM CITY PUBLIC SCHOOLS
OKLAHOMA,PROPOSITION NO. 1 PUTNAM CITY PUBLIC SCHOOLS,FOR THE PROPOSITION - YES,,550011,0,0,51,51,PROPOSITION NO. 1 PUTNAM CITY PUBLIC SCHOOLS
OKLAHOMA,PROPOSITION NO. 1 PUTNAM CITY PUBLIC SCHOOLS,AGAINST THE PROPOSITION - NO,,550011,0,0,16,16,PROPOSITION NO. 1 PUTNAM CITY PUBLIC SCHOOLS
OKLAHOMA,PROPOSITION NO. 2 PUTNAM CITY PUBLIC SCHOOLS,FOR THE PROPOSITION - YES,,550011,0,0,50,50,PROPOSITION NO. 2 PUTNAM CITY PUBLIC SCHOOLS
OKLAHOMA,PROPOSITION NO. 2 PUTNAM CITY PUBLIC SCHOOLS,AGAINST THE PROPOSITION - NO,,550011,0,0,17,17,PROPOSITION NO. 2 PUTNAM CITY PUBLIC SCHOOLS
OKLAHOMA,PROPOSITION NO. 1 PUTNAM CITY PUBLIC SCHOOLS,FOR THE PROPOSITION - YES,,550012,0,0,65,65,PROPOSITION NO. 1 PUTNAM CITY PUBLIC SCHOOLS
OKLAHOMA,PROPOSITION NO. 1 PUTNAM CITY PUBLIC SCHOOLS,AGAINST THE PROPOSITION - NO,,550012,0,0,9,9,PROPOSITION NO. 1 PUTNAM CITY PUBLIC SCHOOLS
OKLAHOMA,PROPOSITION NO. 2 PUTNAM CITY PUBLIC SCHOOLS,FOR THE PROPOSITION - YES,,550012,0,0,65,65,PROPOSITION NO. 2 PUTNAM CITY PUBLIC SCHOOLS
OKLAHOMA,PROPOSITION NO. 2 PUTNAM CITY PUBLIC SCHOOLS,AGAINST THE PROPOSITION - NO,,550012,0,0,9,9,PROPOSITION NO. 2 PUTNAM CITY PUBLIC SCHOOLS
OKLAHOMA,PROPOSITION NO. 1 PUTNAM CITY PUBLIC SCHOOLS,FOR THE PROPOSITION - YES,,550013,0,0,34,34,PROPOSITION NO. 1 PUTNAM CITY PUBLIC SCHOOLS
OKLAHOMA,PROPOSITION NO. 1 PUTNAM CITY PUBLIC SCHOOLS,AGAINST THE PROPOSITION - NO,,550013,0,0,10,10,PROPOSITION NO. 1 PUTNAM CITY PUBLIC SCHOOLS
OKLAHOMA,PROPOSITION NO. 2 PUTNAM CITY PUBLIC SCHOOLS,FOR THE PROPOSITION - YES,,550013,0,0,34,34,PROPOSITION NO. 2 PUTNAM CITY PUBLIC SCHOOLS
OKLAHOMA,PROPOSITION NO. 2 PUTNAM CITY PUBLIC SCHOOLS,AGAINST THE PROPOSITION - NO,,550013,0,0,10,10,PROPOSITION NO. 2 PUTNAM CITY PUBLIC SCHOOLS
OKLAHOMA,PROPOSITION NO. 1 PUTNAM CITY PUBLIC SCHOOLS,FOR THE PROPOSITION - YES,,550014,0,0,32,32,PROPOSITION NO. 1 PUTNAM CITY PUBLIC SCHOOLS
OKLAHOMA,PROPOSITION NO. 1 PUTNAM CITY PUBLIC SCHOOLS,AGAINST THE PROPOSITION - NO,,550014,0,0,11,11,PROPOSITION NO. 1 PUTNAM CITY PUBLIC SCHOOLS
OKLAHOMA,PROPOSITION NO. 2 PUTNAM CITY PUBLIC SCHOOLS,FOR THE PROPOSITION - YES,,550014,0,0,30,30,PROPOSITION NO. 2 PUTNAM CITY PUBLIC SCHOOLS
OKLAHOMA,PROPOSITION NO. 2 PUTNAM CITY PUBLIC SCHOOLS,AGAINST THE PROPOSITION - NO,,550014,0,0,14,14,PROPOSITION NO. 2 PUTNAM CITY PUBLIC SCHOOLS
OKLAHOMA,PROPOSITION NO. 1 PUTNAM CITY PUBLIC SCHOOLS,FOR THE PROPOSITION - YES,,550015,0,0,62,62,PROPOSITION NO. 1 PUTNAM CITY PUBLIC SCHOOLS
OKLAHOMA,PROPOSITION NO. 1 PUTNAM CITY PUBLIC SCHOOLS,AGAINST THE PROPOSITION - NO,,550015,0,0,11,11,PROPOSITION NO. 1 PUTNAM CITY PUBLIC SCHOOLS
OKLAHOMA,PROPOSITION NO. 2 PUTNAM CITY PUBLIC SCHOOLS,FOR THE PROPOSITION - YES,,550015,0,0,63,63,PROPOSITION NO. 2 PUTNAM CITY PUBLIC SCHOOLS
OKLAHOMA,PROPOSITION NO. 2 PUTNAM CITY PUBLIC SCHOOLS,AGAINST THE PROPOSITION - NO,,550015,0,0,10,10,PROPOSITION NO. 2 PUTNAM CITY PUBLIC SCHOOLS
OKLAHOMA,PROPOSITION NO. 1 PUTNAM CITY PUBLIC SCHOOLS,FOR THE PROPOSITION - YES,,550016,0,0,11,11,PROPOSITION NO. 1 PUTNAM CITY PUBLIC SCHOOLS
OKLAHOMA,PROPOSITION NO. 1 PUTNAM CITY PUBLIC SCHOOLS,AGAINST THE PROPOSITION - NO,,550016,0,0,2,2,PROPOSITION NO. 1 PUTNAM CITY PUBLIC SCHOOLS
OKLAHOMA,PROPOSITION NO. 2 PUTNAM CITY PUBLIC SCHOOLS,FOR THE PROPOSITION - YES,,550016,0,0,11,11,PROPOSITION NO. 2 PUTNAM CITY PUBLIC SCHOOLS
OKLAHOMA,PROPOSITION NO. 2 PUTNAM CITY PUBLIC SCHOOLS,AGAINST THE PROPOSITION - NO,,550016,0,0,2,2,PROPOSITION NO. 2 PUTNAM CITY PUBLIC SCHOOLS
OKLAHOMA,PROPOSITION NO. 1 PUTNAM CITY PUBLIC SCHOOLS,FOR THE PROPOSITION - YES,,550017,0,0,0,0,PROPOSITION NO. 1 PUTNAM CITY PUBLIC SCHOOLS
OKLAHOMA,PROPOSITION NO. 1 PUTNAM CITY PUBLIC SCHOOLS,AGAINST THE PROPOSITION - NO,,550017,0,0,0,0,PROPOSITION NO. 1 PUTNAM CITY PUBLIC SCHOOLS
OKLAHOMA,PROPOSITION NO. 2 PUTNAM CITY PUBLIC SCHOOLS,FOR THE PROPOSITION - YES,,550017,0,0,0,0,PROPOSITION NO. 2 PUTNAM CITY PUBLIC SCHOOLS
OKLAHOMA,PROPOSITION NO. 2 PUTNAM CITY PUBLIC SCHOOLS,AGAINST THE PROPOSITION - NO,,550017,0,0,0,0,PROPOSITION NO. 2 PUTNAM CITY PUBLIC SCHOOLS
OKLAHOMA,PROPOSITION NO. 1 MIDWEST CITY-DEL CITY PUBLIC SCHOOLS,FOR THE PROPOSITION - YES,,550022,0,0,7,7,PROPOSITION NO. 1 MIDWEST CITY-DEL CITY PUBLIC SCHOOLS
OKLAHOMA,PROPOSITION NO. 1 MIDWEST CITY-DEL CITY PUBLIC SCHOOLS,AGAINST THE PROPOSITION - NO,,550022,0,0,0,0,PROPOSITION NO. 1 MIDWEST CITY-DEL CITY PUBLIC SCHOOLS
OKLAHOMA,PROPOSITION NO. 2 MIDWEST CITY-DEL CITY PUBLIC SCHOOLS,FOR THE PROPOSITION - YES,,550022,0,0,7,7,PROPOSITION NO. 2 MIDWEST CITY-DEL CITY PUBLIC SCHOOLS
OKLAHOMA,PROPOSITION NO. 2 MIDWEST CITY-DEL CITY PUBLIC SCHOOLS,AGAINST THE PROPOSITION - NO,,550022,0,0,0,0,PROPOSITION NO. 2 MIDWEST CITY-DEL CITY PUBLIC SCHOOLS
OKLAHOMA,PROPOSITION NO. 1 MIDWEST CITY-DEL CITY PUBLIC SCHOOLS,FOR THE PROPOSITION - YES,,550028,0,0,20,20,PROPOSITION NO. 1 MIDWEST CITY-DEL CITY PUBLIC SCHOOLS
OKLAHOMA,PROPOSITION NO. 1 MIDWEST CITY-DEL CITY PUBLIC SCHOOLS,AGAINST THE PROPOSITION - NO,,550028,0,0,7,7,PROPOSITION NO. 1 MIDWEST CITY-DEL CITY PUBLIC SCHOOLS
OKLAHOMA,PROPOSITION NO. 2 MIDWEST CITY-DEL CITY PUBLIC SCHOOLS,FOR THE PROPOSITION - YES,,550028,0,0,20,20,PROPOSITION NO. 2 MIDWEST CITY-DEL CITY PUBLIC SCHOOLS
OKLAHOMA,PROPOSITION NO. 2 MIDWEST CITY-DEL CITY PUBLIC SCHOOLS,AGAINST THE PROPOSITION - NO,,550028,0,0,7,7,PROPOSITION NO. 2 MIDWEST CITY-DEL CITY PUBLIC SCHOOLS
OKLAHOMA,PROPOSITION NO. 1 MIDWEST CITY-DEL CITY PUBLIC SCHOOLS,FOR THE PROPOSITION - YES,,550029,0,0,56,56,PROPOSITION NO. 1 MIDWEST CITY-DEL CITY PUBLIC SCHOOLS
OKLAHOMA,PROPOSITION NO. 1 MIDWEST CITY-DEL CITY PUBLIC SCHOOLS,AGAINST THE PROPOSITION - NO,,550029,0,0,20,20,PROPOSITION NO. 1 MIDWEST CITY-DEL CITY PUBLIC SCHOOLS
OKLAHOMA,PROPOSITION NO. 2 MIDWEST CITY-DEL CITY PUBLIC SCHOOLS,FOR THE PROPOSITION - YES,,550029,0,0,56,56,PROPOSITION NO. 2 MIDWEST CITY-DEL CITY PUBLIC SCHOOLS
OKLAHOMA,PROPOSITION NO. 2 MIDWEST CITY-DEL CITY PUBLIC SCHOOLS,AGAINST THE PROPOSITION - NO,,550029,0,0,19,19,PROPOSITION NO. 2 MIDWEST CITY-DEL CITY PUBLIC SCHOOLS
OKLAHOMA,PROPOSITION NO. 1 MIDWEST CITY-DEL CITY PUBLIC SCHOOLS,FOR THE PROPOSITION - YES,,550030,0,0,51,51,PROPOSITION NO. 1 MIDWEST CITY-DEL CITY PUBLIC SCHOOLS
OKLAHOMA,PROPOSITION NO. 1 MIDWEST CITY-DEL CITY PUBLIC SCHOOLS,AGAINST THE PROPOSITION - NO,,550030,0,0,14,14,PROPOSITION NO. 1 MIDWEST CITY-DEL CITY PUBLIC SCHOOLS
OKLAHOMA,PROPOSITION NO. 2 MIDWEST CITY-DEL CITY PUBLIC SCHOOLS,FOR THE PROPOSITION - YES,,550030,0,0,50,50,PROPOSITION NO. 2 MIDWEST CITY-DEL CITY PUBLIC SCHOOLS
OKLAHOMA,PROPOSITION NO. 2 MIDWEST CITY-DEL CITY PUBLIC SCHOOLS,AGAINST THE PROPOSITION - NO,,550030,0,0,16,16,PROPOSITION NO. 2 MIDWEST CITY-DEL CITY PUBLIC SCHOOLS
OKLAHOMA,PROPOSITION NO. 1 MIDWEST CITY-DEL CITY PUBLIC SCHOOLS,FOR THE PROPOSITION - YES,,550031,0,0,58,58,PROPOSITION NO. 1 MIDWEST CITY-DEL CITY PUBLIC SCHOOLS
OKLAHOMA,PROPOSITION NO. 1 MIDWEST CITY-DEL CITY PUBLIC SCHOOLS,AGAINST THE PROPOSITION - NO,,550031,0,0,11,11,PROPOSITION NO. 1 MIDWEST CITY-DEL CITY PUBLIC SCHOOLS
OKLAHOMA,PROPOSITION NO. 2 MIDWEST CITY-DEL CITY PUBLIC SCHOOLS,FOR THE PROPOSITION - YES,,550031,0,0,58,58,PROPOSITION NO. 2 MIDWEST CITY-DEL CITY PUBLIC SCHOOLS
OKLAHOMA,PROPOSITION NO. 2 MIDWEST CITY-DEL CITY PUBLIC SCHOOLS,AGAINST THE PROPOSITION - NO,,550031,0,0,12,12,PROPOSITION NO. 2 MIDWEST CITY-DEL CITY PUBLIC SCHOOLS
OKLAHOMA,PROPOSITION NO. 1 MIDWEST CITY-DEL CITY PUBLIC SCHOOLS,FOR THE PROPOSITION - YES,,550032,0,0,63,63,PROPOSITION NO. 1 MIDWEST CITY-DEL CITY PUBLIC SCHOOLS
OKLAHOMA,PROPOSITION NO. 1 MIDWEST CITY-DEL CITY PUBLIC SCHOOLS,AGAINST THE PROPOSITION - NO,,550032,0,0,20,20,PROPOSITION NO. 1 MIDWEST CITY-DEL CITY PUBLIC SCHOOLS
OKLAHOMA,PROPOSITION NO. 2 MIDWEST CITY-DEL CITY PUBLIC SCHOOLS,FOR THE PROPOSITION - YES,,550032,0,0,61,61,PROPOSITION NO. 2 MIDWEST CITY-DEL CITY PUBLIC SCHOOLS
OKLAHOMA,PROPOSITION NO. 2 MIDWEST CITY-DEL CITY PUBLIC SCHOOLS,AGAINST THE PROPOSITION - NO,,550032,0,0,22,22,PROPOSITION NO. 2 MIDWEST CITY-DEL CITY PUBLIC SCHOOLS
OKLAHOMA,PROPOSITION NO. 1 MIDWEST CITY-DEL CITY PUBLIC SCHOOLS,FOR THE PROPOSITION - YES,,550033,0,0,161,161,PROPOSITION NO. 1 MIDWEST CITY-DEL CITY PUBLIC SCHOOLS
OKLAHOMA,PROPOSITION NO. 1 MIDWEST CITY-DEL CITY PUBLIC SCHOOLS,AGAINST THE PROPOSITION - NO,,550033,0,0,23,23,PROPOSITION NO. 1 MIDWEST CITY-DEL CITY PUBLIC SCHOOLS
OKLAHOMA,PROPOSITION NO. 2 MIDWEST CITY-DEL CITY PUBLIC SCHOOLS,FOR THE PROPOSITION - YES,,550033,0,0,159,159,PROPOSITION NO. 2 MIDWEST CITY-DEL CITY PUBLIC SCHOOLS
OKLAHOMA,PROPOSITION NO. 2 MIDWEST CITY-DEL CITY PUBLIC SCHOOLS,AGAINST THE PROPOSITION - NO,,550033,0,0,25,25,PROPOSITION NO. 2 MIDWEST CITY-DEL CITY PUBLIC SCHOOLS
OKLAHOMA,PROPOSITION NO. 1 MIDWEST CITY-DEL CITY PUBLIC SCHOOLS,FOR THE PROPOSITION - YES,,550066,0,0,62,62,PROPOSITION NO. 1 MIDWEST CITY-DEL CITY PUBLIC SCHOOLS
OKLAHOMA,PROPOSITION NO. 1 MIDWEST CITY-DEL CITY PUBLIC SCHOOLS,AGAINST THE PROPOSITION - NO,,550066,0,0,4,4,PROPOSITION NO. 1 MIDWEST CITY-DEL CITY PUBLIC SCHOOLS
OKLAHOMA,PROPOSITION NO. 2 MIDWEST CITY-DEL CITY PUBLIC SCHOOLS,FOR THE PROPOSITION - YES,,550066,0,0,61,61,PROPOSITION NO. 2 MIDWEST CITY-DEL CITY PUBLIC SCHOOLS
OKLAHOMA,PROPOSITION NO. 2 MIDWEST CITY-DEL CITY PUBLIC SCHOOLS,AGAINST THE PROPOSITION - NO,,550066,0,0,6,6,PROPOSITION NO. 2 MIDWEST CITY-DEL CITY PUBLIC SCHOOLS
OKLAHOMA,PROPOSITION CITY OF MIDWEST CITY,FOR THE PROPOSITION - YES,,550077,0,0,0,0,
OKLAHOMA,PROPOSITION CITY OF MIDWEST CITY,AGAINST THE PROPOSITION - NO,,550077,0,0,0,0,
OKLAHOMA,PROPOSITION NO. 1 MIDWEST CITY-DEL CITY PUBLIC SCHOOLS,FOR THE PROPOSITION - YES,,550077,0,0,0,0,PROPOSITION NO. 1 MIDWEST CITY-DEL CITY PUBLIC SCHOOLS
OKLAHOMA,PROPOSITION NO. 1 MIDWEST CITY-DEL CITY PUBLIC SCHOOLS,AGAINST THE PROPOSITION - NO,,550077,0,0,0,0,PROPOSITION NO. 1 MIDWEST CITY-DEL CITY PUBLIC SCHOOLS
OKLAHOMA,PROPOSITION NO. 2 MIDWEST CITY-DEL CITY PUBLIC SCHOOLS,FOR THE PROPOSITION - YES,,550077,0,0,0,0,PROPOSITION NO. 2 MIDWEST CITY-DEL CITY PUBLIC SCHOOLS
OKLAHOMA,PROPOSITION NO. 2 MIDWEST CITY-DEL CITY PUBLIC SCHOOLS,AGAINST THE PROPOSITION - NO,,550077,0,0,0,0,PROPOSITION NO. 2 MIDWEST CITY-DEL CITY PUBLIC SCHOOLS
OKLAHOMA,PROPOSITION CITY OF MIDWEST CITY,FOR THE PROPOSITION - YES,,550078,0,0,1,1,
OKLAHOMA,PROPOSITION CITY OF MIDWEST CITY,AGAINST THE PROPOSITION - NO,,550078,0,0,3,3,
OKLAHOMA,PROPOSITION CITY OF MIDWEST CITY,FOR THE PROPOSITION - YES,,550079,0,0,25,25,
OKLAHOMA,PROPOSITION CITY OF MIDWEST CITY,AGAINST THE PROPOSITION - NO,,550079,0,0,20,20,
OKLAHOMA,PROPOSITION CITY OF MIDWEST CITY,FOR THE PROPOSITION - YES,,550080,0,0,243,243,
OKLAHOMA,PROPOSITION CITY OF MIDWEST CITY,AGAINST THE PROPOSITION - NO,,550080,0,0,150,150,
OKLAHOMA,PROPOSITION NO. 1 MIDWEST CITY-DEL CITY PUBLIC SCHOOLS,FOR THE PROPOSITION - YES,,550080,0,0,290,290,PROPOSITION NO. 1 MIDWEST CITY-DEL CITY PUBLIC SCHOOLS
OKLAHOMA,PROPOSITION NO. 1 MIDWEST CITY-DEL CITY PUBLIC SCHOOLS,AGAINST THE PROPOSITION - NO,,550080,0,0,99,99,PROPOSITION NO. 1 MIDWEST CITY-DEL CITY PUBLIC SCHOOLS
OKLAHOMA,PROPOSITION NO. 2 MIDWEST CITY-DEL CITY PUBLIC SCHOOLS,FOR THE PROPOSITION - YES,,550080,0,0,272,272,PROPOSITION NO. 2 MIDWEST CITY-DEL CITY PUBLIC SCHOOLS
OKLAHOMA,PROPOSITION NO. 2 MIDWEST CITY-DEL CITY PUBLIC SCHOOLS,AGAINST THE PROPOSITION - NO,,550080,0,0,103,103,PROPOSITION NO. 2 MIDWEST CITY-DEL CITY PUBLIC SCHOOLS
OKLAHOMA,PROPOSITION CITY OF MIDWEST CITY,FOR THE PROPOSITION - YES,,550081,0,0,78,78,
OKLAHOMA,PROPOSITION CITY OF MIDWEST CITY,AGAINST THE PROPOSITION - NO,,550081,0,0,83,83,
OKLAHOMA,PROPOSITION NO. 1 MIDWEST CITY-DEL CITY PUBLIC SCHOOLS,FOR THE PROPOSITION - YES,,550081,0,0,103,103,PROPOSITION NO. 1 MIDWEST CITY-DEL CITY PUBLIC SCHOOLS
OKLAHOMA,PROPOSITION NO. 1 MIDWEST CITY-DEL CITY PUBLIC SCHOOLS,AGAINST THE PROPOSITION - NO,,550081,0,0,58,58,PROPOSITION NO. 1 MIDWEST CITY-DEL CITY PUBLIC SCHOOLS
OKLAHOMA,PROPOSITION NO. 2 MIDWEST CITY-DEL CITY PUBLIC SCHOOLS,FOR THE PROPOSITION - YES,,550081,0,0,92,92,PROPOSITION NO. 2 MIDWEST CITY-DEL CITY PUBLIC SCHOOLS
OKLAHOMA,PROPOSITION NO. 2 MIDWEST CITY-DEL CITY PUBLIC SCHOOLS,AGAINST THE PROPOSITION - NO,,550081,0,0,60,60,PROPOSITION NO. 2 MIDWEST CITY-DEL CITY PUBLIC SCHOOLS
OKLAHOMA,PROPOSITION CITY OF MIDWEST CITY,FOR THE PROPOSITION - YES,,550082,0,0,30,30,
OKLAHOMA,PROPOSITION CITY OF MIDWEST CITY,AGAINST THE PROPOSITION - NO,,550082,0,0,25,25,
OKLAHOMA,PROPOSITION NO. 1 MIDWEST CITY-DEL CITY PUBLIC SCHOOLS,FOR THE PROPOSITION - YES,,550082,0,0,37,37,PROPOSITION NO. 1 MIDWEST CITY-DEL CITY PUBLIC SCHOOLS
OKLAHOMA,PROPOSITION NO. 1 MIDWEST CITY-DEL CITY PUBLIC SCHOOLS,AGAINST THE PROPOSITION - NO,,550082,0,0,18,18,PROPOSITION NO. 1 MIDWEST CITY-DEL CITY PUBLIC SCHOOLS
OKLAHOMA,PROPOSITION NO. 2 MIDWEST CITY-DEL CITY PUBLIC SCHOOLS,FOR THE PROPOSITION - YES,,550082,0,0,31,31,PROPOSITION NO. 2 MIDWEST CITY-DEL CITY PUBLIC SCHOOLS
OKLAHOMA,PROPOSITION NO. 2 MIDWEST CITY-DEL CITY PUBLIC SCHOOLS,AGAINST THE PROPOSITION - NO,,550082,0,0,18,18,PROPOSITION NO. 2 MIDWEST CITY-DEL CITY PUBLIC SCHOOLS
OKLAHOMA,PROPOSITION CITY OF MIDWEST CITY,FOR THE PROPOSITION - YES,,550083,0,0,84,84,
OKLAHOMA,PROPOSITION CITY OF MIDWEST CITY,AGAINST THE PROPOSITION - NO,,550083,0,0,83,83,
OKLAHOMA,PROPOSITION NO. 1 MIDWEST CITY-DEL CITY PUBLIC SCHOOLS,FOR THE PROPOSITION - YES,,550083,0,0,115,115,PROPOSITION NO. 1 MIDWEST CITY-DEL CITY PUBLIC SCHOOLS
OKLAHOMA,PROPOSITION NO. 1 MIDWEST CITY-DEL CITY PUBLIC SCHOOLS,AGAINST THE PROPOSITION - NO,,550083,0,0,52,52,PROPOSITION NO. 1 MIDWEST CITY-DEL CITY PUBLIC SCHOOLS
OKLAHOMA,PROPOSITION NO. 2 MIDWEST CITY-DEL CITY PUBLIC SCHOOLS,FOR THE PROPOSITION - YES,,550083,0,0,117,117,PROPOSITION NO. 2 MIDWEST CITY-DEL CITY PUBLIC SCHOOLS
OKLAHOMA,PROPOSITION NO. 2 MIDWEST CITY-DEL CITY PUBLIC SCHOOLS,AGAINST THE PROPOSITION - NO,,550083,0,0,46,46,PROPOSITION NO. 2 MIDWEST CITY-DEL CITY PUBLIC SCHOOLS
OKLAHOMA,PROPOSITION CITY OF MIDWEST CITY,FOR THE PROPOSITION - YES,,550084,0,0,71,71,
OKLAHOMA,PROPOSITION CITY OF MIDWEST CITY,AGAINST THE PROPOSITION - NO,,550084,0,0,51,51,
OKLAHOMA,PROPOSITION NO. 1 MIDWEST CITY-DEL CITY PUBLIC SCHOOLS,FOR THE PROPOSITION - YES,,550084,0,0,89,89,PROPOSITION NO. 1 MIDWEST CITY-DEL CITY PUBLIC SCHOOLS
OKLAHOMA,PROPOSITION NO. 1 MIDWEST CITY-DEL CITY PUBLIC SCHOOLS,AGAINST THE PROPOSITION - NO,,550084,0,0,33,33,PROPOSITION NO. 1 MIDWEST CITY-DEL CITY PUBLIC SCHOOLS
OKLAHOMA,PROPOSITION NO. 2 MIDWEST CITY-DEL CITY PUBLIC SCHOOLS,FOR THE PROPOSITION - YES,,550084,0,0,84,84,PROPOSITION NO. 2 MIDWEST CITY-DEL CITY PUBLIC SCHOOLS
OKLAHOMA,PROPOSITION NO. 2 MIDWEST CITY-DEL CITY PUBLIC SCHOOLS,AGAINST THE PROPOSITION - NO,,550084,0,0,33,33,PROPOSITION NO. 2 MIDWEST CITY-DEL CITY PUBLIC SCHOOLS
OKLAHOMA,PROPOSITION CITY OF MIDWEST CITY,FOR THE PROPOSITION - YES,,550085,0,0,108,108,
OKLAHOMA,PROPOSITION CITY OF MIDWEST CITY,AGAINST THE PROPOSITION - NO,,550085,0,0,93,93,
OKLAHOMA,PROPOSITION NO. 1 MIDWEST CITY-DEL CITY PUBLIC SCHOOLS,FOR THE PROPOSITION - YES,,550085,0,0,148,148,PROPOSITION NO. 1 MIDWEST CITY-DEL CITY PUBLIC SCHOOLS
OKLAHOMA,PROPOSITION NO. 1 MIDWEST CITY-DEL CITY PUBLIC SCHOOLS,AGAINST THE PROPOSITION - NO,,550085,0,0,52,52,PROPOSITION NO. 1 MIDWEST CITY-DEL CITY PUBLIC SCHOOLS
OKLAHOMA,PROPOSITION NO. 2 MIDWEST CITY-DEL CITY PUBLIC SCHOOLS,FOR THE PROPOSITION - YES,,550085,0,0,141,141,PROPOSITION NO. 2 MIDWEST CITY-DEL CITY PUBLIC SCHOOLS
OKLAHOMA,PROPOSITION NO. 2 MIDWEST CITY-DEL CITY PUBLIC SCHOOLS,AGAINST THE PROPOSITION - NO,,550085,0,0,49,49,PROPOSITION NO. 2 MIDWEST CITY-DEL CITY PUBLIC SCHOOLS
OKLAHOMA,PROPOSITION CITY OF MIDWEST CITY,FOR THE PROPOSITION - YES,,550086,0,0,174,174,
OKLAHOMA,PROPOSITION CITY OF MIDWEST CITY,AGAINST THE PROPOSITION - NO,,550086,0,0,165,165,
OKLAHOMA,PROPOSITION NO. 1 MIDWEST CITY-DEL CITY PUBLIC SCHOOLS,FOR THE PROPOSITION - YES,,550086,0,0,225,225,PROPOSITION NO. 1 MIDWEST CITY-DEL CITY PUBLIC SCHOOLS
OKLAHOMA,PROPOSITION NO. 1 MIDWEST CITY-DEL CITY PUBLIC SCHOOLS,AGAINST THE PROPOSITION - NO,,550086,0,0,102,102,PROPOSITION NO. 1 MIDWEST CITY-DEL CITY PUBLIC SCHOOLS
OKLAHOMA,PROPOSITION NO. 2 MIDWEST CITY-DEL CITY PUBLIC SCHOOLS,FOR THE PROPOSITION - YES,,550086,0,0,211,211,PROPOSITION NO. 2 MIDWEST CITY-DEL CITY PUBLIC SCHOOLS
OKLAHOMA,PROPOSITION NO. 2 MIDWEST CITY-DEL CITY PUBLIC SCHOOLS,AGAINST THE PROPOSITION - NO,,550086,0,0,101,101,PROPOSITION NO. 2 MIDWEST CITY-DEL CITY PUBLIC SCHOOLS
OKLAHOMA,PROPOSITION CITY OF MIDWEST CITY,FOR THE PROPOSITION - YES,,550087,0,0,38,38,
OKLAHOMA,PROPOSITION CITY OF MIDWEST CITY,AGAINST THE PROPOSITION - NO,,550087,0,0,51,51,
OKLAHOMA,PROPOSITION NO. 1 MIDWEST CITY-DEL CITY PUBLIC SCHOOLS,FOR THE PROPOSITION - YES,,550087,0,0,43,43,PROPOSITION NO. 1 MIDWEST CITY-DEL CITY PUBLIC SCHOOLS
OKLAHOMA,PROPOSITION NO. 1 MIDWEST CITY-DEL CITY PUBLIC SCHOOLS,AGAINST THE PROPOSITION - NO,,550087,0,0,18,18,PROPOSITION NO. 1 MIDWEST CITY-DEL CITY PUBLIC SCHOOLS
OKLAHOMA,PROPOSITION NO. 2 MIDWEST CITY-DEL CITY PUBLIC SCHOOLS,FOR THE PROPOSITION - YES,,550087,0,0,38,38,PROPOSITION NO. 2 MIDWEST CITY-DEL CITY PUBLIC SCHOOLS
OKLAHOMA,PROPOSITION NO. 2 MIDWEST CITY-DEL CITY PUBLIC SCHOOLS,AGAINST THE PROPOSITION - NO,,550087,0,0,19,19,PROPOSITION NO. 2 MIDWEST CITY-DEL CITY PUBLIC SCHOOLS
OKLAHOMA,PROPOSITION CITY OF MIDWEST CITY,FOR THE PROPOSITION - YES,,550088,0,0,13,13,
OKLAHOMA,PROPOSITION CITY OF MIDWEST CITY,AGAINST THE PROPOSITION - NO,,550088,0,0,29,29,
OKLAHOMA,PROPOSITION NO. 1 MIDWEST CITY-DEL CITY PUBLIC SCHOOLS,FOR THE PROPOSITION - YES,,550088,0,0,19,19,PROPOSITION NO. 1 MIDWEST CITY-DEL CITY PUBLIC SCHOOLS
OKLAHOMA,PROPOSITION NO. 1 MIDWEST CITY-DEL CITY PUBLIC SCHOOLS,AGAINST THE PROPOSITION - NO,,550088,0,0,10,10,PROPOSITION NO. 1 MIDWEST CITY-DEL CITY PUBLIC SCHOOLS
OKLAHOMA,PROPOSITION NO. 2 MIDWEST CITY-DEL CITY PUBLIC SCHOOLS,FOR THE PROPOSITION - YES,,550088,0,0,18,18,PROPOSITION NO. 2 MIDWEST CITY-DEL CITY PUBLIC SCHOOLS
OKLAHOMA,PROPOSITION NO. 2 MIDWEST CITY-DEL CITY PUBLIC SCHOOLS,AGAINST THE PROPOSITION - NO,,550088,0,0,11,11,PROPOSITION NO. 2 MIDWEST CITY-DEL CITY PUBLIC SCHOOLS
OKLAHOMA,PROPOSITION CITY OF MIDWEST CITY,FOR THE PROPOSITION - YES,,550089,0,0,20,20,
OKLAHOMA,PROPOSITION CITY OF MIDWEST CITY,AGAINST THE PROPOSITION - NO,,550089,0,0,38,38,
OKLAHOMA,PROPOSITION CITY OF MIDWEST CITY,FOR THE PROPOSITION - YES,,550090,0,0,6,6,
OKLAHOMA,PROPOSITION CITY OF MIDWEST CITY,AGAINST THE PROPOSITION - NO,,550090,0,0,10,10,
OKLAHOMA,PROPOSITION CITY OF MIDWEST CITY,FOR THE PROPOSITION - YES,,550091,0,0,5,5,
OKLAHOMA,PROPOSITION CITY OF MIDWEST CITY,AGAINST THE PROPOSITION - NO,,550091,0,0,7,7,
OKLAHOMA,PROPOSITION CITY OF MIDWEST CITY,FOR THE PROPOSITION - YES,,550092,0,0,121,121,
OKLAHOMA,PROPOSITION CITY OF MIDWEST CITY,AGAINST THE PROPOSITION - NO,,550092,0,0,124,124,
OKLAHOMA,PROPOSITION NO. 1 MIDWEST CITY-DEL CITY PUBLIC SCHOOLS,FOR THE PROPOSITION - YES,,550092,0,0,87,87,PROPOSITION NO. 1 MIDWEST CITY-DEL CITY PUBLIC SCHOOLS
OKLAHOMA,PROPOSITION NO. 1 MIDWEST CITY-DEL CITY PUBLIC SCHOOLS,AGAINST THE PROPOSITION - NO,,550092,0,0,35,35,PROPOSITION NO. 1 MIDWEST CITY-DEL CITY PUBLIC SCHOOLS
OKLAHOMA,PROPOSITION NO. 2 MIDWEST CITY-DEL CITY PUBLIC SCHOOLS,FOR THE PROPOSITION - YES,,550092,0,0,81,81,PROPOSITION NO. 2 MIDWEST CITY-DEL CITY PUBLIC SCHOOLS
OKLAHOMA,PROPOSITION NO. 2 MIDWEST CITY-DEL CITY PUBLIC SCHOOLS,AGAINST THE PROPOSITION - NO,,550092,0,0,31,31,PROPOSITION NO. 2 MIDWEST CITY-DEL CITY PUBLIC SCHOOLS
OKLAHOMA,PROPOSITION CITY OF MIDWEST CITY,FOR THE PROPOSITION - YES,,550093,0,0,52,52,
OKLAHOMA,PROPOSITION CITY OF MIDWEST CITY,AGAINST THE PROPOSITION - NO,,550093,0,0,78,78,
OKLAHOMA,PROPOSITION CITY OF MIDWEST CITY,FOR THE PROPOSITION - YES,,550094,0,0,136,136,
OKLAHOMA,PROPOSITION CITY OF MIDWEST CITY,AGAINST THE PROPOSITION - NO,,550094,0,0,109,109,
OKLAHOMA,PROPOSITION NO. 1 MIDWEST CITY-DEL CITY PUBLIC SCHOOLS,FOR THE PROPOSITION - YES,,550094,0,0,78,78,PROPOSITION NO. 1 MIDWEST CITY-DEL CITY PUBLIC SCHOOLS
OKLAHOMA,PROPOSITION NO. 1 MIDWEST CITY-DEL CITY PUBLIC SCHOOLS,AGAINST THE PROPOSITION - NO,,550094,0,0,20,20,PROPOSITION NO. 1 MIDWEST CITY-DEL CITY PUBLIC SCHOOLS
OKLAHOMA,PROPOSITION NO. 2 MIDWEST CITY-DEL CITY PUBLIC SCHOOLS,FOR THE PROPOSITION - YES,,550094,0,0,75,75,PROPOSITION NO. 2 MIDWEST CITY-DEL CITY PUBLIC SCHOOLS
OKLAHOMA,PROPOSITION NO. 2 MIDWEST CITY-DEL CITY PUBLIC SCHOOLS,AGAINST THE PROPOSITION - NO,,550094,0,0,19,19,PROPOSITION NO. 2 MIDWEST CITY-DEL CITY PUBLIC SCHOOLS
OKLAHOMA,PROPOSITION CITY OF MIDWEST CITY,FOR THE PROPOSITION - YES,,550095,0,0,152,152,
OKLAHOMA,PROPOSITION CITY OF MIDWEST CITY,AGAINST THE PROPOSITION - NO,,550095,0,0,170,170,
OKLAHOMA,PROPOSITION NO. 1 MIDWEST CITY-DEL CITY PUBLIC SCHOOLS,FOR THE PROPOSITION - YES,,550095,0,0,226,226,PROPOSITION NO. 1 MIDWEST CITY-DEL CITY PUBLIC SCHOOLS
OKLAHOMA,PROPOSITION NO. 1 MIDWEST CITY-DEL CITY PUBLIC SCHOOLS,AGAINST THE PROPOSITION - NO,,550095,0,0,97,97,PROPOSITION NO. 1 MIDWEST CITY-DEL CITY PUBLIC SCHOOLS
OKLAHOMA,PROPOSITION NO. 2 MIDWEST CITY-DEL CITY PUBLIC SCHOOLS,FOR THE PROPOSITION - YES,,550095,0,0,212,212,PROPOSITION NO. 2 MIDWEST CITY-DEL CITY PUBLIC SCHOOLS
OKLAHOMA,PROPOSITION NO. 2 MIDWEST CITY-DEL CITY PUBLIC SCHOOLS,AGAINST THE PROPOSITION - NO,,550095,0,0,91,91,PROPOSITION NO. 2 MIDWEST CITY-DEL CITY PUBLIC SCHOOLS
OKLAHOMA,PROPOSITION CITY OF MIDWEST CITY,FOR THE PROPOSITION - YES,,550096,0,0,160,160,
OKLAHOMA,PROPOSITION CITY OF MIDWEST CITY,AGAINST THE PROPOSITION - NO,,550096,0,0,81,81,
OKLAHOMA,PROPOSITION NO. 1 MIDWEST CITY-DEL CITY PUBLIC SCHOOLS,FOR THE PROPOSITION - YES,,550096,0,0,198,198,PROPOSITION NO. 1 MIDWEST CITY-DEL CITY PUBLIC SCHOOLS
OKLAHOMA,PROPOSITION NO. 1 MIDWEST CITY-DEL CITY PUBLIC SCHOOLS,AGAINST THE PROPOSITION - NO,,550096,0,0,41,41,PROPOSITION NO. 1 MIDWEST CITY-DEL CITY PUBLIC SCHOOLS
OKLAHOMA,PROPOSITION NO. 2 MIDWEST CITY-DEL CITY PUBLIC SCHOOLS,FOR THE PROPOSITION - YES,,550096,0,0,193,193,PROPOSITION NO. 2 MIDWEST CITY-DEL CITY PUBLIC SCHOOLS
OKLAHOMA,PROPOSITION NO. 2 MIDWEST CITY-DEL CITY PUBLIC SCHOOLS,AGAINST THE PROPOSITION - NO,,550096,0,0,41,41,PROPOSITION NO. 2 MIDWEST CITY-DEL CITY PUBLIC SCHOOLS
OKLAHOMA,PROPOSITION CITY OF MIDWEST CITY,FOR THE PROPOSITION - YES,,550097,0,0,117,117,
OKLAHOMA,PROPOSITION CITY OF MIDWEST CITY,AGAINST THE PROPOSITION - NO,,550097,0,0,98,98,
OKLAHOMA,PROPOSITION NO. 1 MIDWEST CITY-DEL CITY PUBLIC SCHOOLS,FOR THE PROPOSITION - YES,,550097,0,0,65,65,PROPOSITION NO. 1 MIDWEST CITY-DEL CITY PUBLIC SCHOOLS
OKLAHOMA,PROPOSITION NO. 1 MIDWEST CITY-DEL CITY PUBLIC SCHOOLS,AGAINST THE PROPOSITION - NO,,550097,0,0,27,27,PROPOSITION NO. 1 MIDWEST CITY-DEL CITY PUBLIC SCHOOLS
OKLAHOMA,PROPOSITION NO. 2 MIDWEST CITY-DEL CITY PUBLIC SCHOOLS,FOR THE PROPOSITION - YES,,550097,0,0,59,59,PROPOSITION NO. 2 MIDWEST CITY-DEL CITY PUBLIC SCHOOLS
OKLAHOMA,PROPOSITION NO. 2 MIDWEST CITY-DEL CITY PUBLIC SCHOOLS,AGAINST THE PROPOSITION - NO,,550097,0,0,29,29,PROPOSITION NO. 2 MIDWEST CITY-DEL CITY PUBLIC SCHOOLS
OKLAHOMA,PROPOSITION CITY OF MIDWEST CITY,FOR THE PROPOSITION - YES,,550098,0,0,129,129,
OKLAHOMA,PROPOSITION CITY OF MIDWEST CITY,AGAINST THE PROPOSITION - NO,,550098,0,0,112,112,
OKLAHOMA,PROPOSITION NO. 1 PUTNAM CITY PUBLIC SCHOOLS,FOR THE PROPOSITION - YES,,550106,0,0,0,0,PROPOSITION NO. 1 PUTNAM CITY PUBLIC SCHOOLS
OKLAHOMA,PROPOSITION NO. 1 PUTNAM CITY PUBLIC SCHOOLS,AGAINST THE PROPOSITION - NO,,550106,0,0,0,0,PROPOSITION NO. 1 PUTNAM CITY PUBLIC SCHOOLS
OKLAHOMA,PROPOSITION NO. 2 PUTNAM CITY PUBLIC SCHOOLS,FOR THE PROPOSITION - YES,,550106,0,0,0,0,PROPOSITION NO. 2 PUTNAM CITY PUBLIC SCHOOLS
OKLAHOMA,PROPOSITION NO. 2 PUTNAM CITY PUBLIC SCHOOLS,AGAINST THE PROPOSITION - NO,,550106,0,0,0,0,PROPOSITION NO. 2 PUTNAM CITY PUBLIC SCHOOLS
OKLAHOMA,PROPOSITION NO. 1 PUTNAM CITY PUBLIC SCHOOLS,FOR THE PROPOSITION - YES,,550141,0,0,17,17,PROPOSITION NO. 1 PUTNAM CITY PUBLIC SCHOOLS
OKLAHOMA,PROPOSITION NO. 1 PUTNAM CITY PUBLIC SCHOOLS,AGAINST THE PROPOSITION - NO,,550141,0,0,6,6,PROPOSITION NO. 1 PUTNAM CITY PUBLIC SCHOOLS
OKLAHOMA,PROPOSITION NO. 2 PUTNAM CITY PUBLIC SCHOOLS,FOR THE PROPOSITION - YES,,550141,0,0,17,17,PROPOSITION NO. 2 PUTNAM CITY PUBLIC SCHOOLS
OKLAHOMA,PROPOSITION NO. 2 PUTNAM CITY PUBLIC SCHOOLS,AGAINST THE PROPOSITION - NO,,550141,0,0,6,6,PROPOSITION NO. 2 PUTNAM CITY PUBLIC SCHOOLS
OKLAHOMA,PROPOSITION NO. 1 PUTNAM CITY PUBLIC SCHOOLS,FOR THE PROPOSITION - YES,,550142,0,0,32,32,PROPOSITION NO. 1 PUTNAM CITY PUBLIC SCHOOLS
OKLAHOMA,PROPOSITION NO. 1 PUTNAM CITY PUBLIC SCHOOLS,AGAINST THE PROPOSITION - NO,,550142,0,0,8,8,PROPOSITION NO. 1 PUTNAM CITY PUBLIC SCHOOLS
OKLAHOMA,PROPOSITION NO. 2 PUTNAM CITY PUBLIC SCHOOLS,FOR THE PROPOSITION - YES,,550142,0,0,31,31,PROPOSITION NO. 2 PUTNAM CITY PUBLIC SCHOOLS
OKLAHOMA,PROPOSITION NO. 2 PUTNAM CITY PUBLIC SCHOOLS,AGAINST THE PROPOSITION - NO,,550142,0,0,9,9,PROPOSITION NO. 2 PUTNAM CITY PUBLIC SCHOOLS
OKLAHOMA,PROPOSITION NO. 1 PUTNAM CITY PUBLIC SCHOOLS,FOR THE PROPOSITION - YES,,550143,0,0,7,7,PROPOSITION NO. 1 PUTNAM CITY PUBLIC SCHOOLS
OKLAHOMA,PROPOSITION NO. 1 PUTNAM CITY PUBLIC SCHOOLS,AGAINST THE PROPOSITION - NO,,550143,0,0,1,1,PROPOSITION NO. 1 PUTNAM CITY PUBLIC SCHOOLS
OKLAHOMA,PROPOSITION NO. 2 PUTNAM CITY PUBLIC SCHOOLS,FOR THE PROPOSITION - YES,,550143,0,0,7,7,PROPOSITION NO. 2 PUTNAM CITY PUBLIC SCHOOLS
OKLAHOMA,PROPOSITION NO. 2 PUTNAM CITY PUBLIC SCHOOLS,AGAINST THE PROPOSITION - NO,,550143,0,0,1,1,PROPOSITION NO. 2 PUTNAM CITY PUBLIC SCHOOLS
OKLAHOMA,PROPOSITION NO. 1 PUTNAM CITY PUBLIC SCHOOLS,FOR THE PROPOSITION - YES,,550148,0,0,59,59,PROPOSITION NO. 1 PUTNAM CITY PUBLIC SCHOOLS
OKLAHOMA,PROPOSITION NO. 1 PUTNAM CITY PUBLIC SCHOOLS,AGAINST THE PROPOSITION - NO,,550148,0,0,2,2,PROPOSITION NO. 1 PUTNAM CITY PUBLIC SCHOOLS
OKLAHOMA,PROPOSITION NO. 2 PUTNAM CITY PUBLIC SCHOOLS,FOR THE PROPOSITION - YES,,550148,0,0,59,59,PROPOSITION NO. 2 PUTNAM CITY PUBLIC SCHOOLS
OKLAHOMA,PROPOSITION NO. 2 PUTNAM CITY PUBLIC SCHOOLS,AGAINST THE PROPOSITION - NO,,550148,0,0,2,2,PROPOSITION NO. 2 PUTNAM CITY PUBLIC SCHOOLS
OKLAHOMA,PROPOSITION NO. 1 PUTNAM CITY PUBLIC SCHOOLS,FOR THE PROPOSITION - YES,,550149,0,0,83,83,PROPOSITION NO. 1 PUTNAM CITY PUBLIC SCHOOLS
OKLAHOMA,PROPOSITION NO. 1 PUTNAM CITY PUBLIC SCHOOLS,AGAINST THE PROPOSITION - NO,,550149,0,0,8,8,PROPOSITION NO. 1 PUTNAM CITY PUBLIC SCHOOLS
OKLAHOMA,PROPOSITION NO. 2 PUTNAM CITY PUBLIC SCHOOLS,FOR THE PROPOSITION - YES,,550149,0,0,81,81,PROPOSITION NO. 2 PUTNAM CITY PUBLIC SCHOOLS
OKLAHOMA,PROPOSITION NO. 2 PUTNAM CITY PUBLIC SCHOOLS,AGAINST THE PROPOSITION - NO,,550149,0,0,10,10,PROPOSITION NO. 2 PUTNAM CITY PUBLIC SCHOOLS
OKLAHOMA,PROPOSITION NO. 1 PUTNAM CITY PUBLIC SCHOOLS,FOR THE PROPOSITION - YES,,550150,0,0,89,89,PROPOSITION NO. 1 PUTNAM CITY PUBLIC SCHOOLS
OKLAHOMA,PROPOSITION NO. 1 PUTNAM CITY PUBLIC SCHOOLS,AGAINST THE PROPOSITION - NO,,550150,0,0,15,15,PROPOSITION NO. 1 PUTNAM CITY PUBLIC SCHOOLS
OKLAHOMA,PROPOSITION NO. 2 PUTNAM CITY PUBLIC SCHOOLS,FOR THE PROPOSITION - YES,,550150,0,0,91,91,PROPOSITION NO. 2 PUTNAM CITY PUBLIC SCHOOLS
OKLAHOMA,PROPOSITION NO. 2 PUTNAM CITY PUBLIC SCHOOLS,AGAINST THE PROPOSITION - NO,,550150,0,0,13,13,PROPOSITION NO. 2 PUTNAM CITY PUBLIC SCHOOLS
OKLAHOMA,PROPOSITION NO. 1 PUTNAM CITY PUBLIC SCHOOLS,FOR THE PROPOSITION - YES,,550151,0,0,27,27,PROPOSITION NO. 1 PUTNAM CITY PUBLIC SCHOOLS
OKLAHOMA,PROPOSITION NO. 1 PUTNAM CITY PUBLIC SCHOOLS,AGAINST THE PROPOSITION - NO,,550151,0,0,9,9,PROPOSITION NO. 1 PUTNAM CITY PUBLIC SCHOOLS
OKLAHOMA,PROPOSITION NO. 2 PUTNAM CITY PUBLIC SCHOOLS,FOR THE PROPOSITION - YES,,550151,0,0,27,27,PROPOSITION NO. 2 PUTNAM CITY PUBLIC SCHOOLS
OKLAHOMA,PROPOSITION NO. 2 PUTNAM CITY PUBLIC SCHOOLS,AGAINST THE PROPOSITION - NO,,550151,0,0,9,9,PROPOSITION NO. 2 PUTNAM CITY PUBLIC SCHOOLS
OKLAHOMA,PROPOSITION NO. 1 PUTNAM CITY PUBLIC SCHOOLS,FOR THE PROPOSITION - YES,,550152,0,0,56,56,PROPOSITION NO. 1 PUTNAM CITY PUBLIC SCHOOLS
OKLAHOMA,PROPOSITION NO. 1 PUTNAM CITY PUBLIC SCHOOLS,AGAINST THE PROPOSITION - NO,,550152,0,0,4,4,PROPOSITION NO. 1 PUTNAM CITY PUBLIC SCHOOLS
OKLAHOMA,PROPOSITION NO. 2 PUTNAM CITY PUBLIC SCHOOLS,FOR THE PROPOSITION - YES,,550152,0,0,55,55,PROPOSITION NO. 2 PUTNAM CITY PUBLIC SCHOOLS
OKLAHOMA,PROPOSITION NO. 2 PUTNAM CITY PUBLIC SCHOOLS,AGAINST THE PROPOSITION - NO,,550152,0,0,4,4,PROPOSITION NO. 2 PUTNAM CITY PUBLIC SCHOOLS
OKLAHOMA,PROPOSITION NO. 1 PUTNAM CITY PUBLIC SCHOOLS,FOR THE PROPOSITION - YES,,550153,0,0,81,81,PROPOSITION NO. 1 PUTNAM CITY PUBLIC SCHOOLS
OKLAHOMA,PROPOSITION NO. 1 PUTNAM CITY PUBLIC SCHOOLS,AGAINST THE PROPOSITION - NO,,550153,0,0,14,14,PROPOSITION NO. 1 PUTNAM CITY PUBLIC SCHOOLS
OKLAHOMA,PROPOSITION NO. 2 PUTNAM CITY PUBLIC SCHOOLS,FOR THE PROPOSITION - YES,,550153,0,0,80,80,PROPOSITION NO. 2 PUTNAM CITY PUBLIC SCHOOLS
OKLAHOMA,PROPOSITION NO. 2 PUTNAM CITY PUBLIC SCHOOLS,AGAINST THE PROPOSITION - NO,,550153,0,0,15,15,PROPOSITION NO. 2 PUTNAM CITY PUBLIC SCHOOLS
OKLAHOMA,PROPOSITION NO. 1 PUTNAM CITY PUBLIC SCHOOLS,FOR THE PROPOSITION - YES,,550154,0,0,64,64,PROPOSITION NO. 1 PUTNAM CITY PUBLIC SCHOOLS
OKLAHOMA,PROPOSITION NO. 1 PUTNAM CITY PUBLIC SCHOOLS,AGAINST THE PROPOSITION - NO,,550154,0,0,13,13,PROPOSITION NO. 1 PUTNAM CITY PUBLIC SCHOOLS
OKLAHOMA,PROPOSITION NO. 2 PUTNAM CITY PUBLIC SCHOOLS,FOR THE PROPOSITION - YES,,550154,0,0,62,62,PROPOSITION NO. 2 PUTNAM CITY PUBLIC SCHOOLS
OKLAHOMA,PROPOSITION NO. 2 PUTNAM CITY PUBLIC SCHOOLS,AGAINST THE PROPOSITION - NO,,550154,0,0,14,14,PROPOSITION NO. 2 PUTNAM CITY PUBLIC SCHOOLS
OKLAHOMA,PROPOSITION NO. 1 PUTNAM CITY PUBLIC SCHOOLS,FOR THE PROPOSITION - YES,,550155,0,0,26,26,PROPOSITION NO. 1 PUTNAM CITY PUBLIC SCHOOLS
OKLAHOMA,PROPOSITION NO. 1 PUTNAM CITY PUBLIC SCHOOLS,AGAINST THE PROPOSITION - NO,,550155,0,0,4,4,PROPOSITION NO. 1 PUTNAM CITY PUBLIC SCHOOLS
OKLAHOMA,PROPOSITION NO. 2 PUTNAM CITY PUBLIC SCHOOLS,FOR THE PROPOSITION - YES,,550155,0,0,26,26,PROPOSITION NO. 2 PUTNAM CITY PUBLIC SCHOOLS
OKLAHOMA,PROPOSITION NO. 2 PUTNAM CITY PUBLIC SCHOOLS,AGAINST THE PROPOSITION - NO,,550155,0,0,4,4,PROPOSITION NO. 2 PUTNAM CITY PUBLIC SCHOOLS
OKLAHOMA,PROPOSITION NO. 1 PUTNAM CITY PUBLIC SCHOOLS,FOR THE PROPOSITION - YES,,550156,0,0,83,83,PROPOSITION NO. 1 PUTNAM CITY PUBLIC SCHOOLS
OKLAHOMA,PROPOSITION NO. 1 PUTNAM CITY PUBLIC SCHOOLS,AGAINST THE PROPOSITION - NO,,550156,0,0,7,7,PROPOSITION NO. 1 PUTNAM CITY PUBLIC SCHOOLS
OKLAHOMA,PROPOSITION NO. 2 PUTNAM CITY PUBLIC SCHOOLS,FOR THE PROPOSITION - YES,,550156,0,0,81,81,PROPOSITION NO. 2 PUTNAM CITY PUBLIC SCHOOLS
OKLAHOMA,PROPOSITION NO. 2 PUTNAM CITY PUBLIC SCHOOLS,AGAINST THE PROPOSITION - NO,,550156,0,0,9,9,PROPOSITION NO. 2 PUTNAM CITY PUBLIC SCHOOLS
OKLAHOMA,PROPOSITION NO. 1 PUTNAM CITY PUBLIC SCHOOLS,FOR THE PROPOSITION - YES,,550157,0,0,0,0,PROPOSITION NO. 1 PUTNAM CITY PUBLIC SCHOOLS
OKLAHOMA,PROPOSITION NO. 1 PUTNAM CITY PUBLIC SCHOOLS,AGAINST THE PROPOSITION - NO,,550157,0,0,0,0,PROPOSITION NO. 1 PUTNAM CITY PUBLIC SCHOOLS
OKLAHOMA,PROPOSITION NO. 2 PUTNAM CITY PUBLIC SCHOOLS,FOR THE PROPOSITION - YES,,550157,0,0,0,0,PROPOSITION NO. 2 PUTNAM CITY PUBLIC SCHOOLS
OKLAHOMA,PROPOSITION NO. 2 PUTNAM CITY PUBLIC SCHOOLS,AGAINST THE PROPOSITION - NO,,550157,0,0,0,0,PROPOSITION NO. 2 PUTNAM CITY PUBLIC SCHOOLS
OKLAHOMA,PROPOSITION NO. 1 PUTNAM CITY PUBLIC SCHOOLS,FOR THE PROPOSITION - YES,,550158,0,0,47,47,PROPOSITION NO. 1 PUTNAM CITY PUBLIC SCHOOLS
OKLAHOMA,PROPOSITION NO. 1 PUTNAM CITY PUBLIC SCHOOLS,AGAINST THE PROPOSITION - NO,,550158,0,0,8,8,PROPOSITION NO. 1 PUTNAM CITY PUBLIC SCHOOLS
OKLAHOMA,PROPOSITION NO. 2 PUTNAM CITY PUBLIC SCHOOLS,FOR THE PROPOSITION - YES,,550158,0,0,47,47,PROPOSITION NO. 2 PUTNAM CITY PUBLIC SCHOOLS
OKLAHOMA,PROPOSITION NO. 2 PUTNAM CITY PUBLIC SCHOOLS,AGAINST THE PROPOSITION - NO,,550158,0,0,7,7,PROPOSITION NO. 2 PUTNAM CITY PUBLIC SCHOOLS
OKLAHOMA,PROPOSITION NO. 1 PUTNAM CITY PUBLIC SCHOOLS,FOR THE PROPOSITION - YES,,550159,0,0,56,56,PROPOSITION NO. 1 PUTNAM CITY PUBLIC SCHOOLS
OKLAHOMA,PROPOSITION NO. 1 PUTNAM CITY PUBLIC SCHOOLS,AGAINST THE PROPOSITION - NO,,550159,0,0,4,4,PROPOSITION NO. 1 PUTNAM CITY PUBLIC SCHOOLS
OKLAHOMA,PROPOSITION NO. 2 PUTNAM CITY PUBLIC SCHOOLS,FOR THE PROPOSITION - YES,,550159,0,0,56,56,PROPOSITION NO. 2 PUTNAM CITY PUBLIC SCHOOLS
OKLAHOMA,PROPOSITION NO. 2 PUTNAM CITY PUBLIC SCHOOLS,AGAINST THE PROPOSITION - NO,,550159,0,0,4,4,PROPOSITION NO. 2 PUTNAM CITY PUBLIC SCHOOLS
OKLAHOMA,PROPOSITION NO. 1 PUTNAM CITY PUBLIC SCHOOLS,FOR THE PROPOSITION - YES,,550160,0,0,63,63,PROPOSITION NO. 1 PUTNAM CITY PUBLIC SCHOOLS
OKLAHOMA,PROPOSITION NO. 1 PUTNAM CITY PUBLIC SCHOOLS,AGAINST THE PROPOSITION - NO,,550160,0,0,11,11,PROPOSITION NO. 1 PUTNAM CITY PUBLIC SCHOOLS
OKLAHOMA,PROPOSITION NO. 2 PUTNAM CITY PUBLIC SCHOOLS,FOR THE PROPOSITION - YES,,550160,0,0,64,64,PROPOSITION NO. 2 PUTNAM CITY PUBLIC SCHOOLS
OKLAHOMA,PROPOSITION NO. 2 PUTNAM CITY PUBLIC SCHOOLS,AGAINST THE PROPOSITION - NO,,550160,0,0,10,10,PROPOSITION NO. 2 PUTNAM CITY PUBLIC SCHOOLS
OKLAHOMA,PROPOSITION NO. 1 PUTNAM CITY PUBLIC SCHOOLS,FOR THE PROPOSITION - YES,,550161,0,0,21,21,PROPOSITION NO. 1 PUTNAM CITY PUBLIC SCHOOLS
OKLAHOMA,PROPOSITION NO. 1 PUTNAM CITY PUBLIC SCHOOLS,AGAINST THE PROPOSITION - NO,,550161,0,0,5,5,PROPOSITION NO. 1 PUTNAM CITY PUBLIC SCHOOLS
OKLAHOMA,PROPOSITION NO. 2 PUTNAM CITY PUBLIC SCHOOLS,FOR THE PROPOSITION - YES,,550161,0,0,22,22,PROPOSITION NO. 2 PUTNAM CITY PUBLIC SCHOOLS
OKLAHOMA,PROPOSITION NO. 2 PUTNAM CITY PUBLIC SCHOOLS,AGAINST THE PROPOSITION - NO,,550161,0,0,4,4,PROPOSITION NO. 2 PUTNAM CITY PUBLIC SCHOOLS
OKLAHOMA,PROPOSITION NO. 1 PUTNAM CITY PUBLIC SCHOOLS,FOR THE PROPOSITION - YES,,550162,0,0,23,23,PROPOSITION NO. 1 PUTNAM CITY PUBLIC SCHOOLS
OKLAHOMA,PROPOSITION NO. 1 PUTNAM CITY PUBLIC SCHOOLS,AGAINST THE PROPOSITION - NO,,550162,0,0,6,6,PROPOSITION NO. 1 PUTNAM CITY PUBLIC SCHOOLS
OKLAHOMA,PROPOSITION NO. 2 PUTNAM CITY PUBLIC SCHOOLS,FOR THE PROPOSITION - YES,,550162,0,0,23,23,PROPOSITION NO. 2 PUTNAM CITY PUBLIC SCHOOLS
OKLAHOMA,PROPOSITION NO. 2 PUTNAM CITY PUBLIC SCHOOLS,AGAINST THE PROPOSITION - NO,,550162,0,0,6,6,PROPOSITION NO. 2 PUTNAM CITY PUBLIC SCHOOLS
OKLAHOMA,PROPOSITION NO. 1 WESTERN HEIGHTS PUBLIC SCHOOLS,FOR THE PROPOSITION - YES,,550162,0,0,6,6,PROPOSITION NO. 1 WESTERN HEIGHTS PUBLIC SCHOOLS
OKLAHOMA,PROPOSITION NO. 1 WESTERN HEIGHTS PUBLIC SCHOOLS,AGAINST THE PROPOSITION - NO,,550162,0,0,0,0,PROPOSITION NO. 1 WESTERN HEIGHTS PUBLIC SCHOOLS
OKLAHOMA,PROPOSITION NO. 2 WESTERN HEIGHTS PUBLIC SCHOOLS,FOR THE PROPOSITION - YES,,550162,0,0,5,5,PROPOSITION NO. 2 WESTERN HEIGHTS PUBLIC SCHOOLS
OKLAHOMA,PROPOSITION NO. 2 WESTERN HEIGHTS PUBLIC SCHOOLS,AGAINST THE PROPOSITION - NO,,550162,0,0,1,1,PROPOSITION NO. 2 WESTERN HEIGHTS PUBLIC SCHOOLS
OKLAHOMA,PROPOSITION NO. 1 PUTNAM CITY PUBLIC SCHOOLS,FOR THE PROPOSITION - YES,,550163,0,0,4,4,PROPOSITION NO. 1 PUTNAM CITY PUBLIC SCHOOLS
OKLAHOMA,PROPOSITION NO. 1 PUTNAM CITY PUBLIC SCHOOLS,AGAINST THE PROPOSITION - NO,,550163,0,0,2,2,PROPOSITION NO. 1 PUTNAM CITY PUBLIC SCHOOLS
OKLAHOMA,PROPOSITION NO. 2 PUTNAM CITY PUBLIC SCHOOLS,FOR THE PROPOSITION - YES,,550163,0,0,4,4,PROPOSITION NO. 2 PUTNAM CITY PUBLIC SCHOOLS
OKLAHOMA,PROPOSITION NO. 2 PUTNAM CITY PUBLIC SCHOOLS,AGAINST THE PROPOSITION - NO,,550163,0,0,2,2,PROPOSITION NO. 2 PUTNAM CITY PUBLIC SCHOOLS
OKLAHOMA,PROPOSITION NO. 1 WESTERN HEIGHTS PUBLIC SCHOOLS,FOR THE PROPOSITION - YES,,550163,0,0,32,32,PROPOSITION NO. 1 WESTERN HEIGHTS PUBLIC SCHOOLS
OKLAHOMA,PROPOSITION NO. 1 WESTERN HEIGHTS PUBLIC SCHOOLS,AGAINST THE PROPOSITION - NO,,550163,0,0,4,4,PROPOSITION NO. 1 WESTERN HEIGHTS PUBLIC SCHOOLS
OKLAHOMA,PROPOSITION NO. 2 WESTERN HEIGHTS PUBLIC SCHOOLS,FOR THE PROPOSITION - YES,,550163,0,0,32,32,PROPOSITION NO. 2 WESTERN HEIGHTS PUBLIC SCHOOLS
OKLAHOMA,PROPOSITION NO. 2 WESTERN HEIGHTS PUBLIC SCHOOLS,AGAINST THE PROPOSITION - NO,,550163,0,0,4,4,PROPOSITION NO. 2 WESTERN HEIGHTS PUBLIC SCHOOLS
OKLAHOMA,PROPOSITION NO. 1 PUTNAM CITY PUBLIC SCHOOLS,FOR THE PROPOSITION - YES,,550164,0,0,2,2,PROPOSITION NO. 1 PUTNAM CITY PUBLIC SCHOOLS
OKLAHOMA,PROPOSITION NO. 1 PUTNAM CITY PUBLIC SCHOOLS,AGAINST THE PROPOSITION - NO,,550164,0,0,0,0,PROPOSITION NO. 1 PUTNAM CITY PUBLIC SCHOOLS
OKLAHOMA,PROPOSITION NO. 2 PUTNAM CITY PUBLIC SCHOOLS,FOR THE PROPOSITION - YES,,550164,0,0,2,2,PROPOSITION NO. 2 PUTNAM CITY PUBLIC SCHOOLS
OKLAHOMA,PROPOSITION NO. 2 PUTNAM CITY PUBLIC SCHOOLS,AGAINST THE PROPOSITION - NO,,550164,0,0,0,0,PROPOSITION NO. 2 PUTNAM CITY PUBLIC SCHOOLS
OKLAHOMA,PROPOSITION NO. 1 WESTERN HEIGHTS PUBLIC SCHOOLS,FOR THE PROPOSITION - YES,,550164,0,0,14,14,PROPOSITION NO. 1 WESTERN HEIGHTS PUBLIC SCHOOLS
OKLAHOMA,PROPOSITION NO. 1 WESTERN HEIGHTS PUBLIC SCHOOLS,AGAINST THE PROPOSITION - NO,,550164,0,0,3,3,PROPOSITION NO. 1 WESTERN HEIGHTS PUBLIC SCHOOLS
OKLAHOMA,PROPOSITION NO. 2 WESTERN HEIGHTS PUBLIC SCHOOLS,FOR THE PROPOSITION - YES,,550164,0,0,15,15,PROPOSITION NO. 2 WESTERN HEIGHTS PUBLIC SCHOOLS
OKLAHOMA,PROPOSITION NO. 2 WESTERN HEIGHTS PUBLIC SCHOOLS,AGAINST THE PROPOSITION - NO,,550164,0,0,2,2,PROPOSITION NO. 2 WESTERN HEIGHTS PUBLIC SCHOOLS
OKLAHOMA,PROPOSITION NO. 1 WESTERN HEIGHTS PUBLIC SCHOOLS,FOR THE PROPOSITION - YES,,550165,0,0,13,13,PROPOSITION NO. 1 WESTERN HEIGHTS PUBLIC SCHOOLS
OKLAHOMA,PROPOSITION NO. 1 WESTERN HEIGHTS PUBLIC SCHOOLS,AGAINST THE PROPOSITION - NO,,550165,0,0,6,6,PROPOSITION NO. 1 WESTERN HEIGHTS PUBLIC SCHOOLS
OKLAHOMA,PROPOSITION NO. 2 WESTERN HEIGHTS PUBLIC SCHOOLS,FOR THE PROPOSITION - YES,,550165,0,0,13,13,PROPOSITION NO. 2 WESTERN HEIGHTS PUBLIC SCHOOLS
OKLAHOMA,PROPOSITION NO. 2 WESTERN HEIGHTS PUBLIC SCHOOLS,AGAINST THE PROPOSITION - NO,,550165,0,0,6,6,PROPOSITION NO. 2 WESTERN HEIGHTS PUBLIC SCHOOLS
OKLAHOMA,PROPOSITION NO. 1 PUTNAM CITY PUBLIC SCHOOLS,FOR THE PROPOSITION - YES,,550166,0,0,0,0,PROPOSITION NO. 1 PUTNAM CITY PUBLIC SCHOOLS
OKLAHOMA,PROPOSITION NO. 1 PUTNAM CITY PUBLIC SCHOOLS,AGAINST THE PROPOSITION - NO,,550166,0,0,0,0,PROPOSITION NO. 1 PUTNAM CITY PUBLIC SCHOOLS
OKLAHOMA,PROPOSITION NO. 2 PUTNAM CITY PUBLIC SCHOOLS,FOR THE PROPOSITION - YES,,550166,0,0,0,0,PROPOSITION NO. 2 PUTNAM CITY PUBLIC SCHOOLS
OKLAHOMA,PROPOSITION NO. 2 PUTNAM CITY PUBLIC SCHOOLS,AGAINST THE PROPOSITION - NO,,550166,0,0,0,0,PROPOSITION NO. 2 PUTNAM CITY PUBLIC SCHOOLS
OKLAHOMA,PROPOSITION NO. 1 WESTERN HEIGHTS PUBLIC SCHOOLS,FOR THE PROPOSITION - YES,,550166,0,0,9,9,PROPOSITION NO. 1 WESTERN HEIGHTS PUBLIC SCHOOLS
OKLAHOMA,PROPOSITION NO. 1 WESTERN HEIGHTS PUBLIC SCHOOLS,AGAINST THE PROPOSITION - NO,,550166,0,0,5,5,PROPOSITION NO. 1 WESTERN HEIGHTS PUBLIC SCHOOLS
OKLAHOMA,PROPOSITION NO. 2 WESTERN HEIGHTS PUBLIC SCHOOLS,FOR THE PROPOSITION - YES,,550166,0,0,9,9,PROPOSITION NO. 2 WESTERN HEIGHTS PUBLIC SCHOOLS
OKLAHOMA,PROPOSITION NO. 2 WESTERN HEIGHTS PUBLIC SCHOOLS,AGAINST THE PROPOSITION - NO,,550166,0,0,5,5,PROPOSITION NO. 2 WESTERN HEIGHTS PUBLIC SCHOOLS
OKLAHOMA,PROPOSITION NO. 1 PUTNAM CITY PUBLIC SCHOOLS,FOR THE PROPOSITION - YES,,550168,0,0,1,1,PROPOSITION NO. 1 PUTNAM CITY PUBLIC SCHOOLS
OKLAHOMA,PROPOSITION NO. 1 PUTNAM CITY PUBLIC SCHOOLS,AGAINST THE PROPOSITION - NO,,550168,0,0,3,3,PROPOSITION NO. 1 PUTNAM CITY PUBLIC SCHOOLS
OKLAHOMA,PROPOSITION NO. 2 PUTNAM CITY PUBLIC SCHOOLS,FOR THE PROPOSITION - YES,,550168,0,0,2,2,PROPOSITION NO. 2 PUTNAM CITY PUBLIC SCHOOLS
OKLAHOMA,PROPOSITION NO. 2 PUTNAM CITY PUBLIC SCHOOLS,AGAINST THE PROPOSITION - NO,,550168,0,0,2,2,PROPOSITION NO. 2 PUTNAM CITY PUBLIC SCHOOLS
OKLAHOMA,PROPOSITION NO. 1 PUTNAM CITY PUBLIC SCHOOLS,FOR THE PROPOSITION - YES,,550169,0,0,13,13,PROPOSITION NO. 1 PUTNAM CITY PUBLIC SCHOOLS
OKLAHOMA,PROPOSITION NO. 1 PUTNAM CITY PUBLIC SCHOOLS,AGAINST THE PROPOSITION - NO,,550169,0,0,5,5,PROPOSITION NO. 1 PUTNAM CITY PUBLIC SCHOOLS
OKLAHOMA,PROPOSITION NO. 2 PUTNAM CITY PUBLIC SCHOOLS,FOR THE PROPOSITION - YES,,550169,0,0,13,13,PROPOSITION NO. 2 PUTNAM CITY PUBLIC SCHOOLS
OKLAHOMA,PROPOSITION NO. 2 PUTNAM CITY PUBLIC SCHOOLS,AGAINST THE PROPOSITION - NO,,550169,0,0,5,5,PROPOSITION NO. 2 PUTNAM CITY PUBLIC SCHOOLS
OKLAHOMA,PROPOSITION NO. 1 PUTNAM CITY PUBLIC SCHOOLS,FOR THE PROPOSITION - YES,,550172,0,0,7,7,PROPOSITION NO. 1 PUTNAM CITY PUBLIC SCHOOLS
OKLAHOMA,PROPOSITION NO. 1 PUTNAM CITY PUBLIC SCHOOLS,AGAINST THE PROPOSITION - NO,,550172,0,0,0,0,PROPOSITION NO. 1 PUTNAM CITY PUBLIC SCHOOLS
OKLAHOMA,PROPOSITION NO. 2 PUTNAM CITY PUBLIC SCHOOLS,FOR THE PROPOSITION - YES,,550172,0,0,6,6,PROPOSITION NO. 2 PUTNAM CITY PUBLIC SCHOOLS
OKLAHOMA,PROPOSITION NO. 2 PUTNAM CITY PUBLIC SCHOOLS,AGAINST THE PROPOSITION - NO,,550172,0,0,1,1,PROPOSITION NO. 2 PUTNAM CITY PUBLIC SCHOOLS
OKLAHOMA,PROPOSITION NO. 1 PUTNAM CITY PUBLIC SCHOOLS,FOR THE PROPOSITION - YES,,550173,0,0,49,49,PROPOSITION NO. 1 PUTNAM CITY PUBLIC SCHOOLS
OKLAHOMA,PROPOSITION NO. 1 PUTNAM CITY PUBLIC SCHOOLS,AGAINST THE PROPOSITION - NO,,550173,0,0,7,7,PROPOSITION NO. 1 PUTNAM CITY PUBLIC SCHOOLS
OKLAHOMA,PROPOSITION NO. 2 PUTNAM CITY PUBLIC SCHOOLS,FOR THE PROPOSITION - YES,,550173,0,0,48,48,PROPOSITION NO. 2 PUTNAM CITY PUBLIC SCHOOLS
OKLAHOMA,PROPOSITION NO. 2 PUTNAM CITY PUBLIC SCHOOLS,AGAINST THE PROPOSITION - NO,,550173,0,0,8,8,PROPOSITION NO. 2 PUTNAM CITY PUBLIC SCHOOLS
OKLAHOMA,PROPOSITION NO. 1 PUTNAM CITY PUBLIC SCHOOLS,FOR THE PROPOSITION - YES,,550174,0,0,27,27,PROPOSITION NO. 1 PUTNAM CITY PUBLIC SCHOOLS
OKLAHOMA,PROPOSITION NO. 1 PUTNAM CITY PUBLIC SCHOOLS,AGAINST THE PROPOSITION - NO,,550174,0,0,2,2,PROPOSITION NO. 1 PUTNAM CITY PUBLIC SCHOOLS
OKLAHOMA,PROPOSITION NO. 2 PUTNAM CITY PUBLIC SCHOOLS,FOR THE PROPOSITION - YES,,550174,0,0,27,27,PROPOSITION NO. 2 PUTNAM CITY PUBLIC SCHOOLS
OKLAHOMA,PROPOSITION NO. 2 PUTNAM CITY PUBLIC SCHOOLS,AGAINST THE PROPOSITION - NO,,550174,0,0,2,2,PROPOSITION NO. 2 PUTNAM CITY PUBLIC SCHOOLS
OKLAHOMA,PROPOSITION NO. 1 PUTNAM CITY PUBLIC SCHOOLS,FOR THE PROPOSITION - YES,,550175,0,0,17,17,PROPOSITION NO. 1 PUTNAM CITY PUBLIC SCHOOLS
OKLAHOMA,PROPOSITION NO. 1 PUTNAM CITY PUBLIC SCHOOLS,AGAINST THE PROPOSITION - NO,,550175,0,0,1,1,PROPOSITION NO. 1 PUTNAM CITY PUBLIC SCHOOLS
OKLAHOMA,PROPOSITION NO. 2 PUTNAM CITY PUBLIC SCHOOLS,FOR THE PROPOSITION - YES,,550175,0,0,17,17,PROPOSITION NO. 2 PUTNAM CITY PUBLIC SCHOOLS
OKLAHOMA,PROPOSITION NO. 2 PUTNAM CITY PUBLIC SCHOOLS,AGAINST THE PROPOSITION - NO,,550175,0,0,1,1,PROPOSITION NO. 2 PUTNAM CITY PUBLIC SCHOOLS
OKLAHOMA,PROPOSITION NO. 1 PUTNAM CITY PUBLIC SCHOOLS,FOR THE PROPOSITION - YES,,550176,0,0,52,52,PROPOSITION NO. 1 PUTNAM CITY PUBLIC SCHOOLS
OKLAHOMA,PROPOSITION NO. 1 PUTNAM CITY PUBLIC SCHOOLS,AGAINST THE PROPOSITION - NO,,550176,0,0,9,9,PROPOSITION NO. 1 PUTNAM CITY PUBLIC SCHOOLS
OKLAHOMA,PROPOSITION NO. 2 PUTNAM CITY PUBLIC SCHOOLS,FOR THE PROPOSITION - YES,,550176,0,0,51,51,PROPOSITION NO. 2 PUTNAM CITY PUBLIC SCHOOLS
OKLAHOMA,PROPOSITION NO. 2 PUTNAM CITY PUBLIC SCHOOLS,AGAINST THE PROPOSITION - NO,,550176,0,0,11,11,PROPOSITION NO. 2 PUTNAM CITY PUBLIC SCHOOLS
OKLAHOMA,PROPOSITION NO. 1 PUTNAM CITY PUBLIC SCHOOLS,FOR THE PROPOSITION - YES,,550177,0,0,53,53,PROPOSITION NO. 1 PUTNAM CITY PUBLIC SCHOOLS
OKLAHOMA,PROPOSITION NO. 1 PUTNAM CITY PUBLIC SCHOOLS,AGAINST THE PROPOSITION - NO,,550177,0,0,4,4,PROPOSITION NO. 1 PUTNAM CITY PUBLIC SCHOOLS
OKLAHOMA,PROPOSITION NO. 2 PUTNAM CITY PUBLIC SCHOOLS,FOR THE PROPOSITION - YES,,550177,0,0,53,53,PROPOSITION NO. 2 PUTNAM CITY PUBLIC SCHOOLS
OKLAHOMA,PROPOSITION NO. 2 PUTNAM CITY PUBLIC SCHOOLS,AGAINST THE PROPOSITION - NO,,550177,0,0,4,4,PROPOSITION NO. 2 PUTNAM CITY PUBLIC SCHOOLS
OKLAHOMA,PROPOSITION NO. 1 PUTNAM CITY PUBLIC SCHOOLS,FOR THE PROPOSITION - YES,,550178,0,0,49,49,PROPOSITION NO. 1 PUTNAM CITY PUBLIC SCHOOLS
OKLAHOMA,PROPOSITION NO. 1 PUTNAM CITY PUBLIC SCHOOLS,AGAINST THE PROPOSITION - NO,,550178,0,0,6,6,PROPOSITION NO. 1 PUTNAM CITY PUBLIC SCHOOLS
OKLAHOMA,PROPOSITION NO. 2 PUTNAM CITY PUBLIC SCHOOLS,FOR THE PROPOSITION - YES,,550178,0,0,48,48,PROPOSITION NO. 2 PUTNAM CITY PUBLIC SCHOOLS
OKLAHOMA,PROPOSITION NO. 2 PUTNAM CITY PUBLIC SCHOOLS,AGAINST THE PROPOSITION - NO,,550178,0,0,7,7,PROPOSITION NO. 2 PUTNAM CITY PUBLIC SCHOOLS
OKLAHOMA,PROPOSITION NO. 1 PUTNAM CITY PUBLIC SCHOOLS,FOR THE PROPOSITION - YES,,550179,0,0,46,46,PROPOSITION NO. 1 PUTNAM CITY PUBLIC SCHOOLS
OKLAHOMA,PROPOSITION NO. 1 PUTNAM CITY PUBLIC SCHOOLS,AGAINST THE PROPOSITION - NO,,550179,0,0,7,7,PROPOSITION NO. 1 PUTNAM CITY PUBLIC SCHOOLS
OKLAHOMA,PROPOSITION NO. 2 PUTNAM CITY PUBLIC SCHOOLS,FOR THE PROPOSITION - YES,,550179,0,0,46,46,PROPOSITION NO. 2 PUTNAM CITY PUBLIC SCHOOLS
OKLAHOMA,PROPOSITION NO. 2 PUTNAM CITY PUBLIC SCHOOLS,AGAINST THE PROPOSITION - NO,,550179,0,0,7,7,PROPOSITION NO. 2 PUTNAM CITY PUBLIC SCHOOLS
OKLAHOMA,PROPOSITION NO. 1 PUTNAM CITY PUBLIC SCHOOLS,FOR THE PROPOSITION - YES,,550180,0,0,3,3,PROPOSITION NO. 1 PUTNAM CITY PUBLIC SCHOOLS
OKLAHOMA,PROPOSITION NO. 1 PUTNAM CITY PUBLIC SCHOOLS,AGAINST THE PROPOSITION - NO,,550180,0,0,0,0,PROPOSITION NO. 1 PUTNAM CITY PUBLIC SCHOOLS
OKLAHOMA,PROPOSITION NO. 2 PUTNAM CITY PUBLIC SCHOOLS,FOR THE PROPOSITION - YES,,550180,0,0,3,3,PROPOSITION NO. 2 PUTNAM CITY PUBLIC SCHOOLS
OKLAHOMA,PROPOSITION NO. 2 PUTNAM CITY PUBLIC SCHOOLS,AGAINST THE PROPOSITION - NO,,550180,0,0,0,0,PROPOSITION NO. 2 PUTNAM CITY PUBLIC SCHOOLS
OKLAHOMA,PROPOSITION NO. 1 PUTNAM CITY PUBLIC SCHOOLS,FOR THE PROPOSITION - YES,,550181,0,0,13,13,PROPOSITION NO. 1 PUTNAM CITY PUBLIC SCHOOLS
OKLAHOMA,PROPOSITION NO. 1 PUTNAM CITY PUBLIC SCHOOLS,AGAINST THE PROPOSITION - NO,,550181,0,0,4,4,PROPOSITION NO. 1 PUTNAM CITY PUBLIC SCHOOLS
OKLAHOMA,PROPOSITION NO. 2 PUTNAM CITY PUBLIC SCHOOLS,FOR THE PROPOSITION - YES,,550181,0,0,13,13,PROPOSITION NO. 2 PUTNAM CITY PUBLIC SCHOOLS
OKLAHOMA,PROPOSITION NO. 2 PUTNAM CITY PUBLIC SCHOOLS,AGAINST THE PROPOSITION - NO,,550181,0,0,4,4,PROPOSITION NO. 2 PUTNAM CITY PUBLIC SCHOOLS
OKLAHOMA,PROPOSITION NO. 1 PUTNAM CITY PUBLIC SCHOOLS,FOR THE PROPOSITION - YES,,550182,0,0,1,1,PROPOSITION NO. 1 PUTNAM CITY PUBLIC SCHOOLS
OKLAHOMA,PROPOSITION NO. 1 PUTNAM CITY PUBLIC SCHOOLS,AGAINST THE PROPOSITION - NO,,550182,0,0,1,1,PROPOSITION NO. 1 PUTNAM CITY PUBLIC SCHOOLS
OKLAHOMA,PROPOSITION NO. 2 PUTNAM CITY PUBLIC SCHOOLS,FOR THE PROPOSITION - YES,,550182,0,0,1,1,PROPOSITION NO. 2 PUTNAM CITY PUBLIC SCHOOLS
OKLAHOMA,PROPOSITION NO. 2 PUTNAM CITY PUBLIC SCHOOLS,AGAINST THE PROPOSITION - NO,,550182,0,0,1,1,PROPOSITION NO. 2 PUTNAM CITY PUBLIC SCHOOLS
OKLAHOMA,PROPOSITION NO. 1 PUTNAM CITY PUBLIC SCHOOLS,FOR THE PROPOSITION - YES,,550183,0,0,0,0,PROPOSITION NO. 1 PUTNAM CITY PUBLIC SCHOOLS
OKLAHOMA,PROPOSITION NO. 1 PUTNAM CITY PUBLIC SCHOOLS,AGAINST THE PROPOSITION - NO,,550183,0,0,0,0,PROPOSITION NO. 1 PUTNAM CITY PUBLIC SCHOOLS
OKLAHOMA,PROPOSITION NO. 2 PUTNAM CITY PUBLIC SCHOOLS,FOR THE PROPOSITION - YES,,550183,0,0,0,0,PROPOSITION NO. 2 PUTNAM CITY PUBLIC SCHOOLS
OKLAHOMA,PROPOSITION NO. 2 PUTNAM CITY PUBLIC SCHOOLS,AGAINST THE PROPOSITION - NO,,550183,0,0,0,0,PROPOSITION NO. 2 PUTNAM CITY PUBLIC SCHOOLS
OKLAHOMA,PROPOSITION NO. 1 PUTNAM CITY PUBLIC SCHOOLS,FOR THE PROPOSITION - YES,,550184,0,0,2,2,PROPOSITION NO. 1 PUTNAM CITY PUBLIC SCHOOLS
OKLAHOMA,PROPOSITION NO. 1 PUTNAM CITY PUBLIC SCHOOLS,AGAINST THE PROPOSITION - NO,,550184,0,0,0,0,PROPOSITION NO. 1 PUTNAM CITY PUBLIC SCHOOLS
OKLAHOMA,PROPOSITION NO. 2 PUTNAM CITY PUBLIC SCHOOLS,FOR THE PROPOSITION - YES,,550184,0,0,2,2,PROPOSITION NO. 2 PUTNAM CITY PUBLIC SCHOOLS
OKLAHOMA,PROPOSITION NO. 2 PUTNAM CITY PUBLIC SCHOOLS,AGAINST THE PROPOSITION - NO,,550184,0,0,0,0,PROPOSITION NO. 2 PUTNAM CITY PUBLIC SCHOOLS
OKLAHOMA,PROPOSITION NO. 1 PUTNAM CITY PUBLIC SCHOOLS,FOR THE PROPOSITION - YES,,550188,0,0,0,0,PROPOSITION NO. 1 PUTNAM CITY PUBLIC SCHOOLS
OKLAHOMA,PROPOSITION NO. 1 PUTNAM CITY PUBLIC SCHOOLS,AGAINST THE PROPOSITION - NO,,550188,0,0,0,0,PROPOSITION NO. 1 PUTNAM CITY PUBLIC SCHOOLS
OKLAHOMA,PROPOSITION NO. 2 PUTNAM CITY PUBLIC SCHOOLS,FOR THE PROPOSITION - YES,,550188,0,0,0,0,PROPOSITION NO. 2 PUTNAM CITY PUBLIC SCHOOLS
OKLAHOMA,PROPOSITION NO. 2 PUTNAM CITY PUBLIC SCHOOLS,AGAINST THE PROPOSITION - NO,,550188,0,0,0,0,PROPOSITION NO. 2 PUTNAM CITY PUBLIC SCHOOLS
OKLAHOMA,PROPOSITION NO. 1 WESTERN HEIGHTS PUBLIC SCHOOLS,FOR THE PROPOSITION - YES,,550226,0,0,2,2,PROPOSITION NO. 1 WESTERN HEIGHTS PUBLIC SCHOOLS
OKLAHOMA,PROPOSITION NO. 1 WESTERN HEIGHTS PUBLIC SCHOOLS,AGAINST THE PROPOSITION - NO,,550226,0,0,3,3,PROPOSITION NO. 1 WESTERN HEIGHTS PUBLIC SCHOOLS
OKLAHOMA,PROPOSITION NO. 2 WESTERN HEIGHTS PUBLIC SCHOOLS,FOR THE PROPOSITION - YES,,550226,0,0,2,2,PROPOSITION NO. 2 WESTERN HEIGHTS PUBLIC SCHOOLS
OKLAHOMA,PROPOSITION NO. 2 WESTERN HEIGHTS PUBLIC SCHOOLS,AGAINST THE PROPOSITION - NO,,550226,0,0,3,3,PROPOSITION NO. 2 WESTERN HEIGHTS PUBLIC SCHOOLS
OKLAHOMA,PROPOSITION NO. 1 WESTERN HEIGHTS PUBLIC SCHOOLS,FOR THE PROPOSITION - YES,,550227,0,0,19,19,PROPOSITION NO. 1 WESTERN HEIGHTS PUBLIC SCHOOLS
OKLAHOMA,PROPOSITION NO. 1 WESTERN HEIGHTS PUBLIC SCHOOLS,AGAINST THE PROPOSITION - NO,,550227,0,0,1,1,PROPOSITION NO. 1 WESTERN HEIGHTS PUBLIC SCHOOLS
OKLAHOMA,PROPOSITION NO. 2 WESTERN HEIGHTS PUBLIC SCHOOLS,FOR THE PROPOSITION - YES,,550227,0,0,20,20,PROPOSITION NO. 2 WESTERN HEIGHTS PUBLIC SCHOOLS
OKLAHOMA,PROPOSITION NO. 2 WESTERN HEIGHTS PUBLIC SCHOOLS,AGAINST THE PROPOSITION - NO,,550227,0,0,1,1,PROPOSITION NO. 2 WESTERN HEIGHTS PUBLIC SCHOOLS
OKLAHOMA,PROPOSITION NO. 1 WESTERN HEIGHTS PUBLIC SCHOOLS,FOR THE PROPOSITION - YES,,550228,0,0,2,2,PROPOSITION NO. 1 WESTERN HEIGHTS PUBLIC SCHOOLS
OKLAHOMA,PROPOSITION NO. 1 WESTERN HEIGHTS PUBLIC SCHOOLS,AGAINST THE PROPOSITION - NO,,550228,0,0,0,0,PROPOSITION NO. 1 WESTERN HEIGHTS PUBLIC SCHOOLS
OKLAHOMA,PROPOSITION NO. 2 WESTERN HEIGHTS PUBLIC SCHOOLS,FOR THE PROPOSITION - YES,,550228,0,0,2,2,PROPOSITION NO. 2 WESTERN HEIGHTS PUBLIC SCHOOLS
OKLAHOMA,PROPOSITION NO. 2 WESTERN HEIGHTS PUBLIC SCHOOLS,AGAINST THE PROPOSITION - NO,,550228,0,0,0,0,PROPOSITION NO. 2 WESTERN HEIGHTS PUBLIC SCHOOLS
OKLAHOMA,PROPOSITION NO. 1 WESTERN HEIGHTS PUBLIC SCHOOLS,FOR THE PROPOSITION - YES,,550229,0,0,17,17,PROPOSITION NO. 1 WESTERN HEIGHTS PUBLIC SCHOOLS
OKLAHOMA,PROPOSITION NO. 1 WESTERN HEIGHTS PUBLIC SCHOOLS,AGAINST THE PROPOSITION - NO,,550229,0,0,4,4,PROPOSITION NO. 1 WESTERN HEIGHTS PUBLIC SCHOOLS
OKLAHOMA,PROPOSITION NO. 2 WESTERN HEIGHTS PUBLIC SCHOOLS,FOR THE PROPOSITION - YES,,550229,0,0,18,18,PROPOSITION NO. 2 WESTERN HEIGHTS PUBLIC SCHOOLS
OKLAHOMA,PROPOSITION NO. 2 WESTERN HEIGHTS PUBLIC SCHOOLS,AGAINST THE PROPOSITION - NO,,550229,0,0,4,4,PROPOSITION NO. 2 WESTERN HEIGHTS PUBLIC SCHOOLS
OKLAHOMA,PROPOSITION NO. 1 WESTERN HEIGHTS PUBLIC SCHOOLS,FOR THE PROPOSITION - YES,,550230,0,0,0,0,PROPOSITION NO. 1 WESTERN HEIGHTS PUBLIC SCHOOLS
OKLAHOMA,PROPOSITION NO. 1 WESTERN HEIGHTS PUBLIC SCHOOLS,AGAINST THE PROPOSITION - NO,,550230,0,0,0,0,PROPOSITION NO. 1 WESTERN HEIGHTS PUBLIC SCHOOLS
OKLAHOMA,PROPOSITION NO. 2 WESTERN HEIGHTS PUBLIC SCHOOLS,FOR THE PROPOSITION - YES,,550230,0,0,0,0,PROPOSITION NO. 2 WESTERN HEIGHTS PUBLIC SCHOOLS
OKLAHOMA,PROPOSITION NO. 2 WESTERN HEIGHTS PUBLIC SCHOOLS,AGAINST THE PROPOSITION - NO,,550230,0,0,0,0,PROPOSITION NO. 2 WESTERN HEIGHTS PUBLIC SCHOOLS
OKLAHOMA,PROPOSITION NO. 1 MIDWEST CITY-DEL CITY PUBLIC SCHOOLS,FOR THE PROPOSITION - YES,,550243,0,0,0,0,PROPOSITION NO. 1 MIDWEST CITY-DEL CITY PUBLIC SCHOOLS
OKLAHOMA,PROPOSITION NO. 1 MIDWEST CITY-DEL CITY PUBLIC SCHOOLS,AGAINST THE PROPOSITION - NO,,550243,0,0,0,0,PROPOSITION NO. 1 MIDWEST CITY-DEL CITY PUBLIC SCHOOLS
OKLAHOMA,PROPOSITION NO. 2 MIDWEST CITY-DEL CITY PUBLIC SCHOOLS,FOR THE PROPOSITION - YES,,550243,0,0,0,0,PROPOSITION NO. 2 MIDWEST CITY-DEL CITY PUBLIC SCHOOLS
OKLAHOMA,PROPOSITION NO. 2 MIDWEST CITY-DEL CITY PUBLIC SCHOOLS,AGAINST THE PROPOSITION - NO,,550243,0,0,0,0,PROPOSITION NO. 2 MIDWEST CITY-DEL CITY PUBLIC SCHOOLS
OKLAHOMA,PROPOSITION NO. 1 MIDWEST CITY-DEL CITY PUBLIC SCHOOLS,FOR THE PROPOSITION - YES,,550244,0,0,3,3,PROPOSITION NO. 1 MIDWEST CITY-DEL CITY PUBLIC SCHOOLS
OKLAHOMA,PROPOSITION NO. 1 MIDWEST CITY-DEL CITY PUBLIC SCHOOLS,AGAINST THE PROPOSITION - NO,,550244,0,0,3,3,PROPOSITION NO. 1 MIDWEST CITY-DEL CITY PUBLIC SCHOOLS
OKLAHOMA,PROPOSITION NO. 2 MIDWEST CITY-DEL CITY PUBLIC SCHOOLS,FOR THE PROPOSITION - YES,,550244,0,0,3,3,PROPOSITION NO. 2 MIDWEST CITY-DEL CITY PUBLIC SCHOOLS
OKLAHOMA,PROPOSITION NO. 2 MIDWEST CITY-DEL CITY PUBLIC SCHOOLS,AGAINST THE PROPOSITION - NO,,550244,0,0,3,3,PROPOSITION NO. 2 MIDWEST CITY-DEL CITY PUBLIC SCHOOLS
OKLAHOMA,PROPOSITION NO. 1 MIDWEST CITY-DEL CITY PUBLIC SCHOOLS,FOR THE PROPOSITION - YES,,550248,0,0,45,45,PROPOSITION NO. 1 MIDWEST CITY-DEL CITY PUBLIC SCHOOLS
OKLAHOMA,PROPOSITION NO. 1 MIDWEST CITY-DEL CITY PUBLIC SCHOOLS,AGAINST THE PROPOSITION - NO,,550248,0,0,3,3,PROPOSITION NO. 1 MIDWEST CITY-DEL CITY PUBLIC SCHOOLS
OKLAHOMA,PROPOSITION NO. 2 MIDWEST CITY-DEL CITY PUBLIC SCHOOLS,FOR THE PROPOSITION - YES,,550248,0,0,45,45,PROPOSITION NO. 2 MIDWEST CITY-DEL CITY PUBLIC SCHOOLS
OKLAHOMA,PROPOSITION NO. 2 MIDWEST CITY-DEL CITY PUBLIC SCHOOLS,AGAINST THE PROPOSITION - NO,,550248,0,0,3,3,PROPOSITION NO. 2 MIDWEST CITY-DEL CITY PUBLIC SCHOOLS
OKLAHOMA,PROPOSITION NO. 1 MIDWEST CITY-DEL CITY PUBLIC SCHOOLS,FOR THE PROPOSITION - YES,,550249,0,0,95,95,PROPOSITION NO. 1 MIDWEST CITY-DEL CITY PUBLIC SCHOOLS
OKLAHOMA,PROPOSITION NO. 1 MIDWEST CITY-DEL CITY PUBLIC SCHOOLS,AGAINST THE PROPOSITION - NO,,550249,0,0,15,15,PROPOSITION NO. 1 MIDWEST CITY-DEL CITY PUBLIC SCHOOLS
OKLAHOMA,PROPOSITION NO. 2 MIDWEST CITY-DEL CITY PUBLIC SCHOOLS,FOR THE PROPOSITION - YES,,550249,0,0,93,93,PROPOSITION NO. 2 MIDWEST CITY-DEL CITY PUBLIC SCHOOLS
OKLAHOMA,PROPOSITION NO. 2 MIDWEST CITY-DEL CITY PUBLIC SCHOOLS,AGAINST THE PROPOSITION - NO,,550249,0,0,16,16,PROPOSITION NO. 2 MIDWEST CITY-DEL CITY PUBLIC SCHOOLS
OKLAHOMA,PROPOSITION NO. 1 MIDWEST CITY-DEL CITY PUBLIC SCHOOLS,FOR THE PROPOSITION - YES,,550250,0,0,20,20,PROPOSITION NO. 1 MIDWEST CITY-DEL CITY PUBLIC SCHOOLS
OKLAHOMA,PROPOSITION NO. 1 MIDWEST CITY-DEL CITY PUBLIC SCHOOLS,AGAINST THE PROPOSITION - NO,,550250,0,0,1,1,PROPOSITION NO. 1 MIDWEST CITY-DEL CITY PUBLIC SCHOOLS
OKLAHOMA,PROPOSITION NO. 2 MIDWEST CITY-DEL CITY PUBLIC SCHOOLS,FOR THE PROPOSITION - YES,,550250,0,0,20,20,PROPOSITION NO. 2 MIDWEST CITY-DEL CITY PUBLIC SCHOOLS
OKLAHOMA,PROPOSITION NO. 2 MIDWEST CITY-DEL CITY PUBLIC SCHOOLS,AGAINST THE PROPOSITION - NO,,550250,0,0,1,1,PROPOSITION NO. 2 MIDWEST CITY-DEL CITY PUBLIC SCHOOLS
OKLAHOMA,PROPOSITION CITY OF MIDWEST CITY,FOR THE PROPOSITION - YES,,550251,0,0,0,0,
OKLAHOMA,PROPOSITION CITY OF MIDWEST CITY,AGAINST THE PROPOSITION - NO,,550251,0,0,0,0,
OKLAHOMA,PROPOSITION NO. 1 MIDWEST CITY-DEL CITY PUBLIC SCHOOLS,FOR THE PROPOSITION - YES,,550251,0,0,46,46,PROPOSITION NO. 1 MIDWEST CITY-DEL CITY PUBLIC SCHOOLS
OKLAHOMA,PROPOSITION NO. 1 MIDWEST CITY-DEL CITY PUBLIC SCHOOLS,AGAINST THE PROPOSITION - NO,,550251,0,0,5,5,PROPOSITION NO. 1 MIDWEST CITY-DEL CITY PUBLIC SCHOOLS
OKLAHOMA,PROPOSITION NO. 2 MIDWEST CITY-DEL CITY PUBLIC SCHOOLS,FOR THE PROPOSITION - YES,,550251,0,0,43,43,PROPOSITION NO. 2 MIDWEST CITY-DEL CITY PUBLIC SCHOOLS
OKLAHOMA,PROPOSITION NO. 2 MIDWEST CITY-DEL CITY PUBLIC SCHOOLS,AGAINST THE PROPOSITION - NO,,550251,0,0,8,8,PROPOSITION NO. 2 MIDWEST CITY-DEL CITY PUBLIC SCHOOLS
OKLAHOMA,PROPOSITION NO. 1 MIDWEST CITY-DEL CITY PUBLIC SCHOOLS,FOR THE PROPOSITION - YES,,550252,0,0,128,128,PROPOSITION NO. 1 MIDWEST CITY-DEL CITY PUBLIC SCHOOLS
OKLAHOMA,PROPOSITION NO. 1 MIDWEST CITY-DEL CITY PUBLIC SCHOOLS,AGAINST THE PROPOSITION - NO,,550252,0,0,25,25,PROPOSITION NO. 1 MIDWEST CITY-DEL CITY PUBLIC SCHOOLS
OKLAHOMA,PROPOSITION NO. 2 MIDWEST CITY-DEL CITY PUBLIC SCHOOLS,FOR THE PROPOSITION - YES,,550252,0,0,125,125,PROPOSITION NO. 2 MIDWEST CITY-DEL CITY PUBLIC SCHOOLS
OKLAHOMA,PROPOSITION NO. 2 MIDWEST CITY-DEL CITY PUBLIC SCHOOLS,AGAINST THE PROPOSITION - NO,,550252,0,0,27,27,PROPOSITION NO. 2 MIDWEST CITY-DEL CITY PUBLIC SCHOOLS
OKLAHOMA,PROPOSITION NO. 1 MIDWEST CITY-DEL CITY PUBLIC SCHOOLS,FOR THE PROPOSITION - YES,,550253,0,0,26,26,PROPOSITION NO. 1 MIDWEST CITY-DEL CITY PUBLIC SCHOOLS
OKLAHOMA,PROPOSITION NO. 1 MIDWEST CITY-DEL CITY PUBLIC SCHOOLS,AGAINST THE PROPOSITION - NO,,550253,0,0,4,4,PROPOSITION NO. 1 MIDWEST CITY-DEL CITY PUBLIC SCHOOLS
OKLAHOMA,PROPOSITION NO. 2 MIDWEST CITY-DEL CITY PUBLIC SCHOOLS,FOR THE PROPOSITION - YES,,550253,0,0,26,26,PROPOSITION NO. 2 MIDWEST CITY-DEL CITY PUBLIC SCHOOLS
OKLAHOMA,PROPOSITION NO. 2 MIDWEST CITY-DEL CITY PUBLIC SCHOOLS,AGAINST THE PROPOSITION - NO,,550253,0,0,4,4,PROPOSITION NO. 2 MIDWEST CITY-DEL CITY PUBLIC SCHOOLS
OKLAHOMA,PROPOSITION NO. 1 MIDWEST CITY-DEL CITY PUBLIC SCHOOLS,FOR THE PROPOSITION - YES,,550254,0,0,19,19,PROPOSITION NO. 1 MIDWEST CITY-DEL CITY PUBLIC SCHOOLS
OKLAHOMA,PROPOSITION NO. 1 MIDWEST CITY-DEL CITY PUBLIC SCHOOLS,AGAINST THE PROPOSITION - NO,,550254,0,0,4,4,PROPOSITION NO. 1 MIDWEST CITY-DEL CITY PUBLIC SCHOOLS
OKLAHOMA,PROPOSITION NO. 2 MIDWEST CITY-DEL CITY PUBLIC SCHOOLS,FOR THE PROPOSITION - YES,,550254,0,0,17,17,PROPOSITION NO. 2 MIDWEST CITY-DEL CITY PUBLIC SCHOOLS
OKLAHOMA,PROPOSITION NO. 2 MIDWEST CITY-DEL CITY PUBLIC SCHOOLS,AGAINST THE PROPOSITION - NO,,550254,0,0,6,6,PROPOSITION NO. 2 MIDWEST CITY-DEL CITY PUBLIC SCHOOLS
OKLAHOMA,PROPOSITION CITY OF MIDWEST CITY,FOR THE PROPOSITION - YES,,559999,85,6,0,91,
OKLAHOMA,PROPOSITION CITY OF MIDWEST CITY,AGAINST THE PROPOSITION - NO,,559999,64,2,0,66,
OKLAHOMA,PROPOSITION NO. 1 MIDWEST CITY-DEL CITY PUBLIC SCHOOLS,FOR THE PROPOSITION - YES,,559999,115,6,0,121,PROPOSITION NO. 1 MIDWEST CITY-DEL CITY PUBLIC SCHOOLS
OKLAHOMA,PROPOSITION NO. 1 MIDWEST CITY-DEL CITY PUBLIC SCHOOLS,AGAINST THE PROPOSITION - NO,,559999,78,0,0,78,PROPOSITION NO. 1 MIDWEST CITY-DEL CITY PUBLIC SCHOOLS
OKLAHOMA,PROPOSITION NO. 2 MIDWEST CITY-DEL CITY PUBLIC SCHOOLS,FOR THE PROPOSITION - YES,,559999,115,5,0,120,PROPOSITION NO. 2 MIDWEST CITY-DEL CITY PUBLIC SCHOOLS
OKLAHOMA,PROPOSITION NO. 2 MIDWEST CITY-DEL CITY PUBLIC SCHOOLS,AGAINST THE PROPOSITION - NO,,559999,74,0,0,74,PROPOSITION NO. 2 MIDWEST CITY-DEL CITY PUBLIC SCHOOLS
OKLAHOMA,PROPOSITION NO. 1 PUTNAM CITY PUBLIC SCHOOLS,FOR THE PROPOSITION - YES,,559999,172,7,0,179,PROPOSITION NO. 1 PUTNAM CITY PUBLIC SCHOOLS
OKLAHOMA,PROPOSITION NO. 1 PUTNAM CITY PUBLIC SCHOOLS,AGAINST THE PROPOSITION - NO,,559999,122,1,0,123,PROPOSITION NO. 1 PUTNAM CITY PUBLIC SCHOOLS
OKLAHOMA,PROPOSITION NO. 2 PUTNAM CITY PUBLIC SCHOOLS,FOR THE PROPOSITION - YES,,559999,172,7,0,179,PROPOSITION NO. 2 PUTNAM CITY PUBLIC SCHOOLS
OKLAHOMA,PROPOSITION NO. 2 PUTNAM CITY PUBLIC SCHOOLS,AGAINST THE PROPOSITION - NO,,559999,120,1,0,121,PROPOSITION NO. 2 PUTNAM CITY PUBLIC SCHOOLS
OKLAHOMA,PROPOSITION NO. 1 WESTERN HEIGHTS PUBLIC SCHOOLS,FOR THE PROPOSITION - YES,,559999,12,1,0,13,PROPOSITION NO. 1 WESTERN HEIGHTS PUBLIC SCHOOLS
OKLAHOMA,PROPOSITION NO. 1 WESTERN HEIGHTS PUBLIC SCHOOLS,AGAINST THE PROPOSITION - NO,,559999,7,2,0,9,PROPOSITION NO. 1 WESTERN HEIGHTS PUBLIC SCHOOLS
OKLAHOMA,PROPOSITION NO. 2 WESTERN HEIGHTS PUBLIC SCHOOLS,FOR THE PROPOSITION - YES,,559999,12,1,0,13,PROPOSITION NO. 2 WESTERN HEIGHTS PUBLIC SCHOOLS
OKLAHOMA,PROPOSITION NO. 2 WESTERN HEIGHTS PUBLIC SCHOOLS,AGAINST THE PROPOSITION - NO,,559999,7,2,0,9,PROPOSITION NO. 2 WESTERN HEIGHTS PUBLIC SCHOOLS
OSAGE,PROPOSITION SHIDLER PUBLIC SCHOOLS,FOR THE PROPOSITION - YES,,570103,4,0,80,84,
OSAGE,PROPOSITION SHIDLER PUBLIC SCHOOLS,AGAINST THE PROPOSITION - NO,,570103,0,0,45,45,
OSAGE,PROPOSITION SHIDLER PUBLIC SCHOOLS,FOR THE PROPOSITION - YES,,570105,2,0,5,7,
OSAGE,PROPOSITION SHIDLER PUBLIC SCHOOLS,AGAINST THE PROPOSITION - NO,,570105,2,0,0,2,
OSAGE,PROPOSITION SHIDLER PUBLIC SCHOOLS,FOR THE PROPOSITION - YES,,570106,0,0,7,7,
OSAGE,PROPOSITION SHIDLER PUBLIC SCHOOLS,AGAINST THE PROPOSITION - NO,,570106,0,3,13,16,
OSAGE,PROPOSITION OKLA DEPT - CAREER & TECH ED,FOR THE PROPOSITION - YES,,570112,2,0,0,2,
OSAGE,PROPOSITION OKLA DEPT - CAREER & TECH ED,AGAINST THE PROPOSITION - NO,,570112,0,0,0,0,
OSAGE,PROPOSITION SHIDLER PUBLIC SCHOOLS,FOR THE PROPOSITION - YES,,570113,1,0,15,16,
OSAGE,PROPOSITION SHIDLER PUBLIC SCHOOLS,AGAINST THE PROPOSITION - NO,,570113,0,0,11,11,
OSAGE,PROPOSITION OKLA DEPT - CAREER & TECH ED,FOR THE PROPOSITION - YES,,570203,0,0,0,0,
OSAGE,PROPOSITION OKLA DEPT - CAREER & TECH ED,AGAINST THE PROPOSITION - NO,,570203,0,0,0,0,
OSAGE,PROPOSITION SHIDLER PUBLIC SCHOOLS,FOR THE PROPOSITION - YES,,570301,0,0,0,0,
OSAGE,PROPOSITION SHIDLER PUBLIC SCHOOLS,AGAINST THE PROPOSITION - NO,,570301,0,0,0,0,
OSAGE,PROPOSITION OKLA DEPT - CAREER & TECH ED,FOR THE PROPOSITION - YES,,570305,8,0,83,91,
OSAGE,PROPOSITION OKLA DEPT - CAREER & TECH ED,AGAINST THE PROPOSITION - NO,,570305,3,0,13,16,
OSAGE,PROPOSITION OKLA DEPT - CAREER & TECH ED,FOR THE PROPOSITION - YES,,570306,0,0,4,4,
OSAGE,PROPOSITION OKLA DEPT - CAREER & TECH ED,AGAINST THE PROPOSITION - NO,,570306,0,0,0,0,
OSAGE,PROPOSITION OKLA DEPT - CAREER & TECH ED,FOR THE PROPOSITION - YES,,570308,1,0,12,13,
OSAGE,PROPOSITION OKLA DEPT - CAREER & TECH ED,AGAINST THE PROPOSITION - NO,,570308,0,0,8,8,
OTTAWA,PROPOSITION TURKEY FORD PUBLIC SCHOOL,FOR THE PROPOSITION - YES,,580026,1,0,20,21,
OTTAWA,PROPOSITION TURKEY FORD PUBLIC SCHOOL,AGAINST THE PROPOSITION - NO,,580026,1,0,4,5,
PONTOTOC,PROPOSITION ROFF PUBLIC SCHOOLS,FOR THE PROPOSITION - YES,,620055,0,0,50,50,
PONTOTOC,PROPOSITION ROFF PUBLIC SCHOOLS,AGAINST THE PROPOSITION - NO,,620055,2,0,17,19,
PONTOTOC,PROPOSITION ROFF PUBLIC SCHOOLS,FOR THE PROPOSITION - YES,,620058,0,0,1,1,
PONTOTOC,PROPOSITION ROFF PUBLIC SCHOOLS,AGAINST THE PROPOSITION - NO,,620058,0,0,1,1,
PONTOTOC,PROPOSITION ROFF PUBLIC SCHOOLS,FOR THE PROPOSITION - YES,,620063,2,0,160,162,
PONTOTOC,PROPOSITION ROFF PUBLIC SCHOOLS,AGAINST THE PROPOSITION - NO,,620063,0,0,98,98,
PONTOTOC,PROPOSITION ROFF PUBLIC SCHOOLS,FOR THE PROPOSITION - YES,,620067,0,0,1,1,
PONTOTOC,PROPOSITION ROFF PUBLIC SCHOOLS,AGAINST THE PROPOSITION - NO,,620067,0,0,2,2,
POTTAWATOMIE,PROPOSITION NO. 1 MACOMB PUBLIC SCHOOLS,FOR THE PROPOSITION - YES,,630027,0,1,25,26,PROPOSITION NO. 1 MACOMB PUBLIC SCHOOLS
POTTAWATOMIE,PROPOSITION NO. 1 MACOMB PUBLIC SCHOOLS,AGAINST THE PROPOSITION - NO,,630027,0,0,25,25,PROPOSITION NO. 1 MACOMB PUBLIC SCHOOLS
POTTAWATOMIE,PROPOSITION NO. 2 MACOMB PUBLIC SCHOOLS,FOR THE PROPOSITION - YES,,630027,0,1,28,29,PROPOSITION NO. 2 MACOMB PUBLIC SCHOOLS
POTTAWATOMIE,PROPOSITION NO. 2 MACOMB PUBLIC SCHOOLS,AGAINST THE PROPOSITION - NO,,630027,0,0,23,23,PROPOSITION NO. 2 MACOMB PUBLIC SCHOOLS
POTTAWATOMIE,PROPOSITION NO. 1 MACOMB PUBLIC SCHOOLS,FOR THE PROPOSITION - YES,,630029,1,0,3,4,PROPOSITION NO. 1 MACOMB PUBLIC SCHOOLS
POTTAWATOMIE,PROPOSITION NO. 1 MACOMB PUBLIC SCHOOLS,AGAINST THE PROPOSITION - NO,,630029,0,0,6,6,PROPOSITION NO. 1 MACOMB PUBLIC SCHOOLS
POTTAWATOMIE,PROPOSITION NO. 2 MACOMB PUBLIC SCHOOLS,FOR THE PROPOSITION - YES,,630029,1,0,3,4,PROPOSITION NO. 2 MACOMB PUBLIC SCHOOLS
POTTAWATOMIE,PROPOSITION NO. 2 MACOMB PUBLIC SCHOOLS,AGAINST THE PROPOSITION - NO,,630029,0,0,6,6,PROPOSITION NO. 2 MACOMB PUBLIC SCHOOLS
POTTAWATOMIE,PROPOSITION NO. 1 MACOMB PUBLIC SCHOOLS,FOR THE PROPOSITION - YES,,630037,0,0,31,31,PROPOSITION NO. 1 MACOMB PUBLIC SCHOOLS
POTTAWATOMIE,PROPOSITION NO. 1 MACOMB PUBLIC SCHOOLS,AGAINST THE PROPOSITION - NO,,630037,2,0,26,28,PROPOSITION NO. 1 MACOMB PUBLIC SCHOOLS
POTTAWATOMIE,PROPOSITION NO. 2 MACOMB PUBLIC SCHOOLS,FOR THE PROPOSITION - YES,,630037,2,0,30,32,PROPOSITION NO. 2 MACOMB PUBLIC SCHOOLS
POTTAWATOMIE,PROPOSITION NO. 2 MACOMB PUBLIC SCHOOLS,AGAINST THE PROPOSITION - NO,,630037,0,0,28,28,PROPOSITION NO. 2 MACOMB PUBLIC SCHOOLS
POTTAWATOMIE,PROPOSITION NO. 1 MACOMB PUBLIC SCHOOLS,FOR THE PROPOSITION - YES,,630038,2,1,31,34,PROPOSITION NO. 1 MACOMB PUBLIC SCHOOLS
POTTAWATOMIE,PROPOSITION NO. 1 MACOMB PUBLIC SCHOOLS,AGAINST THE PROPOSITION - NO,,630038,2,0,21,23,PROPOSITION NO. 1 MACOMB PUBLIC SCHOOLS
POTTAWATOMIE,PROPOSITION NO. 2 MACOMB PUBLIC SCHOOLS,FOR THE PROPOSITION - YES,,630038,2,1,31,34,PROPOSITION NO. 2 MACOMB PUBLIC SCHOOLS
POTTAWATOMIE,PROPOSITION NO. 2 MACOMB PUBLIC SCHOOLS,AGAINST THE PROPOSITION - NO,,630038,2,0,21,23,PROPOSITION NO. 2 MACOMB PUBLIC SCHOOLS
PUSHMATAHA,PROPOSITION RATTAN PUBLIC SCHOOLS,FOR THE PROPOSITION - YES,,640003,0,0,22,22,
PUSHMATAHA,PROPOSITION RATTAN PUBLIC SCHOOLS,AGAINST THE PROPOSITION - NO,,640003,0,0,8,8,
PUSHMATAHA,PROPOSITION RATTAN PUBLIC SCHOOLS,FOR THE PROPOSITION - YES,,640004,0,0,2,2,
PUSHMATAHA,PROPOSITION RATTAN PUBLIC SCHOOLS,AGAINST THE PROPOSITION - NO,,640004,0,0,0,0,
PUSHMATAHA,PROPOSITION RATTAN PUBLIC SCHOOLS,FOR THE PROPOSITION - YES,,640008,0,0,0,0,
PUSHMATAHA,PROPOSITION RATTAN PUBLIC SCHOOLS,AGAINST THE PROPOSITION - NO,,640008,0,0,0,0,
PUSHMATAHA,PROPOSITION RATTAN PUBLIC SCHOOLS,FOR THE PROPOSITION - YES,,640011,5,8,273,286,
PUSHMATAHA,PROPOSITION RATTAN PUBLIC SCHOOLS,AGAINST THE PROPOSITION - NO,,640011,3,0,152,155,
PUSHMATAHA,PROPOSITION RATTAN PUBLIC SCHOOLS,FOR THE PROPOSITION - YES,,640012,0,0,31,31,
PUSHMATAHA,PROPOSITION RATTAN PUBLIC SCHOOLS,AGAINST THE PROPOSITION - NO,,640012,0,0,44,44,
PUSHMATAHA,PROPOSITION RATTAN PUBLIC SCHOOLS,FOR THE PROPOSITION - YES,,640014,0,0,20,20,
PUSHMATAHA,PROPOSITION RATTAN PUBLIC SCHOOLS,AGAINST THE PROPOSITION - NO,,640014,0,1,42,43,
ROGERS,PROPOSITION NO. 1 OWASSO PUBLIC SCHOOLS,FOR THE PROPOSITION - YES,,660006,3,0,32,35,PROPOSITION NO. 1 OWASSO PUBLIC SCHOOLS
ROGERS,PROPOSITION NO. 1 OWASSO PUBLIC SCHOOLS,AGAINST THE PROPOSITION - NO,,660006,2,1,4,7,PROPOSITION NO. 1 OWASSO PUBLIC SCHOOLS
ROGERS,PROPOSITION NO. 2 OWASSO PUBLIC SCHOOLS,FOR THE PROPOSITION - YES,,660006,3,0,31,34,PROPOSITION NO. 2 OWASSO PUBLIC SCHOOLS
ROGERS,PROPOSITION NO. 2 OWASSO PUBLIC SCHOOLS,AGAINST THE PROPOSITION - NO,,660006,2,1,5,8,PROPOSITION NO. 2 OWASSO PUBLIC SCHOOLS
ROGERS,PROPOSITION NO. 1 OWASSO PUBLIC SCHOOLS,FOR THE PROPOSITION - YES,,660010,0,0,0,0,PROPOSITION NO. 1 OWASSO PUBLIC SCHOOLS
ROGERS,PROPOSITION NO. 1 OWASSO PUBLIC SCHOOLS,AGAINST THE PROPOSITION - NO,,660010,0,0,0,0,PROPOSITION NO. 1 OWASSO PUBLIC SCHOOLS
ROGERS,PROPOSITION NO. 2 OWASSO PUBLIC SCHOOLS,FOR THE PROPOSITION - YES,,660010,0,0,0,0,PROPOSITION NO. 2 OWASSO PUBLIC SCHOOLS
ROGERS,PROPOSITION NO. 2 OWASSO PUBLIC SCHOOLS,AGAINST THE PROPOSITION - NO,,660010,0,0,0,0,PROPOSITION NO. 2 OWASSO PUBLIC SCHOOLS
ROGERS,PROPOSITION NO. 1 OWASSO PUBLIC SCHOOLS,FOR THE PROPOSITION - YES,,660021,2,0,40,42,PROPOSITION NO. 1 OWASSO PUBLIC SCHOOLS
ROGERS,PROPOSITION NO. 1 OWASSO PUBLIC SCHOOLS,AGAINST THE PROPOSITION - NO,,660021,5,0,2,7,PROPOSITION NO. 1 OWASSO PUBLIC SCHOOLS
ROGERS,PROPOSITION NO. 2 OWASSO PUBLIC SCHOOLS,FOR THE PROPOSITION - YES,,660021,2,0,39,41,PROPOSITION NO. 2 OWASSO PUBLIC SCHOOLS
ROGERS,PROPOSITION NO. 2 OWASSO PUBLIC SCHOOLS,AGAINST THE PROPOSITION - NO,,660021,5,0,3,8,PROPOSITION NO. 2 OWASSO PUBLIC SCHOOLS
ROGERS,PROPOSITION NO. 1 OWASSO PUBLIC SCHOOLS,FOR THE PROPOSITION - YES,,660029,0,0,18,18,PROPOSITION NO. 1 OWASSO PUBLIC SCHOOLS
ROGERS,PROPOSITION NO. 1 OWASSO PUBLIC SCHOOLS,AGAINST THE PROPOSITION - NO,,660029,3,0,14,17,PROPOSITION NO. 1 OWASSO PUBLIC SCHOOLS
ROGERS,PROPOSITION NO. 2 OWASSO PUBLIC SCHOOLS,FOR THE PROPOSITION - YES,,660029,0,0,18,18,PROPOSITION NO. 2 OWASSO PUBLIC SCHOOLS
ROGERS,PROPOSITION NO. 2 OWASSO PUBLIC SCHOOLS,AGAINST THE PROPOSITION - NO,,660029,3,0,14,17,PROPOSITION NO. 2 OWASSO PUBLIC SCHOOLS
ROGERS,PROPOSITION NO. 1 OWASSO PUBLIC SCHOOLS,FOR THE PROPOSITION - YES,,660030,4,0,115,119,PROPOSITION NO. 1 OWASSO PUBLIC SCHOOLS
ROGERS,PROPOSITION NO. 1 OWASSO PUBLIC SCHOOLS,AGAINST THE PROPOSITION - NO,,660030,9,0,29,38,PROPOSITION NO. 1 OWASSO PUBLIC SCHOOLS
ROGERS,PROPOSITION NO. 2 OWASSO PUBLIC SCHOOLS,FOR THE PROPOSITION - YES,,660030,4,0,120,124,PROPOSITION NO. 2 OWASSO PUBLIC SCHOOLS
ROGERS,PROPOSITION NO. 2 OWASSO PUBLIC SCHOOLS,AGAINST THE PROPOSITION - NO,,660030,9,0,24,33,PROPOSITION NO. 2 OWASSO PUBLIC SCHOOLS
ROGERS,PROPOSITION NO. 1 OWASSO PUBLIC SCHOOLS,FOR THE PROPOSITION - YES,,660031,6,1,70,77,PROPOSITION NO. 1 OWASSO PUBLIC SCHOOLS
ROGERS,PROPOSITION NO. 1 OWASSO PUBLIC SCHOOLS,AGAINST THE PROPOSITION - NO,,660031,2,3,15,20,PROPOSITION NO. 1 OWASSO PUBLIC SCHOOLS
ROGERS,PROPOSITION NO. 2 OWASSO PUBLIC SCHOOLS,FOR THE PROPOSITION - YES,,660031,6,1,71,78,PROPOSITION NO. 2 OWASSO PUBLIC SCHOOLS
ROGERS,PROPOSITION NO. 2 OWASSO PUBLIC SCHOOLS,AGAINST THE PROPOSITION - NO,,660031,2,3,14,19,PROPOSITION NO. 2 OWASSO PUBLIC SCHOOLS
ROGERS,PROPOSITION NO. 1 OWASSO PUBLIC SCHOOLS,FOR THE PROPOSITION - YES,,660130,10,1,156,167,PROPOSITION NO. 1 OWASSO PUBLIC SCHOOLS
ROGERS,PROPOSITION NO. 1 OWASSO PUBLIC SCHOOLS,AGAINST THE PROPOSITION - NO,,660130,17,2,28,47,PROPOSITION NO. 1 OWASSO PUBLIC SCHOOLS
ROGERS,PROPOSITION NO. 2 OWASSO PUBLIC SCHOOLS,FOR THE PROPOSITION - YES,,660130,10,1,160,171,PROPOSITION NO. 2 OWASSO PUBLIC SCHOOLS
ROGERS,PROPOSITION NO. 2 OWASSO PUBLIC SCHOOLS,AGAINST THE PROPOSITION - NO,,660130,17,2,23,42,PROPOSITION NO. 2 OWASSO PUBLIC SCHOOLS
TEXAS,PROPOSITION GUYMON PUBLIC SCHOOLS,FOR THE PROPOSITION - YES,,700102,0,1,60,61,
TEXAS,PROPOSITION GUYMON PUBLIC SCHOOLS,AGAINST THE PROPOSITION - NO,,700102,0,3,31,34,
TEXAS,PROPOSITION NO. 1 TYRONE PUBLIC SCHOOLS,FOR THE PROPOSITION - YES,,700104,0,0,88,88,PROPOSITION NO. 1 TYRONE PUBLIC SCHOOLS
TEXAS,PROPOSITION NO. 1 TYRONE PUBLIC SCHOOLS,AGAINST THE PROPOSITION - NO,,700104,0,0,4,4,PROPOSITION NO. 1 TYRONE PUBLIC SCHOOLS
TEXAS,PROPOSITION NO. 2 TYRONE PUBLIC SCHOOLS,FOR THE PROPOSITION - YES,,700104,0,0,84,84,PROPOSITION NO. 2 TYRONE PUBLIC SCHOOLS
TEXAS,PROPOSITION NO. 2 TYRONE PUBLIC SCHOOLS,AGAINST THE PROPOSITION - NO,,700104,0,0,8,8,PROPOSITION NO. 2 TYRONE PUBLIC SCHOOLS
TEXAS,PROPOSITION GUYMON PUBLIC SCHOOLS,FOR THE PROPOSITION - YES,,700107,0,0,1,1,
TEXAS,PROPOSITION GUYMON PUBLIC SCHOOLS,AGAINST THE PROPOSITION - NO,,700107,0,0,0,0,
TEXAS,PROPOSITION GUYMON PUBLIC SCHOOLS,FOR THE PROPOSITION - YES,,700201,10,16,178,204,
TEXAS,PROPOSITION GUYMON PUBLIC SCHOOLS,AGAINST THE PROPOSITION - NO,,700201,4,12,83,99,
TEXAS,PROPOSITION GUYMON PUBLIC SCHOOLS,FOR THE PROPOSITION - YES,,700202,1,5,66,72,
TEXAS,PROPOSITION GUYMON PUBLIC SCHOOLS,AGAINST THE PROPOSITION - NO,,700202,2,5,28,35,
TEXAS,PROPOSITION GUYMON PUBLIC SCHOOLS,FOR THE PROPOSITION - YES,,700205,2,34,212,248,
TEXAS,PROPOSITION GUYMON PUBLIC SCHOOLS,AGAINST THE PROPOSITION - NO,,700205,6,2,95,103,
TEXAS,PROPOSITION GUYMON PUBLIC SCHOOLS,FOR THE PROPOSITION - YES,,700302,0,0,2,2,
TEXAS,PROPOSITION GUYMON PUBLIC SCHOOLS,AGAINST THE PROPOSITION - NO,,700302,0,0,1,1,
TEXAS,PROPOSITION GUYMON PUBLIC SCHOOLS,FOR THE PROPOSITION - YES,,700304,0,0,0,0,
TEXAS,PROPOSITION GUYMON PUBLIC SCHOOLS,AGAINST THE PROPOSITION - NO,,700304,0,0,0,0,
TEXAS,PROPOSITION GUYMON PUBLIC SCHOOLS,FOR THE PROPOSITION - YES,,700305,3,25,250,278,
TEXAS,PROPOSITION GUYMON PUBLIC SCHOOLS,AGAINST THE PROPOSITION - NO,,700305,0,1,83,84,
TULSA,PROPOSITION NO. 1 OWASSO PUBLIC SCHOOLS,FOR THE PROPOSITION - YES,,720003,0,0,0,0,PROPOSITION NO. 1 OWASSO PUBLIC SCHOOLS
TULSA,PROPOSITION NO. 1 OWASSO PUBLIC SCHOOLS,AGAINST THE PROPOSITION - NO,,720003,0,0,0,0,PROPOSITION NO. 1 OWASSO PUBLIC SCHOOLS
TULSA,PROPOSITION NO. 2 OWASSO PUBLIC SCHOOLS,FOR THE PROPOSITION - YES,,720003,0,0,0,0,PROPOSITION NO. 2 OWASSO PUBLIC SCHOOLS
TULSA,PROPOSITION NO. 2 OWASSO PUBLIC SCHOOLS,AGAINST THE PROPOSITION - NO,,720003,0,0,0,0,PROPOSITION NO. 2 OWASSO PUBLIC SCHOOLS
TULSA,PROPOSITION NO. 1 OWASSO PUBLIC SCHOOLS,FOR THE PROPOSITION - YES,,720008,0,0,0,0,PROPOSITION NO. 1 OWASSO PUBLIC SCHOOLS
TULSA,PROPOSITION NO. 1 OWASSO PUBLIC SCHOOLS,AGAINST THE PROPOSITION - NO,,720008,0,0,0,0,PROPOSITION NO. 1 OWASSO PUBLIC SCHOOLS
TULSA,PROPOSITION NO. 2 OWASSO PUBLIC SCHOOLS,FOR THE PROPOSITION - YES,,720008,0,0,0,0,PROPOSITION NO. 2 OWASSO PUBLIC SCHOOLS
TULSA,PROPOSITION NO. 2 OWASSO PUBLIC SCHOOLS,AGAINST THE PROPOSITION - NO,,720008,0,0,0,0,PROPOSITION NO. 2 OWASSO PUBLIC SCHOOLS
TULSA,PROPOSITION NO. 1 OWASSO PUBLIC SCHOOLS,FOR THE PROPOSITION - YES,,720021,0,0,1,1,PROPOSITION NO. 1 OWASSO PUBLIC SCHOOLS
TULSA,PROPOSITION NO. 1 OWASSO PUBLIC SCHOOLS,AGAINST THE PROPOSITION - NO,,720021,0,0,4,4,PROPOSITION NO. 1 OWASSO PUBLIC SCHOOLS
TULSA,PROPOSITION NO. 2 OWASSO PUBLIC SCHOOLS,FOR THE PROPOSITION - YES,,720021,0,0,1,1,PROPOSITION NO. 2 OWASSO PUBLIC SCHOOLS
TULSA,PROPOSITION NO. 2 OWASSO PUBLIC SCHOOLS,AGAINST THE PROPOSITION - NO,,720021,0,0,4,4,PROPOSITION NO. 2 OWASSO PUBLIC SCHOOLS
TULSA,PROPOSITION NO. 1 OWASSO PUBLIC SCHOOLS,FOR THE PROPOSITION - YES,,720023,0,0,0,0,PROPOSITION NO. 1 OWASSO PUBLIC SCHOOLS
TULSA,PROPOSITION NO. 1 OWASSO PUBLIC SCHOOLS,AGAINST THE PROPOSITION - NO,,720023,0,0,0,0,PROPOSITION NO. 1 OWASSO PUBLIC SCHOOLS
TULSA,PROPOSITION NO. 2 OWASSO PUBLIC SCHOOLS,FOR THE PROPOSITION - YES,,720023,0,0,0,0,PROPOSITION NO. 2 OWASSO PUBLIC SCHOOLS
TULSA,PROPOSITION NO. 2 OWASSO PUBLIC SCHOOLS,AGAINST THE PROPOSITION - NO,,720023,0,0,0,0,PROPOSITION NO. 2 OWASSO PUBLIC SCHOOLS
TULSA,PROPOSITION NO. 1 OWASSO PUBLIC SCHOOLS,FOR THE PROPOSITION - YES,,720551,0,0,0,0,PROPOSITION NO. 1 OWASSO PUBLIC SCHOOLS
TULSA,PROPOSITION NO. 1 OWASSO PUBLIC SCHOOLS,AGAINST THE PROPOSITION - NO,,720551,0,0,0,0,PROPOSITION NO. 1 OWASSO PUBLIC SCHOOLS
TULSA,PROPOSITION NO. 2 OWASSO PUBLIC SCHOOLS,FOR THE PROPOSITION - YES,,720551,0,0,0,0,PROPOSITION NO. 2 OWASSO PUBLIC SCHOOLS
TULSA,PROPOSITION NO. 2 OWASSO PUBLIC SCHOOLS,AGAINST THE PROPOSITION - NO,,720551,0,0,0,0,PROPOSITION NO. 2 OWASSO PUBLIC SCHOOLS
TULSA,PROPOSITION NO. 1 OWASSO PUBLIC SCHOOLS,FOR THE PROPOSITION - YES,,720552,0,0,5,5,PROPOSITION NO. 1 OWASSO PUBLIC SCHOOLS
TULSA,PROPOSITION NO. 1 OWASSO PUBLIC SCHOOLS,AGAINST THE PROPOSITION - NO,,720552,0,0,0,0,PROPOSITION NO. 1 OWASSO PUBLIC SCHOOLS
TULSA,PROPOSITION NO. 2 OWASSO PUBLIC SCHOOLS,FOR THE PROPOSITION - YES,,720552,0,0,5,5,PROPOSITION NO. 2 OWASSO PUBLIC SCHOOLS
TULSA,PROPOSITION NO. 2 OWASSO PUBLIC SCHOOLS,AGAINST THE PROPOSITION - NO,,720552,0,0,0,0,PROPOSITION NO. 2 OWASSO PUBLIC SCHOOLS
TULSA,PROPOSITION NO. 1 OWASSO PUBLIC SCHOOLS,FOR THE PROPOSITION - YES,,720750,0,0,77,77,PROPOSITION NO. 1 OWASSO PUBLIC SCHOOLS
TULSA,PROPOSITION NO. 1 OWASSO PUBLIC SCHOOLS,AGAINST THE PROPOSITION - NO,,720750,0,0,18,18,PROPOSITION NO. 1 OWASSO PUBLIC SCHOOLS
TULSA,PROPOSITION NO. 2 OWASSO PUBLIC SCHOOLS,FOR THE PROPOSITION - YES,,720750,0,0,79,79,PROPOSITION NO. 2 OWASSO PUBLIC SCHOOLS
TULSA,PROPOSITION NO. 2 OWASSO PUBLIC SCHOOLS,AGAINST THE PROPOSITION - NO,,720750,0,0,16,16,PROPOSITION NO. 2 OWASSO PUBLIC SCHOOLS
TULSA,PROPOSITION NO. 1 OWASSO PUBLIC SCHOOLS,FOR THE PROPOSITION - YES,,720751,0,0,124,124,PROPOSITION NO. 1 OWASSO PUBLIC SCHOOLS
TULSA,PROPOSITION NO. 1 OWASSO PUBLIC SCHOOLS,AGAINST THE PROPOSITION - NO,,720751,0,0,47,47,PROPOSITION NO. 1 OWASSO PUBLIC SCHOOLS
TULSA,PROPOSITION NO. 2 OWASSO PUBLIC SCHOOLS,FOR THE PROPOSITION - YES,,720751,0,0,123,123,PROPOSITION NO. 2 OWASSO PUBLIC SCHOOLS
TULSA,PROPOSITION NO. 2 OWASSO PUBLIC SCHOOLS,AGAINST THE PROPOSITION - NO,,720751,0,0,46,46,PROPOSITION NO. 2 OWASSO PUBLIC SCHOOLS
TULSA,PROPOSITION NO. 1 OWASSO PUBLIC SCHOOLS,FOR THE PROPOSITION - YES,,720752,0,0,42,42,PROPOSITION NO. 1 OWASSO PUBLIC SCHOOLS
TULSA,PROPOSITION NO. 1 OWASSO PUBLIC SCHOOLS,AGAINST THE PROPOSITION - NO,,720752,0,0,14,14,PROPOSITION NO. 1 OWASSO PUBLIC SCHOOLS
TULSA,PROPOSITION NO. 2 OWASSO PUBLIC SCHOOLS,FOR THE PROPOSITION - YES,,720752,0,0,41,41,PROPOSITION NO. 2 OWASSO PUBLIC SCHOOLS
TULSA,PROPOSITION NO. 2 OWASSO PUBLIC SCHOOLS,AGAINST THE PROPOSITION - NO,,720752,0,0,14,14,PROPOSITION NO. 2 OWASSO PUBLIC SCHOOLS
TULSA,PROPOSITION NO. 1 OWASSO PUBLIC SCHOOLS,FOR THE PROPOSITION - YES,,720753,0,0,51,51,PROPOSITION NO. 1 OWASSO PUBLIC SCHOOLS
TULSA,PROPOSITION NO. 1 OWASSO PUBLIC SCHOOLS,AGAINST THE PROPOSITION - NO,,720753,0,0,25,25,PROPOSITION NO. 1 OWASSO PUBLIC SCHOOLS
TULSA,PROPOSITION NO. 2 OWASSO PUBLIC SCHOOLS,FOR THE PROPOSITION - YES,,720753,0,0,56,56,PROPOSITION NO. 2 OWASSO PUBLIC SCHOOLS
TULSA,PROPOSITION NO. 2 OWASSO PUBLIC SCHOOLS,AGAINST THE PROPOSITION - NO,,720753,0,0,20,20,PROPOSITION NO. 2 OWASSO PUBLIC SCHOOLS
TULSA,PROPOSITION NO. 1 OWASSO PUBLIC SCHOOLS,FOR THE PROPOSITION - YES,,720754,0,0,95,95,PROPOSITION NO. 1 OWASSO PUBLIC SCHOOLS
TULSA,PROPOSITION NO. 1 OWASSO PUBLIC SCHOOLS,AGAINST THE PROPOSITION - NO,,720754,0,0,57,57,PROPOSITION NO. 1 OWASSO PUBLIC SCHOOLS
TULSA,PROPOSITION NO. 2 OWASSO PUBLIC SCHOOLS,FOR THE PROPOSITION - YES,,720754,0,0,99,99,PROPOSITION NO. 2 OWASSO PUBLIC SCHOOLS
TULSA,PROPOSITION NO. 2 OWASSO PUBLIC SCHOOLS,AGAINST THE PROPOSITION - NO,,720754,0,0,53,53,PROPOSITION NO. 2 OWASSO PUBLIC SCHOOLS
TULSA,PROPOSITION NO. 1 OWASSO PUBLIC SCHOOLS,FOR THE PROPOSITION - YES,,720755,0,0,199,199,PROPOSITION NO. 1 OWASSO PUBLIC SCHOOLS
TULSA,PROPOSITION NO. 1 OWASSO PUBLIC SCHOOLS,AGAINST THE PROPOSITION - NO,,720755,0,0,39,39,PROPOSITION NO. 1 OWASSO PUBLIC SCHOOLS
TULSA,PROPOSITION NO. 2 OWASSO PUBLIC SCHOOLS,FOR THE PROPOSITION - YES,,720755,0,0,201,201,PROPOSITION NO. 2 OWASSO PUBLIC SCHOOLS
TULSA,PROPOSITION NO. 2 OWASSO PUBLIC SCHOOLS,AGAINST THE PROPOSITION - NO,,720755,0,0,36,36,PROPOSITION NO. 2 OWASSO PUBLIC SCHOOLS
TULSA,PROPOSITION NO. 1 OWASSO PUBLIC SCHOOLS,FOR THE PROPOSITION - YES,,720756,0,0,2,2,PROPOSITION NO. 1 OWASSO PUBLIC SCHOOLS
TULSA,PROPOSITION NO. 1 OWASSO PUBLIC SCHOOLS,AGAINST THE PROPOSITION - NO,,720756,0,0,3,3,PROPOSITION NO. 1 OWASSO PUBLIC SCHOOLS
TULSA,PROPOSITION NO. 2 OWASSO PUBLIC SCHOOLS,FOR THE PROPOSITION - YES,,720756,0,0,2,2,PROPOSITION NO. 2 OWASSO PUBLIC SCHOOLS
TULSA,PROPOSITION NO. 2 OWASSO PUBLIC SCHOOLS,AGAINST THE PROPOSITION - NO,,720756,0,0,3,3,PROPOSITION NO. 2 OWASSO PUBLIC SCHOOLS
TULSA,PROPOSITION NO. 1 OWASSO PUBLIC SCHOOLS,FOR THE PROPOSITION - YES,,720757,0,0,239,239,PROPOSITION NO. 1 OWASSO PUBLIC SCHOOLS
TULSA,PROPOSITION NO. 1 OWASSO PUBLIC SCHOOLS,AGAINST THE PROPOSITION - NO,,720757,0,0,54,54,PROPOSITION NO. 1 OWASSO PUBLIC SCHOOLS
TULSA,PROPOSITION NO. 2 OWASSO PUBLIC SCHOOLS,FOR THE PROPOSITION - YES,,720757,0,0,239,239,PROPOSITION NO. 2 OWASSO PUBLIC SCHOOLS
TULSA,PROPOSITION NO. 2 OWASSO PUBLIC SCHOOLS,AGAINST THE PROPOSITION - NO,,720757,0,0,55,55,PROPOSITION NO. 2 OWASSO PUBLIC SCHOOLS
TULSA,PROPOSITION NO. 1 OWASSO PUBLIC SCHOOLS,FOR THE PROPOSITION - YES,,720758,0,0,42,42,PROPOSITION NO. 1 OWASSO PUBLIC SCHOOLS
TULSA,PROPOSITION NO. 1 OWASSO PUBLIC SCHOOLS,AGAINST THE PROPOSITION - NO,,720758,0,0,12,12,PROPOSITION NO. 1 OWASSO PUBLIC SCHOOLS
TULSA,PROPOSITION NO. 2 OWASSO PUBLIC SCHOOLS,FOR THE PROPOSITION - YES,,720758,0,0,45,45,PROPOSITION NO. 2 OWASSO PUBLIC SCHOOLS
TULSA,PROPOSITION NO. 2 OWASSO PUBLIC SCHOOLS,AGAINST THE PROPOSITION - NO,,720758,0,0,9,9,PROPOSITION NO. 2 OWASSO PUBLIC SCHOOLS
TULSA,PROPOSITION NO. 1 OWASSO PUBLIC SCHOOLS,FOR THE PROPOSITION - YES,,720759,0,0,99,99,PROPOSITION NO. 1 OWASSO PUBLIC SCHOOLS
TULSA,PROPOSITION NO. 1 OWASSO PUBLIC SCHOOLS,AGAINST THE PROPOSITION - NO,,720759,0,0,30,30,PROPOSITION NO. 1 OWASSO PUBLIC SCHOOLS
TULSA,PROPOSITION NO. 2 OWASSO PUBLIC SCHOOLS,FOR THE PROPOSITION - YES,,720759,0,0,104,104,PROPOSITION NO. 2 OWASSO PUBLIC SCHOOLS
TULSA,PROPOSITION NO. 2 OWASSO PUBLIC SCHOOLS,AGAINST THE PROPOSITION - NO,,720759,0,0,25,25,PROPOSITION NO. 2 OWASSO PUBLIC SCHOOLS
TULSA,PROPOSITION NO. 1 OWASSO PUBLIC SCHOOLS,FOR THE PROPOSITION - YES,,720760,0,0,75,75,PROPOSITION NO. 1 OWASSO PUBLIC SCHOOLS
TULSA,PROPOSITION NO. 1 OWASSO PUBLIC SCHOOLS,AGAINST THE PROPOSITION - NO,,720760,0,0,11,11,PROPOSITION NO. 1 OWASSO PUBLIC SCHOOLS
TULSA,PROPOSITION NO. 2 OWASSO PUBLIC SCHOOLS,FOR THE PROPOSITION - YES,,720760,0,0,71,71,PROPOSITION NO. 2 OWASSO PUBLIC SCHOOLS
TULSA,PROPOSITION NO. 2 OWASSO PUBLIC SCHOOLS,AGAINST THE PROPOSITION - NO,,720760,0,0,15,15,PROPOSITION NO. 2 OWASSO PUBLIC SCHOOLS
TULSA,PROPOSITION NO. 1 OWASSO PUBLIC SCHOOLS,FOR THE PROPOSITION - YES,,729999,38,1,0,39,PROPOSITION NO. 1 OWASSO PUBLIC SCHOOLS
TULSA,PROPOSITION NO. 1 OWASSO PUBLIC SCHOOLS,AGAINST THE PROPOSITION - NO,,729999,24,0,0,24,PROPOSITION NO. 1 OWASSO PUBLIC SCHOOLS
TULSA,PROPOSITION NO. 2 OWASSO PUBLIC SCHOOLS,FOR THE PROPOSITION - YES,,729999,39,1,0,40,PROPOSITION NO. 2 OWASSO PUBLIC SCHOOLS
TULSA,PROPOSITION NO. 2 OWASSO PUBLIC SCHOOLS,AGAINST THE PROPOSITION - NO,,729999,23,0,0,23,PROPOSITION NO. 2 OWASSO PUBLIC SCHOOLS
WAGONER,PROPOSITION LOCUST GROVE PUBLIC SCHOOLS,FOR THE PROPOSITION - YES,,730206,0,0,4,4,
WAGONER,PROPOSITION LOCUST GROVE PUBLIC SCHOOLS,AGAINST THE PROPOSITION - NO,,730206,0,0,6,6,
WASHITA,PROPOSITION TOWN OF SENTINEL,FOR THE PROPOSITION - YES,,750019,0,0,45,45,
WASHITA,PROPOSITION TOWN OF SENTINEL,AGAINST THE PROPOSITION - NO,,750019,0,0,4,4,
WOODWARD,PROPOSITION MOORELAND PUBLIC SCHOOLS,FOR THE PROPOSITION - YES,,770105,7,13,333,353,
WOODWARD,PROPOSITION MOORELAND PUBLIC SCHOOLS,AGAINST THE PROPOSITION - NO,,770105,5,3,174,182,
WOODWARD,PROPOSITION MOORELAND PUBLIC SCHOOLS,FOR THE PROPOSITION - YES,,770106,0,0,12,12,
WOODWARD,PROPOSITION MOORELAND PUBLIC SCHOOLS,AGAINST THE PROPOSITION - NO,,770106,0,0,22,22,
WOODWARD,PROPOSITION MOORELAND PUBLIC SCHOOLS,FOR THE PROPOSITION - YES,,770201,3,1,0,4,
WOODWARD,PROPOSITION MOORELAND PUBLIC SCHOOLS,AGAINST THE PROPOSITION - NO,,770201,0,7,0,7,
WOODWARD,PROPOSITION MOORELAND PUBLIC SCHOOLS,FOR THE PROPOSITION - YES,,770302,1,2,0,3,
WOODWARD,PROPOSITION MOORELAND PUBLIC SCHOOLS,AGAINST THE PROPOSITION - NO,,770302,4,0,0,4,
WOODWARD,PROPOSITION MOORELAND PUBLIC SCHOOLS,FOR THE PROPOSITION - YES,,770303,0,0,0,0,
WOODWARD,PROPOSITION MOORELAND PUBLIC SCHOOLS,AGAINST THE PROPOSITION - NO,,770303,0,0,0,0,
WOODWARD,PROPOSITION MOORELAND PUBLIC SCHOOLS,FOR THE PROPOSITION - YES,,770304,0,0,0,0,
WOODWARD,PROPOSITION MOORELAND PUBLIC SCHOOLS,AGAINST THE PROPOSITION - NO,,770304,0,0,0,0,
WOODWARD,PROPOSITION MOORELAND PUBLIC SCHOOLS,FOR THE PROPOSITION - YES,,770306,0,0,0,0,
WOODWARD,PROPOSITION MOORELAND PUBLIC SCHOOLS,AGAINST THE PROPOSITION - NO,,770306,0,0,0,0,
