county,office,candidate,party,precinct,mail_votes,early_votes,elec_day_votes,votes,district
ATOKA,PROPOSITION STRINGTOWN PUBLIC SCHOOLS,FOR THE PROPOSITION - YES,,30013,1,3,110,114,
ATOKA,PROPOSITION STRINGTOWN PUBLIC SCHOOLS,AGAINST THE PROPOSITION - NO,,30013,0,4,54,58,
ATOKA,PROPOSITION STRINGTOWN PUBLIC SCHOOLS,FOR THE PROPOSITION - YES,,30014,0,1,31,32,
ATOKA,PROPOSITION STRINGTOWN PUBLIC SCHOOLS,AGAINST THE PROPOSITION - NO,,30014,0,2,19,21,
ATOKA,PROPOSITION STRINGTOWN PUBLIC SCHOOLS,FOR THE PROPOSITION - YES,,30019,0,0,7,7,
ATOKA,PROPOSITION STRINGTOWN PUBLIC SCHOOLS,AGAINST THE PROPOSITION - NO,,30019,0,1,9,10,
CANADIAN,PROPOSITION CITY OF YUKON,FOR THE PROPOSITION - YES,,90201,0,2,16,18,
CANADIAN,PROPOSITION CITY OF YUKON,AGAINST THE PROPOSITION - NO,,90201,2,0,61,63,
CANADIAN,PROPOSITION CITY OF YUKON,FOR THE PROPOSITION - YES,,90204,4,0,99,103,
CANADIAN,PROPOSITION CITY OF YUKON,AGAINST THE PROPOSITION - NO,,90204,8,3,240,251,
CANADIAN,PROPOSITION CITY OF YUKON,FOR THE PROPOSITION - YES,,90206,3,0,58,61,
CANADIAN,PROPOSITION CITY OF YUKON,AGAINST THE PROPOSITION - NO,,90206,5,0,238,243,
CANADIAN,PROPOSITION CITY OF YUKON,FOR THE PROPOSITION - YES,,90208,0,0,102,102,
CANADIAN,PROPOSITION CITY OF YUKON,AGAINST THE PROPOSITION - NO,,90208,13,3,310,326,
CANADIAN,PROPOSITION CITY OF YUKON,FOR THE PROPOSITION - YES,,90209,0,0,4,4,
CANADIAN,PROPOSITION CITY OF YUKON,AGAINST THE PROPOSITION - NO,,90209,0,0,5,5,
CANADIAN,PROPOSITION CITY OF YUKON,FOR THE PROPOSITION - YES,,90210,4,0,104,108,
CANADIAN,PROPOSITION CITY OF YUKON,AGAINST THE PROPOSITION - NO,,90210,2,2,168,172,
CANADIAN,PROPOSITION CITY OF YUKON,FOR THE PROPOSITION - YES,,90211,0,0,0,0,
CANADIAN,PROPOSITION CITY OF YUKON,AGAINST THE PROPOSITION - NO,,90211,0,0,0,0,
CANADIAN,PROPOSITION CITY OF YUKON,FOR THE PROPOSITION - YES,,90214,4,0,100,104,
CANADIAN,PROPOSITION CITY OF YUKON,AGAINST THE PROPOSITION - NO,,90214,13,2,339,354,
CANADIAN,PROPOSITION CITY OF YUKON,FOR THE PROPOSITION - YES,,90216,8,4,184,196,
CANADIAN,PROPOSITION CITY OF YUKON,AGAINST THE PROPOSITION - NO,,90216,13,7,381,401,
CANADIAN,PROPOSITION CITY OF YUKON,FOR THE PROPOSITION - YES,,90217,0,0,0,0,
CANADIAN,PROPOSITION CITY OF YUKON,AGAINST THE PROPOSITION - NO,,90217,0,0,0,0,
CANADIAN,PROPOSITION CITY OF YUKON,FOR THE PROPOSITION - YES,,90218,1,0,83,84,
CANADIAN,PROPOSITION CITY OF YUKON,AGAINST THE PROPOSITION - NO,,90218,4,2,262,268,
CANADIAN,PROPOSITION CITY OF YUKON,FOR THE PROPOSITION - YES,,90220,5,2,107,114,
CANADIAN,PROPOSITION CITY OF YUKON,AGAINST THE PROPOSITION - NO,,90220,7,2,357,366,
CHOCTAW,PROPOSITION TOWN OF FORT TOWSON,FOR THE PROPOSITION - YES,,120320,0,0,0,0,
CHOCTAW,PROPOSITION TOWN OF FORT TOWSON,AGAINST THE PROPOSITION - NO,,120320,0,0,0,0,
CHOCTAW,PROPOSITION TOWN OF FORT TOWSON,FOR THE PROPOSITION - YES,,120321,4,2,59,65,
CHOCTAW,PROPOSITION TOWN OF FORT TOWSON,AGAINST THE PROPOSITION - NO,,120321,0,0,1,1,
CLEVELAND,PROPOSITION NO. 1 NOBLE PUBLIC SCHOOLS,FOR THE PROPOSITION - YES,,140029,5,1,269,275,PROPOSITION NO. 1 NOBLE PUBLIC SCHOOLS
CLEVELAND,PROPOSITION NO. 1 NOBLE PUBLIC SCHOOLS,AGAINST THE PROPOSITION - NO,,140029,11,1,101,113,PROPOSITION NO. 1 NOBLE PUBLIC SCHOOLS
CLEVELAND,PROPOSITION NO. 2 NOBLE PUBLIC SCHOOLS,FOR THE PROPOSITION - YES,,140029,5,1,292,298,PROPOSITION NO. 2 NOBLE PUBLIC SCHOOLS
CLEVELAND,PROPOSITION NO. 2 NOBLE PUBLIC SCHOOLS,AGAINST THE PROPOSITION - NO,,140029,11,1,79,91,PROPOSITION NO. 2 NOBLE PUBLIC SCHOOLS
CLEVELAND,PROPOSITION NO. 1 NOBLE PUBLIC SCHOOLS,FOR THE PROPOSITION - YES,,140038,0,0,71,71,PROPOSITION NO. 1 NOBLE PUBLIC SCHOOLS
CLEVELAND,PROPOSITION NO. 1 NOBLE PUBLIC SCHOOLS,AGAINST THE PROPOSITION - NO,,140038,5,0,37,42,PROPOSITION NO. 1 NOBLE PUBLIC SCHOOLS
CLEVELAND,PROPOSITION NO. 2 NOBLE PUBLIC SCHOOLS,FOR THE PROPOSITION - YES,,140038,0,0,77,77,PROPOSITION NO. 2 NOBLE PUBLIC SCHOOLS
CLEVELAND,PROPOSITION NO. 2 NOBLE PUBLIC SCHOOLS,AGAINST THE PROPOSITION - NO,,140038,5,0,32,37,PROPOSITION NO. 2 NOBLE PUBLIC SCHOOLS
CLEVELAND,PROPOSITION NO. 1 NOBLE PUBLIC SCHOOLS,FOR THE PROPOSITION - YES,,140045,1,0,21,22,PROPOSITION NO. 1 NOBLE PUBLIC SCHOOLS
CLEVELAND,PROPOSITION NO. 1 NOBLE PUBLIC SCHOOLS,AGAINST THE PROPOSITION - NO,,140045,4,0,30,34,PROPOSITION NO. 1 NOBLE PUBLIC SCHOOLS
CLEVELAND,PROPOSITION NO. 2 NOBLE PUBLIC SCHOOLS,FOR THE PROPOSITION - YES,,140045,1,0,23,24,PROPOSITION NO. 2 NOBLE PUBLIC SCHOOLS
CLEVELAND,PROPOSITION NO. 2 NOBLE PUBLIC SCHOOLS,AGAINST THE PROPOSITION - NO,,140045,4,0,29,33,PROPOSITION NO. 2 NOBLE PUBLIC SCHOOLS
CLEVELAND,PROPOSITION NO. 1 NOBLE PUBLIC SCHOOLS,FOR THE PROPOSITION - YES,,140049,1,0,4,5,PROPOSITION NO. 1 NOBLE PUBLIC SCHOOLS
CLEVELAND,PROPOSITION NO. 1 NOBLE PUBLIC SCHOOLS,AGAINST THE PROPOSITION - NO,,140049,0,0,1,1,PROPOSITION NO. 1 NOBLE PUBLIC SCHOOLS
CLEVELAND,PROPOSITION NO. 2 NOBLE PUBLIC SCHOOLS,FOR THE PROPOSITION - YES,,140049,1,0,4,5,PROPOSITION NO. 2 NOBLE PUBLIC SCHOOLS
CLEVELAND,PROPOSITION NO. 2 NOBLE PUBLIC SCHOOLS,AGAINST THE PROPOSITION - NO,,140049,0,0,1,1,PROPOSITION NO. 2 NOBLE PUBLIC SCHOOLS
CLEVELAND,PROPOSITION NO. 1 NOBLE PUBLIC SCHOOLS,FOR THE PROPOSITION - YES,,140057,20,2,384,406,PROPOSITION NO. 1 NOBLE PUBLIC SCHOOLS
CLEVELAND,PROPOSITION NO. 1 NOBLE PUBLIC SCHOOLS,AGAINST THE PROPOSITION - NO,,140057,9,0,131,140,PROPOSITION NO. 1 NOBLE PUBLIC SCHOOLS
CLEVELAND,PROPOSITION NO. 2 NOBLE PUBLIC SCHOOLS,FOR THE PROPOSITION - YES,,140057,21,2,389,412,PROPOSITION NO. 2 NOBLE PUBLIC SCHOOLS
CLEVELAND,PROPOSITION NO. 2 NOBLE PUBLIC SCHOOLS,AGAINST THE PROPOSITION - NO,,140057,7,0,127,134,PROPOSITION NO. 2 NOBLE PUBLIC SCHOOLS
CLEVELAND,PROPOSITION NO. 1 NOBLE PUBLIC SCHOOLS,FOR THE PROPOSITION - YES,,140067,1,0,23,24,PROPOSITION NO. 1 NOBLE PUBLIC SCHOOLS
CLEVELAND,PROPOSITION NO. 1 NOBLE PUBLIC SCHOOLS,AGAINST THE PROPOSITION - NO,,140067,0,0,8,8,PROPOSITION NO. 1 NOBLE PUBLIC SCHOOLS
CLEVELAND,PROPOSITION NO. 2 NOBLE PUBLIC SCHOOLS,FOR THE PROPOSITION - YES,,140067,1,0,25,26,PROPOSITION NO. 2 NOBLE PUBLIC SCHOOLS
CLEVELAND,PROPOSITION NO. 2 NOBLE PUBLIC SCHOOLS,AGAINST THE PROPOSITION - NO,,140067,0,0,6,6,PROPOSITION NO. 2 NOBLE PUBLIC SCHOOLS
CLEVELAND,PROPOSITION NO. 1 NOBLE PUBLIC SCHOOLS,FOR THE PROPOSITION - YES,,140083,2,1,25,28,PROPOSITION NO. 1 NOBLE PUBLIC SCHOOLS
CLEVELAND,PROPOSITION NO. 1 NOBLE PUBLIC SCHOOLS,AGAINST THE PROPOSITION - NO,,140083,1,0,14,15,PROPOSITION NO. 1 NOBLE PUBLIC SCHOOLS
CLEVELAND,PROPOSITION NO. 2 NOBLE PUBLIC SCHOOLS,FOR THE PROPOSITION - YES,,140083,2,1,28,31,PROPOSITION NO. 2 NOBLE PUBLIC SCHOOLS
CLEVELAND,PROPOSITION NO. 2 NOBLE PUBLIC SCHOOLS,AGAINST THE PROPOSITION - NO,,140083,1,0,11,12,PROPOSITION NO. 2 NOBLE PUBLIC SCHOOLS
CLEVELAND,PROPOSITION NO. 1 NOBLE PUBLIC SCHOOLS,FOR THE PROPOSITION - YES,,140094,1,0,4,5,PROPOSITION NO. 1 NOBLE PUBLIC SCHOOLS
CLEVELAND,PROPOSITION NO. 1 NOBLE PUBLIC SCHOOLS,AGAINST THE PROPOSITION - NO,,140094,0,2,12,14,PROPOSITION NO. 1 NOBLE PUBLIC SCHOOLS
CLEVELAND,PROPOSITION NO. 2 NOBLE PUBLIC SCHOOLS,FOR THE PROPOSITION - YES,,140094,1,0,6,7,PROPOSITION NO. 2 NOBLE PUBLIC SCHOOLS
CLEVELAND,PROPOSITION NO. 2 NOBLE PUBLIC SCHOOLS,AGAINST THE PROPOSITION - NO,,140094,0,2,10,12,PROPOSITION NO. 2 NOBLE PUBLIC SCHOOLS
CLEVELAND,PROPOSITION NO. 1 NOBLE PUBLIC SCHOOLS,FOR THE PROPOSITION - YES,,140095,4,0,72,76,PROPOSITION NO. 1 NOBLE PUBLIC SCHOOLS
CLEVELAND,PROPOSITION NO. 1 NOBLE PUBLIC SCHOOLS,AGAINST THE PROPOSITION - NO,,140095,1,0,15,16,PROPOSITION NO. 1 NOBLE PUBLIC SCHOOLS
CLEVELAND,PROPOSITION NO. 2 NOBLE PUBLIC SCHOOLS,FOR THE PROPOSITION - YES,,140095,4,0,73,77,PROPOSITION NO. 2 NOBLE PUBLIC SCHOOLS
CLEVELAND,PROPOSITION NO. 2 NOBLE PUBLIC SCHOOLS,AGAINST THE PROPOSITION - NO,,140095,1,0,14,15,PROPOSITION NO. 2 NOBLE PUBLIC SCHOOLS
COMANCHE,PROPOSITION ELGIN PUBLIC SCHOOLS,FOR THE PROPOSITION - YES,,160031,0,0,3,3,
COMANCHE,PROPOSITION ELGIN PUBLIC SCHOOLS,AGAINST THE PROPOSITION - NO,,160031,0,0,7,7,
COMANCHE,PROPOSITION ELGIN PUBLIC SCHOOLS,FOR THE PROPOSITION - YES,,160035,0,0,12,12,
COMANCHE,PROPOSITION ELGIN PUBLIC SCHOOLS,AGAINST THE PROPOSITION - NO,,160035,0,0,12,12,
COMANCHE,PROPOSITION ELGIN PUBLIC SCHOOLS,FOR THE PROPOSITION - YES,,160036,0,0,22,22,
COMANCHE,PROPOSITION ELGIN PUBLIC SCHOOLS,AGAINST THE PROPOSITION - NO,,160036,2,0,22,24,
COMANCHE,PROPOSITION ELGIN PUBLIC SCHOOLS,FOR THE PROPOSITION - YES,,160037,2,0,56,58,
COMANCHE,PROPOSITION ELGIN PUBLIC SCHOOLS,AGAINST THE PROPOSITION - NO,,160037,0,0,40,40,
COMANCHE,PROPOSITION ELGIN PUBLIC SCHOOLS,FOR THE PROPOSITION - YES,,160038,16,11,457,484,
COMANCHE,PROPOSITION ELGIN PUBLIC SCHOOLS,AGAINST THE PROPOSITION - NO,,160038,13,7,213,233,
COMANCHE,PROPOSITION ELGIN PUBLIC SCHOOLS,FOR THE PROPOSITION - YES,,160039,0,0,0,0,
COMANCHE,PROPOSITION ELGIN PUBLIC SCHOOLS,AGAINST THE PROPOSITION - NO,,160039,1,0,4,5,
COMANCHE,PROPOSITION ELGIN PUBLIC SCHOOLS,FOR THE PROPOSITION - YES,,160051,2,4,138,144,
COMANCHE,PROPOSITION ELGIN PUBLIC SCHOOLS,AGAINST THE PROPOSITION - NO,,160051,6,0,127,133,
COMANCHE,PROPOSITION ELGIN PUBLIC SCHOOLS,FOR THE PROPOSITION - YES,,160053,0,0,0,0,
COMANCHE,PROPOSITION ELGIN PUBLIC SCHOOLS,AGAINST THE PROPOSITION - NO,,160053,0,0,0,0,
DELAWARE,PROPOSITON GROVE PUBLIC SCHOOLS,FOR THE PROPOSITION - YES,,210003,3,0,22,25,
DELAWARE,PROPOSITON GROVE PUBLIC SCHOOLS,AGAINST THE PROPOSITION - NO,,210003,0,0,28,28,
DELAWARE,PROPOSITON GROVE PUBLIC SCHOOLS,FOR THE PROPOSITION - YES,,210004,0,0,26,26,
DELAWARE,PROPOSITON GROVE PUBLIC SCHOOLS,AGAINST THE PROPOSITION - NO,,210004,2,0,23,25,
DELAWARE,PROPOSITON GROVE PUBLIC SCHOOLS,FOR THE PROPOSITION - YES,,210005,2,2,55,59,
DELAWARE,PROPOSITON GROVE PUBLIC SCHOOLS,AGAINST THE PROPOSITION - NO,,210005,7,0,34,41,
DELAWARE,PROPOSITON GROVE PUBLIC SCHOOLS,FOR THE PROPOSITION - YES,,210006,3,0,16,19,
DELAWARE,PROPOSITON GROVE PUBLIC SCHOOLS,AGAINST THE PROPOSITION - NO,,210006,1,0,29,30,
DELAWARE,PROPOSITON GROVE PUBLIC SCHOOLS,FOR THE PROPOSITION - YES,,210007,7,1,105,113,
DELAWARE,PROPOSITON GROVE PUBLIC SCHOOLS,AGAINST THE PROPOSITION - NO,,210007,10,0,65,75,
DELAWARE,PROPOSITON GROVE PUBLIC SCHOOLS,FOR THE PROPOSITION - YES,,210008,0,0,6,6,
DELAWARE,PROPOSITON GROVE PUBLIC SCHOOLS,AGAINST THE PROPOSITION - NO,,210008,3,0,16,19,
DELAWARE,PROPOSITON GROVE PUBLIC SCHOOLS,FOR THE PROPOSITION - YES,,210009,8,1,111,120,
DELAWARE,PROPOSITON GROVE PUBLIC SCHOOLS,AGAINST THE PROPOSITION - NO,,210009,8,0,71,79,
DELAWARE,PROPOSITON GROVE PUBLIC SCHOOLS,FOR THE PROPOSITION - YES,,210011,3,0,34,37,
DELAWARE,PROPOSITON GROVE PUBLIC SCHOOLS,AGAINST THE PROPOSITION - NO,,210011,2,0,30,32,
DELAWARE,PROPOSITON GROVE PUBLIC SCHOOLS,FOR THE PROPOSITION - YES,,210012,0,0,20,20,
DELAWARE,PROPOSITON GROVE PUBLIC SCHOOLS,AGAINST THE PROPOSITION - NO,,210012,2,0,26,28,
GARVIN,PROPOSITION PAULS VALLEY PUBLIC SCHOOLS,FOR THE PROPOSITION - YES,,250007,0,5,47,52,
GARVIN,PROPOSITION PAULS VALLEY PUBLIC SCHOOLS,AGAINST THE PROPOSITION - NO,,250007,0,4,26,30,
GARVIN,PROPOSITION PAULS VALLEY PUBLIC SCHOOLS,FOR THE PROPOSITION - YES,,250008,1,2,24,27,
GARVIN,PROPOSITION PAULS VALLEY PUBLIC SCHOOLS,AGAINST THE PROPOSITION - NO,,250008,0,0,17,17,
GARVIN,PROPOSITION PAULS VALLEY PUBLIC SCHOOLS,FOR THE PROPOSITION - YES,,250015,0,5,110,115,
GARVIN,PROPOSITION PAULS VALLEY PUBLIC SCHOOLS,AGAINST THE PROPOSITION - NO,,250015,1,11,98,110,
GARVIN,PROPOSITION PAULS VALLEY PUBLIC SCHOOLS,FOR THE PROPOSITION - YES,,250017,1,2,99,102,
GARVIN,PROPOSITION PAULS VALLEY PUBLIC SCHOOLS,AGAINST THE PROPOSITION - NO,,250017,0,4,60,64,
GARVIN,PROPOSITION PAULS VALLEY PUBLIC SCHOOLS,FOR THE PROPOSITION - YES,,250018,3,6,110,119,
GARVIN,PROPOSITION PAULS VALLEY PUBLIC SCHOOLS,AGAINST THE PROPOSITION - NO,,250018,4,7,103,114,
GRANT,PROPOSITION DEER CREEK-LAMONT SCHOOLS,FOR THE PROPOSITION - YES,,270011,0,0,50,50,
GRANT,PROPOSITION DEER CREEK-LAMONT SCHOOLS,AGAINST THE PROPOSITION - NO,,270011,0,0,4,4,
GRANT,PROPOSITION DEER CREEK-LAMONT SCHOOLS,FOR THE PROPOSITION - YES,,270023,0,0,0,0,
GRANT,PROPOSITION DEER CREEK-LAMONT SCHOOLS,AGAINST THE PROPOSITION - NO,,270023,0,0,0,0,
GRANT,PROPOSITION DEER CREEK-LAMONT SCHOOLS,FOR THE PROPOSITION - YES,,270026,0,0,93,93,
GRANT,PROPOSITION DEER CREEK-LAMONT SCHOOLS,AGAINST THE PROPOSITION - NO,,270026,1,0,12,13,
GRANT,PROPOSITION DEER CREEK-LAMONT SCHOOLS,FOR THE PROPOSITION - YES,,270029,0,0,3,3,
GRANT,PROPOSITION DEER CREEK-LAMONT SCHOOLS,AGAINST THE PROPOSITION - NO,,270029,0,1,1,2,
GRANT,PROPOSITION DEER CREEK-LAMONT SCHOOLS,FOR THE PROPOSITION - YES,,270030,0,0,0,0,
GRANT,PROPOSITION DEER CREEK-LAMONT SCHOOLS,AGAINST THE PROPOSITION - NO,,270030,0,0,1,1,
HARMON,PROPOSED CONSOLIDATION ELDORADO PUBLIC SCHOOLS,FOR THE CONSOLIDATION - YES,,290204,0,0,0,0,
HARMON,PROPOSED CONSOLIDATION ELDORADO PUBLIC SCHOOLS,AGAINST THE CONSOLIDATION - NO,,290204,0,0,0,0,
HARMON,PROPOSED CONSOLIDATION PLAN ELDORADO PUBLIC SCHOOLS,FOR THE CONSOLIDATION - YES,,290204,0,0,0,0,
HARMON,PROPOSED CONSOLIDATION PLAN ELDORADO PUBLIC SCHOOLS,AGAINST THE CONSOLIDATION - NO,,290204,0,0,0,0,
HARMON,PROPOSED CONSOLIDATION ELDORADO PUBLIC SCHOOLS,FOR THE CONSOLIDATION - YES,,290302,1,0,5,6,
HARMON,PROPOSED CONSOLIDATION ELDORADO PUBLIC SCHOOLS,AGAINST THE CONSOLIDATION - NO,,290302,0,0,0,0,
HARMON,PROPOSED CONSOLIDATION PLAN ELDORADO PUBLIC SCHOOLS,FOR THE CONSOLIDATION - YES,,290302,1,0,4,5,
HARMON,PROPOSED CONSOLIDATION PLAN ELDORADO PUBLIC SCHOOLS,AGAINST THE CONSOLIDATION - NO,,290302,0,0,1,1,
JACKSON,PROPOSED CONSOLIDATION ELDORADO PUBLIC SCHOOLS,FOR THE CONSOLIDATION - YES,,330018,0,1,116,117,
JACKSON,PROPOSED CONSOLIDATION ELDORADO PUBLIC SCHOOLS,AGAINST THE CONSOLIDATION - NO,,330018,0,2,4,6,
JACKSON,PROPOSED CONSOLIDATION PLAN ELDORADO PUBLIC SCHOOLS,FOR THE CONSOLIDATION - YES,,330018,1,1,112,114,
JACKSON,PROPOSED CONSOLIDATION PLAN ELDORADO PUBLIC SCHOOLS,AGAINST THE CONSOLIDATION - NO,,330018,0,2,5,7,
JACKSON,PROPOSED CONSOLIDATION OLUSTEE PUBLIC SCHOOLS,FOR THE CONSOLIDATION - YES,,330018,0,0,0,0,
JACKSON,PROPOSED CONSOLIDATION OLUSTEE PUBLIC SCHOOLS,AGAINST THE CONSOLIDATION - NO,,330018,0,0,0,0,
JACKSON,PROPOSED CONSOLIDATION PLAN OLUSTEE PUBLIC SCHOOLS,FOR THE CONSOLIDATION - YES,,330018,0,0,0,0,
JACKSON,PROPOSED CONSOLIDATION PLAN OLUSTEE PUBLIC SCHOOLS,AGAINST THE CONSOLIDATION - NO,,330018,0,0,0,0,
JACKSON,PROPOSED CONSOLIDATION ELDORADO PUBLIC SCHOOLS,FOR THE CONSOLIDATION - YES,,330019,0,0,0,0,
JACKSON,PROPOSED CONSOLIDATION ELDORADO PUBLIC SCHOOLS,AGAINST THE CONSOLIDATION - NO,,330019,0,0,0,0,
JACKSON,PROPOSED CONSOLIDATION PLAN ELDORADO PUBLIC SCHOOLS,FOR THE CONSOLIDATION - YES,,330019,0,0,0,0,
JACKSON,PROPOSED CONSOLIDATION PLAN ELDORADO PUBLIC SCHOOLS,AGAINST THE CONSOLIDATION - NO,,330019,0,0,0,0,
JACKSON,PROPOSED CONSOLIDATION OLUSTEE PUBLIC SCHOOLS,FOR THE CONSOLIDATION - YES,,330019,0,0,1,1,
JACKSON,PROPOSED CONSOLIDATION OLUSTEE PUBLIC SCHOOLS,AGAINST THE CONSOLIDATION - NO,,330019,0,0,0,0,
JACKSON,PROPOSED CONSOLIDATION PLAN OLUSTEE PUBLIC SCHOOLS,FOR THE CONSOLIDATION - YES,,330019,0,0,1,1,
JACKSON,PROPOSED CONSOLIDATION PLAN OLUSTEE PUBLIC SCHOOLS,AGAINST THE CONSOLIDATION - NO,,330019,0,0,0,0,
JACKSON,PROPOSED CONSOLIDATION ELDORADO PUBLIC SCHOOLS,FOR THE CONSOLIDATION - YES,,330024,0,0,0,0,
JACKSON,PROPOSED CONSOLIDATION ELDORADO PUBLIC SCHOOLS,AGAINST THE CONSOLIDATION - NO,,330024,0,0,0,0,
JACKSON,PROPOSED CONSOLIDATION PLAN ELDORADO PUBLIC SCHOOLS,FOR THE CONSOLIDATION - YES,,330024,0,0,0,0,
JACKSON,PROPOSED CONSOLIDATION PLAN ELDORADO PUBLIC SCHOOLS,AGAINST THE CONSOLIDATION - NO,,330024,0,0,0,0,
JACKSON,PROPOSED CONSOLIDATION OLUSTEE PUBLIC SCHOOLS,FOR THE CONSOLIDATION - YES,,330024,4,0,140,144,
JACKSON,PROPOSED CONSOLIDATION OLUSTEE PUBLIC SCHOOLS,AGAINST THE CONSOLIDATION - NO,,330024,0,0,6,6,
JACKSON,PROPOSED CONSOLIDATION PLAN OLUSTEE PUBLIC SCHOOLS,FOR THE CONSOLIDATION - YES,,330024,4,0,138,142,
JACKSON,PROPOSED CONSOLIDATION PLAN OLUSTEE PUBLIC SCHOOLS,AGAINST THE CONSOLIDATION - NO,,330024,0,0,6,6,
KAY,PROPOSITION DEER CREEK-LAMONT SCHOOLS,FOR THE PROPOSITION - YES,,360101,0,0,0,0,
KAY,PROPOSITION DEER CREEK-LAMONT SCHOOLS,AGAINST THE PROPOSITION - NO,,360101,0,0,0,0,
KAY,PROPOSITION DEER CREEK-LAMONT SCHOOLS,FOR THE PROPOSITION - YES,,360103,0,0,1,1,
KAY,PROPOSITION DEER CREEK-LAMONT SCHOOLS,AGAINST THE PROPOSITION - NO,,360103,0,0,0,0,
KAY,PROPOSITION NO. 1 BLACKWELL PUBLIC SCHOOLS,FOR THE PROPOSITION - YES,,360103,0,0,7,7,PROPOSITION NO. 1 BLACKWELL PUBLIC SCHOOLS
KAY,PROPOSITION NO. 1 BLACKWELL PUBLIC SCHOOLS,AGAINST THE PROPOSITION - NO,,360103,0,0,6,6,PROPOSITION NO. 1 BLACKWELL PUBLIC SCHOOLS
KAY,PROPOSITION NO. 2 BLACKWELL PUBLIC SCHOOLS,FOR THE PROPOSITION - YES,,360103,0,0,7,7,PROPOSITION NO. 2 BLACKWELL PUBLIC SCHOOLS
KAY,PROPOSITION NO. 2 BLACKWELL PUBLIC SCHOOLS,AGAINST THE PROPOSITION - NO,,360103,0,0,6,6,PROPOSITION NO. 2 BLACKWELL PUBLIC SCHOOLS
KAY,PROPOSITION NO. 1 BLACKWELL PUBLIC SCHOOLS,FOR THE PROPOSITION - YES,,360202,4,1,129,134,PROPOSITION NO. 1 BLACKWELL PUBLIC SCHOOLS
KAY,PROPOSITION NO. 1 BLACKWELL PUBLIC SCHOOLS,AGAINST THE PROPOSITION - NO,,360202,1,1,73,75,PROPOSITION NO. 1 BLACKWELL PUBLIC SCHOOLS
KAY,PROPOSITION NO. 2 BLACKWELL PUBLIC SCHOOLS,FOR THE PROPOSITION - YES,,360202,4,1,137,142,PROPOSITION NO. 2 BLACKWELL PUBLIC SCHOOLS
KAY,PROPOSITION NO. 2 BLACKWELL PUBLIC SCHOOLS,AGAINST THE PROPOSITION - NO,,360202,1,1,67,69,PROPOSITION NO. 2 BLACKWELL PUBLIC SCHOOLS
KAY,PROPOSITION NO. 1 BLACKWELL PUBLIC SCHOOLS,FOR THE PROPOSITION - YES,,360205,1,2,116,119,PROPOSITION NO. 1 BLACKWELL PUBLIC SCHOOLS
KAY,PROPOSITION NO. 1 BLACKWELL PUBLIC SCHOOLS,AGAINST THE PROPOSITION - NO,,360205,1,2,65,68,PROPOSITION NO. 1 BLACKWELL PUBLIC SCHOOLS
KAY,PROPOSITION NO. 2 BLACKWELL PUBLIC SCHOOLS,FOR THE PROPOSITION - YES,,360205,4,1,117,122,PROPOSITION NO. 2 BLACKWELL PUBLIC SCHOOLS
KAY,PROPOSITION NO. 2 BLACKWELL PUBLIC SCHOOLS,AGAINST THE PROPOSITION - NO,,360205,0,3,65,68,PROPOSITION NO. 2 BLACKWELL PUBLIC SCHOOLS
KAY,PROPOSITION NO. 1 BLACKWELL PUBLIC SCHOOLS,FOR THE PROPOSITION - YES,,360206,9,3,262,274,PROPOSITION NO. 1 BLACKWELL PUBLIC SCHOOLS
KAY,PROPOSITION NO. 1 BLACKWELL PUBLIC SCHOOLS,AGAINST THE PROPOSITION - NO,,360206,1,1,90,92,PROPOSITION NO. 1 BLACKWELL PUBLIC SCHOOLS
KAY,PROPOSITION NO. 2 BLACKWELL PUBLIC SCHOOLS,FOR THE PROPOSITION - YES,,360206,9,3,272,284,PROPOSITION NO. 2 BLACKWELL PUBLIC SCHOOLS
KAY,PROPOSITION NO. 2 BLACKWELL PUBLIC SCHOOLS,AGAINST THE PROPOSITION - NO,,360206,1,1,86,88,PROPOSITION NO. 2 BLACKWELL PUBLIC SCHOOLS
KAY,PROPOSITION NO. 1 BLACKWELL PUBLIC SCHOOLS,FOR THE PROPOSITION - YES,,360404,0,0,0,0,PROPOSITION NO. 1 BLACKWELL PUBLIC SCHOOLS
KAY,PROPOSITION NO. 1 BLACKWELL PUBLIC SCHOOLS,AGAINST THE PROPOSITION - NO,,360404,0,0,0,0,PROPOSITION NO. 1 BLACKWELL PUBLIC SCHOOLS
KAY,PROPOSITION NO. 2 BLACKWELL PUBLIC SCHOOLS,FOR THE PROPOSITION - YES,,360404,0,0,0,0,PROPOSITION NO. 2 BLACKWELL PUBLIC SCHOOLS
KAY,PROPOSITION NO. 2 BLACKWELL PUBLIC SCHOOLS,AGAINST THE PROPOSITION - NO,,360404,0,0,0,0,PROPOSITION NO. 2 BLACKWELL PUBLIC SCHOOLS
KAY,PROPOSITION NO. 1 BLACKWELL PUBLIC SCHOOLS,FOR THE PROPOSITION - YES,,360406,0,0,0,0,PROPOSITION NO. 1 BLACKWELL PUBLIC SCHOOLS
KAY,PROPOSITION NO. 1 BLACKWELL PUBLIC SCHOOLS,AGAINST THE PROPOSITION - NO,,360406,0,0,0,0,PROPOSITION NO. 1 BLACKWELL PUBLIC SCHOOLS
KAY,PROPOSITION NO. 2 BLACKWELL PUBLIC SCHOOLS,FOR THE PROPOSITION - YES,,360406,0,0,0,0,PROPOSITION NO. 2 BLACKWELL PUBLIC SCHOOLS
KAY,PROPOSITION NO. 2 BLACKWELL PUBLIC SCHOOLS,AGAINST THE PROPOSITION - NO,,360406,0,0,0,0,PROPOSITION NO. 2 BLACKWELL PUBLIC SCHOOLS
KAY,PROPOSITION NO. 1 BLACKWELL PUBLIC SCHOOLS,FOR THE PROPOSITION - YES,,360409,0,0,0,0,PROPOSITION NO. 1 BLACKWELL PUBLIC SCHOOLS
KAY,PROPOSITION NO. 1 BLACKWELL PUBLIC SCHOOLS,AGAINST THE PROPOSITION - NO,,360409,0,0,0,0,PROPOSITION NO. 1 BLACKWELL PUBLIC SCHOOLS
KAY,PROPOSITION NO. 2 BLACKWELL PUBLIC SCHOOLS,FOR THE PROPOSITION - YES,,360409,0,0,0,0,PROPOSITION NO. 2 BLACKWELL PUBLIC SCHOOLS
KAY,PROPOSITION NO. 2 BLACKWELL PUBLIC SCHOOLS,AGAINST THE PROPOSITION - NO,,360409,0,0,0,0,PROPOSITION NO. 2 BLACKWELL PUBLIC SCHOOLS
KAY,PROPOSITION NO. 1 BLACKWELL PUBLIC SCHOOLS,FOR THE PROPOSITION - YES,,360420,0,0,0,0,PROPOSITION NO. 1 BLACKWELL PUBLIC SCHOOLS
KAY,PROPOSITION NO. 1 BLACKWELL PUBLIC SCHOOLS,AGAINST THE PROPOSITION - NO,,360420,0,0,0,0,PROPOSITION NO. 1 BLACKWELL PUBLIC SCHOOLS
KAY,PROPOSITION NO. 2 BLACKWELL PUBLIC SCHOOLS,FOR THE PROPOSITION - YES,,360420,0,0,0,0,PROPOSITION NO. 2 BLACKWELL PUBLIC SCHOOLS
KAY,PROPOSITION NO. 2 BLACKWELL PUBLIC SCHOOLS,AGAINST THE PROPOSITION - NO,,360420,0,0,0,0,PROPOSITION NO. 2 BLACKWELL PUBLIC SCHOOLS
LINCOLN,PROPOSITION CUSHING PUBLIC SCHOOLS,FOR THE PROPOSITION - YES,,410004,0,0,0,0,
LINCOLN,PROPOSITION CUSHING PUBLIC SCHOOLS,AGAINST THE PROPOSITION - NO,,410004,0,0,0,0,
LINCOLN,PROPOSITION NO. 1 OAK GROVE PUBLIC SCHOOL,FOR THE PROPOSITION - YES,,410004,0,0,0,0,PROPOSITION NO. 1 OAK GROVE PUBLIC SCHOOL
LINCOLN,PROPOSITION NO. 1 OAK GROVE PUBLIC SCHOOL,AGAINST THE PROPOSITION - NO,,410004,0,0,0,0,PROPOSITION NO. 1 OAK GROVE PUBLIC SCHOOL
LINCOLN,PROPOSITION NO. 2 OAK GROVE PUBLIC SCHOOL,FOR THE PROPOSITION - YES,,410004,0,0,0,0,PROPOSITION NO. 2 OAK GROVE PUBLIC SCHOOL
LINCOLN,PROPOSITION NO. 2 OAK GROVE PUBLIC SCHOOL,AGAINST THE PROPOSITION - NO,,410004,0,0,0,0,PROPOSITION NO. 2 OAK GROVE PUBLIC SCHOOL
LINCOLN,PROPOSITION CUSHING PUBLIC SCHOOLS,FOR THE PROPOSITION - YES,,410005,0,0,0,0,
LINCOLN,PROPOSITION CUSHING PUBLIC SCHOOLS,AGAINST THE PROPOSITION - NO,,410005,0,0,1,1,
LOVE,PROPOSITION MARIETTA PUBLIC SCHOOLS,FOR THE PROPOSITION - YES,,430101,1,2,54,57,
LOVE,PROPOSITION MARIETTA PUBLIC SCHOOLS,AGAINST THE PROPOSITION - NO,,430101,0,1,2,3,
LOVE,PROPOSITION MARIETTA PUBLIC SCHOOLS,FOR THE PROPOSITION - YES,,430102,0,2,34,36,
LOVE,PROPOSITION MARIETTA PUBLIC SCHOOLS,AGAINST THE PROPOSITION - NO,,430102,0,2,5,7,
LOVE,PROPOSITION MARIETTA PUBLIC SCHOOLS,FOR THE PROPOSITION - YES,,430204,1,1,29,31,
LOVE,PROPOSITION MARIETTA PUBLIC SCHOOLS,AGAINST THE PROPOSITION - NO,,430204,0,0,8,8,
LOVE,PROPOSITION MARIETTA PUBLIC SCHOOLS,FOR THE PROPOSITION - YES,,430310,3,3,32,38,
LOVE,PROPOSITION MARIETTA PUBLIC SCHOOLS,AGAINST THE PROPOSITION - NO,,430310,0,0,2,2,
LOVE,PROPOSITION MARIETTA PUBLIC SCHOOLS,FOR THE PROPOSITION - YES,,430312,0,1,31,32,
LOVE,PROPOSITION MARIETTA PUBLIC SCHOOLS,AGAINST THE PROPOSITION - NO,,430312,0,0,0,0,
MUSKOGEE,PROPOSITION 1 HILLDALE PUBLIC SCHOOLS,FOR THE PROPOSITION - YES,,510009,0,3,26,29,PROPOSITION 1 HILLDALE PUBLIC SCHOOLS
MUSKOGEE,PROPOSITION 1 HILLDALE PUBLIC SCHOOLS,AGAINST THE PROPOSITION - NO,,510009,0,2,18,20,PROPOSITION 1 HILLDALE PUBLIC SCHOOLS
MUSKOGEE,PROPOSITION 2 HILLDALE PUBLIC SCHOOLS,FOR THE PROPOSITION - YES,,510009,0,3,27,30,PROPOSITION 2 HILLDALE PUBLIC SCHOOLS
MUSKOGEE,PROPOSITION 2 HILLDALE PUBLIC SCHOOLS,AGAINST THE PROPOSITION - NO,,510009,0,2,17,19,PROPOSITION 2 HILLDALE PUBLIC SCHOOLS
MUSKOGEE,PROPOSITION 1 HILLDALE PUBLIC SCHOOLS,FOR THE PROPOSITION - YES,,510011,0,0,1,1,PROPOSITION 1 HILLDALE PUBLIC SCHOOLS
MUSKOGEE,PROPOSITION 1 HILLDALE PUBLIC SCHOOLS,AGAINST THE PROPOSITION - NO,,510011,0,0,0,0,PROPOSITION 1 HILLDALE PUBLIC SCHOOLS
MUSKOGEE,PROPOSITION 2 HILLDALE PUBLIC SCHOOLS,FOR THE PROPOSITION - YES,,510011,0,0,1,1,PROPOSITION 2 HILLDALE PUBLIC SCHOOLS
MUSKOGEE,PROPOSITION 2 HILLDALE PUBLIC SCHOOLS,AGAINST THE PROPOSITION - NO,,510011,0,0,0,0,PROPOSITION 2 HILLDALE PUBLIC SCHOOLS
MUSKOGEE,PROPOSITION 1 HILLDALE PUBLIC SCHOOLS,FOR THE PROPOSITION - YES,,510013,0,0,18,18,PROPOSITION 1 HILLDALE PUBLIC SCHOOLS
MUSKOGEE,PROPOSITION 1 HILLDALE PUBLIC SCHOOLS,AGAINST THE PROPOSITION - NO,,510013,0,0,11,11,PROPOSITION 1 HILLDALE PUBLIC SCHOOLS
MUSKOGEE,PROPOSITION 2 HILLDALE PUBLIC SCHOOLS,FOR THE PROPOSITION - YES,,510013,0,0,18,18,PROPOSITION 2 HILLDALE PUBLIC SCHOOLS
MUSKOGEE,PROPOSITION 2 HILLDALE PUBLIC SCHOOLS,AGAINST THE PROPOSITION - NO,,510013,0,0,11,11,PROPOSITION 2 HILLDALE PUBLIC SCHOOLS
MUSKOGEE,PROPOSITION 1 HILLDALE PUBLIC SCHOOLS,FOR THE PROPOSITION - YES,,510037,0,0,0,0,PROPOSITION 1 HILLDALE PUBLIC SCHOOLS
MUSKOGEE,PROPOSITION 1 HILLDALE PUBLIC SCHOOLS,AGAINST THE PROPOSITION - NO,,510037,0,0,0,0,PROPOSITION 1 HILLDALE PUBLIC SCHOOLS
MUSKOGEE,PROPOSITION 2 HILLDALE PUBLIC SCHOOLS,FOR THE PROPOSITION - YES,,510037,0,0,0,0,PROPOSITION 2 HILLDALE PUBLIC SCHOOLS
MUSKOGEE,PROPOSITION 2 HILLDALE PUBLIC SCHOOLS,AGAINST THE PROPOSITION - NO,,510037,0,0,0,0,PROPOSITION 2 HILLDALE PUBLIC SCHOOLS
MUSKOGEE,PROPOSITION 1 HILLDALE PUBLIC SCHOOLS,FOR THE PROPOSITION - YES,,510046,4,10,148,162,PROPOSITION 1 HILLDALE PUBLIC SCHOOLS
MUSKOGEE,PROPOSITION 1 HILLDALE PUBLIC SCHOOLS,AGAINST THE PROPOSITION - NO,,510046,1,6,99,106,PROPOSITION 1 HILLDALE PUBLIC SCHOOLS
MUSKOGEE,PROPOSITION 2 HILLDALE PUBLIC SCHOOLS,FOR THE PROPOSITION - YES,,510046,4,10,155,169,PROPOSITION 2 HILLDALE PUBLIC SCHOOLS
MUSKOGEE,PROPOSITION 2 HILLDALE PUBLIC SCHOOLS,AGAINST THE PROPOSITION - NO,,510046,1,6,95,102,PROPOSITION 2 HILLDALE PUBLIC SCHOOLS
MUSKOGEE,PROPOSITION 1 HILLDALE PUBLIC SCHOOLS,FOR THE PROPOSITION - YES,,510047,0,5,39,44,PROPOSITION 1 HILLDALE PUBLIC SCHOOLS
MUSKOGEE,PROPOSITION 1 HILLDALE PUBLIC SCHOOLS,AGAINST THE PROPOSITION - NO,,510047,0,7,42,49,PROPOSITION 1 HILLDALE PUBLIC SCHOOLS
MUSKOGEE,PROPOSITION 2 HILLDALE PUBLIC SCHOOLS,FOR THE PROPOSITION - YES,,510047,0,5,44,49,PROPOSITION 2 HILLDALE PUBLIC SCHOOLS
MUSKOGEE,PROPOSITION 2 HILLDALE PUBLIC SCHOOLS,AGAINST THE PROPOSITION - NO,,510047,0,7,40,47,PROPOSITION 2 HILLDALE PUBLIC SCHOOLS
MUSKOGEE,PROPOSITION 1 HILLDALE PUBLIC SCHOOLS,FOR THE PROPOSITION - YES,,510055,0,11,158,169,PROPOSITION 1 HILLDALE PUBLIC SCHOOLS
MUSKOGEE,PROPOSITION 1 HILLDALE PUBLIC SCHOOLS,AGAINST THE PROPOSITION - NO,,510055,1,14,114,129,PROPOSITION 1 HILLDALE PUBLIC SCHOOLS
MUSKOGEE,PROPOSITION 2 HILLDALE PUBLIC SCHOOLS,FOR THE PROPOSITION - YES,,510055,0,11,171,182,PROPOSITION 2 HILLDALE PUBLIC SCHOOLS
MUSKOGEE,PROPOSITION 2 HILLDALE PUBLIC SCHOOLS,AGAINST THE PROPOSITION - NO,,510055,1,14,105,120,PROPOSITION 2 HILLDALE PUBLIC SCHOOLS
MUSKOGEE,PROPOSITION 1 HILLDALE PUBLIC SCHOOLS,FOR THE PROPOSITION - YES,,510061,0,0,10,10,PROPOSITION 1 HILLDALE PUBLIC SCHOOLS
MUSKOGEE,PROPOSITION 1 HILLDALE PUBLIC SCHOOLS,AGAINST THE PROPOSITION - NO,,510061,0,0,7,7,PROPOSITION 1 HILLDALE PUBLIC SCHOOLS
MUSKOGEE,PROPOSITION 2 HILLDALE PUBLIC SCHOOLS,FOR THE PROPOSITION - YES,,510061,0,0,10,10,PROPOSITION 2 HILLDALE PUBLIC SCHOOLS
MUSKOGEE,PROPOSITION 2 HILLDALE PUBLIC SCHOOLS,AGAINST THE PROPOSITION - NO,,510061,0,0,7,7,PROPOSITION 2 HILLDALE PUBLIC SCHOOLS
OKMULGEE,PROPOSITION CITY OF BEGGS,FOR THE PROPOSITION - YES,,560020,0,0,36,36,
OKMULGEE,PROPOSITION CITY OF BEGGS,AGAINST THE PROPOSITION - NO,,560020,1,0,1,2,
OKMULGEE,PROPOSITION LIBERTY PUBLIC SCHOOLS,FOR THE PROPOSITION - YES,,560027,2,0,2,4,
OKMULGEE,PROPOSITION LIBERTY PUBLIC SCHOOLS,AGAINST THE PROPOSITION - NO,,560027,1,0,0,1,
OKMULGEE,PROPOSITION CITY OF BEGGS,FOR THE PROPOSITION - YES,,560029,0,0,0,0,
OKMULGEE,PROPOSITION CITY OF BEGGS,AGAINST THE PROPOSITION - NO,,560029,0,0,0,0,
OKMULGEE,PROPOSITION LIBERTY PUBLIC SCHOOLS,FOR THE PROPOSITION - YES,,560029,0,0,17,17,
OKMULGEE,PROPOSITION LIBERTY PUBLIC SCHOOLS,AGAINST THE PROPOSITION - NO,,560029,0,0,1,1,
OKMULGEE,PROPOSITION CITY OF BEGGS,FOR THE PROPOSITION - YES,,560033,0,0,0,0,
OKMULGEE,PROPOSITION CITY OF BEGGS,AGAINST THE PROPOSITION - NO,,560033,0,0,0,0,
OSAGE,PROPOSITION BARNSDALL PUBLIC SCHOOLS,FOR THE PROPOSITION - YES,,570102,0,0,2,2,
OSAGE,PROPOSITION BARNSDALL PUBLIC SCHOOLS,AGAINST THE PROPOSITION - NO,,570102,0,0,5,5,
OSAGE,PROPOSITION WYNONA PUBLIC SCHOOLS,FOR THE PROPOSITION - YES,,570108,0,1,2,3,
OSAGE,PROPOSITION WYNONA PUBLIC SCHOOLS,AGAINST THE PROPOSITION - NO,,570108,0,0,0,0,
OSAGE,PROPOSITION BARNSDALL PUBLIC SCHOOLS,FOR THE PROPOSITION - YES,,570109,1,0,3,4,
OSAGE,PROPOSITION BARNSDALL PUBLIC SCHOOLS,AGAINST THE PROPOSITION - NO,,570109,1,0,0,1,
OSAGE,PROPOSITION BARNSDALL PUBLIC SCHOOLS,FOR THE PROPOSITION - YES,,570110,8,2,115,125,
OSAGE,PROPOSITION BARNSDALL PUBLIC SCHOOLS,AGAINST THE PROPOSITION - NO,,570110,5,1,81,87,
OSAGE,PROPOSITION TOWN OF WYNONA,FOR THE PROPOSITION - YES,,570111,0,0,51,51,
OSAGE,PROPOSITION TOWN OF WYNONA,AGAINST THE PROPOSITION - NO,,570111,0,0,2,2,
OSAGE,PROPOSITION WYNONA PUBLIC SCHOOLS,FOR THE PROPOSITION - YES,,570111,0,1,62,63,
OSAGE,PROPOSITION WYNONA PUBLIC SCHOOLS,AGAINST THE PROPOSITION - NO,,570111,0,1,13,14,
OSAGE,PROPOSITION BARNSDALL PUBLIC SCHOOLS,FOR THE PROPOSITION - YES,,570112,1,0,2,3,
OSAGE,PROPOSITION BARNSDALL PUBLIC SCHOOLS,AGAINST THE PROPOSITION - NO,,570112,0,0,3,3,
OSAGE,PROPOSITION WYNONA PUBLIC SCHOOLS,FOR THE PROPOSITION - YES,,570112,0,0,0,0,
OSAGE,PROPOSITION WYNONA PUBLIC SCHOOLS,AGAINST THE PROPOSITION - NO,,570112,0,0,0,0,
OSAGE,PROPOSITION WYNONA PUBLIC SCHOOLS,FOR THE PROPOSITION - YES,,570306,0,0,5,5,
OSAGE,PROPOSITION WYNONA PUBLIC SCHOOLS,AGAINST THE PROPOSITION - NO,,570306,0,0,0,0,
PAYNE,PROPOSITION CUSHING PUBLIC SCHOOLS,FOR THE PROPOSITION - YES,,600101,0,0,64,64,
PAYNE,PROPOSITION CUSHING PUBLIC SCHOOLS,AGAINST THE PROPOSITION - NO,,600101,2,0,17,19,
PAYNE,PROPOSITION CUSHING PUBLIC SCHOOLS,FOR THE PROPOSITION - YES,,600102,0,1,82,83,
PAYNE,PROPOSITION CUSHING PUBLIC SCHOOLS,AGAINST THE PROPOSITION - NO,,600102,1,0,23,24,
PAYNE,PROPOSITION CUSHING PUBLIC SCHOOLS,FOR THE PROPOSITION - YES,,600103,1,1,73,75,
PAYNE,PROPOSITION CUSHING PUBLIC SCHOOLS,AGAINST THE PROPOSITION - NO,,600103,5,0,13,18,
PAYNE,PROPOSITION CUSHING PUBLIC SCHOOLS,FOR THE PROPOSITION - YES,,600104,0,0,47,47,
PAYNE,PROPOSITION CUSHING PUBLIC SCHOOLS,AGAINST THE PROPOSITION - NO,,600104,2,0,6,8,
PAYNE,PROPOSITION NO. 1 OAK GROVE PUBLIC SCHOOL,FOR THE PROPOSITION - YES,,600104,1,0,40,41,PROPOSITION NO. 1 OAK GROVE PUBLIC SCHOOL
PAYNE,PROPOSITION NO. 1 OAK GROVE PUBLIC SCHOOL,AGAINST THE PROPOSITION - NO,,600104,1,0,13,14,PROPOSITION NO. 1 OAK GROVE PUBLIC SCHOOL
PAYNE,PROPOSITION NO. 2 OAK GROVE PUBLIC SCHOOL,FOR THE PROPOSITION - YES,,600104,1,0,41,42,PROPOSITION NO. 2 OAK GROVE PUBLIC SCHOOL
PAYNE,PROPOSITION NO. 2 OAK GROVE PUBLIC SCHOOL,AGAINST THE PROPOSITION - NO,,600104,1,0,13,14,PROPOSITION NO. 2 OAK GROVE PUBLIC SCHOOL
PAYNE,PROPOSITION CUSHING PUBLIC SCHOOLS,FOR THE PROPOSITION - YES,,600409,0,0,7,7,
PAYNE,PROPOSITION CUSHING PUBLIC SCHOOLS,AGAINST THE PROPOSITION - NO,,600409,0,0,0,0,
POTTAWATOMIE,PROPOSITION STROTHER PUBLIC SCHOOLS,FOR THE PROPOSITION - YES,,630021,0,0,5,5,
POTTAWATOMIE,PROPOSITION STROTHER PUBLIC SCHOOLS,AGAINST THE PROPOSITION - NO,,630021,0,0,4,4,
POTTAWATOMIE,State Representative,ZACK TAYLOR,Republican,630024,2,0,30,32,28
POTTAWATOMIE,State Representative,MIKE MATLOCK,Republican,630024,6,0,56,62,28
POTTAWATOMIE,State Representative,DANIEL J. MATTHEWS,Republican,630024,4,5,61,70,28
POTTAWATOMIE,State Representative,BILLY CHOATE,Republican,630024,0,0,0,0,28
POTTAWATOMIE,State Representative,BLAKE CUMMINGS,Democratic,630024,1,0,4,5,28
POTTAWATOMIE,State Representative,MARILYN RAINWATER,Democratic,630024,1,0,13,14,28
POTTAWATOMIE,State Representative,JASON LEONARD,Democratic,630024,2,0,5,7,28
POTTAWATOMIE,State Representative,STEVE BARNES,Democratic,630024,2,2,9,13,28
POTTAWATOMIE,State Representative,YASMINDA CHOATE,Democratic,630024,0,0,2,2,28
POTTAWATOMIE,State Representative,ZACK TAYLOR,Republican,630025,0,0,21,21,28
POTTAWATOMIE,State Representative,MIKE MATLOCK,Republican,630025,0,0,1,1,28
POTTAWATOMIE,State Representative,DANIEL J. MATTHEWS,Republican,630025,4,0,13,17,28
POTTAWATOMIE,State Representative,BILLY CHOATE,Republican,630025,0,0,0,0,28
POTTAWATOMIE,State Representative,BLAKE CUMMINGS,Democratic,630025,0,0,4,4,28
POTTAWATOMIE,State Representative,MARILYN RAINWATER,Democratic,630025,2,0,4,6,28
POTTAWATOMIE,State Representative,JASON LEONARD,Democratic,630025,0,0,0,0,28
POTTAWATOMIE,State Representative,STEVE BARNES,Democratic,630025,0,0,6,6,28
POTTAWATOMIE,State Representative,YASMINDA CHOATE,Democratic,630025,0,0,4,4,28
POTTAWATOMIE,State Representative,ZACK TAYLOR,Republican,630031,7,1,58,66,28
POTTAWATOMIE,State Representative,MIKE MATLOCK,Republican,630031,1,0,32,33,28
POTTAWATOMIE,State Representative,DANIEL J. MATTHEWS,Republican,630031,1,5,29,35,28
POTTAWATOMIE,State Representative,BILLY CHOATE,Republican,630031,0,0,2,2,28
POTTAWATOMIE,State Representative,BLAKE CUMMINGS,Democratic,630031,2,0,5,7,28
POTTAWATOMIE,State Representative,MARILYN RAINWATER,Democratic,630031,0,1,17,18,28
POTTAWATOMIE,State Representative,JASON LEONARD,Democratic,630031,1,0,3,4,28
POTTAWATOMIE,State Representative,STEVE BARNES,Democratic,630031,1,0,22,23,28
POTTAWATOMIE,State Representative,YASMINDA CHOATE,Democratic,630031,0,0,16,16,28
SEMINOLE,State Representative,ZACK TAYLOR,Republican,670010,1,14,75,90,28
SEMINOLE,State Representative,MIKE MATLOCK,Republican,670010,0,0,12,12,28
SEMINOLE,State Representative,DANIEL J. MATTHEWS,Republican,670010,0,0,8,8,28
SEMINOLE,State Representative,BILLY CHOATE,Republican,670010,1,0,14,15,28
SEMINOLE,State Representative,BLAKE CUMMINGS,Democratic,670010,0,1,5,6,28
SEMINOLE,State Representative,MARILYN RAINWATER,Democratic,670010,0,1,69,70,28
SEMINOLE,State Representative,JASON LEONARD,Democratic,670010,0,0,14,14,28
SEMINOLE,State Representative,STEVE BARNES,Democratic,670010,4,4,43,51,28
SEMINOLE,State Representative,YASMINDA CHOATE,Democratic,670010,0,0,6,6,28
SEMINOLE,State Representative,ZACK TAYLOR,Republican,670012,0,0,15,15,28
SEMINOLE,State Representative,MIKE MATLOCK,Republican,670012,2,0,1,3,28
SEMINOLE,State Representative,DANIEL J. MATTHEWS,Republican,670012,0,0,0,0,28
SEMINOLE,State Representative,BILLY CHOATE,Republican,670012,0,0,0,0,28
SEMINOLE,State Representative,BLAKE CUMMINGS,Democratic,670012,0,0,3,3,28
SEMINOLE,State Representative,MARILYN RAINWATER,Democratic,670012,0,0,0,0,28
SEMINOLE,State Representative,JASON LEONARD,Democratic,670012,0,0,0,0,28
SEMINOLE,State Representative,STEVE BARNES,Democratic,670012,0,1,3,4,28
SEMINOLE,State Representative,YASMINDA CHOATE,Democratic,670012,0,0,1,1,28
SEMINOLE,State Representative,ZACK TAYLOR,Republican,670014,6,0,43,49,28
SEMINOLE,State Representative,MIKE MATLOCK,Republican,670014,0,0,3,3,28
SEMINOLE,State Representative,DANIEL J. MATTHEWS,Republican,670014,0,0,11,11,28
SEMINOLE,State Representative,BILLY CHOATE,Republican,670014,3,0,1,4,28
SEMINOLE,State Representative,BLAKE CUMMINGS,Democratic,670014,0,0,7,7,28
SEMINOLE,State Representative,MARILYN RAINWATER,Democratic,670014,1,0,16,17,28
SEMINOLE,State Representative,JASON LEONARD,Democratic,670014,1,0,2,3,28
SEMINOLE,State Representative,STEVE BARNES,Democratic,670014,0,0,22,22,28
SEMINOLE,State Representative,YASMINDA CHOATE,Democratic,670014,0,1,6,7,28
SEMINOLE,State Representative,ZACK TAYLOR,Republican,670015,1,1,15,17,28
SEMINOLE,State Representative,MIKE MATLOCK,Republican,670015,2,1,2,5,28
SEMINOLE,State Representative,DANIEL J. MATTHEWS,Republican,670015,0,0,1,1,28
SEMINOLE,State Representative,BILLY CHOATE,Republican,670015,2,0,6,8,28
SEMINOLE,State Representative,BLAKE CUMMINGS,Democratic,670015,0,0,0,0,28
SEMINOLE,State Representative,MARILYN RAINWATER,Democratic,670015,0,1,5,6,28
SEMINOLE,State Representative,JASON LEONARD,Democratic,670015,0,0,0,0,28
SEMINOLE,State Representative,STEVE BARNES,Democratic,670015,0,2,26,28,28
SEMINOLE,State Representative,YASMINDA CHOATE,Democratic,670015,1,1,17,19,28
SEMINOLE,State Representative,ZACK TAYLOR,Republican,670020,3,8,52,63,28
SEMINOLE,State Representative,MIKE MATLOCK,Republican,670020,0,0,30,30,28
SEMINOLE,State Representative,DANIEL J. MATTHEWS,Republican,670020,0,0,6,6,28
SEMINOLE,State Representative,BILLY CHOATE,Republican,670020,0,0,6,6,28
SEMINOLE,State Representative,BLAKE CUMMINGS,Democratic,670020,0,0,15,15,28
SEMINOLE,State Representative,MARILYN RAINWATER,Democratic,670020,0,0,29,29,28
SEMINOLE,State Representative,JASON LEONARD,Democratic,670020,0,0,15,15,28
SEMINOLE,State Representative,STEVE BARNES,Democratic,670020,2,0,46,48,28
SEMINOLE,State Representative,YASMINDA CHOATE,Democratic,670020,0,0,5,5,28
SEMINOLE,PROPOSITION STROTHER PUBLIC SCHOOLS,FOR THE PROPOSITION - YES,,670020,0,0,88,88,
SEMINOLE,PROPOSITION STROTHER PUBLIC SCHOOLS,AGAINST THE PROPOSITION - NO,,670020,2,3,66,71,
SEMINOLE,State Representative,ZACK TAYLOR,Republican,670022,4,6,57,67,28
SEMINOLE,State Representative,MIKE MATLOCK,Republican,670022,0,0,13,13,28
SEMINOLE,State Representative,DANIEL J. MATTHEWS,Republican,670022,0,0,12,12,28
SEMINOLE,State Representative,BILLY CHOATE,Republican,670022,2,3,5,10,28
SEMINOLE,State Representative,BLAKE CUMMINGS,Democratic,670022,0,2,10,12,28
SEMINOLE,State Representative,MARILYN RAINWATER,Democratic,670022,1,0,36,37,28
SEMINOLE,State Representative,JASON LEONARD,Democratic,670022,0,0,9,9,28
SEMINOLE,State Representative,STEVE BARNES,Democratic,670022,1,2,20,23,28
SEMINOLE,State Representative,YASMINDA CHOATE,Democratic,670022,0,0,6,6,28
SEMINOLE,State Representative,ZACK TAYLOR,Republican,670023,3,4,80,87,28
SEMINOLE,State Representative,MIKE MATLOCK,Republican,670023,1,1,11,13,28
SEMINOLE,State Representative,DANIEL J. MATTHEWS,Republican,670023,0,2,20,22,28
SEMINOLE,State Representative,BILLY CHOATE,Republican,670023,0,0,6,6,28
SEMINOLE,State Representative,BLAKE CUMMINGS,Democratic,670023,0,0,3,3,28
SEMINOLE,State Representative,MARILYN RAINWATER,Democratic,670023,1,5,49,55,28
SEMINOLE,State Representative,JASON LEONARD,Democratic,670023,1,0,5,6,28
SEMINOLE,State Representative,STEVE BARNES,Democratic,670023,1,3,38,42,28
SEMINOLE,State Representative,YASMINDA CHOATE,Democratic,670023,0,0,8,8,28
SEMINOLE,State Representative,ZACK TAYLOR,Republican,670024,0,0,49,49,28
SEMINOLE,State Representative,MIKE MATLOCK,Republican,670024,0,0,8,8,28
SEMINOLE,State Representative,DANIEL J. MATTHEWS,Republican,670024,0,0,7,7,28
SEMINOLE,State Representative,BILLY CHOATE,Republican,670024,0,0,1,1,28
SEMINOLE,State Representative,BLAKE CUMMINGS,Democratic,670024,0,2,2,4,28
SEMINOLE,State Representative,MARILYN RAINWATER,Democratic,670024,0,0,22,22,28
SEMINOLE,State Representative,JASON LEONARD,Democratic,670024,0,0,4,4,28
SEMINOLE,State Representative,STEVE BARNES,Democratic,670024,1,0,15,16,28
SEMINOLE,State Representative,YASMINDA CHOATE,Democratic,670024,0,0,4,4,28
SEMINOLE,State Representative,ZACK TAYLOR,Republican,670025,0,0,11,11,28
SEMINOLE,State Representative,MIKE MATLOCK,Republican,670025,0,0,0,0,28
SEMINOLE,State Representative,DANIEL J. MATTHEWS,Republican,670025,0,0,3,3,28
SEMINOLE,State Representative,BILLY CHOATE,Republican,670025,0,0,0,0,28
SEMINOLE,State Representative,BLAKE CUMMINGS,Democratic,670025,2,0,4,6,28
SEMINOLE,State Representative,MARILYN RAINWATER,Democratic,670025,0,0,2,2,28
SEMINOLE,State Representative,JASON LEONARD,Democratic,670025,0,0,1,1,28
SEMINOLE,State Representative,STEVE BARNES,Democratic,670025,0,2,2,4,28
SEMINOLE,State Representative,YASMINDA CHOATE,Democratic,670025,1,0,1,2,28
SEMINOLE,State Representative,ZACK TAYLOR,Republican,670030,0,0,18,18,28
SEMINOLE,State Representative,MIKE MATLOCK,Republican,670030,0,0,3,3,28
SEMINOLE,State Representative,DANIEL J. MATTHEWS,Republican,670030,0,0,0,0,28
SEMINOLE,State Representative,BILLY CHOATE,Republican,670030,0,0,0,0,28
SEMINOLE,State Representative,BLAKE CUMMINGS,Democratic,670030,0,0,0,0,28
SEMINOLE,State Representative,MARILYN RAINWATER,Democratic,670030,0,0,7,7,28
SEMINOLE,State Representative,JASON LEONARD,Democratic,670030,0,0,6,6,28
SEMINOLE,State Representative,STEVE BARNES,Democratic,670030,0,1,5,6,28
SEMINOLE,State Representative,YASMINDA CHOATE,Democratic,670030,0,0,3,3,28
SEMINOLE,PROPOSITION STROTHER PUBLIC SCHOOLS,FOR THE PROPOSITION - YES,,670030,0,0,0,0,
SEMINOLE,PROPOSITION STROTHER PUBLIC SCHOOLS,AGAINST THE PROPOSITION - NO,,670030,0,0,0,0,
SEMINOLE,State Representative,ZACK TAYLOR,Republican,670032,2,4,19,25,28
SEMINOLE,State Representative,MIKE MATLOCK,Republican,670032,0,2,11,13,28
SEMINOLE,State Representative,DANIEL J. MATTHEWS,Republican,670032,2,2,5,9,28
SEMINOLE,State Representative,BILLY CHOATE,Republican,670032,0,0,3,3,28
SEMINOLE,State Representative,BLAKE CUMMINGS,Democratic,670032,0,1,1,2,28
SEMINOLE,State Representative,MARILYN RAINWATER,Democratic,670032,1,4,15,20,28
SEMINOLE,State Representative,JASON LEONARD,Democratic,670032,0,0,1,1,28
SEMINOLE,State Representative,STEVE BARNES,Democratic,670032,1,11,36,48,28
SEMINOLE,State Representative,YASMINDA CHOATE,Democratic,670032,0,1,6,7,28
SEMINOLE,PROPOSITION STROTHER PUBLIC SCHOOLS,FOR THE PROPOSITION - YES,,670032,0,0,0,0,
SEMINOLE,PROPOSITION STROTHER PUBLIC SCHOOLS,AGAINST THE PROPOSITION - NO,,670032,0,0,0,0,
SEMINOLE,State Representative,ZACK TAYLOR,Republican,670033,0,0,4,4,28
SEMINOLE,State Representative,MIKE MATLOCK,Republican,670033,0,0,1,1,28
SEMINOLE,State Representative,DANIEL J. MATTHEWS,Republican,670033,0,0,1,1,28
SEMINOLE,State Representative,BILLY CHOATE,Republican,670033,0,0,0,0,28
SEMINOLE,State Representative,BLAKE CUMMINGS,Democratic,670033,0,0,0,0,28
SEMINOLE,State Representative,MARILYN RAINWATER,Democratic,670033,0,0,2,2,28
SEMINOLE,State Representative,JASON LEONARD,Democratic,670033,0,0,0,0,28
SEMINOLE,State Representative,STEVE BARNES,Democratic,670033,0,3,5,8,28
SEMINOLE,State Representative,YASMINDA CHOATE,Democratic,670033,0,0,0,0,28
SEMINOLE,State Representative,ZACK TAYLOR,Republican,670034,0,4,39,43,28
SEMINOLE,State Representative,MIKE MATLOCK,Republican,670034,3,0,7,10,28
SEMINOLE,State Representative,DANIEL J. MATTHEWS,Republican,670034,0,1,4,5,28
SEMINOLE,State Representative,BILLY CHOATE,Republican,670034,0,2,3,5,28
SEMINOLE,State Representative,BLAKE CUMMINGS,Democratic,670034,0,1,1,2,28
SEMINOLE,State Representative,MARILYN RAINWATER,Democratic,670034,1,3,24,28,28
SEMINOLE,State Representative,JASON LEONARD,Democratic,670034,0,1,1,2,28
SEMINOLE,State Representative,STEVE BARNES,Democratic,670034,0,11,57,68,28
SEMINOLE,State Representative,YASMINDA CHOATE,Democratic,670034,0,0,4,4,28
SEMINOLE,State Representative,ZACK TAYLOR,Republican,670035,1,1,35,37,28
SEMINOLE,State Representative,MIKE MATLOCK,Republican,670035,1,0,33,34,28
SEMINOLE,State Representative,DANIEL J. MATTHEWS,Republican,670035,0,0,4,4,28
SEMINOLE,State Representative,BILLY CHOATE,Republican,670035,0,0,4,4,28
SEMINOLE,State Representative,BLAKE CUMMINGS,Democratic,670035,0,0,2,2,28
SEMINOLE,State Representative,MARILYN RAINWATER,Democratic,670035,1,2,27,30,28
SEMINOLE,State Representative,JASON LEONARD,Democratic,670035,0,0,19,19,28
SEMINOLE,State Representative,STEVE BARNES,Democratic,670035,0,1,30,31,28
SEMINOLE,State Representative,YASMINDA CHOATE,Democratic,670035,0,0,6,6,28
SEMINOLE,PROPOSITION STROTHER PUBLIC SCHOOLS,FOR THE PROPOSITION - YES,,670035,3,4,118,125,
SEMINOLE,PROPOSITION STROTHER PUBLIC SCHOOLS,AGAINST THE PROPOSITION - NO,,670035,1,0,49,50,
TULSA,PROPOSITION LIBERTY PUBLIC SCHOOLS,FOR THE PROPOSITION - YES,,720352,0,0,6,6,
TULSA,PROPOSITION LIBERTY PUBLIC SCHOOLS,AGAINST THE PROPOSITION - NO,,720352,0,0,2,2,
TULSA,PROPOSITION 1 GLENPOOL PUBLIC SCHOOLS,FOR THE PROPOSITION - YES,,720705,0,0,130,130,PROPOSITION 1 GLENPOOL PUBLIC SCHOOLS
TULSA,PROPOSITION 1 GLENPOOL PUBLIC SCHOOLS,AGAINST THE PROPOSITION - NO,,720705,0,0,28,28,PROPOSITION 1 GLENPOOL PUBLIC SCHOOLS
TULSA,PROPOSITION 2 GLENPOOL PUBLIC SCHOOLS,FOR THE PROPOSITION - YES,,720705,0,0,129,129,PROPOSITION 2 GLENPOOL PUBLIC SCHOOLS
TULSA,PROPOSITION 2 GLENPOOL PUBLIC SCHOOLS,AGAINST THE PROPOSITION - NO,,720705,0,0,30,30,PROPOSITION 2 GLENPOOL PUBLIC SCHOOLS
TULSA,PROPOSITION LIBERTY PUBLIC SCHOOLS,FOR THE PROPOSITION - YES,,720705,0,0,0,0,
TULSA,PROPOSITION LIBERTY PUBLIC SCHOOLS,AGAINST THE PROPOSITION - NO,,720705,0,0,0,0,
TULSA,PROPOSITION 1 GLENPOOL PUBLIC SCHOOLS,FOR THE PROPOSITION - YES,,720706,0,0,223,223,PROPOSITION 1 GLENPOOL PUBLIC SCHOOLS
TULSA,PROPOSITION 1 GLENPOOL PUBLIC SCHOOLS,AGAINST THE PROPOSITION - NO,,720706,0,0,51,51,PROPOSITION 1 GLENPOOL PUBLIC SCHOOLS
TULSA,PROPOSITION 2 GLENPOOL PUBLIC SCHOOLS,FOR THE PROPOSITION - YES,,720706,0,0,222,222,PROPOSITION 2 GLENPOOL PUBLIC SCHOOLS
TULSA,PROPOSITION 2 GLENPOOL PUBLIC SCHOOLS,AGAINST THE PROPOSITION - NO,,720706,0,0,55,55,PROPOSITION 2 GLENPOOL PUBLIC SCHOOLS
TULSA,PROPOSITION 1 GLENPOOL PUBLIC SCHOOLS,FOR THE PROPOSITION - YES,,720707,0,0,101,101,PROPOSITION 1 GLENPOOL PUBLIC SCHOOLS
TULSA,PROPOSITION 1 GLENPOOL PUBLIC SCHOOLS,AGAINST THE PROPOSITION - NO,,720707,0,0,15,15,PROPOSITION 1 GLENPOOL PUBLIC SCHOOLS
TULSA,PROPOSITION 2 GLENPOOL PUBLIC SCHOOLS,FOR THE PROPOSITION - YES,,720707,0,0,103,103,PROPOSITION 2 GLENPOOL PUBLIC SCHOOLS
TULSA,PROPOSITION 2 GLENPOOL PUBLIC SCHOOLS,AGAINST THE PROPOSITION - NO,,720707,0,0,13,13,PROPOSITION 2 GLENPOOL PUBLIC SCHOOLS
TULSA,PROPOSITION 1 GLENPOOL PUBLIC SCHOOLS,FOR THE PROPOSITION - YES,,720708,0,0,97,97,PROPOSITION 1 GLENPOOL PUBLIC SCHOOLS
TULSA,PROPOSITION 1 GLENPOOL PUBLIC SCHOOLS,AGAINST THE PROPOSITION - NO,,720708,0,0,16,16,PROPOSITION 1 GLENPOOL PUBLIC SCHOOLS
TULSA,PROPOSITION 2 GLENPOOL PUBLIC SCHOOLS,FOR THE PROPOSITION - YES,,720708,0,0,95,95,PROPOSITION 2 GLENPOOL PUBLIC SCHOOLS
TULSA,PROPOSITION 2 GLENPOOL PUBLIC SCHOOLS,AGAINST THE PROPOSITION - NO,,720708,0,0,19,19,PROPOSITION 2 GLENPOOL PUBLIC SCHOOLS
TULSA,PROPOSITION LIBERTY PUBLIC SCHOOLS,FOR THE PROPOSITION - YES,,720710,0,0,19,19,
TULSA,PROPOSITION LIBERTY PUBLIC SCHOOLS,AGAINST THE PROPOSITION - NO,,720710,0,0,3,3,
TULSA,PROPOSITION 1 GLENPOOL PUBLIC SCHOOLS,FOR THE PROPOSITION - YES,,729999,6,3,0,9,PROPOSITION 1 GLENPOOL PUBLIC SCHOOLS
TULSA,PROPOSITION 1 GLENPOOL PUBLIC SCHOOLS,AGAINST THE PROPOSITION - NO,,729999,7,2,0,9,PROPOSITION 1 GLENPOOL PUBLIC SCHOOLS
TULSA,PROPOSITION 2 GLENPOOL PUBLIC SCHOOLS,FOR THE PROPOSITION - YES,,729999,7,3,0,10,PROPOSITION 2 GLENPOOL PUBLIC SCHOOLS
TULSA,PROPOSITION 2 GLENPOOL PUBLIC SCHOOLS,AGAINST THE PROPOSITION - NO,,729999,6,2,0,8,PROPOSITION 2 GLENPOOL PUBLIC SCHOOLS
TULSA,PROPOSITION LIBERTY PUBLIC SCHOOLS,FOR THE PROPOSITION - YES,,729999,0,0,0,0,
TULSA,PROPOSITION LIBERTY PUBLIC SCHOOLS,AGAINST THE PROPOSITION - NO,,729999,1,0,0,1,
WAGONER,PROPOSITION NO. 1 PORTER CONSOLIDATED SCHOOLS,FOR THE PROPOSITION - YES,,730202,0,0,0,0,PROPOSITION NO. 1 PORTER CONSOLIDATED SCHOOLS
WAGONER,PROPOSITION NO. 1 PORTER CONSOLIDATED SCHOOLS,AGAINST THE PROPOSITION - NO,,730202,0,0,2,2,PROPOSITION NO. 1 PORTER CONSOLIDATED SCHOOLS
WAGONER,PROPOSITION NO. 2 PORTER CONSOLIDATED SCHOOLS,FOR THE PROPOSITION - YES,,730202,0,0,0,0,PROPOSITION NO. 2 PORTER CONSOLIDATED SCHOOLS
WAGONER,PROPOSITION NO. 2 PORTER CONSOLIDATED SCHOOLS,AGAINST THE PROPOSITION - NO,,730202,0,0,1,1,PROPOSITION NO. 2 PORTER CONSOLIDATED SCHOOLS
WAGONER,PROPOSITION NO. 1 PORTER CONSOLIDATED SCHOOLS,FOR THE PROPOSITION - YES,,730203,0,0,0,0,PROPOSITION NO. 1 PORTER CONSOLIDATED SCHOOLS
WAGONER,PROPOSITION NO. 1 PORTER CONSOLIDATED SCHOOLS,AGAINST THE PROPOSITION - NO,,730203,0,0,0,0,PROPOSITION NO. 1 PORTER CONSOLIDATED SCHOOLS
WAGONER,PROPOSITION NO. 2 PORTER CONSOLIDATED SCHOOLS,FOR THE PROPOSITION - YES,,730203,0,0,0,0,PROPOSITION NO. 2 PORTER CONSOLIDATED SCHOOLS
WAGONER,PROPOSITION NO. 2 PORTER CONSOLIDATED SCHOOLS,AGAINST THE PROPOSITION - NO,,730203,0,0,0,0,PROPOSITION NO. 2 PORTER CONSOLIDATED SCHOOLS
WAGONER,PROPOSITION NO. 1 PORTER CONSOLIDATED SCHOOLS,FOR THE PROPOSITION - YES,,730210,0,0,6,6,PROPOSITION NO. 1 PORTER CONSOLIDATED SCHOOLS
WAGONER,PROPOSITION NO. 1 PORTER CONSOLIDATED SCHOOLS,AGAINST THE PROPOSITION - NO,,730210,0,0,0,0,PROPOSITION NO. 1 PORTER CONSOLIDATED SCHOOLS
WAGONER,PROPOSITION NO. 2 PORTER CONSOLIDATED SCHOOLS,FOR THE PROPOSITION - YES,,730210,0,0,6,6,PROPOSITION NO. 2 PORTER CONSOLIDATED SCHOOLS
WAGONER,PROPOSITION NO. 2 PORTER CONSOLIDATED SCHOOLS,AGAINST THE PROPOSITION - NO,,730210,0,0,0,0,PROPOSITION NO. 2 PORTER CONSOLIDATED SCHOOLS
WAGONER,PROPOSITION NO. 1 PORTER CONSOLIDATED SCHOOLS,FOR THE PROPOSITION - YES,,730311,0,3,16,19,PROPOSITION NO. 1 PORTER CONSOLIDATED SCHOOLS
WAGONER,PROPOSITION NO. 1 PORTER CONSOLIDATED SCHOOLS,AGAINST THE PROPOSITION - NO,,730311,0,0,4,4,PROPOSITION NO. 1 PORTER CONSOLIDATED SCHOOLS
WAGONER,PROPOSITION NO. 2 PORTER CONSOLIDATED SCHOOLS,FOR THE PROPOSITION - YES,,730311,0,3,17,20,PROPOSITION NO. 2 PORTER CONSOLIDATED SCHOOLS
WAGONER,PROPOSITION NO. 2 PORTER CONSOLIDATED SCHOOLS,AGAINST THE PROPOSITION - NO,,730311,0,0,3,3,PROPOSITION NO. 2 PORTER CONSOLIDATED SCHOOLS
WAGONER,PROPOSITION NO. 1 PORTER CONSOLIDATED SCHOOLS,FOR THE PROPOSITION - YES,,730312,1,2,112,115,PROPOSITION NO. 1 PORTER CONSOLIDATED SCHOOLS
WAGONER,PROPOSITION NO. 1 PORTER CONSOLIDATED SCHOOLS,AGAINST THE PROPOSITION - NO,,730312,0,1,55,56,PROPOSITION NO. 1 PORTER CONSOLIDATED SCHOOLS
WAGONER,PROPOSITION NO. 2 PORTER CONSOLIDATED SCHOOLS,FOR THE PROPOSITION - YES,,730312,1,2,129,132,PROPOSITION NO. 2 PORTER CONSOLIDATED SCHOOLS
WAGONER,PROPOSITION NO. 2 PORTER CONSOLIDATED SCHOOLS,AGAINST THE PROPOSITION - NO,,730312,0,1,39,40,PROPOSITION NO. 2 PORTER CONSOLIDATED SCHOOLS
WAGONER,PROPOSITION NO. 1 PORTER CONSOLIDATED SCHOOLS,FOR THE PROPOSITION - YES,,730313,0,1,59,60,PROPOSITION NO. 1 PORTER CONSOLIDATED SCHOOLS
WAGONER,PROPOSITION NO. 1 PORTER CONSOLIDATED SCHOOLS,AGAINST THE PROPOSITION - NO,,730313,0,3,43,46,PROPOSITION NO. 1 PORTER CONSOLIDATED SCHOOLS
WAGONER,PROPOSITION NO. 2 PORTER CONSOLIDATED SCHOOLS,FOR THE PROPOSITION - YES,,730313,0,3,69,72,PROPOSITION NO. 2 PORTER CONSOLIDATED SCHOOLS
WAGONER,PROPOSITION NO. 2 PORTER CONSOLIDATED SCHOOLS,AGAINST THE PROPOSITION - NO,,730313,0,2,34,36,PROPOSITION NO. 2 PORTER CONSOLIDATED SCHOOLS
