county,office,candidate,party,precinct,mail_votes,early_votes,elec_day_votes,votes,district
ADAIR,PROPOSITION STILWELL PUBLIC SCHOOLS,FOR THE PROPOSITION - YES,,10001,0,0,0,0,
ADAIR,PROPOSITION STILWELL PUBLIC SCHOOLS,AGAINST THE PROPOSITION - NO,,10001,0,0,0,0,
ADAIR,PROPOSITION STILWELL PUBLIC SCHOOLS,FOR THE PROPOSITION - YES,,10004,0,1,18,19,
ADAIR,PROPOSITION STILWELL PUBLIC SCHOOLS,AGAINST THE PROPOSITION - NO,,10004,2,0,14,16,
ADAIR,PROPOSITION STILWELL PUBLIC SCHOOLS,FOR THE PROPOSITION - YES,,10006,0,0,7,7,
ADAIR,PROPOSITION STILWELL PUBLIC SCHOOLS,AGAINST THE PROPOSITION - NO,,10006,0,0,5,5,
ADAIR,PROPOSITION STILWELL PUBLIC SCHOOLS,FOR THE PROPOSITION - YES,,10007,0,0,46,46,
ADAIR,PROPOSITION STILWELL PUBLIC SCHOOLS,AGAINST THE PROPOSITION - NO,,10007,0,3,31,34,
ADAIR,PROPOSITION STILWELL PUBLIC SCHOOLS,FOR THE PROPOSITION - YES,,10008,0,0,11,11,
ADAIR,PROPOSITION STILWELL PUBLIC SCHOOLS,AGAINST THE PROPOSITION - NO,,10008,0,0,7,7,
ADAIR,PROPOSITION STILWELL PUBLIC SCHOOLS,FOR THE PROPOSITION - YES,,10010,0,0,0,0,
ADAIR,PROPOSITION STILWELL PUBLIC SCHOOLS,AGAINST THE PROPOSITION - NO,,10010,0,0,8,8,
ADAIR,PROPOSITION STILWELL PUBLIC SCHOOLS,FOR THE PROPOSITION - YES,,10011,0,0,2,2,
ADAIR,PROPOSITION STILWELL PUBLIC SCHOOLS,AGAINST THE PROPOSITION - NO,,10011,0,1,4,5,
ADAIR,PROPOSITION STILWELL PUBLIC SCHOOLS,FOR THE PROPOSITION - YES,,10012,0,0,16,16,
ADAIR,PROPOSITION STILWELL PUBLIC SCHOOLS,AGAINST THE PROPOSITION - NO,,10012,0,2,51,53,
ADAIR,PROPOSITION STILWELL PUBLIC SCHOOLS,FOR THE PROPOSITION - YES,,10013,8,3,33,44,
ADAIR,PROPOSITION STILWELL PUBLIC SCHOOLS,AGAINST THE PROPOSITION - NO,,10013,0,1,21,22,
ADAIR,PROPOSITION STILWELL PUBLIC SCHOOLS,FOR THE PROPOSITION - YES,,10014,2,4,53,59,
ADAIR,PROPOSITION STILWELL PUBLIC SCHOOLS,AGAINST THE PROPOSITION - NO,,10014,0,3,47,50,
CANADIAN,State Senator,SCOTT HARRIS,Republican,90211,0,0,17,17,45
CANADIAN,State Senator,PAUL ROSINO,Republican,90211,2,0,12,14,45
CANADIAN,State Senator,DUANE SMITH,Republican,90211,0,0,2,2,45
CANADIAN,State Senator,MATHEW HAMRICK,Republican,90211,0,0,3,3,45
CANADIAN,State Senator,DIANE MEANS,Republican,90211,0,1,8,9,45
CANADIAN,State Senator,BRIAN WALTERS,Republican,90211,3,0,21,24,45
CANADIAN,State Senator,KERRY PETTINGILL,Republican,90211,0,0,8,8,45
CANADIAN,State Senator,STEVEN VINCENT,Democratic,90211,1,0,18,19,45
CANADIAN,State Senator,NOAH S. YNCLAN,Democratic,90211,0,0,0,0,45
CANADIAN,State Senator,SCOTT HARRIS,Republican,90215,4,0,17,21,45
CANADIAN,State Senator,PAUL ROSINO,Republican,90215,2,0,22,24,45
CANADIAN,State Senator,DUANE SMITH,Republican,90215,0,0,5,5,45
CANADIAN,State Senator,MATHEW HAMRICK,Republican,90215,0,0,6,6,45
CANADIAN,State Senator,DIANE MEANS,Republican,90215,1,0,55,56,45
CANADIAN,State Senator,BRIAN WALTERS,Republican,90215,5,0,45,50,45
CANADIAN,State Senator,KERRY PETTINGILL,Republican,90215,0,0,13,13,45
CANADIAN,State Senator,STEVEN VINCENT,Democratic,90215,3,0,41,44,45
CANADIAN,State Senator,NOAH S. YNCLAN,Democratic,90215,0,0,2,2,45
CANADIAN,State Senator,SCOTT HARRIS,Republican,90221,1,0,18,19,45
CANADIAN,State Senator,PAUL ROSINO,Republican,90221,2,0,10,12,45
CANADIAN,State Senator,DUANE SMITH,Republican,90221,0,0,4,4,45
CANADIAN,State Senator,MATHEW HAMRICK,Republican,90221,0,0,4,4,45
CANADIAN,State Senator,DIANE MEANS,Republican,90221,4,0,27,31,45
CANADIAN,State Senator,BRIAN WALTERS,Republican,90221,2,0,16,18,45
CANADIAN,State Senator,KERRY PETTINGILL,Republican,90221,0,0,6,6,45
CANADIAN,State Senator,STEVEN VINCENT,Democratic,90221,4,0,33,37,45
CANADIAN,State Senator,NOAH S. YNCLAN,Democratic,90221,0,0,4,4,45
CANADIAN,State Senator,SCOTT HARRIS,Republican,90223,1,0,12,13,45
CANADIAN,State Senator,PAUL ROSINO,Republican,90223,0,0,17,17,45
CANADIAN,State Senator,DUANE SMITH,Republican,90223,3,0,4,7,45
CANADIAN,State Senator,MATHEW HAMRICK,Republican,90223,0,0,5,5,45
CANADIAN,State Senator,DIANE MEANS,Republican,90223,3,0,45,48,45
CANADIAN,State Senator,BRIAN WALTERS,Republican,90223,2,2,31,35,45
CANADIAN,State Senator,KERRY PETTINGILL,Republican,90223,0,0,36,36,45
CANADIAN,State Senator,STEVEN VINCENT,Democratic,90223,2,0,53,55,45
CANADIAN,State Senator,NOAH S. YNCLAN,Democratic,90223,1,0,2,3,45
CANADIAN,State Senator,SCOTT HARRIS,Republican,90300,0,0,16,16,45
CANADIAN,State Senator,PAUL ROSINO,Republican,90300,11,0,63,74,45
CANADIAN,State Senator,DUANE SMITH,Republican,90300,0,0,18,18,45
CANADIAN,State Senator,MATHEW HAMRICK,Republican,90300,1,0,4,5,45
CANADIAN,State Senator,DIANE MEANS,Republican,90300,2,0,37,39,45
CANADIAN,State Senator,BRIAN WALTERS,Republican,90300,1,1,23,25,45
CANADIAN,State Senator,KERRY PETTINGILL,Republican,90300,0,2,28,30,45
CANADIAN,State Senator,STEVEN VINCENT,Democratic,90300,0,0,42,42,45
CANADIAN,State Senator,NOAH S. YNCLAN,Democratic,90300,1,0,1,2,45
CANADIAN,State Senator,SCOTT HARRIS,Republican,90301,5,0,16,21,45
CANADIAN,State Senator,PAUL ROSINO,Republican,90301,4,1,48,53,45
CANADIAN,State Senator,DUANE SMITH,Republican,90301,3,0,33,36,45
CANADIAN,State Senator,MATHEW HAMRICK,Republican,90301,0,0,1,1,45
CANADIAN,State Senator,DIANE MEANS,Republican,90301,7,0,52,59,45
CANADIAN,State Senator,BRIAN WALTERS,Republican,90301,0,1,55,56,45
CANADIAN,State Senator,KERRY PETTINGILL,Republican,90301,3,0,9,12,45
CANADIAN,State Senator,STEVEN VINCENT,Democratic,90301,8,0,56,64,45
CANADIAN,State Senator,NOAH S. YNCLAN,Democratic,90301,1,0,2,3,45
CANADIAN,State Senator,SCOTT HARRIS,Republican,90302,2,0,14,16,45
CANADIAN,State Senator,PAUL ROSINO,Republican,90302,4,0,40,44,45
CANADIAN,State Senator,DUANE SMITH,Republican,90302,0,0,9,9,45
CANADIAN,State Senator,MATHEW HAMRICK,Republican,90302,0,0,3,3,45
CANADIAN,State Senator,DIANE MEANS,Republican,90302,2,0,23,25,45
CANADIAN,State Senator,BRIAN WALTERS,Republican,90302,1,0,32,33,45
CANADIAN,State Senator,KERRY PETTINGILL,Republican,90302,0,0,16,16,45
CANADIAN,State Senator,STEVEN VINCENT,Democratic,90302,4,0,41,45,45
CANADIAN,State Senator,NOAH S. YNCLAN,Democratic,90302,0,0,6,6,45
CANADIAN,State Senator,SCOTT HARRIS,Republican,90303,1,0,36,37,45
CANADIAN,State Senator,PAUL ROSINO,Republican,90303,1,0,36,37,45
CANADIAN,State Senator,DUANE SMITH,Republican,90303,3,0,17,20,45
CANADIAN,State Senator,MATHEW HAMRICK,Republican,90303,0,0,0,0,45
CANADIAN,State Senator,DIANE MEANS,Republican,90303,3,0,13,16,45
CANADIAN,State Senator,BRIAN WALTERS,Republican,90303,3,1,36,40,45
CANADIAN,State Senator,KERRY PETTINGILL,Republican,90303,3,0,22,25,45
CANADIAN,State Senator,STEVEN VINCENT,Democratic,90303,3,0,47,50,45
CANADIAN,State Senator,NOAH S. YNCLAN,Democratic,90303,1,0,2,3,45
CANADIAN,State Senator,SCOTT HARRIS,Republican,90304,4,0,12,16,45
CANADIAN,State Senator,PAUL ROSINO,Republican,90304,3,0,60,63,45
CANADIAN,State Senator,DUANE SMITH,Republican,90304,0,0,24,24,45
CANADIAN,State Senator,MATHEW HAMRICK,Republican,90304,0,0,1,1,45
CANADIAN,State Senator,DIANE MEANS,Republican,90304,3,0,45,48,45
CANADIAN,State Senator,BRIAN WALTERS,Republican,90304,0,0,28,28,45
CANADIAN,State Senator,KERRY PETTINGILL,Republican,90304,2,0,10,12,45
CANADIAN,State Senator,STEVEN VINCENT,Democratic,90304,0,0,40,40,45
CANADIAN,State Senator,NOAH S. YNCLAN,Democratic,90304,0,0,1,1,45
CANADIAN,State Senator,SCOTT HARRIS,Republican,90306,2,0,45,47,45
CANADIAN,State Senator,PAUL ROSINO,Republican,90306,9,0,83,92,45
CANADIAN,State Senator,DUANE SMITH,Republican,90306,2,0,16,18,45
CANADIAN,State Senator,MATHEW HAMRICK,Republican,90306,1,0,4,5,45
CANADIAN,State Senator,DIANE MEANS,Republican,90306,2,3,71,76,45
CANADIAN,State Senator,BRIAN WALTERS,Republican,90306,1,0,55,56,45
CANADIAN,State Senator,KERRY PETTINGILL,Republican,90306,2,0,48,50,45
CANADIAN,State Senator,STEVEN VINCENT,Democratic,90306,3,1,63,67,45
CANADIAN,State Senator,NOAH S. YNCLAN,Democratic,90306,0,0,2,2,45
CLEVELAND,State Senator,SCOTT HARRIS,Republican,140004,6,1,5,12,45
CLEVELAND,State Senator,PAUL ROSINO,Republican,140004,9,3,151,163,45
CLEVELAND,State Senator,DUANE SMITH,Republican,140004,2,0,14,16,45
CLEVELAND,State Senator,MATHEW HAMRICK,Republican,140004,2,0,2,4,45
CLEVELAND,State Senator,DIANE MEANS,Republican,140004,11,0,44,55,45
CLEVELAND,State Senator,BRIAN WALTERS,Republican,140004,7,0,79,86,45
CLEVELAND,State Senator,KERRY PETTINGILL,Republican,140004,1,0,11,12,45
CLEVELAND,State Senator,STEVEN VINCENT,Democratic,140004,12,0,75,87,45
CLEVELAND,State Senator,NOAH S. YNCLAN,Democratic,140004,2,0,12,14,45
CLEVELAND,State Senator,SCOTT HARRIS,Republican,140007,0,0,5,5,45
CLEVELAND,State Senator,PAUL ROSINO,Republican,140007,4,0,32,36,45
CLEVELAND,State Senator,DUANE SMITH,Republican,140007,0,0,8,8,45
CLEVELAND,State Senator,MATHEW HAMRICK,Republican,140007,0,0,2,2,45
CLEVELAND,State Senator,DIANE MEANS,Republican,140007,0,0,12,12,45
CLEVELAND,State Senator,BRIAN WALTERS,Republican,140007,2,0,28,30,45
CLEVELAND,State Senator,KERRY PETTINGILL,Republican,140007,0,0,13,13,45
CLEVELAND,State Senator,STEVEN VINCENT,Democratic,140007,6,0,28,34,45
CLEVELAND,State Senator,NOAH S. YNCLAN,Democratic,140007,1,0,2,3,45
CLEVELAND,State Senator,SCOTT HARRIS,Republican,140010,0,0,8,8,45
CLEVELAND,State Senator,PAUL ROSINO,Republican,140010,2,0,18,20,45
CLEVELAND,State Senator,DUANE SMITH,Republican,140010,0,0,0,0,45
CLEVELAND,State Senator,MATHEW HAMRICK,Republican,140010,0,0,1,1,45
CLEVELAND,State Senator,DIANE MEANS,Republican,140010,8,0,31,39,45
CLEVELAND,State Senator,BRIAN WALTERS,Republican,140010,3,0,40,43,45
CLEVELAND,State Senator,KERRY PETTINGILL,Republican,140010,2,0,7,9,45
CLEVELAND,State Senator,STEVEN VINCENT,Democratic,140010,3,0,37,40,45
CLEVELAND,State Senator,NOAH S. YNCLAN,Democratic,140010,1,0,1,2,45
CLEVELAND,State Senator,SCOTT HARRIS,Republican,140040,2,0,13,15,45
CLEVELAND,State Senator,PAUL ROSINO,Republican,140040,6,0,86,92,45
CLEVELAND,State Senator,DUANE SMITH,Republican,140040,3,0,7,10,45
CLEVELAND,State Senator,MATHEW HAMRICK,Republican,140040,0,0,4,4,45
CLEVELAND,State Senator,DIANE MEANS,Republican,140040,4,0,21,25,45
CLEVELAND,State Senator,BRIAN WALTERS,Republican,140040,1,0,16,17,45
CLEVELAND,State Senator,KERRY PETTINGILL,Republican,140040,0,0,10,10,45
CLEVELAND,State Senator,STEVEN VINCENT,Democratic,140040,7,0,50,57,45
CLEVELAND,State Senator,NOAH S. YNCLAN,Democratic,140040,0,0,3,3,45
CLEVELAND,State Senator,SCOTT HARRIS,Republican,140041,1,0,4,5,45
CLEVELAND,State Senator,PAUL ROSINO,Republican,140041,0,0,29,29,45
CLEVELAND,State Senator,DUANE SMITH,Republican,140041,0,0,2,2,45
CLEVELAND,State Senator,MATHEW HAMRICK,Republican,140041,0,0,1,1,45
CLEVELAND,State Senator,DIANE MEANS,Republican,140041,0,0,12,12,45
CLEVELAND,State Senator,BRIAN WALTERS,Republican,140041,0,0,10,10,45
CLEVELAND,State Senator,KERRY PETTINGILL,Republican,140041,0,0,6,6,45
CLEVELAND,State Senator,STEVEN VINCENT,Democratic,140041,0,0,18,18,45
CLEVELAND,State Senator,NOAH S. YNCLAN,Democratic,140041,0,0,0,0,45
CLEVELAND,State Senator,SCOTT HARRIS,Republican,140050,2,0,8,10,45
CLEVELAND,State Senator,PAUL ROSINO,Republican,140050,2,0,84,86,45
CLEVELAND,State Senator,DUANE SMITH,Republican,140050,1,0,27,28,45
CLEVELAND,State Senator,MATHEW HAMRICK,Republican,140050,0,0,1,1,45
CLEVELAND,State Senator,DIANE MEANS,Republican,140050,4,0,38,42,45
CLEVELAND,State Senator,BRIAN WALTERS,Republican,140050,3,0,15,18,45
CLEVELAND,State Senator,KERRY PETTINGILL,Republican,140050,1,1,6,8,45
CLEVELAND,State Senator,STEVEN VINCENT,Democratic,140050,8,0,64,72,45
CLEVELAND,State Senator,NOAH S. YNCLAN,Democratic,140050,0,0,2,2,45
CLEVELAND,State Senator,SCOTT HARRIS,Republican,140061,6,0,6,12,45
CLEVELAND,State Senator,PAUL ROSINO,Republican,140061,14,2,105,121,45
CLEVELAND,State Senator,DUANE SMITH,Republican,140061,2,0,11,13,45
CLEVELAND,State Senator,MATHEW HAMRICK,Republican,140061,0,0,2,2,45
CLEVELAND,State Senator,DIANE MEANS,Republican,140061,6,0,34,40,45
CLEVELAND,State Senator,BRIAN WALTERS,Republican,140061,11,0,34,45,45
CLEVELAND,State Senator,KERRY PETTINGILL,Republican,140061,1,0,4,5,45
CLEVELAND,State Senator,STEVEN VINCENT,Democratic,140061,6,0,43,49,45
CLEVELAND,State Senator,NOAH S. YNCLAN,Democratic,140061,2,0,7,9,45
CLEVELAND,State Senator,SCOTT HARRIS,Republican,140069,1,0,3,4,45
CLEVELAND,State Senator,PAUL ROSINO,Republican,140069,7,0,106,113,45
CLEVELAND,State Senator,DUANE SMITH,Republican,140069,0,0,12,12,45
CLEVELAND,State Senator,MATHEW HAMRICK,Republican,140069,0,0,6,6,45
CLEVELAND,State Senator,DIANE MEANS,Republican,140069,6,0,38,44,45
CLEVELAND,State Senator,BRIAN WALTERS,Republican,140069,2,1,32,35,45
CLEVELAND,State Senator,KERRY PETTINGILL,Republican,140069,1,0,9,10,45
CLEVELAND,State Senator,STEVEN VINCENT,Democratic,140069,6,0,52,58,45
CLEVELAND,State Senator,NOAH S. YNCLAN,Democratic,140069,1,0,7,8,45
CLEVELAND,State Senator,SCOTT HARRIS,Republican,140080,1,0,1,2,45
CLEVELAND,State Senator,PAUL ROSINO,Republican,140080,1,0,3,4,45
CLEVELAND,State Senator,DUANE SMITH,Republican,140080,0,0,0,0,45
CLEVELAND,State Senator,MATHEW HAMRICK,Republican,140080,0,0,3,3,45
CLEVELAND,State Senator,DIANE MEANS,Republican,140080,1,0,19,20,45
CLEVELAND,State Senator,BRIAN WALTERS,Republican,140080,0,0,17,17,45
CLEVELAND,State Senator,KERRY PETTINGILL,Republican,140080,0,0,4,4,45
CLEVELAND,State Senator,STEVEN VINCENT,Democratic,140080,0,0,11,11,45
CLEVELAND,State Senator,NOAH S. YNCLAN,Democratic,140080,0,0,0,0,45
CLEVELAND,State Senator,SCOTT HARRIS,Republican,140090,0,0,0,0,45
CLEVELAND,State Senator,PAUL ROSINO,Republican,140090,0,0,0,0,45
CLEVELAND,State Senator,DUANE SMITH,Republican,140090,0,0,0,0,45
CLEVELAND,State Senator,MATHEW HAMRICK,Republican,140090,0,0,0,0,45
CLEVELAND,State Senator,DIANE MEANS,Republican,140090,0,0,0,0,45
CLEVELAND,State Senator,BRIAN WALTERS,Republican,140090,0,0,0,0,45
CLEVELAND,State Senator,KERRY PETTINGILL,Republican,140090,0,0,0,0,45
CLEVELAND,State Senator,STEVEN VINCENT,Democratic,140090,0,0,0,0,45
CLEVELAND,State Senator,NOAH S. YNCLAN,Democratic,140090,0,0,0,0,45
GRADY,PROPOSITION TOWN OF ALEX,FOR THE PROPOSITION - YES,,260020,0,0,24,24,
GRADY,PROPOSITION TOWN OF ALEX,AGAINST THE PROPOSITION - NO,,260020,0,1,1,2,
GRADY,PROPOSITION TOWN OF ALEX,FOR THE PROPOSITION - YES,,260031,0,0,0,0,
GRADY,PROPOSITION TOWN OF ALEX,AGAINST THE PROPOSITION - NO,,260031,0,0,0,0,
MAYES,PROPOSTION NO. 1 CITY OF PRYOR CREEK,FOR THE PROPOSITION - YES,,490101,3,1,56,60,PROPOSTION NO. 1 CITY OF PRYOR CREEK
MAYES,PROPOSTION NO. 1 CITY OF PRYOR CREEK,AGAINST THE PROPOSITION - NO,,490101,3,0,56,59,PROPOSTION NO. 1 CITY OF PRYOR CREEK
MAYES,PROPOSTION NO. 1 CITY OF PRYOR CREEK,FOR THE PROPOSITION - YES,,490121,1,9,90,100,PROPOSTION NO. 1 CITY OF PRYOR CREEK
MAYES,PROPOSTION NO. 1 CITY OF PRYOR CREEK,AGAINST THE PROPOSITION - NO,,490121,5,3,49,57,PROPOSTION NO. 1 CITY OF PRYOR CREEK
MAYES,PROPOSTION NO. 1 CITY OF PRYOR CREEK,FOR THE PROPOSITION - YES,,490132,6,16,86,108,PROPOSTION NO. 1 CITY OF PRYOR CREEK
MAYES,PROPOSTION NO. 1 CITY OF PRYOR CREEK,AGAINST THE PROPOSITION - NO,,490132,5,4,82,91,PROPOSTION NO. 1 CITY OF PRYOR CREEK
MAYES,PROPOSTION NO. 1 CITY OF PRYOR CREEK,FOR THE PROPOSITION - YES,,490241,8,16,224,248,PROPOSTION NO. 1 CITY OF PRYOR CREEK
MAYES,PROPOSTION NO. 1 CITY OF PRYOR CREEK,AGAINST THE PROPOSITION - NO,,490241,7,9,153,169,PROPOSTION NO. 1 CITY OF PRYOR CREEK
MAYES,PROPOSTION NO. 1 CITY OF PRYOR CREEK,FOR THE PROPOSITION - YES,,490242,2,1,85,88,PROPOSTION NO. 1 CITY OF PRYOR CREEK
MAYES,PROPOSTION NO. 1 CITY OF PRYOR CREEK,AGAINST THE PROPOSITION - NO,,490242,3,2,42,47,PROPOSTION NO. 1 CITY OF PRYOR CREEK
OKLAHOMA,State Senator,SCOTT HARRIS,Republican,550233,0,0,3,3,45
OKLAHOMA,State Senator,PAUL ROSINO,Republican,550233,0,0,3,3,45
OKLAHOMA,State Senator,DUANE SMITH,Republican,550233,0,0,0,0,45
OKLAHOMA,State Senator,MATHEW HAMRICK,Republican,550233,0,0,0,0,45
OKLAHOMA,State Senator,DIANE MEANS,Republican,550233,0,0,5,5,45
OKLAHOMA,State Senator,BRIAN WALTERS,Republican,550233,0,0,5,5,45
OKLAHOMA,State Senator,KERRY PETTINGILL,Republican,550233,0,0,2,2,45
OKLAHOMA,State Senator,STEVEN VINCENT,Democratic,550233,0,0,5,5,45
OKLAHOMA,State Senator,NOAH S. YNCLAN,Democratic,550233,0,0,1,1,45
OKLAHOMA,State Senator,SCOTT HARRIS,Republican,550234,0,0,2,2,45
OKLAHOMA,State Senator,PAUL ROSINO,Republican,550234,0,0,14,14,45
OKLAHOMA,State Senator,DUANE SMITH,Republican,550234,0,0,0,0,45
OKLAHOMA,State Senator,MATHEW HAMRICK,Republican,550234,0,0,1,1,45
OKLAHOMA,State Senator,DIANE MEANS,Republican,550234,0,0,6,6,45
OKLAHOMA,State Senator,BRIAN WALTERS,Republican,550234,0,0,7,7,45
OKLAHOMA,State Senator,KERRY PETTINGILL,Republican,550234,0,0,3,3,45
OKLAHOMA,State Senator,STEVEN VINCENT,Democratic,550234,0,0,18,18,45
OKLAHOMA,State Senator,NOAH S. YNCLAN,Democratic,550234,0,0,3,3,45
OKLAHOMA,State Senator,SCOTT HARRIS,Republican,550238,0,0,0,0,45
OKLAHOMA,State Senator,PAUL ROSINO,Republican,550238,0,0,0,0,45
OKLAHOMA,State Senator,DUANE SMITH,Republican,550238,0,0,0,0,45
OKLAHOMA,State Senator,MATHEW HAMRICK,Republican,550238,0,0,0,0,45
OKLAHOMA,State Senator,DIANE MEANS,Republican,550238,0,0,0,0,45
OKLAHOMA,State Senator,BRIAN WALTERS,Republican,550238,0,0,0,0,45
OKLAHOMA,State Senator,KERRY PETTINGILL,Republican,550238,0,0,0,0,45
OKLAHOMA,State Senator,STEVEN VINCENT,Democratic,550238,0,0,0,0,45
OKLAHOMA,State Senator,NOAH S. YNCLAN,Democratic,550238,0,0,0,0,45
OKLAHOMA,State Senator,SCOTT HARRIS,Republican,550246,0,0,1,1,45
OKLAHOMA,State Senator,PAUL ROSINO,Republican,550246,0,0,3,3,45
OKLAHOMA,State Senator,DUANE SMITH,Republican,550246,0,0,0,0,45
OKLAHOMA,State Senator,MATHEW HAMRICK,Republican,550246,0,0,0,0,45
OKLAHOMA,State Senator,DIANE MEANS,Republican,550246,0,0,1,1,45
OKLAHOMA,State Senator,BRIAN WALTERS,Republican,550246,0,0,1,1,45
OKLAHOMA,State Senator,KERRY PETTINGILL,Republican,550246,0,0,2,2,45
OKLAHOMA,State Senator,STEVEN VINCENT,Democratic,550246,0,0,3,3,45
OKLAHOMA,State Senator,NOAH S. YNCLAN,Democratic,550246,0,0,1,1,45
OKLAHOMA,State Senator,SCOTT HARRIS,Republican,550247,0,0,0,0,45
OKLAHOMA,State Senator,PAUL ROSINO,Republican,550247,0,0,3,3,45
OKLAHOMA,State Senator,DUANE SMITH,Republican,550247,0,0,0,0,45
OKLAHOMA,State Senator,MATHEW HAMRICK,Republican,550247,0,0,0,0,45
OKLAHOMA,State Senator,DIANE MEANS,Republican,550247,0,0,1,1,45
OKLAHOMA,State Senator,BRIAN WALTERS,Republican,550247,0,0,3,3,45
OKLAHOMA,State Senator,KERRY PETTINGILL,Republican,550247,0,0,1,1,45
OKLAHOMA,State Senator,STEVEN VINCENT,Democratic,550247,0,0,16,16,45
OKLAHOMA,State Senator,NOAH S. YNCLAN,Democratic,550247,0,0,1,1,45
OKLAHOMA,State Senator,SCOTT HARRIS,Republican,550248,0,0,5,5,45
OKLAHOMA,State Senator,PAUL ROSINO,Republican,550248,0,0,7,7,45
OKLAHOMA,State Senator,DUANE SMITH,Republican,550248,0,0,3,3,45
OKLAHOMA,State Senator,MATHEW HAMRICK,Republican,550248,0,0,1,1,45
OKLAHOMA,State Senator,DIANE MEANS,Republican,550248,0,0,20,20,45
OKLAHOMA,State Senator,BRIAN WALTERS,Republican,550248,0,0,15,15,45
OKLAHOMA,State Senator,KERRY PETTINGILL,Republican,550248,0,0,4,4,45
OKLAHOMA,State Senator,STEVEN VINCENT,Democratic,550248,0,0,65,65,45
OKLAHOMA,State Senator,NOAH S. YNCLAN,Democratic,550248,0,0,10,10,45
OKLAHOMA,State Senator,SCOTT HARRIS,Republican,559999,0,0,0,0,45
OKLAHOMA,State Senator,PAUL ROSINO,Republican,559999,3,0,0,3,45
OKLAHOMA,State Senator,DUANE SMITH,Republican,559999,3,0,0,3,45
OKLAHOMA,State Senator,MATHEW HAMRICK,Republican,559999,1,0,0,1,45
OKLAHOMA,State Senator,DIANE MEANS,Republican,559999,1,0,0,1,45
OKLAHOMA,State Senator,BRIAN WALTERS,Republican,559999,1,0,0,1,45
OKLAHOMA,State Senator,KERRY PETTINGILL,Republican,559999,0,0,0,0,45
OKLAHOMA,State Senator,STEVEN VINCENT,Democratic,559999,12,1,0,13,45
OKLAHOMA,State Senator,NOAH S. YNCLAN,Democratic,559999,2,0,0,2,45
STEPHENS,PROPOSITION CITY OF COMANCHE,FOR THE PROPOSITION - YES,,690041,1,0,24,25,
STEPHENS,PROPOSITION CITY OF COMANCHE,AGAINST THE PROPOSITION - NO,,690041,0,0,0,0,
STEPHENS,PROPOSITION CITY OF COMANCHE,FOR THE PROPOSITION - YES,,690061,0,0,0,0,
STEPHENS,PROPOSITION CITY OF COMANCHE,AGAINST THE PROPOSITION - NO,,690061,0,0,0,0,
STEPHENS,PROPOSITION CITY OF COMANCHE,FOR THE PROPOSITION - YES,,690062,0,0,0,0,
STEPHENS,PROPOSITION CITY OF COMANCHE,AGAINST THE PROPOSITION - NO,,690062,0,0,0,0,
TEXAS,PROPOSITION CITY OF HOOKER,FOR THE PROPOSITION - YES,,700101,1,0,15,16,
TEXAS,PROPOSITION CITY OF HOOKER,AGAINST THE PROPOSITION - NO,,700101,0,0,1,1,
TULSA,State Representative,SHELLEY BRUMBAUGH,Republican,720451,0,0,25,25,76
TULSA,State Representative,ROSS FORD,Republican,720451,0,0,15,15,76
TULSA,State Representative,JESS GUTHRIE,Republican,720451,0,0,2,2,76
TULSA,State Representative,BRIAN ELLIOTT,Republican,720451,0,0,22,22,76
TULSA,State Representative,CLIFF JOHNS,Republican,720451,0,0,13,13,76
TULSA,State Representative,FORREST MAYER,Democratic,720451,0,0,21,21,76
TULSA,State Representative,CHRIS VanLANDINGHAM,Democratic,720451,0,0,9,9,76
TULSA,State Representative,SHELLEY BRUMBAUGH,Republican,720454,0,0,47,47,76
TULSA,State Representative,ROSS FORD,Republican,720454,0,0,90,90,76
TULSA,State Representative,JESS GUTHRIE,Republican,720454,0,0,7,7,76
TULSA,State Representative,BRIAN ELLIOTT,Republican,720454,0,0,65,65,76
TULSA,State Representative,CLIFF JOHNS,Republican,720454,0,0,10,10,76
TULSA,State Representative,FORREST MAYER,Democratic,720454,0,0,21,21,76
TULSA,State Representative,CHRIS VanLANDINGHAM,Democratic,720454,0,0,29,29,76
TULSA,State Representative,SHELLEY BRUMBAUGH,Republican,720455,0,0,17,17,76
TULSA,State Representative,ROSS FORD,Republican,720455,0,0,13,13,76
TULSA,State Representative,JESS GUTHRIE,Republican,720455,0,0,1,1,76
TULSA,State Representative,BRIAN ELLIOTT,Republican,720455,0,0,15,15,76
TULSA,State Representative,CLIFF JOHNS,Republican,720455,0,0,10,10,76
TULSA,State Representative,FORREST MAYER,Democratic,720455,0,0,12,12,76
TULSA,State Representative,CHRIS VanLANDINGHAM,Democratic,720455,0,0,14,14,76
TULSA,State Representative,SHELLEY BRUMBAUGH,Republican,720456,0,0,60,60,76
TULSA,State Representative,ROSS FORD,Republican,720456,0,0,25,25,76
TULSA,State Representative,JESS GUTHRIE,Republican,720456,0,0,3,3,76
TULSA,State Representative,BRIAN ELLIOTT,Republican,720456,0,0,21,21,76
TULSA,State Representative,CLIFF JOHNS,Republican,720456,0,0,8,8,76
TULSA,State Representative,FORREST MAYER,Democratic,720456,0,0,12,12,76
TULSA,State Representative,CHRIS VanLANDINGHAM,Democratic,720456,0,0,17,17,76
TULSA,State Representative,SHELLEY BRUMBAUGH,Republican,720458,0,0,93,93,76
TULSA,State Representative,ROSS FORD,Republican,720458,0,0,82,82,76
TULSA,State Representative,JESS GUTHRIE,Republican,720458,0,0,2,2,76
TULSA,State Representative,BRIAN ELLIOTT,Republican,720458,0,0,68,68,76
TULSA,State Representative,CLIFF JOHNS,Republican,720458,0,0,16,16,76
TULSA,State Representative,FORREST MAYER,Democratic,720458,0,0,38,38,76
TULSA,State Representative,CHRIS VanLANDINGHAM,Democratic,720458,0,0,35,35,76
TULSA,State Representative,SHELLEY BRUMBAUGH,Republican,720462,0,0,65,65,76
TULSA,State Representative,ROSS FORD,Republican,720462,0,0,43,43,76
TULSA,State Representative,JESS GUTHRIE,Republican,720462,0,0,1,1,76
TULSA,State Representative,BRIAN ELLIOTT,Republican,720462,0,0,78,78,76
TULSA,State Representative,CLIFF JOHNS,Republican,720462,0,0,29,29,76
TULSA,State Representative,FORREST MAYER,Democratic,720462,0,0,24,24,76
TULSA,State Representative,CHRIS VanLANDINGHAM,Democratic,720462,0,0,23,23,76
TULSA,State Representative,SHELLEY BRUMBAUGH,Republican,720463,0,0,34,34,76
TULSA,State Representative,ROSS FORD,Republican,720463,0,0,18,18,76
TULSA,State Representative,JESS GUTHRIE,Republican,720463,0,0,2,2,76
TULSA,State Representative,BRIAN ELLIOTT,Republican,720463,0,0,25,25,76
TULSA,State Representative,CLIFF JOHNS,Republican,720463,0,0,21,21,76
TULSA,State Representative,FORREST MAYER,Democratic,720463,0,0,16,16,76
TULSA,State Representative,CHRIS VanLANDINGHAM,Democratic,720463,0,0,8,8,76
TULSA,State Representative,SHELLEY BRUMBAUGH,Republican,720465,0,0,35,35,76
TULSA,State Representative,ROSS FORD,Republican,720465,0,0,55,55,76
TULSA,State Representative,JESS GUTHRIE,Republican,720465,0,0,0,0,76
TULSA,State Representative,BRIAN ELLIOTT,Republican,720465,0,0,29,29,76
TULSA,State Representative,CLIFF JOHNS,Republican,720465,0,0,11,11,76
TULSA,State Representative,FORREST MAYER,Democratic,720465,0,0,16,16,76
TULSA,State Representative,CHRIS VanLANDINGHAM,Democratic,720465,0,0,12,12,76
TULSA,State Representative,SHELLEY BRUMBAUGH,Republican,720468,0,0,78,78,76
TULSA,State Representative,ROSS FORD,Republican,720468,0,0,76,76,76
TULSA,State Representative,JESS GUTHRIE,Republican,720468,0,0,2,2,76
TULSA,State Representative,BRIAN ELLIOTT,Republican,720468,0,0,90,90,76
TULSA,State Representative,CLIFF JOHNS,Republican,720468,0,0,21,21,76
TULSA,State Representative,FORREST MAYER,Democratic,720468,0,0,25,25,76
TULSA,State Representative,CHRIS VanLANDINGHAM,Democratic,720468,0,0,19,19,76
TULSA,State Representative,SHELLEY BRUMBAUGH,Republican,720470,0,0,34,34,76
TULSA,State Representative,ROSS FORD,Republican,720470,0,0,64,64,76
TULSA,State Representative,JESS GUTHRIE,Republican,720470,0,0,1,1,76
TULSA,State Representative,BRIAN ELLIOTT,Republican,720470,0,0,67,67,76
TULSA,State Representative,CLIFF JOHNS,Republican,720470,0,0,20,20,76
TULSA,State Representative,FORREST MAYER,Democratic,720470,0,0,13,13,76
TULSA,State Representative,CHRIS VanLANDINGHAM,Democratic,720470,0,0,63,63,76
TULSA,State Representative,SHELLEY BRUMBAUGH,Republican,720471,0,0,35,35,76
TULSA,State Representative,ROSS FORD,Republican,720471,0,0,55,55,76
TULSA,State Representative,JESS GUTHRIE,Republican,720471,0,0,0,0,76
TULSA,State Representative,BRIAN ELLIOTT,Republican,720471,0,0,48,48,76
TULSA,State Representative,CLIFF JOHNS,Republican,720471,0,0,4,4,76
TULSA,State Representative,FORREST MAYER,Democratic,720471,0,0,4,4,76
TULSA,State Representative,CHRIS VanLANDINGHAM,Democratic,720471,0,0,8,8,76
TULSA,State Representative,SHELLEY BRUMBAUGH,Republican,720474,0,0,79,79,76
TULSA,State Representative,ROSS FORD,Republican,720474,0,0,86,86,76
TULSA,State Representative,JESS GUTHRIE,Republican,720474,0,0,3,3,76
TULSA,State Representative,BRIAN ELLIOTT,Republican,720474,0,0,43,43,76
TULSA,State Representative,CLIFF JOHNS,Republican,720474,0,0,28,28,76
TULSA,State Representative,FORREST MAYER,Democratic,720474,0,0,30,30,76
TULSA,State Representative,CHRIS VanLANDINGHAM,Democratic,720474,0,0,42,42,76
TULSA,PROPOSITION CITY OF GLENPOOL,FOR THE PROPOSITION - YES,,720705,0,0,32,32,
TULSA,PROPOSITION CITY OF GLENPOOL,AGAINST THE PROPOSITION - NO,,720705,0,0,5,5,
TULSA,PROPOSITION CITY OF GLENPOOL,FOR THE PROPOSITION - YES,,720706,0,0,49,49,
TULSA,PROPOSITION CITY OF GLENPOOL,AGAINST THE PROPOSITION - NO,,720706,0,0,7,7,
TULSA,PROPOSITION CITY OF GLENPOOL,FOR THE PROPOSITION - YES,,720707,0,0,14,14,
TULSA,PROPOSITION CITY OF GLENPOOL,AGAINST THE PROPOSITION - NO,,720707,0,0,0,0,
TULSA,PROPOSITION CITY OF GLENPOOL,FOR THE PROPOSITION - YES,,720708,0,0,10,10,
TULSA,PROPOSITION CITY OF GLENPOOL,AGAINST THE PROPOSITION - NO,,720708,0,0,1,1,
TULSA,PROPOSITION CITY OF GLENPOOL,FOR THE PROPOSITION - YES,,720710,0,0,0,0,
TULSA,PROPOSITION CITY OF GLENPOOL,AGAINST THE PROPOSITION - NO,,720710,0,0,0,0,
TULSA,State Representative,SHELLEY BRUMBAUGH,Republican,729999,18,6,0,24,76
TULSA,State Representative,ROSS FORD,Republican,729999,19,4,0,23,76
TULSA,State Representative,JESS GUTHRIE,Republican,729999,3,0,0,3,76
TULSA,State Representative,BRIAN ELLIOTT,Republican,729999,22,5,0,27,76
TULSA,State Representative,CLIFF JOHNS,Republican,729999,8,2,0,10,76
TULSA,State Representative,FORREST MAYER,Democratic,729999,7,2,0,9,76
TULSA,State Representative,CHRIS VanLANDINGHAM,Democratic,729999,8,2,0,10,76
TULSA,PROPOSITION CITY OF GLENPOOL,FOR THE PROPOSITION - YES,,729999,12,0,0,12,
TULSA,PROPOSITION CITY OF GLENPOOL,AGAINST THE PROPOSITION - NO,,729999,4,0,0,4,
