county,office,candidate,party,precinct,mail_votes,early_votes,elec_day_votes,votes,district
ADAIR,OFFICE NO. 3 DAHLONEGAH PUBLIC SCHOOL,CLARISSA WOFFORD,,10001,12,8,84,104,OFFICE NO. 3 DAHLONEGAH PUBLIC SCHOOL
ADAIR,OFFICE NO. 3 DAHLONEGAH PUBLIC SCHOOL,KENNY LIMORE JR,,10001,14,2,16,32,OFFICE NO. 3 DAHLONEGAH PUBLIC SCHOOL
ADAIR,OFFICE NO. 2 INDIAN CAPITAL TECH CENTER,TOM STILES,,10001,13,3,78,94,OFFICE NO. 2 INDIAN CAPITAL TECH CENTER
ADAIR,OFFICE NO. 2 INDIAN CAPITAL TECH CENTER,RAY KIRK,,10001,6,6,26,38,OFFICE NO. 2 INDIAN CAPITAL TECH CENTER
ADAIR,OFFICE NO. 2 INDIAN CAPITAL TECH CENTER,TOM STILES,,10002,0,0,10,10,OFFICE NO. 2 INDIAN CAPITAL TECH CENTER
ADAIR,OFFICE NO. 2 INDIAN CAPITAL TECH CENTER,RAY KIRK,,10002,0,0,1,1,OFFICE NO. 2 INDIAN CAPITAL TECH CENTER
ADAIR,OFFICE NO. 2 INDIAN CAPITAL TECH CENTER,TOM STILES,,10003,0,0,0,0,OFFICE NO. 2 INDIAN CAPITAL TECH CENTER
ADAIR,OFFICE NO. 2 INDIAN CAPITAL TECH CENTER,RAY KIRK,,10003,0,0,7,7,OFFICE NO. 2 INDIAN CAPITAL TECH CENTER
ADAIR,OFFICE NO. 2 INDIAN CAPITAL TECH CENTER,TOM STILES,,10004,0,0,6,6,OFFICE NO. 2 INDIAN CAPITAL TECH CENTER
ADAIR,OFFICE NO. 2 INDIAN CAPITAL TECH CENTER,RAY KIRK,,10004,0,0,1,1,OFFICE NO. 2 INDIAN CAPITAL TECH CENTER
ADAIR,OFFICE NO. 2 INDIAN CAPITAL TECH CENTER,TOM STILES,,10005,0,0,4,4,OFFICE NO. 2 INDIAN CAPITAL TECH CENTER
ADAIR,OFFICE NO. 2 INDIAN CAPITAL TECH CENTER,RAY KIRK,,10005,0,1,4,5,OFFICE NO. 2 INDIAN CAPITAL TECH CENTER
ADAIR,OFFICE NO. 2 INDIAN CAPITAL TECH CENTER,TOM STILES,,10006,0,0,3,3,OFFICE NO. 2 INDIAN CAPITAL TECH CENTER
ADAIR,OFFICE NO. 2 INDIAN CAPITAL TECH CENTER,RAY KIRK,,10006,0,0,0,0,OFFICE NO. 2 INDIAN CAPITAL TECH CENTER
ADAIR,OFFICE NO. 2 INDIAN CAPITAL TECH CENTER,TOM STILES,,10007,0,2,11,13,OFFICE NO. 2 INDIAN CAPITAL TECH CENTER
ADAIR,OFFICE NO. 2 INDIAN CAPITAL TECH CENTER,RAY KIRK,,10007,0,4,2,6,OFFICE NO. 2 INDIAN CAPITAL TECH CENTER
ADAIR,OFFICE NO. 2 INDIAN CAPITAL TECH CENTER,TOM STILES,,10008,0,0,5,5,OFFICE NO. 2 INDIAN CAPITAL TECH CENTER
ADAIR,OFFICE NO. 2 INDIAN CAPITAL TECH CENTER,RAY KIRK,,10008,0,1,0,1,OFFICE NO. 2 INDIAN CAPITAL TECH CENTER
ADAIR,OFFICE NO. 2 INDIAN CAPITAL TECH CENTER,TOM STILES,,10010,0,0,2,2,OFFICE NO. 2 INDIAN CAPITAL TECH CENTER
ADAIR,OFFICE NO. 2 INDIAN CAPITAL TECH CENTER,RAY KIRK,,10010,0,0,5,5,OFFICE NO. 2 INDIAN CAPITAL TECH CENTER
ADAIR,OFFICE NO. 3 DAHLONEGAH PUBLIC SCHOOL,CLARISSA WOFFORD,,10011,0,2,0,2,OFFICE NO. 3 DAHLONEGAH PUBLIC SCHOOL
ADAIR,OFFICE NO. 3 DAHLONEGAH PUBLIC SCHOOL,KENNY LIMORE JR,,10011,0,1,0,1,OFFICE NO. 3 DAHLONEGAH PUBLIC SCHOOL
ADAIR,OFFICE NO. 2 INDIAN CAPITAL TECH CENTER,TOM STILES,,10011,0,2,0,2,OFFICE NO. 2 INDIAN CAPITAL TECH CENTER
ADAIR,OFFICE NO. 2 INDIAN CAPITAL TECH CENTER,RAY KIRK,,10011,0,1,0,1,OFFICE NO. 2 INDIAN CAPITAL TECH CENTER
ADAIR,OFFICE NO. 2 INDIAN CAPITAL TECH CENTER,TOM STILES,,10012,0,0,4,4,OFFICE NO. 2 INDIAN CAPITAL TECH CENTER
ADAIR,OFFICE NO. 2 INDIAN CAPITAL TECH CENTER,RAY KIRK,,10012,0,0,5,5,OFFICE NO. 2 INDIAN CAPITAL TECH CENTER
ADAIR,OFFICE NO. 2 INDIAN CAPITAL TECH CENTER,TOM STILES,,10013,0,0,7,7,OFFICE NO. 2 INDIAN CAPITAL TECH CENTER
ADAIR,OFFICE NO. 2 INDIAN CAPITAL TECH CENTER,RAY KIRK,,10013,0,3,0,3,OFFICE NO. 2 INDIAN CAPITAL TECH CENTER
ADAIR,OFFICE NO. 2 INDIAN CAPITAL TECH CENTER,TOM STILES,,10014,0,0,6,6,OFFICE NO. 2 INDIAN CAPITAL TECH CENTER
ADAIR,OFFICE NO. 2 INDIAN CAPITAL TECH CENTER,RAY KIRK,,10014,0,0,0,0,OFFICE NO. 2 INDIAN CAPITAL TECH CENTER
ADAIR,OFFICE NO. 2 INDIAN CAPITAL TECH CENTER,TOM STILES,,10016,0,0,6,6,OFFICE NO. 2 INDIAN CAPITAL TECH CENTER
ADAIR,OFFICE NO. 2 INDIAN CAPITAL TECH CENTER,RAY KIRK,,10016,0,0,3,3,OFFICE NO. 2 INDIAN CAPITAL TECH CENTER
ADAIR,OFFICE NO. 2 MOSELEY PUBLIC SCHOOL,AMANDA KAUFFELD,,10017,0,0,1,1,OFFICE NO. 2 MOSELEY PUBLIC SCHOOL
ADAIR,OFFICE NO. 2 MOSELEY PUBLIC SCHOOL,LAURA POTEET,,10017,0,0,0,0,OFFICE NO. 2 MOSELEY PUBLIC SCHOOL
ADAIR,OFFICE NO. 2 INDIAN CAPITAL TECH CENTER,TOM STILES,,10017,0,0,5,5,OFFICE NO. 2 INDIAN CAPITAL TECH CENTER
ADAIR,OFFICE NO. 2 INDIAN CAPITAL TECH CENTER,RAY KIRK,,10017,0,0,7,7,OFFICE NO. 2 INDIAN CAPITAL TECH CENTER
ADAIR,OFFICE NO. 2 INDIAN CAPITAL TECH CENTER,TOM STILES,,10018,0,0,5,5,OFFICE NO. 2 INDIAN CAPITAL TECH CENTER
ADAIR,OFFICE NO. 2 INDIAN CAPITAL TECH CENTER,RAY KIRK,,10018,0,0,0,0,OFFICE NO. 2 INDIAN CAPITAL TECH CENTER
ADAIR,OFFICE NO. 2 INDIAN CAPITAL TECH CENTER,TOM STILES,,10019,0,0,9,9,OFFICE NO. 2 INDIAN CAPITAL TECH CENTER
ADAIR,OFFICE NO. 2 INDIAN CAPITAL TECH CENTER,RAY KIRK,,10019,0,0,3,3,OFFICE NO. 2 INDIAN CAPITAL TECH CENTER
ALFALFA,OFFICE NO. 2 TIMBERLAKE PUBLIC SCHOOLS,QUENTIN STURGEON,,20120,0,0,0,0,OFFICE NO. 2 TIMBERLAKE PUBLIC SCHOOLS
ALFALFA,OFFICE NO. 2 TIMBERLAKE PUBLIC SCHOOLS,JAY JENLINK,,20120,2,0,1,3,OFFICE NO. 2 TIMBERLAKE PUBLIC SCHOOLS
ALFALFA,OFFICE NO. 2 TIMBERLAKE PUBLIC SCHOOLS,CHRIS CLIFT,,20120,0,0,0,0,OFFICE NO. 2 TIMBERLAKE PUBLIC SCHOOLS
ALFALFA,PROPOSITION CHEROKEE PUBLIC SCHOOLS,FOR THE PROPOSITION - YES,,20140,0,5,91,96,
ALFALFA,PROPOSITION CHEROKEE PUBLIC SCHOOLS,AGAINST THE PROPOSITION - NO,,20140,0,0,47,47,
ALFALFA,PROPOSITION CHEROKEE PUBLIC SCHOOLS,FOR THE PROPOSITION - YES,,20220,1,7,87,95,
ALFALFA,PROPOSITION CHEROKEE PUBLIC SCHOOLS,AGAINST THE PROPOSITION - NO,,20220,5,7,88,100,
ALFALFA,PROPOSITION CHEROKEE PUBLIC SCHOOLS,FOR THE PROPOSITION - YES,,20230,0,0,0,0,
ALFALFA,PROPOSITION CHEROKEE PUBLIC SCHOOLS,AGAINST THE PROPOSITION - NO,,20230,0,0,0,0,
ALFALFA,OFFICE NO. 2 TIMBERLAKE PUBLIC SCHOOLS,QUENTIN STURGEON,,20310,0,0,14,14,OFFICE NO. 2 TIMBERLAKE PUBLIC SCHOOLS
ALFALFA,OFFICE NO. 2 TIMBERLAKE PUBLIC SCHOOLS,JAY JENLINK,,20310,0,0,72,72,OFFICE NO. 2 TIMBERLAKE PUBLIC SCHOOLS
ALFALFA,OFFICE NO. 2 TIMBERLAKE PUBLIC SCHOOLS,CHRIS CLIFT,,20310,0,1,40,41,OFFICE NO. 2 TIMBERLAKE PUBLIC SCHOOLS
ALFALFA,OFFICE NO. 2 TIMBERLAKE PUBLIC SCHOOLS,QUENTIN STURGEON,,20320,0,0,9,9,OFFICE NO. 2 TIMBERLAKE PUBLIC SCHOOLS
ALFALFA,OFFICE NO. 2 TIMBERLAKE PUBLIC SCHOOLS,JAY JENLINK,,20320,1,0,40,41,OFFICE NO. 2 TIMBERLAKE PUBLIC SCHOOLS
ALFALFA,OFFICE NO. 2 TIMBERLAKE PUBLIC SCHOOLS,CHRIS CLIFT,,20320,0,0,20,20,OFFICE NO. 2 TIMBERLAKE PUBLIC SCHOOLS
ALFALFA,PROPOSITION CHEROKEE PUBLIC SCHOOLS,FOR THE PROPOSITION - YES,,20330,0,2,0,2,
ALFALFA,PROPOSITION CHEROKEE PUBLIC SCHOOLS,AGAINST THE PROPOSITION - NO,,20330,0,1,0,1,
ALFALFA,OFFICE NO. 2 TIMBERLAKE PUBLIC SCHOOLS,QUENTIN STURGEON,,20330,0,0,4,4,OFFICE NO. 2 TIMBERLAKE PUBLIC SCHOOLS
ALFALFA,OFFICE NO. 2 TIMBERLAKE PUBLIC SCHOOLS,JAY JENLINK,,20330,0,0,62,62,OFFICE NO. 2 TIMBERLAKE PUBLIC SCHOOLS
ALFALFA,OFFICE NO. 2 TIMBERLAKE PUBLIC SCHOOLS,CHRIS CLIFT,,20330,1,0,3,4,OFFICE NO. 2 TIMBERLAKE PUBLIC SCHOOLS
ATOKA,OFFICE NO. 2 COALGATE PUBLIC SCHOOLS,TRENT BOURLAND,,30006,0,0,0,0,OFFICE NO. 2 COALGATE PUBLIC SCHOOLS
ATOKA,OFFICE NO. 2 COALGATE PUBLIC SCHOOLS,PHILIP SCOTT BROWN,,30006,0,0,0,0,OFFICE NO. 2 COALGATE PUBLIC SCHOOLS
ATOKA,OFFICE NO. 2 COLEMAN PUBLIC SCHOOLS,JEFF TIPTON,,30006,4,4,0,8,OFFICE NO. 2 COLEMAN PUBLIC SCHOOLS
ATOKA,OFFICE NO. 2 COLEMAN PUBLIC SCHOOLS,RONALD NEEDHAM,,30006,6,2,0,8,OFFICE NO. 2 COLEMAN PUBLIC SCHOOLS
ATOKA,OFFICE NO. 2 CANEY PUBLIC SCHOOLS,MIRANDA ALFORD,,30007,0,0,0,0,OFFICE NO. 2 CANEY PUBLIC SCHOOLS
ATOKA,OFFICE NO. 2 CANEY PUBLIC SCHOOLS,MANDY LAWSON,,30007,0,0,0,0,OFFICE NO. 2 CANEY PUBLIC SCHOOLS
ATOKA,OFFICE NO. 2 CANEY PUBLIC SCHOOLS,MIRANDA ALFORD,,30008,2,0,29,31,OFFICE NO. 2 CANEY PUBLIC SCHOOLS
ATOKA,OFFICE NO. 2 CANEY PUBLIC SCHOOLS,MANDY LAWSON,,30008,0,3,75,78,OFFICE NO. 2 CANEY PUBLIC SCHOOLS
ATOKA,OFFICE NO. 2 CADDO PUBLIC SCHOOLS,KARLEEN WINGFIELD,,30008,0,0,1,1,OFFICE NO. 2 CADDO PUBLIC SCHOOLS
ATOKA,OFFICE NO. 2 CADDO PUBLIC SCHOOLS,STEVE KELSO,,30008,0,0,3,3,OFFICE NO. 2 CADDO PUBLIC SCHOOLS
ATOKA,PROPOSITION CADDO PUBLIC SCHOOLS,FOR THE PROPOSITION - YES,,30008,0,0,4,4,
ATOKA,PROPOSITION CADDO PUBLIC SCHOOLS,AGAINST THE PROPOSITION - NO,,30008,0,0,0,0,
ATOKA,OFFICE NO. 4 ROCK CREEK PUBLIC SCHOOLS,RYAN WHITE,,30008,0,0,0,0,OFFICE NO. 4 ROCK CREEK PUBLIC SCHOOLS
ATOKA,OFFICE NO. 4 ROCK CREEK PUBLIC SCHOOLS,JERRY COOK,,30008,0,0,0,0,OFFICE NO. 4 ROCK CREEK PUBLIC SCHOOLS
ATOKA,OFFICE NO. 2 COLEMAN PUBLIC SCHOOLS,JEFF TIPTON,,30008,6,2,12,20,OFFICE NO. 2 COLEMAN PUBLIC SCHOOLS
ATOKA,OFFICE NO. 2 COLEMAN PUBLIC SCHOOLS,RONALD NEEDHAM,,30008,0,0,0,0,OFFICE NO. 2 COLEMAN PUBLIC SCHOOLS
ATOKA,OFFICE NO. 2 CANEY PUBLIC SCHOOLS,MIRANDA ALFORD,,30009,0,0,0,0,OFFICE NO. 2 CANEY PUBLIC SCHOOLS
ATOKA,OFFICE NO. 2 CANEY PUBLIC SCHOOLS,MANDY LAWSON,,30009,0,0,0,0,OFFICE NO. 2 CANEY PUBLIC SCHOOLS
ATOKA,OFFICE NO. 2 COALGATE PUBLIC SCHOOLS,TRENT BOURLAND,,30010,0,0,1,1,OFFICE NO. 2 COALGATE PUBLIC SCHOOLS
ATOKA,OFFICE NO. 2 COALGATE PUBLIC SCHOOLS,PHILIP SCOTT BROWN,,30010,1,0,2,3,OFFICE NO. 2 COALGATE PUBLIC SCHOOLS
ATOKA,OFFICE NO. 2 KIOWA PUBLIC SCHOOLS,RICK SARTOR,,30010,0,0,15,15,OFFICE NO. 2 KIOWA PUBLIC SCHOOLS
ATOKA,OFFICE NO. 2 KIOWA PUBLIC SCHOOLS,DIANA LINSCOTT,,30010,0,0,5,5,OFFICE NO. 2 KIOWA PUBLIC SCHOOLS
ATOKA,OFFICE NO. 3 LANE PUBLIC SCHOOL,RD WILLIS,,30011,0,10,47,57,OFFICE NO. 3 LANE PUBLIC SCHOOL
ATOKA,OFFICE NO. 3 LANE PUBLIC SCHOOL,DON McGINTY,,30011,0,12,63,75,OFFICE NO. 3 LANE PUBLIC SCHOOL
ATOKA,OFFICE NO. 3 LANE PUBLIC SCHOOL,RD WILLIS,,30012,0,0,14,14,OFFICE NO. 3 LANE PUBLIC SCHOOL
ATOKA,OFFICE NO. 3 LANE PUBLIC SCHOOL,DON McGINTY,,30012,0,0,27,27,OFFICE NO. 3 LANE PUBLIC SCHOOL
ATOKA,OFFICE NO. 2 KIOWA PUBLIC SCHOOLS,RICK SARTOR,,30013,0,0,0,0,OFFICE NO. 2 KIOWA PUBLIC SCHOOLS
ATOKA,OFFICE NO. 2 KIOWA PUBLIC SCHOOLS,DIANA LINSCOTT,,30013,0,0,0,0,OFFICE NO. 2 KIOWA PUBLIC SCHOOLS
ATOKA,OFFICE NO. 2 KIOWA PUBLIC SCHOOLS,RICK SARTOR,,30014,0,0,0,0,OFFICE NO. 2 KIOWA PUBLIC SCHOOLS
ATOKA,OFFICE NO. 2 KIOWA PUBLIC SCHOOLS,DIANA LINSCOTT,,30014,0,0,0,0,OFFICE NO. 2 KIOWA PUBLIC SCHOOLS
ATOKA,OFFICE NO. 3 LANE PUBLIC SCHOOL,RD WILLIS,,30015,0,0,7,7,OFFICE NO. 3 LANE PUBLIC SCHOOL
ATOKA,OFFICE NO. 3 LANE PUBLIC SCHOOL,DON McGINTY,,30015,0,0,6,6,OFFICE NO. 3 LANE PUBLIC SCHOOL
ATOKA,OFFICE NO. 2 CADDO PUBLIC SCHOOLS,KARLEEN WINGFIELD,,30016,0,0,0,0,OFFICE NO. 2 CADDO PUBLIC SCHOOLS
ATOKA,OFFICE NO. 2 CADDO PUBLIC SCHOOLS,STEVE KELSO,,30016,0,0,0,0,OFFICE NO. 2 CADDO PUBLIC SCHOOLS
ATOKA,PROPOSITION CADDO PUBLIC SCHOOLS,FOR THE PROPOSITION - YES,,30016,0,0,0,0,
ATOKA,PROPOSITION CADDO PUBLIC SCHOOLS,AGAINST THE PROPOSITION - NO,,30016,0,0,0,0,
ATOKA,OFFICE NO. 4 ROCK CREEK PUBLIC SCHOOLS,RYAN WHITE,,30016,0,0,0,0,OFFICE NO. 4 ROCK CREEK PUBLIC SCHOOLS
ATOKA,OFFICE NO. 4 ROCK CREEK PUBLIC SCHOOLS,JERRY COOK,,30016,0,0,0,0,OFFICE NO. 4 ROCK CREEK PUBLIC SCHOOLS
ATOKA,OFFICE NO. 2 KIOWA PUBLIC SCHOOLS,RICK SARTOR,,30018,0,0,0,0,OFFICE NO. 2 KIOWA PUBLIC SCHOOLS
ATOKA,OFFICE NO. 2 KIOWA PUBLIC SCHOOLS,DIANA LINSCOTT,,30018,0,0,0,0,OFFICE NO. 2 KIOWA PUBLIC SCHOOLS
BEAVER,OFFICE NO. 2 LAVERNE PUBLIC SCHOOLS,GABE HOPE,,40011,0,2,3,5,OFFICE NO. 2 LAVERNE PUBLIC SCHOOLS
BEAVER,OFFICE NO. 2 LAVERNE PUBLIC SCHOOLS,JIMMY DIXON,,40011,0,0,10,10,OFFICE NO. 2 LAVERNE PUBLIC SCHOOLS
BEAVER,OFFICE NO. 2 BEAVER PUBLIC SCHOOLS,MIKE PUGH,,40013,0,0,0,0,OFFICE NO. 2 BEAVER PUBLIC SCHOOLS
BEAVER,OFFICE NO. 2 BEAVER PUBLIC SCHOOLS,HEATH NOYES,,40013,0,0,0,0,OFFICE NO. 2 BEAVER PUBLIC SCHOOLS
BEAVER,OFFICE NO. 2 BEAVER PUBLIC SCHOOLS,JUSTIN EARLS,,40013,0,0,0,0,OFFICE NO. 2 BEAVER PUBLIC SCHOOLS
BEAVER,OFFICE NO. 2 BEAVER PUBLIC SCHOOLS,SHANE CHALOUPEK,,40013,0,0,0,0,OFFICE NO. 2 BEAVER PUBLIC SCHOOLS
BEAVER,PROPOSITION FORGAN PUBLIC SCHOOLS,FOR THE PROPOSITION - YES,,40013,0,0,3,3,
BEAVER,PROPOSITION FORGAN PUBLIC SCHOOLS,AGAINST THE PROPOSITION - NO,,40013,0,0,2,2,
BEAVER,OFFICE NO. 2 LAVERNE PUBLIC SCHOOLS,GABE HOPE,,40013,3,1,4,8,OFFICE NO. 2 LAVERNE PUBLIC SCHOOLS
BEAVER,OFFICE NO. 2 LAVERNE PUBLIC SCHOOLS,JIMMY DIXON,,40013,0,0,3,3,OFFICE NO. 2 LAVERNE PUBLIC SCHOOLS
BEAVER,OFFICE NO. 2 BEAVER PUBLIC SCHOOLS,MIKE PUGH,,40023,1,15,116,132,OFFICE NO. 2 BEAVER PUBLIC SCHOOLS
BEAVER,OFFICE NO. 2 BEAVER PUBLIC SCHOOLS,HEATH NOYES,,40023,2,11,34,47,OFFICE NO. 2 BEAVER PUBLIC SCHOOLS
BEAVER,OFFICE NO. 2 BEAVER PUBLIC SCHOOLS,JUSTIN EARLS,,40023,0,3,14,17,OFFICE NO. 2 BEAVER PUBLIC SCHOOLS
BEAVER,OFFICE NO. 2 BEAVER PUBLIC SCHOOLS,SHANE CHALOUPEK,,40023,0,1,9,10,OFFICE NO. 2 BEAVER PUBLIC SCHOOLS
BEAVER,OFFICE NO. 4 (UNEXPIRED TERM) Balko Public Schools,WESLEY E. DELK,,40023,1,1,1,3,OFFICE NO. 4 (UNEXPIRED TERM) Balko Public Schools
BEAVER,OFFICE NO. 4 (UNEXPIRED TERM) Balko Public Schools,THERON CATES,,40023,0,7,20,27,OFFICE NO. 4 (UNEXPIRED TERM) Balko Public Schools
BEAVER,OFFICE NO. 2 LAVERNE PUBLIC SCHOOLS,GABE HOPE,,40023,0,0,0,0,OFFICE NO. 2 LAVERNE PUBLIC SCHOOLS
BEAVER,OFFICE NO. 2 LAVERNE PUBLIC SCHOOLS,JIMMY DIXON,,40023,0,0,0,0,OFFICE NO. 2 LAVERNE PUBLIC SCHOOLS
BEAVER,OFFICE NO. 2 BEAVER PUBLIC SCHOOLS,MIKE PUGH,,40025,0,0,0,0,OFFICE NO. 2 BEAVER PUBLIC SCHOOLS
BEAVER,OFFICE NO. 2 BEAVER PUBLIC SCHOOLS,HEATH NOYES,,40025,0,0,0,0,OFFICE NO. 2 BEAVER PUBLIC SCHOOLS
BEAVER,OFFICE NO. 2 BEAVER PUBLIC SCHOOLS,JUSTIN EARLS,,40025,0,0,0,0,OFFICE NO. 2 BEAVER PUBLIC SCHOOLS
BEAVER,OFFICE NO. 2 BEAVER PUBLIC SCHOOLS,SHANE CHALOUPEK,,40025,0,0,0,0,OFFICE NO. 2 BEAVER PUBLIC SCHOOLS
BEAVER,PROPOSITION FORGAN PUBLIC SCHOOLS,FOR THE PROPOSITION - YES,,40025,0,0,63,63,
BEAVER,PROPOSITION FORGAN PUBLIC SCHOOLS,AGAINST THE PROPOSITION - NO,,40025,0,0,1,1,
BEAVER,OFFICE NO. 2 BEAVER PUBLIC SCHOOLS,MIKE PUGH,,40026,0,0,0,0,OFFICE NO. 2 BEAVER PUBLIC SCHOOLS
BEAVER,OFFICE NO. 2 BEAVER PUBLIC SCHOOLS,HEATH NOYES,,40026,1,1,0,2,OFFICE NO. 2 BEAVER PUBLIC SCHOOLS
BEAVER,OFFICE NO. 2 BEAVER PUBLIC SCHOOLS,JUSTIN EARLS,,40026,0,0,0,0,OFFICE NO. 2 BEAVER PUBLIC SCHOOLS
BEAVER,OFFICE NO. 2 BEAVER PUBLIC SCHOOLS,SHANE CHALOUPEK,,40026,0,0,0,0,OFFICE NO. 2 BEAVER PUBLIC SCHOOLS
BEAVER,PROPOSITION FORGAN PUBLIC SCHOOLS,FOR THE PROPOSITION - YES,,40026,0,0,14,14,
BEAVER,PROPOSITION FORGAN PUBLIC SCHOOLS,AGAINST THE PROPOSITION - NO,,40026,0,1,1,2,
BEAVER,OFFICE NO. 2 TURPIN PUBLIC SCHOOLS,KEVIN WILLIAMS,,40026,0,0,0,0,OFFICE NO. 2 TURPIN PUBLIC SCHOOLS
BEAVER,OFFICE NO. 2 TURPIN PUBLIC SCHOOLS,SARAH ARCHER,,40026,0,0,0,0,OFFICE NO. 2 TURPIN PUBLIC SCHOOLS
BEAVER,OFFICE NO. 1 (UNEXPIRED TERM) TURPIN PUBLIC SCHOOLS,BLAINE BECKLEY,,40026,0,0,0,0,OFFICE NO. 1 (UNEXPIRED TERM) TURPIN PUBLIC SCHOOLS
BEAVER,OFFICE NO. 1 (UNEXPIRED TERM) TURPIN PUBLIC SCHOOLS,CHARLIE DELAY,,40026,0,0,0,0,OFFICE NO. 1 (UNEXPIRED TERM) TURPIN PUBLIC SCHOOLS
BEAVER,COUNTY COMMISSIONER DISTRICT NO. 3 (UNEXPIRED TERM),KERRY REGIER,Republican,40031,0,6,34,40,COUNTY COMMISSIONER DISTRICT NO. 3 (UNEXPIRED TERM)
BEAVER,COUNTY COMMISSIONER DISTRICT NO. 3 (UNEXPIRED TERM),RICHARD LEE COWAN,Republican,40031,2,1,67,70,COUNTY COMMISSIONER DISTRICT NO. 3 (UNEXPIRED TERM)
BEAVER,OFFICE NO. 2 BEAVER PUBLIC SCHOOLS,MIKE PUGH,,40031,0,2,0,2,OFFICE NO. 2 BEAVER PUBLIC SCHOOLS
BEAVER,OFFICE NO. 2 BEAVER PUBLIC SCHOOLS,HEATH NOYES,,40031,0,0,0,0,OFFICE NO. 2 BEAVER PUBLIC SCHOOLS
BEAVER,OFFICE NO. 2 BEAVER PUBLIC SCHOOLS,JUSTIN EARLS,,40031,0,0,0,0,OFFICE NO. 2 BEAVER PUBLIC SCHOOLS
BEAVER,OFFICE NO. 2 BEAVER PUBLIC SCHOOLS,SHANE CHALOUPEK,,40031,0,0,0,0,OFFICE NO. 2 BEAVER PUBLIC SCHOOLS
BEAVER,OFFICE NO. 4 (UNEXPIRED TERM) Balko Public Schools,WESLEY E. DELK,,40031,2,0,32,34,OFFICE NO. 4 (UNEXPIRED TERM) Balko Public Schools
BEAVER,OFFICE NO. 4 (UNEXPIRED TERM) Balko Public Schools,THERON CATES,,40031,2,0,80,82,OFFICE NO. 4 (UNEXPIRED TERM) Balko Public Schools
BEAVER,OFFICE NO. 2 TURPIN PUBLIC SCHOOLS,KEVIN WILLIAMS,,40031,0,2,6,8,OFFICE NO. 2 TURPIN PUBLIC SCHOOLS
BEAVER,OFFICE NO. 2 TURPIN PUBLIC SCHOOLS,SARAH ARCHER,,40031,1,1,1,3,OFFICE NO. 2 TURPIN PUBLIC SCHOOLS
BEAVER,OFFICE NO. 1 (UNEXPIRED TERM) TURPIN PUBLIC SCHOOLS,BLAINE BECKLEY,,40031,1,3,4,8,OFFICE NO. 1 (UNEXPIRED TERM) TURPIN PUBLIC SCHOOLS
BEAVER,OFFICE NO. 1 (UNEXPIRED TERM) TURPIN PUBLIC SCHOOLS,CHARLIE DELAY,,40031,0,0,3,3,OFFICE NO. 1 (UNEXPIRED TERM) TURPIN PUBLIC SCHOOLS
BEAVER,COUNTY COMMISSIONER DISTRICT NO. 3 (UNEXPIRED TERM),KERRY REGIER,Republican,40033,1,1,189,191,COUNTY COMMISSIONER DISTRICT NO. 3 (UNEXPIRED TERM)
BEAVER,COUNTY COMMISSIONER DISTRICT NO. 3 (UNEXPIRED TERM),RICHARD LEE COWAN,Republican,40033,2,3,45,50,COUNTY COMMISSIONER DISTRICT NO. 3 (UNEXPIRED TERM)
BEAVER,PROPOSITION FORGAN PUBLIC SCHOOLS,FOR THE PROPOSITION - YES,,40033,1,0,10,11,
BEAVER,PROPOSITION FORGAN PUBLIC SCHOOLS,AGAINST THE PROPOSITION - NO,,40033,0,0,2,2,
BEAVER,OFFICE NO. 2 TURPIN PUBLIC SCHOOLS,KEVIN WILLIAMS,,40033,1,4,224,229,OFFICE NO. 2 TURPIN PUBLIC SCHOOLS
BEAVER,OFFICE NO. 2 TURPIN PUBLIC SCHOOLS,SARAH ARCHER,,40033,0,2,30,32,OFFICE NO. 2 TURPIN PUBLIC SCHOOLS
BEAVER,OFFICE NO. 1 (UNEXPIRED TERM) TURPIN PUBLIC SCHOOLS,BLAINE BECKLEY,,40033,1,4,163,168,OFFICE NO. 1 (UNEXPIRED TERM) TURPIN PUBLIC SCHOOLS
BEAVER,OFFICE NO. 1 (UNEXPIRED TERM) TURPIN PUBLIC SCHOOLS,CHARLIE DELAY,,40033,0,2,91,93,OFFICE NO. 1 (UNEXPIRED TERM) TURPIN PUBLIC SCHOOLS
BECKHAM,OFFICE NO. 2 SAYRE PUBLIC SCHOOLS,MATT THORNBROUGH,,50111,1,24,92,117,OFFICE NO. 2 SAYRE PUBLIC SCHOOLS
BECKHAM,OFFICE NO. 2 SAYRE PUBLIC SCHOOLS,BRIAN CHAPMAN,,50111,1,8,85,94,OFFICE NO. 2 SAYRE PUBLIC SCHOOLS
BECKHAM,OFFICE NO. 2 WESTERN TECH CENTER,GARY D. SMITH,,50111,1,14,121,136,OFFICE NO. 2 WESTERN TECH CENTER
BECKHAM,OFFICE NO. 2 WESTERN TECH CENTER,BILL JOHANNING,,50111,1,5,28,34,OFFICE NO. 2 WESTERN TECH CENTER
BECKHAM,OFFICE NO. 2 SAYRE PUBLIC SCHOOLS,MATT THORNBROUGH,,50112,2,8,51,61,OFFICE NO. 2 SAYRE PUBLIC SCHOOLS
BECKHAM,OFFICE NO. 2 SAYRE PUBLIC SCHOOLS,BRIAN CHAPMAN,,50112,0,1,23,24,OFFICE NO. 2 SAYRE PUBLIC SCHOOLS
BECKHAM,OFFICE NO. 2 WESTERN TECH CENTER,GARY D. SMITH,,50112,1,6,56,63,OFFICE NO. 2 WESTERN TECH CENTER
BECKHAM,OFFICE NO. 2 WESTERN TECH CENTER,BILL JOHANNING,,50112,1,0,8,9,OFFICE NO. 2 WESTERN TECH CENTER
BECKHAM,OFFICE NO. 2 SAYRE PUBLIC SCHOOLS,MATT THORNBROUGH,,50115,0,11,21,32,OFFICE NO. 2 SAYRE PUBLIC SCHOOLS
BECKHAM,OFFICE NO. 2 SAYRE PUBLIC SCHOOLS,BRIAN CHAPMAN,,50115,1,0,4,5,OFFICE NO. 2 SAYRE PUBLIC SCHOOLS
BECKHAM,OFFICE NO. 2 WESTERN TECH CENTER,GARY D. SMITH,,50115,1,6,15,22,OFFICE NO. 2 WESTERN TECH CENTER
BECKHAM,OFFICE NO. 2 WESTERN TECH CENTER,BILL JOHANNING,,50115,0,1,2,3,OFFICE NO. 2 WESTERN TECH CENTER
BECKHAM,OFFICE NO. 2 WESTERN TECH CENTER,GARY D. SMITH,,50141,1,0,3,4,OFFICE NO. 2 WESTERN TECH CENTER
BECKHAM,OFFICE NO. 2 WESTERN TECH CENTER,BILL JOHANNING,,50141,1,0,0,1,OFFICE NO. 2 WESTERN TECH CENTER
BECKHAM,OFFICE NO. 2 HAMMON PUBLIC SCHOOLS,VIC McCALLAY,,50231,0,0,0,0,OFFICE NO. 2 HAMMON PUBLIC SCHOOLS
BECKHAM,OFFICE NO. 2 HAMMON PUBLIC SCHOOLS,RECTOR CANDY,,50231,0,0,0,0,OFFICE NO. 2 HAMMON PUBLIC SCHOOLS
BECKHAM,OFFICE NO. 2 WESTERN TECH CENTER,GARY D. SMITH,,50231,1,0,3,4,OFFICE NO. 2 WESTERN TECH CENTER
BECKHAM,OFFICE NO. 2 WESTERN TECH CENTER,BILL JOHANNING,,50231,0,0,0,0,OFFICE NO. 2 WESTERN TECH CENTER
BECKHAM,OFFICE NO. 2 WESTERN TECH CENTER,GARY D. SMITH,,50232,2,0,0,2,OFFICE NO. 2 WESTERN TECH CENTER
BECKHAM,OFFICE NO. 2 WESTERN TECH CENTER,BILL JOHANNING,,50232,0,0,0,0,OFFICE NO. 2 WESTERN TECH CENTER
BECKHAM,OFFICE NO. 2 SAYRE PUBLIC SCHOOLS,MATT THORNBROUGH,,50235,0,0,0,0,OFFICE NO. 2 SAYRE PUBLIC SCHOOLS
BECKHAM,OFFICE NO. 2 SAYRE PUBLIC SCHOOLS,BRIAN CHAPMAN,,50235,0,0,0,0,OFFICE NO. 2 SAYRE PUBLIC SCHOOLS
BECKHAM,OFFICE NO. 2 WESTERN TECH CENTER,GARY D. SMITH,,50235,1,0,9,10,OFFICE NO. 2 WESTERN TECH CENTER
BECKHAM,OFFICE NO. 2 WESTERN TECH CENTER,BILL JOHANNING,,50235,1,0,3,4,OFFICE NO. 2 WESTERN TECH CENTER
BECKHAM,OFFICE NO. 2 SAYRE PUBLIC SCHOOLS,MATT THORNBROUGH,,50242,2,0,4,6,OFFICE NO. 2 SAYRE PUBLIC SCHOOLS
BECKHAM,OFFICE NO. 2 SAYRE PUBLIC SCHOOLS,BRIAN CHAPMAN,,50242,0,0,1,1,OFFICE NO. 2 SAYRE PUBLIC SCHOOLS
BECKHAM,OFFICE NO. 2 WESTERN TECH CENTER,GARY D. SMITH,,50242,2,0,4,6,OFFICE NO. 2 WESTERN TECH CENTER
BECKHAM,OFFICE NO. 2 WESTERN TECH CENTER,BILL JOHANNING,,50242,0,0,3,3,OFFICE NO. 2 WESTERN TECH CENTER
BECKHAM,OFFICE NO. 2 SAYRE PUBLIC SCHOOLS,MATT THORNBROUGH,,50320,2,2,0,4,OFFICE NO. 2 SAYRE PUBLIC SCHOOLS
BECKHAM,OFFICE NO. 2 SAYRE PUBLIC SCHOOLS,BRIAN CHAPMAN,,50320,0,0,1,1,OFFICE NO. 2 SAYRE PUBLIC SCHOOLS
BECKHAM,OFFICE NO. 2 WESTERN TECH CENTER,GARY D. SMITH,,50320,2,0,1,3,OFFICE NO. 2 WESTERN TECH CENTER
BECKHAM,OFFICE NO. 2 WESTERN TECH CENTER,BILL JOHANNING,,50320,0,1,0,1,OFFICE NO. 2 WESTERN TECH CENTER
BECKHAM,OFFICE NO. 2 SAYRE PUBLIC SCHOOLS,MATT THORNBROUGH,,50330,0,2,1,3,OFFICE NO. 2 SAYRE PUBLIC SCHOOLS
BECKHAM,OFFICE NO. 2 SAYRE PUBLIC SCHOOLS,BRIAN CHAPMAN,,50330,0,0,0,0,OFFICE NO. 2 SAYRE PUBLIC SCHOOLS
BECKHAM,OFFICE NO. 2 WESTERN TECH CENTER,GARY D. SMITH,,50330,1,2,1,4,OFFICE NO. 2 WESTERN TECH CENTER
BECKHAM,OFFICE NO. 2 WESTERN TECH CENTER,BILL JOHANNING,,50330,0,0,3,3,OFFICE NO. 2 WESTERN TECH CENTER
BECKHAM,OFFICE NO. 2 WESTERN TECH CENTER,GARY D. SMITH,,50332,3,0,8,11,OFFICE NO. 2 WESTERN TECH CENTER
BECKHAM,OFFICE NO. 2 WESTERN TECH CENTER,BILL JOHANNING,,50332,0,0,1,1,OFFICE NO. 2 WESTERN TECH CENTER
BECKHAM,OFFICE NO. 2 WESTERN TECH CENTER,GARY D. SMITH,,50333,1,0,12,13,OFFICE NO. 2 WESTERN TECH CENTER
BECKHAM,OFFICE NO. 2 WESTERN TECH CENTER,BILL JOHANNING,,50333,0,0,1,1,OFFICE NO. 2 WESTERN TECH CENTER
BECKHAM,OFFICE NO. 2 SAYRE PUBLIC SCHOOLS,MATT THORNBROUGH,,50343,0,5,0,5,OFFICE NO. 2 SAYRE PUBLIC SCHOOLS
BECKHAM,OFFICE NO. 2 SAYRE PUBLIC SCHOOLS,BRIAN CHAPMAN,,50343,1,1,0,2,OFFICE NO. 2 SAYRE PUBLIC SCHOOLS
BECKHAM,OFFICE NO. 2 SWEETWATER PUBLIC SCHOOLS,FLOYD PICKERING,,50343,1,2,20,23,OFFICE NO. 2 SWEETWATER PUBLIC SCHOOLS
BECKHAM,OFFICE NO. 2 SWEETWATER PUBLIC SCHOOLS,BOB CAREY,,50343,1,0,31,32,OFFICE NO. 2 SWEETWATER PUBLIC SCHOOLS
BECKHAM,OFFICE NO. 2 WESTERN TECH CENTER,GARY D. SMITH,,50343,0,7,38,45,OFFICE NO. 2 WESTERN TECH CENTER
BECKHAM,OFFICE NO. 2 WESTERN TECH CENTER,BILL JOHANNING,,50343,0,0,8,8,OFFICE NO. 2 WESTERN TECH CENTER
BLAINE,OFFICE NO. 2 CANTON PUBLIC SCHOOLS,MATT SWARTWOOD,,60002,1,0,0,1,OFFICE NO. 2 CANTON PUBLIC SCHOOLS
BLAINE,OFFICE NO. 2 CANTON PUBLIC SCHOOLS,MIKE NIX,,60002,0,0,0,0,OFFICE NO. 2 CANTON PUBLIC SCHOOLS
BLAINE,OFFICE NO. 2 OKEENE PUBLIC SCHOOLS,MICHAEL WILLIAMS,,60002,3,0,168,171,OFFICE NO. 2 OKEENE PUBLIC SCHOOLS
BLAINE,OFFICE NO. 2 OKEENE PUBLIC SCHOOLS,BRANDON SWAIM,,60002,2,0,103,105,OFFICE NO. 2 OKEENE PUBLIC SCHOOLS
BLAINE,OFFICE NO. 2 LOMEGA PUBLIC SCHOOLS,LESLEY FISHER,,60002,1,0,0,1,OFFICE NO. 2 LOMEGA PUBLIC SCHOOLS
BLAINE,OFFICE NO. 2 LOMEGA PUBLIC SCHOOLS,CHERIE INGRAM,,60002,0,0,0,0,OFFICE NO. 2 LOMEGA PUBLIC SCHOOLS
BLAINE,OFFICE NO. 5 (UNEXPIRED TERM) LOMEGA PUBLIC SCHOOLS,LORI GLAZIER,,60002,1,0,0,1,OFFICE NO. 5 (UNEXPIRED TERM) LOMEGA PUBLIC SCHOOLS
BLAINE,OFFICE NO. 5 (UNEXPIRED TERM) LOMEGA PUBLIC SCHOOLS,MATTHEW R. OPPEL,,60002,0,0,0,0,OFFICE NO. 5 (UNEXPIRED TERM) LOMEGA PUBLIC SCHOOLS
BLAINE,PROPOSITION NO. 1 FAIRVIEW PUBLIC SCHOOLS,FOR THE PROPOSITION - YES,,60002,0,3,0,3,PROPOSITION NO. 1 FAIRVIEW PUBLIC SCHOOLS
BLAINE,PROPOSITION NO. 1 FAIRVIEW PUBLIC SCHOOLS,AGAINST THE PROPOSITION - NO,,60002,0,0,0,0,PROPOSITION NO. 1 FAIRVIEW PUBLIC SCHOOLS
BLAINE,PROPOSITION NO. 2 FAIRVIEW PUBLIC SCHOOLS,FOR THE PROPOSITION - YES,,60002,0,3,0,3,PROPOSITION NO. 2 FAIRVIEW PUBLIC SCHOOLS
BLAINE,PROPOSITION NO. 2 FAIRVIEW PUBLIC SCHOOLS,AGAINST THE PROPOSITION - NO,,60002,0,0,0,0,PROPOSITION NO. 2 FAIRVIEW PUBLIC SCHOOLS
BLAINE,OFFICE NO. 2 CANTON PUBLIC SCHOOLS,MATT SWARTWOOD,,60007,5,0,68,73,OFFICE NO. 2 CANTON PUBLIC SCHOOLS
BLAINE,OFFICE NO. 2 CANTON PUBLIC SCHOOLS,MIKE NIX,,60007,3,0,39,42,OFFICE NO. 2 CANTON PUBLIC SCHOOLS
BLAINE,OFFICE NO. 2 LOMEGA PUBLIC SCHOOLS,LESLEY FISHER,,60010,4,3,9,16,OFFICE NO. 2 LOMEGA PUBLIC SCHOOLS
BLAINE,OFFICE NO. 2 LOMEGA PUBLIC SCHOOLS,CHERIE INGRAM,,60010,1,1,10,12,OFFICE NO. 2 LOMEGA PUBLIC SCHOOLS
BLAINE,OFFICE NO. 5 (UNEXPIRED TERM) LOMEGA PUBLIC SCHOOLS,LORI GLAZIER,,60010,1,1,4,6,OFFICE NO. 5 (UNEXPIRED TERM) LOMEGA PUBLIC SCHOOLS
BLAINE,OFFICE NO. 5 (UNEXPIRED TERM) LOMEGA PUBLIC SCHOOLS,MATTHEW R. OPPEL,,60010,4,3,15,22,OFFICE NO. 5 (UNEXPIRED TERM) LOMEGA PUBLIC SCHOOLS
BLAINE,OFFICE NO. 2 OKEENE PUBLIC SCHOOLS,MICHAEL WILLIAMS,,60012,2,0,0,2,OFFICE NO. 2 OKEENE PUBLIC SCHOOLS
BLAINE,OFFICE NO. 2 OKEENE PUBLIC SCHOOLS,BRANDON SWAIM,,60012,0,0,0,0,OFFICE NO. 2 OKEENE PUBLIC SCHOOLS
BLAINE,OFFICE NO. 2 LOMEGA PUBLIC SCHOOLS,LESLEY FISHER,,60012,0,0,0,0,OFFICE NO. 2 LOMEGA PUBLIC SCHOOLS
BLAINE,OFFICE NO. 2 LOMEGA PUBLIC SCHOOLS,CHERIE INGRAM,,60012,0,0,0,0,OFFICE NO. 2 LOMEGA PUBLIC SCHOOLS
BLAINE,OFFICE NO. 5 (UNEXPIRED TERM) LOMEGA PUBLIC SCHOOLS,LORI GLAZIER,,60012,0,0,0,0,OFFICE NO. 5 (UNEXPIRED TERM) LOMEGA PUBLIC SCHOOLS
BLAINE,OFFICE NO. 5 (UNEXPIRED TERM) LOMEGA PUBLIC SCHOOLS,MATTHEW R. OPPEL,,60012,0,0,0,0,OFFICE NO. 5 (UNEXPIRED TERM) LOMEGA PUBLIC SCHOOLS
BLAINE,OFFICE NO. 2 GEARY PUBLIC SCHOOLS,SCOTT HICKS,,60016,0,1,7,8,OFFICE NO. 2 GEARY PUBLIC SCHOOLS
BLAINE,OFFICE NO. 2 GEARY PUBLIC SCHOOLS,AFTON JAMESON,,60016,0,2,14,16,OFFICE NO. 2 GEARY PUBLIC SCHOOLS
BLAINE,OFFICE NO. 2 LOMEGA PUBLIC SCHOOLS,LESLEY FISHER,,60016,0,0,0,0,OFFICE NO. 2 LOMEGA PUBLIC SCHOOLS
BLAINE,OFFICE NO. 2 LOMEGA PUBLIC SCHOOLS,CHERIE INGRAM,,60016,0,0,0,0,OFFICE NO. 2 LOMEGA PUBLIC SCHOOLS
BLAINE,OFFICE NO. 5 (UNEXPIRED TERM) LOMEGA PUBLIC SCHOOLS,LORI GLAZIER,,60016,0,0,0,0,OFFICE NO. 5 (UNEXPIRED TERM) LOMEGA PUBLIC SCHOOLS
BLAINE,OFFICE NO. 5 (UNEXPIRED TERM) LOMEGA PUBLIC SCHOOLS,MATTHEW R. OPPEL,,60016,0,0,0,0,OFFICE NO. 5 (UNEXPIRED TERM) LOMEGA PUBLIC SCHOOLS
BLAINE,OFFICE NO. 2 GEARY PUBLIC SCHOOLS,SCOTT HICKS,,60017,1,0,68,69,OFFICE NO. 2 GEARY PUBLIC SCHOOLS
BLAINE,OFFICE NO. 2 GEARY PUBLIC SCHOOLS,AFTON JAMESON,,60017,0,0,43,43,OFFICE NO. 2 GEARY PUBLIC SCHOOLS
BLAINE,OFFICE NO. 2 GEARY PUBLIC SCHOOLS,SCOTT HICKS,,60020,0,0,0,0,OFFICE NO. 2 GEARY PUBLIC SCHOOLS
BLAINE,OFFICE NO. 2 GEARY PUBLIC SCHOOLS,AFTON JAMESON,,60020,0,0,0,0,OFFICE NO. 2 GEARY PUBLIC SCHOOLS
BLAINE,OFFICE NO. 2 CANTON PUBLIC SCHOOLS,MATT SWARTWOOD,,60022,0,0,20,20,OFFICE NO. 2 CANTON PUBLIC SCHOOLS
BLAINE,OFFICE NO. 2 CANTON PUBLIC SCHOOLS,MIKE NIX,,60022,0,0,11,11,OFFICE NO. 2 CANTON PUBLIC SCHOOLS
BRYAN,OFFICE NO. 4 ROCK CREEK PUBLIC SCHOOLS,RYAN WHITE,,70004,0,0,0,0,OFFICE NO. 4 ROCK CREEK PUBLIC SCHOOLS
BRYAN,OFFICE NO. 4 ROCK CREEK PUBLIC SCHOOLS,JERRY COOK,,70004,0,0,2,2,OFFICE NO. 4 ROCK CREEK PUBLIC SCHOOLS
BRYAN,OFFICE NO. 2 ACHILLE PUBLIC SCHOOLS,CYNTHIA M. ERVIN,,70010,0,0,5,5,OFFICE NO. 2 ACHILLE PUBLIC SCHOOLS
BRYAN,OFFICE NO. 2 ACHILLE PUBLIC SCHOOLS,DAVID KELLY,,70010,0,0,16,16,OFFICE NO. 2 ACHILLE PUBLIC SCHOOLS
BRYAN,OFFICE NO. 4 ROCK CREEK PUBLIC SCHOOLS,RYAN WHITE,,70010,0,0,0,0,OFFICE NO. 4 ROCK CREEK PUBLIC SCHOOLS
BRYAN,OFFICE NO. 4 ROCK CREEK PUBLIC SCHOOLS,JERRY COOK,,70010,1,0,4,5,OFFICE NO. 4 ROCK CREEK PUBLIC SCHOOLS
BRYAN,OFFICE NO. 2 ACHILLE PUBLIC SCHOOLS,CYNTHIA M. ERVIN,,70011,0,0,8,8,OFFICE NO. 2 ACHILLE PUBLIC SCHOOLS
BRYAN,OFFICE NO. 2 ACHILLE PUBLIC SCHOOLS,DAVID KELLY,,70011,0,0,9,9,OFFICE NO. 2 ACHILLE PUBLIC SCHOOLS
BRYAN,OFFICE NO. 4 ROCK CREEK PUBLIC SCHOOLS,RYAN WHITE,,70011,0,0,3,3,OFFICE NO. 4 ROCK CREEK PUBLIC SCHOOLS
BRYAN,OFFICE NO. 4 ROCK CREEK PUBLIC SCHOOLS,JERRY COOK,,70011,0,0,3,3,OFFICE NO. 4 ROCK CREEK PUBLIC SCHOOLS
BRYAN,OFFICE NO. 4 ROCK CREEK PUBLIC SCHOOLS,RYAN WHITE,,70013,0,0,0,0,OFFICE NO. 4 ROCK CREEK PUBLIC SCHOOLS
BRYAN,OFFICE NO. 4 ROCK CREEK PUBLIC SCHOOLS,JERRY COOK,,70013,0,0,0,0,OFFICE NO. 4 ROCK CREEK PUBLIC SCHOOLS
BRYAN,OFFICE NO. 2 CADDO PUBLIC SCHOOLS,KARLEEN WINGFIELD,,70014,0,0,2,2,OFFICE NO. 2 CADDO PUBLIC SCHOOLS
BRYAN,OFFICE NO. 2 CADDO PUBLIC SCHOOLS,STEVE KELSO,,70014,0,0,1,1,OFFICE NO. 2 CADDO PUBLIC SCHOOLS
BRYAN,PROPOSITION CADDO PUBLIC SCHOOLS,FOR THE PROPOSITION - YES,,70014,0,0,2,2,
BRYAN,PROPOSITION CADDO PUBLIC SCHOOLS,AGAINST THE PROPOSITION - NO,,70014,0,0,1,1,
BRYAN,OFFICE NO. 4 ROCK CREEK PUBLIC SCHOOLS,RYAN WHITE,,70014,1,0,5,6,OFFICE NO. 4 ROCK CREEK PUBLIC SCHOOLS
BRYAN,OFFICE NO. 4 ROCK CREEK PUBLIC SCHOOLS,JERRY COOK,,70014,0,1,8,9,OFFICE NO. 4 ROCK CREEK PUBLIC SCHOOLS
BRYAN,OFFICE NO. 2 CADDO PUBLIC SCHOOLS,KARLEEN WINGFIELD,,70015,0,0,11,11,OFFICE NO. 2 CADDO PUBLIC SCHOOLS
BRYAN,OFFICE NO. 2 CADDO PUBLIC SCHOOLS,STEVE KELSO,,70015,0,0,25,25,OFFICE NO. 2 CADDO PUBLIC SCHOOLS
BRYAN,PROPOSITION CADDO PUBLIC SCHOOLS,FOR THE PROPOSITION - YES,,70015,0,0,23,23,
BRYAN,PROPOSITION CADDO PUBLIC SCHOOLS,AGAINST THE PROPOSITION - NO,,70015,0,0,13,13,
BRYAN,OFFICE NO. 4 ROCK CREEK PUBLIC SCHOOLS,RYAN WHITE,,70015,1,0,36,37,OFFICE NO. 4 ROCK CREEK PUBLIC SCHOOLS
BRYAN,OFFICE NO. 4 ROCK CREEK PUBLIC SCHOOLS,JERRY COOK,,70015,1,0,27,28,OFFICE NO. 4 ROCK CREEK PUBLIC SCHOOLS
BRYAN,OFFICE NO. 2 CADDO PUBLIC SCHOOLS,KARLEEN WINGFIELD,,70017,0,0,45,45,OFFICE NO. 2 CADDO PUBLIC SCHOOLS
BRYAN,OFFICE NO. 2 CADDO PUBLIC SCHOOLS,STEVE KELSO,,70017,1,0,72,73,OFFICE NO. 2 CADDO PUBLIC SCHOOLS
BRYAN,PROPOSITION CADDO PUBLIC SCHOOLS,FOR THE PROPOSITION - YES,,70017,1,0,89,90,
BRYAN,PROPOSITION CADDO PUBLIC SCHOOLS,AGAINST THE PROPOSITION - NO,,70017,0,0,27,27,
BRYAN,OFFICE NO. 4 ROCK CREEK PUBLIC SCHOOLS,RYAN WHITE,,70019,0,0,0,0,OFFICE NO. 4 ROCK CREEK PUBLIC SCHOOLS
BRYAN,OFFICE NO. 4 ROCK CREEK PUBLIC SCHOOLS,JERRY COOK,,70019,0,0,0,0,OFFICE NO. 4 ROCK CREEK PUBLIC SCHOOLS
BRYAN,OFFICE NO. 2 CADDO PUBLIC SCHOOLS,KARLEEN WINGFIELD,,70021,0,0,9,9,OFFICE NO. 2 CADDO PUBLIC SCHOOLS
BRYAN,OFFICE NO. 2 CADDO PUBLIC SCHOOLS,STEVE KELSO,,70021,1,0,14,15,OFFICE NO. 2 CADDO PUBLIC SCHOOLS
BRYAN,PROPOSITION CADDO PUBLIC SCHOOLS,FOR THE PROPOSITION - YES,,70021,1,0,16,17,
BRYAN,PROPOSITION CADDO PUBLIC SCHOOLS,AGAINST THE PROPOSITION - NO,,70021,0,0,7,7,
BRYAN,OFFICE NO. 2 ACHILLE PUBLIC SCHOOLS,CYNTHIA M. ERVIN,,70022,0,0,0,0,OFFICE NO. 2 ACHILLE PUBLIC SCHOOLS
BRYAN,OFFICE NO. 2 ACHILLE PUBLIC SCHOOLS,DAVID KELLY,,70022,0,0,0,0,OFFICE NO. 2 ACHILLE PUBLIC SCHOOLS
BRYAN,OFFICE NO. 2 ACHILLE PUBLIC SCHOOLS,CYNTHIA M. ERVIN,,70023,1,1,44,46,OFFICE NO. 2 ACHILLE PUBLIC SCHOOLS
BRYAN,OFFICE NO. 2 ACHILLE PUBLIC SCHOOLS,DAVID KELLY,,70023,0,0,45,45,OFFICE NO. 2 ACHILLE PUBLIC SCHOOLS
BRYAN,OFFICE NO. 4 ROCK CREEK PUBLIC SCHOOLS,RYAN WHITE,,70026,0,0,0,0,OFFICE NO. 4 ROCK CREEK PUBLIC SCHOOLS
BRYAN,OFFICE NO. 4 ROCK CREEK PUBLIC SCHOOLS,JERRY COOK,,70026,0,0,0,0,OFFICE NO. 4 ROCK CREEK PUBLIC SCHOOLS
BRYAN,OFFICE NO. 4 ROCK CREEK PUBLIC SCHOOLS,RYAN WHITE,,70029,0,0,2,2,OFFICE NO. 4 ROCK CREEK PUBLIC SCHOOLS
BRYAN,OFFICE NO. 4 ROCK CREEK PUBLIC SCHOOLS,JERRY COOK,,70029,0,0,8,8,OFFICE NO. 4 ROCK CREEK PUBLIC SCHOOLS
CADDO,OFFICE NO. 2 ANADARKO PUBLIC SCHOOLS,RENEE HILL,,80012,1,0,11,12,OFFICE NO. 2 ANADARKO PUBLIC SCHOOLS
CADDO,OFFICE NO. 2 ANADARKO PUBLIC SCHOOLS,MYLES STEPHENSON JR.,,80012,1,0,12,13,OFFICE NO. 2 ANADARKO PUBLIC SCHOOLS
CADDO,OFFICE NO. 2 VERDEN PUBLIC SCHOOLS,CHAD THARP,,80012,0,0,0,0,OFFICE NO. 2 VERDEN PUBLIC SCHOOLS
CADDO,OFFICE NO. 2 VERDEN PUBLIC SCHOOLS,MICHAEL PERRAULT,,80012,0,0,1,1,OFFICE NO. 2 VERDEN PUBLIC SCHOOLS
CADDO,PROPOSITION VERDEN PUBLIC SCHOOLS,FOR THE PROPOSITION - YES,,80012,0,0,1,1,
CADDO,PROPOSITION VERDEN PUBLIC SCHOOLS,AGAINST THE PROPOSITION - NO,,80012,0,0,0,0,
CADDO,OFFICE NO. 2 ANADARKO PUBLIC SCHOOLS,RENEE HILL,,80022,2,1,19,22,OFFICE NO. 2 ANADARKO PUBLIC SCHOOLS
CADDO,OFFICE NO. 2 ANADARKO PUBLIC SCHOOLS,MYLES STEPHENSON JR.,,80022,2,1,22,25,OFFICE NO. 2 ANADARKO PUBLIC SCHOOLS
CADDO,OFFICE NO. 2 ANADARKO PUBLIC SCHOOLS,RENEE HILL,,80031,1,3,6,10,OFFICE NO. 2 ANADARKO PUBLIC SCHOOLS
CADDO,OFFICE NO. 2 ANADARKO PUBLIC SCHOOLS,MYLES STEPHENSON JR.,,80031,0,2,9,11,OFFICE NO. 2 ANADARKO PUBLIC SCHOOLS
CADDO,OFFICE NO. 2 ANADARKO PUBLIC SCHOOLS,RENEE HILL,,80041,5,3,37,45,OFFICE NO. 2 ANADARKO PUBLIC SCHOOLS
CADDO,OFFICE NO. 2 ANADARKO PUBLIC SCHOOLS,MYLES STEPHENSON JR.,,80041,0,1,9,10,OFFICE NO. 2 ANADARKO PUBLIC SCHOOLS
CADDO,OFFICE NO. 2 VERDEN PUBLIC SCHOOLS,CHAD THARP,,80041,0,0,6,6,OFFICE NO. 2 VERDEN PUBLIC SCHOOLS
CADDO,OFFICE NO. 2 VERDEN PUBLIC SCHOOLS,MICHAEL PERRAULT,,80041,0,0,1,1,OFFICE NO. 2 VERDEN PUBLIC SCHOOLS
CADDO,PROPOSITION VERDEN PUBLIC SCHOOLS,FOR THE PROPOSITION - YES,,80041,0,0,6,6,
CADDO,PROPOSITION VERDEN PUBLIC SCHOOLS,AGAINST THE PROPOSITION - NO,,80041,0,0,1,1,
CADDO,OFFICE NO. 2 ANADARKO PUBLIC SCHOOLS,RENEE HILL,,80051,7,6,80,93,OFFICE NO. 2 ANADARKO PUBLIC SCHOOLS
CADDO,OFFICE NO. 2 ANADARKO PUBLIC SCHOOLS,MYLES STEPHENSON JR.,,80051,2,0,56,58,OFFICE NO. 2 ANADARKO PUBLIC SCHOOLS
CADDO,OFFICE NO. 2 ANADARKO PUBLIC SCHOOLS,RENEE HILL,,80509,0,0,0,0,OFFICE NO. 2 ANADARKO PUBLIC SCHOOLS
CADDO,OFFICE NO. 2 ANADARKO PUBLIC SCHOOLS,MYLES STEPHENSON JR.,,80509,0,0,0,0,OFFICE NO. 2 ANADARKO PUBLIC SCHOOLS
CADDO,OFFICE NO. 2 FLETCHER PUBLIC SCHOOLS,CHAD FUNKHOUSER,,80510,0,0,0,0,OFFICE NO. 2 FLETCHER PUBLIC SCHOOLS
CADDO,OFFICE NO. 2 FLETCHER PUBLIC SCHOOLS,BRYAN SWIETEK,,80510,0,0,0,0,OFFICE NO. 2 FLETCHER PUBLIC SCHOOLS
CADDO,OFFICE NO. 2 FLETCHER PUBLIC SCHOOLS,AMBER HENDRIX,,80510,0,0,0,0,OFFICE NO. 2 FLETCHER PUBLIC SCHOOLS
CADDO,OFFICE NO. 2 ANADARKO PUBLIC SCHOOLS,RENEE HILL,,80810,0,1,1,2,OFFICE NO. 2 ANADARKO PUBLIC SCHOOLS
CADDO,OFFICE NO. 2 ANADARKO PUBLIC SCHOOLS,MYLES STEPHENSON JR.,,80810,0,0,0,0,OFFICE NO. 2 ANADARKO PUBLIC SCHOOLS
CADDO,OFFICE NO. 2 GRACEMONT PUBLIC SCHOOLS,DONITA SETTLE,,80810,0,0,8,8,OFFICE NO. 2 GRACEMONT PUBLIC SCHOOLS
CADDO,OFFICE NO. 2 GRACEMONT PUBLIC SCHOOLS,PAUL BUZBEE,,80810,0,0,7,7,OFFICE NO. 2 GRACEMONT PUBLIC SCHOOLS
CADDO,OFFICE NO. 2 GRACEMONT PUBLIC SCHOOLS,ALESE SAVAGE,,80810,0,0,0,0,OFFICE NO. 2 GRACEMONT PUBLIC SCHOOLS
CADDO,OFFICE NO. 2 ANADARKO PUBLIC SCHOOLS,RENEE HILL,,80811,0,0,1,1,OFFICE NO. 2 ANADARKO PUBLIC SCHOOLS
CADDO,OFFICE NO. 2 ANADARKO PUBLIC SCHOOLS,MYLES STEPHENSON JR.,,80811,0,0,1,1,OFFICE NO. 2 ANADARKO PUBLIC SCHOOLS
CADDO,OFFICE NO. 2 GRACEMONT PUBLIC SCHOOLS,DONITA SETTLE,,80811,0,1,13,14,OFFICE NO. 2 GRACEMONT PUBLIC SCHOOLS
CADDO,OFFICE NO. 2 GRACEMONT PUBLIC SCHOOLS,PAUL BUZBEE,,80811,0,2,8,10,OFFICE NO. 2 GRACEMONT PUBLIC SCHOOLS
CADDO,OFFICE NO. 2 GRACEMONT PUBLIC SCHOOLS,ALESE SAVAGE,,80811,0,1,16,17,OFFICE NO. 2 GRACEMONT PUBLIC SCHOOLS
CADDO,OFFICE NO. 2 VERDEN PUBLIC SCHOOLS,CHAD THARP,,80811,2,0,10,12,OFFICE NO. 2 VERDEN PUBLIC SCHOOLS
CADDO,OFFICE NO. 2 VERDEN PUBLIC SCHOOLS,MICHAEL PERRAULT,,80811,2,1,0,3,OFFICE NO. 2 VERDEN PUBLIC SCHOOLS
CADDO,PROPOSITION VERDEN PUBLIC SCHOOLS,FOR THE PROPOSITION - YES,,80811,2,1,6,9,
CADDO,PROPOSITION VERDEN PUBLIC SCHOOLS,AGAINST THE PROPOSITION - NO,,80811,2,0,4,6,
CADDO,OFFICE NO. 2 GRACEMONT PUBLIC SCHOOLS,DONITA SETTLE,,81009,0,0,0,0,OFFICE NO. 2 GRACEMONT PUBLIC SCHOOLS
CADDO,OFFICE NO. 2 GRACEMONT PUBLIC SCHOOLS,PAUL BUZBEE,,81009,0,1,0,1,OFFICE NO. 2 GRACEMONT PUBLIC SCHOOLS
CADDO,OFFICE NO. 2 GRACEMONT PUBLIC SCHOOLS,ALESE SAVAGE,,81009,0,0,2,2,OFFICE NO. 2 GRACEMONT PUBLIC SCHOOLS
CADDO,OFFICE NO. 2 GRACEMONT PUBLIC SCHOOLS,DONITA SETTLE,,81010,0,0,0,0,OFFICE NO. 2 GRACEMONT PUBLIC SCHOOLS
CADDO,OFFICE NO. 2 GRACEMONT PUBLIC SCHOOLS,PAUL BUZBEE,,81010,0,0,0,0,OFFICE NO. 2 GRACEMONT PUBLIC SCHOOLS
CADDO,OFFICE NO. 2 GRACEMONT PUBLIC SCHOOLS,ALESE SAVAGE,,81010,0,0,0,0,OFFICE NO. 2 GRACEMONT PUBLIC SCHOOLS
CADDO,OFFICE NO. 2 WESTERN TECH CENTER,GARY D. SMITH,,81013,0,0,0,0,OFFICE NO. 2 WESTERN TECH CENTER
CADDO,OFFICE NO. 2 WESTERN TECH CENTER,BILL JOHANNING,,81013,0,0,0,0,OFFICE NO. 2 WESTERN TECH CENTER
CANADIAN,OFFICE NO. 3 RIVERSIDE PUBLIC SCHOOL,BRENTON CHAFFEE,,90100,0,0,10,10,OFFICE NO. 3 RIVERSIDE PUBLIC SCHOOL
CANADIAN,OFFICE NO. 3 RIVERSIDE PUBLIC SCHOOL,KARRI LANCASTER,,90100,0,0,19,19,OFFICE NO. 3 RIVERSIDE PUBLIC SCHOOL
CANADIAN,OFFICE NO. 3 RIVERSIDE PUBLIC SCHOOL,BRENTON CHAFFEE,,90107,0,0,0,0,OFFICE NO. 3 RIVERSIDE PUBLIC SCHOOL
CANADIAN,OFFICE NO. 3 RIVERSIDE PUBLIC SCHOOL,KARRI LANCASTER,,90107,0,0,0,0,OFFICE NO. 3 RIVERSIDE PUBLIC SCHOOL
CANADIAN,OFFICE NO. 3 RIVERSIDE PUBLIC SCHOOL,BRENTON CHAFFEE,,90114,0,0,1,1,OFFICE NO. 3 RIVERSIDE PUBLIC SCHOOL
CANADIAN,OFFICE NO. 3 RIVERSIDE PUBLIC SCHOOL,KARRI LANCASTER,,90114,0,0,1,1,OFFICE NO. 3 RIVERSIDE PUBLIC SCHOOL
CANADIAN,"COUNCILMEMBER, WARD 1 CITY OF OKLAHOMA CITY",CHRIS GORDON,,90200,1,0,157,158,"COUNCILMEMBER, WARD 1 CITY OF OKLAHOMA CITY"
CANADIAN,"COUNCILMEMBER, WARD 1 CITY OF OKLAHOMA CITY",JAMES GREINER,,90200,13,0,65,78,"COUNCILMEMBER, WARD 1 CITY OF OKLAHOMA CITY"
CANADIAN,"COUNCILMEMBER, WARD 1 CITY OF OKLAHOMA CITY",JONATHAN CLOUR,,90200,2,0,6,8,"COUNCILMEMBER, WARD 1 CITY OF OKLAHOMA CITY"
CANADIAN,"COUNCILMEMBER, WARD 1 CITY OF OKLAHOMA CITY",CHRIS GORDON,,90201,0,0,6,6,"COUNCILMEMBER, WARD 1 CITY OF OKLAHOMA CITY"
CANADIAN,"COUNCILMEMBER, WARD 1 CITY OF OKLAHOMA CITY",JAMES GREINER,,90201,4,0,15,19,"COUNCILMEMBER, WARD 1 CITY OF OKLAHOMA CITY"
CANADIAN,"COUNCILMEMBER, WARD 1 CITY OF OKLAHOMA CITY",JONATHAN CLOUR,,90201,0,0,0,0,"COUNCILMEMBER, WARD 1 CITY OF OKLAHOMA CITY"
CANADIAN,"COUNCILMEMBER, WARD 3 CITY OF OKLAHOMA CITY",LARRY McATEE,,90201,0,0,0,0,"COUNCILMEMBER, WARD 3 CITY OF OKLAHOMA CITY"
CANADIAN,"COUNCILMEMBER, WARD 3 CITY OF OKLAHOMA CITY",MATTHEW W. OLSEN,,90201,0,0,0,0,"COUNCILMEMBER, WARD 3 CITY OF OKLAHOMA CITY"
CANADIAN,"COUNCILMEMBER, WARD 3 CITY OF OKLAHOMA CITY",JOE SARGE NELSON,,90201,0,0,0,0,"COUNCILMEMBER, WARD 3 CITY OF OKLAHOMA CITY"
CANADIAN,OFFICE NO. 3 RIVERSIDE PUBLIC SCHOOL,BRENTON CHAFFEE,,90201,0,0,18,18,OFFICE NO. 3 RIVERSIDE PUBLIC SCHOOL
CANADIAN,OFFICE NO. 3 RIVERSIDE PUBLIC SCHOOL,KARRI LANCASTER,,90201,0,0,6,6,OFFICE NO. 3 RIVERSIDE PUBLIC SCHOOL
CANADIAN,"COUNCILMEMBER, WARD 1 CITY OF OKLAHOMA CITY",CHRIS GORDON,,90202,0,0,3,3,"COUNCILMEMBER, WARD 1 CITY OF OKLAHOMA CITY"
CANADIAN,"COUNCILMEMBER, WARD 1 CITY OF OKLAHOMA CITY",JAMES GREINER,,90202,0,0,1,1,"COUNCILMEMBER, WARD 1 CITY OF OKLAHOMA CITY"
CANADIAN,"COUNCILMEMBER, WARD 1 CITY OF OKLAHOMA CITY",JONATHAN CLOUR,,90202,0,0,0,0,"COUNCILMEMBER, WARD 1 CITY OF OKLAHOMA CITY"
CANADIAN,OFFICE NO. 3 RIVERSIDE PUBLIC SCHOOL,BRENTON CHAFFEE,,90202,0,0,15,15,OFFICE NO. 3 RIVERSIDE PUBLIC SCHOOL
CANADIAN,OFFICE NO. 3 RIVERSIDE PUBLIC SCHOOL,KARRI LANCASTER,,90202,0,0,1,1,OFFICE NO. 3 RIVERSIDE PUBLIC SCHOOL
CANADIAN,OFFICE NO. 2 OKARCHE PUBLIC SCHOOLS,HEATHER NANCE,,90202,0,0,0,0,OFFICE NO. 2 OKARCHE PUBLIC SCHOOLS
CANADIAN,OFFICE NO. 2 OKARCHE PUBLIC SCHOOLS,DAVID MAYHEW,,90202,0,0,0,0,OFFICE NO. 2 OKARCHE PUBLIC SCHOOLS
CANADIAN,"COUNCILMEMBER, WARD 1 CITY OF OKLAHOMA CITY",CHRIS GORDON,,90206,2,0,1,3,"COUNCILMEMBER, WARD 1 CITY OF OKLAHOMA CITY"
CANADIAN,"COUNCILMEMBER, WARD 1 CITY OF OKLAHOMA CITY",JAMES GREINER,,90206,0,0,10,10,"COUNCILMEMBER, WARD 1 CITY OF OKLAHOMA CITY"
CANADIAN,"COUNCILMEMBER, WARD 1 CITY OF OKLAHOMA CITY",JONATHAN CLOUR,,90206,0,0,2,2,"COUNCILMEMBER, WARD 1 CITY OF OKLAHOMA CITY"
CANADIAN,"COUNCILMEMBER, WARD 3 CITY OF OKLAHOMA CITY",LARRY McATEE,,90211,1,1,19,21,"COUNCILMEMBER, WARD 3 CITY OF OKLAHOMA CITY"
CANADIAN,"COUNCILMEMBER, WARD 3 CITY OF OKLAHOMA CITY",MATTHEW W. OLSEN,,90211,1,0,21,22,"COUNCILMEMBER, WARD 3 CITY OF OKLAHOMA CITY"
CANADIAN,"COUNCILMEMBER, WARD 3 CITY OF OKLAHOMA CITY",JOE SARGE NELSON,,90211,0,0,7,7,"COUNCILMEMBER, WARD 3 CITY OF OKLAHOMA CITY"
CANADIAN,OFFICE NO. 4 (UNEXPIRED TERM) MUSTANG PUBLIC SCHOOLS,BARBARA YOUNG,,90211,1,0,14,15,OFFICE NO. 4 (UNEXPIRED TERM) MUSTANG PUBLIC SCHOOLS
CANADIAN,OFFICE NO. 4 (UNEXPIRED TERM) MUSTANG PUBLIC SCHOOLS,CHAD SCHROEDER,,90211,1,0,29,30,OFFICE NO. 4 (UNEXPIRED TERM) MUSTANG PUBLIC SCHOOLS
CANADIAN,PROPOSITION NO. 1 MUSTANG PUBLIC SCHOOLS,FOR THE PROPOSITION - YES,,90211,1,0,34,35,PROPOSITION NO. 1 MUSTANG PUBLIC SCHOOLS
CANADIAN,PROPOSITION NO. 1 MUSTANG PUBLIC SCHOOLS,AGAINST THE PROPOSITION - NO,,90211,1,0,10,11,PROPOSITION NO. 1 MUSTANG PUBLIC SCHOOLS
CANADIAN,PROPOSITION NO. 2 MUSTANG PUBLIC SCHOOLS,FOR THE PROPOSITION - YES,,90211,1,0,32,33,PROPOSITION NO. 2 MUSTANG PUBLIC SCHOOLS
CANADIAN,PROPOSITION NO. 2 MUSTANG PUBLIC SCHOOLS,AGAINST THE PROPOSITION - NO,,90211,1,0,11,12,PROPOSITION NO. 2 MUSTANG PUBLIC SCHOOLS
CANADIAN,"COUNCILMEMBER, WARD 1 CITY OF OKLAHOMA CITY",CHRIS GORDON,,90215,0,0,32,32,"COUNCILMEMBER, WARD 1 CITY OF OKLAHOMA CITY"
CANADIAN,"COUNCILMEMBER, WARD 1 CITY OF OKLAHOMA CITY",JAMES GREINER,,90215,2,0,49,51,"COUNCILMEMBER, WARD 1 CITY OF OKLAHOMA CITY"
CANADIAN,"COUNCILMEMBER, WARD 1 CITY OF OKLAHOMA CITY",JONATHAN CLOUR,,90215,0,0,10,10,"COUNCILMEMBER, WARD 1 CITY OF OKLAHOMA CITY"
CANADIAN,"COUNCILMEMBER, WARD 3 CITY OF OKLAHOMA CITY",LARRY McATEE,,90215,1,0,11,12,"COUNCILMEMBER, WARD 3 CITY OF OKLAHOMA CITY"
CANADIAN,"COUNCILMEMBER, WARD 3 CITY OF OKLAHOMA CITY",MATTHEW W. OLSEN,,90215,1,0,14,15,"COUNCILMEMBER, WARD 3 CITY OF OKLAHOMA CITY"
CANADIAN,"COUNCILMEMBER, WARD 3 CITY OF OKLAHOMA CITY",JOE SARGE NELSON,,90215,1,0,3,4,"COUNCILMEMBER, WARD 3 CITY OF OKLAHOMA CITY"
CANADIAN,OFFICE NO. 4 (UNEXPIRED TERM) MUSTANG PUBLIC SCHOOLS,BARBARA YOUNG,,90215,3,0,45,48,OFFICE NO. 4 (UNEXPIRED TERM) MUSTANG PUBLIC SCHOOLS
CANADIAN,OFFICE NO. 4 (UNEXPIRED TERM) MUSTANG PUBLIC SCHOOLS,CHAD SCHROEDER,,90215,1,0,52,53,OFFICE NO. 4 (UNEXPIRED TERM) MUSTANG PUBLIC SCHOOLS
CANADIAN,PROPOSITION NO. 1 MUSTANG PUBLIC SCHOOLS,FOR THE PROPOSITION - YES,,90215,3,0,79,82,PROPOSITION NO. 1 MUSTANG PUBLIC SCHOOLS
CANADIAN,PROPOSITION NO. 1 MUSTANG PUBLIC SCHOOLS,AGAINST THE PROPOSITION - NO,,90215,2,0,21,23,PROPOSITION NO. 1 MUSTANG PUBLIC SCHOOLS
CANADIAN,PROPOSITION NO. 2 MUSTANG PUBLIC SCHOOLS,FOR THE PROPOSITION - YES,,90215,3,0,83,86,PROPOSITION NO. 2 MUSTANG PUBLIC SCHOOLS
CANADIAN,PROPOSITION NO. 2 MUSTANG PUBLIC SCHOOLS,AGAINST THE PROPOSITION - NO,,90215,2,0,17,19,PROPOSITION NO. 2 MUSTANG PUBLIC SCHOOLS
CANADIAN,"COUNCILMEMBER, WARD 1 CITY OF OKLAHOMA CITY",CHRIS GORDON,,90217,0,0,8,8,"COUNCILMEMBER, WARD 1 CITY OF OKLAHOMA CITY"
CANADIAN,"COUNCILMEMBER, WARD 1 CITY OF OKLAHOMA CITY",JAMES GREINER,,90217,7,0,26,33,"COUNCILMEMBER, WARD 1 CITY OF OKLAHOMA CITY"
CANADIAN,"COUNCILMEMBER, WARD 1 CITY OF OKLAHOMA CITY",JONATHAN CLOUR,,90217,0,0,3,3,"COUNCILMEMBER, WARD 1 CITY OF OKLAHOMA CITY"
CANADIAN,"COUNCILMEMBER, WARD 1 CITY OF OKLAHOMA CITY",CHRIS GORDON,,90220,0,0,3,3,"COUNCILMEMBER, WARD 1 CITY OF OKLAHOMA CITY"
CANADIAN,"COUNCILMEMBER, WARD 1 CITY OF OKLAHOMA CITY",JAMES GREINER,,90220,0,0,8,8,"COUNCILMEMBER, WARD 1 CITY OF OKLAHOMA CITY"
CANADIAN,"COUNCILMEMBER, WARD 1 CITY OF OKLAHOMA CITY",JONATHAN CLOUR,,90220,0,0,1,1,"COUNCILMEMBER, WARD 1 CITY OF OKLAHOMA CITY"
CANADIAN,"COUNCILMEMBER, WARD 3 CITY OF OKLAHOMA CITY",LARRY McATEE,,90221,3,2,44,49,"COUNCILMEMBER, WARD 3 CITY OF OKLAHOMA CITY"
CANADIAN,"COUNCILMEMBER, WARD 3 CITY OF OKLAHOMA CITY",MATTHEW W. OLSEN,,90221,1,0,44,45,"COUNCILMEMBER, WARD 3 CITY OF OKLAHOMA CITY"
CANADIAN,"COUNCILMEMBER, WARD 3 CITY OF OKLAHOMA CITY",JOE SARGE NELSON,,90221,2,0,10,12,"COUNCILMEMBER, WARD 3 CITY OF OKLAHOMA CITY"
CANADIAN,OFFICE NO. 4 (UNEXPIRED TERM) MUSTANG PUBLIC SCHOOLS,BARBARA YOUNG,,90221,2,1,43,46,OFFICE NO. 4 (UNEXPIRED TERM) MUSTANG PUBLIC SCHOOLS
CANADIAN,OFFICE NO. 4 (UNEXPIRED TERM) MUSTANG PUBLIC SCHOOLS,CHAD SCHROEDER,,90221,3,0,52,55,OFFICE NO. 4 (UNEXPIRED TERM) MUSTANG PUBLIC SCHOOLS
CANADIAN,PROPOSITION NO. 1 MUSTANG PUBLIC SCHOOLS,FOR THE PROPOSITION - YES,,90221,0,0,89,89,PROPOSITION NO. 1 MUSTANG PUBLIC SCHOOLS
CANADIAN,PROPOSITION NO. 1 MUSTANG PUBLIC SCHOOLS,AGAINST THE PROPOSITION - NO,,90221,6,2,19,27,PROPOSITION NO. 1 MUSTANG PUBLIC SCHOOLS
CANADIAN,PROPOSITION NO. 2 MUSTANG PUBLIC SCHOOLS,FOR THE PROPOSITION - YES,,90221,0,0,89,89,PROPOSITION NO. 2 MUSTANG PUBLIC SCHOOLS
CANADIAN,PROPOSITION NO. 2 MUSTANG PUBLIC SCHOOLS,AGAINST THE PROPOSITION - NO,,90221,6,2,19,27,PROPOSITION NO. 2 MUSTANG PUBLIC SCHOOLS
CANADIAN,"COUNCILMEMBER, WARD 3 CITY OF OKLAHOMA CITY",LARRY McATEE,,90223,7,0,87,94,"COUNCILMEMBER, WARD 3 CITY OF OKLAHOMA CITY"
CANADIAN,"COUNCILMEMBER, WARD 3 CITY OF OKLAHOMA CITY",MATTHEW W. OLSEN,,90223,2,0,70,72,"COUNCILMEMBER, WARD 3 CITY OF OKLAHOMA CITY"
CANADIAN,"COUNCILMEMBER, WARD 3 CITY OF OKLAHOMA CITY",JOE SARGE NELSON,,90223,1,0,29,30,"COUNCILMEMBER, WARD 3 CITY OF OKLAHOMA CITY"
CANADIAN,OFFICE NO. 4 (UNEXPIRED TERM) MUSTANG PUBLIC SCHOOLS,BARBARA YOUNG,,90223,3,0,80,83,OFFICE NO. 4 (UNEXPIRED TERM) MUSTANG PUBLIC SCHOOLS
CANADIAN,OFFICE NO. 4 (UNEXPIRED TERM) MUSTANG PUBLIC SCHOOLS,CHAD SCHROEDER,,90223,4,0,97,101,OFFICE NO. 4 (UNEXPIRED TERM) MUSTANG PUBLIC SCHOOLS
CANADIAN,PROPOSITION NO. 1 MUSTANG PUBLIC SCHOOLS,FOR THE PROPOSITION - YES,,90223,5,0,148,153,PROPOSITION NO. 1 MUSTANG PUBLIC SCHOOLS
CANADIAN,PROPOSITION NO. 1 MUSTANG PUBLIC SCHOOLS,AGAINST THE PROPOSITION - NO,,90223,5,0,53,58,PROPOSITION NO. 1 MUSTANG PUBLIC SCHOOLS
CANADIAN,PROPOSITION NO. 2 MUSTANG PUBLIC SCHOOLS,FOR THE PROPOSITION - YES,,90223,5,0,145,150,PROPOSITION NO. 2 MUSTANG PUBLIC SCHOOLS
CANADIAN,PROPOSITION NO. 2 MUSTANG PUBLIC SCHOOLS,AGAINST THE PROPOSITION - NO,,90223,5,0,55,60,PROPOSITION NO. 2 MUSTANG PUBLIC SCHOOLS
CANADIAN,"COUNCILMEMBER, WARD 3 CITY OF OKLAHOMA CITY",LARRY McATEE,,90224,2,0,38,40,"COUNCILMEMBER, WARD 3 CITY OF OKLAHOMA CITY"
CANADIAN,"COUNCILMEMBER, WARD 3 CITY OF OKLAHOMA CITY",MATTHEW W. OLSEN,,90224,0,0,45,45,"COUNCILMEMBER, WARD 3 CITY OF OKLAHOMA CITY"
CANADIAN,"COUNCILMEMBER, WARD 3 CITY OF OKLAHOMA CITY",JOE SARGE NELSON,,90224,0,0,10,10,"COUNCILMEMBER, WARD 3 CITY OF OKLAHOMA CITY"
CANADIAN,OFFICE NO. 4 (UNEXPIRED TERM) MUSTANG PUBLIC SCHOOLS,BARBARA YOUNG,,90224,1,0,39,40,OFFICE NO. 4 (UNEXPIRED TERM) MUSTANG PUBLIC SCHOOLS
CANADIAN,OFFICE NO. 4 (UNEXPIRED TERM) MUSTANG PUBLIC SCHOOLS,CHAD SCHROEDER,,90224,0,0,45,45,OFFICE NO. 4 (UNEXPIRED TERM) MUSTANG PUBLIC SCHOOLS
CANADIAN,PROPOSITION NO. 1 MUSTANG PUBLIC SCHOOLS,FOR THE PROPOSITION - YES,,90224,0,0,93,93,PROPOSITION NO. 1 MUSTANG PUBLIC SCHOOLS
CANADIAN,PROPOSITION NO. 1 MUSTANG PUBLIC SCHOOLS,AGAINST THE PROPOSITION - NO,,90224,2,0,7,9,PROPOSITION NO. 1 MUSTANG PUBLIC SCHOOLS
CANADIAN,PROPOSITION NO. 2 MUSTANG PUBLIC SCHOOLS,FOR THE PROPOSITION - YES,,90224,0,0,89,89,PROPOSITION NO. 2 MUSTANG PUBLIC SCHOOLS
CANADIAN,PROPOSITION NO. 2 MUSTANG PUBLIC SCHOOLS,AGAINST THE PROPOSITION - NO,,90224,2,0,11,13,PROPOSITION NO. 2 MUSTANG PUBLIC SCHOOLS
CANADIAN,"COUNCILMEMBER, WARD 3 CITY OF OKLAHOMA CITY",LARRY McATEE,,90225,4,0,41,45,"COUNCILMEMBER, WARD 3 CITY OF OKLAHOMA CITY"
CANADIAN,"COUNCILMEMBER, WARD 3 CITY OF OKLAHOMA CITY",MATTHEW W. OLSEN,,90225,4,0,46,50,"COUNCILMEMBER, WARD 3 CITY OF OKLAHOMA CITY"
CANADIAN,"COUNCILMEMBER, WARD 3 CITY OF OKLAHOMA CITY",JOE SARGE NELSON,,90225,0,0,6,6,"COUNCILMEMBER, WARD 3 CITY OF OKLAHOMA CITY"
CANADIAN,OFFICE NO. 4 (UNEXPIRED TERM) MUSTANG PUBLIC SCHOOLS,BARBARA YOUNG,,90225,5,0,44,49,OFFICE NO. 4 (UNEXPIRED TERM) MUSTANG PUBLIC SCHOOLS
CANADIAN,OFFICE NO. 4 (UNEXPIRED TERM) MUSTANG PUBLIC SCHOOLS,CHAD SCHROEDER,,90225,3,0,50,53,OFFICE NO. 4 (UNEXPIRED TERM) MUSTANG PUBLIC SCHOOLS
CANADIAN,PROPOSITION NO. 1 MUSTANG PUBLIC SCHOOLS,FOR THE PROPOSITION - YES,,90225,3,0,87,90,PROPOSITION NO. 1 MUSTANG PUBLIC SCHOOLS
CANADIAN,PROPOSITION NO. 1 MUSTANG PUBLIC SCHOOLS,AGAINST THE PROPOSITION - NO,,90225,5,0,22,27,PROPOSITION NO. 1 MUSTANG PUBLIC SCHOOLS
CANADIAN,PROPOSITION NO. 2 MUSTANG PUBLIC SCHOOLS,FOR THE PROPOSITION - YES,,90225,3,0,88,91,PROPOSITION NO. 2 MUSTANG PUBLIC SCHOOLS
CANADIAN,PROPOSITION NO. 2 MUSTANG PUBLIC SCHOOLS,AGAINST THE PROPOSITION - NO,,90225,5,0,21,26,PROPOSITION NO. 2 MUSTANG PUBLIC SCHOOLS
CANADIAN,"COUNCILMEMBER, WARD 3 CITY OF OKLAHOMA CITY",LARRY McATEE,,90226,3,0,3,6,"COUNCILMEMBER, WARD 3 CITY OF OKLAHOMA CITY"
CANADIAN,"COUNCILMEMBER, WARD 3 CITY OF OKLAHOMA CITY",MATTHEW W. OLSEN,,90226,0,0,1,1,"COUNCILMEMBER, WARD 3 CITY OF OKLAHOMA CITY"
CANADIAN,"COUNCILMEMBER, WARD 3 CITY OF OKLAHOMA CITY",JOE SARGE NELSON,,90226,0,0,1,1,"COUNCILMEMBER, WARD 3 CITY OF OKLAHOMA CITY"
CANADIAN,"COUNCILMEMBER, WARD 3 CITY OF OKLAHOMA CITY",LARRY McATEE,,90227,17,0,119,136,"COUNCILMEMBER, WARD 3 CITY OF OKLAHOMA CITY"
CANADIAN,"COUNCILMEMBER, WARD 3 CITY OF OKLAHOMA CITY",MATTHEW W. OLSEN,,90227,3,0,102,105,"COUNCILMEMBER, WARD 3 CITY OF OKLAHOMA CITY"
CANADIAN,"COUNCILMEMBER, WARD 3 CITY OF OKLAHOMA CITY",JOE SARGE NELSON,,90227,2,0,31,33,"COUNCILMEMBER, WARD 3 CITY OF OKLAHOMA CITY"
CANADIAN,OFFICE NO. 4 (UNEXPIRED TERM) MUSTANG PUBLIC SCHOOLS,BARBARA YOUNG,,90227,10,0,100,110,OFFICE NO. 4 (UNEXPIRED TERM) MUSTANG PUBLIC SCHOOLS
CANADIAN,OFFICE NO. 4 (UNEXPIRED TERM) MUSTANG PUBLIC SCHOOLS,CHAD SCHROEDER,,90227,9,0,130,139,OFFICE NO. 4 (UNEXPIRED TERM) MUSTANG PUBLIC SCHOOLS
CANADIAN,PROPOSITION NO. 1 MUSTANG PUBLIC SCHOOLS,FOR THE PROPOSITION - YES,,90227,10,0,228,238,PROPOSITION NO. 1 MUSTANG PUBLIC SCHOOLS
CANADIAN,PROPOSITION NO. 1 MUSTANG PUBLIC SCHOOLS,AGAINST THE PROPOSITION - NO,,90227,12,0,41,53,PROPOSITION NO. 1 MUSTANG PUBLIC SCHOOLS
CANADIAN,PROPOSITION NO. 2 MUSTANG PUBLIC SCHOOLS,FOR THE PROPOSITION - YES,,90227,10,0,230,240,PROPOSITION NO. 2 MUSTANG PUBLIC SCHOOLS
CANADIAN,PROPOSITION NO. 2 MUSTANG PUBLIC SCHOOLS,AGAINST THE PROPOSITION - NO,,90227,12,0,39,51,PROPOSITION NO. 2 MUSTANG PUBLIC SCHOOLS
CANADIAN,"COUNCILMEMBER, WARD 1 CITY OF OKLAHOMA CITY",CHRIS GORDON,,90228,0,0,0,0,"COUNCILMEMBER, WARD 1 CITY OF OKLAHOMA CITY"
CANADIAN,"COUNCILMEMBER, WARD 1 CITY OF OKLAHOMA CITY",JAMES GREINER,,90228,0,0,0,0,"COUNCILMEMBER, WARD 1 CITY OF OKLAHOMA CITY"
CANADIAN,"COUNCILMEMBER, WARD 1 CITY OF OKLAHOMA CITY",JONATHAN CLOUR,,90228,0,0,0,0,"COUNCILMEMBER, WARD 1 CITY OF OKLAHOMA CITY"
CANADIAN,"COUNCILMEMBER, WARD 3 CITY OF OKLAHOMA CITY",LARRY McATEE,,90228,2,0,9,11,"COUNCILMEMBER, WARD 3 CITY OF OKLAHOMA CITY"
CANADIAN,"COUNCILMEMBER, WARD 3 CITY OF OKLAHOMA CITY",MATTHEW W. OLSEN,,90228,0,0,9,9,"COUNCILMEMBER, WARD 3 CITY OF OKLAHOMA CITY"
CANADIAN,"COUNCILMEMBER, WARD 3 CITY OF OKLAHOMA CITY",JOE SARGE NELSON,,90228,1,0,2,3,"COUNCILMEMBER, WARD 3 CITY OF OKLAHOMA CITY"
CANADIAN,OFFICE NO. 4 (UNEXPIRED TERM) MUSTANG PUBLIC SCHOOLS,BARBARA YOUNG,,90228,2,0,6,8,OFFICE NO. 4 (UNEXPIRED TERM) MUSTANG PUBLIC SCHOOLS
CANADIAN,OFFICE NO. 4 (UNEXPIRED TERM) MUSTANG PUBLIC SCHOOLS,CHAD SCHROEDER,,90228,0,0,11,11,OFFICE NO. 4 (UNEXPIRED TERM) MUSTANG PUBLIC SCHOOLS
CANADIAN,PROPOSITION NO. 1 MUSTANG PUBLIC SCHOOLS,FOR THE PROPOSITION - YES,,90228,2,0,20,22,PROPOSITION NO. 1 MUSTANG PUBLIC SCHOOLS
CANADIAN,PROPOSITION NO. 1 MUSTANG PUBLIC SCHOOLS,AGAINST THE PROPOSITION - NO,,90228,1,0,2,3,PROPOSITION NO. 1 MUSTANG PUBLIC SCHOOLS
CANADIAN,PROPOSITION NO. 2 MUSTANG PUBLIC SCHOOLS,FOR THE PROPOSITION - YES,,90228,0,0,20,20,PROPOSITION NO. 2 MUSTANG PUBLIC SCHOOLS
CANADIAN,PROPOSITION NO. 2 MUSTANG PUBLIC SCHOOLS,AGAINST THE PROPOSITION - NO,,90228,3,0,2,5,PROPOSITION NO. 2 MUSTANG PUBLIC SCHOOLS
CANADIAN,OFFICE NO. 4 (UNEXPIRED TERM) MUSTANG PUBLIC SCHOOLS,BARBARA YOUNG,,90300,3,0,98,101,OFFICE NO. 4 (UNEXPIRED TERM) MUSTANG PUBLIC SCHOOLS
CANADIAN,OFFICE NO. 4 (UNEXPIRED TERM) MUSTANG PUBLIC SCHOOLS,CHAD SCHROEDER,,90300,4,1,138,143,OFFICE NO. 4 (UNEXPIRED TERM) MUSTANG PUBLIC SCHOOLS
CANADIAN,PROPOSITION NO. 1 MUSTANG PUBLIC SCHOOLS,FOR THE PROPOSITION - YES,,90300,3,1,150,154,PROPOSITION NO. 1 MUSTANG PUBLIC SCHOOLS
CANADIAN,PROPOSITION NO. 1 MUSTANG PUBLIC SCHOOLS,AGAINST THE PROPOSITION - NO,,90300,5,0,110,115,PROPOSITION NO. 1 MUSTANG PUBLIC SCHOOLS
CANADIAN,PROPOSITION NO. 2 MUSTANG PUBLIC SCHOOLS,FOR THE PROPOSITION - YES,,90300,2,1,157,160,PROPOSITION NO. 2 MUSTANG PUBLIC SCHOOLS
CANADIAN,PROPOSITION NO. 2 MUSTANG PUBLIC SCHOOLS,AGAINST THE PROPOSITION - NO,,90300,6,0,103,109,PROPOSITION NO. 2 MUSTANG PUBLIC SCHOOLS
CANADIAN,OFFICE NO. 4 (UNEXPIRED TERM) MUSTANG PUBLIC SCHOOLS,BARBARA YOUNG,,90301,12,1,106,119,OFFICE NO. 4 (UNEXPIRED TERM) MUSTANG PUBLIC SCHOOLS
CANADIAN,OFFICE NO. 4 (UNEXPIRED TERM) MUSTANG PUBLIC SCHOOLS,CHAD SCHROEDER,,90301,12,1,171,184,OFFICE NO. 4 (UNEXPIRED TERM) MUSTANG PUBLIC SCHOOLS
CANADIAN,PROPOSITION NO. 1 MUSTANG PUBLIC SCHOOLS,FOR THE PROPOSITION - YES,,90301,11,0,216,227,PROPOSITION NO. 1 MUSTANG PUBLIC SCHOOLS
CANADIAN,PROPOSITION NO. 1 MUSTANG PUBLIC SCHOOLS,AGAINST THE PROPOSITION - NO,,90301,15,3,114,132,PROPOSITION NO. 1 MUSTANG PUBLIC SCHOOLS
CANADIAN,PROPOSITION NO. 2 MUSTANG PUBLIC SCHOOLS,FOR THE PROPOSITION - YES,,90301,9,0,209,218,PROPOSITION NO. 2 MUSTANG PUBLIC SCHOOLS
CANADIAN,PROPOSITION NO. 2 MUSTANG PUBLIC SCHOOLS,AGAINST THE PROPOSITION - NO,,90301,17,3,121,141,PROPOSITION NO. 2 MUSTANG PUBLIC SCHOOLS
CANADIAN,"COUNCILMEMBER, WARD 3 CITY OF OKLAHOMA CITY",LARRY McATEE,,90302,7,0,63,70,"COUNCILMEMBER, WARD 3 CITY OF OKLAHOMA CITY"
CANADIAN,"COUNCILMEMBER, WARD 3 CITY OF OKLAHOMA CITY",MATTHEW W. OLSEN,,90302,1,0,29,30,"COUNCILMEMBER, WARD 3 CITY OF OKLAHOMA CITY"
CANADIAN,"COUNCILMEMBER, WARD 3 CITY OF OKLAHOMA CITY",JOE SARGE NELSON,,90302,0,0,14,14,"COUNCILMEMBER, WARD 3 CITY OF OKLAHOMA CITY"
CANADIAN,OFFICE NO. 4 (UNEXPIRED TERM) MUSTANG PUBLIC SCHOOLS,BARBARA YOUNG,,90302,8,0,91,99,OFFICE NO. 4 (UNEXPIRED TERM) MUSTANG PUBLIC SCHOOLS
CANADIAN,OFFICE NO. 4 (UNEXPIRED TERM) MUSTANG PUBLIC SCHOOLS,CHAD SCHROEDER,,90302,4,0,121,125,OFFICE NO. 4 (UNEXPIRED TERM) MUSTANG PUBLIC SCHOOLS
CANADIAN,PROPOSITION NO. 1 MUSTANG PUBLIC SCHOOLS,FOR THE PROPOSITION - YES,,90302,4,0,138,142,PROPOSITION NO. 1 MUSTANG PUBLIC SCHOOLS
CANADIAN,PROPOSITION NO. 1 MUSTANG PUBLIC SCHOOLS,AGAINST THE PROPOSITION - NO,,90302,10,0,103,113,PROPOSITION NO. 1 MUSTANG PUBLIC SCHOOLS
CANADIAN,PROPOSITION NO. 2 MUSTANG PUBLIC SCHOOLS,FOR THE PROPOSITION - YES,,90302,4,0,140,144,PROPOSITION NO. 2 MUSTANG PUBLIC SCHOOLS
CANADIAN,PROPOSITION NO. 2 MUSTANG PUBLIC SCHOOLS,AGAINST THE PROPOSITION - NO,,90302,10,0,100,110,PROPOSITION NO. 2 MUSTANG PUBLIC SCHOOLS
CANADIAN,"COUNCILMEMBER, WARD 3 CITY OF OKLAHOMA CITY",LARRY McATEE,,90303,8,0,138,146,"COUNCILMEMBER, WARD 3 CITY OF OKLAHOMA CITY"
CANADIAN,"COUNCILMEMBER, WARD 3 CITY OF OKLAHOMA CITY",MATTHEW W. OLSEN,,90303,10,0,93,103,"COUNCILMEMBER, WARD 3 CITY OF OKLAHOMA CITY"
CANADIAN,"COUNCILMEMBER, WARD 3 CITY OF OKLAHOMA CITY",JOE SARGE NELSON,,90303,2,0,33,35,"COUNCILMEMBER, WARD 3 CITY OF OKLAHOMA CITY"
CANADIAN,OFFICE NO. 4 (UNEXPIRED TERM) MUSTANG PUBLIC SCHOOLS,BARBARA YOUNG,,90303,9,0,102,111,OFFICE NO. 4 (UNEXPIRED TERM) MUSTANG PUBLIC SCHOOLS
CANADIAN,OFFICE NO. 4 (UNEXPIRED TERM) MUSTANG PUBLIC SCHOOLS,CHAD SCHROEDER,,90303,13,0,149,162,OFFICE NO. 4 (UNEXPIRED TERM) MUSTANG PUBLIC SCHOOLS
CANADIAN,PROPOSITION NO. 1 MUSTANG PUBLIC SCHOOLS,FOR THE PROPOSITION - YES,,90303,13,0,187,200,PROPOSITION NO. 1 MUSTANG PUBLIC SCHOOLS
CANADIAN,PROPOSITION NO. 1 MUSTANG PUBLIC SCHOOLS,AGAINST THE PROPOSITION - NO,,90303,10,0,98,108,PROPOSITION NO. 1 MUSTANG PUBLIC SCHOOLS
CANADIAN,PROPOSITION NO. 2 MUSTANG PUBLIC SCHOOLS,FOR THE PROPOSITION - YES,,90303,15,0,203,218,PROPOSITION NO. 2 MUSTANG PUBLIC SCHOOLS
CANADIAN,PROPOSITION NO. 2 MUSTANG PUBLIC SCHOOLS,AGAINST THE PROPOSITION - NO,,90303,8,0,82,90,PROPOSITION NO. 2 MUSTANG PUBLIC SCHOOLS
CANADIAN,OFFICE NO. 4 (UNEXPIRED TERM) MUSTANG PUBLIC SCHOOLS,BARBARA YOUNG,,90304,3,1,106,110,OFFICE NO. 4 (UNEXPIRED TERM) MUSTANG PUBLIC SCHOOLS
CANADIAN,OFFICE NO. 4 (UNEXPIRED TERM) MUSTANG PUBLIC SCHOOLS,CHAD SCHROEDER,,90304,6,0,146,152,OFFICE NO. 4 (UNEXPIRED TERM) MUSTANG PUBLIC SCHOOLS
CANADIAN,PROPOSITION NO. 1 MUSTANG PUBLIC SCHOOLS,FOR THE PROPOSITION - YES,,90304,3,1,140,144,PROPOSITION NO. 1 MUSTANG PUBLIC SCHOOLS
CANADIAN,PROPOSITION NO. 1 MUSTANG PUBLIC SCHOOLS,AGAINST THE PROPOSITION - NO,,90304,6,0,137,143,PROPOSITION NO. 1 MUSTANG PUBLIC SCHOOLS
CANADIAN,PROPOSITION NO. 2 MUSTANG PUBLIC SCHOOLS,FOR THE PROPOSITION - YES,,90304,3,1,152,156,PROPOSITION NO. 2 MUSTANG PUBLIC SCHOOLS
CANADIAN,PROPOSITION NO. 2 MUSTANG PUBLIC SCHOOLS,AGAINST THE PROPOSITION - NO,,90304,6,0,124,130,PROPOSITION NO. 2 MUSTANG PUBLIC SCHOOLS
CANADIAN,OFFICE NO. 4 (UNEXPIRED TERM) MUSTANG PUBLIC SCHOOLS,BARBARA YOUNG,,90306,2,4,121,127,OFFICE NO. 4 (UNEXPIRED TERM) MUSTANG PUBLIC SCHOOLS
CANADIAN,OFFICE NO. 4 (UNEXPIRED TERM) MUSTANG PUBLIC SCHOOLS,CHAD SCHROEDER,,90306,13,1,233,247,OFFICE NO. 4 (UNEXPIRED TERM) MUSTANG PUBLIC SCHOOLS
CANADIAN,PROPOSITION NO. 1 MUSTANG PUBLIC SCHOOLS,FOR THE PROPOSITION - YES,,90306,8,4,238,250,PROPOSITION NO. 1 MUSTANG PUBLIC SCHOOLS
CANADIAN,PROPOSITION NO. 1 MUSTANG PUBLIC SCHOOLS,AGAINST THE PROPOSITION - NO,,90306,8,1,159,168,PROPOSITION NO. 1 MUSTANG PUBLIC SCHOOLS
CANADIAN,PROPOSITION NO. 2 MUSTANG PUBLIC SCHOOLS,FOR THE PROPOSITION - YES,,90306,9,4,244,257,PROPOSITION NO. 2 MUSTANG PUBLIC SCHOOLS
CANADIAN,PROPOSITION NO. 2 MUSTANG PUBLIC SCHOOLS,AGAINST THE PROPOSITION - NO,,90306,7,1,153,161,PROPOSITION NO. 2 MUSTANG PUBLIC SCHOOLS
CANADIAN,"COUNCILMEMBER, WARD 3 CITY OF OKLAHOMA CITY",LARRY McATEE,,90308,2,2,22,26,"COUNCILMEMBER, WARD 3 CITY OF OKLAHOMA CITY"
CANADIAN,"COUNCILMEMBER, WARD 3 CITY OF OKLAHOMA CITY",MATTHEW W. OLSEN,,90308,0,0,21,21,"COUNCILMEMBER, WARD 3 CITY OF OKLAHOMA CITY"
CANADIAN,"COUNCILMEMBER, WARD 3 CITY OF OKLAHOMA CITY",JOE SARGE NELSON,,90308,1,0,7,8,"COUNCILMEMBER, WARD 3 CITY OF OKLAHOMA CITY"
CANADIAN,OFFICE NO. 4 (UNEXPIRED TERM) MUSTANG PUBLIC SCHOOLS,BARBARA YOUNG,,90308,0,1,14,15,OFFICE NO. 4 (UNEXPIRED TERM) MUSTANG PUBLIC SCHOOLS
CANADIAN,OFFICE NO. 4 (UNEXPIRED TERM) MUSTANG PUBLIC SCHOOLS,CHAD SCHROEDER,,90308,2,1,31,34,OFFICE NO. 4 (UNEXPIRED TERM) MUSTANG PUBLIC SCHOOLS
CANADIAN,PROPOSITION NO. 1 MUSTANG PUBLIC SCHOOLS,FOR THE PROPOSITION - YES,,90308,2,0,29,31,PROPOSITION NO. 1 MUSTANG PUBLIC SCHOOLS
CANADIAN,PROPOSITION NO. 1 MUSTANG PUBLIC SCHOOLS,AGAINST THE PROPOSITION - NO,,90308,0,2,22,24,PROPOSITION NO. 1 MUSTANG PUBLIC SCHOOLS
CANADIAN,PROPOSITION NO. 2 MUSTANG PUBLIC SCHOOLS,FOR THE PROPOSITION - YES,,90308,2,0,30,32,PROPOSITION NO. 2 MUSTANG PUBLIC SCHOOLS
CANADIAN,PROPOSITION NO. 2 MUSTANG PUBLIC SCHOOLS,AGAINST THE PROPOSITION - NO,,90308,0,2,21,23,PROPOSITION NO. 2 MUSTANG PUBLIC SCHOOLS
CANADIAN,"COUNCILMEMBER, WARD 3 CITY OF OKLAHOMA CITY",LARRY McATEE,,90309,0,0,7,7,"COUNCILMEMBER, WARD 3 CITY OF OKLAHOMA CITY"
CANADIAN,"COUNCILMEMBER, WARD 3 CITY OF OKLAHOMA CITY",MATTHEW W. OLSEN,,90309,1,0,7,8,"COUNCILMEMBER, WARD 3 CITY OF OKLAHOMA CITY"
CANADIAN,"COUNCILMEMBER, WARD 3 CITY OF OKLAHOMA CITY",JOE SARGE NELSON,,90309,0,0,6,6,"COUNCILMEMBER, WARD 3 CITY OF OKLAHOMA CITY"
CANADIAN,OFFICE NO. 4 (UNEXPIRED TERM) MUSTANG PUBLIC SCHOOLS,BARBARA YOUNG,,90309,1,0,2,3,OFFICE NO. 4 (UNEXPIRED TERM) MUSTANG PUBLIC SCHOOLS
CANADIAN,OFFICE NO. 4 (UNEXPIRED TERM) MUSTANG PUBLIC SCHOOLS,CHAD SCHROEDER,,90309,0,0,17,17,OFFICE NO. 4 (UNEXPIRED TERM) MUSTANG PUBLIC SCHOOLS
CANADIAN,PROPOSITION NO. 1 MUSTANG PUBLIC SCHOOLS,FOR THE PROPOSITION - YES,,90309,0,0,12,12,PROPOSITION NO. 1 MUSTANG PUBLIC SCHOOLS
CANADIAN,PROPOSITION NO. 1 MUSTANG PUBLIC SCHOOLS,AGAINST THE PROPOSITION - NO,,90309,1,0,8,9,PROPOSITION NO. 1 MUSTANG PUBLIC SCHOOLS
CANADIAN,PROPOSITION NO. 2 MUSTANG PUBLIC SCHOOLS,FOR THE PROPOSITION - YES,,90309,1,0,11,12,PROPOSITION NO. 2 MUSTANG PUBLIC SCHOOLS
CANADIAN,PROPOSITION NO. 2 MUSTANG PUBLIC SCHOOLS,AGAINST THE PROPOSITION - NO,,90309,0,0,9,9,PROPOSITION NO. 2 MUSTANG PUBLIC SCHOOLS
CANADIAN,OFFICE NO. 4 (UNEXPIRED TERM) MUSTANG PUBLIC SCHOOLS,BARBARA YOUNG,,90398,0,0,0,0,OFFICE NO. 4 (UNEXPIRED TERM) MUSTANG PUBLIC SCHOOLS
CANADIAN,OFFICE NO. 4 (UNEXPIRED TERM) MUSTANG PUBLIC SCHOOLS,CHAD SCHROEDER,,90398,0,0,0,0,OFFICE NO. 4 (UNEXPIRED TERM) MUSTANG PUBLIC SCHOOLS
CANADIAN,PROPOSITION NO. 1 MUSTANG PUBLIC SCHOOLS,FOR THE PROPOSITION - YES,,90398,0,0,0,0,PROPOSITION NO. 1 MUSTANG PUBLIC SCHOOLS
CANADIAN,PROPOSITION NO. 1 MUSTANG PUBLIC SCHOOLS,AGAINST THE PROPOSITION - NO,,90398,0,0,0,0,PROPOSITION NO. 1 MUSTANG PUBLIC SCHOOLS
CANADIAN,PROPOSITION NO. 2 MUSTANG PUBLIC SCHOOLS,FOR THE PROPOSITION - YES,,90398,0,0,0,0,PROPOSITION NO. 2 MUSTANG PUBLIC SCHOOLS
CANADIAN,PROPOSITION NO. 2 MUSTANG PUBLIC SCHOOLS,AGAINST THE PROPOSITION - NO,,90398,0,0,0,0,PROPOSITION NO. 2 MUSTANG PUBLIC SCHOOLS
CANADIAN,OFFICE NO. 4 (UNEXPIRED TERM) MUSTANG PUBLIC SCHOOLS,BARBARA YOUNG,,90399,0,0,0,0,OFFICE NO. 4 (UNEXPIRED TERM) MUSTANG PUBLIC SCHOOLS
CANADIAN,OFFICE NO. 4 (UNEXPIRED TERM) MUSTANG PUBLIC SCHOOLS,CHAD SCHROEDER,,90399,0,0,0,0,OFFICE NO. 4 (UNEXPIRED TERM) MUSTANG PUBLIC SCHOOLS
CANADIAN,PROPOSITION NO. 1 MUSTANG PUBLIC SCHOOLS,FOR THE PROPOSITION - YES,,90399,0,0,0,0,PROPOSITION NO. 1 MUSTANG PUBLIC SCHOOLS
CANADIAN,PROPOSITION NO. 1 MUSTANG PUBLIC SCHOOLS,AGAINST THE PROPOSITION - NO,,90399,0,0,0,0,PROPOSITION NO. 1 MUSTANG PUBLIC SCHOOLS
CANADIAN,PROPOSITION NO. 2 MUSTANG PUBLIC SCHOOLS,FOR THE PROPOSITION - YES,,90399,0,0,0,0,PROPOSITION NO. 2 MUSTANG PUBLIC SCHOOLS
CANADIAN,PROPOSITION NO. 2 MUSTANG PUBLIC SCHOOLS,AGAINST THE PROPOSITION - NO,,90399,0,0,0,0,PROPOSITION NO. 2 MUSTANG PUBLIC SCHOOLS
CANADIAN,OFFICE NO. 2 GEARY PUBLIC SCHOOLS,SCOTT HICKS,,90406,0,0,25,25,OFFICE NO. 2 GEARY PUBLIC SCHOOLS
CANADIAN,OFFICE NO. 2 GEARY PUBLIC SCHOOLS,AFTON JAMESON,,90406,0,3,4,7,OFFICE NO. 2 GEARY PUBLIC SCHOOLS
CANADIAN,OFFICE NO. 2 OKARCHE PUBLIC SCHOOLS,HEATHER NANCE,,90408,0,0,0,0,OFFICE NO. 2 OKARCHE PUBLIC SCHOOLS
CANADIAN,OFFICE NO. 2 OKARCHE PUBLIC SCHOOLS,DAVID MAYHEW,,90408,0,0,0,0,OFFICE NO. 2 OKARCHE PUBLIC SCHOOLS
CANADIAN,OFFICE NO. 2 OKARCHE PUBLIC SCHOOLS,HEATHER NANCE,,90409,0,0,0,0,OFFICE NO. 2 OKARCHE PUBLIC SCHOOLS
CANADIAN,OFFICE NO. 2 OKARCHE PUBLIC SCHOOLS,DAVID MAYHEW,,90409,0,0,0,0,OFFICE NO. 2 OKARCHE PUBLIC SCHOOLS
CANADIAN,OFFICE NO. 2 OKARCHE PUBLIC SCHOOLS,HEATHER NANCE,,90502,0,0,8,8,OFFICE NO. 2 OKARCHE PUBLIC SCHOOLS
CANADIAN,OFFICE NO. 2 OKARCHE PUBLIC SCHOOLS,DAVID MAYHEW,,90502,0,0,1,1,OFFICE NO. 2 OKARCHE PUBLIC SCHOOLS
CANADIAN,"COUNCILMEMBER, WARD 1 CITY OF OKLAHOMA CITY",CHRIS GORDON,,90503,0,0,0,0,"COUNCILMEMBER, WARD 1 CITY OF OKLAHOMA CITY"
CANADIAN,"COUNCILMEMBER, WARD 1 CITY OF OKLAHOMA CITY",JAMES GREINER,,90503,0,0,0,0,"COUNCILMEMBER, WARD 1 CITY OF OKLAHOMA CITY"
CANADIAN,"COUNCILMEMBER, WARD 1 CITY OF OKLAHOMA CITY",JONATHAN CLOUR,,90503,0,0,0,0,"COUNCILMEMBER, WARD 1 CITY OF OKLAHOMA CITY"
CANADIAN,OFFICE NO. 2 OKARCHE PUBLIC SCHOOLS,HEATHER NANCE,,90503,0,0,0,0,OFFICE NO. 2 OKARCHE PUBLIC SCHOOLS
CANADIAN,OFFICE NO. 2 OKARCHE PUBLIC SCHOOLS,DAVID MAYHEW,,90503,0,0,0,0,OFFICE NO. 2 OKARCHE PUBLIC SCHOOLS
CANADIAN,OFFICE NO. 2 DEER CREEK PUBLIC SCHOOLS,TOM CORBIN,,90504,0,0,0,0,OFFICE NO. 2 DEER CREEK PUBLIC SCHOOLS
CANADIAN,OFFICE NO. 2 DEER CREEK PUBLIC SCHOOLS,ANDI NEAVES,,90504,0,0,0,0,OFFICE NO. 2 DEER CREEK PUBLIC SCHOOLS
CANADIAN,OFFICE NO. 2 FRANCIS TUTTLE TECH CENTER,PETE LEE,,90504,0,0,0,0,OFFICE NO. 2 FRANCIS TUTTLE TECH CENTER
CANADIAN,OFFICE NO. 2 FRANCIS TUTTLE TECH CENTER,ROBERT STONE,,90504,0,0,0,0,OFFICE NO. 2 FRANCIS TUTTLE TECH CENTER
CANADIAN,"COUNCILMEMBER, WARD 1 CITY OF OKLAHOMA CITY",CHRIS GORDON,,90506,2,0,10,12,"COUNCILMEMBER, WARD 1 CITY OF OKLAHOMA CITY"
CANADIAN,"COUNCILMEMBER, WARD 1 CITY OF OKLAHOMA CITY",JAMES GREINER,,90506,3,0,3,6,"COUNCILMEMBER, WARD 1 CITY OF OKLAHOMA CITY"
CANADIAN,"COUNCILMEMBER, WARD 1 CITY OF OKLAHOMA CITY",JONATHAN CLOUR,,90506,0,0,0,0,"COUNCILMEMBER, WARD 1 CITY OF OKLAHOMA CITY"
CARTER,OFFICE NO. 2 WILSON PUBLIC SCHOOLS,CHAD NANCE,,100030,0,0,9,9,OFFICE NO. 2 WILSON PUBLIC SCHOOLS
CARTER,OFFICE NO. 2 WILSON PUBLIC SCHOOLS,TOMMI SUE IDLEMAN,,100030,3,1,12,16,OFFICE NO. 2 WILSON PUBLIC SCHOOLS
CARTER,OFFICE NO. 2 WILSON PUBLIC SCHOOLS,CHAD NANCE,,100031,0,1,0,1,OFFICE NO. 2 WILSON PUBLIC SCHOOLS
CARTER,OFFICE NO. 2 WILSON PUBLIC SCHOOLS,TOMMI SUE IDLEMAN,,100031,1,0,0,1,OFFICE NO. 2 WILSON PUBLIC SCHOOLS
CARTER,OFFICE NO. 2 WILSON PUBLIC SCHOOLS,CHAD NANCE,,100032,0,0,0,0,OFFICE NO. 2 WILSON PUBLIC SCHOOLS
CARTER,OFFICE NO. 2 WILSON PUBLIC SCHOOLS,TOMMI SUE IDLEMAN,,100032,0,0,0,0,OFFICE NO. 2 WILSON PUBLIC SCHOOLS
CARTER,OFFICE NO. 2 WILSON PUBLIC SCHOOLS,CHAD NANCE,,100039,0,0,0,0,OFFICE NO. 2 WILSON PUBLIC SCHOOLS
CARTER,OFFICE NO. 2 WILSON PUBLIC SCHOOLS,TOMMI SUE IDLEMAN,,100039,0,0,0,0,OFFICE NO. 2 WILSON PUBLIC SCHOOLS
CARTER,OFFICE NO. 2 WILSON PUBLIC SCHOOLS,CHAD NANCE,,100041,0,0,0,0,OFFICE NO. 2 WILSON PUBLIC SCHOOLS
CARTER,OFFICE NO. 2 WILSON PUBLIC SCHOOLS,TOMMI SUE IDLEMAN,,100041,0,0,0,0,OFFICE NO. 2 WILSON PUBLIC SCHOOLS
CARTER,OFFICE NO. 2 WILSON PUBLIC SCHOOLS,CHAD NANCE,,100071,0,0,52,52,OFFICE NO. 2 WILSON PUBLIC SCHOOLS
CARTER,OFFICE NO. 2 WILSON PUBLIC SCHOOLS,TOMMI SUE IDLEMAN,,100071,1,0,66,67,OFFICE NO. 2 WILSON PUBLIC SCHOOLS
CHEROKEE,CITY CLERK CITY OF TAHLEQUAH,DeANNA HAMMONS,,110001,2,7,48,57,
CHEROKEE,CITY CLERK CITY OF TAHLEQUAH,BLAKE TURNER,,110001,4,9,60,73,
CHEROKEE,OFFICE NO. 3 GRAND VIEW PUBLIC SCHOOLS,MARTY A. KIMBLE,,110001,0,0,0,0,OFFICE NO. 3 GRAND VIEW PUBLIC SCHOOLS
CHEROKEE,OFFICE NO. 3 GRAND VIEW PUBLIC SCHOOLS,NORMA BOREN,,110001,0,0,1,1,OFFICE NO. 3 GRAND VIEW PUBLIC SCHOOLS
CHEROKEE,OFFICE NO. 2 INDIAN CAPITAL TECH CENTER,TOM STILES,,110001,2,8,48,58,OFFICE NO. 2 INDIAN CAPITAL TECH CENTER
CHEROKEE,OFFICE NO. 2 INDIAN CAPITAL TECH CENTER,RAY KIRK,,110001,4,8,60,72,OFFICE NO. 2 INDIAN CAPITAL TECH CENTER
CHEROKEE,COUNCILOR WARD 2 CITY OF TAHLEQUAH,DOWER COMBS,,110002,1,31,137,169,COUNCILOR WARD 2 CITY OF TAHLEQUAH
CHEROKEE,COUNCILOR WARD 2 CITY OF TAHLEQUAH,CHARLES CARROLL,,110002,0,20,92,112,COUNCILOR WARD 2 CITY OF TAHLEQUAH
CHEROKEE,CITY CLERK CITY OF TAHLEQUAH,DeANNA HAMMONS,,110002,1,27,127,155,
CHEROKEE,CITY CLERK CITY OF TAHLEQUAH,BLAKE TURNER,,110002,0,24,102,126,
CHEROKEE,OFFICE NO. 2 INDIAN CAPITAL TECH CENTER,TOM STILES,,110002,0,24,124,148,OFFICE NO. 2 INDIAN CAPITAL TECH CENTER
CHEROKEE,OFFICE NO. 2 INDIAN CAPITAL TECH CENTER,RAY KIRK,,110002,1,26,105,132,OFFICE NO. 2 INDIAN CAPITAL TECH CENTER
CHEROKEE,CITY CLERK CITY OF TAHLEQUAH,DeANNA HAMMONS,,110003,0,41,94,135,
CHEROKEE,CITY CLERK CITY OF TAHLEQUAH,BLAKE TURNER,,110003,1,17,46,64,
CHEROKEE,OFFICE NO. 2 INDIAN CAPITAL TECH CENTER,TOM STILES,,110003,1,30,67,98,OFFICE NO. 2 INDIAN CAPITAL TECH CENTER
CHEROKEE,OFFICE NO. 2 INDIAN CAPITAL TECH CENTER,RAY KIRK,,110003,0,27,75,102,OFFICE NO. 2 INDIAN CAPITAL TECH CENTER
CHEROKEE,CITY CLERK CITY OF TAHLEQUAH,DeANNA HAMMONS,,110004,0,13,74,87,
CHEROKEE,CITY CLERK CITY OF TAHLEQUAH,BLAKE TURNER,,110004,0,14,46,60,
CHEROKEE,OFFICE NO. 3 GRAND VIEW PUBLIC SCHOOLS,MARTY A. KIMBLE,,110004,0,6,35,41,OFFICE NO. 3 GRAND VIEW PUBLIC SCHOOLS
CHEROKEE,OFFICE NO. 3 GRAND VIEW PUBLIC SCHOOLS,NORMA BOREN,,110004,0,4,27,31,OFFICE NO. 3 GRAND VIEW PUBLIC SCHOOLS
CHEROKEE,OFFICE NO. 1 SHADY GROVE PUBLIC SCHOOLS,LEA ARNALL-SHEETS,,110004,0,0,1,1,OFFICE NO. 1 SHADY GROVE PUBLIC SCHOOLS
CHEROKEE,OFFICE NO. 1 SHADY GROVE PUBLIC SCHOOLS,CHANCE BATES,,110004,0,0,0,0,OFFICE NO. 1 SHADY GROVE PUBLIC SCHOOLS
CHEROKEE,OFFICE NO. 2 INDIAN CAPITAL TECH CENTER,TOM STILES,,110004,0,17,57,74,OFFICE NO. 2 INDIAN CAPITAL TECH CENTER
CHEROKEE,OFFICE NO. 2 INDIAN CAPITAL TECH CENTER,RAY KIRK,,110004,0,16,81,97,OFFICE NO. 2 INDIAN CAPITAL TECH CENTER
CHEROKEE,COUNCILOR WARD 2 CITY OF TAHLEQUAH,DOWER COMBS,,110005,3,3,20,26,COUNCILOR WARD 2 CITY OF TAHLEQUAH
CHEROKEE,COUNCILOR WARD 2 CITY OF TAHLEQUAH,CHARLES CARROLL,,110005,0,3,23,26,COUNCILOR WARD 2 CITY OF TAHLEQUAH
CHEROKEE,CITY CLERK CITY OF TAHLEQUAH,DeANNA HAMMONS,,110005,2,5,16,23,
CHEROKEE,CITY CLERK CITY OF TAHLEQUAH,BLAKE TURNER,,110005,1,1,27,29,
CHEROKEE,OFFICE NO. 2 INDIAN CAPITAL TECH CENTER,TOM STILES,,110005,1,2,13,16,OFFICE NO. 2 INDIAN CAPITAL TECH CENTER
CHEROKEE,OFFICE NO. 2 INDIAN CAPITAL TECH CENTER,RAY KIRK,,110005,2,4,29,35,OFFICE NO. 2 INDIAN CAPITAL TECH CENTER
CHEROKEE,PROPOSITION KEYS PUBLIC SCHOOLS,FOR THE PROPOSITION - YES,,110006,0,4,44,48,
CHEROKEE,PROPOSITION KEYS PUBLIC SCHOOLS,AGAINST THE PROPOSITION - NO,,110006,0,3,23,26,
CHEROKEE,OFFICE NO. 2 INDIAN CAPITAL TECH CENTER,TOM STILES,,110006,0,3,18,21,OFFICE NO. 2 INDIAN CAPITAL TECH CENTER
CHEROKEE,OFFICE NO. 2 INDIAN CAPITAL TECH CENTER,RAY KIRK,,110006,0,4,60,64,OFFICE NO. 2 INDIAN CAPITAL TECH CENTER
CHEROKEE,OFFICE NO. 3 GRAND VIEW PUBLIC SCHOOLS,MARTY A. KIMBLE,,110007,0,1,3,4,OFFICE NO. 3 GRAND VIEW PUBLIC SCHOOLS
CHEROKEE,OFFICE NO. 3 GRAND VIEW PUBLIC SCHOOLS,NORMA BOREN,,110007,0,1,0,1,OFFICE NO. 3 GRAND VIEW PUBLIC SCHOOLS
CHEROKEE,OFFICE NO. 2 INDIAN CAPITAL TECH CENTER,TOM STILES,,110007,0,1,2,3,OFFICE NO. 2 INDIAN CAPITAL TECH CENTER
CHEROKEE,OFFICE NO. 2 INDIAN CAPITAL TECH CENTER,RAY KIRK,,110007,0,1,2,3,OFFICE NO. 2 INDIAN CAPITAL TECH CENTER
CHEROKEE,OFFICE NO. 3 GRAND VIEW PUBLIC SCHOOLS,MARTY A. KIMBLE,,110008,0,0,0,0,OFFICE NO. 3 GRAND VIEW PUBLIC SCHOOLS
CHEROKEE,OFFICE NO. 3 GRAND VIEW PUBLIC SCHOOLS,NORMA BOREN,,110008,0,0,1,1,OFFICE NO. 3 GRAND VIEW PUBLIC SCHOOLS
CHEROKEE,OFFICE NO. 2 INDIAN CAPITAL TECH CENTER,TOM STILES,,110008,0,1,2,3,OFFICE NO. 2 INDIAN CAPITAL TECH CENTER
CHEROKEE,OFFICE NO. 2 INDIAN CAPITAL TECH CENTER,RAY KIRK,,110008,0,0,5,5,OFFICE NO. 2 INDIAN CAPITAL TECH CENTER
CHEROKEE,PROPOSITION KEYS PUBLIC SCHOOLS,FOR THE PROPOSITION - YES,,110009,0,0,20,20,
CHEROKEE,PROPOSITION KEYS PUBLIC SCHOOLS,AGAINST THE PROPOSITION - NO,,110009,0,0,36,36,
CHEROKEE,OFFICE NO. 2 INDIAN CAPITAL TECH CENTER,TOM STILES,,110009,0,0,16,16,OFFICE NO. 2 INDIAN CAPITAL TECH CENTER
CHEROKEE,OFFICE NO. 2 INDIAN CAPITAL TECH CENTER,RAY KIRK,,110009,0,1,42,43,OFFICE NO. 2 INDIAN CAPITAL TECH CENTER
CHEROKEE,PROPOSITION KEYS PUBLIC SCHOOLS,FOR THE PROPOSITION - YES,,110010,0,1,128,129,
CHEROKEE,PROPOSITION KEYS PUBLIC SCHOOLS,AGAINST THE PROPOSITION - NO,,110010,0,6,121,127,
CHEROKEE,OFFICE NO. 2 INDIAN CAPITAL TECH CENTER,TOM STILES,,110010,0,5,85,90,OFFICE NO. 2 INDIAN CAPITAL TECH CENTER
CHEROKEE,OFFICE NO. 2 INDIAN CAPITAL TECH CENTER,RAY KIRK,,110010,0,2,164,166,OFFICE NO. 2 INDIAN CAPITAL TECH CENTER
CHEROKEE,OFFICE NO. 2 HULBERT PUBLIC SCHOOLS,JIMMY CARL CAREY,,110011,0,0,0,0,OFFICE NO. 2 HULBERT PUBLIC SCHOOLS
CHEROKEE,OFFICE NO. 2 HULBERT PUBLIC SCHOOLS,STEVE CAREY,,110011,0,0,3,3,OFFICE NO. 2 HULBERT PUBLIC SCHOOLS
CHEROKEE,OFFICE NO. 1 SHADY GROVE PUBLIC SCHOOLS,LEA ARNALL-SHEETS,,110011,3,5,41,49,OFFICE NO. 1 SHADY GROVE PUBLIC SCHOOLS
CHEROKEE,OFFICE NO. 1 SHADY GROVE PUBLIC SCHOOLS,CHANCE BATES,,110011,0,1,11,12,OFFICE NO. 1 SHADY GROVE PUBLIC SCHOOLS
CHEROKEE,OFFICE NO. 2 INDIAN CAPITAL TECH CENTER,TOM STILES,,110011,0,6,31,37,OFFICE NO. 2 INDIAN CAPITAL TECH CENTER
CHEROKEE,OFFICE NO. 2 INDIAN CAPITAL TECH CENTER,RAY KIRK,,110011,2,1,26,29,OFFICE NO. 2 INDIAN CAPITAL TECH CENTER
CHEROKEE,OFFICE NO. 3 GRAND VIEW PUBLIC SCHOOLS,MARTY A. KIMBLE,,110012,0,4,9,13,OFFICE NO. 3 GRAND VIEW PUBLIC SCHOOLS
CHEROKEE,OFFICE NO. 3 GRAND VIEW PUBLIC SCHOOLS,NORMA BOREN,,110012,0,3,5,8,OFFICE NO. 3 GRAND VIEW PUBLIC SCHOOLS
CHEROKEE,OFFICE NO. 2 OAKS-MISSION PUBLIC SCHOOLS,MELVIN D BLOSSOM JR,,110012,0,0,2,2,OFFICE NO. 2 OAKS-MISSION PUBLIC SCHOOLS
CHEROKEE,OFFICE NO. 2 OAKS-MISSION PUBLIC SCHOOLS,TONIA FIELDS TREJO,,110012,0,1,1,2,OFFICE NO. 2 OAKS-MISSION PUBLIC SCHOOLS
CHEROKEE,OFFICE NO. 2 NORTHEAST TECH CENTER,BILLY F. HENDRICKSON,,110012,0,1,3,4,OFFICE NO. 2 NORTHEAST TECH CENTER
CHEROKEE,OFFICE NO. 2 NORTHEAST TECH CENTER,SHERMAN WEAVER,,110012,0,0,0,0,OFFICE NO. 2 NORTHEAST TECH CENTER
CHEROKEE,OFFICE NO. 2 INDIAN CAPITAL TECH CENTER,TOM STILES,,110012,0,2,5,7,OFFICE NO. 2 INDIAN CAPITAL TECH CENTER
CHEROKEE,OFFICE NO. 2 INDIAN CAPITAL TECH CENTER,RAY KIRK,,110012,0,6,14,20,OFFICE NO. 2 INDIAN CAPITAL TECH CENTER
CHEROKEE,OFFICE NO. 2 INDIAN CAPITAL TECH CENTER,TOM STILES,,110013,1,2,6,9,OFFICE NO. 2 INDIAN CAPITAL TECH CENTER
CHEROKEE,OFFICE NO. 2 INDIAN CAPITAL TECH CENTER,RAY KIRK,,110013,0,1,8,9,OFFICE NO. 2 INDIAN CAPITAL TECH CENTER
CHEROKEE,OFFICE NO. 2 HULBERT PUBLIC SCHOOLS,JIMMY CARL CAREY,,110014,0,0,27,27,OFFICE NO. 2 HULBERT PUBLIC SCHOOLS
CHEROKEE,OFFICE NO. 2 HULBERT PUBLIC SCHOOLS,STEVE CAREY,,110014,0,0,70,70,OFFICE NO. 2 HULBERT PUBLIC SCHOOLS
CHEROKEE,OFFICE NO. 1 SHADY GROVE PUBLIC SCHOOLS,LEA ARNALL-SHEETS,,110014,0,0,3,3,OFFICE NO. 1 SHADY GROVE PUBLIC SCHOOLS
CHEROKEE,OFFICE NO. 1 SHADY GROVE PUBLIC SCHOOLS,CHANCE BATES,,110014,0,0,1,1,OFFICE NO. 1 SHADY GROVE PUBLIC SCHOOLS
CHEROKEE,OFFICE NO. 2 NORTHEAST TECH CENTER,BILLY F. HENDRICKSON,,110014,1,0,0,1,OFFICE NO. 2 NORTHEAST TECH CENTER
CHEROKEE,OFFICE NO. 2 NORTHEAST TECH CENTER,SHERMAN WEAVER,,110014,0,0,0,0,OFFICE NO. 2 NORTHEAST TECH CENTER
CHEROKEE,OFFICE NO. 2 INDIAN CAPITAL TECH CENTER,TOM STILES,,110014,2,0,41,43,OFFICE NO. 2 INDIAN CAPITAL TECH CENTER
CHEROKEE,OFFICE NO. 2 INDIAN CAPITAL TECH CENTER,RAY KIRK,,110014,0,0,59,59,OFFICE NO. 2 INDIAN CAPITAL TECH CENTER
CHEROKEE,OFFICE NO. 2 HULBERT PUBLIC SCHOOLS,JIMMY CARL CAREY,,110015,0,0,0,0,OFFICE NO. 2 HULBERT PUBLIC SCHOOLS
CHEROKEE,OFFICE NO. 2 HULBERT PUBLIC SCHOOLS,STEVE CAREY,,110015,0,0,11,11,OFFICE NO. 2 HULBERT PUBLIC SCHOOLS
CHEROKEE,OFFICE NO. 2 INDIAN CAPITAL TECH CENTER,TOM STILES,,110015,2,2,24,28,OFFICE NO. 2 INDIAN CAPITAL TECH CENTER
CHEROKEE,OFFICE NO. 2 INDIAN CAPITAL TECH CENTER,RAY KIRK,,110015,0,1,9,10,OFFICE NO. 2 INDIAN CAPITAL TECH CENTER
CHEROKEE,OFFICE NO. 3 GRAND VIEW PUBLIC SCHOOLS,MARTY A. KIMBLE,,110016,0,0,0,0,OFFICE NO. 3 GRAND VIEW PUBLIC SCHOOLS
CHEROKEE,OFFICE NO. 3 GRAND VIEW PUBLIC SCHOOLS,NORMA BOREN,,110016,0,0,0,0,OFFICE NO. 3 GRAND VIEW PUBLIC SCHOOLS
CHEROKEE,OFFICE NO. 2 NORTHEAST TECH CENTER,BILLY F. HENDRICKSON,,110016,0,0,0,0,OFFICE NO. 2 NORTHEAST TECH CENTER
CHEROKEE,OFFICE NO. 2 NORTHEAST TECH CENTER,SHERMAN WEAVER,,110016,0,0,0,0,OFFICE NO. 2 NORTHEAST TECH CENTER
CHEROKEE,OFFICE NO. 2 INDIAN CAPITAL TECH CENTER,TOM STILES,,110016,0,0,7,7,OFFICE NO. 2 INDIAN CAPITAL TECH CENTER
CHEROKEE,OFFICE NO. 2 INDIAN CAPITAL TECH CENTER,RAY KIRK,,110016,1,0,5,6,OFFICE NO. 2 INDIAN CAPITAL TECH CENTER
CHEROKEE,PROPOSITION KEYS PUBLIC SCHOOLS,FOR THE PROPOSITION - YES,,110017,0,0,0,0,
CHEROKEE,PROPOSITION KEYS PUBLIC SCHOOLS,AGAINST THE PROPOSITION - NO,,110017,0,1,0,1,
CHEROKEE,OFFICE NO. 2 INDIAN CAPITAL TECH CENTER,TOM STILES,,110017,0,1,3,4,OFFICE NO. 2 INDIAN CAPITAL TECH CENTER
CHEROKEE,OFFICE NO. 2 INDIAN CAPITAL TECH CENTER,RAY KIRK,,110017,0,0,5,5,OFFICE NO. 2 INDIAN CAPITAL TECH CENTER
CHEROKEE,OFFICE NO. 2 OAKS-MISSION PUBLIC SCHOOLS,MELVIN D BLOSSOM JR,,110018,0,0,7,7,OFFICE NO. 2 OAKS-MISSION PUBLIC SCHOOLS
CHEROKEE,OFFICE NO. 2 OAKS-MISSION PUBLIC SCHOOLS,TONIA FIELDS TREJO,,110018,0,0,15,15,OFFICE NO. 2 OAKS-MISSION PUBLIC SCHOOLS
CHEROKEE,OFFICE NO. 2 NORTHEAST TECH CENTER,BILLY F. HENDRICKSON,,110018,0,0,11,11,OFFICE NO. 2 NORTHEAST TECH CENTER
CHEROKEE,OFFICE NO. 2 NORTHEAST TECH CENTER,SHERMAN WEAVER,,110018,0,0,10,10,OFFICE NO. 2 NORTHEAST TECH CENTER
CHEROKEE,OFFICE NO. 2 INDIAN CAPITAL TECH CENTER,TOM STILES,,110018,0,0,1,1,OFFICE NO. 2 INDIAN CAPITAL TECH CENTER
CHEROKEE,OFFICE NO. 2 INDIAN CAPITAL TECH CENTER,RAY KIRK,,110018,0,0,0,0,OFFICE NO. 2 INDIAN CAPITAL TECH CENTER
CHEROKEE,OFFICE NO. 2 HULBERT PUBLIC SCHOOLS,JIMMY CARL CAREY,,110019,0,0,1,1,OFFICE NO. 2 HULBERT PUBLIC SCHOOLS
CHEROKEE,OFFICE NO. 2 HULBERT PUBLIC SCHOOLS,STEVE CAREY,,110019,0,6,3,9,OFFICE NO. 2 HULBERT PUBLIC SCHOOLS
CHEROKEE,OFFICE NO. 2 INDIAN CAPITAL TECH CENTER,TOM STILES,,110019,0,1,13,14,OFFICE NO. 2 INDIAN CAPITAL TECH CENTER
CHEROKEE,OFFICE NO. 2 INDIAN CAPITAL TECH CENTER,RAY KIRK,,110019,0,5,7,12,OFFICE NO. 2 INDIAN CAPITAL TECH CENTER
CHEROKEE,CITY CLERK CITY OF TAHLEQUAH,DeANNA HAMMONS,,110020,0,5,15,20,
CHEROKEE,CITY CLERK CITY OF TAHLEQUAH,BLAKE TURNER,,110020,0,6,6,12,
CHEROKEE,OFFICE NO. 2 INDIAN CAPITAL TECH CENTER,TOM STILES,,110020,0,5,13,18,OFFICE NO. 2 INDIAN CAPITAL TECH CENTER
CHEROKEE,OFFICE NO. 2 INDIAN CAPITAL TECH CENTER,RAY KIRK,,110020,0,9,18,27,OFFICE NO. 2 INDIAN CAPITAL TECH CENTER
CHEROKEE,OFFICE NO. 2 INDIAN CAPITAL TECH CENTER,TOM STILES,,110021,0,0,2,2,OFFICE NO. 2 INDIAN CAPITAL TECH CENTER
CHEROKEE,OFFICE NO. 2 INDIAN CAPITAL TECH CENTER,RAY KIRK,,110021,0,0,2,2,OFFICE NO. 2 INDIAN CAPITAL TECH CENTER
CHEROKEE,OFFICE NO. 2 INDIAN CAPITAL TECH CENTER,TOM STILES,,110022,0,0,2,2,OFFICE NO. 2 INDIAN CAPITAL TECH CENTER
CHEROKEE,OFFICE NO. 2 INDIAN CAPITAL TECH CENTER,RAY KIRK,,110022,0,1,6,7,OFFICE NO. 2 INDIAN CAPITAL TECH CENTER
CHEROKEE,OFFICE NO. 3 GRAND VIEW PUBLIC SCHOOLS,MARTY A. KIMBLE,,110023,0,0,3,3,OFFICE NO. 3 GRAND VIEW PUBLIC SCHOOLS
CHEROKEE,OFFICE NO. 3 GRAND VIEW PUBLIC SCHOOLS,NORMA BOREN,,110023,0,1,0,1,OFFICE NO. 3 GRAND VIEW PUBLIC SCHOOLS
CHEROKEE,OFFICE NO. 1 SHADY GROVE PUBLIC SCHOOLS,LEA ARNALL-SHEETS,,110023,0,1,4,5,OFFICE NO. 1 SHADY GROVE PUBLIC SCHOOLS
CHEROKEE,OFFICE NO. 1 SHADY GROVE PUBLIC SCHOOLS,CHANCE BATES,,110023,0,0,0,0,OFFICE NO. 1 SHADY GROVE PUBLIC SCHOOLS
CHEROKEE,OFFICE NO. 2 INDIAN CAPITAL TECH CENTER,TOM STILES,,110023,0,2,4,6,OFFICE NO. 2 INDIAN CAPITAL TECH CENTER
CHEROKEE,OFFICE NO. 2 INDIAN CAPITAL TECH CENTER,RAY KIRK,,110023,0,0,7,7,OFFICE NO. 2 INDIAN CAPITAL TECH CENTER
CHEROKEE,OFFICE NO. 3 GRAND VIEW PUBLIC SCHOOLS,MARTY A. KIMBLE,,110025,0,0,0,0,OFFICE NO. 3 GRAND VIEW PUBLIC SCHOOLS
CHEROKEE,OFFICE NO. 3 GRAND VIEW PUBLIC SCHOOLS,NORMA BOREN,,110025,0,0,0,0,OFFICE NO. 3 GRAND VIEW PUBLIC SCHOOLS
CHEROKEE,OFFICE NO. 2 HULBERT PUBLIC SCHOOLS,JIMMY CARL CAREY,,110025,1,3,10,14,OFFICE NO. 2 HULBERT PUBLIC SCHOOLS
CHEROKEE,OFFICE NO. 2 HULBERT PUBLIC SCHOOLS,STEVE CAREY,,110025,0,3,64,67,OFFICE NO. 2 HULBERT PUBLIC SCHOOLS
CHEROKEE,OFFICE NO. 1 SHADY GROVE PUBLIC SCHOOLS,LEA ARNALL-SHEETS,,110025,0,3,4,7,OFFICE NO. 1 SHADY GROVE PUBLIC SCHOOLS
CHEROKEE,OFFICE NO. 1 SHADY GROVE PUBLIC SCHOOLS,CHANCE BATES,,110025,0,1,1,2,OFFICE NO. 1 SHADY GROVE PUBLIC SCHOOLS
CHEROKEE,OFFICE NO. 2 INDIAN CAPITAL TECH CENTER,TOM STILES,,110025,0,4,43,47,OFFICE NO. 2 INDIAN CAPITAL TECH CENTER
CHEROKEE,OFFICE NO. 2 INDIAN CAPITAL TECH CENTER,RAY KIRK,,110025,1,6,33,40,OFFICE NO. 2 INDIAN CAPITAL TECH CENTER
CHOCTAW,OFFICE NO. 2 SOPER PUBLIC SCHOOLS,ANGELLA ANNETTE DANCER,,120104,2,3,96,101,OFFICE NO. 2 SOPER PUBLIC SCHOOLS
CHOCTAW,OFFICE NO. 2 SOPER PUBLIC SCHOOLS,ALVIE SKIP PERKINS JR,,120104,1,0,29,30,OFFICE NO. 2 SOPER PUBLIC SCHOOLS
CHOCTAW,OFFICE NO. 2 SOPER PUBLIC SCHOOLS,ANGELLA ANNETTE DANCER,,120207,0,0,1,1,OFFICE NO. 2 SOPER PUBLIC SCHOOLS
CHOCTAW,OFFICE NO. 2 SOPER PUBLIC SCHOOLS,ALVIE SKIP PERKINS JR,,120207,0,0,1,1,OFFICE NO. 2 SOPER PUBLIC SCHOOLS
CHOCTAW,OFFICE NO. 2 FORT TOWSON PUBLIC SCHOOLS,KIMBERLEY FOWLER,,120210,0,0,0,0,OFFICE NO. 2 FORT TOWSON PUBLIC SCHOOLS
CHOCTAW,OFFICE NO. 2 FORT TOWSON PUBLIC SCHOOLS,C. SHANE MILLER,,120210,0,0,0,0,OFFICE NO. 2 FORT TOWSON PUBLIC SCHOOLS
CHOCTAW,OFFICE NO. 2 FORT TOWSON PUBLIC SCHOOLS,KIMBERLEY FOWLER,,120211,1,0,14,15,OFFICE NO. 2 FORT TOWSON PUBLIC SCHOOLS
CHOCTAW,OFFICE NO. 2 FORT TOWSON PUBLIC SCHOOLS,C. SHANE MILLER,,120211,0,1,10,11,OFFICE NO. 2 FORT TOWSON PUBLIC SCHOOLS
CHOCTAW,OFFICE NO. 2 SOPER PUBLIC SCHOOLS,ANGELLA ANNETTE DANCER,,120318,0,0,0,0,OFFICE NO. 2 SOPER PUBLIC SCHOOLS
CHOCTAW,OFFICE NO. 2 SOPER PUBLIC SCHOOLS,ALVIE SKIP PERKINS JR,,120318,0,0,0,0,OFFICE NO. 2 SOPER PUBLIC SCHOOLS
CHOCTAW,OFFICE NO. 2 FORT TOWSON PUBLIC SCHOOLS,KIMBERLEY FOWLER,,120319,3,4,16,23,OFFICE NO. 2 FORT TOWSON PUBLIC SCHOOLS
CHOCTAW,OFFICE NO. 2 FORT TOWSON PUBLIC SCHOOLS,C. SHANE MILLER,,120319,0,0,5,5,OFFICE NO. 2 FORT TOWSON PUBLIC SCHOOLS
CHOCTAW,OFFICE NO. 2 RATTAN PUBLIC SCHOOLS,CHANCE LAWLESS,,120319,0,0,16,16,OFFICE NO. 2 RATTAN PUBLIC SCHOOLS
CHOCTAW,OFFICE NO. 2 RATTAN PUBLIC SCHOOLS,VALERIE CLAY MERIDA,,120319,0,0,14,14,OFFICE NO. 2 RATTAN PUBLIC SCHOOLS
CHOCTAW,OFFICE NO. 2 FORT TOWSON PUBLIC SCHOOLS,KIMBERLEY FOWLER,,120320,0,0,14,14,OFFICE NO. 2 FORT TOWSON PUBLIC SCHOOLS
CHOCTAW,OFFICE NO. 2 FORT TOWSON PUBLIC SCHOOLS,C. SHANE MILLER,,120320,0,4,10,14,OFFICE NO. 2 FORT TOWSON PUBLIC SCHOOLS
CHOCTAW,OFFICE NO. 2 FORT TOWSON PUBLIC SCHOOLS,KIMBERLEY FOWLER,,120321,2,0,68,70,OFFICE NO. 2 FORT TOWSON PUBLIC SCHOOLS
CHOCTAW,OFFICE NO. 2 FORT TOWSON PUBLIC SCHOOLS,C. SHANE MILLER,,120321,1,2,33,36,OFFICE NO. 2 FORT TOWSON PUBLIC SCHOOLS
CHOCTAW,OFFICE NO. 2 FORT TOWSON PUBLIC SCHOOLS,KIMBERLEY FOWLER,,120322,0,0,0,0,OFFICE NO. 2 FORT TOWSON PUBLIC SCHOOLS
CHOCTAW,OFFICE NO. 2 FORT TOWSON PUBLIC SCHOOLS,C. SHANE MILLER,,120322,0,0,0,0,OFFICE NO. 2 FORT TOWSON PUBLIC SCHOOLS
CLEVELAND,COUNCILMEMBER WARD 7 CITY OF NORMAN,STEPHEN TYLER HOLMAN,,140006,0,0,6,6,COUNCILMEMBER WARD 7 CITY OF NORMAN
CLEVELAND,COUNCILMEMBER WARD 7 CITY OF NORMAN,TRACI BAKER,,140006,1,0,1,2,COUNCILMEMBER WARD 7 CITY OF NORMAN
CLEVELAND,"COUNCILMEMBER, WARD 3 CITY OF OKLAHOMA CITY",LARRY McATEE,,140007,5,0,15,20,"COUNCILMEMBER, WARD 3 CITY OF OKLAHOMA CITY"
CLEVELAND,"COUNCILMEMBER, WARD 3 CITY OF OKLAHOMA CITY",MATTHEW W. OLSEN,,140007,3,0,9,12,"COUNCILMEMBER, WARD 3 CITY OF OKLAHOMA CITY"
CLEVELAND,"COUNCILMEMBER, WARD 3 CITY OF OKLAHOMA CITY",JOE SARGE NELSON,,140007,2,0,4,6,"COUNCILMEMBER, WARD 3 CITY OF OKLAHOMA CITY"
CLEVELAND,OFFICE NO. 4 (UNEXPIRED TERM) MUSTANG PUBLIC SCHOOLS,BARBARA YOUNG,,140007,0,0,6,6,OFFICE NO. 4 (UNEXPIRED TERM) MUSTANG PUBLIC SCHOOLS
CLEVELAND,OFFICE NO. 4 (UNEXPIRED TERM) MUSTANG PUBLIC SCHOOLS,CHAD SCHROEDER,,140007,2,0,10,12,OFFICE NO. 4 (UNEXPIRED TERM) MUSTANG PUBLIC SCHOOLS
CLEVELAND,PROPOSITION NO. 1 MUSTANG PUBLIC SCHOOLS,FOR THE PROPOSITION - YES,,140007,2,0,13,15,PROPOSITION NO. 1 MUSTANG PUBLIC SCHOOLS
CLEVELAND,PROPOSITION NO. 1 MUSTANG PUBLIC SCHOOLS,AGAINST THE PROPOSITION - NO,,140007,0,0,5,5,PROPOSITION NO. 1 MUSTANG PUBLIC SCHOOLS
CLEVELAND,PROPOSITION NO. 2 MUSTANG PUBLIC SCHOOLS,FOR THE PROPOSITION - YES,,140007,2,0,12,14,PROPOSITION NO. 2 MUSTANG PUBLIC SCHOOLS
CLEVELAND,PROPOSITION NO. 2 MUSTANG PUBLIC SCHOOLS,AGAINST THE PROPOSITION - NO,,140007,0,0,5,5,PROPOSITION NO. 2 MUSTANG PUBLIC SCHOOLS
CLEVELAND,"COUNCILMEMBER, WARD 4 CITY OF OKLAHOMA CITY",RICHARD D. MORRISSETTE,,140010,2,0,4,6,"COUNCILMEMBER, WARD 4 CITY OF OKLAHOMA CITY"
CLEVELAND,"COUNCILMEMBER, WARD 4 CITY OF OKLAHOMA CITY",TODD STONE,,140010,0,0,5,5,"COUNCILMEMBER, WARD 4 CITY OF OKLAHOMA CITY"
CLEVELAND,"COUNCILMEMBER, WARD 4 CITY OF OKLAHOMA CITY",WALTER KULA,,140010,0,0,2,2,"COUNCILMEMBER, WARD 4 CITY OF OKLAHOMA CITY"
CLEVELAND,"COUNCILMEMBER, WARD 4 CITY OF OKLAHOMA CITY",DORIS MANGIARACINA BENBROOK,,140010,0,0,1,1,"COUNCILMEMBER, WARD 4 CITY OF OKLAHOMA CITY"
CLEVELAND,COUNCILMEMBER WARD 5 CITY OF NORMAN,SERETA WILSON,,140012,0,0,40,40,COUNCILMEMBER WARD 5 CITY OF NORMAN
CLEVELAND,COUNCILMEMBER WARD 5 CITY OF NORMAN,JAMES CHAPPEL,,140012,1,9,65,75,COUNCILMEMBER WARD 5 CITY OF NORMAN
CLEVELAND,COUNCILMEMBER WARD 5 CITY OF NORMAN,PHILLIP HILLIAN,,140012,0,0,8,8,COUNCILMEMBER WARD 5 CITY OF NORMAN
CLEVELAND,COUNCILMEMBER WARD 7 CITY OF NORMAN,STEPHEN TYLER HOLMAN,,140013,1,0,3,4,COUNCILMEMBER WARD 7 CITY OF NORMAN
CLEVELAND,COUNCILMEMBER WARD 7 CITY OF NORMAN,TRACI BAKER,,140013,0,0,2,2,COUNCILMEMBER WARD 7 CITY OF NORMAN
CLEVELAND,COUNCILMEMBER WARD 7 CITY OF NORMAN,STEPHEN TYLER HOLMAN,,140014,3,0,42,45,COUNCILMEMBER WARD 7 CITY OF NORMAN
CLEVELAND,COUNCILMEMBER WARD 7 CITY OF NORMAN,TRACI BAKER,,140014,1,0,9,10,COUNCILMEMBER WARD 7 CITY OF NORMAN
CLEVELAND,"COUNCILMEMBER, WARD 4 CITY OF OKLAHOMA CITY",RICHARD D. MORRISSETTE,,140017,1,0,0,1,"COUNCILMEMBER, WARD 4 CITY OF OKLAHOMA CITY"
CLEVELAND,"COUNCILMEMBER, WARD 4 CITY OF OKLAHOMA CITY",TODD STONE,,140017,0,0,4,4,"COUNCILMEMBER, WARD 4 CITY OF OKLAHOMA CITY"
CLEVELAND,"COUNCILMEMBER, WARD 4 CITY OF OKLAHOMA CITY",WALTER KULA,,140017,0,0,0,0,"COUNCILMEMBER, WARD 4 CITY OF OKLAHOMA CITY"
CLEVELAND,"COUNCILMEMBER, WARD 4 CITY OF OKLAHOMA CITY",DORIS MANGIARACINA BENBROOK,,140017,0,0,0,0,"COUNCILMEMBER, WARD 4 CITY OF OKLAHOMA CITY"
CLEVELAND,"COUNCILMEMBER, WARD 4 CITY OF OKLAHOMA CITY",RICHARD D. MORRISSETTE,,140024,3,0,0,3,"COUNCILMEMBER, WARD 4 CITY OF OKLAHOMA CITY"
CLEVELAND,"COUNCILMEMBER, WARD 4 CITY OF OKLAHOMA CITY",TODD STONE,,140024,3,0,3,6,"COUNCILMEMBER, WARD 4 CITY OF OKLAHOMA CITY"
CLEVELAND,"COUNCILMEMBER, WARD 4 CITY OF OKLAHOMA CITY",WALTER KULA,,140024,1,0,2,3,"COUNCILMEMBER, WARD 4 CITY OF OKLAHOMA CITY"
CLEVELAND,"COUNCILMEMBER, WARD 4 CITY OF OKLAHOMA CITY",DORIS MANGIARACINA BENBROOK,,140024,0,0,1,1,"COUNCILMEMBER, WARD 4 CITY OF OKLAHOMA CITY"
CLEVELAND,COUNCILMEMBER WARD 5 CITY OF NORMAN,SERETA WILSON,,140025,1,2,55,58,COUNCILMEMBER WARD 5 CITY OF NORMAN
CLEVELAND,COUNCILMEMBER WARD 5 CITY OF NORMAN,JAMES CHAPPEL,,140025,4,0,53,57,COUNCILMEMBER WARD 5 CITY OF NORMAN
CLEVELAND,COUNCILMEMBER WARD 5 CITY OF NORMAN,PHILLIP HILLIAN,,140025,0,4,30,34,COUNCILMEMBER WARD 5 CITY OF NORMAN
CLEVELAND,COUNCILMEMBER WARD 1 CITY OF NORMAN,GREG HEIPLE,,140028,8,2,57,67,COUNCILMEMBER WARD 1 CITY OF NORMAN
CLEVELAND,COUNCILMEMBER WARD 1 CITY OF NORMAN,KATE BIERMAN,,140028,4,5,93,102,COUNCILMEMBER WARD 1 CITY OF NORMAN
CLEVELAND,COUNCILMEMBER WARD 1 CITY OF NORMAN,VICTOR REYES,,140028,2,0,4,6,COUNCILMEMBER WARD 1 CITY OF NORMAN
CLEVELAND,COUNCILMEMBER WARD 5 CITY OF NORMAN,SERETA WILSON,,140028,0,0,0,0,COUNCILMEMBER WARD 5 CITY OF NORMAN
CLEVELAND,COUNCILMEMBER WARD 5 CITY OF NORMAN,JAMES CHAPPEL,,140028,0,0,0,0,COUNCILMEMBER WARD 5 CITY OF NORMAN
CLEVELAND,COUNCILMEMBER WARD 5 CITY OF NORMAN,PHILLIP HILLIAN,,140028,0,0,0,0,COUNCILMEMBER WARD 5 CITY OF NORMAN
CLEVELAND,COUNCILMEMBER WARD 7 CITY OF NORMAN,STEPHEN TYLER HOLMAN,,140028,0,0,16,16,COUNCILMEMBER WARD 7 CITY OF NORMAN
CLEVELAND,COUNCILMEMBER WARD 7 CITY OF NORMAN,TRACI BAKER,,140028,1,0,5,6,COUNCILMEMBER WARD 7 CITY OF NORMAN
CLEVELAND,OFFICE NO. 2 LEXINGTON PUBLIC SCHOOLS,TRAVIS W. PEERY,,140029,1,0,0,1,OFFICE NO. 2 LEXINGTON PUBLIC SCHOOLS
CLEVELAND,OFFICE NO. 2 LEXINGTON PUBLIC SCHOOLS,TERRI SAMPLE,,140029,0,0,0,0,OFFICE NO. 2 LEXINGTON PUBLIC SCHOOLS
CLEVELAND,OFFICE NO. 2 LEXINGTON PUBLIC SCHOOLS,CALEB J. PAUL,,140029,0,0,0,0,OFFICE NO. 2 LEXINGTON PUBLIC SCHOOLS
CLEVELAND,OFFICE NO. 2 LEXINGTON PUBLIC SCHOOLS,MATTHEW T. DIERKING,,140029,0,0,0,0,OFFICE NO. 2 LEXINGTON PUBLIC SCHOOLS
CLEVELAND,COUNCILMEMBER WARD 5 CITY OF NORMAN,SERETA WILSON,,140030,9,2,66,77,COUNCILMEMBER WARD 5 CITY OF NORMAN
CLEVELAND,COUNCILMEMBER WARD 5 CITY OF NORMAN,JAMES CHAPPEL,,140030,3,5,77,85,COUNCILMEMBER WARD 5 CITY OF NORMAN
CLEVELAND,COUNCILMEMBER WARD 5 CITY OF NORMAN,PHILLIP HILLIAN,,140030,0,0,9,9,COUNCILMEMBER WARD 5 CITY OF NORMAN
CLEVELAND,COUNCILMEMBER WARD 1 CITY OF NORMAN,GREG HEIPLE,,140032,2,1,36,39,COUNCILMEMBER WARD 1 CITY OF NORMAN
CLEVELAND,COUNCILMEMBER WARD 1 CITY OF NORMAN,KATE BIERMAN,,140032,5,1,136,142,COUNCILMEMBER WARD 1 CITY OF NORMAN
CLEVELAND,COUNCILMEMBER WARD 1 CITY OF NORMAN,VICTOR REYES,,140032,0,0,4,4,COUNCILMEMBER WARD 1 CITY OF NORMAN
CLEVELAND,OFFICE NO. 2 LEXINGTON PUBLIC SCHOOLS,TRAVIS W. PEERY,,140034,5,0,124,129,OFFICE NO. 2 LEXINGTON PUBLIC SCHOOLS
CLEVELAND,OFFICE NO. 2 LEXINGTON PUBLIC SCHOOLS,TERRI SAMPLE,,140034,7,3,145,155,OFFICE NO. 2 LEXINGTON PUBLIC SCHOOLS
CLEVELAND,OFFICE NO. 2 LEXINGTON PUBLIC SCHOOLS,CALEB J. PAUL,,140034,1,0,23,24,OFFICE NO. 2 LEXINGTON PUBLIC SCHOOLS
CLEVELAND,OFFICE NO. 2 LEXINGTON PUBLIC SCHOOLS,MATTHEW T. DIERKING,,140034,1,0,28,29,OFFICE NO. 2 LEXINGTON PUBLIC SCHOOLS
CLEVELAND,COUNCILMEMBER WARD 7 CITY OF NORMAN,STEPHEN TYLER HOLMAN,,140035,0,0,0,0,COUNCILMEMBER WARD 7 CITY OF NORMAN
CLEVELAND,COUNCILMEMBER WARD 7 CITY OF NORMAN,TRACI BAKER,,140035,0,0,0,0,COUNCILMEMBER WARD 7 CITY OF NORMAN
CLEVELAND,COUNCILMEMBER WARD 5 CITY OF NORMAN,SERETA WILSON,,140036,1,2,25,28,COUNCILMEMBER WARD 5 CITY OF NORMAN
CLEVELAND,COUNCILMEMBER WARD 5 CITY OF NORMAN,JAMES CHAPPEL,,140036,1,0,20,21,COUNCILMEMBER WARD 5 CITY OF NORMAN
CLEVELAND,COUNCILMEMBER WARD 5 CITY OF NORMAN,PHILLIP HILLIAN,,140036,0,2,21,23,COUNCILMEMBER WARD 5 CITY OF NORMAN
CLEVELAND,"COUNCILMEMBER, WARD 4 CITY OF OKLAHOMA CITY",RICHARD D. MORRISSETTE,,140036,4,0,13,17,"COUNCILMEMBER, WARD 4 CITY OF OKLAHOMA CITY"
CLEVELAND,"COUNCILMEMBER, WARD 4 CITY OF OKLAHOMA CITY",TODD STONE,,140036,0,0,9,9,"COUNCILMEMBER, WARD 4 CITY OF OKLAHOMA CITY"
CLEVELAND,"COUNCILMEMBER, WARD 4 CITY OF OKLAHOMA CITY",WALTER KULA,,140036,0,0,0,0,"COUNCILMEMBER, WARD 4 CITY OF OKLAHOMA CITY"
CLEVELAND,"COUNCILMEMBER, WARD 4 CITY OF OKLAHOMA CITY",DORIS MANGIARACINA BENBROOK,,140036,2,0,4,6,"COUNCILMEMBER, WARD 4 CITY OF OKLAHOMA CITY"
CLEVELAND,"COUNCILMEMBER, WARD 4 CITY OF OKLAHOMA CITY",RICHARD D. MORRISSETTE,,140037,1,0,10,11,"COUNCILMEMBER, WARD 4 CITY OF OKLAHOMA CITY"
CLEVELAND,"COUNCILMEMBER, WARD 4 CITY OF OKLAHOMA CITY",TODD STONE,,140037,3,0,5,8,"COUNCILMEMBER, WARD 4 CITY OF OKLAHOMA CITY"
CLEVELAND,"COUNCILMEMBER, WARD 4 CITY OF OKLAHOMA CITY",WALTER KULA,,140037,1,0,0,1,"COUNCILMEMBER, WARD 4 CITY OF OKLAHOMA CITY"
CLEVELAND,"COUNCILMEMBER, WARD 4 CITY OF OKLAHOMA CITY",DORIS MANGIARACINA BENBROOK,,140037,1,0,3,4,"COUNCILMEMBER, WARD 4 CITY OF OKLAHOMA CITY"
CLEVELAND,COUNCILMEMBER WARD 5 CITY OF NORMAN,SERETA WILSON,,140038,0,0,0,0,COUNCILMEMBER WARD 5 CITY OF NORMAN
CLEVELAND,COUNCILMEMBER WARD 5 CITY OF NORMAN,JAMES CHAPPEL,,140038,0,0,1,1,COUNCILMEMBER WARD 5 CITY OF NORMAN
CLEVELAND,COUNCILMEMBER WARD 5 CITY OF NORMAN,PHILLIP HILLIAN,,140038,0,0,0,0,COUNCILMEMBER WARD 5 CITY OF NORMAN
CLEVELAND,COUNCILMEMBER WARD 5 CITY OF NORMAN,SERETA WILSON,,140045,3,4,36,43,COUNCILMEMBER WARD 5 CITY OF NORMAN
CLEVELAND,COUNCILMEMBER WARD 5 CITY OF NORMAN,JAMES CHAPPEL,,140045,0,0,31,31,COUNCILMEMBER WARD 5 CITY OF NORMAN
CLEVELAND,COUNCILMEMBER WARD 5 CITY OF NORMAN,PHILLIP HILLIAN,,140045,0,0,15,15,COUNCILMEMBER WARD 5 CITY OF NORMAN
CLEVELAND,COUNCILMEMBER WARD 5 CITY OF NORMAN,SERETA WILSON,,140049,1,0,16,17,COUNCILMEMBER WARD 5 CITY OF NORMAN
CLEVELAND,COUNCILMEMBER WARD 5 CITY OF NORMAN,JAMES CHAPPEL,,140049,1,0,11,12,COUNCILMEMBER WARD 5 CITY OF NORMAN
CLEVELAND,COUNCILMEMBER WARD 5 CITY OF NORMAN,PHILLIP HILLIAN,,140049,1,0,3,4,COUNCILMEMBER WARD 5 CITY OF NORMAN
CLEVELAND,COUNCILMEMBER WARD 5 CITY OF NORMAN,SERETA WILSON,,140063,0,0,3,3,COUNCILMEMBER WARD 5 CITY OF NORMAN
CLEVELAND,COUNCILMEMBER WARD 5 CITY OF NORMAN,JAMES CHAPPEL,,140063,0,0,2,2,COUNCILMEMBER WARD 5 CITY OF NORMAN
CLEVELAND,COUNCILMEMBER WARD 5 CITY OF NORMAN,PHILLIP HILLIAN,,140063,0,0,3,3,COUNCILMEMBER WARD 5 CITY OF NORMAN
CLEVELAND,"COUNCILMEMBER, WARD 4 CITY OF OKLAHOMA CITY",RICHARD D. MORRISSETTE,,140063,0,0,3,3,"COUNCILMEMBER, WARD 4 CITY OF OKLAHOMA CITY"
CLEVELAND,"COUNCILMEMBER, WARD 4 CITY OF OKLAHOMA CITY",TODD STONE,,140063,0,0,31,31,"COUNCILMEMBER, WARD 4 CITY OF OKLAHOMA CITY"
CLEVELAND,"COUNCILMEMBER, WARD 4 CITY OF OKLAHOMA CITY",WALTER KULA,,140063,1,0,0,1,"COUNCILMEMBER, WARD 4 CITY OF OKLAHOMA CITY"
CLEVELAND,"COUNCILMEMBER, WARD 4 CITY OF OKLAHOMA CITY",DORIS MANGIARACINA BENBROOK,,140063,0,0,0,0,"COUNCILMEMBER, WARD 4 CITY OF OKLAHOMA CITY"
CLEVELAND,COUNCILMEMBER WARD 5 CITY OF NORMAN,SERETA WILSON,,140064,0,0,1,1,COUNCILMEMBER WARD 5 CITY OF NORMAN
CLEVELAND,COUNCILMEMBER WARD 5 CITY OF NORMAN,JAMES CHAPPEL,,140064,1,0,2,3,COUNCILMEMBER WARD 5 CITY OF NORMAN
CLEVELAND,COUNCILMEMBER WARD 5 CITY OF NORMAN,PHILLIP HILLIAN,,140064,0,0,2,2,COUNCILMEMBER WARD 5 CITY OF NORMAN
CLEVELAND,"COUNCILMEMBER, WARD 4 CITY OF OKLAHOMA CITY",RICHARD D. MORRISSETTE,,140064,20,1,39,60,"COUNCILMEMBER, WARD 4 CITY OF OKLAHOMA CITY"
CLEVELAND,"COUNCILMEMBER, WARD 4 CITY OF OKLAHOMA CITY",TODD STONE,,140064,14,0,25,39,"COUNCILMEMBER, WARD 4 CITY OF OKLAHOMA CITY"
CLEVELAND,"COUNCILMEMBER, WARD 4 CITY OF OKLAHOMA CITY",WALTER KULA,,140064,0,0,5,5,"COUNCILMEMBER, WARD 4 CITY OF OKLAHOMA CITY"
CLEVELAND,"COUNCILMEMBER, WARD 4 CITY OF OKLAHOMA CITY",DORIS MANGIARACINA BENBROOK,,140064,7,0,7,14,"COUNCILMEMBER, WARD 4 CITY OF OKLAHOMA CITY"
CLEVELAND,OFFICE NO. 2 MCLOUD PUBLIC SCHOOLS,MELANIE KRAUSE,,140064,4,0,28,32,OFFICE NO. 2 MCLOUD PUBLIC SCHOOLS
CLEVELAND,OFFICE NO. 2 MCLOUD PUBLIC SCHOOLS,STEVEN M. SWARTZ,,140064,4,0,11,15,OFFICE NO. 2 MCLOUD PUBLIC SCHOOLS
CLEVELAND,OFFICE NO. 2 MCLOUD PUBLIC SCHOOLS,JEANNENE WILLIAMS,,140064,7,1,18,26,OFFICE NO. 2 MCLOUD PUBLIC SCHOOLS
CLEVELAND,COUNCILMEMBER WARD 5 CITY OF NORMAN,SERETA WILSON,,140065,0,1,1,2,COUNCILMEMBER WARD 5 CITY OF NORMAN
CLEVELAND,COUNCILMEMBER WARD 5 CITY OF NORMAN,JAMES CHAPPEL,,140065,0,1,2,3,COUNCILMEMBER WARD 5 CITY OF NORMAN
CLEVELAND,COUNCILMEMBER WARD 5 CITY OF NORMAN,PHILLIP HILLIAN,,140065,0,0,0,0,COUNCILMEMBER WARD 5 CITY OF NORMAN
CLEVELAND,"COUNCILMEMBER, WARD 4 CITY OF OKLAHOMA CITY",RICHARD D. MORRISSETTE,,140065,1,0,4,5,"COUNCILMEMBER, WARD 4 CITY OF OKLAHOMA CITY"
CLEVELAND,"COUNCILMEMBER, WARD 4 CITY OF OKLAHOMA CITY",TODD STONE,,140065,3,0,4,7,"COUNCILMEMBER, WARD 4 CITY OF OKLAHOMA CITY"
CLEVELAND,"COUNCILMEMBER, WARD 4 CITY OF OKLAHOMA CITY",WALTER KULA,,140065,0,0,0,0,"COUNCILMEMBER, WARD 4 CITY OF OKLAHOMA CITY"
CLEVELAND,"COUNCILMEMBER, WARD 4 CITY OF OKLAHOMA CITY",DORIS MANGIARACINA BENBROOK,,140065,0,0,0,0,"COUNCILMEMBER, WARD 4 CITY OF OKLAHOMA CITY"
CLEVELAND,COUNCILMEMBER WARD 5 CITY OF NORMAN,SERETA WILSON,,140067,1,1,35,37,COUNCILMEMBER WARD 5 CITY OF NORMAN
CLEVELAND,COUNCILMEMBER WARD 5 CITY OF NORMAN,JAMES CHAPPEL,,140067,3,2,52,57,COUNCILMEMBER WARD 5 CITY OF NORMAN
CLEVELAND,COUNCILMEMBER WARD 5 CITY OF NORMAN,PHILLIP HILLIAN,,140067,0,0,5,5,COUNCILMEMBER WARD 5 CITY OF NORMAN
CLEVELAND,COUNCILMEMBER WARD 7 CITY OF NORMAN,STEPHEN TYLER HOLMAN,,140067,0,0,2,2,COUNCILMEMBER WARD 7 CITY OF NORMAN
CLEVELAND,COUNCILMEMBER WARD 7 CITY OF NORMAN,TRACI BAKER,,140067,0,0,0,0,COUNCILMEMBER WARD 7 CITY OF NORMAN
CLEVELAND,COUNCILMEMBER WARD 7 CITY OF NORMAN,STEPHEN TYLER HOLMAN,,140068,8,2,99,109,COUNCILMEMBER WARD 7 CITY OF NORMAN
CLEVELAND,COUNCILMEMBER WARD 7 CITY OF NORMAN,TRACI BAKER,,140068,2,0,26,28,COUNCILMEMBER WARD 7 CITY OF NORMAN
CLEVELAND,"COUNCILMEMBER, WARD 4 CITY OF OKLAHOMA CITY",RICHARD D. MORRISSETTE,,140072,1,0,1,2,"COUNCILMEMBER, WARD 4 CITY OF OKLAHOMA CITY"
CLEVELAND,"COUNCILMEMBER, WARD 4 CITY OF OKLAHOMA CITY",TODD STONE,,140072,0,0,10,10,"COUNCILMEMBER, WARD 4 CITY OF OKLAHOMA CITY"
CLEVELAND,"COUNCILMEMBER, WARD 4 CITY OF OKLAHOMA CITY",WALTER KULA,,140072,0,0,0,0,"COUNCILMEMBER, WARD 4 CITY OF OKLAHOMA CITY"
CLEVELAND,"COUNCILMEMBER, WARD 4 CITY OF OKLAHOMA CITY",DORIS MANGIARACINA BENBROOK,,140072,0,0,1,1,"COUNCILMEMBER, WARD 4 CITY OF OKLAHOMA CITY"
CLEVELAND,COUNCILMEMBER WARD 5 CITY OF NORMAN,SERETA WILSON,,140078,0,0,0,0,COUNCILMEMBER WARD 5 CITY OF NORMAN
CLEVELAND,COUNCILMEMBER WARD 5 CITY OF NORMAN,JAMES CHAPPEL,,140078,2,0,0,2,COUNCILMEMBER WARD 5 CITY OF NORMAN
CLEVELAND,COUNCILMEMBER WARD 5 CITY OF NORMAN,PHILLIP HILLIAN,,140078,0,0,1,1,COUNCILMEMBER WARD 5 CITY OF NORMAN
CLEVELAND,"COUNCILMEMBER, WARD 4 CITY OF OKLAHOMA CITY",RICHARD D. MORRISSETTE,,140078,14,0,22,36,"COUNCILMEMBER, WARD 4 CITY OF OKLAHOMA CITY"
CLEVELAND,"COUNCILMEMBER, WARD 4 CITY OF OKLAHOMA CITY",TODD STONE,,140078,10,1,34,45,"COUNCILMEMBER, WARD 4 CITY OF OKLAHOMA CITY"
CLEVELAND,"COUNCILMEMBER, WARD 4 CITY OF OKLAHOMA CITY",WALTER KULA,,140078,2,0,14,16,"COUNCILMEMBER, WARD 4 CITY OF OKLAHOMA CITY"
CLEVELAND,"COUNCILMEMBER, WARD 4 CITY OF OKLAHOMA CITY",DORIS MANGIARACINA BENBROOK,,140078,4,0,8,12,"COUNCILMEMBER, WARD 4 CITY OF OKLAHOMA CITY"
CLEVELAND,COUNCILMEMBER WARD 1 CITY OF NORMAN,GREG HEIPLE,,140082,15,7,137,159,COUNCILMEMBER WARD 1 CITY OF NORMAN
CLEVELAND,COUNCILMEMBER WARD 1 CITY OF NORMAN,KATE BIERMAN,,140082,8,2,73,83,COUNCILMEMBER WARD 1 CITY OF NORMAN
CLEVELAND,COUNCILMEMBER WARD 1 CITY OF NORMAN,VICTOR REYES,,140082,1,0,3,4,COUNCILMEMBER WARD 1 CITY OF NORMAN
CLEVELAND,COUNCILMEMBER WARD 5 CITY OF NORMAN,SERETA WILSON,,140082,4,5,56,65,COUNCILMEMBER WARD 5 CITY OF NORMAN
CLEVELAND,COUNCILMEMBER WARD 5 CITY OF NORMAN,JAMES CHAPPEL,,140082,5,1,16,22,COUNCILMEMBER WARD 5 CITY OF NORMAN
CLEVELAND,COUNCILMEMBER WARD 5 CITY OF NORMAN,PHILLIP HILLIAN,,140082,2,0,5,7,COUNCILMEMBER WARD 5 CITY OF NORMAN
CLEVELAND,COUNCILMEMBER WARD 5 CITY OF NORMAN,SERETA WILSON,,140083,1,4,34,39,COUNCILMEMBER WARD 5 CITY OF NORMAN
CLEVELAND,COUNCILMEMBER WARD 5 CITY OF NORMAN,JAMES CHAPPEL,,140083,4,0,24,28,COUNCILMEMBER WARD 5 CITY OF NORMAN
CLEVELAND,COUNCILMEMBER WARD 5 CITY OF NORMAN,PHILLIP HILLIAN,,140083,0,0,1,1,COUNCILMEMBER WARD 5 CITY OF NORMAN
CLEVELAND,"COUNCILMEMBER, WARD 4 CITY OF OKLAHOMA CITY",RICHARD D. MORRISSETTE,,140087,9,0,20,29,"COUNCILMEMBER, WARD 4 CITY OF OKLAHOMA CITY"
CLEVELAND,"COUNCILMEMBER, WARD 4 CITY OF OKLAHOMA CITY",TODD STONE,,140087,2,0,19,21,"COUNCILMEMBER, WARD 4 CITY OF OKLAHOMA CITY"
CLEVELAND,"COUNCILMEMBER, WARD 4 CITY OF OKLAHOMA CITY",WALTER KULA,,140087,3,0,4,7,"COUNCILMEMBER, WARD 4 CITY OF OKLAHOMA CITY"
CLEVELAND,"COUNCILMEMBER, WARD 4 CITY OF OKLAHOMA CITY",DORIS MANGIARACINA BENBROOK,,140087,3,0,7,10,"COUNCILMEMBER, WARD 4 CITY OF OKLAHOMA CITY"
CLEVELAND,"COUNCILMEMBER, WARD 4 CITY OF OKLAHOMA CITY",RICHARD D. MORRISSETTE,,140090,0,0,0,0,"COUNCILMEMBER, WARD 4 CITY OF OKLAHOMA CITY"
CLEVELAND,"COUNCILMEMBER, WARD 4 CITY OF OKLAHOMA CITY",TODD STONE,,140090,0,0,0,0,"COUNCILMEMBER, WARD 4 CITY OF OKLAHOMA CITY"
CLEVELAND,"COUNCILMEMBER, WARD 4 CITY OF OKLAHOMA CITY",WALTER KULA,,140090,0,0,0,0,"COUNCILMEMBER, WARD 4 CITY OF OKLAHOMA CITY"
CLEVELAND,"COUNCILMEMBER, WARD 4 CITY OF OKLAHOMA CITY",DORIS MANGIARACINA BENBROOK,,140090,0,0,0,0,"COUNCILMEMBER, WARD 4 CITY OF OKLAHOMA CITY"
CLEVELAND,COUNCILMEMBER WARD 5 CITY OF NORMAN,SERETA WILSON,,140094,0,4,13,17,COUNCILMEMBER WARD 5 CITY OF NORMAN
CLEVELAND,COUNCILMEMBER WARD 5 CITY OF NORMAN,JAMES CHAPPEL,,140094,2,1,12,15,COUNCILMEMBER WARD 5 CITY OF NORMAN
CLEVELAND,COUNCILMEMBER WARD 5 CITY OF NORMAN,PHILLIP HILLIAN,,140094,0,0,10,10,COUNCILMEMBER WARD 5 CITY OF NORMAN
COAL,OFFICE NO. 2 TUPELO PUBLIC SCHOOLS,CHARITY WOODS-EIDSON,,150002,1,0,18,19,OFFICE NO. 2 TUPELO PUBLIC SCHOOLS
COAL,OFFICE NO. 2 TUPELO PUBLIC SCHOOLS,BRAD GOULD,,150002,1,0,48,49,OFFICE NO. 2 TUPELO PUBLIC SCHOOLS
COAL,OFFICE NO. 2 COALGATE PUBLIC SCHOOLS,TRENT BOURLAND,,150003,3,0,10,13,OFFICE NO. 2 COALGATE PUBLIC SCHOOLS
COAL,OFFICE NO. 2 COALGATE PUBLIC SCHOOLS,PHILIP SCOTT BROWN,,150003,0,0,1,1,OFFICE NO. 2 COALGATE PUBLIC SCHOOLS
COAL,OFFICE NO. 2 TUPELO PUBLIC SCHOOLS,CHARITY WOODS-EIDSON,,150003,0,0,0,0,OFFICE NO. 2 TUPELO PUBLIC SCHOOLS
COAL,OFFICE NO. 2 TUPELO PUBLIC SCHOOLS,BRAD GOULD,,150003,0,0,0,0,OFFICE NO. 2 TUPELO PUBLIC SCHOOLS
COAL,OFFICE NO. 2 ALLEN PUBLIC SCHOOLS,JAMI RINEHART,,150003,0,0,0,0,OFFICE NO. 2 ALLEN PUBLIC SCHOOLS
COAL,OFFICE NO. 2 ALLEN PUBLIC SCHOOLS,CINDY DAVIS,,150003,0,0,0,0,OFFICE NO. 2 ALLEN PUBLIC SCHOOLS
COAL,COUNTY COMMISSIONER DISTRICT NO. 2,NICK LEE,Democratic,150004,5,21,153,179,COUNTY COMMISSIONER DISTRICT NO. 2
COAL,COUNTY COMMISSIONER DISTRICT NO. 2,MELVIN HOPPER JACKSON,Democratic,150004,5,25,68,98,COUNTY COMMISSIONER DISTRICT NO. 2
COAL,OFFICE NO. 2 COALGATE PUBLIC SCHOOLS,TRENT BOURLAND,,150004,5,16,61,82,OFFICE NO. 2 COALGATE PUBLIC SCHOOLS
COAL,OFFICE NO. 2 COALGATE PUBLIC SCHOOLS,PHILIP SCOTT BROWN,,150004,2,14,15,31,OFFICE NO. 2 COALGATE PUBLIC SCHOOLS
COAL,COUNTY COMMISSIONER DISTRICT NO. 2,NICK LEE,Democratic,150005,1,38,100,139,COUNTY COMMISSIONER DISTRICT NO. 2
COAL,COUNTY COMMISSIONER DISTRICT NO. 2,MELVIN HOPPER JACKSON,Democratic,150005,3,35,71,109,COUNTY COMMISSIONER DISTRICT NO. 2
COAL,OFFICE NO. 2 COALGATE PUBLIC SCHOOLS,TRENT BOURLAND,,150005,1,48,98,147,OFFICE NO. 2 COALGATE PUBLIC SCHOOLS
COAL,OFFICE NO. 2 COALGATE PUBLIC SCHOOLS,PHILIP SCOTT BROWN,,150005,2,24,73,99,OFFICE NO. 2 COALGATE PUBLIC SCHOOLS
COAL,OFFICE NO. 2 COALGATE PUBLIC SCHOOLS,TRENT BOURLAND,,150006,3,5,17,25,OFFICE NO. 2 COALGATE PUBLIC SCHOOLS
COAL,OFFICE NO. 2 COALGATE PUBLIC SCHOOLS,PHILIP SCOTT BROWN,,150006,0,1,5,6,OFFICE NO. 2 COALGATE PUBLIC SCHOOLS
COAL,OFFICE NO. 2 COALGATE PUBLIC SCHOOLS,TRENT BOURLAND,,150007,1,3,21,25,OFFICE NO. 2 COALGATE PUBLIC SCHOOLS
COAL,OFFICE NO. 2 COALGATE PUBLIC SCHOOLS,PHILIP SCOTT BROWN,,150007,1,1,6,8,OFFICE NO. 2 COALGATE PUBLIC SCHOOLS
COAL,OFFICE NO. 2 COALGATE PUBLIC SCHOOLS,TRENT BOURLAND,,150009,0,0,3,3,OFFICE NO. 2 COALGATE PUBLIC SCHOOLS
COAL,OFFICE NO. 2 COALGATE PUBLIC SCHOOLS,PHILIP SCOTT BROWN,,150009,0,0,0,0,OFFICE NO. 2 COALGATE PUBLIC SCHOOLS
COAL,OFFICE NO. 2 TUPELO PUBLIC SCHOOLS,CHARITY WOODS-EIDSON,,150009,0,0,2,2,OFFICE NO. 2 TUPELO PUBLIC SCHOOLS
COAL,OFFICE NO. 2 TUPELO PUBLIC SCHOOLS,BRAD GOULD,,150009,0,0,3,3,OFFICE NO. 2 TUPELO PUBLIC SCHOOLS
COAL,OFFICE NO. 2 COALGATE PUBLIC SCHOOLS,TRENT BOURLAND,,150010,0,0,3,3,OFFICE NO. 2 COALGATE PUBLIC SCHOOLS
COAL,OFFICE NO. 2 COALGATE PUBLIC SCHOOLS,PHILIP SCOTT BROWN,,150010,0,1,2,3,OFFICE NO. 2 COALGATE PUBLIC SCHOOLS
COAL,OFFICE NO. 2 TUPELO PUBLIC SCHOOLS,CHARITY WOODS-EIDSON,,150010,0,0,0,0,OFFICE NO. 2 TUPELO PUBLIC SCHOOLS
COAL,OFFICE NO. 2 TUPELO PUBLIC SCHOOLS,BRAD GOULD,,150010,0,0,0,0,OFFICE NO. 2 TUPELO PUBLIC SCHOOLS
COAL,OFFICE NO. 2 COALGATE PUBLIC SCHOOLS,TRENT BOURLAND,,150011,2,2,18,22,OFFICE NO. 2 COALGATE PUBLIC SCHOOLS
COAL,OFFICE NO. 2 COALGATE PUBLIC SCHOOLS,PHILIP SCOTT BROWN,,150011,1,3,7,11,OFFICE NO. 2 COALGATE PUBLIC SCHOOLS
COMANCHE,PROPOSITION CITY OF LAWTON,FOR THE PROPOSITION - YES,,160001,19,5,45,69,
COMANCHE,PROPOSITION CITY OF LAWTON,AGAINST THE PROPOSITION - NO,,160001,4,0,56,60,
COMANCHE,PROPOSITION CITY OF LAWTON,FOR THE PROPOSITION - YES,,160002,8,2,38,48,
COMANCHE,PROPOSITION CITY OF LAWTON,AGAINST THE PROPOSITION - NO,,160002,4,2,41,47,
COMANCHE,PROPOSITION CITY OF LAWTON,FOR THE PROPOSITION - YES,,160003,4,1,32,37,
COMANCHE,PROPOSITION CITY OF LAWTON,AGAINST THE PROPOSITION - NO,,160003,1,3,30,34,
COMANCHE,PROPOSITION CITY OF LAWTON,FOR THE PROPOSITION - YES,,160007,5,2,43,50,
COMANCHE,PROPOSITION CITY OF LAWTON,AGAINST THE PROPOSITION - NO,,160007,1,1,34,36,
COMANCHE,PROPOSITION CITY OF LAWTON,FOR THE PROPOSITION - YES,,160008,11,10,76,97,
COMANCHE,PROPOSITION CITY OF LAWTON,AGAINST THE PROPOSITION - NO,,160008,8,3,42,53,
COMANCHE,PROPOSITION CITY OF LAWTON,FOR THE PROPOSITION - YES,,160009,2,2,48,52,
COMANCHE,PROPOSITION CITY OF LAWTON,AGAINST THE PROPOSITION - NO,,160009,1,0,38,39,
COMANCHE,OFFICE NO. 2 CACHE PUBLIC SCHOOLS,BRAD SEATON,,160009,0,0,3,3,OFFICE NO. 2 CACHE PUBLIC SCHOOLS
COMANCHE,OFFICE NO. 2 CACHE PUBLIC SCHOOLS,JAMES CARTER,,160009,0,0,0,0,OFFICE NO. 2 CACHE PUBLIC SCHOOLS
COMANCHE,PROPOSITION CITY OF LAWTON,FOR THE PROPOSITION - YES,,160011,7,1,32,40,
COMANCHE,PROPOSITION CITY OF LAWTON,AGAINST THE PROPOSITION - NO,,160011,1,1,33,35,
COMANCHE,PROPOSITION CITY OF LAWTON,FOR THE PROPOSITION - YES,,160013,13,1,35,49,
COMANCHE,PROPOSITION CITY OF LAWTON,AGAINST THE PROPOSITION - NO,,160013,5,4,41,50,
COMANCHE,PROPOSITION CITY OF LAWTON,FOR THE PROPOSITION - YES,,160014,2,0,1,3,
COMANCHE,PROPOSITION CITY OF LAWTON,AGAINST THE PROPOSITION - NO,,160014,0,0,0,0,
COMANCHE,PROPOSITION CITY OF LAWTON,FOR THE PROPOSITION - YES,,160015,13,5,54,72,
COMANCHE,PROPOSITION CITY OF LAWTON,AGAINST THE PROPOSITION - NO,,160015,7,8,36,51,
COMANCHE,PROPOSITION CITY OF LAWTON,FOR THE PROPOSITION - YES,,160017,25,8,63,96,
COMANCHE,PROPOSITION CITY OF LAWTON,AGAINST THE PROPOSITION - NO,,160017,4,4,38,46,
COMANCHE,PROPOSITION CITY OF LAWTON,FOR THE PROPOSITION - YES,,160019,2,2,39,43,
COMANCHE,PROPOSITION CITY OF LAWTON,AGAINST THE PROPOSITION - NO,,160019,3,4,37,44,
COMANCHE,PROPOSITION CITY OF LAWTON,FOR THE PROPOSITION - YES,,160020,3,2,21,26,
COMANCHE,PROPOSITION CITY OF LAWTON,AGAINST THE PROPOSITION - NO,,160020,1,2,33,36,
COMANCHE,PROPOSITION CITY OF LAWTON,FOR THE PROPOSITION - YES,,160021,1,2,26,29,
COMANCHE,PROPOSITION CITY OF LAWTON,AGAINST THE PROPOSITION - NO,,160021,2,3,26,31,
COMANCHE,PROPOSITION CITY OF LAWTON,FOR THE PROPOSITION - YES,,160025,0,0,10,10,
COMANCHE,PROPOSITION CITY OF LAWTON,AGAINST THE PROPOSITION - NO,,160025,2,0,2,4,
COMANCHE,PROPOSITION CITY OF LAWTON,FOR THE PROPOSITION - YES,,160026,1,2,13,16,
COMANCHE,PROPOSITION CITY OF LAWTON,AGAINST THE PROPOSITION - NO,,160026,0,5,22,27,
COMANCHE,PROPOSITION CITY OF LAWTON,FOR THE PROPOSITION - YES,,160027,2,1,6,9,
COMANCHE,PROPOSITION CITY OF LAWTON,AGAINST THE PROPOSITION - NO,,160027,2,1,20,23,
COMANCHE,PROPOSITION CITY OF LAWTON,FOR THE PROPOSITION - YES,,160029,0,0,14,14,
COMANCHE,PROPOSITION CITY OF LAWTON,AGAINST THE PROPOSITION - NO,,160029,2,1,10,13,
COMANCHE,PROPOSITION CITY OF LAWTON,FOR THE PROPOSITION - YES,,160030,0,0,23,23,
COMANCHE,PROPOSITION CITY OF LAWTON,AGAINST THE PROPOSITION - NO,,160030,0,0,11,11,
COMANCHE,PROPOSITION CITY OF LAWTON,FOR THE PROPOSITION - YES,,160031,15,10,100,125,
COMANCHE,PROPOSITION CITY OF LAWTON,AGAINST THE PROPOSITION - NO,,160031,11,10,67,88,
COMANCHE,OFFICE NO. 2 ELGIN PUBLIC SCHOOLS,DUSTIN J. HILLIARY,,160031,0,0,4,4,OFFICE NO. 2 ELGIN PUBLIC SCHOOLS
COMANCHE,OFFICE NO. 2 ELGIN PUBLIC SCHOOLS,RANELL OLIVER,,160031,0,0,0,0,OFFICE NO. 2 ELGIN PUBLIC SCHOOLS
COMANCHE,OFFICE NO. 2 ELGIN PUBLIC SCHOOLS,AARON MOLLOY,,160031,0,0,1,1,OFFICE NO. 2 ELGIN PUBLIC SCHOOLS
COMANCHE,PROPOSITION CITY OF LAWTON,FOR THE PROPOSITION - YES,,160032,0,0,6,6,
COMANCHE,PROPOSITION CITY OF LAWTON,AGAINST THE PROPOSITION - NO,,160032,0,0,4,4,
COMANCHE,PROPOSITION CITY OF LAWTON,FOR THE PROPOSITION - YES,,160033,12,0,10,22,
COMANCHE,PROPOSITION CITY OF LAWTON,AGAINST THE PROPOSITION - NO,,160033,1,0,20,21,
COMANCHE,PROPOSITION CITY OF LAWTON,FOR THE PROPOSITION - YES,,160034,14,1,45,60,
COMANCHE,PROPOSITION CITY OF LAWTON,AGAINST THE PROPOSITION - NO,,160034,5,6,42,53,
COMANCHE,OFFICE NO. 2 CACHE PUBLIC SCHOOLS,BRAD SEATON,,160035,0,0,11,11,OFFICE NO. 2 CACHE PUBLIC SCHOOLS
COMANCHE,OFFICE NO. 2 CACHE PUBLIC SCHOOLS,JAMES CARTER,,160035,0,0,2,2,OFFICE NO. 2 CACHE PUBLIC SCHOOLS
COMANCHE,OFFICE NO. 2 ELGIN PUBLIC SCHOOLS,DUSTIN J. HILLIARY,,160035,0,0,16,16,OFFICE NO. 2 ELGIN PUBLIC SCHOOLS
COMANCHE,OFFICE NO. 2 ELGIN PUBLIC SCHOOLS,RANELL OLIVER,,160035,0,0,3,3,OFFICE NO. 2 ELGIN PUBLIC SCHOOLS
COMANCHE,OFFICE NO. 2 ELGIN PUBLIC SCHOOLS,AARON MOLLOY,,160035,1,1,6,8,OFFICE NO. 2 ELGIN PUBLIC SCHOOLS
COMANCHE,OFFICE NO. 3 SNYDER PUBLIC SCHOOLS,DREW JANZ,,160035,0,0,0,0,OFFICE NO. 3 SNYDER PUBLIC SCHOOLS
COMANCHE,OFFICE NO. 3 SNYDER PUBLIC SCHOOLS,CARMEN McCORKLE,,160035,0,0,0,0,OFFICE NO. 3 SNYDER PUBLIC SCHOOLS
COMANCHE,OFFICE NO. 2 ELGIN PUBLIC SCHOOLS,DUSTIN J. HILLIARY,,160036,0,0,20,20,OFFICE NO. 2 ELGIN PUBLIC SCHOOLS
COMANCHE,OFFICE NO. 2 ELGIN PUBLIC SCHOOLS,RANELL OLIVER,,160036,0,2,8,10,OFFICE NO. 2 ELGIN PUBLIC SCHOOLS
COMANCHE,OFFICE NO. 2 ELGIN PUBLIC SCHOOLS,AARON MOLLOY,,160036,0,0,7,7,OFFICE NO. 2 ELGIN PUBLIC SCHOOLS
COMANCHE,OFFICE NO. 2 ELGIN PUBLIC SCHOOLS,DUSTIN J. HILLIARY,,160037,2,0,20,22,OFFICE NO. 2 ELGIN PUBLIC SCHOOLS
COMANCHE,OFFICE NO. 2 ELGIN PUBLIC SCHOOLS,RANELL OLIVER,,160037,0,0,6,6,OFFICE NO. 2 ELGIN PUBLIC SCHOOLS
COMANCHE,OFFICE NO. 2 ELGIN PUBLIC SCHOOLS,AARON MOLLOY,,160037,0,0,48,48,OFFICE NO. 2 ELGIN PUBLIC SCHOOLS
COMANCHE,OFFICE NO. 2 ELGIN PUBLIC SCHOOLS,DUSTIN J. HILLIARY,,160038,10,7,91,108,OFFICE NO. 2 ELGIN PUBLIC SCHOOLS
COMANCHE,OFFICE NO. 2 ELGIN PUBLIC SCHOOLS,RANELL OLIVER,,160038,1,3,39,43,OFFICE NO. 2 ELGIN PUBLIC SCHOOLS
COMANCHE,OFFICE NO. 2 ELGIN PUBLIC SCHOOLS,AARON MOLLOY,,160038,11,8,309,328,OFFICE NO. 2 ELGIN PUBLIC SCHOOLS
COMANCHE,OFFICE NO. 2 FLETCHER PUBLIC SCHOOLS,CHAD FUNKHOUSER,,160038,0,0,0,0,OFFICE NO. 2 FLETCHER PUBLIC SCHOOLS
COMANCHE,OFFICE NO. 2 FLETCHER PUBLIC SCHOOLS,BRYAN SWIETEK,,160038,0,0,0,0,OFFICE NO. 2 FLETCHER PUBLIC SCHOOLS
COMANCHE,OFFICE NO. 2 FLETCHER PUBLIC SCHOOLS,AMBER HENDRIX,,160038,0,0,0,0,OFFICE NO. 2 FLETCHER PUBLIC SCHOOLS
COMANCHE,OFFICE NO. 2 ELGIN PUBLIC SCHOOLS,DUSTIN J. HILLIARY,,160039,0,0,2,2,OFFICE NO. 2 ELGIN PUBLIC SCHOOLS
COMANCHE,OFFICE NO. 2 ELGIN PUBLIC SCHOOLS,RANELL OLIVER,,160039,0,0,0,0,OFFICE NO. 2 ELGIN PUBLIC SCHOOLS
COMANCHE,OFFICE NO. 2 ELGIN PUBLIC SCHOOLS,AARON MOLLOY,,160039,0,0,0,0,OFFICE NO. 2 ELGIN PUBLIC SCHOOLS
COMANCHE,OFFICE NO. 2 FLETCHER PUBLIC SCHOOLS,CHAD FUNKHOUSER,,160039,0,0,26,26,OFFICE NO. 2 FLETCHER PUBLIC SCHOOLS
COMANCHE,OFFICE NO. 2 FLETCHER PUBLIC SCHOOLS,BRYAN SWIETEK,,160039,0,0,9,9,OFFICE NO. 2 FLETCHER PUBLIC SCHOOLS
COMANCHE,OFFICE NO. 2 FLETCHER PUBLIC SCHOOLS,AMBER HENDRIX,,160039,3,1,97,101,OFFICE NO. 2 FLETCHER PUBLIC SCHOOLS
COMANCHE,OFFICE NO. 2 FLETCHER PUBLIC SCHOOLS,CHAD FUNKHOUSER,,160040,0,0,0,0,OFFICE NO. 2 FLETCHER PUBLIC SCHOOLS
COMANCHE,OFFICE NO. 2 FLETCHER PUBLIC SCHOOLS,BRYAN SWIETEK,,160040,0,1,0,1,OFFICE NO. 2 FLETCHER PUBLIC SCHOOLS
COMANCHE,OFFICE NO. 2 FLETCHER PUBLIC SCHOOLS,AMBER HENDRIX,,160040,2,0,10,12,OFFICE NO. 2 FLETCHER PUBLIC SCHOOLS
COMANCHE,OFFICE NO. 2 CACHE PUBLIC SCHOOLS,BRAD SEATON,,160041,2,0,9,11,OFFICE NO. 2 CACHE PUBLIC SCHOOLS
COMANCHE,OFFICE NO. 2 CACHE PUBLIC SCHOOLS,JAMES CARTER,,160041,0,0,4,4,OFFICE NO. 2 CACHE PUBLIC SCHOOLS
COMANCHE,PROPOSITION CITY OF LAWTON,FOR THE PROPOSITION - YES,,160042,0,0,0,0,
COMANCHE,PROPOSITION CITY OF LAWTON,AGAINST THE PROPOSITION - NO,,160042,0,0,0,0,
COMANCHE,OFFICE NO. 2 CACHE PUBLIC SCHOOLS,BRAD SEATON,,160042,9,7,185,201,OFFICE NO. 2 CACHE PUBLIC SCHOOLS
COMANCHE,OFFICE NO. 2 CACHE PUBLIC SCHOOLS,JAMES CARTER,,160042,11,0,76,87,OFFICE NO. 2 CACHE PUBLIC SCHOOLS
COMANCHE,PROPOSITION CITY OF LAWTON,FOR THE PROPOSITION - YES,,160043,0,0,2,2,
COMANCHE,PROPOSITION CITY OF LAWTON,AGAINST THE PROPOSITION - NO,,160043,0,2,8,10,
COMANCHE,PROPOSITION CITY OF LAWTON,FOR THE PROPOSITION - YES,,160045,1,2,3,6,
COMANCHE,PROPOSITION CITY OF LAWTON,AGAINST THE PROPOSITION - NO,,160045,0,1,6,7,
COMANCHE,OFFICE NO. 2 CACHE PUBLIC SCHOOLS,BRAD SEATON,,160045,9,3,50,62,OFFICE NO. 2 CACHE PUBLIC SCHOOLS
COMANCHE,OFFICE NO. 2 CACHE PUBLIC SCHOOLS,JAMES CARTER,,160045,0,0,22,22,OFFICE NO. 2 CACHE PUBLIC SCHOOLS
COMANCHE,OFFICE NO. 2 WALTERS PUBLIC SCHOOLS,SCOTTY REED,,160048,0,0,0,0,OFFICE NO. 2 WALTERS PUBLIC SCHOOLS
COMANCHE,OFFICE NO. 2 WALTERS PUBLIC SCHOOLS,JIM KEESEE,,160048,0,0,0,0,OFFICE NO. 2 WALTERS PUBLIC SCHOOLS
COMANCHE,OFFICE NO. 2 WALTERS PUBLIC SCHOOLS,SCOTTY REED,,160049,0,0,0,0,OFFICE NO. 2 WALTERS PUBLIC SCHOOLS
COMANCHE,OFFICE NO. 2 WALTERS PUBLIC SCHOOLS,JIM KEESEE,,160049,0,0,0,0,OFFICE NO. 2 WALTERS PUBLIC SCHOOLS
COMANCHE,OFFICE NO. 2 EMPIRE PUBLIC SCHOOLS,DEE CARRIO,,160049,0,0,0,0,OFFICE NO. 2 EMPIRE PUBLIC SCHOOLS
COMANCHE,OFFICE NO. 2 EMPIRE PUBLIC SCHOOLS,GALE FLOYD,,160049,0,0,0,0,OFFICE NO. 2 EMPIRE PUBLIC SCHOOLS
COMANCHE,PROPOSITION CITY OF LAWTON,FOR THE PROPOSITION - YES,,160050,18,5,102,125,
COMANCHE,PROPOSITION CITY OF LAWTON,AGAINST THE PROPOSITION - NO,,160050,14,7,65,86,
COMANCHE,PROPOSITION CITY OF LAWTON,FOR THE PROPOSITION - YES,,160051,0,0,0,0,
COMANCHE,PROPOSITION CITY OF LAWTON,AGAINST THE PROPOSITION - NO,,160051,0,0,0,0,
COMANCHE,OFFICE NO. 2 ELGIN PUBLIC SCHOOLS,DUSTIN J. HILLIARY,,160051,2,3,37,42,OFFICE NO. 2 ELGIN PUBLIC SCHOOLS
COMANCHE,OFFICE NO. 2 ELGIN PUBLIC SCHOOLS,RANELL OLIVER,,160051,0,0,21,21,OFFICE NO. 2 ELGIN PUBLIC SCHOOLS
COMANCHE,OFFICE NO. 2 ELGIN PUBLIC SCHOOLS,AARON MOLLOY,,160051,3,3,120,126,OFFICE NO. 2 ELGIN PUBLIC SCHOOLS
COMANCHE,OFFICE NO. 2 ELGIN PUBLIC SCHOOLS,DUSTIN J. HILLIARY,,160053,0,0,0,0,OFFICE NO. 2 ELGIN PUBLIC SCHOOLS
COMANCHE,OFFICE NO. 2 ELGIN PUBLIC SCHOOLS,RANELL OLIVER,,160053,0,0,0,0,OFFICE NO. 2 ELGIN PUBLIC SCHOOLS
COMANCHE,OFFICE NO. 2 ELGIN PUBLIC SCHOOLS,AARON MOLLOY,,160053,0,0,0,0,OFFICE NO. 2 ELGIN PUBLIC SCHOOLS
COTTON,OFFICE NO. 2 WALTERS PUBLIC SCHOOLS,SCOTTY REED,,170001,1,0,3,4,OFFICE NO. 2 WALTERS PUBLIC SCHOOLS
COTTON,OFFICE NO. 2 WALTERS PUBLIC SCHOOLS,JIM KEESEE,,170001,1,0,2,3,OFFICE NO. 2 WALTERS PUBLIC SCHOOLS
COTTON,OFFICE NO. 2 EMPIRE PUBLIC SCHOOLS,DEE CARRIO,,170001,0,0,5,5,OFFICE NO. 2 EMPIRE PUBLIC SCHOOLS
COTTON,OFFICE NO. 2 EMPIRE PUBLIC SCHOOLS,GALE FLOYD,,170001,0,0,0,0,OFFICE NO. 2 EMPIRE PUBLIC SCHOOLS
COTTON,COUNCIL MEMBER AT LARGE CITY OF WALTERS,GERALD LEE HENLEY,,170003,0,0,6,6,
COTTON,COUNCIL MEMBER AT LARGE CITY OF WALTERS,ROBERTA ELLIS,,170003,0,3,30,33,
COTTON,COUNCIL MEMBER AT LARGE CITY OF WALTERS,TIMOTHY LEWIS,,170003,0,1,4,5,
COTTON,OFFICE NO. 2 WALTERS PUBLIC SCHOOLS,SCOTTY REED,,170003,0,6,30,36,OFFICE NO. 2 WALTERS PUBLIC SCHOOLS
COTTON,OFFICE NO. 2 WALTERS PUBLIC SCHOOLS,JIM KEESEE,,170003,1,2,36,39,OFFICE NO. 2 WALTERS PUBLIC SCHOOLS
COTTON,COUNCIL MEMBER AT LARGE CITY OF WALTERS,GERALD LEE HENLEY,,170004,1,2,11,14,
COTTON,COUNCIL MEMBER AT LARGE CITY OF WALTERS,ROBERTA ELLIS,,170004,6,5,50,61,
COTTON,COUNCIL MEMBER AT LARGE CITY OF WALTERS,TIMOTHY LEWIS,,170004,0,4,12,16,
COTTON,OFFICE NO. 2 WALTERS PUBLIC SCHOOLS,SCOTTY REED,,170004,5,4,28,37,OFFICE NO. 2 WALTERS PUBLIC SCHOOLS
COTTON,OFFICE NO. 2 WALTERS PUBLIC SCHOOLS,JIM KEESEE,,170004,2,7,45,54,OFFICE NO. 2 WALTERS PUBLIC SCHOOLS
COTTON,COUNCIL MEMBER AT LARGE CITY OF WALTERS,GERALD LEE HENLEY,,170007,0,0,3,3,
COTTON,COUNCIL MEMBER AT LARGE CITY OF WALTERS,ROBERTA ELLIS,,170007,0,3,48,51,
COTTON,COUNCIL MEMBER AT LARGE CITY OF WALTERS,TIMOTHY LEWIS,,170007,0,1,9,10,
COTTON,OFFICE NO. 2 WALTERS PUBLIC SCHOOLS,SCOTTY REED,,170007,1,1,50,52,OFFICE NO. 2 WALTERS PUBLIC SCHOOLS
COTTON,OFFICE NO. 2 WALTERS PUBLIC SCHOOLS,JIM KEESEE,,170007,0,4,31,35,OFFICE NO. 2 WALTERS PUBLIC SCHOOLS
COTTON,OFFICE NO. 2 WALTERS PUBLIC SCHOOLS,SCOTTY REED,,170008,0,0,0,0,OFFICE NO. 2 WALTERS PUBLIC SCHOOLS
COTTON,OFFICE NO. 2 WALTERS PUBLIC SCHOOLS,JIM KEESEE,,170008,0,0,0,0,OFFICE NO. 2 WALTERS PUBLIC SCHOOLS
COTTON,COUNCIL MEMBER AT LARGE CITY OF WALTERS,GERALD LEE HENLEY,,170009,1,0,6,7,
COTTON,COUNCIL MEMBER AT LARGE CITY OF WALTERS,ROBERTA ELLIS,,170009,0,14,75,89,
COTTON,COUNCIL MEMBER AT LARGE CITY OF WALTERS,TIMOTHY LEWIS,,170009,0,0,8,8,
COTTON,OFFICE NO. 2 WALTERS PUBLIC SCHOOLS,SCOTTY REED,,170009,0,5,53,58,OFFICE NO. 2 WALTERS PUBLIC SCHOOLS
COTTON,OFFICE NO. 2 WALTERS PUBLIC SCHOOLS,JIM KEESEE,,170009,1,9,52,62,OFFICE NO. 2 WALTERS PUBLIC SCHOOLS
CRAIG,OFFICE NO. 2 NORTHEAST TECH CENTER,BILLY F. HENDRICKSON,,180140,1,0,9,10,OFFICE NO. 2 NORTHEAST TECH CENTER
CRAIG,OFFICE NO. 2 NORTHEAST TECH CENTER,SHERMAN WEAVER,,180140,0,0,5,5,OFFICE NO. 2 NORTHEAST TECH CENTER
CRAIG,OFFICE NO. 3 WHITE OAK PUBLIC SCHOOL,GARY MILLS,,180320,0,0,0,0,OFFICE NO. 3 WHITE OAK PUBLIC SCHOOL
CRAIG,OFFICE NO. 3 WHITE OAK PUBLIC SCHOOL,LARRY HAYES,,180320,0,0,0,0,OFFICE NO. 3 WHITE OAK PUBLIC SCHOOL
CRAIG,OFFICE NO. 2 NORTHEAST TECH CENTER,BILLY F. HENDRICKSON,,180320,0,0,6,6,OFFICE NO. 2 NORTHEAST TECH CENTER
CRAIG,OFFICE NO. 2 NORTHEAST TECH CENTER,SHERMAN WEAVER,,180320,0,1,1,2,OFFICE NO. 2 NORTHEAST TECH CENTER
CRAIG,OFFICE NO. 2 NORTHEAST TECH CENTER,BILLY F. HENDRICKSON,,180410,0,0,14,14,OFFICE NO. 2 NORTHEAST TECH CENTER
CRAIG,OFFICE NO. 2 NORTHEAST TECH CENTER,SHERMAN WEAVER,,180410,0,2,17,19,OFFICE NO. 2 NORTHEAST TECH CENTER
CRAIG,OFFICE NO. 3 WHITE OAK PUBLIC SCHOOL,GARY MILLS,,180520,1,0,29,30,OFFICE NO. 3 WHITE OAK PUBLIC SCHOOL
CRAIG,OFFICE NO. 3 WHITE OAK PUBLIC SCHOOL,LARRY HAYES,,180520,1,0,22,23,OFFICE NO. 3 WHITE OAK PUBLIC SCHOOL
CRAIG,OFFICE NO. 2 NORTHEAST TECH CENTER,BILLY F. HENDRICKSON,,180520,1,0,37,38,OFFICE NO. 2 NORTHEAST TECH CENTER
CRAIG,OFFICE NO. 2 NORTHEAST TECH CENTER,SHERMAN WEAVER,,180520,1,0,20,21,OFFICE NO. 2 NORTHEAST TECH CENTER
CRAIG,OFFICE NO. 2 NORTHEAST TECH CENTER,BILLY F. HENDRICKSON,,180611,1,0,9,10,OFFICE NO. 2 NORTHEAST TECH CENTER
CRAIG,OFFICE NO. 2 NORTHEAST TECH CENTER,SHERMAN WEAVER,,180611,0,0,7,7,OFFICE NO. 2 NORTHEAST TECH CENTER
CRAIG,OFFICE NO. 2 NORTHEAST TECH CENTER,BILLY F. HENDRICKSON,,180612,0,0,11,11,OFFICE NO. 2 NORTHEAST TECH CENTER
CRAIG,OFFICE NO. 2 NORTHEAST TECH CENTER,SHERMAN WEAVER,,180612,0,0,3,3,OFFICE NO. 2 NORTHEAST TECH CENTER
CRAIG,OFFICE NO. 3 WHITE OAK PUBLIC SCHOOL,GARY MILLS,,180621,0,0,0,0,OFFICE NO. 3 WHITE OAK PUBLIC SCHOOL
CRAIG,OFFICE NO. 3 WHITE OAK PUBLIC SCHOOL,LARRY HAYES,,180621,0,0,0,0,OFFICE NO. 3 WHITE OAK PUBLIC SCHOOL
CRAIG,OFFICE NO. 2 NORTHEAST TECH CENTER,BILLY F. HENDRICKSON,,180621,3,3,17,23,OFFICE NO. 2 NORTHEAST TECH CENTER
CRAIG,OFFICE NO. 2 NORTHEAST TECH CENTER,SHERMAN WEAVER,,180621,0,0,2,2,OFFICE NO. 2 NORTHEAST TECH CENTER
CRAIG,OFFICE NO. 2 NORTHEAST TECH CENTER,BILLY F. HENDRICKSON,,180622,2,0,11,13,OFFICE NO. 2 NORTHEAST TECH CENTER
CRAIG,OFFICE NO. 2 NORTHEAST TECH CENTER,SHERMAN WEAVER,,180622,0,1,4,5,OFFICE NO. 2 NORTHEAST TECH CENTER
CRAIG,OFFICE NO. 2 NORTHEAST TECH CENTER,BILLY F. HENDRICKSON,,180710,0,0,8,8,OFFICE NO. 2 NORTHEAST TECH CENTER
CRAIG,OFFICE NO. 2 NORTHEAST TECH CENTER,SHERMAN WEAVER,,180710,0,0,3,3,OFFICE NO. 2 NORTHEAST TECH CENTER
CRAIG,OFFICE NO. 3 WHITE OAK PUBLIC SCHOOL,GARY MILLS,,180810,0,0,1,1,OFFICE NO. 3 WHITE OAK PUBLIC SCHOOL
CRAIG,OFFICE NO. 3 WHITE OAK PUBLIC SCHOOL,LARRY HAYES,,180810,2,0,5,7,OFFICE NO. 3 WHITE OAK PUBLIC SCHOOL
CRAIG,OFFICE NO. 2 NORTHEAST TECH CENTER,BILLY F. HENDRICKSON,,180810,2,0,8,10,OFFICE NO. 2 NORTHEAST TECH CENTER
CRAIG,OFFICE NO. 2 NORTHEAST TECH CENTER,SHERMAN WEAVER,,180810,0,0,15,15,OFFICE NO. 2 NORTHEAST TECH CENTER
CRAIG,OFFICE NO. 2 NORTHEAST TECH CENTER,BILLY F. HENDRICKSON,,180820,0,0,7,7,OFFICE NO. 2 NORTHEAST TECH CENTER
CRAIG,OFFICE NO. 2 NORTHEAST TECH CENTER,SHERMAN WEAVER,,180820,0,0,4,4,OFFICE NO. 2 NORTHEAST TECH CENTER
CRAIG,OFFICE NO. 2 NORTHEAST TECH CENTER,BILLY F. HENDRICKSON,,180910,0,0,15,15,OFFICE NO. 2 NORTHEAST TECH CENTER
CRAIG,OFFICE NO. 2 NORTHEAST TECH CENTER,SHERMAN WEAVER,,180910,0,1,2,3,OFFICE NO. 2 NORTHEAST TECH CENTER
CREEK,OFFICE NO. 5 (UNEXPIRED TERM) TULSA TECH CENTER,ROY D. McCLAIN,,190121,0,0,1,1,OFFICE NO. 5 (UNEXPIRED TERM) TULSA TECH CENTER
CREEK,OFFICE NO. 5 (UNEXPIRED TERM) TULSA TECH CENTER,DANNY HANCOCK,,190121,0,0,0,0,OFFICE NO. 5 (UNEXPIRED TERM) TULSA TECH CENTER
CREEK,COUNCILMEMBER WARD 4 CITY OF BRISTOW,MELISSA MERSKI,,190211,0,0,0,0,COUNCILMEMBER WARD 4 CITY OF BRISTOW
CREEK,COUNCILMEMBER WARD 4 CITY OF BRISTOW,JEFF WILLEFORD,,190211,0,0,0,0,COUNCILMEMBER WARD 4 CITY OF BRISTOW
CREEK,COUNCILMEMBER WARD 4 CITY OF BRISTOW,LETHA GRACE CAUDLE,,190211,0,0,0,0,COUNCILMEMBER WARD 4 CITY OF BRISTOW
CREEK,COUNCILMEMBER WARD 4 CITY OF BRISTOW,MELISSA MERSKI,,190231,0,0,0,0,COUNCILMEMBER WARD 4 CITY OF BRISTOW
CREEK,COUNCILMEMBER WARD 4 CITY OF BRISTOW,JEFF WILLEFORD,,190231,0,0,0,0,COUNCILMEMBER WARD 4 CITY OF BRISTOW
CREEK,COUNCILMEMBER WARD 4 CITY OF BRISTOW,LETHA GRACE CAUDLE,,190231,0,0,0,0,COUNCILMEMBER WARD 4 CITY OF BRISTOW
CREEK,COUNCILMEMBER WARD 4 CITY OF BRISTOW,MELISSA MERSKI,,190241,0,0,33,33,COUNCILMEMBER WARD 4 CITY OF BRISTOW
CREEK,COUNCILMEMBER WARD 4 CITY OF BRISTOW,JEFF WILLEFORD,,190241,2,0,49,51,COUNCILMEMBER WARD 4 CITY OF BRISTOW
CREEK,COUNCILMEMBER WARD 4 CITY OF BRISTOW,LETHA GRACE CAUDLE,,190241,0,0,13,13,COUNCILMEMBER WARD 4 CITY OF BRISTOW
CREEK,COMMISSIONER OF WARD 3 CITY OF DRUMRIGHT,JUDY BURRIS,,190311,3,4,81,88,COMMISSIONER OF WARD 3 CITY OF DRUMRIGHT
CREEK,COMMISSIONER OF WARD 3 CITY OF DRUMRIGHT,RICK CREEKMORE,,190311,4,0,41,45,COMMISSIONER OF WARD 3 CITY OF DRUMRIGHT
CREEK,COMMISSIONER AT LARGE CITY OF DRUMRIGHT,JEREMY SNOW,,190311,3,4,81,88,
CREEK,COMMISSIONER AT LARGE CITY OF DRUMRIGHT,WILLIAM SCRIBNER,,190311,4,0,42,46,
CREEK,OFFICE NO. 5 (UNEXPIRED TERM) TULSA TECH CENTER,ROY D. McCLAIN,,190402,0,0,0,0,OFFICE NO. 5 (UNEXPIRED TERM) TULSA TECH CENTER
CREEK,OFFICE NO. 5 (UNEXPIRED TERM) TULSA TECH CENTER,DANNY HANCOCK,,190402,0,0,0,0,OFFICE NO. 5 (UNEXPIRED TERM) TULSA TECH CENTER
CREEK,OFFICE NO. 5 (UNEXPIRED TERM) TULSA TECH CENTER,ROY D. McCLAIN,,190403,0,0,0,0,OFFICE NO. 5 (UNEXPIRED TERM) TULSA TECH CENTER
CREEK,OFFICE NO. 5 (UNEXPIRED TERM) TULSA TECH CENTER,DANNY HANCOCK,,190403,0,0,0,0,OFFICE NO. 5 (UNEXPIRED TERM) TULSA TECH CENTER
CREEK,PROPOSITION CITY OF STROUD,FOR THE PROPOSITION - YES,,190408,0,0,0,0,
CREEK,PROPOSITION CITY OF STROUD,AGAINST THE PROPOSITION - NO,,190408,0,0,0,0,
CREEK,OFFICE NO. 2 DEPEW PUBLIC SCHOOLS,JENNIFER BARENTINE,,190408,0,0,12,12,OFFICE NO. 2 DEPEW PUBLIC SCHOOLS
CREEK,OFFICE NO. 2 DEPEW PUBLIC SCHOOLS,TONY JACKSON,,190408,1,0,43,44,OFFICE NO. 2 DEPEW PUBLIC SCHOOLS
CREEK,PROPOSITION DEPEW PUBLIC SCHOOLS,FOR THE PROPOSITION - YES,,190408,1,0,43,44,
CREEK,PROPOSITION DEPEW PUBLIC SCHOOLS,AGAINST THE PROPOSITION - NO,,190408,0,0,12,12,
CREEK,OFFICE NO. 2 DEPEW PUBLIC SCHOOLS,JENNIFER BARENTINE,,190409,0,0,3,3,OFFICE NO. 2 DEPEW PUBLIC SCHOOLS
CREEK,OFFICE NO. 2 DEPEW PUBLIC SCHOOLS,TONY JACKSON,,190409,0,0,12,12,OFFICE NO. 2 DEPEW PUBLIC SCHOOLS
CREEK,PROPOSITION DEPEW PUBLIC SCHOOLS,FOR THE PROPOSITION - YES,,190409,0,0,9,9,
CREEK,PROPOSITION DEPEW PUBLIC SCHOOLS,AGAINST THE PROPOSITION - NO,,190409,0,0,6,6,
CREEK,OFFICE NO. 2 DEPEW PUBLIC SCHOOLS,JENNIFER BARENTINE,,190410,0,0,28,28,OFFICE NO. 2 DEPEW PUBLIC SCHOOLS
CREEK,OFFICE NO. 2 DEPEW PUBLIC SCHOOLS,TONY JACKSON,,190410,0,0,74,74,OFFICE NO. 2 DEPEW PUBLIC SCHOOLS
CREEK,PROPOSITION DEPEW PUBLIC SCHOOLS,FOR THE PROPOSITION - YES,,190410,0,0,36,36,
CREEK,PROPOSITION DEPEW PUBLIC SCHOOLS,AGAINST THE PROPOSITION - NO,,190410,0,0,69,69,
CREEK,OFFICE NO. 2 GYPSY PUBLIC SCHOOL,TERESA FLATT,,190410,0,0,0,0,OFFICE NO. 2 GYPSY PUBLIC SCHOOL
CREEK,OFFICE NO. 2 GYPSY PUBLIC SCHOOL,DANIEL VANORSDOL,,190410,0,0,0,0,OFFICE NO. 2 GYPSY PUBLIC SCHOOL
CREEK,OFFICE NO. 2 DEPEW PUBLIC SCHOOLS,JENNIFER BARENTINE,,190411,0,2,76,78,OFFICE NO. 2 DEPEW PUBLIC SCHOOLS
CREEK,OFFICE NO. 2 DEPEW PUBLIC SCHOOLS,TONY JACKSON,,190411,0,0,149,149,OFFICE NO. 2 DEPEW PUBLIC SCHOOLS
CREEK,PROPOSITION DEPEW PUBLIC SCHOOLS,FOR THE PROPOSITION - YES,,190411,0,2,165,167,
CREEK,PROPOSITION DEPEW PUBLIC SCHOOLS,AGAINST THE PROPOSITION - NO,,190411,0,0,62,62,
CREEK,OFFICE NO. 2 GYPSY PUBLIC SCHOOL,TERESA FLATT,,190411,0,0,4,4,OFFICE NO. 2 GYPSY PUBLIC SCHOOL
CREEK,OFFICE NO. 2 GYPSY PUBLIC SCHOOL,DANIEL VANORSDOL,,190411,0,0,9,9,OFFICE NO. 2 GYPSY PUBLIC SCHOOL
CREEK,OFFICE NO. 2 DEPEW PUBLIC SCHOOLS,JENNIFER BARENTINE,,190413,0,0,0,0,OFFICE NO. 2 DEPEW PUBLIC SCHOOLS
CREEK,OFFICE NO. 2 DEPEW PUBLIC SCHOOLS,TONY JACKSON,,190413,0,0,1,1,OFFICE NO. 2 DEPEW PUBLIC SCHOOLS
CREEK,PROPOSITION DEPEW PUBLIC SCHOOLS,FOR THE PROPOSITION - YES,,190413,0,0,0,0,
CREEK,PROPOSITION DEPEW PUBLIC SCHOOLS,AGAINST THE PROPOSITION - NO,,190413,0,0,1,1,
CREEK,OFFICE NO. 2 GYPSY PUBLIC SCHOOL,TERESA FLATT,,190413,0,0,4,4,OFFICE NO. 2 GYPSY PUBLIC SCHOOL
CREEK,OFFICE NO. 2 GYPSY PUBLIC SCHOOL,DANIEL VANORSDOL,,190413,0,0,38,38,OFFICE NO. 2 GYPSY PUBLIC SCHOOL
CREEK,OFFICE NO. 5 (UNEXPIRED TERM) TULSA TECH CENTER,ROY D. McCLAIN,,190419,0,0,0,0,OFFICE NO. 5 (UNEXPIRED TERM) TULSA TECH CENTER
CREEK,OFFICE NO. 5 (UNEXPIRED TERM) TULSA TECH CENTER,DANNY HANCOCK,,190419,0,0,1,1,OFFICE NO. 5 (UNEXPIRED TERM) TULSA TECH CENTER
CREEK,PROPOSITION NO. 1 JENKS PUBLIC SCHOOLS,FOR THE PROPOSITION - YES,,190420,3,0,22,25,PROPOSITION NO. 1 JENKS PUBLIC SCHOOLS
CREEK,PROPOSITION NO. 1 JENKS PUBLIC SCHOOLS,AGAINST THE PROPOSITION - NO,,190420,0,0,6,6,PROPOSITION NO. 1 JENKS PUBLIC SCHOOLS
CREEK,PROPOSITION NO. 2 JENKS PUBLIC SCHOOLS,FOR THE PROPOSITION - YES,,190420,3,0,22,25,PROPOSITION NO. 2 JENKS PUBLIC SCHOOLS
CREEK,PROPOSITION NO. 2 JENKS PUBLIC SCHOOLS,AGAINST THE PROPOSITION - NO,,190420,0,0,6,6,PROPOSITION NO. 2 JENKS PUBLIC SCHOOLS
CREEK,PROPOSITION NO. 1 JENKS PUBLIC SCHOOLS,FOR THE PROPOSITION - YES,,190421,0,0,1,1,PROPOSITION NO. 1 JENKS PUBLIC SCHOOLS
CREEK,PROPOSITION NO. 1 JENKS PUBLIC SCHOOLS,AGAINST THE PROPOSITION - NO,,190421,0,0,0,0,PROPOSITION NO. 1 JENKS PUBLIC SCHOOLS
CREEK,PROPOSITION NO. 2 JENKS PUBLIC SCHOOLS,FOR THE PROPOSITION - YES,,190421,0,0,1,1,PROPOSITION NO. 2 JENKS PUBLIC SCHOOLS
CREEK,PROPOSITION NO. 2 JENKS PUBLIC SCHOOLS,AGAINST THE PROPOSITION - NO,,190421,0,0,0,0,PROPOSITION NO. 2 JENKS PUBLIC SCHOOLS
CREEK,OFFICE NO. 5 (UNEXPIRED TERM) TULSA TECH CENTER,ROY D. McCLAIN,,190421,0,0,0,0,OFFICE NO. 5 (UNEXPIRED TERM) TULSA TECH CENTER
CREEK,OFFICE NO. 5 (UNEXPIRED TERM) TULSA TECH CENTER,DANNY HANCOCK,,190421,0,0,0,0,OFFICE NO. 5 (UNEXPIRED TERM) TULSA TECH CENTER
CUSTER,COUNTY QUESTION,FOR THE PROPOSITION - YES,,200001,5,6,101,112,
CUSTER,COUNTY QUESTION,AGAINST THE PROPOSITION - NO,,200001,0,1,21,22,
CUSTER,OFFICE NO. 2 CLINTON PUBLIC SCHOOLS,KIMBERLY L. MEACHAM,,200001,4,4,61,69,OFFICE NO. 2 CLINTON PUBLIC SCHOOLS
CUSTER,OFFICE NO. 2 CLINTON PUBLIC SCHOOLS,KEVIN WOLTERS,,200001,1,3,60,64,OFFICE NO. 2 CLINTON PUBLIC SCHOOLS
CUSTER,OFFICE NO. 2 WESTERN TECH CENTER,GARY D. SMITH,,200001,4,4,94,102,OFFICE NO. 2 WESTERN TECH CENTER
CUSTER,OFFICE NO. 2 WESTERN TECH CENTER,BILL JOHANNING,,200001,1,1,18,20,OFFICE NO. 2 WESTERN TECH CENTER
CUSTER,COUNTY QUESTION,FOR THE PROPOSITION - YES,,200003,4,13,236,253,
CUSTER,COUNTY QUESTION,AGAINST THE PROPOSITION - NO,,200003,1,7,68,76,
CUSTER,OFFICE NO. 2 CLINTON PUBLIC SCHOOLS,KIMBERLY L. MEACHAM,,200003,2,8,151,161,OFFICE NO. 2 CLINTON PUBLIC SCHOOLS
CUSTER,OFFICE NO. 2 CLINTON PUBLIC SCHOOLS,KEVIN WOLTERS,,200003,3,12,154,169,OFFICE NO. 2 CLINTON PUBLIC SCHOOLS
CUSTER,OFFICE NO. 2 WESTERN TECH CENTER,GARY D. SMITH,,200003,4,14,234,252,OFFICE NO. 2 WESTERN TECH CENTER
CUSTER,OFFICE NO. 2 WESTERN TECH CENTER,BILL JOHANNING,,200003,0,4,47,51,OFFICE NO. 2 WESTERN TECH CENTER
CUSTER,COUNTY QUESTION,FOR THE PROPOSITION - YES,,200005,11,20,239,270,
CUSTER,COUNTY QUESTION,AGAINST THE PROPOSITION - NO,,200005,4,6,57,67,
CUSTER,OFFICE NO. 2 ARAPAHO-BUTLER PUBLIC SCHOOLS,CALEB MOORE,,200005,0,0,0,0,OFFICE NO. 2 ARAPAHO-BUTLER PUBLIC SCHOOLS
CUSTER,OFFICE NO. 2 ARAPAHO-BUTLER PUBLIC SCHOOLS,DEREK MATZ,,200005,0,0,0,0,OFFICE NO. 2 ARAPAHO-BUTLER PUBLIC SCHOOLS
CUSTER,OFFICE NO. 2 ARAPAHO-BUTLER PUBLIC SCHOOLS,CLAY KAUK,,200005,0,0,0,0,OFFICE NO. 2 ARAPAHO-BUTLER PUBLIC SCHOOLS
CUSTER,OFFICE NO. 2 CLINTON PUBLIC SCHOOLS,KIMBERLY L. MEACHAM,,200005,6,14,161,181,OFFICE NO. 2 CLINTON PUBLIC SCHOOLS
CUSTER,OFFICE NO. 2 CLINTON PUBLIC SCHOOLS,KEVIN WOLTERS,,200005,8,12,135,155,OFFICE NO. 2 CLINTON PUBLIC SCHOOLS
CUSTER,OFFICE NO. 2 WESTERN TECH CENTER,GARY D. SMITH,,200005,8,24,244,276,OFFICE NO. 2 WESTERN TECH CENTER
CUSTER,OFFICE NO. 2 WESTERN TECH CENTER,BILL JOHANNING,,200005,4,1,36,41,OFFICE NO. 2 WESTERN TECH CENTER
CUSTER,COUNTY QUESTION,FOR THE PROPOSITION - YES,,200007,9,3,93,105,
CUSTER,COUNTY QUESTION,AGAINST THE PROPOSITION - NO,,200007,2,2,21,25,
CUSTER,OFFICE NO. 2 ARAPAHO-BUTLER PUBLIC SCHOOLS,CALEB MOORE,,200007,0,0,1,1,OFFICE NO. 2 ARAPAHO-BUTLER PUBLIC SCHOOLS
CUSTER,OFFICE NO. 2 ARAPAHO-BUTLER PUBLIC SCHOOLS,DEREK MATZ,,200007,0,1,2,3,OFFICE NO. 2 ARAPAHO-BUTLER PUBLIC SCHOOLS
CUSTER,OFFICE NO. 2 ARAPAHO-BUTLER PUBLIC SCHOOLS,CLAY KAUK,,200007,0,0,0,0,OFFICE NO. 2 ARAPAHO-BUTLER PUBLIC SCHOOLS
CUSTER,OFFICE NO. 2 CLINTON PUBLIC SCHOOLS,KIMBERLY L. MEACHAM,,200007,6,2,77,85,OFFICE NO. 2 CLINTON PUBLIC SCHOOLS
CUSTER,OFFICE NO. 2 CLINTON PUBLIC SCHOOLS,KEVIN WOLTERS,,200007,5,3,32,40,OFFICE NO. 2 CLINTON PUBLIC SCHOOLS
CUSTER,OFFICE NO. 2 WEATHERFORD PUBLIC SCHOOLS,BROCK W. McSPERITT,,200007,0,0,0,0,OFFICE NO. 2 WEATHERFORD PUBLIC SCHOOLS
CUSTER,OFFICE NO. 2 WEATHERFORD PUBLIC SCHOOLS,BRYAN BAYLESS,,200007,0,0,0,0,OFFICE NO. 2 WEATHERFORD PUBLIC SCHOOLS
CUSTER,OFFICE NO. 2 WESTERN TECH CENTER,GARY D. SMITH,,200007,6,3,94,103,OFFICE NO. 2 WESTERN TECH CENTER
CUSTER,OFFICE NO. 2 WESTERN TECH CENTER,BILL JOHANNING,,200007,1,1,10,12,OFFICE NO. 2 WESTERN TECH CENTER
CUSTER,COUNTY QUESTION,FOR THE PROPOSITION - YES,,200012,4,13,173,190,
CUSTER,COUNTY QUESTION,AGAINST THE PROPOSITION - NO,,200012,2,3,29,34,
CUSTER,OFFICE NO. 2 ARAPAHO-BUTLER PUBLIC SCHOOLS,CALEB MOORE,,200012,1,1,22,24,OFFICE NO. 2 ARAPAHO-BUTLER PUBLIC SCHOOLS
CUSTER,OFFICE NO. 2 ARAPAHO-BUTLER PUBLIC SCHOOLS,DEREK MATZ,,200012,0,8,102,110,OFFICE NO. 2 ARAPAHO-BUTLER PUBLIC SCHOOLS
CUSTER,OFFICE NO. 2 ARAPAHO-BUTLER PUBLIC SCHOOLS,CLAY KAUK,,200012,3,3,68,74,OFFICE NO. 2 ARAPAHO-BUTLER PUBLIC SCHOOLS
CUSTER,OFFICE NO. 2 CLINTON PUBLIC SCHOOLS,KIMBERLY L. MEACHAM,,200012,0,2,3,5,OFFICE NO. 2 CLINTON PUBLIC SCHOOLS
CUSTER,OFFICE NO. 2 CLINTON PUBLIC SCHOOLS,KEVIN WOLTERS,,200012,0,1,0,1,OFFICE NO. 2 CLINTON PUBLIC SCHOOLS
CUSTER,OFFICE NO. 2 WEATHERFORD PUBLIC SCHOOLS,BROCK W. McSPERITT,,200012,0,0,0,0,OFFICE NO. 2 WEATHERFORD PUBLIC SCHOOLS
CUSTER,OFFICE NO. 2 WEATHERFORD PUBLIC SCHOOLS,BRYAN BAYLESS,,200012,2,0,0,2,OFFICE NO. 2 WEATHERFORD PUBLIC SCHOOLS
CUSTER,OFFICE NO. 2 WESTERN TECH CENTER,GARY D. SMITH,,200012,5,10,161,176,OFFICE NO. 2 WESTERN TECH CENTER
CUSTER,OFFICE NO. 2 WESTERN TECH CENTER,BILL JOHANNING,,200012,1,4,27,32,OFFICE NO. 2 WESTERN TECH CENTER
CUSTER,COUNTY QUESTION,FOR THE PROPOSITION - YES,,200013,1,3,66,70,
CUSTER,COUNTY QUESTION,AGAINST THE PROPOSITION - NO,,200013,0,0,14,14,
CUSTER,OFFICE NO. 2 ARAPAHO-BUTLER PUBLIC SCHOOLS,CALEB MOORE,,200013,0,0,1,1,OFFICE NO. 2 ARAPAHO-BUTLER PUBLIC SCHOOLS
CUSTER,OFFICE NO. 2 ARAPAHO-BUTLER PUBLIC SCHOOLS,DEREK MATZ,,200013,0,0,2,2,OFFICE NO. 2 ARAPAHO-BUTLER PUBLIC SCHOOLS
CUSTER,OFFICE NO. 2 ARAPAHO-BUTLER PUBLIC SCHOOLS,CLAY KAUK,,200013,0,2,1,3,OFFICE NO. 2 ARAPAHO-BUTLER PUBLIC SCHOOLS
CUSTER,OFFICE NO. 2 WESTERN TECH CENTER,GARY D. SMITH,,200013,0,2,3,5,OFFICE NO. 2 WESTERN TECH CENTER
CUSTER,OFFICE NO. 2 WESTERN TECH CENTER,BILL JOHANNING,,200013,0,0,0,0,OFFICE NO. 2 WESTERN TECH CENTER
CUSTER,COUNTY QUESTION,FOR THE PROPOSITION - YES,,200018,11,0,126,137,
CUSTER,COUNTY QUESTION,AGAINST THE PROPOSITION - NO,,200018,2,1,62,65,
CUSTER,OFFICE NO. 2 WEATHERFORD PUBLIC SCHOOLS,BROCK W. McSPERITT,,200018,6,0,54,60,OFFICE NO. 2 WEATHERFORD PUBLIC SCHOOLS
CUSTER,OFFICE NO. 2 WEATHERFORD PUBLIC SCHOOLS,BRYAN BAYLESS,,200018,5,1,130,136,OFFICE NO. 2 WEATHERFORD PUBLIC SCHOOLS
CUSTER,OFFICE NO. 2 WESTERN TECH CENTER,GARY D. SMITH,,200018,6,1,131,138,OFFICE NO. 2 WESTERN TECH CENTER
CUSTER,OFFICE NO. 2 WESTERN TECH CENTER,BILL JOHANNING,,200018,5,0,54,59,OFFICE NO. 2 WESTERN TECH CENTER
CUSTER,COUNTY QUESTION,FOR THE PROPOSITION - YES,,200019,11,1,138,150,
CUSTER,COUNTY QUESTION,AGAINST THE PROPOSITION - NO,,200019,9,1,57,67,
CUSTER,OFFICE NO. 2 WEATHERFORD PUBLIC SCHOOLS,BROCK W. McSPERITT,,200019,8,2,69,79,OFFICE NO. 2 WEATHERFORD PUBLIC SCHOOLS
CUSTER,OFFICE NO. 2 WEATHERFORD PUBLIC SCHOOLS,BRYAN BAYLESS,,200019,11,0,121,132,OFFICE NO. 2 WEATHERFORD PUBLIC SCHOOLS
CUSTER,OFFICE NO. 2 WESTERN TECH CENTER,GARY D. SMITH,,200019,16,2,123,141,OFFICE NO. 2 WESTERN TECH CENTER
CUSTER,OFFICE NO. 2 WESTERN TECH CENTER,BILL JOHANNING,,200019,6,0,67,73,OFFICE NO. 2 WESTERN TECH CENTER
CUSTER,COUNTY QUESTION,FOR THE PROPOSITION - YES,,200020,6,0,159,165,
CUSTER,COUNTY QUESTION,AGAINST THE PROPOSITION - NO,,200020,6,0,105,111,
CUSTER,OFFICE NO. 2 WEATHERFORD PUBLIC SCHOOLS,BROCK W. McSPERITT,,200020,7,0,76,83,OFFICE NO. 2 WEATHERFORD PUBLIC SCHOOLS
CUSTER,OFFICE NO. 2 WEATHERFORD PUBLIC SCHOOLS,BRYAN BAYLESS,,200020,6,0,182,188,OFFICE NO. 2 WEATHERFORD PUBLIC SCHOOLS
CUSTER,OFFICE NO. 2 WESTERN TECH CENTER,GARY D. SMITH,,200020,7,0,185,192,OFFICE NO. 2 WESTERN TECH CENTER
CUSTER,OFFICE NO. 2 WESTERN TECH CENTER,BILL JOHANNING,,200020,6,0,67,73,OFFICE NO. 2 WESTERN TECH CENTER
CUSTER,COUNTY QUESTION,FOR THE PROPOSITION - YES,,200021,5,0,54,59,
CUSTER,COUNTY QUESTION,AGAINST THE PROPOSITION - NO,,200021,3,0,29,32,
CUSTER,OFFICE NO. 2 WEATHERFORD PUBLIC SCHOOLS,BROCK W. McSPERITT,,200021,1,0,31,32,OFFICE NO. 2 WEATHERFORD PUBLIC SCHOOLS
CUSTER,OFFICE NO. 2 WEATHERFORD PUBLIC SCHOOLS,BRYAN BAYLESS,,200021,7,0,52,59,OFFICE NO. 2 WEATHERFORD PUBLIC SCHOOLS
CUSTER,OFFICE NO. 2 WESTERN TECH CENTER,GARY D. SMITH,,200021,5,0,58,63,OFFICE NO. 2 WESTERN TECH CENTER
CUSTER,OFFICE NO. 2 WESTERN TECH CENTER,BILL JOHANNING,,200021,3,0,22,25,OFFICE NO. 2 WESTERN TECH CENTER
CUSTER,COUNTY QUESTION,FOR THE PROPOSITION - YES,,200022,0,1,37,38,
CUSTER,COUNTY QUESTION,AGAINST THE PROPOSITION - NO,,200022,1,2,18,21,
CUSTER,OFFICE NO. 2 WEATHERFORD PUBLIC SCHOOLS,BROCK W. McSPERITT,,200022,0,0,23,23,OFFICE NO. 2 WEATHERFORD PUBLIC SCHOOLS
CUSTER,OFFICE NO. 2 WEATHERFORD PUBLIC SCHOOLS,BRYAN BAYLESS,,200022,0,1,30,31,OFFICE NO. 2 WEATHERFORD PUBLIC SCHOOLS
CUSTER,OFFICE NO. 2 WESTERN TECH CENTER,GARY D. SMITH,,200022,0,0,40,40,OFFICE NO. 2 WESTERN TECH CENTER
CUSTER,OFFICE NO. 2 WESTERN TECH CENTER,BILL JOHANNING,,200022,0,1,13,14,OFFICE NO. 2 WESTERN TECH CENTER
CUSTER,COUNTY QUESTION,FOR THE PROPOSITION - YES,,200023,5,0,70,75,
CUSTER,COUNTY QUESTION,AGAINST THE PROPOSITION - NO,,200023,1,0,13,14,
CUSTER,COUNTY QUESTION,FOR THE PROPOSITION - YES,,200026,4,3,95,102,
CUSTER,COUNTY QUESTION,AGAINST THE PROPOSITION - NO,,200026,2,0,24,26,
CUSTER,OFFICE NO. 2 ARAPAHO-BUTLER PUBLIC SCHOOLS,CALEB MOORE,,200026,0,1,11,12,OFFICE NO. 2 ARAPAHO-BUTLER PUBLIC SCHOOLS
CUSTER,OFFICE NO. 2 ARAPAHO-BUTLER PUBLIC SCHOOLS,DEREK MATZ,,200026,0,1,28,29,OFFICE NO. 2 ARAPAHO-BUTLER PUBLIC SCHOOLS
CUSTER,OFFICE NO. 2 ARAPAHO-BUTLER PUBLIC SCHOOLS,CLAY KAUK,,200026,2,0,47,49,OFFICE NO. 2 ARAPAHO-BUTLER PUBLIC SCHOOLS
CUSTER,OFFICE NO. 2 CLINTON PUBLIC SCHOOLS,KIMBERLY L. MEACHAM,,200026,0,0,2,2,OFFICE NO. 2 CLINTON PUBLIC SCHOOLS
CUSTER,OFFICE NO. 2 CLINTON PUBLIC SCHOOLS,KEVIN WOLTERS,,200026,0,0,0,0,OFFICE NO. 2 CLINTON PUBLIC SCHOOLS
CUSTER,OFFICE NO. 2 HAMMON PUBLIC SCHOOLS,VIC McCALLAY,,200026,2,0,18,20,OFFICE NO. 2 HAMMON PUBLIC SCHOOLS
CUSTER,OFFICE NO. 2 HAMMON PUBLIC SCHOOLS,RECTOR CANDY,,200026,0,0,5,5,OFFICE NO. 2 HAMMON PUBLIC SCHOOLS
CUSTER,OFFICE NO. 2 WESTERN TECH CENTER,GARY D. SMITH,,200026,4,2,92,98,OFFICE NO. 2 WESTERN TECH CENTER
CUSTER,OFFICE NO. 2 WESTERN TECH CENTER,BILL JOHANNING,,200026,0,1,15,16,OFFICE NO. 2 WESTERN TECH CENTER
DELAWARE,OFFICE NO. 2 NORTHEAST TECH CENTER,BILLY F. HENDRICKSON,,210001,1,0,7,8,OFFICE NO. 2 NORTHEAST TECH CENTER
DELAWARE,OFFICE NO. 2 NORTHEAST TECH CENTER,SHERMAN WEAVER,,210001,1,0,2,3,OFFICE NO. 2 NORTHEAST TECH CENTER
DELAWARE,OFFICE NO. 2 NORTHEAST TECH CENTER,BILLY F. HENDRICKSON,,210002,0,0,4,4,OFFICE NO. 2 NORTHEAST TECH CENTER
DELAWARE,OFFICE NO. 2 NORTHEAST TECH CENTER,SHERMAN WEAVER,,210002,1,0,14,15,OFFICE NO. 2 NORTHEAST TECH CENTER
DELAWARE,OFFICE NO. 2 NORTHEAST TECH CENTER,BILLY F. HENDRICKSON,,210003,2,0,8,10,OFFICE NO. 2 NORTHEAST TECH CENTER
DELAWARE,OFFICE NO. 2 NORTHEAST TECH CENTER,SHERMAN WEAVER,,210003,1,0,4,5,OFFICE NO. 2 NORTHEAST TECH CENTER
DELAWARE,OFFICE NO. 2 NORTHEAST TECH CENTER,BILLY F. HENDRICKSON,,210004,0,0,11,11,OFFICE NO. 2 NORTHEAST TECH CENTER
DELAWARE,OFFICE NO. 2 NORTHEAST TECH CENTER,SHERMAN WEAVER,,210004,0,0,10,10,OFFICE NO. 2 NORTHEAST TECH CENTER
DELAWARE,OFFICE NO. 2 NORTHEAST TECH CENTER,BILLY F. HENDRICKSON,,210005,3,0,3,6,OFFICE NO. 2 NORTHEAST TECH CENTER
DELAWARE,OFFICE NO. 2 NORTHEAST TECH CENTER,SHERMAN WEAVER,,210005,2,0,9,11,OFFICE NO. 2 NORTHEAST TECH CENTER
DELAWARE,OFFICE NO. 2 NORTHEAST TECH CENTER,BILLY F. HENDRICKSON,,210006,0,0,2,2,OFFICE NO. 2 NORTHEAST TECH CENTER
DELAWARE,OFFICE NO. 2 NORTHEAST TECH CENTER,SHERMAN WEAVER,,210006,0,0,8,8,OFFICE NO. 2 NORTHEAST TECH CENTER
DELAWARE,OFFICE NO. 2 NORTHEAST TECH CENTER,BILLY F. HENDRICKSON,,210007,3,0,4,7,OFFICE NO. 2 NORTHEAST TECH CENTER
DELAWARE,OFFICE NO. 2 NORTHEAST TECH CENTER,SHERMAN WEAVER,,210007,9,1,1,11,OFFICE NO. 2 NORTHEAST TECH CENTER
DELAWARE,OFFICE NO. 2 JAY PUBLIC SCHOOLS,BILL HOBBS,,210008,0,2,0,2,OFFICE NO. 2 JAY PUBLIC SCHOOLS
DELAWARE,OFFICE NO. 2 JAY PUBLIC SCHOOLS,ASHLEY WILLIAMSON,,210008,0,1,1,2,OFFICE NO. 2 JAY PUBLIC SCHOOLS
DELAWARE,OFFICE NO. 2 NORTHEAST TECH CENTER,BILLY F. HENDRICKSON,,210008,0,1,4,5,OFFICE NO. 2 NORTHEAST TECH CENTER
DELAWARE,OFFICE NO. 2 NORTHEAST TECH CENTER,SHERMAN WEAVER,,210008,1,2,6,9,OFFICE NO. 2 NORTHEAST TECH CENTER
DELAWARE,OFFICE NO. 2 NORTHEAST TECH CENTER,BILLY F. HENDRICKSON,,210009,5,0,5,10,OFFICE NO. 2 NORTHEAST TECH CENTER
DELAWARE,OFFICE NO. 2 NORTHEAST TECH CENTER,SHERMAN WEAVER,,210009,5,1,5,11,OFFICE NO. 2 NORTHEAST TECH CENTER
DELAWARE,OFFICE NO. 2 JAY PUBLIC SCHOOLS,BILL HOBBS,,210010,0,2,0,2,OFFICE NO. 2 JAY PUBLIC SCHOOLS
DELAWARE,OFFICE NO. 2 JAY PUBLIC SCHOOLS,ASHLEY WILLIAMSON,,210010,0,0,5,5,OFFICE NO. 2 JAY PUBLIC SCHOOLS
DELAWARE,OFFICE NO. 2 NORTHEAST TECH CENTER,BILLY F. HENDRICKSON,,210010,0,1,3,4,OFFICE NO. 2 NORTHEAST TECH CENTER
DELAWARE,OFFICE NO. 2 NORTHEAST TECH CENTER,SHERMAN WEAVER,,210010,2,0,2,4,OFFICE NO. 2 NORTHEAST TECH CENTER
DELAWARE,OFFICE NO. 2 NORTHEAST TECH CENTER,BILLY F. HENDRICKSON,,210011,2,0,3,5,OFFICE NO. 2 NORTHEAST TECH CENTER
DELAWARE,OFFICE NO. 2 NORTHEAST TECH CENTER,SHERMAN WEAVER,,210011,2,0,3,5,OFFICE NO. 2 NORTHEAST TECH CENTER
DELAWARE,OFFICE NO. 2 JAY PUBLIC SCHOOLS,BILL HOBBS,,210012,0,0,5,5,OFFICE NO. 2 JAY PUBLIC SCHOOLS
DELAWARE,OFFICE NO. 2 JAY PUBLIC SCHOOLS,ASHLEY WILLIAMSON,,210012,0,0,2,2,OFFICE NO. 2 JAY PUBLIC SCHOOLS
DELAWARE,OFFICE NO. 2 NORTHEAST TECH CENTER,BILLY F. HENDRICKSON,,210012,1,0,14,15,OFFICE NO. 2 NORTHEAST TECH CENTER
DELAWARE,OFFICE NO. 2 NORTHEAST TECH CENTER,SHERMAN WEAVER,,210012,0,0,7,7,OFFICE NO. 2 NORTHEAST TECH CENTER
DELAWARE,OFFICE NO. 2 JAY PUBLIC SCHOOLS,BILL HOBBS,,210014,5,6,53,64,OFFICE NO. 2 JAY PUBLIC SCHOOLS
DELAWARE,OFFICE NO. 2 JAY PUBLIC SCHOOLS,ASHLEY WILLIAMSON,,210014,2,7,55,64,OFFICE NO. 2 JAY PUBLIC SCHOOLS
DELAWARE,OFFICE NO. 2 NORTHEAST TECH CENTER,BILLY F. HENDRICKSON,,210014,2,4,53,59,OFFICE NO. 2 NORTHEAST TECH CENTER
DELAWARE,OFFICE NO. 2 NORTHEAST TECH CENTER,SHERMAN WEAVER,,210014,4,6,52,62,OFFICE NO. 2 NORTHEAST TECH CENTER
DELAWARE,OFFICE NO. 2 JAY PUBLIC SCHOOLS,BILL HOBBS,,210015,4,1,21,26,OFFICE NO. 2 JAY PUBLIC SCHOOLS
DELAWARE,OFFICE NO. 2 JAY PUBLIC SCHOOLS,ASHLEY WILLIAMSON,,210015,3,3,20,26,OFFICE NO. 2 JAY PUBLIC SCHOOLS
DELAWARE,OFFICE NO. 2 NORTHEAST TECH CENTER,BILLY F. HENDRICKSON,,210015,5,0,23,28,OFFICE NO. 2 NORTHEAST TECH CENTER
DELAWARE,OFFICE NO. 2 NORTHEAST TECH CENTER,SHERMAN WEAVER,,210015,1,2,18,21,OFFICE NO. 2 NORTHEAST TECH CENTER
DELAWARE,OFFICE NO. 2 JAY PUBLIC SCHOOLS,BILL HOBBS,,210016,3,3,36,42,OFFICE NO. 2 JAY PUBLIC SCHOOLS
DELAWARE,OFFICE NO. 2 JAY PUBLIC SCHOOLS,ASHLEY WILLIAMSON,,210016,2,3,33,38,OFFICE NO. 2 JAY PUBLIC SCHOOLS
DELAWARE,OFFICE NO. 2 NORTHEAST TECH CENTER,BILLY F. HENDRICKSON,,210016,5,4,40,49,OFFICE NO. 2 NORTHEAST TECH CENTER
DELAWARE,OFFICE NO. 2 NORTHEAST TECH CENTER,SHERMAN WEAVER,,210016,1,1,27,29,OFFICE NO. 2 NORTHEAST TECH CENTER
DELAWARE,OFFICE NO. 2 JAY PUBLIC SCHOOLS,BILL HOBBS,,210017,5,2,26,33,OFFICE NO. 2 JAY PUBLIC SCHOOLS
DELAWARE,OFFICE NO. 2 JAY PUBLIC SCHOOLS,ASHLEY WILLIAMSON,,210017,1,6,26,33,OFFICE NO. 2 JAY PUBLIC SCHOOLS
DELAWARE,OFFICE NO. 2 NORTHEAST TECH CENTER,BILLY F. HENDRICKSON,,210017,3,3,29,35,OFFICE NO. 2 NORTHEAST TECH CENTER
DELAWARE,OFFICE NO. 2 NORTHEAST TECH CENTER,SHERMAN WEAVER,,210017,2,3,21,26,OFFICE NO. 2 NORTHEAST TECH CENTER
DELAWARE,OFFICE NO. 2 COLCORD PUBLIC SCHOOLS,DAVID RAMSEY,,210018,0,0,0,0,OFFICE NO. 2 COLCORD PUBLIC SCHOOLS
DELAWARE,OFFICE NO. 2 COLCORD PUBLIC SCHOOLS,BENJAMIN KING,,210018,0,0,0,0,OFFICE NO. 2 COLCORD PUBLIC SCHOOLS
DELAWARE,OFFICE NO. 2 JAY PUBLIC SCHOOLS,BILL HOBBS,,210018,4,6,7,17,OFFICE NO. 2 JAY PUBLIC SCHOOLS
DELAWARE,OFFICE NO. 2 JAY PUBLIC SCHOOLS,ASHLEY WILLIAMSON,,210018,1,7,26,34,OFFICE NO. 2 JAY PUBLIC SCHOOLS
DELAWARE,OFFICE NO. 2 NORTHEAST TECH CENTER,BILLY F. HENDRICKSON,,210018,2,3,14,19,OFFICE NO. 2 NORTHEAST TECH CENTER
DELAWARE,OFFICE NO. 2 NORTHEAST TECH CENTER,SHERMAN WEAVER,,210018,2,10,16,28,OFFICE NO. 2 NORTHEAST TECH CENTER
DELAWARE,OFFICE NO. 2 COLCORD PUBLIC SCHOOLS,DAVID RAMSEY,,210019,1,1,99,101,OFFICE NO. 2 COLCORD PUBLIC SCHOOLS
DELAWARE,OFFICE NO. 2 COLCORD PUBLIC SCHOOLS,BENJAMIN KING,,210019,2,2,97,101,OFFICE NO. 2 COLCORD PUBLIC SCHOOLS
DELAWARE,OFFICE NO. 2 JAY PUBLIC SCHOOLS,BILL HOBBS,,210019,0,0,2,2,OFFICE NO. 2 JAY PUBLIC SCHOOLS
DELAWARE,OFFICE NO. 2 JAY PUBLIC SCHOOLS,ASHLEY WILLIAMSON,,210019,0,0,0,0,OFFICE NO. 2 JAY PUBLIC SCHOOLS
DELAWARE,OFFICE NO. 2 NORTHEAST TECH CENTER,BILLY F. HENDRICKSON,,210019,2,1,90,93,OFFICE NO. 2 NORTHEAST TECH CENTER
DELAWARE,OFFICE NO. 2 NORTHEAST TECH CENTER,SHERMAN WEAVER,,210019,1,1,91,93,OFFICE NO. 2 NORTHEAST TECH CENTER
DELAWARE,OFFICE NO. 2 JAY PUBLIC SCHOOLS,BILL HOBBS,,210020,0,0,0,0,OFFICE NO. 2 JAY PUBLIC SCHOOLS
DELAWARE,OFFICE NO. 2 JAY PUBLIC SCHOOLS,ASHLEY WILLIAMSON,,210020,0,0,1,1,OFFICE NO. 2 JAY PUBLIC SCHOOLS
DELAWARE,OFFICE NO. 2 NORTHEAST TECH CENTER,BILLY F. HENDRICKSON,,210020,0,0,2,2,OFFICE NO. 2 NORTHEAST TECH CENTER
DELAWARE,OFFICE NO. 2 NORTHEAST TECH CENTER,SHERMAN WEAVER,,210020,0,0,3,3,OFFICE NO. 2 NORTHEAST TECH CENTER
DELAWARE,OFFICE NO. 2 OAKS-MISSION PUBLIC SCHOOLS,MELVIN D BLOSSOM JR,,210021,0,0,0,0,OFFICE NO. 2 OAKS-MISSION PUBLIC SCHOOLS
DELAWARE,OFFICE NO. 2 OAKS-MISSION PUBLIC SCHOOLS,TONIA FIELDS TREJO,,210021,0,0,0,0,OFFICE NO. 2 OAKS-MISSION PUBLIC SCHOOLS
DELAWARE,OFFICE NO. 2 NORTHEAST TECH CENTER,BILLY F. HENDRICKSON,,210021,0,0,4,4,OFFICE NO. 2 NORTHEAST TECH CENTER
DELAWARE,OFFICE NO. 2 NORTHEAST TECH CENTER,SHERMAN WEAVER,,210021,0,0,6,6,OFFICE NO. 2 NORTHEAST TECH CENTER
DELAWARE,OFFICE NO. 2 OAKS-MISSION PUBLIC SCHOOLS,MELVIN D BLOSSOM JR,,210022,0,0,5,5,OFFICE NO. 2 OAKS-MISSION PUBLIC SCHOOLS
DELAWARE,OFFICE NO. 2 OAKS-MISSION PUBLIC SCHOOLS,TONIA FIELDS TREJO,,210022,1,0,12,13,OFFICE NO. 2 OAKS-MISSION PUBLIC SCHOOLS
DELAWARE,OFFICE NO. 2 NORTHEAST TECH CENTER,BILLY F. HENDRICKSON,,210022,1,0,12,13,OFFICE NO. 2 NORTHEAST TECH CENTER
DELAWARE,OFFICE NO. 2 NORTHEAST TECH CENTER,SHERMAN WEAVER,,210022,2,0,17,19,OFFICE NO. 2 NORTHEAST TECH CENTER
DELAWARE,OFFICE NO. 2 COLCORD PUBLIC SCHOOLS,DAVID RAMSEY,,210023,0,0,11,11,OFFICE NO. 2 COLCORD PUBLIC SCHOOLS
DELAWARE,OFFICE NO. 2 COLCORD PUBLIC SCHOOLS,BENJAMIN KING,,210023,2,0,7,9,OFFICE NO. 2 COLCORD PUBLIC SCHOOLS
DELAWARE,OFFICE NO. 2 MOSELEY PUBLIC SCHOOL,AMANDA KAUFFELD,,210023,0,0,9,9,OFFICE NO. 2 MOSELEY PUBLIC SCHOOL
DELAWARE,OFFICE NO. 2 MOSELEY PUBLIC SCHOOL,LAURA POTEET,,210023,1,0,11,12,OFFICE NO. 2 MOSELEY PUBLIC SCHOOL
DELAWARE,OFFICE NO. 2 NORTHEAST TECH CENTER,BILLY F. HENDRICKSON,,210023,0,0,22,22,OFFICE NO. 2 NORTHEAST TECH CENTER
DELAWARE,OFFICE NO. 2 NORTHEAST TECH CENTER,SHERMAN WEAVER,,210023,3,0,15,18,OFFICE NO. 2 NORTHEAST TECH CENTER
DEWEY,OFFICE NO. 2 TALOGA PUBLIC SCHOOLS,RUTH ANN BARRON,,220001,0,7,58,65,OFFICE NO. 2 TALOGA PUBLIC SCHOOLS
DEWEY,OFFICE NO. 2 TALOGA PUBLIC SCHOOLS,RANDY KIENZLE,,220001,1,0,81,82,OFFICE NO. 2 TALOGA PUBLIC SCHOOLS
DEWEY,OFFICE NO. 2 TALOGA PUBLIC SCHOOLS,RUTH ANN BARRON,,220002,0,0,7,7,OFFICE NO. 2 TALOGA PUBLIC SCHOOLS
DEWEY,OFFICE NO. 2 TALOGA PUBLIC SCHOOLS,RANDY KIENZLE,,220002,0,2,8,10,OFFICE NO. 2 TALOGA PUBLIC SCHOOLS
DEWEY,OFFICE NO. 2 TALOGA PUBLIC SCHOOLS,RUTH ANN BARRON,,220004,1,0,0,1,OFFICE NO. 2 TALOGA PUBLIC SCHOOLS
DEWEY,OFFICE NO. 2 TALOGA PUBLIC SCHOOLS,RANDY KIENZLE,,220004,0,0,0,0,OFFICE NO. 2 TALOGA PUBLIC SCHOOLS
DEWEY,OFFICE NO. 2 TALOGA PUBLIC SCHOOLS,RUTH ANN BARRON,,220005,0,4,2,6,OFFICE NO. 2 TALOGA PUBLIC SCHOOLS
DEWEY,OFFICE NO. 2 TALOGA PUBLIC SCHOOLS,RANDY KIENZLE,,220005,0,0,0,0,OFFICE NO. 2 TALOGA PUBLIC SCHOOLS
DEWEY,OFFICE NO. 2 CANTON PUBLIC SCHOOLS,MATT SWARTWOOD,,220008,1,0,2,3,OFFICE NO. 2 CANTON PUBLIC SCHOOLS
DEWEY,OFFICE NO. 2 CANTON PUBLIC SCHOOLS,MIKE NIX,,220008,0,0,1,1,OFFICE NO. 2 CANTON PUBLIC SCHOOLS
DEWEY,OFFICE NO. 2 CANTON PUBLIC SCHOOLS,MATT SWARTWOOD,,220009,2,0,0,2,OFFICE NO. 2 CANTON PUBLIC SCHOOLS
DEWEY,OFFICE NO. 2 CANTON PUBLIC SCHOOLS,MIKE NIX,,220009,0,0,0,0,OFFICE NO. 2 CANTON PUBLIC SCHOOLS
DEWEY,OFFICE NO. 2 TALOGA PUBLIC SCHOOLS,RUTH ANN BARRON,,220009,0,0,5,5,OFFICE NO. 2 TALOGA PUBLIC SCHOOLS
DEWEY,OFFICE NO. 2 TALOGA PUBLIC SCHOOLS,RANDY KIENZLE,,220009,0,0,31,31,OFFICE NO. 2 TALOGA PUBLIC SCHOOLS
DEWEY,OFFICE NO. 2 TALOGA PUBLIC SCHOOLS,RUTH ANN BARRON,,220010,0,0,0,0,OFFICE NO. 2 TALOGA PUBLIC SCHOOLS
DEWEY,OFFICE NO. 2 TALOGA PUBLIC SCHOOLS,RANDY KIENZLE,,220010,0,0,0,0,OFFICE NO. 2 TALOGA PUBLIC SCHOOLS
ELLIS,OFFICE NO. 2 LAVERNE PUBLIC SCHOOLS,GABE HOPE,,230006,0,0,2,2,OFFICE NO. 2 LAVERNE PUBLIC SCHOOLS
ELLIS,OFFICE NO. 2 LAVERNE PUBLIC SCHOOLS,JIMMY DIXON,,230006,0,0,0,0,OFFICE NO. 2 LAVERNE PUBLIC SCHOOLS
ELLIS,OFFICE NO. 2 LAVERNE PUBLIC SCHOOLS,GABE HOPE,,230007,0,0,0,0,OFFICE NO. 2 LAVERNE PUBLIC SCHOOLS
ELLIS,OFFICE NO. 2 LAVERNE PUBLIC SCHOOLS,JIMMY DIXON,,230007,0,0,0,0,OFFICE NO. 2 LAVERNE PUBLIC SCHOOLS
GARFIELD,COMMISSIONER WARD 4 CITY OF ENID,JONATHAN WADDELL,,240103,2,0,23,25,COMMISSIONER WARD 4 CITY OF ENID
GARFIELD,COMMISSIONER WARD 4 CITY OF ENID,RODNEY TIMM,,240103,0,1,8,9,COMMISSIONER WARD 4 CITY OF ENID
GARFIELD,COMMISSIONER WARD 4 CITY OF ENID,JONATHAN WADDELL,,240203,1,0,6,7,COMMISSIONER WARD 4 CITY OF ENID
GARFIELD,COMMISSIONER WARD 4 CITY OF ENID,RODNEY TIMM,,240203,0,0,5,5,COMMISSIONER WARD 4 CITY OF ENID
GARFIELD,COMMISSIONER WARD 4 CITY OF ENID,JONATHAN WADDELL,,240206,2,0,32,34,COMMISSIONER WARD 4 CITY OF ENID
GARFIELD,COMMISSIONER WARD 4 CITY OF ENID,RODNEY TIMM,,240206,0,0,29,29,COMMISSIONER WARD 4 CITY OF ENID
GARFIELD,COMMISSIONER WARD 4 CITY OF ENID,JONATHAN WADDELL,,240207,1,0,11,12,COMMISSIONER WARD 4 CITY OF ENID
GARFIELD,COMMISSIONER WARD 4 CITY OF ENID,RODNEY TIMM,,240207,2,0,8,10,COMMISSIONER WARD 4 CITY OF ENID
GARFIELD,COMMISSIONER WARD 6 CITY OF ENID,DAVID VANHOOSER,,240208,0,0,0,0,COMMISSIONER WARD 6 CITY OF ENID
GARFIELD,COMMISSIONER WARD 6 CITY OF ENID,GEORGE C. PANKONIN,,240208,0,0,0,0,COMMISSIONER WARD 6 CITY OF ENID
GARFIELD,OFFICE NO. 2 KREMLIN-HILLSDALE SCHOOLS,JAN SNAPP,,240208,0,0,14,14,OFFICE NO. 2 KREMLIN-HILLSDALE SCHOOLS
GARFIELD,OFFICE NO. 2 KREMLIN-HILLSDALE SCHOOLS,MICHEAL ANTHONY DULINSKY,,240208,0,0,5,5,OFFICE NO. 2 KREMLIN-HILLSDALE SCHOOLS
GARFIELD,OFFICE NO. 2 POND CREEK-HUNTER SCHOOLS,R J PARRISH,,240210,0,0,0,0,OFFICE NO. 2 POND CREEK-HUNTER SCHOOLS
GARFIELD,OFFICE NO. 2 POND CREEK-HUNTER SCHOOLS,MICAH BARR,,240210,0,0,0,0,OFFICE NO. 2 POND CREEK-HUNTER SCHOOLS
GARFIELD,OFFICE NO. 2 KREMLIN-HILLSDALE SCHOOLS,JAN SNAPP,,240211,2,0,62,64,OFFICE NO. 2 KREMLIN-HILLSDALE SCHOOLS
GARFIELD,OFFICE NO. 2 KREMLIN-HILLSDALE SCHOOLS,MICHEAL ANTHONY DULINSKY,,240211,2,0,22,24,OFFICE NO. 2 KREMLIN-HILLSDALE SCHOOLS
GARFIELD,COMMISSIONER WARD 4 CITY OF ENID,JONATHAN WADDELL,,240212,0,0,5,5,COMMISSIONER WARD 4 CITY OF ENID
GARFIELD,COMMISSIONER WARD 4 CITY OF ENID,RODNEY TIMM,,240212,0,0,10,10,COMMISSIONER WARD 4 CITY OF ENID
GARFIELD,OFFICE NO. 2 POND CREEK-HUNTER SCHOOLS,R J PARRISH,,240212,5,0,0,5,OFFICE NO. 2 POND CREEK-HUNTER SCHOOLS
GARFIELD,OFFICE NO. 2 POND CREEK-HUNTER SCHOOLS,MICAH BARR,,240212,2,0,5,7,OFFICE NO. 2 POND CREEK-HUNTER SCHOOLS
GARFIELD,COMMISSIONER WARD 6 CITY OF ENID,DAVID VANHOOSER,,240304,9,3,28,40,COMMISSIONER WARD 6 CITY OF ENID
GARFIELD,COMMISSIONER WARD 6 CITY OF ENID,GEORGE C. PANKONIN,,240304,13,3,178,194,COMMISSIONER WARD 6 CITY OF ENID
GARFIELD,COMMISSIONER WARD 6 CITY OF ENID,DAVID VANHOOSER,,240305,10,0,41,51,COMMISSIONER WARD 6 CITY OF ENID
GARFIELD,COMMISSIONER WARD 6 CITY OF ENID,GEORGE C. PANKONIN,,240305,11,11,175,197,COMMISSIONER WARD 6 CITY OF ENID
GARFIELD,COMMISSIONER WARD 4 CITY OF ENID,JONATHAN WADDELL,,240306,0,0,0,0,COMMISSIONER WARD 4 CITY OF ENID
GARFIELD,COMMISSIONER WARD 4 CITY OF ENID,RODNEY TIMM,,240306,0,0,1,1,COMMISSIONER WARD 4 CITY OF ENID
GARFIELD,COMMISSIONER WARD 6 CITY OF ENID,DAVID VANHOOSER,,240306,4,0,16,20,COMMISSIONER WARD 6 CITY OF ENID
GARFIELD,COMMISSIONER WARD 6 CITY OF ENID,GEORGE C. PANKONIN,,240306,1,3,49,53,COMMISSIONER WARD 6 CITY OF ENID
GARFIELD,OFFICE NO. 2 KREMLIN-HILLSDALE SCHOOLS,JAN SNAPP,,240306,0,0,0,0,OFFICE NO. 2 KREMLIN-HILLSDALE SCHOOLS
GARFIELD,OFFICE NO. 2 KREMLIN-HILLSDALE SCHOOLS,MICHEAL ANTHONY DULINSKY,,240306,0,0,0,0,OFFICE NO. 2 KREMLIN-HILLSDALE SCHOOLS
GARFIELD,COMMISSIONER WARD 6 CITY OF ENID,DAVID VANHOOSER,,240307,8,0,8,16,COMMISSIONER WARD 6 CITY OF ENID
GARFIELD,COMMISSIONER WARD 6 CITY OF ENID,GEORGE C. PANKONIN,,240307,5,0,14,19,COMMISSIONER WARD 6 CITY OF ENID
GARFIELD,OFFICE NO. 2 KREMLIN-HILLSDALE SCHOOLS,JAN SNAPP,,240307,0,0,2,2,OFFICE NO. 2 KREMLIN-HILLSDALE SCHOOLS
GARFIELD,OFFICE NO. 2 KREMLIN-HILLSDALE SCHOOLS,MICHEAL ANTHONY DULINSKY,,240307,0,0,0,0,OFFICE NO. 2 KREMLIN-HILLSDALE SCHOOLS
GARFIELD,COMMISSIONER WARD 6 CITY OF ENID,DAVID VANHOOSER,,240308,13,0,4,17,COMMISSIONER WARD 6 CITY OF ENID
GARFIELD,COMMISSIONER WARD 6 CITY OF ENID,GEORGE C. PANKONIN,,240308,6,3,10,19,COMMISSIONER WARD 6 CITY OF ENID
GARFIELD,OFFICE NO. 2 TIMBERLAKE PUBLIC SCHOOLS,QUENTIN STURGEON,,240308,0,0,0,0,OFFICE NO. 2 TIMBERLAKE PUBLIC SCHOOLS
GARFIELD,OFFICE NO. 2 TIMBERLAKE PUBLIC SCHOOLS,JAY JENLINK,,240308,0,0,0,0,OFFICE NO. 2 TIMBERLAKE PUBLIC SCHOOLS
GARFIELD,OFFICE NO. 2 TIMBERLAKE PUBLIC SCHOOLS,CHRIS CLIFT,,240308,0,0,0,0,OFFICE NO. 2 TIMBERLAKE PUBLIC SCHOOLS
GARFIELD,OFFICE NO. 2 KREMLIN-HILLSDALE SCHOOLS,JAN SNAPP,,240308,0,0,3,3,OFFICE NO. 2 KREMLIN-HILLSDALE SCHOOLS
GARFIELD,OFFICE NO. 2 KREMLIN-HILLSDALE SCHOOLS,MICHEAL ANTHONY DULINSKY,,240308,0,0,0,0,OFFICE NO. 2 KREMLIN-HILLSDALE SCHOOLS
GARFIELD,PROPOSITION NO. 1 CIMARRON PUBLIC SCHOOLS,FOR THE PROPOSITION - YES,,240309,1,0,72,73,PROPOSITION NO. 1 CIMARRON PUBLIC SCHOOLS
GARFIELD,PROPOSITION NO. 1 CIMARRON PUBLIC SCHOOLS,AGAINST THE PROPOSITION - NO,,240309,3,0,26,29,PROPOSITION NO. 1 CIMARRON PUBLIC SCHOOLS
GARFIELD,PROPOSITION NO. 2 CIMARRON PUBLIC SCHOOLS,FOR THE PROPOSITION - YES,,240309,0,0,71,71,PROPOSITION NO. 2 CIMARRON PUBLIC SCHOOLS
GARFIELD,PROPOSITION NO. 2 CIMARRON PUBLIC SCHOOLS,AGAINST THE PROPOSITION - NO,,240309,4,0,27,31,PROPOSITION NO. 2 CIMARRON PUBLIC SCHOOLS
GARFIELD,PROPOSITION NO. 1 CIMARRON PUBLIC SCHOOLS,FOR THE PROPOSITION - YES,,240310,0,0,0,0,PROPOSITION NO. 1 CIMARRON PUBLIC SCHOOLS
GARFIELD,PROPOSITION NO. 1 CIMARRON PUBLIC SCHOOLS,AGAINST THE PROPOSITION - NO,,240310,0,0,0,0,PROPOSITION NO. 1 CIMARRON PUBLIC SCHOOLS
GARFIELD,PROPOSITION NO. 2 CIMARRON PUBLIC SCHOOLS,FOR THE PROPOSITION - YES,,240310,0,0,0,0,PROPOSITION NO. 2 CIMARRON PUBLIC SCHOOLS
GARFIELD,PROPOSITION NO. 2 CIMARRON PUBLIC SCHOOLS,AGAINST THE PROPOSITION - NO,,240310,0,0,0,0,PROPOSITION NO. 2 CIMARRON PUBLIC SCHOOLS
GARVIN,OFFICE NO. 2 LINDSAY PUBLIC SCHOOLS,CLINT SIMONTON,,250001,2,0,62,64,OFFICE NO. 2 LINDSAY PUBLIC SCHOOLS
GARVIN,OFFICE NO. 2 LINDSAY PUBLIC SCHOOLS,ROBERT D. JONES,,250001,1,0,18,19,OFFICE NO. 2 LINDSAY PUBLIC SCHOOLS
GARVIN,OFFICE NO. 2 LINDSAY PUBLIC SCHOOLS,CLINT SIMONTON,,250002,2,0,51,53,OFFICE NO. 2 LINDSAY PUBLIC SCHOOLS
GARVIN,OFFICE NO. 2 LINDSAY PUBLIC SCHOOLS,ROBERT D. JONES,,250002,0,0,16,16,OFFICE NO. 2 LINDSAY PUBLIC SCHOOLS
GARVIN,OFFICE NO. 2 LINDSAY PUBLIC SCHOOLS,CLINT SIMONTON,,250003,3,0,60,63,OFFICE NO. 2 LINDSAY PUBLIC SCHOOLS
GARVIN,OFFICE NO. 2 LINDSAY PUBLIC SCHOOLS,ROBERT D. JONES,,250003,0,0,24,24,OFFICE NO. 2 LINDSAY PUBLIC SCHOOLS
GARVIN,OFFICE NO. 2 BRAY-DOYLE PUBLIC SCHOOLS,WAYNE TURNER,,250003,0,0,0,0,OFFICE NO. 2 BRAY-DOYLE PUBLIC SCHOOLS
GARVIN,OFFICE NO. 2 BRAY-DOYLE PUBLIC SCHOOLS,ERIC DORMAN,,250003,0,0,0,0,OFFICE NO. 2 BRAY-DOYLE PUBLIC SCHOOLS
GARVIN,OFFICE NO. 2 LINDSAY PUBLIC SCHOOLS,CLINT SIMONTON,,250005,0,0,4,4,OFFICE NO. 2 LINDSAY PUBLIC SCHOOLS
GARVIN,OFFICE NO. 2 LINDSAY PUBLIC SCHOOLS,ROBERT D. JONES,,250005,0,0,0,0,OFFICE NO. 2 LINDSAY PUBLIC SCHOOLS
GARVIN,OFFICE NO. 2 WHITEBEAD PUBLIC SCHOOL,RICKY D. MANNING,,250007,0,6,13,19,OFFICE NO. 2 WHITEBEAD PUBLIC SCHOOL
GARVIN,OFFICE NO. 2 WHITEBEAD PUBLIC SCHOOL,EVERETT PLUMMER,,250007,2,7,56,65,OFFICE NO. 2 WHITEBEAD PUBLIC SCHOOL
GARVIN,OFFICE NO. 2 WHITEBEAD PUBLIC SCHOOL,RICKY D. MANNING,,250008,0,1,12,13,OFFICE NO. 2 WHITEBEAD PUBLIC SCHOOL
GARVIN,OFFICE NO. 2 WHITEBEAD PUBLIC SCHOOL,EVERETT PLUMMER,,250008,1,5,27,33,OFFICE NO. 2 WHITEBEAD PUBLIC SCHOOL
GARVIN,OFFICE NO. 2 BRAY-DOYLE PUBLIC SCHOOLS,WAYNE TURNER,,250009,0,0,0,0,OFFICE NO. 2 BRAY-DOYLE PUBLIC SCHOOLS
GARVIN,OFFICE NO. 2 BRAY-DOYLE PUBLIC SCHOOLS,ERIC DORMAN,,250009,0,0,0,0,OFFICE NO. 2 BRAY-DOYLE PUBLIC SCHOOLS
GRADY,OFFICE NO. 2 LINDSAY PUBLIC SCHOOLS,CLINT SIMONTON,,260016,0,0,0,0,OFFICE NO. 2 LINDSAY PUBLIC SCHOOLS
GRADY,OFFICE NO. 2 LINDSAY PUBLIC SCHOOLS,ROBERT D. JONES,,260016,0,0,0,0,OFFICE NO. 2 LINDSAY PUBLIC SCHOOLS
GRADY,OFFICE NO. 2 VERDEN PUBLIC SCHOOLS,CHAD THARP,,260017,0,1,25,26,OFFICE NO. 2 VERDEN PUBLIC SCHOOLS
GRADY,OFFICE NO. 2 VERDEN PUBLIC SCHOOLS,MICHAEL PERRAULT,,260017,0,0,12,12,OFFICE NO. 2 VERDEN PUBLIC SCHOOLS
GRADY,PROPOSITION VERDEN PUBLIC SCHOOLS,FOR THE PROPOSITION - YES,,260017,0,0,30,30,
GRADY,PROPOSITION VERDEN PUBLIC SCHOOLS,AGAINST THE PROPOSITION - NO,,260017,0,1,5,6,
GRADY,OFFICE NO. 2 LINDSAY PUBLIC SCHOOLS,CLINT SIMONTON,,260026,0,0,2,2,OFFICE NO. 2 LINDSAY PUBLIC SCHOOLS
GRADY,OFFICE NO. 2 LINDSAY PUBLIC SCHOOLS,ROBERT D. JONES,,260026,0,0,2,2,OFFICE NO. 2 LINDSAY PUBLIC SCHOOLS
GRADY,OFFICE NO. 2 BRAY-DOYLE PUBLIC SCHOOLS,WAYNE TURNER,,260026,2,0,7,9,OFFICE NO. 2 BRAY-DOYLE PUBLIC SCHOOLS
GRADY,OFFICE NO. 2 BRAY-DOYLE PUBLIC SCHOOLS,ERIC DORMAN,,260026,1,1,7,9,OFFICE NO. 2 BRAY-DOYLE PUBLIC SCHOOLS
GRADY,OFFICE NO. 2 VERDEN PUBLIC SCHOOLS,CHAD THARP,,260027,0,0,0,0,OFFICE NO. 2 VERDEN PUBLIC SCHOOLS
GRADY,OFFICE NO. 2 VERDEN PUBLIC SCHOOLS,MICHAEL PERRAULT,,260027,0,0,0,0,OFFICE NO. 2 VERDEN PUBLIC SCHOOLS
GRADY,PROPOSITION VERDEN PUBLIC SCHOOLS,FOR THE PROPOSITION - YES,,260027,0,0,0,0,
GRADY,PROPOSITION VERDEN PUBLIC SCHOOLS,AGAINST THE PROPOSITION - NO,,260027,0,0,0,0,
GRADY,OFFICE NO. 2 BLANCHARD PUBLIC SCHOOLS,LIZ GEORGE,,260028,1,0,9,10,OFFICE NO. 2 BLANCHARD PUBLIC SCHOOLS
GRADY,OFFICE NO. 2 BLANCHARD PUBLIC SCHOOLS,MITCH FITZGERALD,,260028,1,0,2,3,OFFICE NO. 2 BLANCHARD PUBLIC SCHOOLS
GRADY,OFFICE NO. 2 DIBBLE PUBLIC SCHOOLS,CLAYTON LEE,,260028,0,0,0,0,OFFICE NO. 2 DIBBLE PUBLIC SCHOOLS
GRADY,OFFICE NO. 2 DIBBLE PUBLIC SCHOOLS,RICHARD CORLEY,,260028,0,0,3,3,OFFICE NO. 2 DIBBLE PUBLIC SCHOOLS
GRADY,OFFICE NO. 2 VERDEN PUBLIC SCHOOLS,CHAD THARP,,260029,0,0,0,0,OFFICE NO. 2 VERDEN PUBLIC SCHOOLS
GRADY,OFFICE NO. 2 VERDEN PUBLIC SCHOOLS,MICHAEL PERRAULT,,260029,0,0,0,0,OFFICE NO. 2 VERDEN PUBLIC SCHOOLS
GRADY,PROPOSITION VERDEN PUBLIC SCHOOLS,FOR THE PROPOSITION - YES,,260029,0,0,0,0,
GRADY,PROPOSITION VERDEN PUBLIC SCHOOLS,AGAINST THE PROPOSITION - NO,,260029,0,0,0,0,
GRADY,OFFICE NO. 2 DIBBLE PUBLIC SCHOOLS,CLAYTON LEE,,260031,0,0,3,3,OFFICE NO. 2 DIBBLE PUBLIC SCHOOLS
GRADY,OFFICE NO. 2 DIBBLE PUBLIC SCHOOLS,RICHARD CORLEY,,260031,0,0,7,7,OFFICE NO. 2 DIBBLE PUBLIC SCHOOLS
GRADY,OFFICE NO. 2 VERDEN PUBLIC SCHOOLS,CHAD THARP,,260035,0,0,0,0,OFFICE NO. 2 VERDEN PUBLIC SCHOOLS
GRADY,OFFICE NO. 2 VERDEN PUBLIC SCHOOLS,MICHAEL PERRAULT,,260035,0,0,0,0,OFFICE NO. 2 VERDEN PUBLIC SCHOOLS
GRADY,PROPOSITION VERDEN PUBLIC SCHOOLS,FOR THE PROPOSITION - YES,,260035,0,0,0,0,
GRADY,PROPOSITION VERDEN PUBLIC SCHOOLS,AGAINST THE PROPOSITION - NO,,260035,0,0,0,0,
GRADY,OFFICE NO. 2 FLETCHER PUBLIC SCHOOLS,CHAD FUNKHOUSER,,260036,0,0,0,0,OFFICE NO. 2 FLETCHER PUBLIC SCHOOLS
GRADY,OFFICE NO. 2 FLETCHER PUBLIC SCHOOLS,BRYAN SWIETEK,,260036,0,0,0,0,OFFICE NO. 2 FLETCHER PUBLIC SCHOOLS
GRADY,OFFICE NO. 2 FLETCHER PUBLIC SCHOOLS,AMBER HENDRIX,,260036,0,0,0,0,OFFICE NO. 2 FLETCHER PUBLIC SCHOOLS
GRADY,OFFICE NO. 2 NEWCASTLE PUBLIC SCHOOLS,ROBERT FULTON,,260037,0,0,0,0,OFFICE NO. 2 NEWCASTLE PUBLIC SCHOOLS
GRADY,OFFICE NO. 2 NEWCASTLE PUBLIC SCHOOLS,VALORY DALTON,,260037,1,0,4,5,OFFICE NO. 2 NEWCASTLE PUBLIC SCHOOLS
GRADY,OFFICE NO. 2 BLANCHARD PUBLIC SCHOOLS,LIZ GEORGE,,260039,2,0,35,37,OFFICE NO. 2 BLANCHARD PUBLIC SCHOOLS
GRADY,OFFICE NO. 2 BLANCHARD PUBLIC SCHOOLS,MITCH FITZGERALD,,260039,3,0,14,17,OFFICE NO. 2 BLANCHARD PUBLIC SCHOOLS
GRADY,OFFICE NO. 2 NEWCASTLE PUBLIC SCHOOLS,ROBERT FULTON,,260041,1,0,0,1,OFFICE NO. 2 NEWCASTLE PUBLIC SCHOOLS
GRADY,OFFICE NO. 2 NEWCASTLE PUBLIC SCHOOLS,VALORY DALTON,,260041,1,0,3,4,OFFICE NO. 2 NEWCASTLE PUBLIC SCHOOLS
GRANT,OFFICE NO. 2 TIMBERLAKE PUBLIC SCHOOLS,QUENTIN STURGEON,,270017,0,0,1,1,OFFICE NO. 2 TIMBERLAKE PUBLIC SCHOOLS
GRANT,OFFICE NO. 2 TIMBERLAKE PUBLIC SCHOOLS,JAY JENLINK,,270017,0,0,59,59,OFFICE NO. 2 TIMBERLAKE PUBLIC SCHOOLS
GRANT,OFFICE NO. 2 TIMBERLAKE PUBLIC SCHOOLS,CHRIS CLIFT,,270017,0,0,0,0,OFFICE NO. 2 TIMBERLAKE PUBLIC SCHOOLS
GRANT,OFFICE NO. 2 KREMLIN-HILLSDALE SCHOOLS,JAN SNAPP,,270017,0,0,0,0,OFFICE NO. 2 KREMLIN-HILLSDALE SCHOOLS
GRANT,OFFICE NO. 2 KREMLIN-HILLSDALE SCHOOLS,MICHEAL ANTHONY DULINSKY,,270017,0,0,0,0,OFFICE NO. 2 KREMLIN-HILLSDALE SCHOOLS
GRANT,OFFICE NO. 2 POND CREEK-HUNTER SCHOOLS,R J PARRISH,,270017,0,0,0,0,OFFICE NO. 2 POND CREEK-HUNTER SCHOOLS
GRANT,OFFICE NO. 2 POND CREEK-HUNTER SCHOOLS,MICAH BARR,,270017,3,0,0,3,OFFICE NO. 2 POND CREEK-HUNTER SCHOOLS
GRANT,OFFICE NO. 2 POND CREEK-HUNTER SCHOOLS,R J PARRISH,,270023,1,3,23,27,OFFICE NO. 2 POND CREEK-HUNTER SCHOOLS
GRANT,OFFICE NO. 2 POND CREEK-HUNTER SCHOOLS,MICAH BARR,,270023,3,3,90,96,OFFICE NO. 2 POND CREEK-HUNTER SCHOOLS
GRANT,OFFICE NO. 2 TIMBERLAKE PUBLIC SCHOOLS,QUENTIN STURGEON,,270025,0,0,0,0,OFFICE NO. 2 TIMBERLAKE PUBLIC SCHOOLS
GRANT,OFFICE NO. 2 TIMBERLAKE PUBLIC SCHOOLS,JAY JENLINK,,270025,0,0,0,0,OFFICE NO. 2 TIMBERLAKE PUBLIC SCHOOLS
GRANT,OFFICE NO. 2 TIMBERLAKE PUBLIC SCHOOLS,CHRIS CLIFT,,270025,0,0,0,0,OFFICE NO. 2 TIMBERLAKE PUBLIC SCHOOLS
GRANT,OFFICE NO. 2 POND CREEK-HUNTER SCHOOLS,R J PARRISH,,270026,0,3,0,3,OFFICE NO. 2 POND CREEK-HUNTER SCHOOLS
GRANT,OFFICE NO. 2 POND CREEK-HUNTER SCHOOLS,MICAH BARR,,270026,0,0,0,0,OFFICE NO. 2 POND CREEK-HUNTER SCHOOLS
GRANT,OFFICE NO. 2 POND CREEK-HUNTER SCHOOLS,R J PARRISH,,270029,0,0,0,0,OFFICE NO. 2 POND CREEK-HUNTER SCHOOLS
GRANT,OFFICE NO. 2 POND CREEK-HUNTER SCHOOLS,MICAH BARR,,270029,0,0,0,0,OFFICE NO. 2 POND CREEK-HUNTER SCHOOLS
GREER,OFFICE NO. 2 DUKE PUBLIC SCHOOLS,RAFE HALL,,280105,0,1,0,1,OFFICE NO. 2 DUKE PUBLIC SCHOOLS
GREER,OFFICE NO. 2 DUKE PUBLIC SCHOOLS,TERRI LEDBETTER PEARSON,,280105,0,0,0,0,OFFICE NO. 2 DUKE PUBLIC SCHOOLS
GREER,OFFICE NO. 2 BLAIR PUBLIC SCHOOLS,SHANE CHAPMAN,,280106,0,0,0,0,OFFICE NO. 2 BLAIR PUBLIC SCHOOLS
GREER,OFFICE NO. 2 BLAIR PUBLIC SCHOOLS,BRANDI BOLEY,,280106,0,0,0,0,OFFICE NO. 2 BLAIR PUBLIC SCHOOLS
GREER,OFFICE NO. 4 (UNEXPIRED TERM) BLAIR PUBLIC SCHOOLS,MARIANNE J. NAGY,,280106,0,0,0,0,OFFICE NO. 4 (UNEXPIRED TERM) BLAIR PUBLIC SCHOOLS
GREER,OFFICE NO. 4 (UNEXPIRED TERM) BLAIR PUBLIC SCHOOLS,JEREMY RODRIQUEZ,,280106,0,0,0,0,OFFICE NO. 4 (UNEXPIRED TERM) BLAIR PUBLIC SCHOOLS
GREER,OFFICE NO. 2 DUKE PUBLIC SCHOOLS,RAFE HALL,,280106,0,0,0,0,OFFICE NO. 2 DUKE PUBLIC SCHOOLS
GREER,OFFICE NO. 2 DUKE PUBLIC SCHOOLS,TERRI LEDBETTER PEARSON,,280106,0,0,0,0,OFFICE NO. 2 DUKE PUBLIC SCHOOLS
GREER,PROPOSITION BLAIR PUBLIC SCHOOLS,FOR THE PROPOSITION - YES,,280106,0,0,0,0,
GREER,PROPOSITION BLAIR PUBLIC SCHOOLS,AGAINST THE PROPOSITION - NO,,280106,0,0,0,0,
GREER,OFFICE NO. 2 BLAIR PUBLIC SCHOOLS,SHANE CHAPMAN,,280202,0,0,4,4,OFFICE NO. 2 BLAIR PUBLIC SCHOOLS
GREER,OFFICE NO. 2 BLAIR PUBLIC SCHOOLS,BRANDI BOLEY,,280202,0,0,0,0,OFFICE NO. 2 BLAIR PUBLIC SCHOOLS
GREER,OFFICE NO. 4 (UNEXPIRED TERM) BLAIR PUBLIC SCHOOLS,MARIANNE J. NAGY,,280202,0,0,0,0,OFFICE NO. 4 (UNEXPIRED TERM) BLAIR PUBLIC SCHOOLS
GREER,OFFICE NO. 4 (UNEXPIRED TERM) BLAIR PUBLIC SCHOOLS,JEREMY RODRIQUEZ,,280202,0,0,4,4,OFFICE NO. 4 (UNEXPIRED TERM) BLAIR PUBLIC SCHOOLS
GREER,PROPOSITION BLAIR PUBLIC SCHOOLS,FOR THE PROPOSITION - YES,,280202,0,0,1,1,
GREER,PROPOSITION BLAIR PUBLIC SCHOOLS,AGAINST THE PROPOSITION - NO,,280202,0,0,3,3,
GREER,OFFICE NO. 2 WESTERN TECH CENTER,GARY D. SMITH,,280202,0,0,0,0,OFFICE NO. 2 WESTERN TECH CENTER
GREER,OFFICE NO. 2 WESTERN TECH CENTER,BILL JOHANNING,,280202,0,0,0,0,OFFICE NO. 2 WESTERN TECH CENTER
GREER,OFFICE NO. 2 SAYRE PUBLIC SCHOOLS,MATT THORNBROUGH,,280203,0,0,0,0,OFFICE NO. 2 SAYRE PUBLIC SCHOOLS
GREER,OFFICE NO. 2 SAYRE PUBLIC SCHOOLS,BRIAN CHAPMAN,,280203,0,0,0,0,OFFICE NO. 2 SAYRE PUBLIC SCHOOLS
GREER,OFFICE NO. 2 WESTERN TECH CENTER,GARY D. SMITH,,280203,0,0,0,0,OFFICE NO. 2 WESTERN TECH CENTER
GREER,OFFICE NO. 2 WESTERN TECH CENTER,BILL JOHANNING,,280203,0,0,0,0,OFFICE NO. 2 WESTERN TECH CENTER
GREER,OFFICE NO. 2 SAYRE PUBLIC SCHOOLS,MATT THORNBROUGH,,280302,0,0,0,0,OFFICE NO. 2 SAYRE PUBLIC SCHOOLS
GREER,OFFICE NO. 2 SAYRE PUBLIC SCHOOLS,BRIAN CHAPMAN,,280302,0,0,0,0,OFFICE NO. 2 SAYRE PUBLIC SCHOOLS
GREER,OFFICE NO. 2 WESTERN TECH CENTER,GARY D. SMITH,,280302,0,0,0,0,OFFICE NO. 2 WESTERN TECH CENTER
GREER,OFFICE NO. 2 WESTERN TECH CENTER,BILL JOHANNING,,280302,0,0,0,0,OFFICE NO. 2 WESTERN TECH CENTER
HARPER,OFFICE NO. 2 LAVERNE PUBLIC SCHOOLS,GABE HOPE,,300201,2,3,79,84,OFFICE NO. 2 LAVERNE PUBLIC SCHOOLS
HARPER,OFFICE NO. 2 LAVERNE PUBLIC SCHOOLS,JIMMY DIXON,,300201,0,2,42,44,OFFICE NO. 2 LAVERNE PUBLIC SCHOOLS
HARPER,OFFICE NO. 2 LAVERNE PUBLIC SCHOOLS,GABE HOPE,,300203,0,2,11,13,OFFICE NO. 2 LAVERNE PUBLIC SCHOOLS
HARPER,OFFICE NO. 2 LAVERNE PUBLIC SCHOOLS,JIMMY DIXON,,300203,0,0,4,4,OFFICE NO. 2 LAVERNE PUBLIC SCHOOLS
HARPER,OFFICE NO. 2 LAVERNE PUBLIC SCHOOLS,GABE HOPE,,300301,0,1,0,1,OFFICE NO. 2 LAVERNE PUBLIC SCHOOLS
HARPER,OFFICE NO. 2 LAVERNE PUBLIC SCHOOLS,JIMMY DIXON,,300301,1,0,1,2,OFFICE NO. 2 LAVERNE PUBLIC SCHOOLS
HARPER,OFFICE NO. 2 LAVERNE PUBLIC SCHOOLS,GABE HOPE,,300302,1,0,0,1,OFFICE NO. 2 LAVERNE PUBLIC SCHOOLS
HARPER,OFFICE NO. 2 LAVERNE PUBLIC SCHOOLS,JIMMY DIXON,,300302,0,0,0,0,OFFICE NO. 2 LAVERNE PUBLIC SCHOOLS
HARPER,OFFICE NO. 2 FREEDOM PUBLIC SCHOOLS,CONCHA HERRERA,,300303,0,0,0,0,OFFICE NO. 2 FREEDOM PUBLIC SCHOOLS
HARPER,OFFICE NO. 2 FREEDOM PUBLIC SCHOOLS,DONALD SIMMONS,,300303,0,0,0,0,OFFICE NO. 2 FREEDOM PUBLIC SCHOOLS
HARPER,OFFICE NO. 4 (UNEXPIRED TERM) FREEDOM PUBLIC SCHOOLS,SANDRA J. KAMAS,,300303,0,0,0,0,OFFICE NO. 4 (UNEXPIRED TERM) FREEDOM PUBLIC SCHOOLS
HARPER,OFFICE NO. 4 (UNEXPIRED TERM) FREEDOM PUBLIC SCHOOLS,ROBERT N BABCOCK,,300303,0,0,0,0,OFFICE NO. 4 (UNEXPIRED TERM) FREEDOM PUBLIC SCHOOLS
HARPER,OFFICE NO. 5 (UNEXPIRED TERM) FREEDOM PUBLIC SCHOOLS,SHANE MORRIS,,300303,0,0,0,0,OFFICE NO. 5 (UNEXPIRED TERM) FREEDOM PUBLIC SCHOOLS
HARPER,OFFICE NO. 5 (UNEXPIRED TERM) FREEDOM PUBLIC SCHOOLS,RAUL GALINDO,,300303,0,0,0,0,OFFICE NO. 5 (UNEXPIRED TERM) FREEDOM PUBLIC SCHOOLS
HUGHES,OFFICE NO. 2 MOSS PUBLIC SCHOOLS,BRYAN SMITH,,320011,0,1,9,10,OFFICE NO. 2 MOSS PUBLIC SCHOOLS
HUGHES,OFFICE NO. 2 MOSS PUBLIC SCHOOLS,RICK SUMMY,,320011,0,0,0,0,OFFICE NO. 2 MOSS PUBLIC SCHOOLS
HUGHES,OFFICE NO. 2 MOSS PUBLIC SCHOOLS,BRYAN SMITH,,320016,0,0,0,0,OFFICE NO. 2 MOSS PUBLIC SCHOOLS
HUGHES,OFFICE NO. 2 MOSS PUBLIC SCHOOLS,RICK SUMMY,,320016,0,1,0,1,OFFICE NO. 2 MOSS PUBLIC SCHOOLS
HUGHES,OFFICE NO. 2 MOSS PUBLIC SCHOOLS,BRYAN SMITH,,320018,0,2,18,20,OFFICE NO. 2 MOSS PUBLIC SCHOOLS
HUGHES,OFFICE NO. 2 MOSS PUBLIC SCHOOLS,RICK SUMMY,,320018,0,0,2,2,OFFICE NO. 2 MOSS PUBLIC SCHOOLS
HUGHES,OFFICE NO. 2 MOSS PUBLIC SCHOOLS,BRYAN SMITH,,320020,0,0,0,0,OFFICE NO. 2 MOSS PUBLIC SCHOOLS
HUGHES,OFFICE NO. 2 MOSS PUBLIC SCHOOLS,RICK SUMMY,,320020,1,0,0,1,OFFICE NO. 2 MOSS PUBLIC SCHOOLS
HUGHES,OFFICE NO. 2 BUTNER PUBLIC SCHOOLS,HOLLIE MURRAY BEELER,,320020,0,0,0,0,OFFICE NO. 2 BUTNER PUBLIC SCHOOLS
HUGHES,OFFICE NO. 2 BUTNER PUBLIC SCHOOLS,BUTCH HOUSER,,320020,0,0,0,0,OFFICE NO. 2 BUTNER PUBLIC SCHOOLS
HUGHES,OFFICE NO. 2 MOSS PUBLIC SCHOOLS,BRYAN SMITH,,320022,0,0,0,0,OFFICE NO. 2 MOSS PUBLIC SCHOOLS
HUGHES,OFFICE NO. 2 MOSS PUBLIC SCHOOLS,RICK SUMMY,,320022,0,0,0,0,OFFICE NO. 2 MOSS PUBLIC SCHOOLS
HUGHES,PROPOSITION NO. 1 GRAHAM-DUSTIN PUBLIC SCHOOLS,FOR THE PROPOSITION - YES,,320022,0,0,81,81,PROPOSITION NO. 1 GRAHAM-DUSTIN PUBLIC SCHOOLS
HUGHES,PROPOSITION NO. 1 GRAHAM-DUSTIN PUBLIC SCHOOLS,AGAINST THE PROPOSITION - NO,,320022,0,0,47,47,PROPOSITION NO. 1 GRAHAM-DUSTIN PUBLIC SCHOOLS
HUGHES,PROPOSITION NO. 2 GRAHAM-DUSTIN PUBLIC SCHOOLS,FOR THE PROPOSITION - YES,,320022,0,0,83,83,PROPOSITION NO. 2 GRAHAM-DUSTIN PUBLIC SCHOOLS
HUGHES,PROPOSITION NO. 2 GRAHAM-DUSTIN PUBLIC SCHOOLS,AGAINST THE PROPOSITION - NO,,320022,0,0,46,46,PROPOSITION NO. 2 GRAHAM-DUSTIN PUBLIC SCHOOLS
HUGHES,OFFICE NO. 2 MOSS PUBLIC SCHOOLS,BRYAN SMITH,,320023,0,0,23,23,OFFICE NO. 2 MOSS PUBLIC SCHOOLS
HUGHES,OFFICE NO. 2 MOSS PUBLIC SCHOOLS,RICK SUMMY,,320023,0,1,0,1,OFFICE NO. 2 MOSS PUBLIC SCHOOLS
HUGHES,PROPOSITION NO. 1 GRAHAM-DUSTIN PUBLIC SCHOOLS,FOR THE PROPOSITION - YES,,320023,0,0,1,1,PROPOSITION NO. 1 GRAHAM-DUSTIN PUBLIC SCHOOLS
HUGHES,PROPOSITION NO. 1 GRAHAM-DUSTIN PUBLIC SCHOOLS,AGAINST THE PROPOSITION - NO,,320023,0,0,0,0,PROPOSITION NO. 1 GRAHAM-DUSTIN PUBLIC SCHOOLS
HUGHES,PROPOSITION NO. 2 GRAHAM-DUSTIN PUBLIC SCHOOLS,FOR THE PROPOSITION - YES,,320023,0,0,1,1,PROPOSITION NO. 2 GRAHAM-DUSTIN PUBLIC SCHOOLS
HUGHES,PROPOSITION NO. 2 GRAHAM-DUSTIN PUBLIC SCHOOLS,AGAINST THE PROPOSITION - NO,,320023,0,0,0,0,PROPOSITION NO. 2 GRAHAM-DUSTIN PUBLIC SCHOOLS
HUGHES,OFFICE NO. 2 MOSS PUBLIC SCHOOLS,BRYAN SMITH,,320030,0,0,0,0,OFFICE NO. 2 MOSS PUBLIC SCHOOLS
HUGHES,OFFICE NO. 2 MOSS PUBLIC SCHOOLS,RICK SUMMY,,320030,0,0,0,0,OFFICE NO. 2 MOSS PUBLIC SCHOOLS
HUGHES,OFFICE NO. 2 ALLEN PUBLIC SCHOOLS,JAMI RINEHART,,320030,0,0,1,1,OFFICE NO. 2 ALLEN PUBLIC SCHOOLS
HUGHES,OFFICE NO. 2 ALLEN PUBLIC SCHOOLS,CINDY DAVIS,,320030,0,0,2,2,OFFICE NO. 2 ALLEN PUBLIC SCHOOLS
HUGHES,PROPOSITION NO. 1 STUART PUBLIC SCHOOLS,FOR THE PROPOSITION - YES,,320032,0,0,60,60,PROPOSITION NO. 1 STUART PUBLIC SCHOOLS
HUGHES,PROPOSITION NO. 1 STUART PUBLIC SCHOOLS,AGAINST THE PROPOSITION - NO,,320032,0,0,5,5,PROPOSITION NO. 1 STUART PUBLIC SCHOOLS
HUGHES,PROPOSITION NO. 2 STUART PUBLIC SCHOOLS,FOR THE PROPOSITION - YES,,320032,0,0,60,60,PROPOSITION NO. 2 STUART PUBLIC SCHOOLS
HUGHES,PROPOSITION NO. 2 STUART PUBLIC SCHOOLS,AGAINST THE PROPOSITION - NO,,320032,0,0,5,5,PROPOSITION NO. 2 STUART PUBLIC SCHOOLS
HUGHES,OFFICE NO. 2 ALLEN PUBLIC SCHOOLS,JAMI RINEHART,,320033,0,0,6,6,OFFICE NO. 2 ALLEN PUBLIC SCHOOLS
HUGHES,OFFICE NO. 2 ALLEN PUBLIC SCHOOLS,CINDY DAVIS,,320033,0,0,4,4,OFFICE NO. 2 ALLEN PUBLIC SCHOOLS
HUGHES,OFFICE NO. 2 ALLEN PUBLIC SCHOOLS,JAMI RINEHART,,320034,0,0,22,22,OFFICE NO. 2 ALLEN PUBLIC SCHOOLS
HUGHES,OFFICE NO. 2 ALLEN PUBLIC SCHOOLS,CINDY DAVIS,,320034,0,0,19,19,OFFICE NO. 2 ALLEN PUBLIC SCHOOLS
JACKSON,"COUNCILMEMBER, WARD NO. 1 CITY OF ALTUS",JOHN WOMACK,,330001,2,11,54,67,"COUNCILMEMBER, WARD NO. 1 CITY OF ALTUS"
JACKSON,"COUNCILMEMBER, WARD NO. 1 CITY OF ALTUS",NATHAN COVINGTON I,,330001,1,2,15,18,"COUNCILMEMBER, WARD NO. 1 CITY OF ALTUS"
JACKSON,"COUNCILMEMBER, WARD NO. 1 CITY OF ALTUS",JOHN WOMACK,,330002,0,0,2,2,"COUNCILMEMBER, WARD NO. 1 CITY OF ALTUS"
JACKSON,"COUNCILMEMBER, WARD NO. 1 CITY OF ALTUS",NATHAN COVINGTON I,,330002,0,0,0,0,"COUNCILMEMBER, WARD NO. 1 CITY OF ALTUS"
JACKSON,"COUNCILMEMBER, WARD NO. 2 CITY OF ALTUS",DAN GOODSON III,,330002,0,0,0,0,"COUNCILMEMBER, WARD NO. 2 CITY OF ALTUS"
JACKSON,"COUNCILMEMBER, WARD NO. 2 CITY OF ALTUS",JON R KIDWELL,,330002,0,1,0,1,"COUNCILMEMBER, WARD NO. 2 CITY OF ALTUS"
JACKSON,"COUNCILMEMBER, WARD NO. 2 CITY OF ALTUS",DAN GOODSON III,,330003,0,0,6,6,"COUNCILMEMBER, WARD NO. 2 CITY OF ALTUS"
JACKSON,"COUNCILMEMBER, WARD NO. 2 CITY OF ALTUS",JON R KIDWELL,,330003,0,0,17,17,"COUNCILMEMBER, WARD NO. 2 CITY OF ALTUS"
JACKSON,"COUNCILMEMBER, WARD NO. 2 CITY OF ALTUS",DAN GOODSON III,,330006,0,1,0,1,"COUNCILMEMBER, WARD NO. 2 CITY OF ALTUS"
JACKSON,"COUNCILMEMBER, WARD NO. 2 CITY OF ALTUS",JON R KIDWELL,,330006,5,3,0,8,"COUNCILMEMBER, WARD NO. 2 CITY OF ALTUS"
JACKSON,"COUNCILMEMBER, WARD NO. 1 CITY OF ALTUS",JOHN WOMACK,,330007,0,5,11,16,"COUNCILMEMBER, WARD NO. 1 CITY OF ALTUS"
JACKSON,"COUNCILMEMBER, WARD NO. 1 CITY OF ALTUS",NATHAN COVINGTON I,,330007,0,0,2,2,"COUNCILMEMBER, WARD NO. 1 CITY OF ALTUS"
JACKSON,"COUNCILMEMBER, WARD NO. 1 CITY OF ALTUS",JOHN WOMACK,,330014,0,1,3,4,"COUNCILMEMBER, WARD NO. 1 CITY OF ALTUS"
JACKSON,"COUNCILMEMBER, WARD NO. 1 CITY OF ALTUS",NATHAN COVINGTON I,,330014,0,0,2,2,"COUNCILMEMBER, WARD NO. 1 CITY OF ALTUS"
JACKSON,"COUNCILMEMBER, WARD NO. 2 CITY OF ALTUS",DAN GOODSON III,,330014,1,1,11,13,"COUNCILMEMBER, WARD NO. 2 CITY OF ALTUS"
JACKSON,"COUNCILMEMBER, WARD NO. 2 CITY OF ALTUS",JON R KIDWELL,,330014,3,6,34,43,"COUNCILMEMBER, WARD NO. 2 CITY OF ALTUS"
JACKSON,OFFICE NO. 2 BLAIR PUBLIC SCHOOLS,SHANE CHAPMAN,,330016,0,0,79,79,OFFICE NO. 2 BLAIR PUBLIC SCHOOLS
JACKSON,OFFICE NO. 2 BLAIR PUBLIC SCHOOLS,BRANDI BOLEY,,330016,1,4,92,97,OFFICE NO. 2 BLAIR PUBLIC SCHOOLS
JACKSON,OFFICE NO. 4 (UNEXPIRED TERM) BLAIR PUBLIC SCHOOLS,MARIANNE J. NAGY,,330016,0,3,32,35,OFFICE NO. 4 (UNEXPIRED TERM) BLAIR PUBLIC SCHOOLS
JACKSON,OFFICE NO. 4 (UNEXPIRED TERM) BLAIR PUBLIC SCHOOLS,JEREMY RODRIQUEZ,,330016,1,2,138,141,OFFICE NO. 4 (UNEXPIRED TERM) BLAIR PUBLIC SCHOOLS
JACKSON,PROPOSITION BLAIR PUBLIC SCHOOLS,FOR THE PROPOSITION - YES,,330016,0,3,101,104,
JACKSON,PROPOSITION BLAIR PUBLIC SCHOOLS,AGAINST THE PROPOSITION - NO,,330016,1,2,67,70,
JACKSON,OFFICE NO. 2 DUKE PUBLIC SCHOOLS,RAFE HALL,,330017,3,5,110,118,OFFICE NO. 2 DUKE PUBLIC SCHOOLS
JACKSON,OFFICE NO. 2 DUKE PUBLIC SCHOOLS,TERRI LEDBETTER PEARSON,,330017,1,0,93,94,OFFICE NO. 2 DUKE PUBLIC SCHOOLS
JACKSON,OFFICE NO. 2 BLAIR PUBLIC SCHOOLS,SHANE CHAPMAN,,330020,0,0,4,4,OFFICE NO. 2 BLAIR PUBLIC SCHOOLS
JACKSON,OFFICE NO. 2 BLAIR PUBLIC SCHOOLS,BRANDI BOLEY,,330020,0,0,8,8,OFFICE NO. 2 BLAIR PUBLIC SCHOOLS
JACKSON,OFFICE NO. 4 (UNEXPIRED TERM) BLAIR PUBLIC SCHOOLS,MARIANNE J. NAGY,,330020,0,0,6,6,OFFICE NO. 4 (UNEXPIRED TERM) BLAIR PUBLIC SCHOOLS
JACKSON,OFFICE NO. 4 (UNEXPIRED TERM) BLAIR PUBLIC SCHOOLS,JEREMY RODRIQUEZ,,330020,0,0,6,6,OFFICE NO. 4 (UNEXPIRED TERM) BLAIR PUBLIC SCHOOLS
JACKSON,PROPOSITION BLAIR PUBLIC SCHOOLS,FOR THE PROPOSITION - YES,,330020,0,0,9,9,
JACKSON,PROPOSITION BLAIR PUBLIC SCHOOLS,AGAINST THE PROPOSITION - NO,,330020,0,0,3,3,
JACKSON,OFFICE NO. 2 BLAIR PUBLIC SCHOOLS,SHANE CHAPMAN,,330023,0,0,1,1,OFFICE NO. 2 BLAIR PUBLIC SCHOOLS
JACKSON,OFFICE NO. 2 BLAIR PUBLIC SCHOOLS,BRANDI BOLEY,,330023,0,0,4,4,OFFICE NO. 2 BLAIR PUBLIC SCHOOLS
JACKSON,OFFICE NO. 4 (UNEXPIRED TERM) BLAIR PUBLIC SCHOOLS,MARIANNE J. NAGY,,330023,0,0,1,1,OFFICE NO. 4 (UNEXPIRED TERM) BLAIR PUBLIC SCHOOLS
JACKSON,OFFICE NO. 4 (UNEXPIRED TERM) BLAIR PUBLIC SCHOOLS,JEREMY RODRIQUEZ,,330023,0,0,3,3,OFFICE NO. 4 (UNEXPIRED TERM) BLAIR PUBLIC SCHOOLS
JACKSON,OFFICE NO. 2 DUKE PUBLIC SCHOOLS,RAFE HALL,,330023,0,0,2,2,OFFICE NO. 2 DUKE PUBLIC SCHOOLS
JACKSON,OFFICE NO. 2 DUKE PUBLIC SCHOOLS,TERRI LEDBETTER PEARSON,,330023,0,0,1,1,OFFICE NO. 2 DUKE PUBLIC SCHOOLS
JACKSON,PROPOSITION BLAIR PUBLIC SCHOOLS,FOR THE PROPOSITION - YES,,330023,0,0,1,1,
JACKSON,PROPOSITION BLAIR PUBLIC SCHOOLS,AGAINST THE PROPOSITION - NO,,330023,0,0,4,4,
JEFFERSON,COUNTY COMMISSIONER DISTRICT NO. 1 (UNEXPIRED TERM),CHRIS JAMES,Republican,340001,1,7,8,16,COUNTY COMMISSIONER DISTRICT NO. 1 (UNEXPIRED TERM)
JEFFERSON,COUNTY COMMISSIONER DISTRICT NO. 1 (UNEXPIRED TERM),JIM BERNARD,Republican,340001,0,2,7,9,COUNTY COMMISSIONER DISTRICT NO. 1 (UNEXPIRED TERM)
JEFFERSON,COUNTY COMMISSIONER DISTRICT NO. 1 (UNEXPIRED TERM),BRYCE BOHOT,Republican,340001,1,7,23,31,COUNTY COMMISSIONER DISTRICT NO. 1 (UNEXPIRED TERM)
JEFFERSON,COUNTY COMMISSIONER DISTRICT NO. 1 (UNEXPIRED TERM),HAROLD WINTON SR,Democratic,340001,0,3,33,36,COUNTY COMMISSIONER DISTRICT NO. 1 (UNEXPIRED TERM)
JEFFERSON,COUNTY COMMISSIONER DISTRICT NO. 1 (UNEXPIRED TERM),MICHAEL W. BRYANT,Democratic,340001,1,12,28,41,COUNTY COMMISSIONER DISTRICT NO. 1 (UNEXPIRED TERM)
JEFFERSON,OFFICE NO. 2 WAURIKA PUBLIC SCHOOLS,KASEY STALLCUP,,340001,3,13,45,61,OFFICE NO. 2 WAURIKA PUBLIC SCHOOLS
JEFFERSON,OFFICE NO. 2 WAURIKA PUBLIC SCHOOLS,COLT MORRISON,,340001,3,15,53,71,OFFICE NO. 2 WAURIKA PUBLIC SCHOOLS
JEFFERSON,COUNTY COMMISSIONER DISTRICT NO. 1 (UNEXPIRED TERM),CHRIS JAMES,Republican,340002,0,6,21,27,COUNTY COMMISSIONER DISTRICT NO. 1 (UNEXPIRED TERM)
JEFFERSON,COUNTY COMMISSIONER DISTRICT NO. 1 (UNEXPIRED TERM),JIM BERNARD,Republican,340002,0,2,6,8,COUNTY COMMISSIONER DISTRICT NO. 1 (UNEXPIRED TERM)
JEFFERSON,COUNTY COMMISSIONER DISTRICT NO. 1 (UNEXPIRED TERM),BRYCE BOHOT,Republican,340002,0,4,26,30,COUNTY COMMISSIONER DISTRICT NO. 1 (UNEXPIRED TERM)
JEFFERSON,COUNTY COMMISSIONER DISTRICT NO. 1 (UNEXPIRED TERM),HAROLD WINTON SR,Democratic,340002,0,6,20,26,COUNTY COMMISSIONER DISTRICT NO. 1 (UNEXPIRED TERM)
JEFFERSON,COUNTY COMMISSIONER DISTRICT NO. 1 (UNEXPIRED TERM),MICHAEL W. BRYANT,Democratic,340002,4,7,17,28,COUNTY COMMISSIONER DISTRICT NO. 1 (UNEXPIRED TERM)
JEFFERSON,OFFICE NO. 2 WAURIKA PUBLIC SCHOOLS,KASEY STALLCUP,,340002,0,10,45,55,OFFICE NO. 2 WAURIKA PUBLIC SCHOOLS
JEFFERSON,OFFICE NO. 2 WAURIKA PUBLIC SCHOOLS,COLT MORRISON,,340002,0,15,45,60,OFFICE NO. 2 WAURIKA PUBLIC SCHOOLS
JEFFERSON,COUNTY COMMISSIONER DISTRICT NO. 1 (UNEXPIRED TERM),CHRIS JAMES,Republican,340003,0,1,10,11,COUNTY COMMISSIONER DISTRICT NO. 1 (UNEXPIRED TERM)
JEFFERSON,COUNTY COMMISSIONER DISTRICT NO. 1 (UNEXPIRED TERM),JIM BERNARD,Republican,340003,0,0,0,0,COUNTY COMMISSIONER DISTRICT NO. 1 (UNEXPIRED TERM)
JEFFERSON,COUNTY COMMISSIONER DISTRICT NO. 1 (UNEXPIRED TERM),BRYCE BOHOT,Republican,340003,0,4,15,19,COUNTY COMMISSIONER DISTRICT NO. 1 (UNEXPIRED TERM)
JEFFERSON,COUNTY COMMISSIONER DISTRICT NO. 1 (UNEXPIRED TERM),HAROLD WINTON SR,Democratic,340003,0,0,3,3,COUNTY COMMISSIONER DISTRICT NO. 1 (UNEXPIRED TERM)
JEFFERSON,COUNTY COMMISSIONER DISTRICT NO. 1 (UNEXPIRED TERM),MICHAEL W. BRYANT,Democratic,340003,0,4,11,15,COUNTY COMMISSIONER DISTRICT NO. 1 (UNEXPIRED TERM)
JEFFERSON,OFFICE NO. 2 WAURIKA PUBLIC SCHOOLS,KASEY STALLCUP,,340003,0,4,17,21,OFFICE NO. 2 WAURIKA PUBLIC SCHOOLS
JEFFERSON,OFFICE NO. 2 WAURIKA PUBLIC SCHOOLS,COLT MORRISON,,340003,0,2,21,23,OFFICE NO. 2 WAURIKA PUBLIC SCHOOLS
JEFFERSON,COUNTY COMMISSIONER DISTRICT NO. 1 (UNEXPIRED TERM),CHRIS JAMES,Republican,340004,0,0,1,1,COUNTY COMMISSIONER DISTRICT NO. 1 (UNEXPIRED TERM)
JEFFERSON,COUNTY COMMISSIONER DISTRICT NO. 1 (UNEXPIRED TERM),JIM BERNARD,Republican,340004,0,0,3,3,COUNTY COMMISSIONER DISTRICT NO. 1 (UNEXPIRED TERM)
JEFFERSON,COUNTY COMMISSIONER DISTRICT NO. 1 (UNEXPIRED TERM),BRYCE BOHOT,Republican,340004,0,3,10,13,COUNTY COMMISSIONER DISTRICT NO. 1 (UNEXPIRED TERM)
JEFFERSON,COUNTY COMMISSIONER DISTRICT NO. 1 (UNEXPIRED TERM),HAROLD WINTON SR,Democratic,340004,0,0,5,5,COUNTY COMMISSIONER DISTRICT NO. 1 (UNEXPIRED TERM)
JEFFERSON,COUNTY COMMISSIONER DISTRICT NO. 1 (UNEXPIRED TERM),MICHAEL W. BRYANT,Democratic,340004,0,4,6,10,COUNTY COMMISSIONER DISTRICT NO. 1 (UNEXPIRED TERM)
JEFFERSON,OFFICE NO. 2 WAURIKA PUBLIC SCHOOLS,KASEY STALLCUP,,340004,0,3,4,7,OFFICE NO. 2 WAURIKA PUBLIC SCHOOLS
JEFFERSON,OFFICE NO. 2 WAURIKA PUBLIC SCHOOLS,COLT MORRISON,,340004,0,2,11,13,OFFICE NO. 2 WAURIKA PUBLIC SCHOOLS
JEFFERSON,OFFICE NO. 2 WAURIKA PUBLIC SCHOOLS,KASEY STALLCUP,,340005,0,0,10,10,OFFICE NO. 2 WAURIKA PUBLIC SCHOOLS
JEFFERSON,OFFICE NO. 2 WAURIKA PUBLIC SCHOOLS,COLT MORRISON,,340005,0,0,6,6,OFFICE NO. 2 WAURIKA PUBLIC SCHOOLS
JEFFERSON,OFFICE NO. 2 WAURIKA PUBLIC SCHOOLS,KASEY STALLCUP,,340006,0,1,1,2,OFFICE NO. 2 WAURIKA PUBLIC SCHOOLS
JEFFERSON,OFFICE NO. 2 WAURIKA PUBLIC SCHOOLS,COLT MORRISON,,340006,0,0,0,0,OFFICE NO. 2 WAURIKA PUBLIC SCHOOLS
JEFFERSON,COUNTY COMMISSIONER DISTRICT NO. 1 (UNEXPIRED TERM),CHRIS JAMES,Republican,340008,0,0,2,2,COUNTY COMMISSIONER DISTRICT NO. 1 (UNEXPIRED TERM)
JEFFERSON,COUNTY COMMISSIONER DISTRICT NO. 1 (UNEXPIRED TERM),JIM BERNARD,Republican,340008,2,0,1,3,COUNTY COMMISSIONER DISTRICT NO. 1 (UNEXPIRED TERM)
JEFFERSON,COUNTY COMMISSIONER DISTRICT NO. 1 (UNEXPIRED TERM),BRYCE BOHOT,Republican,340008,0,3,6,9,COUNTY COMMISSIONER DISTRICT NO. 1 (UNEXPIRED TERM)
JEFFERSON,COUNTY COMMISSIONER DISTRICT NO. 1 (UNEXPIRED TERM),HAROLD WINTON SR,Democratic,340008,0,0,3,3,COUNTY COMMISSIONER DISTRICT NO. 1 (UNEXPIRED TERM)
JEFFERSON,COUNTY COMMISSIONER DISTRICT NO. 1 (UNEXPIRED TERM),MICHAEL W. BRYANT,Democratic,340008,0,3,3,6,COUNTY COMMISSIONER DISTRICT NO. 1 (UNEXPIRED TERM)
JEFFERSON,OFFICE NO. 2 WAURIKA PUBLIC SCHOOLS,KASEY STALLCUP,,340008,0,1,5,6,OFFICE NO. 2 WAURIKA PUBLIC SCHOOLS
JEFFERSON,OFFICE NO. 2 WAURIKA PUBLIC SCHOOLS,COLT MORRISON,,340008,2,4,9,15,OFFICE NO. 2 WAURIKA PUBLIC SCHOOLS
JEFFERSON,OFFICE NO. 2 WAURIKA PUBLIC SCHOOLS,KASEY STALLCUP,,340009,0,0,0,0,OFFICE NO. 2 WAURIKA PUBLIC SCHOOLS
JEFFERSON,OFFICE NO. 2 WAURIKA PUBLIC SCHOOLS,COLT MORRISON,,340009,0,1,0,1,OFFICE NO. 2 WAURIKA PUBLIC SCHOOLS
JOHNSTON,OFFICE NO. 2 MILBURN PUBLIC SCHOOLS,CINDY BARNES,,350001,0,0,4,4,OFFICE NO. 2 MILBURN PUBLIC SCHOOLS
JOHNSTON,OFFICE NO. 2 MILBURN PUBLIC SCHOOLS,CALLEN RAGAN,,350001,0,0,4,4,OFFICE NO. 2 MILBURN PUBLIC SCHOOLS
JOHNSTON,OFFICE NO. 2 TISHOMINGO PUBLIC SCHOOLS,DARRELL GUNTER,,350001,0,1,11,12,OFFICE NO. 2 TISHOMINGO PUBLIC SCHOOLS
JOHNSTON,OFFICE NO. 2 TISHOMINGO PUBLIC SCHOOLS,AMY GANTT,,350001,0,4,25,29,OFFICE NO. 2 TISHOMINGO PUBLIC SCHOOLS
JOHNSTON,OFFICE NO. 2 TISHOMINGO PUBLIC SCHOOLS,DARRELL GUNTER,,350002,0,1,8,9,OFFICE NO. 2 TISHOMINGO PUBLIC SCHOOLS
JOHNSTON,OFFICE NO. 2 TISHOMINGO PUBLIC SCHOOLS,AMY GANTT,,350002,0,0,32,32,OFFICE NO. 2 TISHOMINGO PUBLIC SCHOOLS
JOHNSTON,OFFICE NO. 2 TISHOMINGO PUBLIC SCHOOLS,DARRELL GUNTER,,350003,0,1,6,7,OFFICE NO. 2 TISHOMINGO PUBLIC SCHOOLS
JOHNSTON,OFFICE NO. 2 TISHOMINGO PUBLIC SCHOOLS,AMY GANTT,,350003,0,2,16,18,OFFICE NO. 2 TISHOMINGO PUBLIC SCHOOLS
JOHNSTON,OFFICE NO. 2 TISHOMINGO PUBLIC SCHOOLS,DARRELL GUNTER,,350004,1,2,18,21,OFFICE NO. 2 TISHOMINGO PUBLIC SCHOOLS
JOHNSTON,OFFICE NO. 2 TISHOMINGO PUBLIC SCHOOLS,AMY GANTT,,350004,1,5,46,52,OFFICE NO. 2 TISHOMINGO PUBLIC SCHOOLS
JOHNSTON,OFFICE NO. 2 TISHOMINGO PUBLIC SCHOOLS,DARRELL GUNTER,,350005,0,0,0,0,OFFICE NO. 2 TISHOMINGO PUBLIC SCHOOLS
JOHNSTON,OFFICE NO. 2 TISHOMINGO PUBLIC SCHOOLS,AMY GANTT,,350005,0,0,0,0,OFFICE NO. 2 TISHOMINGO PUBLIC SCHOOLS
JOHNSTON,OFFICE NO. 2 TISHOMINGO PUBLIC SCHOOLS,DARRELL GUNTER,,350006,0,0,0,0,OFFICE NO. 2 TISHOMINGO PUBLIC SCHOOLS
JOHNSTON,OFFICE NO. 2 TISHOMINGO PUBLIC SCHOOLS,AMY GANTT,,350006,0,0,0,0,OFFICE NO. 2 TISHOMINGO PUBLIC SCHOOLS
JOHNSTON,OFFICE NO. 2 TISHOMINGO PUBLIC SCHOOLS,DARRELL GUNTER,,350009,0,0,4,4,OFFICE NO. 2 TISHOMINGO PUBLIC SCHOOLS
JOHNSTON,OFFICE NO. 2 TISHOMINGO PUBLIC SCHOOLS,AMY GANTT,,350009,0,1,0,1,OFFICE NO. 2 TISHOMINGO PUBLIC SCHOOLS
JOHNSTON,OFFICE NO. 2 COLEMAN PUBLIC SCHOOLS,JEFF TIPTON,,350012,0,0,81,81,OFFICE NO. 2 COLEMAN PUBLIC SCHOOLS
JOHNSTON,OFFICE NO. 2 COLEMAN PUBLIC SCHOOLS,RONALD NEEDHAM,,350012,0,0,49,49,OFFICE NO. 2 COLEMAN PUBLIC SCHOOLS
JOHNSTON,OFFICE NO. 2 MILBURN PUBLIC SCHOOLS,CINDY BARNES,,350012,0,0,0,0,OFFICE NO. 2 MILBURN PUBLIC SCHOOLS
JOHNSTON,OFFICE NO. 2 MILBURN PUBLIC SCHOOLS,CALLEN RAGAN,,350012,0,2,11,13,OFFICE NO. 2 MILBURN PUBLIC SCHOOLS
JOHNSTON,OFFICE NO. 2 MILBURN PUBLIC SCHOOLS,CINDY BARNES,,350013,0,0,34,34,OFFICE NO. 2 MILBURN PUBLIC SCHOOLS
JOHNSTON,OFFICE NO. 2 MILBURN PUBLIC SCHOOLS,CALLEN RAGAN,,350013,0,1,33,34,OFFICE NO. 2 MILBURN PUBLIC SCHOOLS
JOHNSTON,OFFICE NO. 2 TISHOMINGO PUBLIC SCHOOLS,DARRELL GUNTER,,350013,0,0,3,3,OFFICE NO. 2 TISHOMINGO PUBLIC SCHOOLS
JOHNSTON,OFFICE NO. 2 TISHOMINGO PUBLIC SCHOOLS,AMY GANTT,,350013,0,0,3,3,OFFICE NO. 2 TISHOMINGO PUBLIC SCHOOLS
JOHNSTON,OFFICE NO. 2 TISHOMINGO PUBLIC SCHOOLS,DARRELL GUNTER,,350014,0,0,0,0,OFFICE NO. 2 TISHOMINGO PUBLIC SCHOOLS
JOHNSTON,OFFICE NO. 2 TISHOMINGO PUBLIC SCHOOLS,AMY GANTT,,350014,0,0,2,2,OFFICE NO. 2 TISHOMINGO PUBLIC SCHOOLS
KAY,OFFICE NO. 2 NEWKIRK PUBLIC SCHOOLS,BILL HOBBS,,360001,4,18,143,165,OFFICE NO. 2 NEWKIRK PUBLIC SCHOOLS
KAY,OFFICE NO. 2 NEWKIRK PUBLIC SCHOOLS,PHILLIP KNIGHT,,360001,5,17,224,246,OFFICE NO. 2 NEWKIRK PUBLIC SCHOOLS
KAY,PROPOSITION NO. 1 NEWKIRK PUBLIC SCHOOLS,FOR THE PROPOSITION - YES,,360001,6,30,310,346,PROPOSITION NO. 1 NEWKIRK PUBLIC SCHOOLS
KAY,PROPOSITION NO. 1 NEWKIRK PUBLIC SCHOOLS,AGAINST THE PROPOSITION - NO,,360001,3,5,61,69,PROPOSITION NO. 1 NEWKIRK PUBLIC SCHOOLS
KAY,PROPOSITION NO. 2 NEWKIRK PUBLIC SCHOOLS,FOR THE PROPOSITION - YES,,360001,6,26,292,324,PROPOSITION NO. 2 NEWKIRK PUBLIC SCHOOLS
KAY,PROPOSITION NO. 2 NEWKIRK PUBLIC SCHOOLS,AGAINST THE PROPOSITION - NO,,360001,3,8,78,89,PROPOSITION NO. 2 NEWKIRK PUBLIC SCHOOLS
KAY,PROPOSITION NO. 3 NEWKIRK PUBLIC SCHOOLS,FOR THE PROPOSITION - YES,,360001,6,30,283,319,PROPOSITION NO. 3 NEWKIRK PUBLIC SCHOOLS
KAY,PROPOSITION NO. 3 NEWKIRK PUBLIC SCHOOLS,AGAINST THE PROPOSITION - NO,,360001,3,5,88,96,PROPOSITION NO. 3 NEWKIRK PUBLIC SCHOOLS
KAY,OFFICE NO. 2 BLACKWELL PUBLIC SCHOOLS,KATHLEEN BROWN,,360103,0,0,6,6,OFFICE NO. 2 BLACKWELL PUBLIC SCHOOLS
KAY,OFFICE NO. 2 BLACKWELL PUBLIC SCHOOLS,BARBARA IHRIG,,360103,0,0,5,5,OFFICE NO. 2 BLACKWELL PUBLIC SCHOOLS
KAY,MAYOR CITY OF BLACKWELL,T J GREENFIELD,,360202,2,9,150,161,
KAY,MAYOR CITY OF BLACKWELL,DENNIS COFFEY,,360202,0,1,43,44,
KAY,MAYOR CITY OF BLACKWELL,ROY DIETRICH,,360202,0,0,4,4,
KAY,OFFICE NO. 2 BLACKWELL PUBLIC SCHOOLS,KATHLEEN BROWN,,360202,1,6,142,149,OFFICE NO. 2 BLACKWELL PUBLIC SCHOOLS
KAY,OFFICE NO. 2 BLACKWELL PUBLIC SCHOOLS,BARBARA IHRIG,,360202,3,4,84,91,OFFICE NO. 2 BLACKWELL PUBLIC SCHOOLS
KAY,MAYOR CITY OF BLACKWELL,T J GREENFIELD,,360205,2,5,157,164,
KAY,MAYOR CITY OF BLACKWELL,DENNIS COFFEY,,360205,0,0,73,73,
KAY,MAYOR CITY OF BLACKWELL,ROY DIETRICH,,360205,0,0,6,6,
KAY,OFFICE NO. 2 BLACKWELL PUBLIC SCHOOLS,KATHLEEN BROWN,,360205,0,4,151,155,OFFICE NO. 2 BLACKWELL PUBLIC SCHOOLS
KAY,OFFICE NO. 2 BLACKWELL PUBLIC SCHOOLS,BARBARA IHRIG,,360205,2,1,85,88,OFFICE NO. 2 BLACKWELL PUBLIC SCHOOLS
KAY,MAYOR CITY OF BLACKWELL,T J GREENFIELD,,360206,3,4,346,353,
KAY,MAYOR CITY OF BLACKWELL,DENNIS COFFEY,,360206,0,1,49,50,
KAY,MAYOR CITY OF BLACKWELL,ROY DIETRICH,,360206,0,1,8,9,
KAY,OFFICE NO. 2 BLACKWELL PUBLIC SCHOOLS,KATHLEEN BROWN,,360206,1,5,243,249,OFFICE NO. 2 BLACKWELL PUBLIC SCHOOLS
KAY,OFFICE NO. 2 BLACKWELL PUBLIC SCHOOLS,BARBARA IHRIG,,360206,2,1,176,179,OFFICE NO. 2 BLACKWELL PUBLIC SCHOOLS
KAY,OFFICE NO. 2 KILDARE PUBLIC SCHOOL,MICHAEL S. SMITH,,360400,0,0,0,0,OFFICE NO. 2 KILDARE PUBLIC SCHOOL
KAY,OFFICE NO. 2 KILDARE PUBLIC SCHOOL,REBEKAH WIMER,,360400,0,0,0,0,OFFICE NO. 2 KILDARE PUBLIC SCHOOL
KAY,OFFICE NO. 2 NEWKIRK PUBLIC SCHOOLS,BILL HOBBS,,360400,0,2,5,7,OFFICE NO. 2 NEWKIRK PUBLIC SCHOOLS
KAY,OFFICE NO. 2 NEWKIRK PUBLIC SCHOOLS,PHILLIP KNIGHT,,360400,0,0,5,5,OFFICE NO. 2 NEWKIRK PUBLIC SCHOOLS
KAY,PROPOSITION NO. 1 NEWKIRK PUBLIC SCHOOLS,FOR THE PROPOSITION - YES,,360400,0,2,8,10,PROPOSITION NO. 1 NEWKIRK PUBLIC SCHOOLS
KAY,PROPOSITION NO. 1 NEWKIRK PUBLIC SCHOOLS,AGAINST THE PROPOSITION - NO,,360400,0,0,2,2,PROPOSITION NO. 1 NEWKIRK PUBLIC SCHOOLS
KAY,PROPOSITION NO. 2 NEWKIRK PUBLIC SCHOOLS,FOR THE PROPOSITION - YES,,360400,0,2,9,11,PROPOSITION NO. 2 NEWKIRK PUBLIC SCHOOLS
KAY,PROPOSITION NO. 2 NEWKIRK PUBLIC SCHOOLS,AGAINST THE PROPOSITION - NO,,360400,0,0,1,1,PROPOSITION NO. 2 NEWKIRK PUBLIC SCHOOLS
KAY,PROPOSITION NO. 3 NEWKIRK PUBLIC SCHOOLS,FOR THE PROPOSITION - YES,,360400,0,2,7,9,PROPOSITION NO. 3 NEWKIRK PUBLIC SCHOOLS
KAY,PROPOSITION NO. 3 NEWKIRK PUBLIC SCHOOLS,AGAINST THE PROPOSITION - NO,,360400,0,0,3,3,PROPOSITION NO. 3 NEWKIRK PUBLIC SCHOOLS
KAY,OFFICE NO. 2 SHIDLER PUBLIC SCHOOLS,WILLY HARGRAVES,,360400,0,0,0,0,OFFICE NO. 2 SHIDLER PUBLIC SCHOOLS
KAY,OFFICE NO. 2 SHIDLER PUBLIC SCHOOLS,NICHOLAS L SMITH,,360400,0,0,2,2,OFFICE NO. 2 SHIDLER PUBLIC SCHOOLS
KAY,OFFICE NO. 2 NEWKIRK PUBLIC SCHOOLS,BILL HOBBS,,360401,0,0,7,7,OFFICE NO. 2 NEWKIRK PUBLIC SCHOOLS
KAY,OFFICE NO. 2 NEWKIRK PUBLIC SCHOOLS,PHILLIP KNIGHT,,360401,0,1,10,11,OFFICE NO. 2 NEWKIRK PUBLIC SCHOOLS
KAY,PROPOSITION NO. 1 NEWKIRK PUBLIC SCHOOLS,FOR THE PROPOSITION - YES,,360401,0,1,15,16,PROPOSITION NO. 1 NEWKIRK PUBLIC SCHOOLS
KAY,PROPOSITION NO. 1 NEWKIRK PUBLIC SCHOOLS,AGAINST THE PROPOSITION - NO,,360401,0,0,2,2,PROPOSITION NO. 1 NEWKIRK PUBLIC SCHOOLS
KAY,PROPOSITION NO. 2 NEWKIRK PUBLIC SCHOOLS,FOR THE PROPOSITION - YES,,360401,0,1,12,13,PROPOSITION NO. 2 NEWKIRK PUBLIC SCHOOLS
KAY,PROPOSITION NO. 2 NEWKIRK PUBLIC SCHOOLS,AGAINST THE PROPOSITION - NO,,360401,0,0,5,5,PROPOSITION NO. 2 NEWKIRK PUBLIC SCHOOLS
KAY,PROPOSITION NO. 3 NEWKIRK PUBLIC SCHOOLS,FOR THE PROPOSITION - YES,,360401,0,1,9,10,PROPOSITION NO. 3 NEWKIRK PUBLIC SCHOOLS
KAY,PROPOSITION NO. 3 NEWKIRK PUBLIC SCHOOLS,AGAINST THE PROPOSITION - NO,,360401,0,0,8,8,PROPOSITION NO. 3 NEWKIRK PUBLIC SCHOOLS
KAY,OFFICE NO. 2 SHIDLER PUBLIC SCHOOLS,WILLY HARGRAVES,,360401,0,0,0,0,OFFICE NO. 2 SHIDLER PUBLIC SCHOOLS
KAY,OFFICE NO. 2 SHIDLER PUBLIC SCHOOLS,NICHOLAS L SMITH,,360401,0,0,0,0,OFFICE NO. 2 SHIDLER PUBLIC SCHOOLS
KAY,OFFICE NO. 2 KILDARE PUBLIC SCHOOL,MICHAEL S. SMITH,,360403,0,1,1,2,OFFICE NO. 2 KILDARE PUBLIC SCHOOL
KAY,OFFICE NO. 2 KILDARE PUBLIC SCHOOL,REBEKAH WIMER,,360403,0,0,0,0,OFFICE NO. 2 KILDARE PUBLIC SCHOOL
KAY,OFFICE NO. 2 NEWKIRK PUBLIC SCHOOLS,BILL HOBBS,,360403,0,9,52,61,OFFICE NO. 2 NEWKIRK PUBLIC SCHOOLS
KAY,OFFICE NO. 2 NEWKIRK PUBLIC SCHOOLS,PHILLIP KNIGHT,,360403,0,5,69,74,OFFICE NO. 2 NEWKIRK PUBLIC SCHOOLS
KAY,PROPOSITION NO. 1 NEWKIRK PUBLIC SCHOOLS,FOR THE PROPOSITION - YES,,360403,0,10,86,96,PROPOSITION NO. 1 NEWKIRK PUBLIC SCHOOLS
KAY,PROPOSITION NO. 1 NEWKIRK PUBLIC SCHOOLS,AGAINST THE PROPOSITION - NO,,360403,0,4,34,38,PROPOSITION NO. 1 NEWKIRK PUBLIC SCHOOLS
KAY,PROPOSITION NO. 2 NEWKIRK PUBLIC SCHOOLS,FOR THE PROPOSITION - YES,,360403,0,10,86,96,PROPOSITION NO. 2 NEWKIRK PUBLIC SCHOOLS
KAY,PROPOSITION NO. 2 NEWKIRK PUBLIC SCHOOLS,AGAINST THE PROPOSITION - NO,,360403,0,4,35,39,PROPOSITION NO. 2 NEWKIRK PUBLIC SCHOOLS
KAY,PROPOSITION NO. 3 NEWKIRK PUBLIC SCHOOLS,FOR THE PROPOSITION - YES,,360403,0,10,84,94,PROPOSITION NO. 3 NEWKIRK PUBLIC SCHOOLS
KAY,PROPOSITION NO. 3 NEWKIRK PUBLIC SCHOOLS,AGAINST THE PROPOSITION - NO,,360403,0,4,37,41,PROPOSITION NO. 3 NEWKIRK PUBLIC SCHOOLS
KAY,OFFICE NO. 2 BLACKWELL PUBLIC SCHOOLS,KATHLEEN BROWN,,360404,0,0,0,0,OFFICE NO. 2 BLACKWELL PUBLIC SCHOOLS
KAY,OFFICE NO. 2 BLACKWELL PUBLIC SCHOOLS,BARBARA IHRIG,,360404,0,0,0,0,OFFICE NO. 2 BLACKWELL PUBLIC SCHOOLS
KAY,OFFICE NO. 2 NEWKIRK PUBLIC SCHOOLS,BILL HOBBS,,360404,0,0,6,6,OFFICE NO. 2 NEWKIRK PUBLIC SCHOOLS
KAY,OFFICE NO. 2 NEWKIRK PUBLIC SCHOOLS,PHILLIP KNIGHT,,360404,0,0,9,9,OFFICE NO. 2 NEWKIRK PUBLIC SCHOOLS
KAY,PROPOSITION NO. 1 NEWKIRK PUBLIC SCHOOLS,FOR THE PROPOSITION - YES,,360404,0,0,7,7,PROPOSITION NO. 1 NEWKIRK PUBLIC SCHOOLS
KAY,PROPOSITION NO. 1 NEWKIRK PUBLIC SCHOOLS,AGAINST THE PROPOSITION - NO,,360404,0,0,8,8,PROPOSITION NO. 1 NEWKIRK PUBLIC SCHOOLS
KAY,PROPOSITION NO. 2 NEWKIRK PUBLIC SCHOOLS,FOR THE PROPOSITION - YES,,360404,0,0,4,4,PROPOSITION NO. 2 NEWKIRK PUBLIC SCHOOLS
KAY,PROPOSITION NO. 2 NEWKIRK PUBLIC SCHOOLS,AGAINST THE PROPOSITION - NO,,360404,0,0,10,10,PROPOSITION NO. 2 NEWKIRK PUBLIC SCHOOLS
KAY,PROPOSITION NO. 3 NEWKIRK PUBLIC SCHOOLS,FOR THE PROPOSITION - YES,,360404,0,0,3,3,PROPOSITION NO. 3 NEWKIRK PUBLIC SCHOOLS
KAY,PROPOSITION NO. 3 NEWKIRK PUBLIC SCHOOLS,AGAINST THE PROPOSITION - NO,,360404,0,0,12,12,PROPOSITION NO. 3 NEWKIRK PUBLIC SCHOOLS
KAY,OFFICE NO. 2 BLACKWELL PUBLIC SCHOOLS,KATHLEEN BROWN,,360406,0,0,0,0,OFFICE NO. 2 BLACKWELL PUBLIC SCHOOLS
KAY,OFFICE NO. 2 BLACKWELL PUBLIC SCHOOLS,BARBARA IHRIG,,360406,0,0,0,0,OFFICE NO. 2 BLACKWELL PUBLIC SCHOOLS
KAY,OFFICE NO. 2 NEWKIRK PUBLIC SCHOOLS,BILL HOBBS,,360406,0,1,33,34,OFFICE NO. 2 NEWKIRK PUBLIC SCHOOLS
KAY,OFFICE NO. 2 NEWKIRK PUBLIC SCHOOLS,PHILLIP KNIGHT,,360406,0,3,43,46,OFFICE NO. 2 NEWKIRK PUBLIC SCHOOLS
KAY,PROPOSITION NO. 1 NEWKIRK PUBLIC SCHOOLS,FOR THE PROPOSITION - YES,,360406,0,5,32,37,PROPOSITION NO. 1 NEWKIRK PUBLIC SCHOOLS
KAY,PROPOSITION NO. 1 NEWKIRK PUBLIC SCHOOLS,AGAINST THE PROPOSITION - NO,,360406,0,0,54,54,PROPOSITION NO. 1 NEWKIRK PUBLIC SCHOOLS
KAY,PROPOSITION NO. 2 NEWKIRK PUBLIC SCHOOLS,FOR THE PROPOSITION - YES,,360406,0,4,25,29,PROPOSITION NO. 2 NEWKIRK PUBLIC SCHOOLS
KAY,PROPOSITION NO. 2 NEWKIRK PUBLIC SCHOOLS,AGAINST THE PROPOSITION - NO,,360406,0,1,61,62,PROPOSITION NO. 2 NEWKIRK PUBLIC SCHOOLS
KAY,PROPOSITION NO. 3 NEWKIRK PUBLIC SCHOOLS,FOR THE PROPOSITION - YES,,360406,0,4,23,27,PROPOSITION NO. 3 NEWKIRK PUBLIC SCHOOLS
KAY,PROPOSITION NO. 3 NEWKIRK PUBLIC SCHOOLS,AGAINST THE PROPOSITION - NO,,360406,0,1,62,63,PROPOSITION NO. 3 NEWKIRK PUBLIC SCHOOLS
KAY,OFFICE NO. 2 KILDARE PUBLIC SCHOOL,MICHAEL S. SMITH,,360407,0,0,23,23,OFFICE NO. 2 KILDARE PUBLIC SCHOOL
KAY,OFFICE NO. 2 KILDARE PUBLIC SCHOOL,REBEKAH WIMER,,360407,0,0,4,4,OFFICE NO. 2 KILDARE PUBLIC SCHOOL
KAY,OFFICE NO. 2 NEWKIRK PUBLIC SCHOOLS,BILL HOBBS,,360407,0,0,1,1,OFFICE NO. 2 NEWKIRK PUBLIC SCHOOLS
KAY,OFFICE NO. 2 NEWKIRK PUBLIC SCHOOLS,PHILLIP KNIGHT,,360407,0,0,1,1,OFFICE NO. 2 NEWKIRK PUBLIC SCHOOLS
KAY,PROPOSITION NO. 1 NEWKIRK PUBLIC SCHOOLS,FOR THE PROPOSITION - YES,,360407,0,0,2,2,PROPOSITION NO. 1 NEWKIRK PUBLIC SCHOOLS
KAY,PROPOSITION NO. 1 NEWKIRK PUBLIC SCHOOLS,AGAINST THE PROPOSITION - NO,,360407,0,0,0,0,PROPOSITION NO. 1 NEWKIRK PUBLIC SCHOOLS
KAY,PROPOSITION NO. 2 NEWKIRK PUBLIC SCHOOLS,FOR THE PROPOSITION - YES,,360407,0,0,2,2,PROPOSITION NO. 2 NEWKIRK PUBLIC SCHOOLS
KAY,PROPOSITION NO. 2 NEWKIRK PUBLIC SCHOOLS,AGAINST THE PROPOSITION - NO,,360407,0,0,0,0,PROPOSITION NO. 2 NEWKIRK PUBLIC SCHOOLS
KAY,PROPOSITION NO. 3 NEWKIRK PUBLIC SCHOOLS,FOR THE PROPOSITION - YES,,360407,0,0,2,2,PROPOSITION NO. 3 NEWKIRK PUBLIC SCHOOLS
KAY,PROPOSITION NO. 3 NEWKIRK PUBLIC SCHOOLS,AGAINST THE PROPOSITION - NO,,360407,0,0,0,0,PROPOSITION NO. 3 NEWKIRK PUBLIC SCHOOLS
KAY,OFFICE NO. 2 BLACKWELL PUBLIC SCHOOLS,KATHLEEN BROWN,,360409,0,0,0,0,OFFICE NO. 2 BLACKWELL PUBLIC SCHOOLS
KAY,OFFICE NO. 2 BLACKWELL PUBLIC SCHOOLS,BARBARA IHRIG,,360409,0,0,0,0,OFFICE NO. 2 BLACKWELL PUBLIC SCHOOLS
KAY,OFFICE NO. 2 KILDARE PUBLIC SCHOOL,MICHAEL S. SMITH,,360409,0,0,0,0,OFFICE NO. 2 KILDARE PUBLIC SCHOOL
KAY,OFFICE NO. 2 KILDARE PUBLIC SCHOOL,REBEKAH WIMER,,360409,0,0,0,0,OFFICE NO. 2 KILDARE PUBLIC SCHOOL
KAY,COMMISSIONER NO. 3 CITY OF PONCA CITY,SHASTA SCOTT,,360411,0,0,0,0,COMMISSIONER NO. 3 CITY OF PONCA CITY
KAY,COMMISSIONER NO. 3 CITY OF PONCA CITY,DANIEL L. SHERRON,,360411,0,0,0,0,COMMISSIONER NO. 3 CITY OF PONCA CITY
KAY,OFFICE NO. 2 KILDARE PUBLIC SCHOOL,MICHAEL S. SMITH,,360411,0,1,0,1,OFFICE NO. 2 KILDARE PUBLIC SCHOOL
KAY,OFFICE NO. 2 KILDARE PUBLIC SCHOOL,REBEKAH WIMER,,360411,0,0,0,0,OFFICE NO. 2 KILDARE PUBLIC SCHOOL
KAY,OFFICE NO. 2 KILDARE PUBLIC SCHOOL,MICHAEL S. SMITH,,360412,0,1,1,2,OFFICE NO. 2 KILDARE PUBLIC SCHOOL
KAY,OFFICE NO. 2 KILDARE PUBLIC SCHOOL,REBEKAH WIMER,,360412,0,0,1,1,OFFICE NO. 2 KILDARE PUBLIC SCHOOL
KAY,OFFICE NO. 2 SHIDLER PUBLIC SCHOOLS,WILLY HARGRAVES,,360412,0,0,10,10,OFFICE NO. 2 SHIDLER PUBLIC SCHOOLS
KAY,OFFICE NO. 2 SHIDLER PUBLIC SCHOOLS,NICHOLAS L SMITH,,360412,0,0,20,20,OFFICE NO. 2 SHIDLER PUBLIC SCHOOLS
KAY,COMMISSIONER NO. 3 CITY OF PONCA CITY,SHASTA SCOTT,,360413,0,0,28,28,COMMISSIONER NO. 3 CITY OF PONCA CITY
KAY,COMMISSIONER NO. 3 CITY OF PONCA CITY,DANIEL L. SHERRON,,360413,0,0,18,18,COMMISSIONER NO. 3 CITY OF PONCA CITY
KAY,OFFICE NO. 2 KILDARE PUBLIC SCHOOL,MICHAEL S. SMITH,,360413,0,0,6,6,OFFICE NO. 2 KILDARE PUBLIC SCHOOL
KAY,OFFICE NO. 2 KILDARE PUBLIC SCHOOL,REBEKAH WIMER,,360413,0,0,1,1,OFFICE NO. 2 KILDARE PUBLIC SCHOOL
KAY,COMMISSIONER NO. 3 CITY OF PONCA CITY,SHASTA SCOTT,,360419,0,1,19,20,COMMISSIONER NO. 3 CITY OF PONCA CITY
KAY,COMMISSIONER NO. 3 CITY OF PONCA CITY,DANIEL L. SHERRON,,360419,2,0,18,20,COMMISSIONER NO. 3 CITY OF PONCA CITY
KAY,COMMISSIONER NO. 3 CITY OF PONCA CITY,SHASTA SCOTT,,360420,0,0,0,0,COMMISSIONER NO. 3 CITY OF PONCA CITY
KAY,COMMISSIONER NO. 3 CITY OF PONCA CITY,DANIEL L. SHERRON,,360420,0,0,0,0,COMMISSIONER NO. 3 CITY OF PONCA CITY
KAY,OFFICE NO. 2 BLACKWELL PUBLIC SCHOOLS,KATHLEEN BROWN,,360420,0,0,0,0,OFFICE NO. 2 BLACKWELL PUBLIC SCHOOLS
KAY,OFFICE NO. 2 BLACKWELL PUBLIC SCHOOLS,BARBARA IHRIG,,360420,0,0,1,1,OFFICE NO. 2 BLACKWELL PUBLIC SCHOOLS
KAY,OFFICE NO. 2 KILDARE PUBLIC SCHOOL,MICHAEL S. SMITH,,360420,0,0,0,0,OFFICE NO. 2 KILDARE PUBLIC SCHOOL
KAY,OFFICE NO. 2 KILDARE PUBLIC SCHOOL,REBEKAH WIMER,,360420,0,0,0,0,OFFICE NO. 2 KILDARE PUBLIC SCHOOL
KAY,COMMISSIONER NO. 3 CITY OF PONCA CITY,SHASTA SCOTT,,360503,0,1,77,78,COMMISSIONER NO. 3 CITY OF PONCA CITY
KAY,COMMISSIONER NO. 3 CITY OF PONCA CITY,DANIEL L. SHERRON,,360503,0,3,60,63,COMMISSIONER NO. 3 CITY OF PONCA CITY
KAY,COMMISSIONER NO. 3 CITY OF PONCA CITY,SHASTA SCOTT,,360507,0,0,44,44,COMMISSIONER NO. 3 CITY OF PONCA CITY
KAY,COMMISSIONER NO. 3 CITY OF PONCA CITY,DANIEL L. SHERRON,,360507,0,3,40,43,COMMISSIONER NO. 3 CITY OF PONCA CITY
KAY,COMMISSIONER NO. 3 CITY OF PONCA CITY,SHASTA SCOTT,,360516,0,0,29,29,COMMISSIONER NO. 3 CITY OF PONCA CITY
KAY,COMMISSIONER NO. 3 CITY OF PONCA CITY,DANIEL L. SHERRON,,360516,0,1,40,41,COMMISSIONER NO. 3 CITY OF PONCA CITY
KAY,COMMISSIONER NO. 3 CITY OF PONCA CITY,SHASTA SCOTT,,360517,0,0,52,52,COMMISSIONER NO. 3 CITY OF PONCA CITY
KAY,COMMISSIONER NO. 3 CITY OF PONCA CITY,DANIEL L. SHERRON,,360517,0,1,52,53,COMMISSIONER NO. 3 CITY OF PONCA CITY
KAY,COMMISSIONER NO. 3 CITY OF PONCA CITY,SHASTA SCOTT,,360527,0,0,86,86,COMMISSIONER NO. 3 CITY OF PONCA CITY
KAY,COMMISSIONER NO. 3 CITY OF PONCA CITY,DANIEL L. SHERRON,,360527,1,2,62,65,COMMISSIONER NO. 3 CITY OF PONCA CITY
KAY,OFFICE NO. 2 KILDARE PUBLIC SCHOOL,MICHAEL S. SMITH,,360527,0,0,1,1,OFFICE NO. 2 KILDARE PUBLIC SCHOOL
KAY,OFFICE NO. 2 KILDARE PUBLIC SCHOOL,REBEKAH WIMER,,360527,0,0,1,1,OFFICE NO. 2 KILDARE PUBLIC SCHOOL
KAY,COMMISSIONER NO. 3 CITY OF PONCA CITY,SHASTA SCOTT,,360530,0,0,65,65,COMMISSIONER NO. 3 CITY OF PONCA CITY
KAY,COMMISSIONER NO. 3 CITY OF PONCA CITY,DANIEL L. SHERRON,,360530,2,0,57,59,COMMISSIONER NO. 3 CITY OF PONCA CITY
KAY,COMMISSIONER NO. 3 CITY OF PONCA CITY,SHASTA SCOTT,,360532,0,2,98,100,COMMISSIONER NO. 3 CITY OF PONCA CITY
KAY,COMMISSIONER NO. 3 CITY OF PONCA CITY,DANIEL L. SHERRON,,360532,0,1,73,74,COMMISSIONER NO. 3 CITY OF PONCA CITY
KAY,COMMISSIONER NO. 3 CITY OF PONCA CITY,SHASTA SCOTT,,360533,1,1,76,78,COMMISSIONER NO. 3 CITY OF PONCA CITY
KAY,COMMISSIONER NO. 3 CITY OF PONCA CITY,DANIEL L. SHERRON,,360533,0,0,55,55,COMMISSIONER NO. 3 CITY OF PONCA CITY
KAY,OFFICE NO. 2 KILDARE PUBLIC SCHOOL,MICHAEL S. SMITH,,360533,0,0,2,2,OFFICE NO. 2 KILDARE PUBLIC SCHOOL
KAY,OFFICE NO. 2 KILDARE PUBLIC SCHOOL,REBEKAH WIMER,,360533,0,0,3,3,OFFICE NO. 2 KILDARE PUBLIC SCHOOL
KAY,COMMISSIONER NO. 3 CITY OF PONCA CITY,SHASTA SCOTT,,360534,2,1,139,142,COMMISSIONER NO. 3 CITY OF PONCA CITY
KAY,COMMISSIONER NO. 3 CITY OF PONCA CITY,DANIEL L. SHERRON,,360534,1,1,95,97,COMMISSIONER NO. 3 CITY OF PONCA CITY
KAY,COMMISSIONER NO. 3 CITY OF PONCA CITY,SHASTA SCOTT,,360535,2,1,112,115,COMMISSIONER NO. 3 CITY OF PONCA CITY
KAY,COMMISSIONER NO. 3 CITY OF PONCA CITY,DANIEL L. SHERRON,,360535,1,1,63,65,COMMISSIONER NO. 3 CITY OF PONCA CITY
KINGFISHER,OFFICE NO. 2 FRANCIS TUTTLE TECH CENTER,PETE LEE,,370102,0,0,0,0,OFFICE NO. 2 FRANCIS TUTTLE TECH CENTER
KINGFISHER,OFFICE NO. 2 FRANCIS TUTTLE TECH CENTER,ROBERT STONE,,370102,0,0,0,0,OFFICE NO. 2 FRANCIS TUTTLE TECH CENTER
KINGFISHER,OFFICE NO. 2 OKARCHE PUBLIC SCHOOLS,HEATHER NANCE,,370103,0,0,2,2,OFFICE NO. 2 OKARCHE PUBLIC SCHOOLS
KINGFISHER,OFFICE NO. 2 OKARCHE PUBLIC SCHOOLS,DAVID MAYHEW,,370103,0,0,0,0,OFFICE NO. 2 OKARCHE PUBLIC SCHOOLS
KINGFISHER,OFFICE NO. 2 FRANCIS TUTTLE TECH CENTER,PETE LEE,,370103,0,0,0,0,OFFICE NO. 2 FRANCIS TUTTLE TECH CENTER
KINGFISHER,OFFICE NO. 2 FRANCIS TUTTLE TECH CENTER,ROBERT STONE,,370103,0,0,0,0,OFFICE NO. 2 FRANCIS TUTTLE TECH CENTER
KINGFISHER,OFFICE NO. 2 FRANCIS TUTTLE TECH CENTER,PETE LEE,,370105,1,0,0,1,OFFICE NO. 2 FRANCIS TUTTLE TECH CENTER
KINGFISHER,OFFICE NO. 2 FRANCIS TUTTLE TECH CENTER,ROBERT STONE,,370105,0,0,10,10,OFFICE NO. 2 FRANCIS TUTTLE TECH CENTER
KINGFISHER,OFFICE NO. 2 CRESCENT PUBLIC SCHOOLS,LISA GRAFF,,370106,0,0,17,17,OFFICE NO. 2 CRESCENT PUBLIC SCHOOLS
KINGFISHER,OFFICE NO. 2 CRESCENT PUBLIC SCHOOLS,TODD AUSCHWITZ,,370106,0,0,0,0,OFFICE NO. 2 CRESCENT PUBLIC SCHOOLS
KINGFISHER,OFFICE NO. 2 FRANCIS TUTTLE TECH CENTER,PETE LEE,,370106,0,0,2,2,OFFICE NO. 2 FRANCIS TUTTLE TECH CENTER
KINGFISHER,OFFICE NO. 2 FRANCIS TUTTLE TECH CENTER,ROBERT STONE,,370106,0,0,15,15,OFFICE NO. 2 FRANCIS TUTTLE TECH CENTER
KINGFISHER,OFFICE NO. 2 OKEENE PUBLIC SCHOOLS,MICHAEL WILLIAMS,,370201,0,0,0,0,OFFICE NO. 2 OKEENE PUBLIC SCHOOLS
KINGFISHER,OFFICE NO. 2 OKEENE PUBLIC SCHOOLS,BRANDON SWAIM,,370201,0,0,0,0,OFFICE NO. 2 OKEENE PUBLIC SCHOOLS
KINGFISHER,OFFICE NO. 2 CRESCENT PUBLIC SCHOOLS,LISA GRAFF,,370203,0,0,0,0,OFFICE NO. 2 CRESCENT PUBLIC SCHOOLS
KINGFISHER,OFFICE NO. 2 CRESCENT PUBLIC SCHOOLS,TODD AUSCHWITZ,,370203,0,0,0,0,OFFICE NO. 2 CRESCENT PUBLIC SCHOOLS
KINGFISHER,OFFICE NO. 2 FRANCIS TUTTLE TECH CENTER,PETE LEE,,370203,0,0,0,0,OFFICE NO. 2 FRANCIS TUTTLE TECH CENTER
KINGFISHER,OFFICE NO. 2 FRANCIS TUTTLE TECH CENTER,ROBERT STONE,,370203,0,0,0,0,OFFICE NO. 2 FRANCIS TUTTLE TECH CENTER
KINGFISHER,OFFICE NO. 2 LOMEGA PUBLIC SCHOOLS,LESLEY FISHER,,370301,0,0,7,7,OFFICE NO. 2 LOMEGA PUBLIC SCHOOLS
KINGFISHER,OFFICE NO. 2 LOMEGA PUBLIC SCHOOLS,CHERIE INGRAM,,370301,0,5,9,14,OFFICE NO. 2 LOMEGA PUBLIC SCHOOLS
KINGFISHER,OFFICE NO. 5 (UNEXPIRED TERM) LOMEGA PUBLIC SCHOOLS,LORI GLAZIER,,370301,0,0,1,1,OFFICE NO. 5 (UNEXPIRED TERM) LOMEGA PUBLIC SCHOOLS
KINGFISHER,OFFICE NO. 5 (UNEXPIRED TERM) LOMEGA PUBLIC SCHOOLS,MATTHEW R. OPPEL,,370301,0,5,15,20,OFFICE NO. 5 (UNEXPIRED TERM) LOMEGA PUBLIC SCHOOLS
KINGFISHER,OFFICE NO. 2 OKARCHE PUBLIC SCHOOLS,HEATHER NANCE,,370302,1,0,19,20,OFFICE NO. 2 OKARCHE PUBLIC SCHOOLS
KINGFISHER,OFFICE NO. 2 OKARCHE PUBLIC SCHOOLS,DAVID MAYHEW,,370302,2,0,6,8,OFFICE NO. 2 OKARCHE PUBLIC SCHOOLS
KINGFISHER,OFFICE NO. 2 LOMEGA PUBLIC SCHOOLS,LESLEY FISHER,,370303,0,0,0,0,OFFICE NO. 2 LOMEGA PUBLIC SCHOOLS
KINGFISHER,OFFICE NO. 2 LOMEGA PUBLIC SCHOOLS,CHERIE INGRAM,,370303,0,1,0,1,OFFICE NO. 2 LOMEGA PUBLIC SCHOOLS
KINGFISHER,OFFICE NO. 5 (UNEXPIRED TERM) LOMEGA PUBLIC SCHOOLS,LORI GLAZIER,,370303,0,0,0,0,OFFICE NO. 5 (UNEXPIRED TERM) LOMEGA PUBLIC SCHOOLS
KINGFISHER,OFFICE NO. 5 (UNEXPIRED TERM) LOMEGA PUBLIC SCHOOLS,MATTHEW R. OPPEL,,370303,0,0,0,0,OFFICE NO. 5 (UNEXPIRED TERM) LOMEGA PUBLIC SCHOOLS
KINGFISHER,OFFICE NO. 2 OKARCHE PUBLIC SCHOOLS,HEATHER NANCE,,370303,1,0,2,3,OFFICE NO. 2 OKARCHE PUBLIC SCHOOLS
KINGFISHER,OFFICE NO. 2 OKARCHE PUBLIC SCHOOLS,DAVID MAYHEW,,370303,0,0,0,0,OFFICE NO. 2 OKARCHE PUBLIC SCHOOLS
KINGFISHER,OFFICE NO. 2 OKEENE PUBLIC SCHOOLS,MICHAEL WILLIAMS,,370304,0,0,0,0,OFFICE NO. 2 OKEENE PUBLIC SCHOOLS
KINGFISHER,OFFICE NO. 2 OKEENE PUBLIC SCHOOLS,BRANDON SWAIM,,370304,0,0,0,0,OFFICE NO. 2 OKEENE PUBLIC SCHOOLS
KINGFISHER,OFFICE NO. 2 LOMEGA PUBLIC SCHOOLS,LESLEY FISHER,,370304,0,0,9,9,OFFICE NO. 2 LOMEGA PUBLIC SCHOOLS
KINGFISHER,OFFICE NO. 2 LOMEGA PUBLIC SCHOOLS,CHERIE INGRAM,,370304,1,6,62,69,OFFICE NO. 2 LOMEGA PUBLIC SCHOOLS
KINGFISHER,OFFICE NO. 5 (UNEXPIRED TERM) LOMEGA PUBLIC SCHOOLS,LORI GLAZIER,,370304,1,2,39,42,OFFICE NO. 5 (UNEXPIRED TERM) LOMEGA PUBLIC SCHOOLS
KINGFISHER,OFFICE NO. 5 (UNEXPIRED TERM) LOMEGA PUBLIC SCHOOLS,MATTHEW R. OPPEL,,370304,0,4,31,35,OFFICE NO. 5 (UNEXPIRED TERM) LOMEGA PUBLIC SCHOOLS
KINGFISHER,OFFICE NO. 2 LOMEGA PUBLIC SCHOOLS,LESLEY FISHER,,370305,0,2,1,3,OFFICE NO. 2 LOMEGA PUBLIC SCHOOLS
KINGFISHER,OFFICE NO. 2 LOMEGA PUBLIC SCHOOLS,CHERIE INGRAM,,370305,1,5,17,23,OFFICE NO. 2 LOMEGA PUBLIC SCHOOLS
KINGFISHER,OFFICE NO. 5 (UNEXPIRED TERM) LOMEGA PUBLIC SCHOOLS,LORI GLAZIER,,370305,1,4,10,15,OFFICE NO. 5 (UNEXPIRED TERM) LOMEGA PUBLIC SCHOOLS
KINGFISHER,OFFICE NO. 5 (UNEXPIRED TERM) LOMEGA PUBLIC SCHOOLS,MATTHEW R. OPPEL,,370305,0,3,8,11,OFFICE NO. 5 (UNEXPIRED TERM) LOMEGA PUBLIC SCHOOLS
KINGFISHER,OFFICE NO. 2 OKARCHE PUBLIC SCHOOLS,HEATHER NANCE,,370306,0,0,0,0,OFFICE NO. 2 OKARCHE PUBLIC SCHOOLS
KINGFISHER,OFFICE NO. 2 OKARCHE PUBLIC SCHOOLS,DAVID MAYHEW,,370306,0,0,0,0,OFFICE NO. 2 OKARCHE PUBLIC SCHOOLS
KIOWA,OFFICE NO. 2 WESTERN TECH CENTER,GARY D. SMITH,,380001,0,1,6,7,OFFICE NO. 2 WESTERN TECH CENTER
KIOWA,OFFICE NO. 2 WESTERN TECH CENTER,BILL JOHANNING,,380001,0,0,0,0,OFFICE NO. 2 WESTERN TECH CENTER
KIOWA,OFFICE NO. 3 SNYDER PUBLIC SCHOOLS,DREW JANZ,,380002,0,0,2,2,OFFICE NO. 3 SNYDER PUBLIC SCHOOLS
KIOWA,OFFICE NO. 3 SNYDER PUBLIC SCHOOLS,CARMEN McCORKLE,,380002,0,0,1,1,OFFICE NO. 3 SNYDER PUBLIC SCHOOLS
KIOWA,OFFICE NO. 2 WESTERN TECH CENTER,GARY D. SMITH,,380002,0,0,1,1,OFFICE NO. 2 WESTERN TECH CENTER
KIOWA,OFFICE NO. 2 WESTERN TECH CENTER,BILL JOHANNING,,380002,0,0,0,0,OFFICE NO. 2 WESTERN TECH CENTER
KIOWA,OFFICE NO. 2 WESTERN TECH CENTER,GARY D. SMITH,,380004,0,0,4,4,OFFICE NO. 2 WESTERN TECH CENTER
KIOWA,OFFICE NO. 2 WESTERN TECH CENTER,BILL JOHANNING,,380004,0,0,1,1,OFFICE NO. 2 WESTERN TECH CENTER
KIOWA,OFFICE NO. 2 WESTERN TECH CENTER,GARY D. SMITH,,380005,0,0,0,0,OFFICE NO. 2 WESTERN TECH CENTER
KIOWA,OFFICE NO. 2 WESTERN TECH CENTER,BILL JOHANNING,,380005,0,0,0,0,OFFICE NO. 2 WESTERN TECH CENTER
KIOWA,OFFICE NO. 2 MOUNTAIN VIEW-GOTEBO SCHOOLS,DUSTY HELLER,,380006,4,0,50,54,OFFICE NO. 2 MOUNTAIN VIEW-GOTEBO SCHOOLS
KIOWA,OFFICE NO. 2 MOUNTAIN VIEW-GOTEBO SCHOOLS,CECIL HOOPER,,380006,0,0,13,13,OFFICE NO. 2 MOUNTAIN VIEW-GOTEBO SCHOOLS
KIOWA,OFFICE NO. 3 SNYDER PUBLIC SCHOOLS,DREW JANZ,,380006,0,0,0,0,OFFICE NO. 3 SNYDER PUBLIC SCHOOLS
KIOWA,OFFICE NO. 3 SNYDER PUBLIC SCHOOLS,CARMEN McCORKLE,,380006,0,0,0,0,OFFICE NO. 3 SNYDER PUBLIC SCHOOLS
KIOWA,OFFICE NO. 2 WESTERN TECH CENTER,GARY D. SMITH,,380007,0,0,0,0,OFFICE NO. 2 WESTERN TECH CENTER
KIOWA,OFFICE NO. 2 WESTERN TECH CENTER,BILL JOHANNING,,380007,0,0,0,0,OFFICE NO. 2 WESTERN TECH CENTER
KIOWA,OFFICE NO. 2 WESTERN TECH CENTER,GARY D. SMITH,,380008,0,1,8,9,OFFICE NO. 2 WESTERN TECH CENTER
KIOWA,OFFICE NO. 2 WESTERN TECH CENTER,BILL JOHANNING,,380008,0,0,0,0,OFFICE NO. 2 WESTERN TECH CENTER
KIOWA,OFFICE NO. 2 MOUNTAIN VIEW-GOTEBO SCHOOLS,DUSTY HELLER,,380009,0,0,0,0,OFFICE NO. 2 MOUNTAIN VIEW-GOTEBO SCHOOLS
KIOWA,OFFICE NO. 2 MOUNTAIN VIEW-GOTEBO SCHOOLS,CECIL HOOPER,,380009,0,0,0,0,OFFICE NO. 2 MOUNTAIN VIEW-GOTEBO SCHOOLS
KIOWA,OFFICE NO. 3 SNYDER PUBLIC SCHOOLS,DREW JANZ,,380009,0,0,0,0,OFFICE NO. 3 SNYDER PUBLIC SCHOOLS
KIOWA,OFFICE NO. 3 SNYDER PUBLIC SCHOOLS,CARMEN McCORKLE,,380009,0,0,0,0,OFFICE NO. 3 SNYDER PUBLIC SCHOOLS
KIOWA,OFFICE NO. 2 WESTERN TECH CENTER,GARY D. SMITH,,380009,0,0,0,0,OFFICE NO. 2 WESTERN TECH CENTER
KIOWA,OFFICE NO. 2 WESTERN TECH CENTER,BILL JOHANNING,,380009,0,0,0,0,OFFICE NO. 2 WESTERN TECH CENTER
KIOWA,OFFICE NO. 2 MOUNTAIN VIEW-GOTEBO SCHOOLS,DUSTY HELLER,,380010,3,0,78,81,OFFICE NO. 2 MOUNTAIN VIEW-GOTEBO SCHOOLS
KIOWA,OFFICE NO. 2 MOUNTAIN VIEW-GOTEBO SCHOOLS,CECIL HOOPER,,380010,2,2,86,90,OFFICE NO. 2 MOUNTAIN VIEW-GOTEBO SCHOOLS
KIOWA,OFFICE NO. 2 BLAIR PUBLIC SCHOOLS,SHANE CHAPMAN,,380011,0,0,0,0,OFFICE NO. 2 BLAIR PUBLIC SCHOOLS
KIOWA,OFFICE NO. 2 BLAIR PUBLIC SCHOOLS,BRANDI BOLEY,,380011,0,0,0,0,OFFICE NO. 2 BLAIR PUBLIC SCHOOLS
KIOWA,OFFICE NO. 4 (UNEXPIRED TERM) BLAIR PUBLIC SCHOOLS,MARIANNE J. NAGY,,380011,0,0,0,0,OFFICE NO. 4 (UNEXPIRED TERM) BLAIR PUBLIC SCHOOLS
KIOWA,OFFICE NO. 4 (UNEXPIRED TERM) BLAIR PUBLIC SCHOOLS,JEREMY RODRIQUEZ,,380011,0,0,0,0,OFFICE NO. 4 (UNEXPIRED TERM) BLAIR PUBLIC SCHOOLS
KIOWA,PROPOSITION BLAIR PUBLIC SCHOOLS,FOR THE PROPOSITION - YES,,380011,0,0,0,0,
KIOWA,PROPOSITION BLAIR PUBLIC SCHOOLS,AGAINST THE PROPOSITION - NO,,380011,0,0,0,0,
KIOWA,OFFICE NO. 2 WESTERN TECH CENTER,GARY D. SMITH,,380011,0,0,1,1,OFFICE NO. 2 WESTERN TECH CENTER
KIOWA,OFFICE NO. 2 WESTERN TECH CENTER,BILL JOHANNING,,380011,0,0,2,2,OFFICE NO. 2 WESTERN TECH CENTER
KIOWA,OFFICE NO. 3 SNYDER PUBLIC SCHOOLS,DREW JANZ,,380014,2,0,141,143,OFFICE NO. 3 SNYDER PUBLIC SCHOOLS
KIOWA,OFFICE NO. 3 SNYDER PUBLIC SCHOOLS,CARMEN McCORKLE,,380014,0,0,42,42,OFFICE NO. 3 SNYDER PUBLIC SCHOOLS
KIOWA,OFFICE NO. 2 MOUNTAIN VIEW-GOTEBO SCHOOLS,DUSTY HELLER,,380015,0,0,0,0,OFFICE NO. 2 MOUNTAIN VIEW-GOTEBO SCHOOLS
KIOWA,OFFICE NO. 2 MOUNTAIN VIEW-GOTEBO SCHOOLS,CECIL HOOPER,,380015,0,0,0,0,OFFICE NO. 2 MOUNTAIN VIEW-GOTEBO SCHOOLS
KIOWA,OFFICE NO. 3 SNYDER PUBLIC SCHOOLS,DREW JANZ,,380015,0,0,18,18,OFFICE NO. 3 SNYDER PUBLIC SCHOOLS
KIOWA,OFFICE NO. 3 SNYDER PUBLIC SCHOOLS,CARMEN McCORKLE,,380015,0,0,4,4,OFFICE NO. 3 SNYDER PUBLIC SCHOOLS
KIOWA,OFFICE NO. 2 WESTERN TECH CENTER,GARY D. SMITH,,380015,0,0,1,1,OFFICE NO. 2 WESTERN TECH CENTER
KIOWA,OFFICE NO. 2 WESTERN TECH CENTER,BILL JOHANNING,,380015,0,0,0,0,OFFICE NO. 2 WESTERN TECH CENTER
KIOWA,OFFICE NO. 3 SNYDER PUBLIC SCHOOLS,DREW JANZ,,380016,0,2,5,7,OFFICE NO. 3 SNYDER PUBLIC SCHOOLS
KIOWA,OFFICE NO. 3 SNYDER PUBLIC SCHOOLS,CARMEN McCORKLE,,380016,0,0,2,2,OFFICE NO. 3 SNYDER PUBLIC SCHOOLS
KIOWA,OFFICE NO. 3 SNYDER PUBLIC SCHOOLS,DREW JANZ,,380022,1,2,21,24,OFFICE NO. 3 SNYDER PUBLIC SCHOOLS
KIOWA,OFFICE NO. 3 SNYDER PUBLIC SCHOOLS,CARMEN McCORKLE,,380022,2,0,18,20,OFFICE NO. 3 SNYDER PUBLIC SCHOOLS
LATIMER,PROPOSITION CROWDER PUBLIC SCHOOLS,FOR THE PROPOSITION - YES,,390003,0,0,0,0,
LATIMER,PROPOSITION CROWDER PUBLIC SCHOOLS,AGAINST THE PROPOSITION - NO,,390003,0,0,0,0,
LATIMER,PROPOSITION BUFFALO VALLEY PUBLIC SCHOOLS,FOR THE PROPOSITION - YES,,390008,0,2,91,93,
LATIMER,PROPOSITION BUFFALO VALLEY PUBLIC SCHOOLS,AGAINST THE PROPOSITION - NO,,390008,0,1,10,11,
LATIMER,PROPOSITION BUFFALO VALLEY PUBLIC SCHOOLS,FOR THE PROPOSITION - YES,,390009,0,1,25,26,
LATIMER,PROPOSITION BUFFALO VALLEY PUBLIC SCHOOLS,AGAINST THE PROPOSITION - NO,,390009,0,1,4,5,
LATIMER,OFFICE NO. 2 LEFLORE PUBLIC SCHOOLS,BRANDY NEWMAN,,390009,0,0,0,0,OFFICE NO. 2 LEFLORE PUBLIC SCHOOLS
LATIMER,OFFICE NO. 2 LEFLORE PUBLIC SCHOOLS,KELLY E. SINGLETERRY,,390009,0,0,0,0,OFFICE NO. 2 LEFLORE PUBLIC SCHOOLS
LATIMER,OFFICE NO. 2 LEFLORE PUBLIC SCHOOLS,BRANDY NEWMAN,,390010,0,0,0,0,OFFICE NO. 2 LEFLORE PUBLIC SCHOOLS
LATIMER,OFFICE NO. 2 LEFLORE PUBLIC SCHOOLS,KELLY E. SINGLETERRY,,390010,0,0,0,0,OFFICE NO. 2 LEFLORE PUBLIC SCHOOLS
LATIMER,OFFICE NO. 2 LEFLORE PUBLIC SCHOOLS,BRANDY NEWMAN,,390012,0,1,34,35,OFFICE NO. 2 LEFLORE PUBLIC SCHOOLS
LATIMER,OFFICE NO. 2 LEFLORE PUBLIC SCHOOLS,KELLY E. SINGLETERRY,,390012,1,0,3,4,OFFICE NO. 2 LEFLORE PUBLIC SCHOOLS
LEFLORE,OFFICE NO. 2 SPIRO PUBLIC SCHOOLS,HENRY L. BURRIS,,400101,0,1,27,28,OFFICE NO. 2 SPIRO PUBLIC SCHOOLS
LEFLORE,OFFICE NO. 2 SPIRO PUBLIC SCHOOLS,BRANDON HARPER,,400101,0,0,13,13,OFFICE NO. 2 SPIRO PUBLIC SCHOOLS
LEFLORE,OFFICE NO. 2 SPIRO PUBLIC SCHOOLS,HENRY L. BURRIS,,400102,0,1,78,79,OFFICE NO. 2 SPIRO PUBLIC SCHOOLS
LEFLORE,OFFICE NO. 2 SPIRO PUBLIC SCHOOLS,BRANDON HARPER,,400102,3,0,50,53,OFFICE NO. 2 SPIRO PUBLIC SCHOOLS
LEFLORE,OFFICE NO. 2 SPIRO PUBLIC SCHOOLS,HENRY L. BURRIS,,400103,5,1,77,83,OFFICE NO. 2 SPIRO PUBLIC SCHOOLS
LEFLORE,OFFICE NO. 2 SPIRO PUBLIC SCHOOLS,BRANDON HARPER,,400103,8,2,34,44,OFFICE NO. 2 SPIRO PUBLIC SCHOOLS
LEFLORE,OFFICE NO. 2 SPIRO PUBLIC SCHOOLS,HENRY L. BURRIS,,400104,4,0,73,77,OFFICE NO. 2 SPIRO PUBLIC SCHOOLS
LEFLORE,OFFICE NO. 2 SPIRO PUBLIC SCHOOLS,BRANDON HARPER,,400104,0,2,2,4,OFFICE NO. 2 SPIRO PUBLIC SCHOOLS
LEFLORE,OFFICE NO. 2 SPIRO PUBLIC SCHOOLS,HENRY L. BURRIS,,400105,0,1,53,54,OFFICE NO. 2 SPIRO PUBLIC SCHOOLS
LEFLORE,OFFICE NO. 2 SPIRO PUBLIC SCHOOLS,BRANDON HARPER,,400105,0,0,33,33,OFFICE NO. 2 SPIRO PUBLIC SCHOOLS
LEFLORE,OFFICE NO. 4 (UNEXPIRED TERM) POCOLA PUBLIC SCHOOLS,JOE PIOVESAN,,400106,0,0,43,43,OFFICE NO. 4 (UNEXPIRED TERM) POCOLA PUBLIC SCHOOLS
LEFLORE,OFFICE NO. 4 (UNEXPIRED TERM) POCOLA PUBLIC SCHOOLS,ROBYN CROOP,,400106,0,0,5,5,OFFICE NO. 4 (UNEXPIRED TERM) POCOLA PUBLIC SCHOOLS
LEFLORE,OFFICE NO. 2 CAMERON PUBLIC SCHOOLS,ORBIE FITZER,,400107,0,0,0,0,OFFICE NO. 2 CAMERON PUBLIC SCHOOLS
LEFLORE,OFFICE NO. 2 CAMERON PUBLIC SCHOOLS,JOHN HAMBRICK,,400107,0,0,0,0,OFFICE NO. 2 CAMERON PUBLIC SCHOOLS
LEFLORE,OFFICE NO. 4 (UNEXPIRED TERM) POCOLA PUBLIC SCHOOLS,JOE PIOVESAN,,400107,0,0,117,117,OFFICE NO. 4 (UNEXPIRED TERM) POCOLA PUBLIC SCHOOLS
LEFLORE,OFFICE NO. 4 (UNEXPIRED TERM) POCOLA PUBLIC SCHOOLS,ROBYN CROOP,,400107,0,0,13,13,OFFICE NO. 4 (UNEXPIRED TERM) POCOLA PUBLIC SCHOOLS
LEFLORE,OFFICE NO. 2 CAMERON PUBLIC SCHOOLS,ORBIE FITZER,,400109,0,0,37,37,OFFICE NO. 2 CAMERON PUBLIC SCHOOLS
LEFLORE,OFFICE NO. 2 CAMERON PUBLIC SCHOOLS,JOHN HAMBRICK,,400109,0,0,18,18,OFFICE NO. 2 CAMERON PUBLIC SCHOOLS
LEFLORE,OFFICE NO. 2 SPIRO PUBLIC SCHOOLS,HENRY L. BURRIS,,400110,0,0,0,0,OFFICE NO. 2 SPIRO PUBLIC SCHOOLS
LEFLORE,OFFICE NO. 2 SPIRO PUBLIC SCHOOLS,BRANDON HARPER,,400110,0,0,0,0,OFFICE NO. 2 SPIRO PUBLIC SCHOOLS
LEFLORE,OFFICE NO. 2 SPIRO PUBLIC SCHOOLS,HENRY L. BURRIS,,400113,1,1,31,33,OFFICE NO. 2 SPIRO PUBLIC SCHOOLS
LEFLORE,OFFICE NO. 2 SPIRO PUBLIC SCHOOLS,BRANDON HARPER,,400113,0,0,12,12,OFFICE NO. 2 SPIRO PUBLIC SCHOOLS
LEFLORE,OFFICE NO. 2 CAMERON PUBLIC SCHOOLS,ORBIE FITZER,,400204,0,0,0,0,OFFICE NO. 2 CAMERON PUBLIC SCHOOLS
LEFLORE,OFFICE NO. 2 CAMERON PUBLIC SCHOOLS,JOHN HAMBRICK,,400204,0,0,0,0,OFFICE NO. 2 CAMERON PUBLIC SCHOOLS
LEFLORE,OFFICE NO. 2 CAMERON PUBLIC SCHOOLS,ORBIE FITZER,,400210,0,0,4,4,OFFICE NO. 2 CAMERON PUBLIC SCHOOLS
LEFLORE,OFFICE NO. 2 CAMERON PUBLIC SCHOOLS,JOHN HAMBRICK,,400210,0,0,1,1,OFFICE NO. 2 CAMERON PUBLIC SCHOOLS
LEFLORE,OFFICE NO. 2 LEFLORE PUBLIC SCHOOLS,BRANDY NEWMAN,,400214,1,0,38,39,OFFICE NO. 2 LEFLORE PUBLIC SCHOOLS
LEFLORE,OFFICE NO. 2 LEFLORE PUBLIC SCHOOLS,KELLY E. SINGLETERRY,,400214,0,0,6,6,OFFICE NO. 2 LEFLORE PUBLIC SCHOOLS
LEFLORE,OFFICE NO. 2 LEFLORE PUBLIC SCHOOLS,BRANDY NEWMAN,,400215,0,0,40,40,OFFICE NO. 2 LEFLORE PUBLIC SCHOOLS
LEFLORE,OFFICE NO. 2 LEFLORE PUBLIC SCHOOLS,KELLY E. SINGLETERRY,,400215,0,0,57,57,OFFICE NO. 2 LEFLORE PUBLIC SCHOOLS
LEFLORE,OFFICE NO. 2 LEFLORE PUBLIC SCHOOLS,BRANDY NEWMAN,,400302,0,0,0,0,OFFICE NO. 2 LEFLORE PUBLIC SCHOOLS
LEFLORE,OFFICE NO. 2 LEFLORE PUBLIC SCHOOLS,KELLY E. SINGLETERRY,,400302,0,0,0,0,OFFICE NO. 2 LEFLORE PUBLIC SCHOOLS
LEFLORE,OFFICE NO. 2 WHITESBORO PUBLIC SCHOOLS,RUSSELL BARRON,,400302,1,0,96,97,OFFICE NO. 2 WHITESBORO PUBLIC SCHOOLS
LEFLORE,OFFICE NO. 2 WHITESBORO PUBLIC SCHOOLS,CATHY WALLER,,400302,0,0,25,25,OFFICE NO. 2 WHITESBORO PUBLIC SCHOOLS
LEFLORE,OFFICE NO. 2 HEAVENER PUBLIC SCHOOLS,MICHAEL WHITE,,400303,0,0,0,0,OFFICE NO. 2 HEAVENER PUBLIC SCHOOLS
LEFLORE,OFFICE NO. 2 HEAVENER PUBLIC SCHOOLS,SHANNON C. WARD,,400303,0,0,0,0,OFFICE NO. 2 HEAVENER PUBLIC SCHOOLS
LEFLORE,OFFICE NO. 2 HEAVENER PUBLIC SCHOOLS,JASON S TIFFEE,,400303,0,0,0,0,OFFICE NO. 2 HEAVENER PUBLIC SCHOOLS
LEFLORE,OFFICE NO. 2 WHITESBORO PUBLIC SCHOOLS,RUSSELL BARRON,,400303,0,0,35,35,OFFICE NO. 2 WHITESBORO PUBLIC SCHOOLS
LEFLORE,OFFICE NO. 2 WHITESBORO PUBLIC SCHOOLS,CATHY WALLER,,400303,0,0,26,26,OFFICE NO. 2 WHITESBORO PUBLIC SCHOOLS
LEFLORE,OFFICE NO. 2 WHITESBORO PUBLIC SCHOOLS,RUSSELL BARRON,,400304,0,0,0,0,OFFICE NO. 2 WHITESBORO PUBLIC SCHOOLS
LEFLORE,OFFICE NO. 2 WHITESBORO PUBLIC SCHOOLS,CATHY WALLER,,400304,0,0,0,0,OFFICE NO. 2 WHITESBORO PUBLIC SCHOOLS
LEFLORE,OFFICE NO. 2 HEAVENER PUBLIC SCHOOLS,MICHAEL WHITE,,400305,0,0,3,3,OFFICE NO. 2 HEAVENER PUBLIC SCHOOLS
LEFLORE,OFFICE NO. 2 HEAVENER PUBLIC SCHOOLS,SHANNON C. WARD,,400305,0,0,0,0,OFFICE NO. 2 HEAVENER PUBLIC SCHOOLS
LEFLORE,OFFICE NO. 2 HEAVENER PUBLIC SCHOOLS,JASON S TIFFEE,,400305,0,0,0,0,OFFICE NO. 2 HEAVENER PUBLIC SCHOOLS
LEFLORE,OFFICE NO. 2 LEFLORE PUBLIC SCHOOLS,BRANDY NEWMAN,,400305,0,0,0,0,OFFICE NO. 2 LEFLORE PUBLIC SCHOOLS
LEFLORE,OFFICE NO. 2 LEFLORE PUBLIC SCHOOLS,KELLY E. SINGLETERRY,,400305,2,0,0,2,OFFICE NO. 2 LEFLORE PUBLIC SCHOOLS
LEFLORE,OFFICE NO. 2 WHITESBORO PUBLIC SCHOOLS,RUSSELL BARRON,,400305,0,0,0,0,OFFICE NO. 2 WHITESBORO PUBLIC SCHOOLS
LEFLORE,OFFICE NO. 2 WHITESBORO PUBLIC SCHOOLS,CATHY WALLER,,400305,0,0,0,0,OFFICE NO. 2 WHITESBORO PUBLIC SCHOOLS
LEFLORE,OFFICE NO. 2 HEAVENER PUBLIC SCHOOLS,MICHAEL WHITE,,400309,0,0,3,3,OFFICE NO. 2 HEAVENER PUBLIC SCHOOLS
LEFLORE,OFFICE NO. 2 HEAVENER PUBLIC SCHOOLS,SHANNON C. WARD,,400309,0,0,3,3,OFFICE NO. 2 HEAVENER PUBLIC SCHOOLS
LEFLORE,OFFICE NO. 2 HEAVENER PUBLIC SCHOOLS,JASON S TIFFEE,,400309,0,0,1,1,OFFICE NO. 2 HEAVENER PUBLIC SCHOOLS
LEFLORE,OFFICE NO. 2 LEFLORE PUBLIC SCHOOLS,BRANDY NEWMAN,,400309,0,0,5,5,OFFICE NO. 2 LEFLORE PUBLIC SCHOOLS
LEFLORE,OFFICE NO. 2 LEFLORE PUBLIC SCHOOLS,KELLY E. SINGLETERRY,,400309,0,0,4,4,OFFICE NO. 2 LEFLORE PUBLIC SCHOOLS
LEFLORE,OFFICE NO. 2 HEAVENER PUBLIC SCHOOLS,MICHAEL WHITE,,400310,0,0,39,39,OFFICE NO. 2 HEAVENER PUBLIC SCHOOLS
LEFLORE,OFFICE NO. 2 HEAVENER PUBLIC SCHOOLS,SHANNON C. WARD,,400310,0,0,19,19,OFFICE NO. 2 HEAVENER PUBLIC SCHOOLS
LEFLORE,OFFICE NO. 2 HEAVENER PUBLIC SCHOOLS,JASON S TIFFEE,,400310,0,1,19,20,OFFICE NO. 2 HEAVENER PUBLIC SCHOOLS
LEFLORE,OFFICE NO. 2 HEAVENER PUBLIC SCHOOLS,MICHAEL WHITE,,400311,0,0,18,18,OFFICE NO. 2 HEAVENER PUBLIC SCHOOLS
LEFLORE,OFFICE NO. 2 HEAVENER PUBLIC SCHOOLS,SHANNON C. WARD,,400311,0,1,11,12,OFFICE NO. 2 HEAVENER PUBLIC SCHOOLS
LEFLORE,OFFICE NO. 2 HEAVENER PUBLIC SCHOOLS,JASON S TIFFEE,,400311,0,0,8,8,OFFICE NO. 2 HEAVENER PUBLIC SCHOOLS
LEFLORE,OFFICE NO. 2 HEAVENER PUBLIC SCHOOLS,MICHAEL WHITE,,400312,0,0,6,6,OFFICE NO. 2 HEAVENER PUBLIC SCHOOLS
LEFLORE,OFFICE NO. 2 HEAVENER PUBLIC SCHOOLS,SHANNON C. WARD,,400312,0,0,3,3,OFFICE NO. 2 HEAVENER PUBLIC SCHOOLS
LEFLORE,OFFICE NO. 2 HEAVENER PUBLIC SCHOOLS,JASON S TIFFEE,,400312,0,0,1,1,OFFICE NO. 2 HEAVENER PUBLIC SCHOOLS
LINCOLN,PROPOSITION CITY OF STROUD,FOR THE PROPOSITION - YES,,410001,5,0,46,51,
LINCOLN,PROPOSITION CITY OF STROUD,AGAINST THE PROPOSITION - NO,,410001,4,0,33,37,
LINCOLN,PROPOSITION CITY OF STROUD,FOR THE PROPOSITION - YES,,410002,0,1,74,75,
LINCOLN,PROPOSITION CITY OF STROUD,AGAINST THE PROPOSITION - NO,,410002,1,1,41,43,
LINCOLN,OFFICE NO. 2 CHANDLER PUBLIC SCHOOLS,WOODY ELMORE,,410003,0,0,8,8,OFFICE NO. 2 CHANDLER PUBLIC SCHOOLS
LINCOLN,OFFICE NO. 2 CHANDLER PUBLIC SCHOOLS,MIKE CHRISTY,,410003,1,5,8,14,OFFICE NO. 2 CHANDLER PUBLIC SCHOOLS
LINCOLN,OFFICE NO. 2 AGRA PUBLIC SCHOOLS,KEITH GLADDEN,,410004,0,0,0,0,OFFICE NO. 2 AGRA PUBLIC SCHOOLS
LINCOLN,OFFICE NO. 2 AGRA PUBLIC SCHOOLS,KYLE A. WOLFF,,410004,0,1,28,29,OFFICE NO. 2 AGRA PUBLIC SCHOOLS
LINCOLN,OFFICE NO. 2 AGRA PUBLIC SCHOOLS,KEITH GLADDEN,,410005,0,0,14,14,OFFICE NO. 2 AGRA PUBLIC SCHOOLS
LINCOLN,OFFICE NO. 2 AGRA PUBLIC SCHOOLS,KYLE A. WOLFF,,410005,2,2,102,106,OFFICE NO. 2 AGRA PUBLIC SCHOOLS
LINCOLN,OFFICE NO. 2 CHANDLER PUBLIC SCHOOLS,WOODY ELMORE,,410005,0,2,2,4,OFFICE NO. 2 CHANDLER PUBLIC SCHOOLS
LINCOLN,OFFICE NO. 2 CHANDLER PUBLIC SCHOOLS,MIKE CHRISTY,,410005,0,3,6,9,OFFICE NO. 2 CHANDLER PUBLIC SCHOOLS
LINCOLN,OFFICE NO. 2 AGRA PUBLIC SCHOOLS,KEITH GLADDEN,,410007,1,0,0,1,OFFICE NO. 2 AGRA PUBLIC SCHOOLS
LINCOLN,OFFICE NO. 2 AGRA PUBLIC SCHOOLS,KYLE A. WOLFF,,410007,0,0,0,0,OFFICE NO. 2 AGRA PUBLIC SCHOOLS
LINCOLN,OFFICE NO. 2 CHANDLER PUBLIC SCHOOLS,WOODY ELMORE,,410007,0,0,0,0,OFFICE NO. 2 CHANDLER PUBLIC SCHOOLS
LINCOLN,OFFICE NO. 2 CHANDLER PUBLIC SCHOOLS,MIKE CHRISTY,,410007,0,0,0,0,OFFICE NO. 2 CHANDLER PUBLIC SCHOOLS
LINCOLN,OFFICE NO. 2 LUTHER PUBLIC SCHOOLS,TONY RUMPL,,410008,0,0,2,2,OFFICE NO. 2 LUTHER PUBLIC SCHOOLS
LINCOLN,OFFICE NO. 2 LUTHER PUBLIC SCHOOLS,MATTHEW MOHR,,410008,0,0,1,1,OFFICE NO. 2 LUTHER PUBLIC SCHOOLS
LINCOLN,OFFICE NO. 2 LUTHER PUBLIC SCHOOLS,GERALD McCAULEY,,410008,0,0,0,0,OFFICE NO. 2 LUTHER PUBLIC SCHOOLS
LINCOLN,OFFICE NO. 2 CHANDLER PUBLIC SCHOOLS,WOODY ELMORE,,410009,0,3,10,13,OFFICE NO. 2 CHANDLER PUBLIC SCHOOLS
LINCOLN,OFFICE NO. 2 CHANDLER PUBLIC SCHOOLS,MIKE CHRISTY,,410009,0,2,1,3,OFFICE NO. 2 CHANDLER PUBLIC SCHOOLS
LINCOLN,OFFICE NO. 2 CHANDLER PUBLIC SCHOOLS,WOODY ELMORE,,410010,0,12,42,54,OFFICE NO. 2 CHANDLER PUBLIC SCHOOLS
LINCOLN,OFFICE NO. 2 CHANDLER PUBLIC SCHOOLS,MIKE CHRISTY,,410010,2,38,91,131,OFFICE NO. 2 CHANDLER PUBLIC SCHOOLS
LINCOLN,OFFICE NO. 2 CHANDLER PUBLIC SCHOOLS,WOODY ELMORE,,410011,0,7,31,38,OFFICE NO. 2 CHANDLER PUBLIC SCHOOLS
LINCOLN,OFFICE NO. 2 CHANDLER PUBLIC SCHOOLS,MIKE CHRISTY,,410011,2,26,66,94,OFFICE NO. 2 CHANDLER PUBLIC SCHOOLS
LINCOLN,OFFICE NO. 2 MEEKER PUBLIC SCHOOLS,JESSICA GABEAU,,410011,0,1,0,1,OFFICE NO. 2 MEEKER PUBLIC SCHOOLS
LINCOLN,OFFICE NO. 2 MEEKER PUBLIC SCHOOLS,BRET WOOD,,410011,0,0,0,0,OFFICE NO. 2 MEEKER PUBLIC SCHOOLS
LINCOLN,OFFICE NO. 2 CHANDLER PUBLIC SCHOOLS,WOODY ELMORE,,410012,0,4,25,29,OFFICE NO. 2 CHANDLER PUBLIC SCHOOLS
LINCOLN,OFFICE NO. 2 CHANDLER PUBLIC SCHOOLS,MIKE CHRISTY,,410012,5,25,74,104,OFFICE NO. 2 CHANDLER PUBLIC SCHOOLS
LINCOLN,OFFICE NO. 2 MEEKER PUBLIC SCHOOLS,JESSICA GABEAU,,410012,0,0,0,0,OFFICE NO. 2 MEEKER PUBLIC SCHOOLS
LINCOLN,OFFICE NO. 2 MEEKER PUBLIC SCHOOLS,BRET WOOD,,410012,0,0,0,0,OFFICE NO. 2 MEEKER PUBLIC SCHOOLS
LINCOLN,OFFICE NO. 2 MCLOUD PUBLIC SCHOOLS,MELANIE KRAUSE,,410015,0,0,5,5,OFFICE NO. 2 MCLOUD PUBLIC SCHOOLS
LINCOLN,OFFICE NO. 2 MCLOUD PUBLIC SCHOOLS,STEVEN M. SWARTZ,,410015,2,0,3,5,OFFICE NO. 2 MCLOUD PUBLIC SCHOOLS
LINCOLN,OFFICE NO. 2 MCLOUD PUBLIC SCHOOLS,JEANNENE WILLIAMS,,410015,0,0,0,0,OFFICE NO. 2 MCLOUD PUBLIC SCHOOLS
LINCOLN,OFFICE NO. 2 CHANDLER PUBLIC SCHOOLS,WOODY ELMORE,,410016,0,0,0,0,OFFICE NO. 2 CHANDLER PUBLIC SCHOOLS
LINCOLN,OFFICE NO. 2 CHANDLER PUBLIC SCHOOLS,MIKE CHRISTY,,410016,0,0,0,0,OFFICE NO. 2 CHANDLER PUBLIC SCHOOLS
LINCOLN,OFFICE NO. 2 MEEKER PUBLIC SCHOOLS,JESSICA GABEAU,,410016,4,0,12,16,OFFICE NO. 2 MEEKER PUBLIC SCHOOLS
LINCOLN,OFFICE NO. 2 MEEKER PUBLIC SCHOOLS,BRET WOOD,,410016,1,0,24,25,OFFICE NO. 2 MEEKER PUBLIC SCHOOLS
LINCOLN,OFFICE NO. 2 MCLOUD PUBLIC SCHOOLS,MELANIE KRAUSE,,410016,0,0,0,0,OFFICE NO. 2 MCLOUD PUBLIC SCHOOLS
LINCOLN,OFFICE NO. 2 MCLOUD PUBLIC SCHOOLS,STEVEN M. SWARTZ,,410016,0,0,0,0,OFFICE NO. 2 MCLOUD PUBLIC SCHOOLS
LINCOLN,OFFICE NO. 2 MCLOUD PUBLIC SCHOOLS,JEANNENE WILLIAMS,,410016,0,0,0,0,OFFICE NO. 2 MCLOUD PUBLIC SCHOOLS
LINCOLN,OFFICE NO. 2 CHANDLER PUBLIC SCHOOLS,WOODY ELMORE,,410017,0,0,0,0,OFFICE NO. 2 CHANDLER PUBLIC SCHOOLS
LINCOLN,OFFICE NO. 2 CHANDLER PUBLIC SCHOOLS,MIKE CHRISTY,,410017,0,0,0,0,OFFICE NO. 2 CHANDLER PUBLIC SCHOOLS
LINCOLN,OFFICE NO. 2 MEEKER PUBLIC SCHOOLS,JESSICA GABEAU,,410017,0,0,3,3,OFFICE NO. 2 MEEKER PUBLIC SCHOOLS
LINCOLN,OFFICE NO. 2 MEEKER PUBLIC SCHOOLS,BRET WOOD,,410017,2,0,2,4,OFFICE NO. 2 MEEKER PUBLIC SCHOOLS
LINCOLN,OFFICE NO. 2 MEEKER PUBLIC SCHOOLS,JESSICA GABEAU,,410018,1,0,14,15,OFFICE NO. 2 MEEKER PUBLIC SCHOOLS
LINCOLN,OFFICE NO. 2 MEEKER PUBLIC SCHOOLS,BRET WOOD,,410018,0,0,33,33,OFFICE NO. 2 MEEKER PUBLIC SCHOOLS
LINCOLN,OFFICE NO. 2 MEEKER PUBLIC SCHOOLS,JESSICA GABEAU,,410019,0,2,29,31,OFFICE NO. 2 MEEKER PUBLIC SCHOOLS
LINCOLN,OFFICE NO. 2 MEEKER PUBLIC SCHOOLS,BRET WOOD,,410019,6,0,51,57,OFFICE NO. 2 MEEKER PUBLIC SCHOOLS
LINCOLN,OFFICE NO. 2 LUTHER PUBLIC SCHOOLS,TONY RUMPL,,410020,0,0,0,0,OFFICE NO. 2 LUTHER PUBLIC SCHOOLS
LINCOLN,OFFICE NO. 2 LUTHER PUBLIC SCHOOLS,MATTHEW MOHR,,410020,0,0,0,0,OFFICE NO. 2 LUTHER PUBLIC SCHOOLS
LINCOLN,OFFICE NO. 2 LUTHER PUBLIC SCHOOLS,GERALD McCAULEY,,410020,0,0,0,0,OFFICE NO. 2 LUTHER PUBLIC SCHOOLS
LINCOLN,OFFICE NO. 2 MEEKER PUBLIC SCHOOLS,JESSICA GABEAU,,410021,0,0,1,1,OFFICE NO. 2 MEEKER PUBLIC SCHOOLS
LINCOLN,OFFICE NO. 2 MEEKER PUBLIC SCHOOLS,BRET WOOD,,410021,0,0,0,0,OFFICE NO. 2 MEEKER PUBLIC SCHOOLS
LOGAN,OFFICE NO. 6 GUTHRIE PUBLIC SCHOOLS,EDDIE LYNN,,420101,0,0,0,0,OFFICE NO. 6 GUTHRIE PUBLIC SCHOOLS
LOGAN,OFFICE NO. 6 GUTHRIE PUBLIC SCHOOLS,GINA DAVIS,,420101,0,0,2,2,OFFICE NO. 6 GUTHRIE PUBLIC SCHOOLS
LOGAN,OFFICE NO. 2 DEER CREEK PUBLIC SCHOOLS,TOM CORBIN,,420101,0,0,0,0,OFFICE NO. 2 DEER CREEK PUBLIC SCHOOLS
LOGAN,OFFICE NO. 2 DEER CREEK PUBLIC SCHOOLS,ANDI NEAVES,,420101,2,0,4,6,OFFICE NO. 2 DEER CREEK PUBLIC SCHOOLS
LOGAN,OFFICE NO. 2 FRANCIS TUTTLE TECH CENTER,PETE LEE,,420101,0,0,3,3,OFFICE NO. 2 FRANCIS TUTTLE TECH CENTER
LOGAN,OFFICE NO. 2 FRANCIS TUTTLE TECH CENTER,ROBERT STONE,,420101,2,0,2,4,OFFICE NO. 2 FRANCIS TUTTLE TECH CENTER
LOGAN,OFFICE NO. 2 CRESCENT PUBLIC SCHOOLS,LISA GRAFF,,420102,0,0,0,0,OFFICE NO. 2 CRESCENT PUBLIC SCHOOLS
LOGAN,OFFICE NO. 2 CRESCENT PUBLIC SCHOOLS,TODD AUSCHWITZ,,420102,0,0,0,0,OFFICE NO. 2 CRESCENT PUBLIC SCHOOLS
LOGAN,OFFICE NO. 6 GUTHRIE PUBLIC SCHOOLS,EDDIE LYNN,,420102,2,1,15,18,OFFICE NO. 6 GUTHRIE PUBLIC SCHOOLS
LOGAN,OFFICE NO. 6 GUTHRIE PUBLIC SCHOOLS,GINA DAVIS,,420102,5,1,52,58,OFFICE NO. 6 GUTHRIE PUBLIC SCHOOLS
LOGAN,OFFICE NO. 2 FRANCIS TUTTLE TECH CENTER,PETE LEE,,420102,0,0,0,0,OFFICE NO. 2 FRANCIS TUTTLE TECH CENTER
LOGAN,OFFICE NO. 2 FRANCIS TUTTLE TECH CENTER,ROBERT STONE,,420102,0,0,0,0,OFFICE NO. 2 FRANCIS TUTTLE TECH CENTER
LOGAN,OFFICE NO. 6 GUTHRIE PUBLIC SCHOOLS,EDDIE LYNN,,420103,0,0,0,0,OFFICE NO. 6 GUTHRIE PUBLIC SCHOOLS
LOGAN,OFFICE NO. 6 GUTHRIE PUBLIC SCHOOLS,GINA DAVIS,,420103,0,0,2,2,OFFICE NO. 6 GUTHRIE PUBLIC SCHOOLS
LOGAN,OFFICE NO. 2 DEER CREEK PUBLIC SCHOOLS,TOM CORBIN,,420103,1,1,16,18,OFFICE NO. 2 DEER CREEK PUBLIC SCHOOLS
LOGAN,OFFICE NO. 2 DEER CREEK PUBLIC SCHOOLS,ANDI NEAVES,,420103,3,1,24,28,OFFICE NO. 2 DEER CREEK PUBLIC SCHOOLS
LOGAN,PROPOSITION NO. 1 EDMOND PUBLIC SCHOOLS,FOR THE PROPOSITION - YES,,420103,5,0,45,50,PROPOSITION NO. 1 EDMOND PUBLIC SCHOOLS
LOGAN,PROPOSITION NO. 1 EDMOND PUBLIC SCHOOLS,AGAINST THE PROPOSITION - NO,,420103,3,0,5,8,PROPOSITION NO. 1 EDMOND PUBLIC SCHOOLS
LOGAN,PROPOSITION NO. 2 EDMOND PUBLIC SCHOOLS,FOR THE PROPOSITION - YES,,420103,5,0,45,50,PROPOSITION NO. 2 EDMOND PUBLIC SCHOOLS
LOGAN,PROPOSITION NO. 2 EDMOND PUBLIC SCHOOLS,AGAINST THE PROPOSITION - NO,,420103,3,0,5,8,PROPOSITION NO. 2 EDMOND PUBLIC SCHOOLS
LOGAN,OFFICE NO. 2 FRANCIS TUTTLE TECH CENTER,PETE LEE,,420103,3,1,23,27,OFFICE NO. 2 FRANCIS TUTTLE TECH CENTER
LOGAN,OFFICE NO. 2 FRANCIS TUTTLE TECH CENTER,ROBERT STONE,,420103,7,1,56,64,OFFICE NO. 2 FRANCIS TUTTLE TECH CENTER
LOGAN,OFFICE NO. 6 GUTHRIE PUBLIC SCHOOLS,EDDIE LYNN,,420104,0,0,0,0,OFFICE NO. 6 GUTHRIE PUBLIC SCHOOLS
LOGAN,OFFICE NO. 6 GUTHRIE PUBLIC SCHOOLS,GINA DAVIS,,420104,0,0,1,1,OFFICE NO. 6 GUTHRIE PUBLIC SCHOOLS
LOGAN,OFFICE NO. 2 DEER CREEK PUBLIC SCHOOLS,TOM CORBIN,,420104,0,0,2,2,OFFICE NO. 2 DEER CREEK PUBLIC SCHOOLS
LOGAN,OFFICE NO. 2 DEER CREEK PUBLIC SCHOOLS,ANDI NEAVES,,420104,0,0,6,6,OFFICE NO. 2 DEER CREEK PUBLIC SCHOOLS
LOGAN,PROPOSITION NO. 1 EDMOND PUBLIC SCHOOLS,FOR THE PROPOSITION - YES,,420104,4,0,34,38,PROPOSITION NO. 1 EDMOND PUBLIC SCHOOLS
LOGAN,PROPOSITION NO. 1 EDMOND PUBLIC SCHOOLS,AGAINST THE PROPOSITION - NO,,420104,0,0,10,10,PROPOSITION NO. 1 EDMOND PUBLIC SCHOOLS
LOGAN,PROPOSITION NO. 2 EDMOND PUBLIC SCHOOLS,FOR THE PROPOSITION - YES,,420104,4,0,34,38,PROPOSITION NO. 2 EDMOND PUBLIC SCHOOLS
LOGAN,PROPOSITION NO. 2 EDMOND PUBLIC SCHOOLS,AGAINST THE PROPOSITION - NO,,420104,0,0,10,10,PROPOSITION NO. 2 EDMOND PUBLIC SCHOOLS
LOGAN,OFFICE NO. 2 FRANCIS TUTTLE TECH CENTER,PETE LEE,,420104,4,0,16,20,OFFICE NO. 2 FRANCIS TUTTLE TECH CENTER
LOGAN,OFFICE NO. 2 FRANCIS TUTTLE TECH CENTER,ROBERT STONE,,420104,0,0,33,33,OFFICE NO. 2 FRANCIS TUTTLE TECH CENTER
LOGAN,OFFICE NO. 6 GUTHRIE PUBLIC SCHOOLS,EDDIE LYNN,,420105,3,1,31,35,OFFICE NO. 6 GUTHRIE PUBLIC SCHOOLS
LOGAN,OFFICE NO. 6 GUTHRIE PUBLIC SCHOOLS,GINA DAVIS,,420105,5,1,23,29,OFFICE NO. 6 GUTHRIE PUBLIC SCHOOLS
LOGAN,OFFICE NO. 6 GUTHRIE PUBLIC SCHOOLS,EDDIE LYNN,,420106,0,2,2,4,OFFICE NO. 6 GUTHRIE PUBLIC SCHOOLS
LOGAN,OFFICE NO. 6 GUTHRIE PUBLIC SCHOOLS,GINA DAVIS,,420106,0,0,0,0,OFFICE NO. 6 GUTHRIE PUBLIC SCHOOLS
LOGAN,PROPOSITION NO. 1 EDMOND PUBLIC SCHOOLS,FOR THE PROPOSITION - YES,,420106,2,0,48,50,PROPOSITION NO. 1 EDMOND PUBLIC SCHOOLS
LOGAN,PROPOSITION NO. 1 EDMOND PUBLIC SCHOOLS,AGAINST THE PROPOSITION - NO,,420106,8,0,6,14,PROPOSITION NO. 1 EDMOND PUBLIC SCHOOLS
LOGAN,PROPOSITION NO. 2 EDMOND PUBLIC SCHOOLS,FOR THE PROPOSITION - YES,,420106,3,0,47,50,PROPOSITION NO. 2 EDMOND PUBLIC SCHOOLS
LOGAN,PROPOSITION NO. 2 EDMOND PUBLIC SCHOOLS,AGAINST THE PROPOSITION - NO,,420106,7,0,7,14,PROPOSITION NO. 2 EDMOND PUBLIC SCHOOLS
LOGAN,OFFICE NO. 2 FRANCIS TUTTLE TECH CENTER,PETE LEE,,420106,5,0,14,19,OFFICE NO. 2 FRANCIS TUTTLE TECH CENTER
LOGAN,OFFICE NO. 2 FRANCIS TUTTLE TECH CENTER,ROBERT STONE,,420106,5,0,31,36,OFFICE NO. 2 FRANCIS TUTTLE TECH CENTER
LOGAN,OFFICE NO. 2 COYLE PUBLIC SCHOOLS,CHAD MAKER,,420201,0,0,31,31,OFFICE NO. 2 COYLE PUBLIC SCHOOLS
LOGAN,OFFICE NO. 2 COYLE PUBLIC SCHOOLS,LEIGH BENTON,,420201,0,0,0,0,OFFICE NO. 2 COYLE PUBLIC SCHOOLS
LOGAN,OFFICE NO. 6 GUTHRIE PUBLIC SCHOOLS,EDDIE LYNN,,420201,0,0,0,0,OFFICE NO. 6 GUTHRIE PUBLIC SCHOOLS
LOGAN,OFFICE NO. 6 GUTHRIE PUBLIC SCHOOLS,GINA DAVIS,,420201,0,0,0,0,OFFICE NO. 6 GUTHRIE PUBLIC SCHOOLS
LOGAN,OFFICE NO. 2 COYLE PUBLIC SCHOOLS,CHAD MAKER,,420203,0,0,10,10,OFFICE NO. 2 COYLE PUBLIC SCHOOLS
LOGAN,OFFICE NO. 2 COYLE PUBLIC SCHOOLS,LEIGH BENTON,,420203,0,0,2,2,OFFICE NO. 2 COYLE PUBLIC SCHOOLS
LOGAN,OFFICE NO. 2 LUTHER PUBLIC SCHOOLS,TONY RUMPL,,420203,9,0,7,16,OFFICE NO. 2 LUTHER PUBLIC SCHOOLS
LOGAN,OFFICE NO. 2 LUTHER PUBLIC SCHOOLS,MATTHEW MOHR,,420203,3,0,2,5,OFFICE NO. 2 LUTHER PUBLIC SCHOOLS
LOGAN,OFFICE NO. 2 LUTHER PUBLIC SCHOOLS,GERALD McCAULEY,,420203,0,0,0,0,OFFICE NO. 2 LUTHER PUBLIC SCHOOLS
LOGAN,COUNCILMEMBER WARD 1 CITY OF GUTHRIE,STEFANI FORTNEY,,420204,0,1,3,4,COUNCILMEMBER WARD 1 CITY OF GUTHRIE
LOGAN,COUNCILMEMBER WARD 1 CITY OF GUTHRIE,PRICE PURVIS,,420204,0,2,6,8,COUNCILMEMBER WARD 1 CITY OF GUTHRIE
LOGAN,COUNCILMEMBER WARD 1 CITY OF GUTHRIE,JIM CASE,,420204,0,4,22,26,COUNCILMEMBER WARD 1 CITY OF GUTHRIE
LOGAN,OFFICE NO. 2 COYLE PUBLIC SCHOOLS,CHAD MAKER,,420204,0,0,0,0,OFFICE NO. 2 COYLE PUBLIC SCHOOLS
LOGAN,OFFICE NO. 2 COYLE PUBLIC SCHOOLS,LEIGH BENTON,,420204,0,1,0,1,OFFICE NO. 2 COYLE PUBLIC SCHOOLS
LOGAN,OFFICE NO. 6 GUTHRIE PUBLIC SCHOOLS,EDDIE LYNN,,420204,0,4,30,34,OFFICE NO. 6 GUTHRIE PUBLIC SCHOOLS
LOGAN,OFFICE NO. 6 GUTHRIE PUBLIC SCHOOLS,GINA DAVIS,,420204,4,7,42,53,OFFICE NO. 6 GUTHRIE PUBLIC SCHOOLS
LOGAN,OFFICE NO. 2 COYLE PUBLIC SCHOOLS,CHAD MAKER,,420205,1,0,0,1,OFFICE NO. 2 COYLE PUBLIC SCHOOLS
LOGAN,OFFICE NO. 2 COYLE PUBLIC SCHOOLS,LEIGH BENTON,,420205,0,0,0,0,OFFICE NO. 2 COYLE PUBLIC SCHOOLS
LOGAN,OFFICE NO. 6 GUTHRIE PUBLIC SCHOOLS,EDDIE LYNN,,420205,3,1,35,39,OFFICE NO. 6 GUTHRIE PUBLIC SCHOOLS
LOGAN,OFFICE NO. 6 GUTHRIE PUBLIC SCHOOLS,GINA DAVIS,,420205,4,1,33,38,OFFICE NO. 6 GUTHRIE PUBLIC SCHOOLS
LOGAN,OFFICE NO. 6 GUTHRIE PUBLIC SCHOOLS,EDDIE LYNN,,420206,0,2,4,6,OFFICE NO. 6 GUTHRIE PUBLIC SCHOOLS
LOGAN,OFFICE NO. 6 GUTHRIE PUBLIC SCHOOLS,GINA DAVIS,,420206,1,0,6,7,OFFICE NO. 6 GUTHRIE PUBLIC SCHOOLS
LOGAN,PROPOSITION NO. 1 EDMOND PUBLIC SCHOOLS,FOR THE PROPOSITION - YES,,420206,0,0,15,15,PROPOSITION NO. 1 EDMOND PUBLIC SCHOOLS
LOGAN,PROPOSITION NO. 1 EDMOND PUBLIC SCHOOLS,AGAINST THE PROPOSITION - NO,,420206,4,0,1,5,PROPOSITION NO. 1 EDMOND PUBLIC SCHOOLS
LOGAN,PROPOSITION NO. 2 EDMOND PUBLIC SCHOOLS,FOR THE PROPOSITION - YES,,420206,0,0,15,15,PROPOSITION NO. 2 EDMOND PUBLIC SCHOOLS
LOGAN,PROPOSITION NO. 2 EDMOND PUBLIC SCHOOLS,AGAINST THE PROPOSITION - NO,,420206,4,0,1,5,PROPOSITION NO. 2 EDMOND PUBLIC SCHOOLS
LOGAN,OFFICE NO. 2 FRANCIS TUTTLE TECH CENTER,PETE LEE,,420206,4,0,5,9,OFFICE NO. 2 FRANCIS TUTTLE TECH CENTER
LOGAN,OFFICE NO. 2 FRANCIS TUTTLE TECH CENTER,ROBERT STONE,,420206,0,0,5,5,OFFICE NO. 2 FRANCIS TUTTLE TECH CENTER
LOGAN,OFFICE NO. 2 COYLE PUBLIC SCHOOLS,CHAD MAKER,,420207,0,0,1,1,OFFICE NO. 2 COYLE PUBLIC SCHOOLS
LOGAN,OFFICE NO. 2 COYLE PUBLIC SCHOOLS,LEIGH BENTON,,420207,0,0,0,0,OFFICE NO. 2 COYLE PUBLIC SCHOOLS
LOGAN,OFFICE NO. 6 GUTHRIE PUBLIC SCHOOLS,EDDIE LYNN,,420207,1,2,3,6,OFFICE NO. 6 GUTHRIE PUBLIC SCHOOLS
LOGAN,OFFICE NO. 6 GUTHRIE PUBLIC SCHOOLS,GINA DAVIS,,420207,3,0,6,9,OFFICE NO. 6 GUTHRIE PUBLIC SCHOOLS
LOGAN,PROPOSITION NO. 1 EDMOND PUBLIC SCHOOLS,FOR THE PROPOSITION - YES,,420207,0,0,5,5,PROPOSITION NO. 1 EDMOND PUBLIC SCHOOLS
LOGAN,PROPOSITION NO. 1 EDMOND PUBLIC SCHOOLS,AGAINST THE PROPOSITION - NO,,420207,0,0,0,0,PROPOSITION NO. 1 EDMOND PUBLIC SCHOOLS
LOGAN,PROPOSITION NO. 2 EDMOND PUBLIC SCHOOLS,FOR THE PROPOSITION - YES,,420207,0,0,5,5,PROPOSITION NO. 2 EDMOND PUBLIC SCHOOLS
LOGAN,PROPOSITION NO. 2 EDMOND PUBLIC SCHOOLS,AGAINST THE PROPOSITION - NO,,420207,0,0,0,0,PROPOSITION NO. 2 EDMOND PUBLIC SCHOOLS
LOGAN,OFFICE NO. 2 FRANCIS TUTTLE TECH CENTER,PETE LEE,,420207,0,0,3,3,OFFICE NO. 2 FRANCIS TUTTLE TECH CENTER
LOGAN,OFFICE NO. 2 FRANCIS TUTTLE TECH CENTER,ROBERT STONE,,420207,0,0,2,2,OFFICE NO. 2 FRANCIS TUTTLE TECH CENTER
LOGAN,OFFICE NO. 2 LUTHER PUBLIC SCHOOLS,TONY RUMPL,,420207,2,0,4,6,OFFICE NO. 2 LUTHER PUBLIC SCHOOLS
LOGAN,OFFICE NO. 2 LUTHER PUBLIC SCHOOLS,MATTHEW MOHR,,420207,0,0,0,0,OFFICE NO. 2 LUTHER PUBLIC SCHOOLS
LOGAN,OFFICE NO. 2 LUTHER PUBLIC SCHOOLS,GERALD McCAULEY,,420207,0,0,0,0,OFFICE NO. 2 LUTHER PUBLIC SCHOOLS
LOGAN,OFFICE NO. 2 CRESCENT PUBLIC SCHOOLS,LISA GRAFF,,420301,0,0,9,9,OFFICE NO. 2 CRESCENT PUBLIC SCHOOLS
LOGAN,OFFICE NO. 2 CRESCENT PUBLIC SCHOOLS,TODD AUSCHWITZ,,420301,0,0,0,0,OFFICE NO. 2 CRESCENT PUBLIC SCHOOLS
LOGAN,OFFICE NO. 2 FRANCIS TUTTLE TECH CENTER,PETE LEE,,420301,0,0,2,2,OFFICE NO. 2 FRANCIS TUTTLE TECH CENTER
LOGAN,OFFICE NO. 2 FRANCIS TUTTLE TECH CENTER,ROBERT STONE,,420301,0,0,7,7,OFFICE NO. 2 FRANCIS TUTTLE TECH CENTER
LOGAN,OFFICE NO. 2 CRESCENT PUBLIC SCHOOLS,LISA GRAFF,,420303,1,2,225,228,OFFICE NO. 2 CRESCENT PUBLIC SCHOOLS
LOGAN,OFFICE NO. 2 CRESCENT PUBLIC SCHOOLS,TODD AUSCHWITZ,,420303,1,2,67,70,OFFICE NO. 2 CRESCENT PUBLIC SCHOOLS
LOGAN,OFFICE NO. 6 GUTHRIE PUBLIC SCHOOLS,EDDIE LYNN,,420303,0,0,0,0,OFFICE NO. 6 GUTHRIE PUBLIC SCHOOLS
LOGAN,OFFICE NO. 6 GUTHRIE PUBLIC SCHOOLS,GINA DAVIS,,420303,0,0,0,0,OFFICE NO. 6 GUTHRIE PUBLIC SCHOOLS
LOGAN,OFFICE NO. 2 FRANCIS TUTTLE TECH CENTER,PETE LEE,,420303,1,1,86,88,OFFICE NO. 2 FRANCIS TUTTLE TECH CENTER
LOGAN,OFFICE NO. 2 FRANCIS TUTTLE TECH CENTER,ROBERT STONE,,420303,0,0,166,166,OFFICE NO. 2 FRANCIS TUTTLE TECH CENTER
LOGAN,OFFICE NO. 2 CRESCENT PUBLIC SCHOOLS,LISA GRAFF,,420304,0,3,1,4,OFFICE NO. 2 CRESCENT PUBLIC SCHOOLS
LOGAN,OFFICE NO. 2 CRESCENT PUBLIC SCHOOLS,TODD AUSCHWITZ,,420304,0,0,0,0,OFFICE NO. 2 CRESCENT PUBLIC SCHOOLS
LOGAN,OFFICE NO. 2 FRANCIS TUTTLE TECH CENTER,PETE LEE,,420304,0,1,0,1,OFFICE NO. 2 FRANCIS TUTTLE TECH CENTER
LOGAN,OFFICE NO. 2 FRANCIS TUTTLE TECH CENTER,ROBERT STONE,,420304,0,2,1,3,OFFICE NO. 2 FRANCIS TUTTLE TECH CENTER
LOGAN,COUNCILMEMBER WARD 1 CITY OF GUTHRIE,STEFANI FORTNEY,,420305,0,0,0,0,COUNCILMEMBER WARD 1 CITY OF GUTHRIE
LOGAN,COUNCILMEMBER WARD 1 CITY OF GUTHRIE,PRICE PURVIS,,420305,0,0,2,2,COUNCILMEMBER WARD 1 CITY OF GUTHRIE
LOGAN,COUNCILMEMBER WARD 1 CITY OF GUTHRIE,JIM CASE,,420305,0,0,0,0,COUNCILMEMBER WARD 1 CITY OF GUTHRIE
LOGAN,OFFICE NO. 2 CRESCENT PUBLIC SCHOOLS,LISA GRAFF,,420305,0,1,2,3,OFFICE NO. 2 CRESCENT PUBLIC SCHOOLS
LOGAN,OFFICE NO. 2 CRESCENT PUBLIC SCHOOLS,TODD AUSCHWITZ,,420305,0,0,0,0,OFFICE NO. 2 CRESCENT PUBLIC SCHOOLS
LOGAN,OFFICE NO. 6 GUTHRIE PUBLIC SCHOOLS,EDDIE LYNN,,420305,0,0,23,23,OFFICE NO. 6 GUTHRIE PUBLIC SCHOOLS
LOGAN,OFFICE NO. 6 GUTHRIE PUBLIC SCHOOLS,GINA DAVIS,,420305,2,0,29,31,OFFICE NO. 6 GUTHRIE PUBLIC SCHOOLS
LOGAN,OFFICE NO. 2 FRANCIS TUTTLE TECH CENTER,PETE LEE,,420305,0,0,0,0,OFFICE NO. 2 FRANCIS TUTTLE TECH CENTER
LOGAN,OFFICE NO. 2 FRANCIS TUTTLE TECH CENTER,ROBERT STONE,,420305,0,0,1,1,OFFICE NO. 2 FRANCIS TUTTLE TECH CENTER
LOGAN,OFFICE NO. 6 GUTHRIE PUBLIC SCHOOLS,EDDIE LYNN,,420306,0,0,9,9,OFFICE NO. 6 GUTHRIE PUBLIC SCHOOLS
LOGAN,OFFICE NO. 6 GUTHRIE PUBLIC SCHOOLS,GINA DAVIS,,420306,0,0,26,26,OFFICE NO. 6 GUTHRIE PUBLIC SCHOOLS
LOGAN,COUNCILMEMBER WARD 1 CITY OF GUTHRIE,STEFANI FORTNEY,,420307,2,1,23,26,COUNCILMEMBER WARD 1 CITY OF GUTHRIE
LOGAN,COUNCILMEMBER WARD 1 CITY OF GUTHRIE,PRICE PURVIS,,420307,0,0,63,63,COUNCILMEMBER WARD 1 CITY OF GUTHRIE
LOGAN,COUNCILMEMBER WARD 1 CITY OF GUTHRIE,JIM CASE,,420307,0,1,60,61,COUNCILMEMBER WARD 1 CITY OF GUTHRIE
LOGAN,OFFICE NO. 6 GUTHRIE PUBLIC SCHOOLS,EDDIE LYNN,,420307,0,0,55,55,OFFICE NO. 6 GUTHRIE PUBLIC SCHOOLS
LOGAN,OFFICE NO. 6 GUTHRIE PUBLIC SCHOOLS,GINA DAVIS,,420307,2,2,96,100,OFFICE NO. 6 GUTHRIE PUBLIC SCHOOLS
LOGAN,COUNCILMEMBER WARD 1 CITY OF GUTHRIE,STEFANI FORTNEY,,420308,0,0,0,0,COUNCILMEMBER WARD 1 CITY OF GUTHRIE
LOGAN,COUNCILMEMBER WARD 1 CITY OF GUTHRIE,PRICE PURVIS,,420308,0,0,1,1,COUNCILMEMBER WARD 1 CITY OF GUTHRIE
LOGAN,COUNCILMEMBER WARD 1 CITY OF GUTHRIE,JIM CASE,,420308,0,0,4,4,COUNCILMEMBER WARD 1 CITY OF GUTHRIE
LOGAN,OFFICE NO. 6 GUTHRIE PUBLIC SCHOOLS,EDDIE LYNN,,420308,1,3,28,32,OFFICE NO. 6 GUTHRIE PUBLIC SCHOOLS
LOGAN,OFFICE NO. 6 GUTHRIE PUBLIC SCHOOLS,GINA DAVIS,,420308,2,4,46,52,OFFICE NO. 6 GUTHRIE PUBLIC SCHOOLS
LOGAN,OFFICE NO. 2 COYLE PUBLIC SCHOOLS,CHAD MAKER,,420309,0,0,1,1,OFFICE NO. 2 COYLE PUBLIC SCHOOLS
LOGAN,OFFICE NO. 2 COYLE PUBLIC SCHOOLS,LEIGH BENTON,,420309,0,0,0,0,OFFICE NO. 2 COYLE PUBLIC SCHOOLS
LOGAN,OFFICE NO. 6 GUTHRIE PUBLIC SCHOOLS,EDDIE LYNN,,420309,0,0,0,0,OFFICE NO. 6 GUTHRIE PUBLIC SCHOOLS
LOGAN,OFFICE NO. 6 GUTHRIE PUBLIC SCHOOLS,GINA DAVIS,,420309,0,0,0,0,OFFICE NO. 6 GUTHRIE PUBLIC SCHOOLS
LOGAN,OFFICE NO. 2 COYLE PUBLIC SCHOOLS,CHAD MAKER,,420310,0,0,5,5,OFFICE NO. 2 COYLE PUBLIC SCHOOLS
LOGAN,OFFICE NO. 2 COYLE PUBLIC SCHOOLS,LEIGH BENTON,,420310,0,0,2,2,OFFICE NO. 2 COYLE PUBLIC SCHOOLS
LOVE,OFFICE NO. 2 TURNER PUBLIC SCHOOLS,STEVE SHORT,,430102,0,0,12,12,OFFICE NO. 2 TURNER PUBLIC SCHOOLS
LOVE,OFFICE NO. 2 TURNER PUBLIC SCHOOLS,TERESA WHITSON,,430102,0,1,7,8,OFFICE NO. 2 TURNER PUBLIC SCHOOLS
LOVE,OFFICE NO. 2 TURNER PUBLIC SCHOOLS,STEVE SHORT,,430204,0,0,6,6,OFFICE NO. 2 TURNER PUBLIC SCHOOLS
LOVE,OFFICE NO. 2 TURNER PUBLIC SCHOOLS,TERESA WHITSON,,430204,0,2,1,3,OFFICE NO. 2 TURNER PUBLIC SCHOOLS
LOVE,OFFICE NO. 2 TURNER PUBLIC SCHOOLS,STEVE SHORT,,430205,4,2,88,94,OFFICE NO. 2 TURNER PUBLIC SCHOOLS
LOVE,OFFICE NO. 2 TURNER PUBLIC SCHOOLS,TERESA WHITSON,,430205,0,4,50,54,OFFICE NO. 2 TURNER PUBLIC SCHOOLS
LOVE,OFFICE NO. 2 TURNER PUBLIC SCHOOLS,STEVE SHORT,,430206,0,1,15,16,OFFICE NO. 2 TURNER PUBLIC SCHOOLS
LOVE,OFFICE NO. 2 TURNER PUBLIC SCHOOLS,TERESA WHITSON,,430206,1,1,56,58,OFFICE NO. 2 TURNER PUBLIC SCHOOLS
LOVE,OFFICE NO. 2 TURNER PUBLIC SCHOOLS,STEVE SHORT,,430207,0,2,8,10,OFFICE NO. 2 TURNER PUBLIC SCHOOLS
LOVE,OFFICE NO. 2 TURNER PUBLIC SCHOOLS,TERESA WHITSON,,430207,0,0,7,7,OFFICE NO. 2 TURNER PUBLIC SCHOOLS
LOVE,OFFICE NO. 2 WILSON PUBLIC SCHOOLS,CHAD NANCE,,430208,0,0,0,0,OFFICE NO. 2 WILSON PUBLIC SCHOOLS
LOVE,OFFICE NO. 2 WILSON PUBLIC SCHOOLS,TOMMI SUE IDLEMAN,,430208,0,0,0,0,OFFICE NO. 2 WILSON PUBLIC SCHOOLS
LOVE,OFFICE NO. 2 TURNER PUBLIC SCHOOLS,STEVE SHORT,,430208,0,0,0,0,OFFICE NO. 2 TURNER PUBLIC SCHOOLS
LOVE,OFFICE NO. 2 TURNER PUBLIC SCHOOLS,TERESA WHITSON,,430208,0,0,0,0,OFFICE NO. 2 TURNER PUBLIC SCHOOLS
LOVE,OFFICE NO. 2 TURNER PUBLIC SCHOOLS,STEVE SHORT,,430311,0,0,2,2,OFFICE NO. 2 TURNER PUBLIC SCHOOLS
LOVE,OFFICE NO. 2 TURNER PUBLIC SCHOOLS,TERESA WHITSON,,430311,0,1,5,6,OFFICE NO. 2 TURNER PUBLIC SCHOOLS
LOVE,OFFICE NO. 2 WILSON PUBLIC SCHOOLS,CHAD NANCE,,430313,0,0,0,0,OFFICE NO. 2 WILSON PUBLIC SCHOOLS
LOVE,OFFICE NO. 2 WILSON PUBLIC SCHOOLS,TOMMI SUE IDLEMAN,,430313,0,0,0,0,OFFICE NO. 2 WILSON PUBLIC SCHOOLS
LOVE,OFFICE NO. 2 TURNER PUBLIC SCHOOLS,STEVE SHORT,,430313,1,3,16,20,OFFICE NO. 2 TURNER PUBLIC SCHOOLS
LOVE,OFFICE NO. 2 TURNER PUBLIC SCHOOLS,TERESA WHITSON,,430313,0,1,13,14,OFFICE NO. 2 TURNER PUBLIC SCHOOLS
MCCLAIN,COUNCILMEMBER DIVISION 1 CITY OF PURCELL,GRAHAM FISHBURN,,440003,0,0,0,0,COUNCILMEMBER DIVISION 1 CITY OF PURCELL
MCCLAIN,COUNCILMEMBER DIVISION 1 CITY OF PURCELL,LARRY DON BACON JR,,440003,0,0,0,0,COUNCILMEMBER DIVISION 1 CITY OF PURCELL
MCCLAIN,COUNCILMEMBER DIVISION 1 CITY OF PURCELL,GRAHAM FISHBURN,,440004,0,0,0,0,COUNCILMEMBER DIVISION 1 CITY OF PURCELL
MCCLAIN,COUNCILMEMBER DIVISION 1 CITY OF PURCELL,LARRY DON BACON JR,,440004,0,0,0,0,COUNCILMEMBER DIVISION 1 CITY OF PURCELL
MCCLAIN,OFFICE NO. 2 LINDSAY PUBLIC SCHOOLS,CLINT SIMONTON,,440005,0,0,48,48,OFFICE NO. 2 LINDSAY PUBLIC SCHOOLS
MCCLAIN,OFFICE NO. 2 LINDSAY PUBLIC SCHOOLS,ROBERT D. JONES,,440005,0,0,6,6,OFFICE NO. 2 LINDSAY PUBLIC SCHOOLS
MCCLAIN,OFFICE NO. 2 DIBBLE PUBLIC SCHOOLS,CLAYTON LEE,,440005,2,0,4,6,OFFICE NO. 2 DIBBLE PUBLIC SCHOOLS
MCCLAIN,OFFICE NO. 2 DIBBLE PUBLIC SCHOOLS,RICHARD CORLEY,,440005,0,0,20,20,OFFICE NO. 2 DIBBLE PUBLIC SCHOOLS
MCCLAIN,COUNCILMEMBER DIVISION 1 CITY OF PURCELL,GRAHAM FISHBURN,,440006,3,4,13,20,COUNCILMEMBER DIVISION 1 CITY OF PURCELL
MCCLAIN,COUNCILMEMBER DIVISION 1 CITY OF PURCELL,LARRY DON BACON JR,,440006,0,3,12,15,COUNCILMEMBER DIVISION 1 CITY OF PURCELL
MCCLAIN,OFFICE NO. 2 PURCELL PUBLIC SCHOOLS,DRU SMITH,,440006,2,6,21,29,OFFICE NO. 2 PURCELL PUBLIC SCHOOLS
MCCLAIN,OFFICE NO. 2 PURCELL PUBLIC SCHOOLS,NATALIE BEVILL,,440006,2,3,16,21,OFFICE NO. 2 PURCELL PUBLIC SCHOOLS
MCCLAIN,COUNCILMEMBER DIVISION 1 CITY OF PURCELL,GRAHAM FISHBURN,,440007,0,0,5,5,COUNCILMEMBER DIVISION 1 CITY OF PURCELL
MCCLAIN,COUNCILMEMBER DIVISION 1 CITY OF PURCELL,LARRY DON BACON JR,,440007,0,0,2,2,COUNCILMEMBER DIVISION 1 CITY OF PURCELL
MCCLAIN,OFFICE NO. 2 PURCELL PUBLIC SCHOOLS,DRU SMITH,,440007,1,0,7,8,OFFICE NO. 2 PURCELL PUBLIC SCHOOLS
MCCLAIN,OFFICE NO. 2 PURCELL PUBLIC SCHOOLS,NATALIE BEVILL,,440007,1,0,0,1,OFFICE NO. 2 PURCELL PUBLIC SCHOOLS
MCCLAIN,COUNCILMEMBER DIVISION 1 CITY OF PURCELL,GRAHAM FISHBURN,,440008,0,0,0,0,COUNCILMEMBER DIVISION 1 CITY OF PURCELL
MCCLAIN,COUNCILMEMBER DIVISION 1 CITY OF PURCELL,LARRY DON BACON JR,,440008,0,0,0,0,COUNCILMEMBER DIVISION 1 CITY OF PURCELL
MCCLAIN,OFFICE NO. 2 BLANCHARD PUBLIC SCHOOLS,LIZ GEORGE,,440008,0,0,0,0,OFFICE NO. 2 BLANCHARD PUBLIC SCHOOLS
MCCLAIN,OFFICE NO. 2 BLANCHARD PUBLIC SCHOOLS,MITCH FITZGERALD,,440008,0,0,0,0,OFFICE NO. 2 BLANCHARD PUBLIC SCHOOLS
MCCLAIN,OFFICE NO. 2 DIBBLE PUBLIC SCHOOLS,CLAYTON LEE,,440008,0,0,0,0,OFFICE NO. 2 DIBBLE PUBLIC SCHOOLS
MCCLAIN,OFFICE NO. 2 DIBBLE PUBLIC SCHOOLS,RICHARD CORLEY,,440008,0,0,10,10,OFFICE NO. 2 DIBBLE PUBLIC SCHOOLS
MCCLAIN,OFFICE NO. 2 PURCELL PUBLIC SCHOOLS,DRU SMITH,,440008,0,0,0,0,OFFICE NO. 2 PURCELL PUBLIC SCHOOLS
MCCLAIN,OFFICE NO. 2 PURCELL PUBLIC SCHOOLS,NATALIE BEVILL,,440008,0,0,0,0,OFFICE NO. 2 PURCELL PUBLIC SCHOOLS
MCCLAIN,OFFICE NO. 2 BLANCHARD PUBLIC SCHOOLS,LIZ GEORGE,,440009,0,0,0,0,OFFICE NO. 2 BLANCHARD PUBLIC SCHOOLS
MCCLAIN,OFFICE NO. 2 BLANCHARD PUBLIC SCHOOLS,MITCH FITZGERALD,,440009,0,0,0,0,OFFICE NO. 2 BLANCHARD PUBLIC SCHOOLS
MCCLAIN,OFFICE NO. 2 NEWCASTLE PUBLIC SCHOOLS,ROBERT FULTON,,440009,2,0,2,4,OFFICE NO. 2 NEWCASTLE PUBLIC SCHOOLS
MCCLAIN,OFFICE NO. 2 NEWCASTLE PUBLIC SCHOOLS,VALORY DALTON,,440009,0,0,6,6,OFFICE NO. 2 NEWCASTLE PUBLIC SCHOOLS
MCCLAIN,OFFICE NO. 2 LINDSAY PUBLIC SCHOOLS,CLINT SIMONTON,,440010,0,0,0,0,OFFICE NO. 2 LINDSAY PUBLIC SCHOOLS
MCCLAIN,OFFICE NO. 2 LINDSAY PUBLIC SCHOOLS,ROBERT D. JONES,,440010,0,0,0,0,OFFICE NO. 2 LINDSAY PUBLIC SCHOOLS
MCCLAIN,OFFICE NO. 2 DIBBLE PUBLIC SCHOOLS,CLAYTON LEE,,440010,0,0,0,0,OFFICE NO. 2 DIBBLE PUBLIC SCHOOLS
MCCLAIN,OFFICE NO. 2 DIBBLE PUBLIC SCHOOLS,RICHARD CORLEY,,440010,0,0,0,0,OFFICE NO. 2 DIBBLE PUBLIC SCHOOLS
MCCLAIN,OFFICE NO. 2 LINDSAY PUBLIC SCHOOLS,CLINT SIMONTON,,440011,0,0,0,0,OFFICE NO. 2 LINDSAY PUBLIC SCHOOLS
MCCLAIN,OFFICE NO. 2 LINDSAY PUBLIC SCHOOLS,ROBERT D. JONES,,440011,0,0,0,0,OFFICE NO. 2 LINDSAY PUBLIC SCHOOLS
MCCLAIN,OFFICE NO. 2 DIBBLE PUBLIC SCHOOLS,CLAYTON LEE,,440011,1,0,9,10,OFFICE NO. 2 DIBBLE PUBLIC SCHOOLS
MCCLAIN,OFFICE NO. 2 DIBBLE PUBLIC SCHOOLS,RICHARD CORLEY,,440011,1,0,31,32,OFFICE NO. 2 DIBBLE PUBLIC SCHOOLS
MCCLAIN,OFFICE NO. 2 BLANCHARD PUBLIC SCHOOLS,LIZ GEORGE,,440012,9,1,59,69,OFFICE NO. 2 BLANCHARD PUBLIC SCHOOLS
MCCLAIN,OFFICE NO. 2 BLANCHARD PUBLIC SCHOOLS,MITCH FITZGERALD,,440012,2,3,26,31,OFFICE NO. 2 BLANCHARD PUBLIC SCHOOLS
MCCLAIN,OFFICE NO. 2 DIBBLE PUBLIC SCHOOLS,CLAYTON LEE,,440012,0,0,1,1,OFFICE NO. 2 DIBBLE PUBLIC SCHOOLS
MCCLAIN,OFFICE NO. 2 DIBBLE PUBLIC SCHOOLS,RICHARD CORLEY,,440012,0,0,0,0,OFFICE NO. 2 DIBBLE PUBLIC SCHOOLS
MCCLAIN,OFFICE NO. 2 BLANCHARD PUBLIC SCHOOLS,LIZ GEORGE,,440013,0,0,0,0,OFFICE NO. 2 BLANCHARD PUBLIC SCHOOLS
MCCLAIN,OFFICE NO. 2 BLANCHARD PUBLIC SCHOOLS,MITCH FITZGERALD,,440013,0,0,1,1,OFFICE NO. 2 BLANCHARD PUBLIC SCHOOLS
MCCLAIN,OFFICE NO. 2 NEWCASTLE PUBLIC SCHOOLS,ROBERT FULTON,,440013,8,2,20,30,OFFICE NO. 2 NEWCASTLE PUBLIC SCHOOLS
MCCLAIN,OFFICE NO. 2 NEWCASTLE PUBLIC SCHOOLS,VALORY DALTON,,440013,3,2,62,67,OFFICE NO. 2 NEWCASTLE PUBLIC SCHOOLS
MCCLAIN,OFFICE NO. 2 NEWCASTLE PUBLIC SCHOOLS,ROBERT FULTON,,440014,0,0,2,2,OFFICE NO. 2 NEWCASTLE PUBLIC SCHOOLS
MCCLAIN,OFFICE NO. 2 NEWCASTLE PUBLIC SCHOOLS,VALORY DALTON,,440014,1,0,9,10,OFFICE NO. 2 NEWCASTLE PUBLIC SCHOOLS
MCCLAIN,OFFICE NO. 2 BLANCHARD PUBLIC SCHOOLS,LIZ GEORGE,,440015,2,0,1,3,OFFICE NO. 2 BLANCHARD PUBLIC SCHOOLS
MCCLAIN,OFFICE NO. 2 BLANCHARD PUBLIC SCHOOLS,MITCH FITZGERALD,,440015,2,0,3,5,OFFICE NO. 2 BLANCHARD PUBLIC SCHOOLS
MCCLAIN,OFFICE NO. 2 NEWCASTLE PUBLIC SCHOOLS,ROBERT FULTON,,440015,1,0,10,11,OFFICE NO. 2 NEWCASTLE PUBLIC SCHOOLS
MCCLAIN,OFFICE NO. 2 NEWCASTLE PUBLIC SCHOOLS,VALORY DALTON,,440015,0,0,14,14,OFFICE NO. 2 NEWCASTLE PUBLIC SCHOOLS
MCCLAIN,OFFICE NO. 2 BLANCHARD PUBLIC SCHOOLS,LIZ GEORGE,,440016,18,0,94,112,OFFICE NO. 2 BLANCHARD PUBLIC SCHOOLS
MCCLAIN,OFFICE NO. 2 BLANCHARD PUBLIC SCHOOLS,MITCH FITZGERALD,,440016,2,0,28,30,OFFICE NO. 2 BLANCHARD PUBLIC SCHOOLS
MCCLAIN,OFFICE NO. 2 NEWCASTLE PUBLIC SCHOOLS,ROBERT FULTON,,440017,2,0,3,5,OFFICE NO. 2 NEWCASTLE PUBLIC SCHOOLS
MCCLAIN,OFFICE NO. 2 NEWCASTLE PUBLIC SCHOOLS,VALORY DALTON,,440017,0,0,4,4,OFFICE NO. 2 NEWCASTLE PUBLIC SCHOOLS
MCCLAIN,OFFICE NO. 2 BLANCHARD PUBLIC SCHOOLS,LIZ GEORGE,,440018,2,0,23,25,OFFICE NO. 2 BLANCHARD PUBLIC SCHOOLS
MCCLAIN,OFFICE NO. 2 BLANCHARD PUBLIC SCHOOLS,MITCH FITZGERALD,,440018,3,0,11,14,OFFICE NO. 2 BLANCHARD PUBLIC SCHOOLS
MCCLAIN,OFFICE NO. 2 NEWCASTLE PUBLIC SCHOOLS,ROBERT FULTON,,440018,0,0,2,2,OFFICE NO. 2 NEWCASTLE PUBLIC SCHOOLS
MCCLAIN,OFFICE NO. 2 NEWCASTLE PUBLIC SCHOOLS,VALORY DALTON,,440018,0,0,1,1,OFFICE NO. 2 NEWCASTLE PUBLIC SCHOOLS
MCCLAIN,OFFICE NO. 2 BLANCHARD PUBLIC SCHOOLS,LIZ GEORGE,,440019,0,0,2,2,OFFICE NO. 2 BLANCHARD PUBLIC SCHOOLS
MCCLAIN,OFFICE NO. 2 BLANCHARD PUBLIC SCHOOLS,MITCH FITZGERALD,,440019,0,0,2,2,OFFICE NO. 2 BLANCHARD PUBLIC SCHOOLS
MCCLAIN,OFFICE NO. 2 DIBBLE PUBLIC SCHOOLS,CLAYTON LEE,,440019,3,0,13,16,OFFICE NO. 2 DIBBLE PUBLIC SCHOOLS
MCCLAIN,OFFICE NO. 2 DIBBLE PUBLIC SCHOOLS,RICHARD CORLEY,,440019,3,0,14,17,OFFICE NO. 2 DIBBLE PUBLIC SCHOOLS
MCCLAIN,COUNCILMEMBER DIVISION 1 CITY OF PURCELL,GRAHAM FISHBURN,,440020,0,0,2,2,COUNCILMEMBER DIVISION 1 CITY OF PURCELL
MCCLAIN,COUNCILMEMBER DIVISION 1 CITY OF PURCELL,LARRY DON BACON JR,,440020,0,1,0,1,COUNCILMEMBER DIVISION 1 CITY OF PURCELL
MCCLAIN,OFFICE NO. 2 PURCELL PUBLIC SCHOOLS,DRU SMITH,,440020,0,1,1,2,OFFICE NO. 2 PURCELL PUBLIC SCHOOLS
MCCLAIN,OFFICE NO. 2 PURCELL PUBLIC SCHOOLS,NATALIE BEVILL,,440020,0,0,1,1,OFFICE NO. 2 PURCELL PUBLIC SCHOOLS
MCCLAIN,COUNCILMEMBER DIVISION 1 CITY OF PURCELL,GRAHAM FISHBURN,,440021,0,6,17,23,COUNCILMEMBER DIVISION 1 CITY OF PURCELL
MCCLAIN,COUNCILMEMBER DIVISION 1 CITY OF PURCELL,LARRY DON BACON JR,,440021,0,3,21,24,COUNCILMEMBER DIVISION 1 CITY OF PURCELL
MCCLAIN,OFFICE NO. 2 PURCELL PUBLIC SCHOOLS,DRU SMITH,,440021,0,6,22,28,OFFICE NO. 2 PURCELL PUBLIC SCHOOLS
MCCLAIN,OFFICE NO. 2 PURCELL PUBLIC SCHOOLS,NATALIE BEVILL,,440021,0,3,16,19,OFFICE NO. 2 PURCELL PUBLIC SCHOOLS
MCCLAIN,COUNCILMEMBER DIVISION 1 CITY OF PURCELL,GRAHAM FISHBURN,,440023,1,3,42,46,COUNCILMEMBER DIVISION 1 CITY OF PURCELL
MCCLAIN,COUNCILMEMBER DIVISION 1 CITY OF PURCELL,LARRY DON BACON JR,,440023,2,4,25,31,COUNCILMEMBER DIVISION 1 CITY OF PURCELL
MCCLAIN,OFFICE NO. 2 PURCELL PUBLIC SCHOOLS,DRU SMITH,,440023,0,3,46,49,OFFICE NO. 2 PURCELL PUBLIC SCHOOLS
MCCLAIN,OFFICE NO. 2 PURCELL PUBLIC SCHOOLS,NATALIE BEVILL,,440023,3,4,22,29,OFFICE NO. 2 PURCELL PUBLIC SCHOOLS
MCCLAIN,COUNCILMEMBER DIVISION 1 CITY OF PURCELL,GRAHAM FISHBURN,,440024,9,8,37,54,COUNCILMEMBER DIVISION 1 CITY OF PURCELL
MCCLAIN,COUNCILMEMBER DIVISION 1 CITY OF PURCELL,LARRY DON BACON JR,,440024,6,2,30,38,COUNCILMEMBER DIVISION 1 CITY OF PURCELL
MCCLAIN,OFFICE NO. 2 PURCELL PUBLIC SCHOOLS,DRU SMITH,,440024,8,6,36,50,OFFICE NO. 2 PURCELL PUBLIC SCHOOLS
MCCLAIN,OFFICE NO. 2 PURCELL PUBLIC SCHOOLS,NATALIE BEVILL,,440024,7,4,31,42,OFFICE NO. 2 PURCELL PUBLIC SCHOOLS
MCCLAIN,OFFICE NO. 2 PURCELL PUBLIC SCHOOLS,DRU SMITH,,440026,0,0,0,0,OFFICE NO. 2 PURCELL PUBLIC SCHOOLS
MCCLAIN,OFFICE NO. 2 PURCELL PUBLIC SCHOOLS,NATALIE BEVILL,,440026,0,1,1,2,OFFICE NO. 2 PURCELL PUBLIC SCHOOLS
MCCLAIN,OFFICE NO. 2 NEWCASTLE PUBLIC SCHOOLS,ROBERT FULTON,,440027,1,0,10,11,OFFICE NO. 2 NEWCASTLE PUBLIC SCHOOLS
MCCLAIN,OFFICE NO. 2 NEWCASTLE PUBLIC SCHOOLS,VALORY DALTON,,440027,1,0,10,11,OFFICE NO. 2 NEWCASTLE PUBLIC SCHOOLS
MCCLAIN,OFFICE NO. 2 NEWCASTLE PUBLIC SCHOOLS,ROBERT FULTON,,440028,0,2,6,8,OFFICE NO. 2 NEWCASTLE PUBLIC SCHOOLS
MCCLAIN,OFFICE NO. 2 NEWCASTLE PUBLIC SCHOOLS,VALORY DALTON,,440028,0,0,0,0,OFFICE NO. 2 NEWCASTLE PUBLIC SCHOOLS
MCCURTAIN,PROPOSITION NO. 1 BROKEN BOW PUBLIC SCHOOLS,FOR THE PROPOSITION - YES,,450008,0,0,0,0,PROPOSITION NO. 1 BROKEN BOW PUBLIC SCHOOLS
MCCURTAIN,PROPOSITION NO. 1 BROKEN BOW PUBLIC SCHOOLS,AGAINST THE PROPOSITION - NO,,450008,0,0,0,0,PROPOSITION NO. 1 BROKEN BOW PUBLIC SCHOOLS
MCCURTAIN,PROPOSITION NO. 2 BROKEN BOW PUBLIC SCHOOLS,FOR THE PROPOSITION - YES,,450008,0,0,0,0,PROPOSITION NO. 2 BROKEN BOW PUBLIC SCHOOLS
MCCURTAIN,PROPOSITION NO. 2 BROKEN BOW PUBLIC SCHOOLS,AGAINST THE PROPOSITION - NO,,450008,0,0,0,0,PROPOSITION NO. 2 BROKEN BOW PUBLIC SCHOOLS
MCCURTAIN,OFFICE NO. 2 HAWORTH PUBLIC SCHOOLS,HANK FARLEY,,450011,5,5,38,48,OFFICE NO. 2 HAWORTH PUBLIC SCHOOLS
MCCURTAIN,OFFICE NO. 2 HAWORTH PUBLIC SCHOOLS,CHARLES R. LEWIS,,450011,0,1,16,17,OFFICE NO. 2 HAWORTH PUBLIC SCHOOLS
MCCURTAIN,OFFICE NO. 4 (UNEXPIRED TERM) HAWORTH PUBLIC SCHOOLS,SHANNON LONG,,450011,2,2,44,48,OFFICE NO. 4 (UNEXPIRED TERM) HAWORTH PUBLIC SCHOOLS
MCCURTAIN,OFFICE NO. 4 (UNEXPIRED TERM) HAWORTH PUBLIC SCHOOLS,SHIRLEY POGUE,,450011,3,4,12,19,OFFICE NO. 4 (UNEXPIRED TERM) HAWORTH PUBLIC SCHOOLS
MCCURTAIN,OFFICE NO. 2 HAWORTH PUBLIC SCHOOLS,HANK FARLEY,,450012,0,1,10,11,OFFICE NO. 2 HAWORTH PUBLIC SCHOOLS
MCCURTAIN,OFFICE NO. 2 HAWORTH PUBLIC SCHOOLS,CHARLES R. LEWIS,,450012,0,1,24,25,OFFICE NO. 2 HAWORTH PUBLIC SCHOOLS
MCCURTAIN,OFFICE NO. 4 (UNEXPIRED TERM) HAWORTH PUBLIC SCHOOLS,SHANNON LONG,,450012,0,1,22,23,OFFICE NO. 4 (UNEXPIRED TERM) HAWORTH PUBLIC SCHOOLS
MCCURTAIN,OFFICE NO. 4 (UNEXPIRED TERM) HAWORTH PUBLIC SCHOOLS,SHIRLEY POGUE,,450012,0,1,7,8,OFFICE NO. 4 (UNEXPIRED TERM) HAWORTH PUBLIC SCHOOLS
MCCURTAIN,OFFICE NO. 2 HAWORTH PUBLIC SCHOOLS,HANK FARLEY,,450013,1,6,72,79,OFFICE NO. 2 HAWORTH PUBLIC SCHOOLS
MCCURTAIN,OFFICE NO. 2 HAWORTH PUBLIC SCHOOLS,CHARLES R. LEWIS,,450013,0,9,28,37,OFFICE NO. 2 HAWORTH PUBLIC SCHOOLS
MCCURTAIN,OFFICE NO. 4 (UNEXPIRED TERM) HAWORTH PUBLIC SCHOOLS,SHANNON LONG,,450013,0,9,50,59,OFFICE NO. 4 (UNEXPIRED TERM) HAWORTH PUBLIC SCHOOLS
MCCURTAIN,OFFICE NO. 4 (UNEXPIRED TERM) HAWORTH PUBLIC SCHOOLS,SHIRLEY POGUE,,450013,1,6,50,57,OFFICE NO. 4 (UNEXPIRED TERM) HAWORTH PUBLIC SCHOOLS
MCCURTAIN,OFFICE NO. 2 HAWORTH PUBLIC SCHOOLS,HANK FARLEY,,450014,0,1,24,25,OFFICE NO. 2 HAWORTH PUBLIC SCHOOLS
MCCURTAIN,OFFICE NO. 2 HAWORTH PUBLIC SCHOOLS,CHARLES R. LEWIS,,450014,0,1,16,17,OFFICE NO. 2 HAWORTH PUBLIC SCHOOLS
MCCURTAIN,OFFICE NO. 4 (UNEXPIRED TERM) HAWORTH PUBLIC SCHOOLS,SHANNON LONG,,450014,0,2,27,29,OFFICE NO. 4 (UNEXPIRED TERM) HAWORTH PUBLIC SCHOOLS
MCCURTAIN,OFFICE NO. 4 (UNEXPIRED TERM) HAWORTH PUBLIC SCHOOLS,SHIRLEY POGUE,,450014,0,0,13,13,OFFICE NO. 4 (UNEXPIRED TERM) HAWORTH PUBLIC SCHOOLS
MCCURTAIN,OFFICE NO. 2 HAWORTH PUBLIC SCHOOLS,HANK FARLEY,,450015,0,0,57,57,OFFICE NO. 2 HAWORTH PUBLIC SCHOOLS
MCCURTAIN,OFFICE NO. 2 HAWORTH PUBLIC SCHOOLS,CHARLES R. LEWIS,,450015,0,0,23,23,OFFICE NO. 2 HAWORTH PUBLIC SCHOOLS
MCCURTAIN,OFFICE NO. 4 (UNEXPIRED TERM) HAWORTH PUBLIC SCHOOLS,SHANNON LONG,,450015,0,0,40,40,OFFICE NO. 4 (UNEXPIRED TERM) HAWORTH PUBLIC SCHOOLS
MCCURTAIN,OFFICE NO. 4 (UNEXPIRED TERM) HAWORTH PUBLIC SCHOOLS,SHIRLEY POGUE,,450015,0,0,39,39,OFFICE NO. 4 (UNEXPIRED TERM) HAWORTH PUBLIC SCHOOLS
MCCURTAIN,PROPOSITION NO. 1 BROKEN BOW PUBLIC SCHOOLS,FOR THE PROPOSITION - YES,,450017,2,10,41,53,PROPOSITION NO. 1 BROKEN BOW PUBLIC SCHOOLS
MCCURTAIN,PROPOSITION NO. 1 BROKEN BOW PUBLIC SCHOOLS,AGAINST THE PROPOSITION - NO,,450017,1,0,4,5,PROPOSITION NO. 1 BROKEN BOW PUBLIC SCHOOLS
MCCURTAIN,PROPOSITION NO. 2 BROKEN BOW PUBLIC SCHOOLS,FOR THE PROPOSITION - YES,,450017,4,10,42,56,PROPOSITION NO. 2 BROKEN BOW PUBLIC SCHOOLS
MCCURTAIN,PROPOSITION NO. 2 BROKEN BOW PUBLIC SCHOOLS,AGAINST THE PROPOSITION - NO,,450017,0,0,3,3,PROPOSITION NO. 2 BROKEN BOW PUBLIC SCHOOLS
MCCURTAIN,PROPOSITION NO. 1 BROKEN BOW PUBLIC SCHOOLS,FOR THE PROPOSITION - YES,,450018,4,13,123,140,PROPOSITION NO. 1 BROKEN BOW PUBLIC SCHOOLS
MCCURTAIN,PROPOSITION NO. 1 BROKEN BOW PUBLIC SCHOOLS,AGAINST THE PROPOSITION - NO,,450018,1,0,6,7,PROPOSITION NO. 1 BROKEN BOW PUBLIC SCHOOLS
MCCURTAIN,PROPOSITION NO. 2 BROKEN BOW PUBLIC SCHOOLS,FOR THE PROPOSITION - YES,,450018,3,12,124,139,PROPOSITION NO. 2 BROKEN BOW PUBLIC SCHOOLS
MCCURTAIN,PROPOSITION NO. 2 BROKEN BOW PUBLIC SCHOOLS,AGAINST THE PROPOSITION - NO,,450018,2,0,5,7,PROPOSITION NO. 2 BROKEN BOW PUBLIC SCHOOLS
MCCURTAIN,PROPOSITION NO. 1 BROKEN BOW PUBLIC SCHOOLS,FOR THE PROPOSITION - YES,,450019,0,16,109,125,PROPOSITION NO. 1 BROKEN BOW PUBLIC SCHOOLS
MCCURTAIN,PROPOSITION NO. 1 BROKEN BOW PUBLIC SCHOOLS,AGAINST THE PROPOSITION - NO,,450019,0,0,8,8,PROPOSITION NO. 1 BROKEN BOW PUBLIC SCHOOLS
MCCURTAIN,PROPOSITION NO. 2 BROKEN BOW PUBLIC SCHOOLS,FOR THE PROPOSITION - YES,,450019,0,16,112,128,PROPOSITION NO. 2 BROKEN BOW PUBLIC SCHOOLS
MCCURTAIN,PROPOSITION NO. 2 BROKEN BOW PUBLIC SCHOOLS,AGAINST THE PROPOSITION - NO,,450019,0,0,6,6,PROPOSITION NO. 2 BROKEN BOW PUBLIC SCHOOLS
MCCURTAIN,OFFICE NO. 2 BATTIEST PUBLIC SCHOOLS,JAMES HAMILTON,,450020,0,0,5,5,OFFICE NO. 2 BATTIEST PUBLIC SCHOOLS
MCCURTAIN,OFFICE NO. 2 BATTIEST PUBLIC SCHOOLS,JEFF PERRIN,,450020,0,0,0,0,OFFICE NO. 2 BATTIEST PUBLIC SCHOOLS
MCCURTAIN,PROPOSITION NO. 1 BROKEN BOW PUBLIC SCHOOLS,FOR THE PROPOSITION - YES,,450020,1,6,23,30,PROPOSITION NO. 1 BROKEN BOW PUBLIC SCHOOLS
MCCURTAIN,PROPOSITION NO. 1 BROKEN BOW PUBLIC SCHOOLS,AGAINST THE PROPOSITION - NO,,450020,0,0,0,0,PROPOSITION NO. 1 BROKEN BOW PUBLIC SCHOOLS
MCCURTAIN,PROPOSITION NO. 2 BROKEN BOW PUBLIC SCHOOLS,FOR THE PROPOSITION - YES,,450020,1,5,23,29,PROPOSITION NO. 2 BROKEN BOW PUBLIC SCHOOLS
MCCURTAIN,PROPOSITION NO. 2 BROKEN BOW PUBLIC SCHOOLS,AGAINST THE PROPOSITION - NO,,450020,0,1,0,1,PROPOSITION NO. 2 BROKEN BOW PUBLIC SCHOOLS
MCCURTAIN,PROPOSITION NO. 1 GLOVER PUBLIC SCHOOL,FOR THE PROPOSITION - YES,,450020,0,0,0,0,PROPOSITION NO. 1 GLOVER PUBLIC SCHOOL
MCCURTAIN,PROPOSITION NO. 1 GLOVER PUBLIC SCHOOL,AGAINST THE PROPOSITION - NO,,450020,0,0,0,0,PROPOSITION NO. 1 GLOVER PUBLIC SCHOOL
MCCURTAIN,PROPOSITION NO. 2 GLOVER PUBLIC SCHOOL,FOR THE PROPOSITION - YES,,450020,0,0,0,0,PROPOSITION NO. 2 GLOVER PUBLIC SCHOOL
MCCURTAIN,PROPOSITION NO. 2 GLOVER PUBLIC SCHOOL,AGAINST THE PROPOSITION - NO,,450020,0,0,0,0,PROPOSITION NO. 2 GLOVER PUBLIC SCHOOL
MCCURTAIN,PROPOSITION NO. 1 BROKEN BOW PUBLIC SCHOOLS,FOR THE PROPOSITION - YES,,450022,4,4,59,67,PROPOSITION NO. 1 BROKEN BOW PUBLIC SCHOOLS
MCCURTAIN,PROPOSITION NO. 1 BROKEN BOW PUBLIC SCHOOLS,AGAINST THE PROPOSITION - NO,,450022,3,0,6,9,PROPOSITION NO. 1 BROKEN BOW PUBLIC SCHOOLS
MCCURTAIN,PROPOSITION NO. 2 BROKEN BOW PUBLIC SCHOOLS,FOR THE PROPOSITION - YES,,450022,4,4,60,68,PROPOSITION NO. 2 BROKEN BOW PUBLIC SCHOOLS
MCCURTAIN,PROPOSITION NO. 2 BROKEN BOW PUBLIC SCHOOLS,AGAINST THE PROPOSITION - NO,,450022,3,0,6,9,PROPOSITION NO. 2 BROKEN BOW PUBLIC SCHOOLS
MCCURTAIN,PROPOSITION NO. 1 BROKEN BOW PUBLIC SCHOOLS,FOR THE PROPOSITION - YES,,450023,0,0,0,0,PROPOSITION NO. 1 BROKEN BOW PUBLIC SCHOOLS
MCCURTAIN,PROPOSITION NO. 1 BROKEN BOW PUBLIC SCHOOLS,AGAINST THE PROPOSITION - NO,,450023,0,0,0,0,PROPOSITION NO. 1 BROKEN BOW PUBLIC SCHOOLS
MCCURTAIN,PROPOSITION NO. 2 BROKEN BOW PUBLIC SCHOOLS,FOR THE PROPOSITION - YES,,450023,0,0,0,0,PROPOSITION NO. 2 BROKEN BOW PUBLIC SCHOOLS
MCCURTAIN,PROPOSITION NO. 2 BROKEN BOW PUBLIC SCHOOLS,AGAINST THE PROPOSITION - NO,,450023,0,0,0,0,PROPOSITION NO. 2 BROKEN BOW PUBLIC SCHOOLS
MCCURTAIN,OFFICE NO. 2 BATTIEST PUBLIC SCHOOLS,JAMES HAMILTON,,450024,0,0,23,23,OFFICE NO. 2 BATTIEST PUBLIC SCHOOLS
MCCURTAIN,OFFICE NO. 2 BATTIEST PUBLIC SCHOOLS,JEFF PERRIN,,450024,2,0,17,19,OFFICE NO. 2 BATTIEST PUBLIC SCHOOLS
MCCURTAIN,OFFICE NO. 2 BATTIEST PUBLIC SCHOOLS,JAMES HAMILTON,,450027,1,0,19,20,OFFICE NO. 2 BATTIEST PUBLIC SCHOOLS
MCCURTAIN,OFFICE NO. 2 BATTIEST PUBLIC SCHOOLS,JEFF PERRIN,,450027,1,0,33,34,OFFICE NO. 2 BATTIEST PUBLIC SCHOOLS
MCCURTAIN,OFFICE NO. 2 BATTIEST PUBLIC SCHOOLS,JAMES HAMILTON,,450028,0,0,9,9,OFFICE NO. 2 BATTIEST PUBLIC SCHOOLS
MCCURTAIN,OFFICE NO. 2 BATTIEST PUBLIC SCHOOLS,JEFF PERRIN,,450028,0,0,20,20,OFFICE NO. 2 BATTIEST PUBLIC SCHOOLS
MCCURTAIN,PROPOSITION NO. 1 GLOVER PUBLIC SCHOOL,FOR THE PROPOSITION - YES,,450029,0,1,26,27,PROPOSITION NO. 1 GLOVER PUBLIC SCHOOL
MCCURTAIN,PROPOSITION NO. 1 GLOVER PUBLIC SCHOOL,AGAINST THE PROPOSITION - NO,,450029,0,0,10,10,PROPOSITION NO. 1 GLOVER PUBLIC SCHOOL
MCCURTAIN,PROPOSITION NO. 2 GLOVER PUBLIC SCHOOL,FOR THE PROPOSITION - YES,,450029,0,1,26,27,PROPOSITION NO. 2 GLOVER PUBLIC SCHOOL
MCCURTAIN,PROPOSITION NO. 2 GLOVER PUBLIC SCHOOL,AGAINST THE PROPOSITION - NO,,450029,0,0,10,10,PROPOSITION NO. 2 GLOVER PUBLIC SCHOOL
MCCURTAIN,PROPOSITION NO. 1 BROKEN BOW PUBLIC SCHOOLS,FOR THE PROPOSITION - YES,,450031,0,0,1,1,PROPOSITION NO. 1 BROKEN BOW PUBLIC SCHOOLS
MCCURTAIN,PROPOSITION NO. 1 BROKEN BOW PUBLIC SCHOOLS,AGAINST THE PROPOSITION - NO,,450031,0,0,1,1,PROPOSITION NO. 1 BROKEN BOW PUBLIC SCHOOLS
MCCURTAIN,PROPOSITION NO. 2 BROKEN BOW PUBLIC SCHOOLS,FOR THE PROPOSITION - YES,,450031,0,0,1,1,PROPOSITION NO. 2 BROKEN BOW PUBLIC SCHOOLS
MCCURTAIN,PROPOSITION NO. 2 BROKEN BOW PUBLIC SCHOOLS,AGAINST THE PROPOSITION - NO,,450031,0,0,1,1,PROPOSITION NO. 2 BROKEN BOW PUBLIC SCHOOLS
MCCURTAIN,PROPOSITION NO. 1 GLOVER PUBLIC SCHOOL,FOR THE PROPOSITION - YES,,450038,0,0,0,0,PROPOSITION NO. 1 GLOVER PUBLIC SCHOOL
MCCURTAIN,PROPOSITION NO. 1 GLOVER PUBLIC SCHOOL,AGAINST THE PROPOSITION - NO,,450038,0,0,0,0,PROPOSITION NO. 1 GLOVER PUBLIC SCHOOL
MCCURTAIN,PROPOSITION NO. 2 GLOVER PUBLIC SCHOOL,FOR THE PROPOSITION - YES,,450038,0,0,0,0,PROPOSITION NO. 2 GLOVER PUBLIC SCHOOL
MCCURTAIN,PROPOSITION NO. 2 GLOVER PUBLIC SCHOOL,AGAINST THE PROPOSITION - NO,,450038,0,0,0,0,PROPOSITION NO. 2 GLOVER PUBLIC SCHOOL
MCINTOSH,OFFICE NO. 2 INDIAN CAPITAL TECH CENTER,TOM STILES,,460102,1,0,7,8,OFFICE NO. 2 INDIAN CAPITAL TECH CENTER
MCINTOSH,OFFICE NO. 2 INDIAN CAPITAL TECH CENTER,RAY KIRK,,460102,0,1,7,8,OFFICE NO. 2 INDIAN CAPITAL TECH CENTER
MCINTOSH,OFFICE NO. 2 INDIAN CAPITAL TECH CENTER,TOM STILES,,460103,1,1,19,21,OFFICE NO. 2 INDIAN CAPITAL TECH CENTER
MCINTOSH,OFFICE NO. 2 INDIAN CAPITAL TECH CENTER,RAY KIRK,,460103,2,0,9,11,OFFICE NO. 2 INDIAN CAPITAL TECH CENTER
MCINTOSH,OFFICE NO. 2 EUFAULA PUBLIC SCHOOLS,DEREK GRAY,,460104,0,0,1,1,OFFICE NO. 2 EUFAULA PUBLIC SCHOOLS
MCINTOSH,OFFICE NO. 2 EUFAULA PUBLIC SCHOOLS,RACHEL S. DODD,,460104,0,1,3,4,OFFICE NO. 2 EUFAULA PUBLIC SCHOOLS
MCINTOSH,OFFICE NO. 1 (UNEXPIRED TERM) EUFAULA PUBLIC SCHOOLS,TERRY BURNS,,460104,0,1,2,3,OFFICE NO. 1 (UNEXPIRED TERM) EUFAULA PUBLIC SCHOOLS
MCINTOSH,OFFICE NO. 1 (UNEXPIRED TERM) EUFAULA PUBLIC SCHOOLS,BRENDON BRIDGES,,460104,0,0,2,2,OFFICE NO. 1 (UNEXPIRED TERM) EUFAULA PUBLIC SCHOOLS
MCINTOSH,OFFICE NO. 2 INDIAN CAPITAL TECH CENTER,TOM STILES,,460104,1,0,2,3,OFFICE NO. 2 INDIAN CAPITAL TECH CENTER
MCINTOSH,OFFICE NO. 2 INDIAN CAPITAL TECH CENTER,RAY KIRK,,460104,1,0,2,3,OFFICE NO. 2 INDIAN CAPITAL TECH CENTER
MCINTOSH,OFFICE NO. 2 EUFAULA PUBLIC SCHOOLS,DEREK GRAY,,460201,3,30,159,192,OFFICE NO. 2 EUFAULA PUBLIC SCHOOLS
MCINTOSH,OFFICE NO. 2 EUFAULA PUBLIC SCHOOLS,RACHEL S. DODD,,460201,1,15,100,116,OFFICE NO. 2 EUFAULA PUBLIC SCHOOLS
MCINTOSH,OFFICE NO. 1 (UNEXPIRED TERM) EUFAULA PUBLIC SCHOOLS,TERRY BURNS,,460201,0,15,92,107,OFFICE NO. 1 (UNEXPIRED TERM) EUFAULA PUBLIC SCHOOLS
MCINTOSH,OFFICE NO. 1 (UNEXPIRED TERM) EUFAULA PUBLIC SCHOOLS,BRENDON BRIDGES,,460201,4,32,171,207,OFFICE NO. 1 (UNEXPIRED TERM) EUFAULA PUBLIC SCHOOLS
MCINTOSH,OFFICE NO. 2 EUFAULA PUBLIC SCHOOLS,DEREK GRAY,,460203,0,10,50,60,OFFICE NO. 2 EUFAULA PUBLIC SCHOOLS
MCINTOSH,OFFICE NO. 2 EUFAULA PUBLIC SCHOOLS,RACHEL S. DODD,,460203,0,6,37,43,OFFICE NO. 2 EUFAULA PUBLIC SCHOOLS
MCINTOSH,OFFICE NO. 1 (UNEXPIRED TERM) EUFAULA PUBLIC SCHOOLS,TERRY BURNS,,460203,0,3,32,35,OFFICE NO. 1 (UNEXPIRED TERM) EUFAULA PUBLIC SCHOOLS
MCINTOSH,OFFICE NO. 1 (UNEXPIRED TERM) EUFAULA PUBLIC SCHOOLS,BRENDON BRIDGES,,460203,0,13,60,73,OFFICE NO. 1 (UNEXPIRED TERM) EUFAULA PUBLIC SCHOOLS
MCINTOSH,OFFICE NO. 2 EUFAULA PUBLIC SCHOOLS,DEREK GRAY,,460205,1,3,15,19,OFFICE NO. 2 EUFAULA PUBLIC SCHOOLS
MCINTOSH,OFFICE NO. 2 EUFAULA PUBLIC SCHOOLS,RACHEL S. DODD,,460205,1,3,26,30,OFFICE NO. 2 EUFAULA PUBLIC SCHOOLS
MCINTOSH,OFFICE NO. 1 (UNEXPIRED TERM) EUFAULA PUBLIC SCHOOLS,TERRY BURNS,,460205,1,3,17,21,OFFICE NO. 1 (UNEXPIRED TERM) EUFAULA PUBLIC SCHOOLS
MCINTOSH,OFFICE NO. 1 (UNEXPIRED TERM) EUFAULA PUBLIC SCHOOLS,BRENDON BRIDGES,,460205,1,3,25,29,OFFICE NO. 1 (UNEXPIRED TERM) EUFAULA PUBLIC SCHOOLS
MCINTOSH,OFFICE NO. 2 INDIAN CAPITAL TECH CENTER,TOM STILES,,460205,0,0,3,3,OFFICE NO. 2 INDIAN CAPITAL TECH CENTER
MCINTOSH,OFFICE NO. 2 INDIAN CAPITAL TECH CENTER,RAY KIRK,,460205,0,2,5,7,OFFICE NO. 2 INDIAN CAPITAL TECH CENTER
MCINTOSH,OFFICE NO. 2 EUFAULA PUBLIC SCHOOLS,DEREK GRAY,,460307,1,5,64,70,OFFICE NO. 2 EUFAULA PUBLIC SCHOOLS
MCINTOSH,OFFICE NO. 2 EUFAULA PUBLIC SCHOOLS,RACHEL S. DODD,,460307,0,5,49,54,OFFICE NO. 2 EUFAULA PUBLIC SCHOOLS
MCINTOSH,OFFICE NO. 1 (UNEXPIRED TERM) EUFAULA PUBLIC SCHOOLS,TERRY BURNS,,460307,0,2,49,51,OFFICE NO. 1 (UNEXPIRED TERM) EUFAULA PUBLIC SCHOOLS
MCINTOSH,OFFICE NO. 1 (UNEXPIRED TERM) EUFAULA PUBLIC SCHOOLS,BRENDON BRIDGES,,460307,1,9,65,75,OFFICE NO. 1 (UNEXPIRED TERM) EUFAULA PUBLIC SCHOOLS
MCINTOSH,PROPOSITION NO. 1 GRAHAM-DUSTIN PUBLIC SCHOOLS,FOR THE PROPOSITION - YES,,460310,0,0,1,1,PROPOSITION NO. 1 GRAHAM-DUSTIN PUBLIC SCHOOLS
MCINTOSH,PROPOSITION NO. 1 GRAHAM-DUSTIN PUBLIC SCHOOLS,AGAINST THE PROPOSITION - NO,,460310,0,0,1,1,PROPOSITION NO. 1 GRAHAM-DUSTIN PUBLIC SCHOOLS
MCINTOSH,PROPOSITION NO. 2 GRAHAM-DUSTIN PUBLIC SCHOOLS,FOR THE PROPOSITION - YES,,460310,0,0,1,1,PROPOSITION NO. 2 GRAHAM-DUSTIN PUBLIC SCHOOLS
MCINTOSH,PROPOSITION NO. 2 GRAHAM-DUSTIN PUBLIC SCHOOLS,AGAINST THE PROPOSITION - NO,,460310,0,0,1,1,PROPOSITION NO. 2 GRAHAM-DUSTIN PUBLIC SCHOOLS
MCINTOSH,PROPOSITION NO. 1 GRAHAM-DUSTIN PUBLIC SCHOOLS,FOR THE PROPOSITION - YES,,460312,0,0,3,3,PROPOSITION NO. 1 GRAHAM-DUSTIN PUBLIC SCHOOLS
MCINTOSH,PROPOSITION NO. 1 GRAHAM-DUSTIN PUBLIC SCHOOLS,AGAINST THE PROPOSITION - NO,,460312,0,0,1,1,PROPOSITION NO. 1 GRAHAM-DUSTIN PUBLIC SCHOOLS
MCINTOSH,PROPOSITION NO. 2 GRAHAM-DUSTIN PUBLIC SCHOOLS,FOR THE PROPOSITION - YES,,460312,0,0,3,3,PROPOSITION NO. 2 GRAHAM-DUSTIN PUBLIC SCHOOLS
MCINTOSH,PROPOSITION NO. 2 GRAHAM-DUSTIN PUBLIC SCHOOLS,AGAINST THE PROPOSITION - NO,,460312,0,0,1,1,PROPOSITION NO. 2 GRAHAM-DUSTIN PUBLIC SCHOOLS
MCINTOSH,OFFICE NO. 2 INDIAN CAPITAL TECH CENTER,TOM STILES,,460313,0,0,0,0,OFFICE NO. 2 INDIAN CAPITAL TECH CENTER
MCINTOSH,OFFICE NO. 2 INDIAN CAPITAL TECH CENTER,RAY KIRK,,460313,0,0,1,1,OFFICE NO. 2 INDIAN CAPITAL TECH CENTER
MCINTOSH,OFFICE NO. 2 HENRYETTA PUBLIC SCHOOLS,JAMES WILLIAMS,,460313,0,0,0,0,OFFICE NO. 2 HENRYETTA PUBLIC SCHOOLS
MCINTOSH,OFFICE NO. 2 HENRYETTA PUBLIC SCHOOLS,DAVID BULLARD,,460313,0,0,0,0,OFFICE NO. 2 HENRYETTA PUBLIC SCHOOLS
MCINTOSH,OFFICE NO. 4 (UNEXPIRED TERM) HENRYETTA PUBLIC SCHOOLS,GARY CLASON,,460313,0,0,0,0,OFFICE NO. 4 (UNEXPIRED TERM) HENRYETTA PUBLIC SCHOOLS
MCINTOSH,OFFICE NO. 4 (UNEXPIRED TERM) HENRYETTA PUBLIC SCHOOLS,CASEY JONES,,460313,0,0,0,0,OFFICE NO. 4 (UNEXPIRED TERM) HENRYETTA PUBLIC SCHOOLS
MCINTOSH,OFFICE NO. 2 EUFAULA PUBLIC SCHOOLS,DEREK GRAY,,460314,2,1,9,12,OFFICE NO. 2 EUFAULA PUBLIC SCHOOLS
MCINTOSH,OFFICE NO. 2 EUFAULA PUBLIC SCHOOLS,RACHEL S. DODD,,460314,0,4,9,13,OFFICE NO. 2 EUFAULA PUBLIC SCHOOLS
MCINTOSH,OFFICE NO. 1 (UNEXPIRED TERM) EUFAULA PUBLIC SCHOOLS,TERRY BURNS,,460314,0,2,6,8,OFFICE NO. 1 (UNEXPIRED TERM) EUFAULA PUBLIC SCHOOLS
MCINTOSH,OFFICE NO. 1 (UNEXPIRED TERM) EUFAULA PUBLIC SCHOOLS,BRENDON BRIDGES,,460314,2,4,13,19,OFFICE NO. 1 (UNEXPIRED TERM) EUFAULA PUBLIC SCHOOLS
MCINTOSH,OFFICE NO. 2 INDIAN CAPITAL TECH CENTER,TOM STILES,,460314,3,0,4,7,OFFICE NO. 2 INDIAN CAPITAL TECH CENTER
MCINTOSH,OFFICE NO. 2 INDIAN CAPITAL TECH CENTER,RAY KIRK,,460314,0,1,3,4,OFFICE NO. 2 INDIAN CAPITAL TECH CENTER
MCINTOSH,OFFICE NO. 2 MIDWAY PUBLIC SCHOOLS,CAL HORSLEY,,460315,0,0,62,62,OFFICE NO. 2 MIDWAY PUBLIC SCHOOLS
MCINTOSH,OFFICE NO. 2 MIDWAY PUBLIC SCHOOLS,GARY LEE DUVALL,,460315,2,0,21,23,OFFICE NO. 2 MIDWAY PUBLIC SCHOOLS
MCINTOSH,OFFICE NO. 2 INDIAN CAPITAL TECH CENTER,TOM STILES,,460315,0,0,62,62,OFFICE NO. 2 INDIAN CAPITAL TECH CENTER
MCINTOSH,OFFICE NO. 2 INDIAN CAPITAL TECH CENTER,RAY KIRK,,460315,2,0,17,19,OFFICE NO. 2 INDIAN CAPITAL TECH CENTER
MCINTOSH,OFFICE NO. 2 MIDWAY PUBLIC SCHOOLS,CAL HORSLEY,,460316,0,0,21,21,OFFICE NO. 2 MIDWAY PUBLIC SCHOOLS
MCINTOSH,OFFICE NO. 2 MIDWAY PUBLIC SCHOOLS,GARY LEE DUVALL,,460316,0,0,4,4,OFFICE NO. 2 MIDWAY PUBLIC SCHOOLS
MCINTOSH,OFFICE NO. 2 INDIAN CAPITAL TECH CENTER,TOM STILES,,460316,0,0,19,19,OFFICE NO. 2 INDIAN CAPITAL TECH CENTER
MCINTOSH,OFFICE NO. 2 INDIAN CAPITAL TECH CENTER,RAY KIRK,,460316,0,0,6,6,OFFICE NO. 2 INDIAN CAPITAL TECH CENTER
MAJOR,OFFICE NO. 2 TIMBERLAKE PUBLIC SCHOOLS,QUENTIN STURGEON,,470002,0,0,0,0,OFFICE NO. 2 TIMBERLAKE PUBLIC SCHOOLS
MAJOR,OFFICE NO. 2 TIMBERLAKE PUBLIC SCHOOLS,JAY JENLINK,,470002,0,0,0,0,OFFICE NO. 2 TIMBERLAKE PUBLIC SCHOOLS
MAJOR,OFFICE NO. 2 TIMBERLAKE PUBLIC SCHOOLS,CHRIS CLIFT,,470002,0,0,0,0,OFFICE NO. 2 TIMBERLAKE PUBLIC SCHOOLS
MAJOR,PROPOSITION NO. 1 CIMARRON PUBLIC SCHOOLS,FOR THE PROPOSITION - YES,,470002,1,1,5,7,PROPOSITION NO. 1 CIMARRON PUBLIC SCHOOLS
MAJOR,PROPOSITION NO. 1 CIMARRON PUBLIC SCHOOLS,AGAINST THE PROPOSITION - NO,,470002,0,0,2,2,PROPOSITION NO. 1 CIMARRON PUBLIC SCHOOLS
MAJOR,PROPOSITION NO. 2 CIMARRON PUBLIC SCHOOLS,FOR THE PROPOSITION - YES,,470002,1,0,6,7,PROPOSITION NO. 2 CIMARRON PUBLIC SCHOOLS
MAJOR,PROPOSITION NO. 2 CIMARRON PUBLIC SCHOOLS,AGAINST THE PROPOSITION - NO,,470002,0,1,1,2,PROPOSITION NO. 2 CIMARRON PUBLIC SCHOOLS
MAJOR,OFFICE NO. 2 WAYNOKA PUBLIC SCHOOLS,TRAVIS GEORGE,,470009,2,0,9,11,OFFICE NO. 2 WAYNOKA PUBLIC SCHOOLS
MAJOR,OFFICE NO. 2 WAYNOKA PUBLIC SCHOOLS,MINDY ZOOK,,470009,2,0,13,15,OFFICE NO. 2 WAYNOKA PUBLIC SCHOOLS
MAJOR,OFFICE NO. 2 WAYNOKA PUBLIC SCHOOLS,JENNIFER RICH,,470009,0,0,0,0,OFFICE NO. 2 WAYNOKA PUBLIC SCHOOLS
MAJOR,PROPOSITION NO. 1 FAIRVIEW PUBLIC SCHOOLS,FOR THE PROPOSITION - YES,,470010,1,1,0,2,PROPOSITION NO. 1 FAIRVIEW PUBLIC SCHOOLS
MAJOR,PROPOSITION NO. 1 FAIRVIEW PUBLIC SCHOOLS,AGAINST THE PROPOSITION - NO,,470010,0,0,1,1,PROPOSITION NO. 1 FAIRVIEW PUBLIC SCHOOLS
MAJOR,PROPOSITION NO. 2 FAIRVIEW PUBLIC SCHOOLS,FOR THE PROPOSITION - YES,,470010,0,1,0,1,PROPOSITION NO. 2 FAIRVIEW PUBLIC SCHOOLS
MAJOR,PROPOSITION NO. 2 FAIRVIEW PUBLIC SCHOOLS,AGAINST THE PROPOSITION - NO,,470010,1,0,1,2,PROPOSITION NO. 2 FAIRVIEW PUBLIC SCHOOLS
MAJOR,OFFICE NO. 2 OKEENE PUBLIC SCHOOLS,MICHAEL WILLIAMS,,470015,0,0,0,0,OFFICE NO. 2 OKEENE PUBLIC SCHOOLS
MAJOR,OFFICE NO. 2 OKEENE PUBLIC SCHOOLS,BRANDON SWAIM,,470015,0,0,0,0,OFFICE NO. 2 OKEENE PUBLIC SCHOOLS
MAJOR,PROPOSITION NO. 1 CIMARRON PUBLIC SCHOOLS,FOR THE PROPOSITION - YES,,470015,0,1,32,33,PROPOSITION NO. 1 CIMARRON PUBLIC SCHOOLS
MAJOR,PROPOSITION NO. 1 CIMARRON PUBLIC SCHOOLS,AGAINST THE PROPOSITION - NO,,470015,0,0,34,34,PROPOSITION NO. 1 CIMARRON PUBLIC SCHOOLS
MAJOR,PROPOSITION NO. 2 CIMARRON PUBLIC SCHOOLS,FOR THE PROPOSITION - YES,,470015,0,1,37,38,PROPOSITION NO. 2 CIMARRON PUBLIC SCHOOLS
MAJOR,PROPOSITION NO. 2 CIMARRON PUBLIC SCHOOLS,AGAINST THE PROPOSITION - NO,,470015,0,0,29,29,PROPOSITION NO. 2 CIMARRON PUBLIC SCHOOLS
MAJOR,OFFICE NO. 2 OKEENE PUBLIC SCHOOLS,MICHAEL WILLIAMS,,470016,0,0,0,0,OFFICE NO. 2 OKEENE PUBLIC SCHOOLS
MAJOR,OFFICE NO. 2 OKEENE PUBLIC SCHOOLS,BRANDON SWAIM,,470016,0,0,0,0,OFFICE NO. 2 OKEENE PUBLIC SCHOOLS
MAJOR,PROPOSITION NO. 1 CIMARRON PUBLIC SCHOOLS,FOR THE PROPOSITION - YES,,470016,0,0,15,15,PROPOSITION NO. 1 CIMARRON PUBLIC SCHOOLS
MAJOR,PROPOSITION NO. 1 CIMARRON PUBLIC SCHOOLS,AGAINST THE PROPOSITION - NO,,470016,0,0,12,12,PROPOSITION NO. 1 CIMARRON PUBLIC SCHOOLS
MAJOR,PROPOSITION NO. 2 CIMARRON PUBLIC SCHOOLS,FOR THE PROPOSITION - YES,,470016,0,0,18,18,PROPOSITION NO. 2 CIMARRON PUBLIC SCHOOLS
MAJOR,PROPOSITION NO. 2 CIMARRON PUBLIC SCHOOLS,AGAINST THE PROPOSITION - NO,,470016,0,0,9,9,PROPOSITION NO. 2 CIMARRON PUBLIC SCHOOLS
MAJOR,OFFICE NO. 2 OKEENE PUBLIC SCHOOLS,MICHAEL WILLIAMS,,470020,1,0,0,1,OFFICE NO. 2 OKEENE PUBLIC SCHOOLS
MAJOR,OFFICE NO. 2 OKEENE PUBLIC SCHOOLS,BRANDON SWAIM,,470020,2,2,0,4,OFFICE NO. 2 OKEENE PUBLIC SCHOOLS
MAJOR,PROPOSITION NO. 1 FAIRVIEW PUBLIC SCHOOLS,FOR THE PROPOSITION - YES,,470020,9,13,190,212,PROPOSITION NO. 1 FAIRVIEW PUBLIC SCHOOLS
MAJOR,PROPOSITION NO. 1 FAIRVIEW PUBLIC SCHOOLS,AGAINST THE PROPOSITION - NO,,470020,4,6,108,118,PROPOSITION NO. 1 FAIRVIEW PUBLIC SCHOOLS
MAJOR,PROPOSITION NO. 2 FAIRVIEW PUBLIC SCHOOLS,FOR THE PROPOSITION - YES,,470020,11,17,241,269,PROPOSITION NO. 2 FAIRVIEW PUBLIC SCHOOLS
MAJOR,PROPOSITION NO. 2 FAIRVIEW PUBLIC SCHOOLS,AGAINST THE PROPOSITION - NO,,470020,3,2,58,63,PROPOSITION NO. 2 FAIRVIEW PUBLIC SCHOOLS
MAJOR,OFFICE NO. 2 CANTON PUBLIC SCHOOLS,MATT SWARTWOOD,,470022,0,0,0,0,OFFICE NO. 2 CANTON PUBLIC SCHOOLS
MAJOR,OFFICE NO. 2 CANTON PUBLIC SCHOOLS,MIKE NIX,,470022,1,2,0,3,OFFICE NO. 2 CANTON PUBLIC SCHOOLS
MAJOR,PROPOSITION NO. 1 FAIRVIEW PUBLIC SCHOOLS,FOR THE PROPOSITION - YES,,470022,3,17,117,137,PROPOSITION NO. 1 FAIRVIEW PUBLIC SCHOOLS
MAJOR,PROPOSITION NO. 1 FAIRVIEW PUBLIC SCHOOLS,AGAINST THE PROPOSITION - NO,,470022,3,21,63,87,PROPOSITION NO. 1 FAIRVIEW PUBLIC SCHOOLS
MAJOR,PROPOSITION NO. 2 FAIRVIEW PUBLIC SCHOOLS,FOR THE PROPOSITION - YES,,470022,3,26,140,169,PROPOSITION NO. 2 FAIRVIEW PUBLIC SCHOOLS
MAJOR,PROPOSITION NO. 2 FAIRVIEW PUBLIC SCHOOLS,AGAINST THE PROPOSITION - NO,,470022,3,12,40,55,PROPOSITION NO. 2 FAIRVIEW PUBLIC SCHOOLS
MAJOR,OFFICE NO. 2 WAYNOKA PUBLIC SCHOOLS,TRAVIS GEORGE,,470022,2,0,0,2,OFFICE NO. 2 WAYNOKA PUBLIC SCHOOLS
MAJOR,OFFICE NO. 2 WAYNOKA PUBLIC SCHOOLS,MINDY ZOOK,,470022,0,0,0,0,OFFICE NO. 2 WAYNOKA PUBLIC SCHOOLS
MAJOR,OFFICE NO. 2 WAYNOKA PUBLIC SCHOOLS,JENNIFER RICH,,470022,0,0,0,0,OFFICE NO. 2 WAYNOKA PUBLIC SCHOOLS
MARSHALL,OFFICE NO. 2 MADILL PUBLIC SCHOOLS,DONNY RALEY,,480101,2,3,69,74,OFFICE NO. 2 MADILL PUBLIC SCHOOLS
MARSHALL,OFFICE NO. 2 MADILL PUBLIC SCHOOLS,MARK GLENN,,480101,1,18,99,118,OFFICE NO. 2 MADILL PUBLIC SCHOOLS
MARSHALL,OFFICE NO. 2 MADILL PUBLIC SCHOOLS,DONNY RALEY,,480102,2,8,48,58,OFFICE NO. 2 MADILL PUBLIC SCHOOLS
MARSHALL,OFFICE NO. 2 MADILL PUBLIC SCHOOLS,MARK GLENN,,480102,0,10,83,93,OFFICE NO. 2 MADILL PUBLIC SCHOOLS
MARSHALL,OFFICE NO. 2 MADILL PUBLIC SCHOOLS,DONNY RALEY,,480105,3,3,24,30,OFFICE NO. 2 MADILL PUBLIC SCHOOLS
MARSHALL,OFFICE NO. 2 MADILL PUBLIC SCHOOLS,MARK GLENN,,480105,1,3,17,21,OFFICE NO. 2 MADILL PUBLIC SCHOOLS
MARSHALL,OFFICE NO. 2 MADILL PUBLIC SCHOOLS,DONNY RALEY,,480106,0,0,4,4,OFFICE NO. 2 MADILL PUBLIC SCHOOLS
MARSHALL,OFFICE NO. 2 MADILL PUBLIC SCHOOLS,MARK GLENN,,480106,0,0,2,2,OFFICE NO. 2 MADILL PUBLIC SCHOOLS
MARSHALL,OFFICE NO. 2 MADILL PUBLIC SCHOOLS,DONNY RALEY,,480201,0,2,30,32,OFFICE NO. 2 MADILL PUBLIC SCHOOLS
MARSHALL,OFFICE NO. 2 MADILL PUBLIC SCHOOLS,MARK GLENN,,480201,1,9,43,53,OFFICE NO. 2 MADILL PUBLIC SCHOOLS
MARSHALL,OFFICE NO. 2 MADILL PUBLIC SCHOOLS,DONNY RALEY,,480202,2,5,41,48,OFFICE NO. 2 MADILL PUBLIC SCHOOLS
MARSHALL,OFFICE NO. 2 MADILL PUBLIC SCHOOLS,MARK GLENN,,480202,2,5,40,47,OFFICE NO. 2 MADILL PUBLIC SCHOOLS
MARSHALL,OFFICE NO. 2 MADILL PUBLIC SCHOOLS,DONNY RALEY,,480204,1,0,6,7,OFFICE NO. 2 MADILL PUBLIC SCHOOLS
MARSHALL,OFFICE NO. 2 MADILL PUBLIC SCHOOLS,MARK GLENN,,480204,0,4,12,16,OFFICE NO. 2 MADILL PUBLIC SCHOOLS
MARSHALL,OFFICE NO. 2 MADILL PUBLIC SCHOOLS,DONNY RALEY,,480206,0,2,16,18,OFFICE NO. 2 MADILL PUBLIC SCHOOLS
MARSHALL,OFFICE NO. 2 MADILL PUBLIC SCHOOLS,MARK GLENN,,480206,0,8,30,38,OFFICE NO. 2 MADILL PUBLIC SCHOOLS
MAYES,OFFICE NO. 2 NORTHEAST TECH CENTER,BILLY F. HENDRICKSON,,490011,0,1,28,29,OFFICE NO. 2 NORTHEAST TECH CENTER
MAYES,OFFICE NO. 2 NORTHEAST TECH CENTER,SHERMAN WEAVER,,490011,0,0,38,38,OFFICE NO. 2 NORTHEAST TECH CENTER
MAYES,OFFICE NO. 2 NORTHEAST TECH CENTER,BILLY F. HENDRICKSON,,490012,1,1,42,44,OFFICE NO. 2 NORTHEAST TECH CENTER
MAYES,OFFICE NO. 2 NORTHEAST TECH CENTER,SHERMAN WEAVER,,490012,2,4,49,55,OFFICE NO. 2 NORTHEAST TECH CENTER
MAYES,OFFICE NO. 2 NORTHEAST TECH CENTER,BILLY F. HENDRICKSON,,490014,0,0,7,7,OFFICE NO. 2 NORTHEAST TECH CENTER
MAYES,OFFICE NO. 2 NORTHEAST TECH CENTER,SHERMAN WEAVER,,490014,0,1,11,12,OFFICE NO. 2 NORTHEAST TECH CENTER
MAYES,OFFICE NO. 2 NORTHEAST TECH CENTER,BILLY F. HENDRICKSON,,490015,0,2,17,19,OFFICE NO. 2 NORTHEAST TECH CENTER
MAYES,OFFICE NO. 2 NORTHEAST TECH CENTER,SHERMAN WEAVER,,490015,3,4,16,23,OFFICE NO. 2 NORTHEAST TECH CENTER
MAYES,OFFICE NO. 2 PRYOR PUBLIC SCHOOLS,RAYMOND GRENINGER,,490015,0,5,19,24,OFFICE NO. 2 PRYOR PUBLIC SCHOOLS
MAYES,OFFICE NO. 2 PRYOR PUBLIC SCHOOLS,TIFFANY NANCE,,490015,0,0,1,1,OFFICE NO. 2 PRYOR PUBLIC SCHOOLS
MAYES,OFFICE NO. 2 NORTHEAST TECH CENTER,BILLY F. HENDRICKSON,,490016,0,0,12,12,OFFICE NO. 2 NORTHEAST TECH CENTER
MAYES,OFFICE NO. 2 NORTHEAST TECH CENTER,SHERMAN WEAVER,,490016,2,0,36,38,OFFICE NO. 2 NORTHEAST TECH CENTER
MAYES,OFFICE NO. 2 PRYOR PUBLIC SCHOOLS,RAYMOND GRENINGER,,490016,1,0,17,18,OFFICE NO. 2 PRYOR PUBLIC SCHOOLS
MAYES,OFFICE NO. 2 PRYOR PUBLIC SCHOOLS,TIFFANY NANCE,,490016,1,0,4,5,OFFICE NO. 2 PRYOR PUBLIC SCHOOLS
MAYES,OFFICE NO. 2 NORTHEAST TECH CENTER,BILLY F. HENDRICKSON,,490020,1,5,30,36,OFFICE NO. 2 NORTHEAST TECH CENTER
MAYES,OFFICE NO. 2 NORTHEAST TECH CENTER,SHERMAN WEAVER,,490020,2,4,38,44,OFFICE NO. 2 NORTHEAST TECH CENTER
MAYES,OFFICE NO. 2 PRYOR PUBLIC SCHOOLS,RAYMOND GRENINGER,,490020,0,5,14,19,OFFICE NO. 2 PRYOR PUBLIC SCHOOLS
MAYES,OFFICE NO. 2 PRYOR PUBLIC SCHOOLS,TIFFANY NANCE,,490020,0,2,1,3,OFFICE NO. 2 PRYOR PUBLIC SCHOOLS
MAYES,OFFICE NO. 2 NORTHEAST TECH CENTER,BILLY F. HENDRICKSON,,490021,0,1,7,8,OFFICE NO. 2 NORTHEAST TECH CENTER
MAYES,OFFICE NO. 2 NORTHEAST TECH CENTER,SHERMAN WEAVER,,490021,2,0,7,9,OFFICE NO. 2 NORTHEAST TECH CENTER
MAYES,OFFICE NO. 2 PRYOR PUBLIC SCHOOLS,RAYMOND GRENINGER,,490021,0,0,6,6,OFFICE NO. 2 PRYOR PUBLIC SCHOOLS
MAYES,OFFICE NO. 2 PRYOR PUBLIC SCHOOLS,TIFFANY NANCE,,490021,0,1,3,4,OFFICE NO. 2 PRYOR PUBLIC SCHOOLS
MAYES,OFFICE NO. 2 NORTHEAST TECH CENTER,BILLY F. HENDRICKSON,,490022,2,0,8,10,OFFICE NO. 2 NORTHEAST TECH CENTER
MAYES,OFFICE NO. 2 NORTHEAST TECH CENTER,SHERMAN WEAVER,,490022,0,0,13,13,OFFICE NO. 2 NORTHEAST TECH CENTER
MAYES,OFFICE NO. 2 NORTHEAST TECH CENTER,BILLY F. HENDRICKSON,,490023,0,0,13,13,OFFICE NO. 2 NORTHEAST TECH CENTER
MAYES,OFFICE NO. 2 NORTHEAST TECH CENTER,SHERMAN WEAVER,,490023,0,0,18,18,OFFICE NO. 2 NORTHEAST TECH CENTER
MAYES,OFFICE NO. 2 PRYOR PUBLIC SCHOOLS,RAYMOND GRENINGER,,490023,0,0,0,0,OFFICE NO. 2 PRYOR PUBLIC SCHOOLS
MAYES,OFFICE NO. 2 PRYOR PUBLIC SCHOOLS,TIFFANY NANCE,,490023,0,0,0,0,OFFICE NO. 2 PRYOR PUBLIC SCHOOLS
MAYES,OFFICE NO. 2 NORTHEAST TECH CENTER,BILLY F. HENDRICKSON,,490024,0,0,9,9,OFFICE NO. 2 NORTHEAST TECH CENTER
MAYES,OFFICE NO. 2 NORTHEAST TECH CENTER,SHERMAN WEAVER,,490024,0,1,4,5,OFFICE NO. 2 NORTHEAST TECH CENTER
MAYES,OFFICE NO. 2 NORTHEAST TECH CENTER,BILLY F. HENDRICKSON,,490025,0,0,3,3,OFFICE NO. 2 NORTHEAST TECH CENTER
MAYES,OFFICE NO. 2 NORTHEAST TECH CENTER,SHERMAN WEAVER,,490025,0,0,2,2,OFFICE NO. 2 NORTHEAST TECH CENTER
MAYES,OFFICE NO. 2 NORTHEAST TECH CENTER,BILLY F. HENDRICKSON,,490026,0,0,0,0,OFFICE NO. 2 NORTHEAST TECH CENTER
MAYES,OFFICE NO. 2 NORTHEAST TECH CENTER,SHERMAN WEAVER,,490026,0,0,0,0,OFFICE NO. 2 NORTHEAST TECH CENTER
MAYES,OFFICE NO. 2 NORTHEAST TECH CENTER,BILLY F. HENDRICKSON,,490027,0,0,2,2,OFFICE NO. 2 NORTHEAST TECH CENTER
MAYES,OFFICE NO. 2 NORTHEAST TECH CENTER,SHERMAN WEAVER,,490027,0,0,0,0,OFFICE NO. 2 NORTHEAST TECH CENTER
MAYES,OFFICE NO. 2 JAY PUBLIC SCHOOLS,BILL HOBBS,,490031,0,0,2,2,OFFICE NO. 2 JAY PUBLIC SCHOOLS
MAYES,OFFICE NO. 2 JAY PUBLIC SCHOOLS,ASHLEY WILLIAMSON,,490031,0,0,1,1,OFFICE NO. 2 JAY PUBLIC SCHOOLS
MAYES,OFFICE NO. 2 NORTHEAST TECH CENTER,BILLY F. HENDRICKSON,,490031,0,0,7,7,OFFICE NO. 2 NORTHEAST TECH CENTER
MAYES,OFFICE NO. 2 NORTHEAST TECH CENTER,SHERMAN WEAVER,,490031,3,1,13,17,OFFICE NO. 2 NORTHEAST TECH CENTER
MAYES,OFFICE NO. 2 JAY PUBLIC SCHOOLS,BILL HOBBS,,490034,0,0,4,4,OFFICE NO. 2 JAY PUBLIC SCHOOLS
MAYES,OFFICE NO. 2 JAY PUBLIC SCHOOLS,ASHLEY WILLIAMSON,,490034,0,0,5,5,OFFICE NO. 2 JAY PUBLIC SCHOOLS
MAYES,OFFICE NO. 2 NORTHEAST TECH CENTER,BILLY F. HENDRICKSON,,490034,1,0,8,9,OFFICE NO. 2 NORTHEAST TECH CENTER
MAYES,OFFICE NO. 2 NORTHEAST TECH CENTER,SHERMAN WEAVER,,490034,4,0,10,14,OFFICE NO. 2 NORTHEAST TECH CENTER
MAYES,OFFICE NO. 2 NORTHEAST TECH CENTER,BILLY F. HENDRICKSON,,490036,2,0,24,26,OFFICE NO. 2 NORTHEAST TECH CENTER
MAYES,OFFICE NO. 2 NORTHEAST TECH CENTER,SHERMAN WEAVER,,490036,3,0,24,27,OFFICE NO. 2 NORTHEAST TECH CENTER
MAYES,OFFICE NO. 2 NORTHEAST TECH CENTER,BILLY F. HENDRICKSON,,490037,0,0,4,4,OFFICE NO. 2 NORTHEAST TECH CENTER
MAYES,OFFICE NO. 2 NORTHEAST TECH CENTER,SHERMAN WEAVER,,490037,0,0,8,8,OFFICE NO. 2 NORTHEAST TECH CENTER
MAYES,OFFICE NO. 2 NORTHEAST TECH CENTER,BILLY F. HENDRICKSON,,490038,0,0,6,6,OFFICE NO. 2 NORTHEAST TECH CENTER
MAYES,OFFICE NO. 2 NORTHEAST TECH CENTER,SHERMAN WEAVER,,490038,1,0,1,2,OFFICE NO. 2 NORTHEAST TECH CENTER
MAYES,OFFICE NO. 2 NORTHEAST TECH CENTER,BILLY F. HENDRICKSON,,490039,0,0,11,11,OFFICE NO. 2 NORTHEAST TECH CENTER
MAYES,OFFICE NO. 2 NORTHEAST TECH CENTER,SHERMAN WEAVER,,490039,2,0,14,16,OFFICE NO. 2 NORTHEAST TECH CENTER
MAYES,COUNCILMEMBER WARD 2 (UNEXPIRED TERM) CITY OF PRYOR CREEK,STEVE SMITH,,490101,0,0,4,4,COUNCILMEMBER WARD 2 (UNEXPIRED TERM) CITY OF PRYOR CREEK
MAYES,COUNCILMEMBER WARD 2 (UNEXPIRED TERM) CITY OF PRYOR CREEK,RYAN KELLEY,,490101,0,1,3,4,COUNCILMEMBER WARD 2 (UNEXPIRED TERM) CITY OF PRYOR CREEK
MAYES,CITY CLERK CITY OF PRYOR CREEK,EVA SMITH,,490101,6,10,74,90,
MAYES,CITY CLERK CITY OF PRYOR CREEK,CHERYL WHITE HINKLE,,490101,2,1,26,29,
MAYES,CHIEF OF POLICE CITY OF PRYOR CREEK,DENNIS NICHOLS,,490101,5,11,78,94,
MAYES,CHIEF OF POLICE CITY OF PRYOR CREEK,FRANK CANTEY,,490101,3,0,26,29,
MAYES,OFFICE NO. 2 NORTHEAST TECH CENTER,BILLY F. HENDRICKSON,,490101,4,4,33,41,OFFICE NO. 2 NORTHEAST TECH CENTER
MAYES,OFFICE NO. 2 NORTHEAST TECH CENTER,SHERMAN WEAVER,,490101,4,6,79,89,OFFICE NO. 2 NORTHEAST TECH CENTER
MAYES,OFFICE NO. 2 PRYOR PUBLIC SCHOOLS,RAYMOND GRENINGER,,490101,5,7,65,77,OFFICE NO. 2 PRYOR PUBLIC SCHOOLS
MAYES,OFFICE NO. 2 PRYOR PUBLIC SCHOOLS,TIFFANY NANCE,,490101,3,2,42,47,OFFICE NO. 2 PRYOR PUBLIC SCHOOLS
MAYES,COUNCILMEMBER WARD 2 (UNEXPIRED TERM) CITY OF PRYOR CREEK,STEVE SMITH,,490121,6,9,101,116,COUNCILMEMBER WARD 2 (UNEXPIRED TERM) CITY OF PRYOR CREEK
MAYES,COUNCILMEMBER WARD 2 (UNEXPIRED TERM) CITY OF PRYOR CREEK,RYAN KELLEY,,490121,2,7,77,86,COUNCILMEMBER WARD 2 (UNEXPIRED TERM) CITY OF PRYOR CREEK
MAYES,CITY CLERK CITY OF PRYOR CREEK,EVA SMITH,,490121,4,11,129,144,
MAYES,CITY CLERK CITY OF PRYOR CREEK,CHERYL WHITE HINKLE,,490121,4,5,46,55,
MAYES,CHIEF OF POLICE CITY OF PRYOR CREEK,DENNIS NICHOLS,,490121,6,12,118,136,
MAYES,CHIEF OF POLICE CITY OF PRYOR CREEK,FRANK CANTEY,,490121,3,4,61,68,
MAYES,OFFICE NO. 2 NORTHEAST TECH CENTER,BILLY F. HENDRICKSON,,490121,2,10,52,64,OFFICE NO. 2 NORTHEAST TECH CENTER
MAYES,OFFICE NO. 2 NORTHEAST TECH CENTER,SHERMAN WEAVER,,490121,7,12,147,166,OFFICE NO. 2 NORTHEAST TECH CENTER
MAYES,OFFICE NO. 2 PRYOR PUBLIC SCHOOLS,RAYMOND GRENINGER,,490121,4,16,113,133,OFFICE NO. 2 PRYOR PUBLIC SCHOOLS
MAYES,OFFICE NO. 2 PRYOR PUBLIC SCHOOLS,TIFFANY NANCE,,490121,5,6,86,97,OFFICE NO. 2 PRYOR PUBLIC SCHOOLS
MAYES,OFFICE NO. 2 NORTHEAST TECH CENTER,BILLY F. HENDRICKSON,,490122,0,0,1,1,OFFICE NO. 2 NORTHEAST TECH CENTER
MAYES,OFFICE NO. 2 NORTHEAST TECH CENTER,SHERMAN WEAVER,,490122,0,2,3,5,OFFICE NO. 2 NORTHEAST TECH CENTER
MAYES,OFFICE NO. 2 PRYOR PUBLIC SCHOOLS,RAYMOND GRENINGER,,490122,0,1,3,4,OFFICE NO. 2 PRYOR PUBLIC SCHOOLS
MAYES,OFFICE NO. 2 PRYOR PUBLIC SCHOOLS,TIFFANY NANCE,,490122,0,1,1,2,OFFICE NO. 2 PRYOR PUBLIC SCHOOLS
MAYES,OFFICE NO. 2 NORTHEAST TECH CENTER,BILLY F. HENDRICKSON,,490130,1,2,11,14,OFFICE NO. 2 NORTHEAST TECH CENTER
MAYES,OFFICE NO. 2 NORTHEAST TECH CENTER,SHERMAN WEAVER,,490130,0,2,21,23,OFFICE NO. 2 NORTHEAST TECH CENTER
MAYES,CITY CLERK CITY OF PRYOR CREEK,EVA SMITH,,490132,7,12,122,141,
MAYES,CITY CLERK CITY OF PRYOR CREEK,CHERYL WHITE HINKLE,,490132,6,3,42,51,
MAYES,CHIEF OF POLICE CITY OF PRYOR CREEK,DENNIS NICHOLS,,490132,9,13,126,148,
MAYES,CHIEF OF POLICE CITY OF PRYOR CREEK,FRANK CANTEY,,490132,3,4,40,47,
MAYES,OFFICE NO. 2 NORTHEAST TECH CENTER,BILLY F. HENDRICKSON,,490132,7,9,59,75,OFFICE NO. 2 NORTHEAST TECH CENTER
MAYES,OFFICE NO. 2 NORTHEAST TECH CENTER,SHERMAN WEAVER,,490132,6,9,107,122,OFFICE NO. 2 NORTHEAST TECH CENTER
MAYES,OFFICE NO. 2 PRYOR PUBLIC SCHOOLS,RAYMOND GRENINGER,,490132,3,16,109,128,OFFICE NO. 2 PRYOR PUBLIC SCHOOLS
MAYES,OFFICE NO. 2 PRYOR PUBLIC SCHOOLS,TIFFANY NANCE,,490132,10,2,56,68,OFFICE NO. 2 PRYOR PUBLIC SCHOOLS
MAYES,CITY CLERK CITY OF PRYOR CREEK,EVA SMITH,,490241,12,25,300,337,
MAYES,CITY CLERK CITY OF PRYOR CREEK,CHERYL WHITE HINKLE,,490241,2,4,73,79,
MAYES,CHIEF OF POLICE CITY OF PRYOR CREEK,DENNIS NICHOLS,,490241,10,25,295,330,
MAYES,CHIEF OF POLICE CITY OF PRYOR CREEK,FRANK CANTEY,,490241,4,4,84,92,
MAYES,OFFICE NO. 2 NORTHEAST TECH CENTER,BILLY F. HENDRICKSON,,490241,3,15,137,155,OFFICE NO. 2 NORTHEAST TECH CENTER
MAYES,OFFICE NO. 2 NORTHEAST TECH CENTER,SHERMAN WEAVER,,490241,11,17,252,280,OFFICE NO. 2 NORTHEAST TECH CENTER
MAYES,OFFICE NO. 2 PRYOR PUBLIC SCHOOLS,RAYMOND GRENINGER,,490241,7,21,261,289,OFFICE NO. 2 PRYOR PUBLIC SCHOOLS
MAYES,OFFICE NO. 2 PRYOR PUBLIC SCHOOLS,TIFFANY NANCE,,490241,5,11,125,141,OFFICE NO. 2 PRYOR PUBLIC SCHOOLS
MAYES,COUNCILMEMBER WARD 2 (UNEXPIRED TERM) CITY OF PRYOR CREEK,STEVE SMITH,,490242,0,0,0,0,COUNCILMEMBER WARD 2 (UNEXPIRED TERM) CITY OF PRYOR CREEK
MAYES,COUNCILMEMBER WARD 2 (UNEXPIRED TERM) CITY OF PRYOR CREEK,RYAN KELLEY,,490242,0,0,0,0,COUNCILMEMBER WARD 2 (UNEXPIRED TERM) CITY OF PRYOR CREEK
MAYES,CITY CLERK CITY OF PRYOR CREEK,EVA SMITH,,490242,6,8,91,105,
MAYES,CITY CLERK CITY OF PRYOR CREEK,CHERYL WHITE HINKLE,,490242,1,3,27,31,
MAYES,CHIEF OF POLICE CITY OF PRYOR CREEK,DENNIS NICHOLS,,490242,2,9,92,103,
MAYES,CHIEF OF POLICE CITY OF PRYOR CREEK,FRANK CANTEY,,490242,6,2,28,36,
MAYES,OFFICE NO. 2 NORTHEAST TECH CENTER,BILLY F. HENDRICKSON,,490242,2,5,47,54,OFFICE NO. 2 NORTHEAST TECH CENTER
MAYES,OFFICE NO. 2 NORTHEAST TECH CENTER,SHERMAN WEAVER,,490242,5,7,97,109,OFFICE NO. 2 NORTHEAST TECH CENTER
MAYES,OFFICE NO. 2 PRYOR PUBLIC SCHOOLS,RAYMOND GRENINGER,,490242,4,8,91,103,OFFICE NO. 2 PRYOR PUBLIC SCHOOLS
MAYES,OFFICE NO. 2 PRYOR PUBLIC SCHOOLS,TIFFANY NANCE,,490242,3,4,53,60,OFFICE NO. 2 PRYOR PUBLIC SCHOOLS
MAYES,OFFICE NO. 2 NORTHEAST TECH CENTER,BILLY F. HENDRICKSON,,490311,0,0,1,1,OFFICE NO. 2 NORTHEAST TECH CENTER
MAYES,OFFICE NO. 2 NORTHEAST TECH CENTER,SHERMAN WEAVER,,490311,0,2,6,8,OFFICE NO. 2 NORTHEAST TECH CENTER
MUSKOGEE,OFFICE NO. 2 INDIAN CAPITAL TECH CENTER,TOM STILES,,510005,1,3,3,7,OFFICE NO. 2 INDIAN CAPITAL TECH CENTER
MUSKOGEE,OFFICE NO. 2 INDIAN CAPITAL TECH CENTER,RAY KIRK,,510005,0,2,4,6,OFFICE NO. 2 INDIAN CAPITAL TECH CENTER
MUSKOGEE,OFFICE NO. 2 INDIAN CAPITAL TECH CENTER,TOM STILES,,510007,0,5,13,18,OFFICE NO. 2 INDIAN CAPITAL TECH CENTER
MUSKOGEE,OFFICE NO. 2 INDIAN CAPITAL TECH CENTER,RAY KIRK,,510007,0,1,13,14,OFFICE NO. 2 INDIAN CAPITAL TECH CENTER
MUSKOGEE,OFFICE NO. 2 INDIAN CAPITAL TECH CENTER,TOM STILES,,510009,0,5,21,26,OFFICE NO. 2 INDIAN CAPITAL TECH CENTER
MUSKOGEE,OFFICE NO. 2 INDIAN CAPITAL TECH CENTER,RAY KIRK,,510009,0,1,6,7,OFFICE NO. 2 INDIAN CAPITAL TECH CENTER
MUSKOGEE,OFFICE NO. 2 INDIAN CAPITAL TECH CENTER,TOM STILES,,510011,0,0,2,2,OFFICE NO. 2 INDIAN CAPITAL TECH CENTER
MUSKOGEE,OFFICE NO. 2 INDIAN CAPITAL TECH CENTER,RAY KIRK,,510011,0,0,4,4,OFFICE NO. 2 INDIAN CAPITAL TECH CENTER
MUSKOGEE,OFFICE NO. 2 INDIAN CAPITAL TECH CENTER,TOM STILES,,510013,0,2,5,7,OFFICE NO. 2 INDIAN CAPITAL TECH CENTER
MUSKOGEE,OFFICE NO. 2 INDIAN CAPITAL TECH CENTER,RAY KIRK,,510013,1,0,7,8,OFFICE NO. 2 INDIAN CAPITAL TECH CENTER
MUSKOGEE,OFFICE NO. 2 INDIAN CAPITAL TECH CENTER,TOM STILES,,510017,0,1,11,12,OFFICE NO. 2 INDIAN CAPITAL TECH CENTER
MUSKOGEE,OFFICE NO. 2 INDIAN CAPITAL TECH CENTER,RAY KIRK,,510017,0,0,2,2,OFFICE NO. 2 INDIAN CAPITAL TECH CENTER
MUSKOGEE,OFFICE NO. 2 INDIAN CAPITAL TECH CENTER,TOM STILES,,510021,2,1,7,10,OFFICE NO. 2 INDIAN CAPITAL TECH CENTER
MUSKOGEE,OFFICE NO. 2 INDIAN CAPITAL TECH CENTER,RAY KIRK,,510021,0,1,4,5,OFFICE NO. 2 INDIAN CAPITAL TECH CENTER
MUSKOGEE,OFFICE NO. 2 INDIAN CAPITAL TECH CENTER,TOM STILES,,510022,3,2,12,17,OFFICE NO. 2 INDIAN CAPITAL TECH CENTER
MUSKOGEE,OFFICE NO. 2 INDIAN CAPITAL TECH CENTER,RAY KIRK,,510022,3,1,7,11,OFFICE NO. 2 INDIAN CAPITAL TECH CENTER
MUSKOGEE,OFFICE NO. 2 INDIAN CAPITAL TECH CENTER,TOM STILES,,510023,0,0,12,12,OFFICE NO. 2 INDIAN CAPITAL TECH CENTER
MUSKOGEE,OFFICE NO. 2 INDIAN CAPITAL TECH CENTER,RAY KIRK,,510023,0,0,6,6,OFFICE NO. 2 INDIAN CAPITAL TECH CENTER
MUSKOGEE,OFFICE NO. 2 INDIAN CAPITAL TECH CENTER,TOM STILES,,510028,0,1,8,9,OFFICE NO. 2 INDIAN CAPITAL TECH CENTER
MUSKOGEE,OFFICE NO. 2 INDIAN CAPITAL TECH CENTER,RAY KIRK,,510028,0,0,4,4,OFFICE NO. 2 INDIAN CAPITAL TECH CENTER
MUSKOGEE,OFFICE NO. 2 INDIAN CAPITAL TECH CENTER,TOM STILES,,510033,0,0,20,20,OFFICE NO. 2 INDIAN CAPITAL TECH CENTER
MUSKOGEE,OFFICE NO. 2 INDIAN CAPITAL TECH CENTER,RAY KIRK,,510033,0,0,7,7,OFFICE NO. 2 INDIAN CAPITAL TECH CENTER
MUSKOGEE,OFFICE NO. 2 INDIAN CAPITAL TECH CENTER,TOM STILES,,510036,0,1,15,16,OFFICE NO. 2 INDIAN CAPITAL TECH CENTER
MUSKOGEE,OFFICE NO. 2 INDIAN CAPITAL TECH CENTER,RAY KIRK,,510036,0,1,3,4,OFFICE NO. 2 INDIAN CAPITAL TECH CENTER
MUSKOGEE,OFFICE NO. 2 INDIAN CAPITAL TECH CENTER,TOM STILES,,510037,0,0,17,17,OFFICE NO. 2 INDIAN CAPITAL TECH CENTER
MUSKOGEE,OFFICE NO. 2 INDIAN CAPITAL TECH CENTER,RAY KIRK,,510037,0,0,4,4,OFFICE NO. 2 INDIAN CAPITAL TECH CENTER
MUSKOGEE,OFFICE NO. 2 INDIAN CAPITAL TECH CENTER,TOM STILES,,510038,0,4,31,35,OFFICE NO. 2 INDIAN CAPITAL TECH CENTER
MUSKOGEE,OFFICE NO. 2 INDIAN CAPITAL TECH CENTER,RAY KIRK,,510038,0,0,9,9,OFFICE NO. 2 INDIAN CAPITAL TECH CENTER
MUSKOGEE,OFFICE NO. 2 INDIAN CAPITAL TECH CENTER,TOM STILES,,510040,0,0,12,12,OFFICE NO. 2 INDIAN CAPITAL TECH CENTER
MUSKOGEE,OFFICE NO. 2 INDIAN CAPITAL TECH CENTER,RAY KIRK,,510040,0,0,2,2,OFFICE NO. 2 INDIAN CAPITAL TECH CENTER
MUSKOGEE,OFFICE NO. 2 INDIAN CAPITAL TECH CENTER,TOM STILES,,510041,5,2,107,114,OFFICE NO. 2 INDIAN CAPITAL TECH CENTER
MUSKOGEE,OFFICE NO. 2 INDIAN CAPITAL TECH CENTER,RAY KIRK,,510041,0,1,13,14,OFFICE NO. 2 INDIAN CAPITAL TECH CENTER
MUSKOGEE,OFFICE NO. 2 INDIAN CAPITAL TECH CENTER,TOM STILES,,510044,0,0,3,3,OFFICE NO. 2 INDIAN CAPITAL TECH CENTER
MUSKOGEE,OFFICE NO. 2 INDIAN CAPITAL TECH CENTER,RAY KIRK,,510044,0,0,8,8,OFFICE NO. 2 INDIAN CAPITAL TECH CENTER
MUSKOGEE,OFFICE NO. 2 INDIAN CAPITAL TECH CENTER,TOM STILES,,510045,0,0,13,13,OFFICE NO. 2 INDIAN CAPITAL TECH CENTER
MUSKOGEE,OFFICE NO. 2 INDIAN CAPITAL TECH CENTER,RAY KIRK,,510045,0,0,4,4,OFFICE NO. 2 INDIAN CAPITAL TECH CENTER
MUSKOGEE,OFFICE NO. 2 INDIAN CAPITAL TECH CENTER,TOM STILES,,510046,0,0,17,17,OFFICE NO. 2 INDIAN CAPITAL TECH CENTER
MUSKOGEE,OFFICE NO. 2 INDIAN CAPITAL TECH CENTER,RAY KIRK,,510046,2,1,3,6,OFFICE NO. 2 INDIAN CAPITAL TECH CENTER
MUSKOGEE,OFFICE NO. 2 INDIAN CAPITAL TECH CENTER,TOM STILES,,510047,0,2,12,14,OFFICE NO. 2 INDIAN CAPITAL TECH CENTER
MUSKOGEE,OFFICE NO. 2 INDIAN CAPITAL TECH CENTER,RAY KIRK,,510047,0,0,5,5,OFFICE NO. 2 INDIAN CAPITAL TECH CENTER
MUSKOGEE,OFFICE NO. 2 INDIAN CAPITAL TECH CENTER,TOM STILES,,510049,0,0,0,0,OFFICE NO. 2 INDIAN CAPITAL TECH CENTER
MUSKOGEE,OFFICE NO. 2 INDIAN CAPITAL TECH CENTER,RAY KIRK,,510049,0,0,2,2,OFFICE NO. 2 INDIAN CAPITAL TECH CENTER
MUSKOGEE,OFFICE NO. 2 MIDWAY PUBLIC SCHOOLS,CAL HORSLEY,,510050,0,0,29,29,OFFICE NO. 2 MIDWAY PUBLIC SCHOOLS
MUSKOGEE,OFFICE NO. 2 MIDWAY PUBLIC SCHOOLS,GARY LEE DUVALL,,510050,0,0,16,16,OFFICE NO. 2 MIDWAY PUBLIC SCHOOLS
MUSKOGEE,OFFICE NO. 2 INDIAN CAPITAL TECH CENTER,TOM STILES,,510050,0,0,29,29,OFFICE NO. 2 INDIAN CAPITAL TECH CENTER
MUSKOGEE,OFFICE NO. 2 INDIAN CAPITAL TECH CENTER,RAY KIRK,,510050,0,0,16,16,OFFICE NO. 2 INDIAN CAPITAL TECH CENTER
MUSKOGEE,OFFICE NO. 2 MIDWAY PUBLIC SCHOOLS,CAL HORSLEY,,510051,0,0,47,47,OFFICE NO. 2 MIDWAY PUBLIC SCHOOLS
MUSKOGEE,OFFICE NO. 2 MIDWAY PUBLIC SCHOOLS,GARY LEE DUVALL,,510051,0,0,9,9,OFFICE NO. 2 MIDWAY PUBLIC SCHOOLS
MUSKOGEE,OFFICE NO. 2 INDIAN CAPITAL TECH CENTER,TOM STILES,,510051,0,0,37,37,OFFICE NO. 2 INDIAN CAPITAL TECH CENTER
MUSKOGEE,OFFICE NO. 2 INDIAN CAPITAL TECH CENTER,RAY KIRK,,510051,0,0,18,18,OFFICE NO. 2 INDIAN CAPITAL TECH CENTER
MUSKOGEE,OFFICE NO. 2 MIDWAY PUBLIC SCHOOLS,CAL HORSLEY,,510052,0,0,3,3,OFFICE NO. 2 MIDWAY PUBLIC SCHOOLS
MUSKOGEE,OFFICE NO. 2 MIDWAY PUBLIC SCHOOLS,GARY LEE DUVALL,,510052,0,1,2,3,OFFICE NO. 2 MIDWAY PUBLIC SCHOOLS
MUSKOGEE,OFFICE NO. 2 INDIAN CAPITAL TECH CENTER,TOM STILES,,510052,0,0,8,8,OFFICE NO. 2 INDIAN CAPITAL TECH CENTER
MUSKOGEE,OFFICE NO. 2 INDIAN CAPITAL TECH CENTER,RAY KIRK,,510052,0,3,2,5,OFFICE NO. 2 INDIAN CAPITAL TECH CENTER
MUSKOGEE,OFFICE NO. 2 INDIAN CAPITAL TECH CENTER,TOM STILES,,510053,0,2,17,19,OFFICE NO. 2 INDIAN CAPITAL TECH CENTER
MUSKOGEE,OFFICE NO. 2 INDIAN CAPITAL TECH CENTER,RAY KIRK,,510053,0,0,4,4,OFFICE NO. 2 INDIAN CAPITAL TECH CENTER
MUSKOGEE,OFFICE NO. 2 INDIAN CAPITAL TECH CENTER,TOM STILES,,510055,1,1,12,14,OFFICE NO. 2 INDIAN CAPITAL TECH CENTER
MUSKOGEE,OFFICE NO. 2 INDIAN CAPITAL TECH CENTER,RAY KIRK,,510055,2,1,5,8,OFFICE NO. 2 INDIAN CAPITAL TECH CENTER
MUSKOGEE,OFFICE NO. 2 INDIAN CAPITAL TECH CENTER,TOM STILES,,510056,0,0,2,2,OFFICE NO. 2 INDIAN CAPITAL TECH CENTER
MUSKOGEE,OFFICE NO. 2 INDIAN CAPITAL TECH CENTER,RAY KIRK,,510056,0,0,3,3,OFFICE NO. 2 INDIAN CAPITAL TECH CENTER
MUSKOGEE,OFFICE NO. 2 INDIAN CAPITAL TECH CENTER,TOM STILES,,510057,0,0,0,0,OFFICE NO. 2 INDIAN CAPITAL TECH CENTER
MUSKOGEE,OFFICE NO. 2 INDIAN CAPITAL TECH CENTER,RAY KIRK,,510057,0,0,0,0,OFFICE NO. 2 INDIAN CAPITAL TECH CENTER
MUSKOGEE,OFFICE NO. 2 INDIAN CAPITAL TECH CENTER,TOM STILES,,510058,0,0,13,13,OFFICE NO. 2 INDIAN CAPITAL TECH CENTER
MUSKOGEE,OFFICE NO. 2 INDIAN CAPITAL TECH CENTER,RAY KIRK,,510058,0,0,5,5,OFFICE NO. 2 INDIAN CAPITAL TECH CENTER
MUSKOGEE,OFFICE NO. 2 INDIAN CAPITAL TECH CENTER,TOM STILES,,510059,0,1,14,15,OFFICE NO. 2 INDIAN CAPITAL TECH CENTER
MUSKOGEE,OFFICE NO. 2 INDIAN CAPITAL TECH CENTER,RAY KIRK,,510059,0,0,14,14,OFFICE NO. 2 INDIAN CAPITAL TECH CENTER
MUSKOGEE,OFFICE NO. 2 INDIAN CAPITAL TECH CENTER,TOM STILES,,510060,0,0,2,2,OFFICE NO. 2 INDIAN CAPITAL TECH CENTER
MUSKOGEE,OFFICE NO. 2 INDIAN CAPITAL TECH CENTER,RAY KIRK,,510060,0,0,2,2,OFFICE NO. 2 INDIAN CAPITAL TECH CENTER
MUSKOGEE,OFFICE NO. 2 INDIAN CAPITAL TECH CENTER,TOM STILES,,510061,0,0,4,4,OFFICE NO. 2 INDIAN CAPITAL TECH CENTER
MUSKOGEE,OFFICE NO. 2 INDIAN CAPITAL TECH CENTER,RAY KIRK,,510061,0,0,2,2,OFFICE NO. 2 INDIAN CAPITAL TECH CENTER
MUSKOGEE,OFFICE NO. 2 INDIAN CAPITAL TECH CENTER,TOM STILES,,510064,0,0,14,14,OFFICE NO. 2 INDIAN CAPITAL TECH CENTER
MUSKOGEE,OFFICE NO. 2 INDIAN CAPITAL TECH CENTER,RAY KIRK,,510064,0,0,8,8,OFFICE NO. 2 INDIAN CAPITAL TECH CENTER
NOBLE,COUNTY QUESTION NO. 1,FOR THE PROPOSITION - YES,,520101,2,19,137,158,COUNTY QUESTION NO. 1
NOBLE,COUNTY QUESTION NO. 1,AGAINST THE PROPOSITION - NO,,520101,1,7,20,28,COUNTY QUESTION NO. 1
NOBLE,COUNTY QUESTION NO. 2,FOR THE PROPOSITION - YES,,520101,2,23,136,161,COUNTY QUESTION NO. 2
NOBLE,COUNTY QUESTION NO. 2,AGAINST THE PROPOSITION - NO,,520101,1,7,23,31,COUNTY QUESTION NO. 2
NOBLE,OFFICE NO. 2 PERRY PUBLIC SCHOOLS,PAUL GREEN,,520101,2,11,60,73,OFFICE NO. 2 PERRY PUBLIC SCHOOLS
NOBLE,OFFICE NO. 2 PERRY PUBLIC SCHOOLS,LINDA POWERS,,520101,1,19,97,117,OFFICE NO. 2 PERRY PUBLIC SCHOOLS
NOBLE,COUNTY QUESTION NO. 1,FOR THE PROPOSITION - YES,,520102,0,9,21,30,COUNTY QUESTION NO. 1
NOBLE,COUNTY QUESTION NO. 1,AGAINST THE PROPOSITION - NO,,520102,0,1,1,2,COUNTY QUESTION NO. 1
NOBLE,COUNTY QUESTION NO. 2,FOR THE PROPOSITION - YES,,520102,0,9,20,29,COUNTY QUESTION NO. 2
NOBLE,COUNTY QUESTION NO. 2,AGAINST THE PROPOSITION - NO,,520102,0,1,2,3,COUNTY QUESTION NO. 2
NOBLE,OFFICE NO. 2 PERRY PUBLIC SCHOOLS,PAUL GREEN,,520102,0,6,7,13,OFFICE NO. 2 PERRY PUBLIC SCHOOLS
NOBLE,OFFICE NO. 2 PERRY PUBLIC SCHOOLS,LINDA POWERS,,520102,0,3,15,18,OFFICE NO. 2 PERRY PUBLIC SCHOOLS
NOBLE,COUNTY QUESTION NO. 1,FOR THE PROPOSITION - YES,,520103,0,1,35,36,COUNTY QUESTION NO. 1
NOBLE,COUNTY QUESTION NO. 1,AGAINST THE PROPOSITION - NO,,520103,0,0,5,5,COUNTY QUESTION NO. 1
NOBLE,COUNTY QUESTION NO. 2,FOR THE PROPOSITION - YES,,520103,0,1,37,38,COUNTY QUESTION NO. 2
NOBLE,COUNTY QUESTION NO. 2,AGAINST THE PROPOSITION - NO,,520103,0,0,3,3,COUNTY QUESTION NO. 2
NOBLE,COUNTY QUESTION NO. 1,FOR THE PROPOSITION - YES,,520104,1,3,20,24,COUNTY QUESTION NO. 1
NOBLE,COUNTY QUESTION NO. 1,AGAINST THE PROPOSITION - NO,,520104,0,0,5,5,COUNTY QUESTION NO. 1
NOBLE,COUNTY QUESTION NO. 2,FOR THE PROPOSITION - YES,,520104,1,3,21,25,COUNTY QUESTION NO. 2
NOBLE,COUNTY QUESTION NO. 2,AGAINST THE PROPOSITION - NO,,520104,0,1,4,5,COUNTY QUESTION NO. 2
NOBLE,COUNTY QUESTION NO. 1,FOR THE PROPOSITION - YES,,520105,0,0,18,18,COUNTY QUESTION NO. 1
NOBLE,COUNTY QUESTION NO. 1,AGAINST THE PROPOSITION - NO,,520105,0,0,2,2,COUNTY QUESTION NO. 1
NOBLE,COUNTY QUESTION NO. 2,FOR THE PROPOSITION - YES,,520105,0,0,19,19,COUNTY QUESTION NO. 2
NOBLE,COUNTY QUESTION NO. 2,AGAINST THE PROPOSITION - NO,,520105,0,0,1,1,COUNTY QUESTION NO. 2
NOBLE,COUNTY QUESTION NO. 1,FOR THE PROPOSITION - YES,,520106,0,0,12,12,COUNTY QUESTION NO. 1
NOBLE,COUNTY QUESTION NO. 1,AGAINST THE PROPOSITION - NO,,520106,0,0,2,2,COUNTY QUESTION NO. 1
NOBLE,COUNTY QUESTION NO. 2,FOR THE PROPOSITION - YES,,520106,0,0,14,14,COUNTY QUESTION NO. 2
NOBLE,COUNTY QUESTION NO. 2,AGAINST THE PROPOSITION - NO,,520106,0,0,2,2,COUNTY QUESTION NO. 2
NOBLE,PROPOSITION MORRISON PUBLIC SCHOOLS,FOR THE PROPOSITION - YES,,520106,0,0,11,11,
NOBLE,PROPOSITION MORRISON PUBLIC SCHOOLS,AGAINST THE PROPOSITION - NO,,520106,0,0,2,2,
NOBLE,OFFICE NO. 2 PERRY PUBLIC SCHOOLS,PAUL GREEN,,520106,0,0,0,0,OFFICE NO. 2 PERRY PUBLIC SCHOOLS
NOBLE,OFFICE NO. 2 PERRY PUBLIC SCHOOLS,LINDA POWERS,,520106,0,0,0,0,OFFICE NO. 2 PERRY PUBLIC SCHOOLS
NOBLE,COUNTY QUESTION NO. 1,FOR THE PROPOSITION - YES,,520201,3,17,125,145,COUNTY QUESTION NO. 1
NOBLE,COUNTY QUESTION NO. 1,AGAINST THE PROPOSITION - NO,,520201,1,3,30,34,COUNTY QUESTION NO. 1
NOBLE,COUNTY QUESTION NO. 2,FOR THE PROPOSITION - YES,,520201,4,17,127,148,COUNTY QUESTION NO. 2
NOBLE,COUNTY QUESTION NO. 2,AGAINST THE PROPOSITION - NO,,520201,1,3,30,34,COUNTY QUESTION NO. 2
NOBLE,OFFICE NO. 2 PERRY PUBLIC SCHOOLS,PAUL GREEN,,520201,1,9,59,69,OFFICE NO. 2 PERRY PUBLIC SCHOOLS
NOBLE,OFFICE NO. 2 PERRY PUBLIC SCHOOLS,LINDA POWERS,,520201,4,11,98,113,OFFICE NO. 2 PERRY PUBLIC SCHOOLS
NOBLE,COUNTY QUESTION NO. 1,FOR THE PROPOSITION - YES,,520202,9,14,63,86,COUNTY QUESTION NO. 1
NOBLE,COUNTY QUESTION NO. 1,AGAINST THE PROPOSITION - NO,,520202,1,0,11,12,COUNTY QUESTION NO. 1
NOBLE,COUNTY QUESTION NO. 2,FOR THE PROPOSITION - YES,,520202,10,15,62,87,COUNTY QUESTION NO. 2
NOBLE,COUNTY QUESTION NO. 2,AGAINST THE PROPOSITION - NO,,520202,0,0,14,14,COUNTY QUESTION NO. 2
NOBLE,OFFICE NO. 2 PERRY PUBLIC SCHOOLS,PAUL GREEN,,520202,3,7,24,34,OFFICE NO. 2 PERRY PUBLIC SCHOOLS
NOBLE,OFFICE NO. 2 PERRY PUBLIC SCHOOLS,LINDA POWERS,,520202,7,8,51,66,OFFICE NO. 2 PERRY PUBLIC SCHOOLS
NOBLE,COUNTY QUESTION NO. 1,FOR THE PROPOSITION - YES,,520203,3,15,36,54,COUNTY QUESTION NO. 1
NOBLE,COUNTY QUESTION NO. 1,AGAINST THE PROPOSITION - NO,,520203,0,3,13,16,COUNTY QUESTION NO. 1
NOBLE,COUNTY QUESTION NO. 2,FOR THE PROPOSITION - YES,,520203,3,15,38,56,COUNTY QUESTION NO. 2
NOBLE,COUNTY QUESTION NO. 2,AGAINST THE PROPOSITION - NO,,520203,0,4,12,16,COUNTY QUESTION NO. 2
NOBLE,OFFICE NO. 2 PERRY PUBLIC SCHOOLS,PAUL GREEN,,520203,0,8,31,39,OFFICE NO. 2 PERRY PUBLIC SCHOOLS
NOBLE,OFFICE NO. 2 PERRY PUBLIC SCHOOLS,LINDA POWERS,,520203,3,11,19,33,OFFICE NO. 2 PERRY PUBLIC SCHOOLS
NOBLE,COUNTY QUESTION NO. 1,FOR THE PROPOSITION - YES,,520301,1,18,46,65,COUNTY QUESTION NO. 1
NOBLE,COUNTY QUESTION NO. 1,AGAINST THE PROPOSITION - NO,,520301,0,6,15,21,COUNTY QUESTION NO. 1
NOBLE,COUNTY QUESTION NO. 2,FOR THE PROPOSITION - YES,,520301,1,17,49,67,COUNTY QUESTION NO. 2
NOBLE,COUNTY QUESTION NO. 2,AGAINST THE PROPOSITION - NO,,520301,0,7,13,20,COUNTY QUESTION NO. 2
NOBLE,OFFICE NO. 2 PERRY PUBLIC SCHOOLS,PAUL GREEN,,520301,0,5,15,20,OFFICE NO. 2 PERRY PUBLIC SCHOOLS
NOBLE,OFFICE NO. 2 PERRY PUBLIC SCHOOLS,LINDA POWERS,,520301,0,14,39,53,OFFICE NO. 2 PERRY PUBLIC SCHOOLS
NOBLE,COUNTY QUESTION NO. 1,FOR THE PROPOSITION - YES,,520305,9,4,130,143,COUNTY QUESTION NO. 1
NOBLE,COUNTY QUESTION NO. 1,AGAINST THE PROPOSITION - NO,,520305,0,1,27,28,COUNTY QUESTION NO. 1
NOBLE,COUNTY QUESTION NO. 2,FOR THE PROPOSITION - YES,,520305,9,5,128,142,COUNTY QUESTION NO. 2
NOBLE,COUNTY QUESTION NO. 2,AGAINST THE PROPOSITION - NO,,520305,0,1,27,28,COUNTY QUESTION NO. 2
NOBLE,PROPOSITION MORRISON PUBLIC SCHOOLS,FOR THE PROPOSITION - YES,,520305,6,5,131,142,
NOBLE,PROPOSITION MORRISON PUBLIC SCHOOLS,AGAINST THE PROPOSITION - NO,,520305,3,1,26,30,
NOBLE,COUNTY QUESTION NO. 1,FOR THE PROPOSITION - YES,,520307,3,24,47,74,COUNTY QUESTION NO. 1
NOBLE,COUNTY QUESTION NO. 1,AGAINST THE PROPOSITION - NO,,520307,0,3,5,8,COUNTY QUESTION NO. 1
NOBLE,COUNTY QUESTION NO. 2,FOR THE PROPOSITION - YES,,520307,3,24,46,73,COUNTY QUESTION NO. 2
NOBLE,COUNTY QUESTION NO. 2,AGAINST THE PROPOSITION - NO,,520307,0,3,8,11,COUNTY QUESTION NO. 2
NOBLE,OFFICE NO. 2 PERRY PUBLIC SCHOOLS,PAUL GREEN,,520307,2,15,21,38,OFFICE NO. 2 PERRY PUBLIC SCHOOLS
NOBLE,OFFICE NO. 2 PERRY PUBLIC SCHOOLS,LINDA POWERS,,520307,1,12,31,44,OFFICE NO. 2 PERRY PUBLIC SCHOOLS
NOBLE,OFFICE NO. 2 STILLWATER PUBLIC SCHOOLS,MARSHALL A. BAKER,,520307,0,0,0,0,OFFICE NO. 2 STILLWATER PUBLIC SCHOOLS
NOBLE,OFFICE NO. 2 STILLWATER PUBLIC SCHOOLS,LAURA ANN CLARK,,520307,0,0,0,0,OFFICE NO. 2 STILLWATER PUBLIC SCHOOLS
NOBLE,OFFICE NO. 2 STILLWATER PUBLIC SCHOOLS,PAM FRIEDEN,,520307,0,0,0,0,OFFICE NO. 2 STILLWATER PUBLIC SCHOOLS
NOBLE,PROPOSITION NO. 1 STILLWATER PUBLIC SCHOOLS,FOR THE PROPOSITION - YES,,520307,0,0,0,0,PROPOSITION NO. 1 STILLWATER PUBLIC SCHOOLS
NOBLE,PROPOSITION NO. 1 STILLWATER PUBLIC SCHOOLS,AGAINST THE PROPOSITION - NO,,520307,0,0,0,0,PROPOSITION NO. 1 STILLWATER PUBLIC SCHOOLS
NOBLE,PROPOSITION NO. 2 STILLWATER PUBLIC SCHOOLS,FOR THE PROPOSITION - YES,,520307,0,0,0,0,PROPOSITION NO. 2 STILLWATER PUBLIC SCHOOLS
NOBLE,PROPOSITION NO. 2 STILLWATER PUBLIC SCHOOLS,AGAINST THE PROPOSITION - NO,,520307,0,0,0,0,PROPOSITION NO. 2 STILLWATER PUBLIC SCHOOLS
NOWATA,OFFICE NO. 2 NORTHEAST TECH CENTER,BILLY F. HENDRICKSON,,530103,0,0,3,3,OFFICE NO. 2 NORTHEAST TECH CENTER
NOWATA,OFFICE NO. 2 NORTHEAST TECH CENTER,SHERMAN WEAVER,,530103,0,0,3,3,OFFICE NO. 2 NORTHEAST TECH CENTER
NOWATA,OFFICE NO. 2 SOUTH COFFEYVILLE SCHOOLS,DEBORAH LEE,,530201,1,0,2,3,OFFICE NO. 2 SOUTH COFFEYVILLE SCHOOLS
NOWATA,OFFICE NO. 2 SOUTH COFFEYVILLE SCHOOLS,AARON TITUS,,530201,0,0,4,4,OFFICE NO. 2 SOUTH COFFEYVILLE SCHOOLS
NOWATA,OFFICE NO. 2 SOUTH COFFEYVILLE SCHOOLS,DEBORAH LEE,,530301,6,0,61,67,OFFICE NO. 2 SOUTH COFFEYVILLE SCHOOLS
NOWATA,OFFICE NO. 2 SOUTH COFFEYVILLE SCHOOLS,AARON TITUS,,530301,5,0,18,23,OFFICE NO. 2 SOUTH COFFEYVILLE SCHOOLS
NOWATA,OFFICE NO. 2 SOUTH COFFEYVILLE SCHOOLS,DEBORAH LEE,,530304,0,0,0,0,OFFICE NO. 2 SOUTH COFFEYVILLE SCHOOLS
NOWATA,OFFICE NO. 2 SOUTH COFFEYVILLE SCHOOLS,AARON TITUS,,530304,0,0,0,0,OFFICE NO. 2 SOUTH COFFEYVILLE SCHOOLS
OKFUSKEE,PROPOSITION OKEMAH PUBLIC SCHOOLS,FOR THE PROPOSITION - YES,,540101,0,0,0,0,
OKFUSKEE,PROPOSITION OKEMAH PUBLIC SCHOOLS,AGAINST THE PROPOSITION - NO,,540101,0,1,0,1,
OKFUSKEE,OFFICE NO. 2 PADEN PUBLIC SCHOOLS,JIMMY LYNN WATTS,,540101,0,3,52,55,OFFICE NO. 2 PADEN PUBLIC SCHOOLS
OKFUSKEE,OFFICE NO. 2 PADEN PUBLIC SCHOOLS,KELLY JO SEATON,,540101,0,0,17,17,OFFICE NO. 2 PADEN PUBLIC SCHOOLS
OKFUSKEE,OFFICE NO. 2 PADEN PUBLIC SCHOOLS,LINSEY NORMAN,,540101,0,0,93,93,OFFICE NO. 2 PADEN PUBLIC SCHOOLS
OKFUSKEE,OFFICE NO. 2 MASON PUBLIC SCHOOLS,MATTHEW YOUNG,,540102,0,0,0,0,OFFICE NO. 2 MASON PUBLIC SCHOOLS
OKFUSKEE,OFFICE NO. 2 MASON PUBLIC SCHOOLS,DANNY BEEN,,540102,0,0,0,0,OFFICE NO. 2 MASON PUBLIC SCHOOLS
OKFUSKEE,OFFICE NO. 2 MASON PUBLIC SCHOOLS,JEROLD SMITH,,540102,0,0,0,0,OFFICE NO. 2 MASON PUBLIC SCHOOLS
OKFUSKEE,PROPOSITION OKEMAH PUBLIC SCHOOLS,FOR THE PROPOSITION - YES,,540102,0,1,17,18,
OKFUSKEE,PROPOSITION OKEMAH PUBLIC SCHOOLS,AGAINST THE PROPOSITION - NO,,540102,3,1,11,15,
OKFUSKEE,OFFICE NO. 2 PADEN PUBLIC SCHOOLS,JIMMY LYNN WATTS,,540102,0,0,0,0,OFFICE NO. 2 PADEN PUBLIC SCHOOLS
OKFUSKEE,OFFICE NO. 2 PADEN PUBLIC SCHOOLS,KELLY JO SEATON,,540102,0,0,0,0,OFFICE NO. 2 PADEN PUBLIC SCHOOLS
OKFUSKEE,OFFICE NO. 2 PADEN PUBLIC SCHOOLS,LINSEY NORMAN,,540102,0,0,0,0,OFFICE NO. 2 PADEN PUBLIC SCHOOLS
OKFUSKEE,OFFICE NO. 2 MASON PUBLIC SCHOOLS,MATTHEW YOUNG,,540103,0,0,6,6,OFFICE NO. 2 MASON PUBLIC SCHOOLS
OKFUSKEE,OFFICE NO. 2 MASON PUBLIC SCHOOLS,DANNY BEEN,,540103,0,0,29,29,OFFICE NO. 2 MASON PUBLIC SCHOOLS
OKFUSKEE,OFFICE NO. 2 MASON PUBLIC SCHOOLS,JEROLD SMITH,,540103,0,1,12,13,OFFICE NO. 2 MASON PUBLIC SCHOOLS
OKFUSKEE,PROPOSITION OKEMAH PUBLIC SCHOOLS,FOR THE PROPOSITION - YES,,540103,0,0,0,0,
OKFUSKEE,PROPOSITION OKEMAH PUBLIC SCHOOLS,AGAINST THE PROPOSITION - NO,,540103,0,0,0,0,
OKFUSKEE,OFFICE NO. 2 PADEN PUBLIC SCHOOLS,JIMMY LYNN WATTS,,540103,0,0,0,0,OFFICE NO. 2 PADEN PUBLIC SCHOOLS
OKFUSKEE,OFFICE NO. 2 PADEN PUBLIC SCHOOLS,KELLY JO SEATON,,540103,0,0,0,0,OFFICE NO. 2 PADEN PUBLIC SCHOOLS
OKFUSKEE,OFFICE NO. 2 PADEN PUBLIC SCHOOLS,LINSEY NORMAN,,540103,0,0,0,0,OFFICE NO. 2 PADEN PUBLIC SCHOOLS
OKFUSKEE,OFFICE NO. 2 MASON PUBLIC SCHOOLS,MATTHEW YOUNG,,540105,0,0,2,2,OFFICE NO. 2 MASON PUBLIC SCHOOLS
OKFUSKEE,OFFICE NO. 2 MASON PUBLIC SCHOOLS,DANNY BEEN,,540105,0,2,0,2,OFFICE NO. 2 MASON PUBLIC SCHOOLS
OKFUSKEE,OFFICE NO. 2 MASON PUBLIC SCHOOLS,JEROLD SMITH,,540105,0,0,0,0,OFFICE NO. 2 MASON PUBLIC SCHOOLS
OKFUSKEE,PROPOSITION OKEMAH PUBLIC SCHOOLS,FOR THE PROPOSITION - YES,,540105,0,3,20,23,
OKFUSKEE,PROPOSITION OKEMAH PUBLIC SCHOOLS,AGAINST THE PROPOSITION - NO,,540105,0,4,18,22,
OKFUSKEE,OFFICE NO. 2 MASON PUBLIC SCHOOLS,MATTHEW YOUNG,,540206,0,1,13,14,OFFICE NO. 2 MASON PUBLIC SCHOOLS
OKFUSKEE,OFFICE NO. 2 MASON PUBLIC SCHOOLS,DANNY BEEN,,540206,0,4,30,34,OFFICE NO. 2 MASON PUBLIC SCHOOLS
OKFUSKEE,OFFICE NO. 2 MASON PUBLIC SCHOOLS,JEROLD SMITH,,540206,0,0,5,5,OFFICE NO. 2 MASON PUBLIC SCHOOLS
OKFUSKEE,PROPOSITION OKEMAH PUBLIC SCHOOLS,FOR THE PROPOSITION - YES,,540206,0,3,0,3,
OKFUSKEE,PROPOSITION OKEMAH PUBLIC SCHOOLS,AGAINST THE PROPOSITION - NO,,540206,0,7,0,7,
OKFUSKEE,PROPOSITION OKEMAH PUBLIC SCHOOLS,FOR THE PROPOSITION - YES,,540207,0,2,19,21,
OKFUSKEE,PROPOSITION OKEMAH PUBLIC SCHOOLS,AGAINST THE PROPOSITION - NO,,540207,0,0,13,13,
OKFUSKEE,OFFICE NO. 2 BUTNER PUBLIC SCHOOLS,HOLLIE MURRAY BEELER,,540207,0,0,0,0,OFFICE NO. 2 BUTNER PUBLIC SCHOOLS
OKFUSKEE,OFFICE NO. 2 BUTNER PUBLIC SCHOOLS,BUTCH HOUSER,,540207,0,0,0,0,OFFICE NO. 2 BUTNER PUBLIC SCHOOLS
OKFUSKEE,PROPOSITION OKEMAH PUBLIC SCHOOLS,FOR THE PROPOSITION - YES,,540208,1,13,59,73,
OKFUSKEE,PROPOSITION OKEMAH PUBLIC SCHOOLS,AGAINST THE PROPOSITION - NO,,540208,0,5,50,55,
OKFUSKEE,PROPOSITION OKEMAH PUBLIC SCHOOLS,FOR THE PROPOSITION - YES,,540209,4,14,101,119,
OKFUSKEE,PROPOSITION OKEMAH PUBLIC SCHOOLS,AGAINST THE PROPOSITION - NO,,540209,1,10,57,68,
OKFUSKEE,PROPOSITION OKEMAH PUBLIC SCHOOLS,FOR THE PROPOSITION - YES,,540210,1,3,0,4,
OKFUSKEE,PROPOSITION OKEMAH PUBLIC SCHOOLS,AGAINST THE PROPOSITION - NO,,540210,0,0,0,0,
OKFUSKEE,OFFICE NO. 2 BUTNER PUBLIC SCHOOLS,HOLLIE MURRAY BEELER,,540210,0,0,0,0,OFFICE NO. 2 BUTNER PUBLIC SCHOOLS
OKFUSKEE,OFFICE NO. 2 BUTNER PUBLIC SCHOOLS,BUTCH HOUSER,,540210,0,0,0,0,OFFICE NO. 2 BUTNER PUBLIC SCHOOLS
OKFUSKEE,PROPOSITION NO. 1 GRAHAM-DUSTIN PUBLIC SCHOOLS,FOR THE PROPOSITION - YES,,540311,0,0,0,0,PROPOSITION NO. 1 GRAHAM-DUSTIN PUBLIC SCHOOLS
OKFUSKEE,PROPOSITION NO. 1 GRAHAM-DUSTIN PUBLIC SCHOOLS,AGAINST THE PROPOSITION - NO,,540311,0,0,0,0,PROPOSITION NO. 1 GRAHAM-DUSTIN PUBLIC SCHOOLS
OKFUSKEE,PROPOSITION NO. 2 GRAHAM-DUSTIN PUBLIC SCHOOLS,FOR THE PROPOSITION - YES,,540311,0,0,0,0,PROPOSITION NO. 2 GRAHAM-DUSTIN PUBLIC SCHOOLS
OKFUSKEE,PROPOSITION NO. 2 GRAHAM-DUSTIN PUBLIC SCHOOLS,AGAINST THE PROPOSITION - NO,,540311,0,0,0,0,PROPOSITION NO. 2 GRAHAM-DUSTIN PUBLIC SCHOOLS
OKFUSKEE,PROPOSITION OKEMAH PUBLIC SCHOOLS,FOR THE PROPOSITION - YES,,540311,0,11,0,11,
OKFUSKEE,PROPOSITION OKEMAH PUBLIC SCHOOLS,AGAINST THE PROPOSITION - NO,,540311,0,8,0,8,
OKFUSKEE,PROPOSITION NO. 1 GRAHAM-DUSTIN PUBLIC SCHOOLS,FOR THE PROPOSITION - YES,,540312,0,0,0,0,PROPOSITION NO. 1 GRAHAM-DUSTIN PUBLIC SCHOOLS
OKFUSKEE,PROPOSITION NO. 1 GRAHAM-DUSTIN PUBLIC SCHOOLS,AGAINST THE PROPOSITION - NO,,540312,0,0,3,3,PROPOSITION NO. 1 GRAHAM-DUSTIN PUBLIC SCHOOLS
OKFUSKEE,PROPOSITION NO. 2 GRAHAM-DUSTIN PUBLIC SCHOOLS,FOR THE PROPOSITION - YES,,540312,0,0,0,0,PROPOSITION NO. 2 GRAHAM-DUSTIN PUBLIC SCHOOLS
OKFUSKEE,PROPOSITION NO. 2 GRAHAM-DUSTIN PUBLIC SCHOOLS,AGAINST THE PROPOSITION - NO,,540312,0,0,3,3,PROPOSITION NO. 2 GRAHAM-DUSTIN PUBLIC SCHOOLS
OKFUSKEE,PROPOSITION OKEMAH PUBLIC SCHOOLS,FOR THE PROPOSITION - YES,,540312,0,2,0,2,
OKFUSKEE,PROPOSITION OKEMAH PUBLIC SCHOOLS,AGAINST THE PROPOSITION - NO,,540312,0,0,0,0,
OKFUSKEE,PROPOSITION NO. 1 GRAHAM-DUSTIN PUBLIC SCHOOLS,FOR THE PROPOSITION - YES,,540313,0,0,35,35,PROPOSITION NO. 1 GRAHAM-DUSTIN PUBLIC SCHOOLS
OKFUSKEE,PROPOSITION NO. 1 GRAHAM-DUSTIN PUBLIC SCHOOLS,AGAINST THE PROPOSITION - NO,,540313,0,0,15,15,PROPOSITION NO. 1 GRAHAM-DUSTIN PUBLIC SCHOOLS
OKFUSKEE,PROPOSITION NO. 2 GRAHAM-DUSTIN PUBLIC SCHOOLS,FOR THE PROPOSITION - YES,,540313,0,0,36,36,PROPOSITION NO. 2 GRAHAM-DUSTIN PUBLIC SCHOOLS
OKFUSKEE,PROPOSITION NO. 2 GRAHAM-DUSTIN PUBLIC SCHOOLS,AGAINST THE PROPOSITION - NO,,540313,0,0,14,14,PROPOSITION NO. 2 GRAHAM-DUSTIN PUBLIC SCHOOLS
OKFUSKEE,PROPOSITION OKEMAH PUBLIC SCHOOLS,FOR THE PROPOSITION - YES,,540314,7,2,35,44,
OKFUSKEE,PROPOSITION OKEMAH PUBLIC SCHOOLS,AGAINST THE PROPOSITION - NO,,540314,2,7,29,38,
OKLAHOMA,MAYOR CITY OF BETHANY,KATHY LARSEN,,550001,0,0,14,14,
OKLAHOMA,MAYOR CITY OF BETHANY,KP WESTMORELAND,,550001,0,0,22,22,
OKLAHOMA,"COUNCILMEMBER, WARD 1 CITY OF BETHANY",PAUL TODD,,550001,0,0,23,23,"COUNCILMEMBER, WARD 1 CITY OF BETHANY"
OKLAHOMA,"COUNCILMEMBER, WARD 1 CITY OF BETHANY",MATTHEW PALLARES,,550001,0,0,11,11,"COUNCILMEMBER, WARD 1 CITY OF BETHANY"
OKLAHOMA,"COUNCILMEMBER, WARD 3 CITY OF OKLAHOMA CITY",LARRY McATEE,,550001,0,0,11,11,"COUNCILMEMBER, WARD 3 CITY OF OKLAHOMA CITY"
OKLAHOMA,"COUNCILMEMBER, WARD 3 CITY OF OKLAHOMA CITY",MATTHEW W. OLSEN,,550001,0,0,4,4,"COUNCILMEMBER, WARD 3 CITY OF OKLAHOMA CITY"
OKLAHOMA,"COUNCILMEMBER, WARD 3 CITY OF OKLAHOMA CITY",JOE SARGE NELSON,,550001,0,0,8,8,"COUNCILMEMBER, WARD 3 CITY OF OKLAHOMA CITY"
OKLAHOMA,OFFICE NO. 2 FRANCIS TUTTLE TECH CENTER,PETE LEE,,550001,0,0,16,16,OFFICE NO. 2 FRANCIS TUTTLE TECH CENTER
OKLAHOMA,OFFICE NO. 2 FRANCIS TUTTLE TECH CENTER,ROBERT STONE,,550001,0,0,36,36,OFFICE NO. 2 FRANCIS TUTTLE TECH CENTER
OKLAHOMA,MAYOR CITY OF BETHANY,KATHY LARSEN,,550002,0,0,46,46,
OKLAHOMA,MAYOR CITY OF BETHANY,KP WESTMORELAND,,550002,0,0,72,72,
OKLAHOMA,"COUNCILMEMBER, WARD 1 CITY OF BETHANY",PAUL TODD,,550002,0,0,51,51,"COUNCILMEMBER, WARD 1 CITY OF BETHANY"
OKLAHOMA,"COUNCILMEMBER, WARD 1 CITY OF BETHANY",MATTHEW PALLARES,,550002,0,0,25,25,"COUNCILMEMBER, WARD 1 CITY OF BETHANY"
OKLAHOMA,"COUNCILMEMBER, WARD 1 CITY OF OKLAHOMA CITY",CHRIS GORDON,,550002,0,0,2,2,"COUNCILMEMBER, WARD 1 CITY OF OKLAHOMA CITY"
OKLAHOMA,"COUNCILMEMBER, WARD 1 CITY OF OKLAHOMA CITY",JAMES GREINER,,550002,0,0,4,4,"COUNCILMEMBER, WARD 1 CITY OF OKLAHOMA CITY"
OKLAHOMA,"COUNCILMEMBER, WARD 1 CITY OF OKLAHOMA CITY",JONATHAN CLOUR,,550002,0,0,2,2,"COUNCILMEMBER, WARD 1 CITY OF OKLAHOMA CITY"
OKLAHOMA,OFFICE NO. 2 FRANCIS TUTTLE TECH CENTER,PETE LEE,,550002,0,0,33,33,OFFICE NO. 2 FRANCIS TUTTLE TECH CENTER
OKLAHOMA,OFFICE NO. 2 FRANCIS TUTTLE TECH CENTER,ROBERT STONE,,550002,0,0,77,77,OFFICE NO. 2 FRANCIS TUTTLE TECH CENTER
OKLAHOMA,MAYOR CITY OF BETHANY,KATHY LARSEN,,550003,0,0,25,25,
OKLAHOMA,MAYOR CITY OF BETHANY,KP WESTMORELAND,,550003,0,0,33,33,
OKLAHOMA,"COUNCILMEMBER, WARD 3 CITY OF BETHANY",ARVEL L. WILLIAMS,,550003,0,0,13,13,"COUNCILMEMBER, WARD 3 CITY OF BETHANY"
OKLAHOMA,"COUNCILMEMBER, WARD 3 CITY OF BETHANY",JOHN HERREN,,550003,0,0,40,40,"COUNCILMEMBER, WARD 3 CITY OF BETHANY"
OKLAHOMA,"COUNCILMEMBER, WARD 1 CITY OF OKLAHOMA CITY",CHRIS GORDON,,550003,0,0,8,8,"COUNCILMEMBER, WARD 1 CITY OF OKLAHOMA CITY"
OKLAHOMA,"COUNCILMEMBER, WARD 1 CITY OF OKLAHOMA CITY",JAMES GREINER,,550003,0,0,45,45,"COUNCILMEMBER, WARD 1 CITY OF OKLAHOMA CITY"
OKLAHOMA,"COUNCILMEMBER, WARD 1 CITY OF OKLAHOMA CITY",JONATHAN CLOUR,,550003,0,0,3,3,"COUNCILMEMBER, WARD 1 CITY OF OKLAHOMA CITY"
OKLAHOMA,OFFICE NO. 2 FRANCIS TUTTLE TECH CENTER,PETE LEE,,550003,0,0,32,32,OFFICE NO. 2 FRANCIS TUTTLE TECH CENTER
OKLAHOMA,OFFICE NO. 2 FRANCIS TUTTLE TECH CENTER,ROBERT STONE,,550003,0,0,69,69,OFFICE NO. 2 FRANCIS TUTTLE TECH CENTER
OKLAHOMA,MAYOR CITY OF BETHANY,KATHY LARSEN,,550004,0,0,61,61,
OKLAHOMA,MAYOR CITY OF BETHANY,KP WESTMORELAND,,550004,0,0,168,168,
OKLAHOMA,"COUNCILMEMBER, WARD 3 CITY OF BETHANY",ARVEL L. WILLIAMS,,550004,0,0,21,21,"COUNCILMEMBER, WARD 3 CITY OF BETHANY"
OKLAHOMA,"COUNCILMEMBER, WARD 3 CITY OF BETHANY",JOHN HERREN,,550004,0,0,101,101,"COUNCILMEMBER, WARD 3 CITY OF BETHANY"
OKLAHOMA,OFFICE NO. 2 FRANCIS TUTTLE TECH CENTER,PETE LEE,,550004,0,0,66,66,OFFICE NO. 2 FRANCIS TUTTLE TECH CENTER
OKLAHOMA,OFFICE NO. 2 FRANCIS TUTTLE TECH CENTER,ROBERT STONE,,550004,0,0,125,125,OFFICE NO. 2 FRANCIS TUTTLE TECH CENTER
OKLAHOMA,MAYOR CITY OF BETHANY,KATHY LARSEN,,550005,0,0,27,27,
OKLAHOMA,MAYOR CITY OF BETHANY,KP WESTMORELAND,,550005,0,0,66,66,
OKLAHOMA,"COUNCILMEMBER, WARD 1 CITY OF BETHANY",PAUL TODD,,550005,0,0,14,14,"COUNCILMEMBER, WARD 1 CITY OF BETHANY"
OKLAHOMA,"COUNCILMEMBER, WARD 1 CITY OF BETHANY",MATTHEW PALLARES,,550005,0,0,8,8,"COUNCILMEMBER, WARD 1 CITY OF BETHANY"
OKLAHOMA,"COUNCILMEMBER, WARD 3 CITY OF OKLAHOMA CITY",LARRY McATEE,,550005,0,0,3,3,"COUNCILMEMBER, WARD 3 CITY OF OKLAHOMA CITY"
OKLAHOMA,"COUNCILMEMBER, WARD 3 CITY OF OKLAHOMA CITY",MATTHEW W. OLSEN,,550005,0,0,9,9,"COUNCILMEMBER, WARD 3 CITY OF OKLAHOMA CITY"
OKLAHOMA,"COUNCILMEMBER, WARD 3 CITY OF OKLAHOMA CITY",JOE SARGE NELSON,,550005,0,0,3,3,"COUNCILMEMBER, WARD 3 CITY OF OKLAHOMA CITY"
OKLAHOMA,OFFICE NO. 2 FRANCIS TUTTLE TECH CENTER,PETE LEE,,550005,0,0,23,23,OFFICE NO. 2 FRANCIS TUTTLE TECH CENTER
OKLAHOMA,OFFICE NO. 2 FRANCIS TUTTLE TECH CENTER,ROBERT STONE,,550005,0,0,73,73,OFFICE NO. 2 FRANCIS TUTTLE TECH CENTER
OKLAHOMA,MAYOR CITY OF BETHANY,KATHY LARSEN,,550006,0,0,43,43,
OKLAHOMA,MAYOR CITY OF BETHANY,KP WESTMORELAND,,550006,0,0,52,52,
OKLAHOMA,"COUNCILMEMBER, WARD 1 CITY OF BETHANY",PAUL TODD,,550006,0,0,31,31,"COUNCILMEMBER, WARD 1 CITY OF BETHANY"
OKLAHOMA,"COUNCILMEMBER, WARD 1 CITY OF BETHANY",MATTHEW PALLARES,,550006,0,0,13,13,"COUNCILMEMBER, WARD 1 CITY OF BETHANY"
OKLAHOMA,OFFICE NO. 2 FRANCIS TUTTLE TECH CENTER,PETE LEE,,550006,0,0,22,22,OFFICE NO. 2 FRANCIS TUTTLE TECH CENTER
OKLAHOMA,OFFICE NO. 2 FRANCIS TUTTLE TECH CENTER,ROBERT STONE,,550006,0,0,71,71,OFFICE NO. 2 FRANCIS TUTTLE TECH CENTER
OKLAHOMA,MAYOR CITY OF BETHANY,KATHY LARSEN,,550007,0,0,141,141,
OKLAHOMA,MAYOR CITY OF BETHANY,KP WESTMORELAND,,550007,0,0,137,137,
OKLAHOMA,"COUNCILMEMBER, WARD 3 CITY OF BETHANY",ARVEL L. WILLIAMS,,550007,0,0,136,136,"COUNCILMEMBER, WARD 3 CITY OF BETHANY"
OKLAHOMA,"COUNCILMEMBER, WARD 3 CITY OF BETHANY",JOHN HERREN,,550007,0,0,137,137,"COUNCILMEMBER, WARD 3 CITY OF BETHANY"
OKLAHOMA,"COUNCILMEMBER, WARD 1 CITY OF OKLAHOMA CITY",CHRIS GORDON,,550007,0,0,0,0,"COUNCILMEMBER, WARD 1 CITY OF OKLAHOMA CITY"
OKLAHOMA,"COUNCILMEMBER, WARD 1 CITY OF OKLAHOMA CITY",JAMES GREINER,,550007,0,0,0,0,"COUNCILMEMBER, WARD 1 CITY OF OKLAHOMA CITY"
OKLAHOMA,"COUNCILMEMBER, WARD 1 CITY OF OKLAHOMA CITY",JONATHAN CLOUR,,550007,0,0,0,0,"COUNCILMEMBER, WARD 1 CITY OF OKLAHOMA CITY"
OKLAHOMA,OFFICE NO. 2 FRANCIS TUTTLE TECH CENTER,PETE LEE,,550007,0,0,90,90,OFFICE NO. 2 FRANCIS TUTTLE TECH CENTER
OKLAHOMA,OFFICE NO. 2 FRANCIS TUTTLE TECH CENTER,ROBERT STONE,,550007,0,0,147,147,OFFICE NO. 2 FRANCIS TUTTLE TECH CENTER
OKLAHOMA,MAYOR CITY OF BETHANY,KATHY LARSEN,,550008,0,0,20,20,
OKLAHOMA,MAYOR CITY OF BETHANY,KP WESTMORELAND,,550008,0,0,93,93,
OKLAHOMA,"COUNCILMEMBER, WARD 2 CITY OF BETHANY",DON RICHARDS,,550008,0,0,17,17,"COUNCILMEMBER, WARD 2 CITY OF BETHANY"
OKLAHOMA,"COUNCILMEMBER, WARD 2 CITY OF BETHANY",KATHI HOLLOWAY,,550008,0,0,13,13,"COUNCILMEMBER, WARD 2 CITY OF BETHANY"
OKLAHOMA,"COUNCILMEMBER, WARD 2 CITY OF BETHANY",STEVE PALMER,,550008,0,0,39,39,"COUNCILMEMBER, WARD 2 CITY OF BETHANY"
OKLAHOMA,"COUNCILMEMBER, WARD 3 CITY OF BETHANY",ARVEL L. WILLIAMS,,550008,0,0,13,13,"COUNCILMEMBER, WARD 3 CITY OF BETHANY"
OKLAHOMA,"COUNCILMEMBER, WARD 3 CITY OF BETHANY",JOHN HERREN,,550008,0,0,29,29,"COUNCILMEMBER, WARD 3 CITY OF BETHANY"
OKLAHOMA,OFFICE NO. 2 FRANCIS TUTTLE TECH CENTER,PETE LEE,,550008,0,0,8,8,OFFICE NO. 2 FRANCIS TUTTLE TECH CENTER
OKLAHOMA,OFFICE NO. 2 FRANCIS TUTTLE TECH CENTER,ROBERT STONE,,550008,0,0,27,27,OFFICE NO. 2 FRANCIS TUTTLE TECH CENTER
OKLAHOMA,MAYOR CITY OF BETHANY,KATHY LARSEN,,550009,0,0,33,33,
OKLAHOMA,MAYOR CITY OF BETHANY,KP WESTMORELAND,,550009,0,0,174,174,
OKLAHOMA,"COUNCILMEMBER, WARD 2 CITY OF BETHANY",DON RICHARDS,,550009,0,0,17,17,"COUNCILMEMBER, WARD 2 CITY OF BETHANY"
OKLAHOMA,"COUNCILMEMBER, WARD 2 CITY OF BETHANY",KATHI HOLLOWAY,,550009,0,0,41,41,"COUNCILMEMBER, WARD 2 CITY OF BETHANY"
OKLAHOMA,"COUNCILMEMBER, WARD 2 CITY OF BETHANY",STEVE PALMER,,550009,0,0,148,148,"COUNCILMEMBER, WARD 2 CITY OF BETHANY"
OKLAHOMA,"COUNCILMAN, WARD 3 CITY OF WARR ACRES",JIMMY BULLEN,,550009,0,0,0,0,"COUNCILMAN, WARD 3 CITY OF WARR ACRES"
OKLAHOMA,"COUNCILMAN, WARD 3 CITY OF WARR ACRES",ROGER GODWIN,,550009,0,0,1,1,"COUNCILMAN, WARD 3 CITY OF WARR ACRES"
OKLAHOMA,OFFICE NO. 2 FRANCIS TUTTLE TECH CENTER,PETE LEE,,550009,0,0,0,0,OFFICE NO. 2 FRANCIS TUTTLE TECH CENTER
OKLAHOMA,OFFICE NO. 2 FRANCIS TUTTLE TECH CENTER,ROBERT STONE,,550009,0,0,1,1,OFFICE NO. 2 FRANCIS TUTTLE TECH CENTER
OKLAHOMA,MAYOR CITY OF BETHANY,KATHY LARSEN,,550010,0,0,9,9,
OKLAHOMA,MAYOR CITY OF BETHANY,KP WESTMORELAND,,550010,0,0,96,96,
OKLAHOMA,"COUNCILMEMBER, WARD 2 CITY OF BETHANY",DON RICHARDS,,550010,0,0,4,4,"COUNCILMEMBER, WARD 2 CITY OF BETHANY"
OKLAHOMA,"COUNCILMEMBER, WARD 2 CITY OF BETHANY",KATHI HOLLOWAY,,550010,0,0,13,13,"COUNCILMEMBER, WARD 2 CITY OF BETHANY"
OKLAHOMA,"COUNCILMEMBER, WARD 2 CITY OF BETHANY",STEVE PALMER,,550010,0,0,90,90,"COUNCILMEMBER, WARD 2 CITY OF BETHANY"
OKLAHOMA,"COUNCILMAN, WARD 3 CITY OF WARR ACRES",JIMMY BULLEN,,550010,0,0,3,3,"COUNCILMAN, WARD 3 CITY OF WARR ACRES"
OKLAHOMA,"COUNCILMAN, WARD 3 CITY OF WARR ACRES",ROGER GODWIN,,550010,0,0,11,11,"COUNCILMAN, WARD 3 CITY OF WARR ACRES"
OKLAHOMA,OFFICE NO. 2 FRANCIS TUTTLE TECH CENTER,PETE LEE,,550010,0,0,3,3,OFFICE NO. 2 FRANCIS TUTTLE TECH CENTER
OKLAHOMA,OFFICE NO. 2 FRANCIS TUTTLE TECH CENTER,ROBERT STONE,,550010,0,0,11,11,OFFICE NO. 2 FRANCIS TUTTLE TECH CENTER
OKLAHOMA,"COUNCILMAN, WARD 3 CITY OF WARR ACRES",JIMMY BULLEN,,550011,0,0,1,1,"COUNCILMAN, WARD 3 CITY OF WARR ACRES"
OKLAHOMA,"COUNCILMAN, WARD 3 CITY OF WARR ACRES",ROGER GODWIN,,550011,0,0,4,4,"COUNCILMAN, WARD 3 CITY OF WARR ACRES"
OKLAHOMA,OFFICE NO. 2 FRANCIS TUTTLE TECH CENTER,PETE LEE,,550011,0,0,6,6,OFFICE NO. 2 FRANCIS TUTTLE TECH CENTER
OKLAHOMA,OFFICE NO. 2 FRANCIS TUTTLE TECH CENTER,ROBERT STONE,,550011,0,0,10,10,OFFICE NO. 2 FRANCIS TUTTLE TECH CENTER
OKLAHOMA,"COUNCILMEMBER, WARD 1 CITY OF OKLAHOMA CITY",CHRIS GORDON,,550012,0,0,41,41,"COUNCILMEMBER, WARD 1 CITY OF OKLAHOMA CITY"
OKLAHOMA,"COUNCILMEMBER, WARD 1 CITY OF OKLAHOMA CITY",JAMES GREINER,,550012,0,0,54,54,"COUNCILMEMBER, WARD 1 CITY OF OKLAHOMA CITY"
OKLAHOMA,"COUNCILMEMBER, WARD 1 CITY OF OKLAHOMA CITY",JONATHAN CLOUR,,550012,0,0,2,2,"COUNCILMEMBER, WARD 1 CITY OF OKLAHOMA CITY"
OKLAHOMA,"COUNCILMAN, WARD 3 CITY OF WARR ACRES",JIMMY BULLEN,,550012,0,0,0,0,"COUNCILMAN, WARD 3 CITY OF WARR ACRES"
OKLAHOMA,"COUNCILMAN, WARD 3 CITY OF WARR ACRES",ROGER GODWIN,,550012,0,0,1,1,"COUNCILMAN, WARD 3 CITY OF WARR ACRES"
OKLAHOMA,OFFICE NO. 2 FRANCIS TUTTLE TECH CENTER,PETE LEE,,550012,0,0,23,23,OFFICE NO. 2 FRANCIS TUTTLE TECH CENTER
OKLAHOMA,OFFICE NO. 2 FRANCIS TUTTLE TECH CENTER,ROBERT STONE,,550012,0,0,61,61,OFFICE NO. 2 FRANCIS TUTTLE TECH CENTER
OKLAHOMA,MAYOR CITY OF BETHANY,KATHY LARSEN,,550013,0,0,18,18,
OKLAHOMA,MAYOR CITY OF BETHANY,KP WESTMORELAND,,550013,0,0,45,45,
OKLAHOMA,"COUNCILMEMBER, WARD 2 CITY OF BETHANY",DON RICHARDS,,550013,0,0,6,6,"COUNCILMEMBER, WARD 2 CITY OF BETHANY"
OKLAHOMA,"COUNCILMEMBER, WARD 2 CITY OF BETHANY",KATHI HOLLOWAY,,550013,0,0,23,23,"COUNCILMEMBER, WARD 2 CITY OF BETHANY"
OKLAHOMA,"COUNCILMEMBER, WARD 2 CITY OF BETHANY",STEVE PALMER,,550013,0,0,36,36,"COUNCILMEMBER, WARD 2 CITY OF BETHANY"
OKLAHOMA,"COUNCILMAN, WARD 3 CITY OF WARR ACRES",JIMMY BULLEN,,550013,0,0,2,2,"COUNCILMAN, WARD 3 CITY OF WARR ACRES"
OKLAHOMA,"COUNCILMAN, WARD 3 CITY OF WARR ACRES",ROGER GODWIN,,550013,0,0,2,2,"COUNCILMAN, WARD 3 CITY OF WARR ACRES"
OKLAHOMA,OFFICE NO. 2 FRANCIS TUTTLE TECH CENTER,PETE LEE,,550013,0,0,18,18,OFFICE NO. 2 FRANCIS TUTTLE TECH CENTER
OKLAHOMA,OFFICE NO. 2 FRANCIS TUTTLE TECH CENTER,ROBERT STONE,,550013,0,0,48,48,OFFICE NO. 2 FRANCIS TUTTLE TECH CENTER
OKLAHOMA,"COUNCILMEMBER, WARD 1 CITY OF OKLAHOMA CITY",CHRIS GORDON,,550014,0,0,7,7,"COUNCILMEMBER, WARD 1 CITY OF OKLAHOMA CITY"
OKLAHOMA,"COUNCILMEMBER, WARD 1 CITY OF OKLAHOMA CITY",JAMES GREINER,,550014,0,0,2,2,"COUNCILMEMBER, WARD 1 CITY OF OKLAHOMA CITY"
OKLAHOMA,"COUNCILMEMBER, WARD 1 CITY OF OKLAHOMA CITY",JONATHAN CLOUR,,550014,0,0,1,1,"COUNCILMEMBER, WARD 1 CITY OF OKLAHOMA CITY"
OKLAHOMA,OFFICE NO. 2 FRANCIS TUTTLE TECH CENTER,PETE LEE,,550014,0,0,6,6,OFFICE NO. 2 FRANCIS TUTTLE TECH CENTER
OKLAHOMA,OFFICE NO. 2 FRANCIS TUTTLE TECH CENTER,ROBERT STONE,,550014,0,0,10,10,OFFICE NO. 2 FRANCIS TUTTLE TECH CENTER
OKLAHOMA,"COUNCILMEMBER, WARD 1 CITY OF OKLAHOMA CITY",CHRIS GORDON,,550015,0,0,35,35,"COUNCILMEMBER, WARD 1 CITY OF OKLAHOMA CITY"
OKLAHOMA,"COUNCILMEMBER, WARD 1 CITY OF OKLAHOMA CITY",JAMES GREINER,,550015,0,0,30,30,"COUNCILMEMBER, WARD 1 CITY OF OKLAHOMA CITY"
OKLAHOMA,"COUNCILMEMBER, WARD 1 CITY OF OKLAHOMA CITY",JONATHAN CLOUR,,550015,0,0,6,6,"COUNCILMEMBER, WARD 1 CITY OF OKLAHOMA CITY"
OKLAHOMA,OFFICE NO. 2 FRANCIS TUTTLE TECH CENTER,PETE LEE,,550015,0,0,33,33,OFFICE NO. 2 FRANCIS TUTTLE TECH CENTER
OKLAHOMA,OFFICE NO. 2 FRANCIS TUTTLE TECH CENTER,ROBERT STONE,,550015,0,0,37,37,OFFICE NO. 2 FRANCIS TUTTLE TECH CENTER
OKLAHOMA,"COUNCILMEMBER, WARD 1 CITY OF OKLAHOMA CITY",CHRIS GORDON,,550016,0,0,18,18,"COUNCILMEMBER, WARD 1 CITY OF OKLAHOMA CITY"
OKLAHOMA,"COUNCILMEMBER, WARD 1 CITY OF OKLAHOMA CITY",JAMES GREINER,,550016,0,0,11,11,"COUNCILMEMBER, WARD 1 CITY OF OKLAHOMA CITY"
OKLAHOMA,"COUNCILMEMBER, WARD 1 CITY OF OKLAHOMA CITY",JONATHAN CLOUR,,550016,0,0,0,0,"COUNCILMEMBER, WARD 1 CITY OF OKLAHOMA CITY"
OKLAHOMA,OFFICE NO. 2 FRANCIS TUTTLE TECH CENTER,PETE LEE,,550016,0,0,13,13,OFFICE NO. 2 FRANCIS TUTTLE TECH CENTER
OKLAHOMA,OFFICE NO. 2 FRANCIS TUTTLE TECH CENTER,ROBERT STONE,,550016,0,0,10,10,OFFICE NO. 2 FRANCIS TUTTLE TECH CENTER
OKLAHOMA,OFFICE NO. 2 FRANCIS TUTTLE TECH CENTER,PETE LEE,,550017,0,0,0,0,OFFICE NO. 2 FRANCIS TUTTLE TECH CENTER
OKLAHOMA,OFFICE NO. 2 FRANCIS TUTTLE TECH CENTER,ROBERT STONE,,550017,0,0,0,0,OFFICE NO. 2 FRANCIS TUTTLE TECH CENTER
OKLAHOMA,"COUNCILMEMBER, WARD 4 CITY OF OKLAHOMA CITY",RICHARD D. MORRISSETTE,,550021,0,0,4,4,"COUNCILMEMBER, WARD 4 CITY OF OKLAHOMA CITY"
OKLAHOMA,"COUNCILMEMBER, WARD 4 CITY OF OKLAHOMA CITY",TODD STONE,,550021,0,0,8,8,"COUNCILMEMBER, WARD 4 CITY OF OKLAHOMA CITY"
OKLAHOMA,"COUNCILMEMBER, WARD 4 CITY OF OKLAHOMA CITY",WALTER KULA,,550021,0,0,4,4,"COUNCILMEMBER, WARD 4 CITY OF OKLAHOMA CITY"
OKLAHOMA,"COUNCILMEMBER, WARD 4 CITY OF OKLAHOMA CITY",DORIS MANGIARACINA BENBROOK,,550021,0,0,1,1,"COUNCILMEMBER, WARD 4 CITY OF OKLAHOMA CITY"
OKLAHOMA,"COUNCILMEMBER, WARD 4 CITY OF OKLAHOMA CITY",RICHARD D. MORRISSETTE,,550022,0,0,8,8,"COUNCILMEMBER, WARD 4 CITY OF OKLAHOMA CITY"
OKLAHOMA,"COUNCILMEMBER, WARD 4 CITY OF OKLAHOMA CITY",TODD STONE,,550022,0,0,14,14,"COUNCILMEMBER, WARD 4 CITY OF OKLAHOMA CITY"
OKLAHOMA,"COUNCILMEMBER, WARD 4 CITY OF OKLAHOMA CITY",WALTER KULA,,550022,0,0,2,2,"COUNCILMEMBER, WARD 4 CITY OF OKLAHOMA CITY"
OKLAHOMA,"COUNCILMEMBER, WARD 4 CITY OF OKLAHOMA CITY",DORIS MANGIARACINA BENBROOK,,550022,0,0,5,5,"COUNCILMEMBER, WARD 4 CITY OF OKLAHOMA CITY"
OKLAHOMA,BOARD CHAIRPERSON OKLAHOMA CITY PUBLIC SCHOOLS,PAULA LEWIS,,550024,0,0,0,0,
OKLAHOMA,BOARD CHAIRPERSON OKLAHOMA CITY PUBLIC SCHOOLS,WILFREDO SANTOS RIVERA,,550024,0,0,0,0,
OKLAHOMA,BOARD CHAIRPERSON OKLAHOMA CITY PUBLIC SCHOOLS,GREGORY A. WYATT,,550024,0,0,0,0,
OKLAHOMA,BOARD CHAIRPERSON OKLAHOMA CITY PUBLIC SCHOOLS,BIANCA ROSE,,550024,0,0,0,0,
OKLAHOMA,BOARD CHAIRPERSON OKLAHOMA CITY PUBLIC SCHOOLS,STANLEY HUPFELD,,550024,0,0,0,0,
OKLAHOMA,BOARD CHAIRPERSON OKLAHOMA CITY PUBLIC SCHOOLS,PAULA LEWIS,,550025,0,0,0,0,
OKLAHOMA,BOARD CHAIRPERSON OKLAHOMA CITY PUBLIC SCHOOLS,WILFREDO SANTOS RIVERA,,550025,0,0,2,2,
OKLAHOMA,BOARD CHAIRPERSON OKLAHOMA CITY PUBLIC SCHOOLS,GREGORY A. WYATT,,550025,0,0,0,0,
OKLAHOMA,BOARD CHAIRPERSON OKLAHOMA CITY PUBLIC SCHOOLS,BIANCA ROSE,,550025,0,0,0,0,
OKLAHOMA,BOARD CHAIRPERSON OKLAHOMA CITY PUBLIC SCHOOLS,STANLEY HUPFELD,,550025,0,0,1,1,
OKLAHOMA,BOARD CHAIRPERSON OKLAHOMA CITY PUBLIC SCHOOLS,PAULA LEWIS,,550027,0,0,0,0,
OKLAHOMA,BOARD CHAIRPERSON OKLAHOMA CITY PUBLIC SCHOOLS,WILFREDO SANTOS RIVERA,,550027,0,0,0,0,
OKLAHOMA,BOARD CHAIRPERSON OKLAHOMA CITY PUBLIC SCHOOLS,GREGORY A. WYATT,,550027,0,0,0,0,
OKLAHOMA,BOARD CHAIRPERSON OKLAHOMA CITY PUBLIC SCHOOLS,BIANCA ROSE,,550027,0,0,0,0,
OKLAHOMA,BOARD CHAIRPERSON OKLAHOMA CITY PUBLIC SCHOOLS,STANLEY HUPFELD,,550027,0,0,0,0,
OKLAHOMA,BOARD CHAIRPERSON OKLAHOMA CITY PUBLIC SCHOOLS,PAULA LEWIS,,550028,0,0,1,1,
OKLAHOMA,BOARD CHAIRPERSON OKLAHOMA CITY PUBLIC SCHOOLS,WILFREDO SANTOS RIVERA,,550028,0,0,0,0,
OKLAHOMA,BOARD CHAIRPERSON OKLAHOMA CITY PUBLIC SCHOOLS,GREGORY A. WYATT,,550028,0,0,0,0,
OKLAHOMA,BOARD CHAIRPERSON OKLAHOMA CITY PUBLIC SCHOOLS,BIANCA ROSE,,550028,0,0,0,0,
OKLAHOMA,BOARD CHAIRPERSON OKLAHOMA CITY PUBLIC SCHOOLS,STANLEY HUPFELD,,550028,0,0,2,2,
OKLAHOMA,"COUNCILPERSON, WARD 2 CITY OF DEL CITY",JACK McBRAYER,,550029,0,0,23,23,"COUNCILPERSON, WARD 2 CITY OF DEL CITY"
OKLAHOMA,"COUNCILPERSON, WARD 2 CITY OF DEL CITY",PAM FINCH,,550029,0,0,55,55,"COUNCILPERSON, WARD 2 CITY OF DEL CITY"
OKLAHOMA,"COUNCILMEMBER, WARD 7 CITY OF OKLAHOMA CITY","JOHN A. PETTIS, JR.",,550030,0,0,0,0,"COUNCILMEMBER, WARD 7 CITY OF OKLAHOMA CITY"
OKLAHOMA,"COUNCILMEMBER, WARD 7 CITY OF OKLAHOMA CITY",MARINA MANGIARACINA,,550030,0,0,0,0,"COUNCILMEMBER, WARD 7 CITY OF OKLAHOMA CITY"
OKLAHOMA,"COUNCILMEMBER, WARD 7 CITY OF OKLAHOMA CITY",T. SHERI DICKERSON,,550030,0,0,0,0,"COUNCILMEMBER, WARD 7 CITY OF OKLAHOMA CITY"
OKLAHOMA,"COUNCILPERSON, WARD 2 CITY OF DEL CITY",JACK McBRAYER,,550030,0,0,8,8,"COUNCILPERSON, WARD 2 CITY OF DEL CITY"
OKLAHOMA,"COUNCILPERSON, WARD 2 CITY OF DEL CITY",PAM FINCH,,550030,0,0,10,10,"COUNCILPERSON, WARD 2 CITY OF DEL CITY"
OKLAHOMA,"COUNCILPERSON, WARD 4 CITY OF DEL CITY",FLOYD EASON,,550030,0,0,38,38,"COUNCILPERSON, WARD 4 CITY OF DEL CITY"
OKLAHOMA,"COUNCILPERSON, WARD 4 CITY OF DEL CITY",BEVERLY SMITH,,550030,0,0,42,42,"COUNCILPERSON, WARD 4 CITY OF DEL CITY"
OKLAHOMA,BOARD CHAIRPERSON OKLAHOMA CITY PUBLIC SCHOOLS,PAULA LEWIS,,550030,0,0,0,0,
OKLAHOMA,BOARD CHAIRPERSON OKLAHOMA CITY PUBLIC SCHOOLS,WILFREDO SANTOS RIVERA,,550030,0,0,0,0,
OKLAHOMA,BOARD CHAIRPERSON OKLAHOMA CITY PUBLIC SCHOOLS,GREGORY A. WYATT,,550030,0,0,0,0,
OKLAHOMA,BOARD CHAIRPERSON OKLAHOMA CITY PUBLIC SCHOOLS,BIANCA ROSE,,550030,0,0,0,0,
OKLAHOMA,BOARD CHAIRPERSON OKLAHOMA CITY PUBLIC SCHOOLS,STANLEY HUPFELD,,550030,0,0,0,0,
OKLAHOMA,"COUNCILPERSON, WARD 4 CITY OF DEL CITY",FLOYD EASON,,550031,0,0,40,40,"COUNCILPERSON, WARD 4 CITY OF DEL CITY"
OKLAHOMA,"COUNCILPERSON, WARD 4 CITY OF DEL CITY",BEVERLY SMITH,,550031,0,0,31,31,"COUNCILPERSON, WARD 4 CITY OF DEL CITY"
OKLAHOMA,PROPOSITION CRUTCHO PUBLIC SCHOOLS,FOR THE PROPOSITION - YES,,550031,0,0,0,0,
OKLAHOMA,PROPOSITION CRUTCHO PUBLIC SCHOOLS,AGAINST THE PROPOSITION - NO,,550031,0,0,0,0,
OKLAHOMA,BOARD CHAIRPERSON OKLAHOMA CITY PUBLIC SCHOOLS,PAULA LEWIS,,550031,0,0,0,0,
OKLAHOMA,BOARD CHAIRPERSON OKLAHOMA CITY PUBLIC SCHOOLS,WILFREDO SANTOS RIVERA,,550031,0,0,0,0,
OKLAHOMA,BOARD CHAIRPERSON OKLAHOMA CITY PUBLIC SCHOOLS,GREGORY A. WYATT,,550031,0,0,0,0,
OKLAHOMA,BOARD CHAIRPERSON OKLAHOMA CITY PUBLIC SCHOOLS,BIANCA ROSE,,550031,0,0,0,0,
OKLAHOMA,BOARD CHAIRPERSON OKLAHOMA CITY PUBLIC SCHOOLS,STANLEY HUPFELD,,550031,0,0,0,0,
OKLAHOMA,OFFICE NO. 2 DEER CREEK PUBLIC SCHOOLS,TOM CORBIN,,550034,0,0,17,17,OFFICE NO. 2 DEER CREEK PUBLIC SCHOOLS
OKLAHOMA,OFFICE NO. 2 DEER CREEK PUBLIC SCHOOLS,ANDI NEAVES,,550034,0,0,60,60,OFFICE NO. 2 DEER CREEK PUBLIC SCHOOLS
OKLAHOMA,OFFICE NO. 2 FRANCIS TUTTLE TECH CENTER,PETE LEE,,550034,0,0,33,33,OFFICE NO. 2 FRANCIS TUTTLE TECH CENTER
OKLAHOMA,OFFICE NO. 2 FRANCIS TUTTLE TECH CENTER,ROBERT STONE,,550034,0,0,26,26,OFFICE NO. 2 FRANCIS TUTTLE TECH CENTER
OKLAHOMA,OFFICE NO. 2 DEER CREEK PUBLIC SCHOOLS,TOM CORBIN,,550035,0,0,10,10,OFFICE NO. 2 DEER CREEK PUBLIC SCHOOLS
OKLAHOMA,OFFICE NO. 2 DEER CREEK PUBLIC SCHOOLS,ANDI NEAVES,,550035,0,0,37,37,OFFICE NO. 2 DEER CREEK PUBLIC SCHOOLS
OKLAHOMA,OFFICE NO. 2 EDMOND PUBLIC SCHOOLS,KATHLEEN M. DUNCAN,,550035,0,0,47,47,OFFICE NO. 2 EDMOND PUBLIC SCHOOLS
OKLAHOMA,OFFICE NO. 2 EDMOND PUBLIC SCHOOLS,CHAD MULLEN,,550035,0,0,27,27,OFFICE NO. 2 EDMOND PUBLIC SCHOOLS
OKLAHOMA,PROPOSITION NO. 1 EDMOND PUBLIC SCHOOLS,FOR THE PROPOSITION - YES,,550035,0,0,64,64,PROPOSITION NO. 1 EDMOND PUBLIC SCHOOLS
OKLAHOMA,PROPOSITION NO. 1 EDMOND PUBLIC SCHOOLS,AGAINST THE PROPOSITION - NO,,550035,0,0,11,11,PROPOSITION NO. 1 EDMOND PUBLIC SCHOOLS
OKLAHOMA,PROPOSITION NO. 2 EDMOND PUBLIC SCHOOLS,FOR THE PROPOSITION - YES,,550035,0,0,62,62,PROPOSITION NO. 2 EDMOND PUBLIC SCHOOLS
OKLAHOMA,PROPOSITION NO. 2 EDMOND PUBLIC SCHOOLS,AGAINST THE PROPOSITION - NO,,550035,0,0,13,13,PROPOSITION NO. 2 EDMOND PUBLIC SCHOOLS
OKLAHOMA,OFFICE NO. 2 FRANCIS TUTTLE TECH CENTER,PETE LEE,,550035,0,0,48,48,OFFICE NO. 2 FRANCIS TUTTLE TECH CENTER
OKLAHOMA,OFFICE NO. 2 FRANCIS TUTTLE TECH CENTER,ROBERT STONE,,550035,0,0,62,62,OFFICE NO. 2 FRANCIS TUTTLE TECH CENTER
OKLAHOMA,"COUNCILMEMBER, WARD 7 CITY OF OKLAHOMA CITY","JOHN A. PETTIS, JR.",,550036,0,0,20,20,"COUNCILMEMBER, WARD 7 CITY OF OKLAHOMA CITY"
OKLAHOMA,"COUNCILMEMBER, WARD 7 CITY OF OKLAHOMA CITY",MARINA MANGIARACINA,,550036,0,0,5,5,"COUNCILMEMBER, WARD 7 CITY OF OKLAHOMA CITY"
OKLAHOMA,"COUNCILMEMBER, WARD 7 CITY OF OKLAHOMA CITY",T. SHERI DICKERSON,,550036,0,0,9,9,"COUNCILMEMBER, WARD 7 CITY OF OKLAHOMA CITY"
OKLAHOMA,OFFICE NO. 2 DEER CREEK PUBLIC SCHOOLS,TOM CORBIN,,550036,0,0,1,1,OFFICE NO. 2 DEER CREEK PUBLIC SCHOOLS
OKLAHOMA,OFFICE NO. 2 DEER CREEK PUBLIC SCHOOLS,ANDI NEAVES,,550036,0,0,8,8,OFFICE NO. 2 DEER CREEK PUBLIC SCHOOLS
OKLAHOMA,OFFICE NO. 2 EDMOND PUBLIC SCHOOLS,KATHLEEN M. DUNCAN,,550036,0,0,56,56,OFFICE NO. 2 EDMOND PUBLIC SCHOOLS
OKLAHOMA,OFFICE NO. 2 EDMOND PUBLIC SCHOOLS,CHAD MULLEN,,550036,0,0,95,95,OFFICE NO. 2 EDMOND PUBLIC SCHOOLS
OKLAHOMA,PROPOSITION NO. 1 EDMOND PUBLIC SCHOOLS,FOR THE PROPOSITION - YES,,550036,0,0,128,128,PROPOSITION NO. 1 EDMOND PUBLIC SCHOOLS
OKLAHOMA,PROPOSITION NO. 1 EDMOND PUBLIC SCHOOLS,AGAINST THE PROPOSITION - NO,,550036,0,0,26,26,PROPOSITION NO. 1 EDMOND PUBLIC SCHOOLS
OKLAHOMA,PROPOSITION NO. 2 EDMOND PUBLIC SCHOOLS,FOR THE PROPOSITION - YES,,550036,0,0,127,127,PROPOSITION NO. 2 EDMOND PUBLIC SCHOOLS
OKLAHOMA,PROPOSITION NO. 2 EDMOND PUBLIC SCHOOLS,AGAINST THE PROPOSITION - NO,,550036,0,0,27,27,PROPOSITION NO. 2 EDMOND PUBLIC SCHOOLS
OKLAHOMA,OFFICE NO. 2 FRANCIS TUTTLE TECH CENTER,PETE LEE,,550036,0,0,94,94,OFFICE NO. 2 FRANCIS TUTTLE TECH CENTER
OKLAHOMA,OFFICE NO. 2 FRANCIS TUTTLE TECH CENTER,ROBERT STONE,,550036,0,0,61,61,OFFICE NO. 2 FRANCIS TUTTLE TECH CENTER
OKLAHOMA,OFFICE NO. 2 EDMOND PUBLIC SCHOOLS,KATHLEEN M. DUNCAN,,550037,0,0,87,87,OFFICE NO. 2 EDMOND PUBLIC SCHOOLS
OKLAHOMA,OFFICE NO. 2 EDMOND PUBLIC SCHOOLS,CHAD MULLEN,,550037,0,0,43,43,OFFICE NO. 2 EDMOND PUBLIC SCHOOLS
OKLAHOMA,PROPOSITION NO. 1 EDMOND PUBLIC SCHOOLS,FOR THE PROPOSITION - YES,,550037,0,0,122,122,PROPOSITION NO. 1 EDMOND PUBLIC SCHOOLS
OKLAHOMA,PROPOSITION NO. 1 EDMOND PUBLIC SCHOOLS,AGAINST THE PROPOSITION - NO,,550037,0,0,9,9,PROPOSITION NO. 1 EDMOND PUBLIC SCHOOLS
OKLAHOMA,PROPOSITION NO. 2 EDMOND PUBLIC SCHOOLS,FOR THE PROPOSITION - YES,,550037,0,0,121,121,PROPOSITION NO. 2 EDMOND PUBLIC SCHOOLS
OKLAHOMA,PROPOSITION NO. 2 EDMOND PUBLIC SCHOOLS,AGAINST THE PROPOSITION - NO,,550037,0,0,10,10,PROPOSITION NO. 2 EDMOND PUBLIC SCHOOLS
OKLAHOMA,OFFICE NO. 2 FRANCIS TUTTLE TECH CENTER,PETE LEE,,550037,0,0,54,54,OFFICE NO. 2 FRANCIS TUTTLE TECH CENTER
OKLAHOMA,OFFICE NO. 2 FRANCIS TUTTLE TECH CENTER,ROBERT STONE,,550037,0,0,60,60,OFFICE NO. 2 FRANCIS TUTTLE TECH CENTER
OKLAHOMA,OFFICE NO. 2 EDMOND PUBLIC SCHOOLS,KATHLEEN M. DUNCAN,,550038,0,0,70,70,OFFICE NO. 2 EDMOND PUBLIC SCHOOLS
OKLAHOMA,OFFICE NO. 2 EDMOND PUBLIC SCHOOLS,CHAD MULLEN,,550038,0,0,28,28,OFFICE NO. 2 EDMOND PUBLIC SCHOOLS
OKLAHOMA,PROPOSITION NO. 1 EDMOND PUBLIC SCHOOLS,FOR THE PROPOSITION - YES,,550038,0,0,78,78,PROPOSITION NO. 1 EDMOND PUBLIC SCHOOLS
OKLAHOMA,PROPOSITION NO. 1 EDMOND PUBLIC SCHOOLS,AGAINST THE PROPOSITION - NO,,550038,0,0,21,21,PROPOSITION NO. 1 EDMOND PUBLIC SCHOOLS
OKLAHOMA,PROPOSITION NO. 2 EDMOND PUBLIC SCHOOLS,FOR THE PROPOSITION - YES,,550038,0,0,80,80,PROPOSITION NO. 2 EDMOND PUBLIC SCHOOLS
OKLAHOMA,PROPOSITION NO. 2 EDMOND PUBLIC SCHOOLS,AGAINST THE PROPOSITION - NO,,550038,0,0,18,18,PROPOSITION NO. 2 EDMOND PUBLIC SCHOOLS
OKLAHOMA,OFFICE NO. 2 FRANCIS TUTTLE TECH CENTER,PETE LEE,,550038,0,0,29,29,OFFICE NO. 2 FRANCIS TUTTLE TECH CENTER
OKLAHOMA,OFFICE NO. 2 FRANCIS TUTTLE TECH CENTER,ROBERT STONE,,550038,0,0,58,58,OFFICE NO. 2 FRANCIS TUTTLE TECH CENTER
OKLAHOMA,PROPOSITION NO. 1 EDMOND PUBLIC SCHOOLS,FOR THE PROPOSITION - YES,,550039,0,0,85,85,PROPOSITION NO. 1 EDMOND PUBLIC SCHOOLS
OKLAHOMA,PROPOSITION NO. 1 EDMOND PUBLIC SCHOOLS,AGAINST THE PROPOSITION - NO,,550039,0,0,7,7,PROPOSITION NO. 1 EDMOND PUBLIC SCHOOLS
OKLAHOMA,PROPOSITION NO. 2 EDMOND PUBLIC SCHOOLS,FOR THE PROPOSITION - YES,,550039,0,0,85,85,PROPOSITION NO. 2 EDMOND PUBLIC SCHOOLS
OKLAHOMA,PROPOSITION NO. 2 EDMOND PUBLIC SCHOOLS,AGAINST THE PROPOSITION - NO,,550039,0,0,8,8,PROPOSITION NO. 2 EDMOND PUBLIC SCHOOLS
OKLAHOMA,OFFICE NO. 2 FRANCIS TUTTLE TECH CENTER,PETE LEE,,550039,0,0,36,36,OFFICE NO. 2 FRANCIS TUTTLE TECH CENTER
OKLAHOMA,OFFICE NO. 2 FRANCIS TUTTLE TECH CENTER,ROBERT STONE,,550039,0,0,46,46,OFFICE NO. 2 FRANCIS TUTTLE TECH CENTER
OKLAHOMA,OFFICE NO. 2 EDMOND PUBLIC SCHOOLS,KATHLEEN M. DUNCAN,,550040,0,0,87,87,OFFICE NO. 2 EDMOND PUBLIC SCHOOLS
OKLAHOMA,OFFICE NO. 2 EDMOND PUBLIC SCHOOLS,CHAD MULLEN,,550040,0,0,47,47,OFFICE NO. 2 EDMOND PUBLIC SCHOOLS
OKLAHOMA,PROPOSITION NO. 1 EDMOND PUBLIC SCHOOLS,FOR THE PROPOSITION - YES,,550040,0,0,117,117,PROPOSITION NO. 1 EDMOND PUBLIC SCHOOLS
OKLAHOMA,PROPOSITION NO. 1 EDMOND PUBLIC SCHOOLS,AGAINST THE PROPOSITION - NO,,550040,0,0,18,18,PROPOSITION NO. 1 EDMOND PUBLIC SCHOOLS
OKLAHOMA,PROPOSITION NO. 2 EDMOND PUBLIC SCHOOLS,FOR THE PROPOSITION - YES,,550040,0,0,120,120,PROPOSITION NO. 2 EDMOND PUBLIC SCHOOLS
OKLAHOMA,PROPOSITION NO. 2 EDMOND PUBLIC SCHOOLS,AGAINST THE PROPOSITION - NO,,550040,0,0,16,16,PROPOSITION NO. 2 EDMOND PUBLIC SCHOOLS
OKLAHOMA,OFFICE NO. 2 FRANCIS TUTTLE TECH CENTER,PETE LEE,,550040,0,0,46,46,OFFICE NO. 2 FRANCIS TUTTLE TECH CENTER
OKLAHOMA,OFFICE NO. 2 FRANCIS TUTTLE TECH CENTER,ROBERT STONE,,550040,0,0,76,76,OFFICE NO. 2 FRANCIS TUTTLE TECH CENTER
OKLAHOMA,OFFICE NO. 2 EDMOND PUBLIC SCHOOLS,KATHLEEN M. DUNCAN,,550041,0,0,66,66,OFFICE NO. 2 EDMOND PUBLIC SCHOOLS
OKLAHOMA,OFFICE NO. 2 EDMOND PUBLIC SCHOOLS,CHAD MULLEN,,550041,0,0,35,35,OFFICE NO. 2 EDMOND PUBLIC SCHOOLS
OKLAHOMA,PROPOSITION NO. 1 EDMOND PUBLIC SCHOOLS,FOR THE PROPOSITION - YES,,550041,0,0,87,87,PROPOSITION NO. 1 EDMOND PUBLIC SCHOOLS
OKLAHOMA,PROPOSITION NO. 1 EDMOND PUBLIC SCHOOLS,AGAINST THE PROPOSITION - NO,,550041,0,0,17,17,PROPOSITION NO. 1 EDMOND PUBLIC SCHOOLS
OKLAHOMA,PROPOSITION NO. 2 EDMOND PUBLIC SCHOOLS,FOR THE PROPOSITION - YES,,550041,0,0,88,88,PROPOSITION NO. 2 EDMOND PUBLIC SCHOOLS
OKLAHOMA,PROPOSITION NO. 2 EDMOND PUBLIC SCHOOLS,AGAINST THE PROPOSITION - NO,,550041,0,0,16,16,PROPOSITION NO. 2 EDMOND PUBLIC SCHOOLS
OKLAHOMA,OFFICE NO. 2 FRANCIS TUTTLE TECH CENTER,PETE LEE,,550041,0,0,31,31,OFFICE NO. 2 FRANCIS TUTTLE TECH CENTER
OKLAHOMA,OFFICE NO. 2 FRANCIS TUTTLE TECH CENTER,ROBERT STONE,,550041,0,0,58,58,OFFICE NO. 2 FRANCIS TUTTLE TECH CENTER
OKLAHOMA,OFFICE NO. 2 DEER CREEK PUBLIC SCHOOLS,TOM CORBIN,,550042,0,0,0,0,OFFICE NO. 2 DEER CREEK PUBLIC SCHOOLS
OKLAHOMA,OFFICE NO. 2 DEER CREEK PUBLIC SCHOOLS,ANDI NEAVES,,550042,0,0,4,4,OFFICE NO. 2 DEER CREEK PUBLIC SCHOOLS
OKLAHOMA,PROPOSITION NO. 1 EDMOND PUBLIC SCHOOLS,FOR THE PROPOSITION - YES,,550042,0,0,134,134,PROPOSITION NO. 1 EDMOND PUBLIC SCHOOLS
OKLAHOMA,PROPOSITION NO. 1 EDMOND PUBLIC SCHOOLS,AGAINST THE PROPOSITION - NO,,550042,0,0,27,27,PROPOSITION NO. 1 EDMOND PUBLIC SCHOOLS
OKLAHOMA,PROPOSITION NO. 2 EDMOND PUBLIC SCHOOLS,FOR THE PROPOSITION - YES,,550042,0,0,137,137,PROPOSITION NO. 2 EDMOND PUBLIC SCHOOLS
OKLAHOMA,PROPOSITION NO. 2 EDMOND PUBLIC SCHOOLS,AGAINST THE PROPOSITION - NO,,550042,0,0,24,24,PROPOSITION NO. 2 EDMOND PUBLIC SCHOOLS
OKLAHOMA,OFFICE NO. 2 FRANCIS TUTTLE TECH CENTER,PETE LEE,,550042,0,0,55,55,OFFICE NO. 2 FRANCIS TUTTLE TECH CENTER
OKLAHOMA,OFFICE NO. 2 FRANCIS TUTTLE TECH CENTER,ROBERT STONE,,550042,0,0,97,97,OFFICE NO. 2 FRANCIS TUTTLE TECH CENTER
OKLAHOMA,OFFICE NO. 2 DEER CREEK PUBLIC SCHOOLS,TOM CORBIN,,550043,0,0,2,2,OFFICE NO. 2 DEER CREEK PUBLIC SCHOOLS
OKLAHOMA,OFFICE NO. 2 DEER CREEK PUBLIC SCHOOLS,ANDI NEAVES,,550043,0,0,1,1,OFFICE NO. 2 DEER CREEK PUBLIC SCHOOLS
OKLAHOMA,PROPOSITION NO. 1 EDMOND PUBLIC SCHOOLS,FOR THE PROPOSITION - YES,,550043,0,0,136,136,PROPOSITION NO. 1 EDMOND PUBLIC SCHOOLS
OKLAHOMA,PROPOSITION NO. 1 EDMOND PUBLIC SCHOOLS,AGAINST THE PROPOSITION - NO,,550043,0,0,21,21,PROPOSITION NO. 1 EDMOND PUBLIC SCHOOLS
OKLAHOMA,PROPOSITION NO. 2 EDMOND PUBLIC SCHOOLS,FOR THE PROPOSITION - YES,,550043,0,0,124,124,PROPOSITION NO. 2 EDMOND PUBLIC SCHOOLS
OKLAHOMA,PROPOSITION NO. 2 EDMOND PUBLIC SCHOOLS,AGAINST THE PROPOSITION - NO,,550043,0,0,31,31,PROPOSITION NO. 2 EDMOND PUBLIC SCHOOLS
OKLAHOMA,OFFICE NO. 2 FRANCIS TUTTLE TECH CENTER,PETE LEE,,550043,0,0,54,54,OFFICE NO. 2 FRANCIS TUTTLE TECH CENTER
OKLAHOMA,OFFICE NO. 2 FRANCIS TUTTLE TECH CENTER,ROBERT STONE,,550043,0,0,73,73,OFFICE NO. 2 FRANCIS TUTTLE TECH CENTER
OKLAHOMA,PROPOSITION NO. 1 EDMOND PUBLIC SCHOOLS,FOR THE PROPOSITION - YES,,550044,0,0,182,182,PROPOSITION NO. 1 EDMOND PUBLIC SCHOOLS
OKLAHOMA,PROPOSITION NO. 1 EDMOND PUBLIC SCHOOLS,AGAINST THE PROPOSITION - NO,,550044,0,0,12,12,PROPOSITION NO. 1 EDMOND PUBLIC SCHOOLS
OKLAHOMA,PROPOSITION NO. 2 EDMOND PUBLIC SCHOOLS,FOR THE PROPOSITION - YES,,550044,0,0,178,178,PROPOSITION NO. 2 EDMOND PUBLIC SCHOOLS
OKLAHOMA,PROPOSITION NO. 2 EDMOND PUBLIC SCHOOLS,AGAINST THE PROPOSITION - NO,,550044,0,0,17,17,PROPOSITION NO. 2 EDMOND PUBLIC SCHOOLS
OKLAHOMA,OFFICE NO. 2 FRANCIS TUTTLE TECH CENTER,PETE LEE,,550044,0,0,72,72,OFFICE NO. 2 FRANCIS TUTTLE TECH CENTER
OKLAHOMA,OFFICE NO. 2 FRANCIS TUTTLE TECH CENTER,ROBERT STONE,,550044,0,0,102,102,OFFICE NO. 2 FRANCIS TUTTLE TECH CENTER
OKLAHOMA,PROPOSITION NO. 1 EDMOND PUBLIC SCHOOLS,FOR THE PROPOSITION - YES,,550045,0,0,156,156,PROPOSITION NO. 1 EDMOND PUBLIC SCHOOLS
OKLAHOMA,PROPOSITION NO. 1 EDMOND PUBLIC SCHOOLS,AGAINST THE PROPOSITION - NO,,550045,0,0,18,18,PROPOSITION NO. 1 EDMOND PUBLIC SCHOOLS
OKLAHOMA,PROPOSITION NO. 2 EDMOND PUBLIC SCHOOLS,FOR THE PROPOSITION - YES,,550045,0,0,154,154,PROPOSITION NO. 2 EDMOND PUBLIC SCHOOLS
OKLAHOMA,PROPOSITION NO. 2 EDMOND PUBLIC SCHOOLS,AGAINST THE PROPOSITION - NO,,550045,0,0,18,18,PROPOSITION NO. 2 EDMOND PUBLIC SCHOOLS
OKLAHOMA,OFFICE NO. 2 FRANCIS TUTTLE TECH CENTER,PETE LEE,,550045,0,0,62,62,OFFICE NO. 2 FRANCIS TUTTLE TECH CENTER
OKLAHOMA,OFFICE NO. 2 FRANCIS TUTTLE TECH CENTER,ROBERT STONE,,550045,0,0,84,84,OFFICE NO. 2 FRANCIS TUTTLE TECH CENTER
OKLAHOMA,PROPOSITION NO. 1 EDMOND PUBLIC SCHOOLS,FOR THE PROPOSITION - YES,,550046,0,0,52,52,PROPOSITION NO. 1 EDMOND PUBLIC SCHOOLS
OKLAHOMA,PROPOSITION NO. 1 EDMOND PUBLIC SCHOOLS,AGAINST THE PROPOSITION - NO,,550046,0,0,12,12,PROPOSITION NO. 1 EDMOND PUBLIC SCHOOLS
OKLAHOMA,PROPOSITION NO. 2 EDMOND PUBLIC SCHOOLS,FOR THE PROPOSITION - YES,,550046,0,0,54,54,PROPOSITION NO. 2 EDMOND PUBLIC SCHOOLS
OKLAHOMA,PROPOSITION NO. 2 EDMOND PUBLIC SCHOOLS,AGAINST THE PROPOSITION - NO,,550046,0,0,11,11,PROPOSITION NO. 2 EDMOND PUBLIC SCHOOLS
OKLAHOMA,OFFICE NO. 2 FRANCIS TUTTLE TECH CENTER,PETE LEE,,550046,0,0,24,24,OFFICE NO. 2 FRANCIS TUTTLE TECH CENTER
OKLAHOMA,OFFICE NO. 2 FRANCIS TUTTLE TECH CENTER,ROBERT STONE,,550046,0,0,34,34,OFFICE NO. 2 FRANCIS TUTTLE TECH CENTER
OKLAHOMA,PROPOSITION NO. 1 EDMOND PUBLIC SCHOOLS,FOR THE PROPOSITION - YES,,550047,0,0,32,32,PROPOSITION NO. 1 EDMOND PUBLIC SCHOOLS
OKLAHOMA,PROPOSITION NO. 1 EDMOND PUBLIC SCHOOLS,AGAINST THE PROPOSITION - NO,,550047,0,0,10,10,PROPOSITION NO. 1 EDMOND PUBLIC SCHOOLS
OKLAHOMA,PROPOSITION NO. 2 EDMOND PUBLIC SCHOOLS,FOR THE PROPOSITION - YES,,550047,0,0,32,32,PROPOSITION NO. 2 EDMOND PUBLIC SCHOOLS
OKLAHOMA,PROPOSITION NO. 2 EDMOND PUBLIC SCHOOLS,AGAINST THE PROPOSITION - NO,,550047,0,0,11,11,PROPOSITION NO. 2 EDMOND PUBLIC SCHOOLS
OKLAHOMA,OFFICE NO. 2 FRANCIS TUTTLE TECH CENTER,PETE LEE,,550047,0,0,8,8,OFFICE NO. 2 FRANCIS TUTTLE TECH CENTER
OKLAHOMA,OFFICE NO. 2 FRANCIS TUTTLE TECH CENTER,ROBERT STONE,,550047,0,0,27,27,OFFICE NO. 2 FRANCIS TUTTLE TECH CENTER
OKLAHOMA,PROPOSITION NO. 1 EDMOND PUBLIC SCHOOLS,FOR THE PROPOSITION - YES,,550048,0,0,43,43,PROPOSITION NO. 1 EDMOND PUBLIC SCHOOLS
OKLAHOMA,PROPOSITION NO. 1 EDMOND PUBLIC SCHOOLS,AGAINST THE PROPOSITION - NO,,550048,0,0,10,10,PROPOSITION NO. 1 EDMOND PUBLIC SCHOOLS
OKLAHOMA,PROPOSITION NO. 2 EDMOND PUBLIC SCHOOLS,FOR THE PROPOSITION - YES,,550048,0,0,44,44,PROPOSITION NO. 2 EDMOND PUBLIC SCHOOLS
OKLAHOMA,PROPOSITION NO. 2 EDMOND PUBLIC SCHOOLS,AGAINST THE PROPOSITION - NO,,550048,0,0,10,10,PROPOSITION NO. 2 EDMOND PUBLIC SCHOOLS
OKLAHOMA,OFFICE NO. 2 FRANCIS TUTTLE TECH CENTER,PETE LEE,,550048,0,0,15,15,OFFICE NO. 2 FRANCIS TUTTLE TECH CENTER
OKLAHOMA,OFFICE NO. 2 FRANCIS TUTTLE TECH CENTER,ROBERT STONE,,550048,0,0,35,35,OFFICE NO. 2 FRANCIS TUTTLE TECH CENTER
OKLAHOMA,PROPOSITION NO. 1 EDMOND PUBLIC SCHOOLS,FOR THE PROPOSITION - YES,,550049,0,0,33,33,PROPOSITION NO. 1 EDMOND PUBLIC SCHOOLS
OKLAHOMA,PROPOSITION NO. 1 EDMOND PUBLIC SCHOOLS,AGAINST THE PROPOSITION - NO,,550049,0,0,5,5,PROPOSITION NO. 1 EDMOND PUBLIC SCHOOLS
OKLAHOMA,PROPOSITION NO. 2 EDMOND PUBLIC SCHOOLS,FOR THE PROPOSITION - YES,,550049,0,0,32,32,PROPOSITION NO. 2 EDMOND PUBLIC SCHOOLS
OKLAHOMA,PROPOSITION NO. 2 EDMOND PUBLIC SCHOOLS,AGAINST THE PROPOSITION - NO,,550049,0,0,6,6,PROPOSITION NO. 2 EDMOND PUBLIC SCHOOLS
OKLAHOMA,OFFICE NO. 2 FRANCIS TUTTLE TECH CENTER,PETE LEE,,550049,0,0,14,14,OFFICE NO. 2 FRANCIS TUTTLE TECH CENTER
OKLAHOMA,OFFICE NO. 2 FRANCIS TUTTLE TECH CENTER,ROBERT STONE,,550049,0,0,20,20,OFFICE NO. 2 FRANCIS TUTTLE TECH CENTER
OKLAHOMA,"COUNCILMEMBER, WARD 7 CITY OF OKLAHOMA CITY","JOHN A. PETTIS, JR.",,550050,0,0,0,0,"COUNCILMEMBER, WARD 7 CITY OF OKLAHOMA CITY"
OKLAHOMA,"COUNCILMEMBER, WARD 7 CITY OF OKLAHOMA CITY",MARINA MANGIARACINA,,550050,0,0,0,0,"COUNCILMEMBER, WARD 7 CITY OF OKLAHOMA CITY"
OKLAHOMA,"COUNCILMEMBER, WARD 7 CITY OF OKLAHOMA CITY",T. SHERI DICKERSON,,550050,0,0,0,0,"COUNCILMEMBER, WARD 7 CITY OF OKLAHOMA CITY"
OKLAHOMA,PROPOSITION NO. 1 EDMOND PUBLIC SCHOOLS,FOR THE PROPOSITION - YES,,550050,0,0,1,1,PROPOSITION NO. 1 EDMOND PUBLIC SCHOOLS
OKLAHOMA,PROPOSITION NO. 1 EDMOND PUBLIC SCHOOLS,AGAINST THE PROPOSITION - NO,,550050,0,0,0,0,PROPOSITION NO. 1 EDMOND PUBLIC SCHOOLS
OKLAHOMA,PROPOSITION NO. 2 EDMOND PUBLIC SCHOOLS,FOR THE PROPOSITION - YES,,550050,0,0,1,1,PROPOSITION NO. 2 EDMOND PUBLIC SCHOOLS
OKLAHOMA,PROPOSITION NO. 2 EDMOND PUBLIC SCHOOLS,AGAINST THE PROPOSITION - NO,,550050,0,0,0,0,PROPOSITION NO. 2 EDMOND PUBLIC SCHOOLS
OKLAHOMA,OFFICE NO. 2 FRANCIS TUTTLE TECH CENTER,PETE LEE,,550050,0,0,0,0,OFFICE NO. 2 FRANCIS TUTTLE TECH CENTER
OKLAHOMA,OFFICE NO. 2 FRANCIS TUTTLE TECH CENTER,ROBERT STONE,,550050,0,0,0,0,OFFICE NO. 2 FRANCIS TUTTLE TECH CENTER
OKLAHOMA,"COUNCILMEMBER, WARD 7 CITY OF OKLAHOMA CITY","JOHN A. PETTIS, JR.",,550051,0,0,7,7,"COUNCILMEMBER, WARD 7 CITY OF OKLAHOMA CITY"
OKLAHOMA,"COUNCILMEMBER, WARD 7 CITY OF OKLAHOMA CITY",MARINA MANGIARACINA,,550051,0,0,3,3,"COUNCILMEMBER, WARD 7 CITY OF OKLAHOMA CITY"
OKLAHOMA,"COUNCILMEMBER, WARD 7 CITY OF OKLAHOMA CITY",T. SHERI DICKERSON,,550051,0,0,4,4,"COUNCILMEMBER, WARD 7 CITY OF OKLAHOMA CITY"
OKLAHOMA,PROPOSITION NO. 1 EDMOND PUBLIC SCHOOLS,FOR THE PROPOSITION - YES,,550051,0,0,39,39,PROPOSITION NO. 1 EDMOND PUBLIC SCHOOLS
OKLAHOMA,PROPOSITION NO. 1 EDMOND PUBLIC SCHOOLS,AGAINST THE PROPOSITION - NO,,550051,0,0,6,6,PROPOSITION NO. 1 EDMOND PUBLIC SCHOOLS
OKLAHOMA,PROPOSITION NO. 2 EDMOND PUBLIC SCHOOLS,FOR THE PROPOSITION - YES,,550051,0,0,38,38,PROPOSITION NO. 2 EDMOND PUBLIC SCHOOLS
OKLAHOMA,PROPOSITION NO. 2 EDMOND PUBLIC SCHOOLS,AGAINST THE PROPOSITION - NO,,550051,0,0,7,7,PROPOSITION NO. 2 EDMOND PUBLIC SCHOOLS
OKLAHOMA,OFFICE NO. 2 FRANCIS TUTTLE TECH CENTER,PETE LEE,,550051,0,0,18,18,OFFICE NO. 2 FRANCIS TUTTLE TECH CENTER
OKLAHOMA,OFFICE NO. 2 FRANCIS TUTTLE TECH CENTER,ROBERT STONE,,550051,0,0,19,19,OFFICE NO. 2 FRANCIS TUTTLE TECH CENTER
OKLAHOMA,"COUNCILMEMBER, WARD 7 CITY OF OKLAHOMA CITY","JOHN A. PETTIS, JR.",,550052,0,0,13,13,"COUNCILMEMBER, WARD 7 CITY OF OKLAHOMA CITY"
OKLAHOMA,"COUNCILMEMBER, WARD 7 CITY OF OKLAHOMA CITY",MARINA MANGIARACINA,,550052,0,0,2,2,"COUNCILMEMBER, WARD 7 CITY OF OKLAHOMA CITY"
OKLAHOMA,"COUNCILMEMBER, WARD 7 CITY OF OKLAHOMA CITY",T. SHERI DICKERSON,,550052,0,0,4,4,"COUNCILMEMBER, WARD 7 CITY OF OKLAHOMA CITY"
OKLAHOMA,PROPOSITION NO. 1 EDMOND PUBLIC SCHOOLS,FOR THE PROPOSITION - YES,,550052,0,0,83,83,PROPOSITION NO. 1 EDMOND PUBLIC SCHOOLS
OKLAHOMA,PROPOSITION NO. 1 EDMOND PUBLIC SCHOOLS,AGAINST THE PROPOSITION - NO,,550052,0,0,17,17,PROPOSITION NO. 1 EDMOND PUBLIC SCHOOLS
OKLAHOMA,PROPOSITION NO. 2 EDMOND PUBLIC SCHOOLS,FOR THE PROPOSITION - YES,,550052,0,0,81,81,PROPOSITION NO. 2 EDMOND PUBLIC SCHOOLS
OKLAHOMA,PROPOSITION NO. 2 EDMOND PUBLIC SCHOOLS,AGAINST THE PROPOSITION - NO,,550052,0,0,18,18,PROPOSITION NO. 2 EDMOND PUBLIC SCHOOLS
OKLAHOMA,OFFICE NO. 2 FRANCIS TUTTLE TECH CENTER,PETE LEE,,550052,0,0,33,33,OFFICE NO. 2 FRANCIS TUTTLE TECH CENTER
OKLAHOMA,OFFICE NO. 2 FRANCIS TUTTLE TECH CENTER,ROBERT STONE,,550052,0,0,50,50,OFFICE NO. 2 FRANCIS TUTTLE TECH CENTER
OKLAHOMA,PROPOSITION NO. 1 EDMOND PUBLIC SCHOOLS,FOR THE PROPOSITION - YES,,550053,0,0,71,71,PROPOSITION NO. 1 EDMOND PUBLIC SCHOOLS
OKLAHOMA,PROPOSITION NO. 1 EDMOND PUBLIC SCHOOLS,AGAINST THE PROPOSITION - NO,,550053,0,0,9,9,PROPOSITION NO. 1 EDMOND PUBLIC SCHOOLS
OKLAHOMA,PROPOSITION NO. 2 EDMOND PUBLIC SCHOOLS,FOR THE PROPOSITION - YES,,550053,0,0,72,72,PROPOSITION NO. 2 EDMOND PUBLIC SCHOOLS
OKLAHOMA,PROPOSITION NO. 2 EDMOND PUBLIC SCHOOLS,AGAINST THE PROPOSITION - NO,,550053,0,0,8,8,PROPOSITION NO. 2 EDMOND PUBLIC SCHOOLS
OKLAHOMA,OFFICE NO. 2 FRANCIS TUTTLE TECH CENTER,PETE LEE,,550053,0,0,17,17,OFFICE NO. 2 FRANCIS TUTTLE TECH CENTER
OKLAHOMA,OFFICE NO. 2 FRANCIS TUTTLE TECH CENTER,ROBERT STONE,,550053,0,0,51,51,OFFICE NO. 2 FRANCIS TUTTLE TECH CENTER
OKLAHOMA,PROPOSITION NO. 1 EDMOND PUBLIC SCHOOLS,FOR THE PROPOSITION - YES,,550054,0,0,88,88,PROPOSITION NO. 1 EDMOND PUBLIC SCHOOLS
OKLAHOMA,PROPOSITION NO. 1 EDMOND PUBLIC SCHOOLS,AGAINST THE PROPOSITION - NO,,550054,0,0,21,21,PROPOSITION NO. 1 EDMOND PUBLIC SCHOOLS
OKLAHOMA,PROPOSITION NO. 2 EDMOND PUBLIC SCHOOLS,FOR THE PROPOSITION - YES,,550054,0,0,87,87,PROPOSITION NO. 2 EDMOND PUBLIC SCHOOLS
OKLAHOMA,PROPOSITION NO. 2 EDMOND PUBLIC SCHOOLS,AGAINST THE PROPOSITION - NO,,550054,0,0,23,23,PROPOSITION NO. 2 EDMOND PUBLIC SCHOOLS
OKLAHOMA,OFFICE NO. 2 FRANCIS TUTTLE TECH CENTER,PETE LEE,,550054,0,0,30,30,OFFICE NO. 2 FRANCIS TUTTLE TECH CENTER
OKLAHOMA,OFFICE NO. 2 FRANCIS TUTTLE TECH CENTER,ROBERT STONE,,550054,0,0,64,64,OFFICE NO. 2 FRANCIS TUTTLE TECH CENTER
OKLAHOMA,PROPOSITION NO. 1 EDMOND PUBLIC SCHOOLS,FOR THE PROPOSITION - YES,,550055,0,0,75,75,PROPOSITION NO. 1 EDMOND PUBLIC SCHOOLS
OKLAHOMA,PROPOSITION NO. 1 EDMOND PUBLIC SCHOOLS,AGAINST THE PROPOSITION - NO,,550055,0,0,22,22,PROPOSITION NO. 1 EDMOND PUBLIC SCHOOLS
OKLAHOMA,PROPOSITION NO. 2 EDMOND PUBLIC SCHOOLS,FOR THE PROPOSITION - YES,,550055,0,0,79,79,PROPOSITION NO. 2 EDMOND PUBLIC SCHOOLS
OKLAHOMA,PROPOSITION NO. 2 EDMOND PUBLIC SCHOOLS,AGAINST THE PROPOSITION - NO,,550055,0,0,19,19,PROPOSITION NO. 2 EDMOND PUBLIC SCHOOLS
OKLAHOMA,OFFICE NO. 2 FRANCIS TUTTLE TECH CENTER,PETE LEE,,550055,0,0,28,28,OFFICE NO. 2 FRANCIS TUTTLE TECH CENTER
OKLAHOMA,OFFICE NO. 2 FRANCIS TUTTLE TECH CENTER,ROBERT STONE,,550055,0,0,60,60,OFFICE NO. 2 FRANCIS TUTTLE TECH CENTER
OKLAHOMA,PROPOSITION NO. 1 EDMOND PUBLIC SCHOOLS,FOR THE PROPOSITION - YES,,550056,0,0,69,69,PROPOSITION NO. 1 EDMOND PUBLIC SCHOOLS
OKLAHOMA,PROPOSITION NO. 1 EDMOND PUBLIC SCHOOLS,AGAINST THE PROPOSITION - NO,,550056,0,0,8,8,PROPOSITION NO. 1 EDMOND PUBLIC SCHOOLS
OKLAHOMA,PROPOSITION NO. 2 EDMOND PUBLIC SCHOOLS,FOR THE PROPOSITION - YES,,550056,0,0,65,65,PROPOSITION NO. 2 EDMOND PUBLIC SCHOOLS
OKLAHOMA,PROPOSITION NO. 2 EDMOND PUBLIC SCHOOLS,AGAINST THE PROPOSITION - NO,,550056,0,0,12,12,PROPOSITION NO. 2 EDMOND PUBLIC SCHOOLS
OKLAHOMA,OFFICE NO. 2 FRANCIS TUTTLE TECH CENTER,PETE LEE,,550056,0,0,35,35,OFFICE NO. 2 FRANCIS TUTTLE TECH CENTER
OKLAHOMA,OFFICE NO. 2 FRANCIS TUTTLE TECH CENTER,ROBERT STONE,,550056,0,0,33,33,OFFICE NO. 2 FRANCIS TUTTLE TECH CENTER
OKLAHOMA,PROPOSITION NO. 1 EDMOND PUBLIC SCHOOLS,FOR THE PROPOSITION - YES,,550057,0,0,58,58,PROPOSITION NO. 1 EDMOND PUBLIC SCHOOLS
OKLAHOMA,PROPOSITION NO. 1 EDMOND PUBLIC SCHOOLS,AGAINST THE PROPOSITION - NO,,550057,0,0,16,16,PROPOSITION NO. 1 EDMOND PUBLIC SCHOOLS
OKLAHOMA,PROPOSITION NO. 2 EDMOND PUBLIC SCHOOLS,FOR THE PROPOSITION - YES,,550057,0,0,56,56,PROPOSITION NO. 2 EDMOND PUBLIC SCHOOLS
OKLAHOMA,PROPOSITION NO. 2 EDMOND PUBLIC SCHOOLS,AGAINST THE PROPOSITION - NO,,550057,0,0,17,17,PROPOSITION NO. 2 EDMOND PUBLIC SCHOOLS
OKLAHOMA,OFFICE NO. 2 FRANCIS TUTTLE TECH CENTER,PETE LEE,,550057,0,0,25,25,OFFICE NO. 2 FRANCIS TUTTLE TECH CENTER
OKLAHOMA,OFFICE NO. 2 FRANCIS TUTTLE TECH CENTER,ROBERT STONE,,550057,0,0,38,38,OFFICE NO. 2 FRANCIS TUTTLE TECH CENTER
OKLAHOMA,PROPOSITION NO. 1 EDMOND PUBLIC SCHOOLS,FOR THE PROPOSITION - YES,,550058,0,0,220,220,PROPOSITION NO. 1 EDMOND PUBLIC SCHOOLS
OKLAHOMA,PROPOSITION NO. 1 EDMOND PUBLIC SCHOOLS,AGAINST THE PROPOSITION - NO,,550058,0,0,16,16,PROPOSITION NO. 1 EDMOND PUBLIC SCHOOLS
OKLAHOMA,PROPOSITION NO. 2 EDMOND PUBLIC SCHOOLS,FOR THE PROPOSITION - YES,,550058,0,0,214,214,PROPOSITION NO. 2 EDMOND PUBLIC SCHOOLS
OKLAHOMA,PROPOSITION NO. 2 EDMOND PUBLIC SCHOOLS,AGAINST THE PROPOSITION - NO,,550058,0,0,22,22,PROPOSITION NO. 2 EDMOND PUBLIC SCHOOLS
OKLAHOMA,OFFICE NO. 2 FRANCIS TUTTLE TECH CENTER,PETE LEE,,550058,0,0,79,79,OFFICE NO. 2 FRANCIS TUTTLE TECH CENTER
OKLAHOMA,OFFICE NO. 2 FRANCIS TUTTLE TECH CENTER,ROBERT STONE,,550058,0,0,112,112,OFFICE NO. 2 FRANCIS TUTTLE TECH CENTER
OKLAHOMA,PROPOSITION NO. 1 EDMOND PUBLIC SCHOOLS,FOR THE PROPOSITION - YES,,550059,0,0,94,94,PROPOSITION NO. 1 EDMOND PUBLIC SCHOOLS
OKLAHOMA,PROPOSITION NO. 1 EDMOND PUBLIC SCHOOLS,AGAINST THE PROPOSITION - NO,,550059,0,0,26,26,PROPOSITION NO. 1 EDMOND PUBLIC SCHOOLS
OKLAHOMA,PROPOSITION NO. 2 EDMOND PUBLIC SCHOOLS,FOR THE PROPOSITION - YES,,550059,0,0,94,94,PROPOSITION NO. 2 EDMOND PUBLIC SCHOOLS
OKLAHOMA,PROPOSITION NO. 2 EDMOND PUBLIC SCHOOLS,AGAINST THE PROPOSITION - NO,,550059,0,0,25,25,PROPOSITION NO. 2 EDMOND PUBLIC SCHOOLS
OKLAHOMA,OFFICE NO. 2 FRANCIS TUTTLE TECH CENTER,PETE LEE,,550059,0,0,37,37,OFFICE NO. 2 FRANCIS TUTTLE TECH CENTER
OKLAHOMA,OFFICE NO. 2 FRANCIS TUTTLE TECH CENTER,ROBERT STONE,,550059,0,0,55,55,OFFICE NO. 2 FRANCIS TUTTLE TECH CENTER
OKLAHOMA,PROPOSITION NO. 1 EDMOND PUBLIC SCHOOLS,FOR THE PROPOSITION - YES,,550060,0,0,137,137,PROPOSITION NO. 1 EDMOND PUBLIC SCHOOLS
OKLAHOMA,PROPOSITION NO. 1 EDMOND PUBLIC SCHOOLS,AGAINST THE PROPOSITION - NO,,550060,0,0,15,15,PROPOSITION NO. 1 EDMOND PUBLIC SCHOOLS
OKLAHOMA,PROPOSITION NO. 2 EDMOND PUBLIC SCHOOLS,FOR THE PROPOSITION - YES,,550060,0,0,136,136,PROPOSITION NO. 2 EDMOND PUBLIC SCHOOLS
OKLAHOMA,PROPOSITION NO. 2 EDMOND PUBLIC SCHOOLS,AGAINST THE PROPOSITION - NO,,550060,0,0,15,15,PROPOSITION NO. 2 EDMOND PUBLIC SCHOOLS
OKLAHOMA,OFFICE NO. 2 FRANCIS TUTTLE TECH CENTER,PETE LEE,,550060,0,0,42,42,OFFICE NO. 2 FRANCIS TUTTLE TECH CENTER
OKLAHOMA,OFFICE NO. 2 FRANCIS TUTTLE TECH CENTER,ROBERT STONE,,550060,0,0,70,70,OFFICE NO. 2 FRANCIS TUTTLE TECH CENTER
OKLAHOMA,PROPOSITION NO. 1 EDMOND PUBLIC SCHOOLS,FOR THE PROPOSITION - YES,,550061,0,0,171,171,PROPOSITION NO. 1 EDMOND PUBLIC SCHOOLS
OKLAHOMA,PROPOSITION NO. 1 EDMOND PUBLIC SCHOOLS,AGAINST THE PROPOSITION - NO,,550061,0,0,22,22,PROPOSITION NO. 1 EDMOND PUBLIC SCHOOLS
OKLAHOMA,PROPOSITION NO. 2 EDMOND PUBLIC SCHOOLS,FOR THE PROPOSITION - YES,,550061,0,0,167,167,PROPOSITION NO. 2 EDMOND PUBLIC SCHOOLS
OKLAHOMA,PROPOSITION NO. 2 EDMOND PUBLIC SCHOOLS,AGAINST THE PROPOSITION - NO,,550061,0,0,23,23,PROPOSITION NO. 2 EDMOND PUBLIC SCHOOLS
OKLAHOMA,OFFICE NO. 2 FRANCIS TUTTLE TECH CENTER,PETE LEE,,550061,0,0,63,63,OFFICE NO. 2 FRANCIS TUTTLE TECH CENTER
OKLAHOMA,OFFICE NO. 2 FRANCIS TUTTLE TECH CENTER,ROBERT STONE,,550061,0,0,97,97,OFFICE NO. 2 FRANCIS TUTTLE TECH CENTER
OKLAHOMA,"COUNCILMEMBER, WARD 7 CITY OF OKLAHOMA CITY","JOHN A. PETTIS, JR.",,550062,0,0,63,63,"COUNCILMEMBER, WARD 7 CITY OF OKLAHOMA CITY"
OKLAHOMA,"COUNCILMEMBER, WARD 7 CITY OF OKLAHOMA CITY",MARINA MANGIARACINA,,550062,0,0,11,11,"COUNCILMEMBER, WARD 7 CITY OF OKLAHOMA CITY"
OKLAHOMA,"COUNCILMEMBER, WARD 7 CITY OF OKLAHOMA CITY",T. SHERI DICKERSON,,550062,0,0,32,32,"COUNCILMEMBER, WARD 7 CITY OF OKLAHOMA CITY"
OKLAHOMA,PROPOSITION NO. 1 EDMOND PUBLIC SCHOOLS,FOR THE PROPOSITION - YES,,550062,0,0,184,184,PROPOSITION NO. 1 EDMOND PUBLIC SCHOOLS
OKLAHOMA,PROPOSITION NO. 1 EDMOND PUBLIC SCHOOLS,AGAINST THE PROPOSITION - NO,,550062,0,0,37,37,PROPOSITION NO. 1 EDMOND PUBLIC SCHOOLS
OKLAHOMA,PROPOSITION NO. 2 EDMOND PUBLIC SCHOOLS,FOR THE PROPOSITION - YES,,550062,0,0,190,190,PROPOSITION NO. 2 EDMOND PUBLIC SCHOOLS
OKLAHOMA,PROPOSITION NO. 2 EDMOND PUBLIC SCHOOLS,AGAINST THE PROPOSITION - NO,,550062,0,0,34,34,PROPOSITION NO. 2 EDMOND PUBLIC SCHOOLS
OKLAHOMA,OFFICE NO. 2 FRANCIS TUTTLE TECH CENTER,PETE LEE,,550062,0,0,66,66,OFFICE NO. 2 FRANCIS TUTTLE TECH CENTER
OKLAHOMA,OFFICE NO. 2 FRANCIS TUTTLE TECH CENTER,ROBERT STONE,,550062,0,0,117,117,OFFICE NO. 2 FRANCIS TUTTLE TECH CENTER
OKLAHOMA,"COUNCILMEMBER, WARD 7 CITY OF OKLAHOMA CITY","JOHN A. PETTIS, JR.",,550063,0,0,17,17,"COUNCILMEMBER, WARD 7 CITY OF OKLAHOMA CITY"
OKLAHOMA,"COUNCILMEMBER, WARD 7 CITY OF OKLAHOMA CITY",MARINA MANGIARACINA,,550063,0,0,1,1,"COUNCILMEMBER, WARD 7 CITY OF OKLAHOMA CITY"
OKLAHOMA,"COUNCILMEMBER, WARD 7 CITY OF OKLAHOMA CITY",T. SHERI DICKERSON,,550063,0,0,9,9,"COUNCILMEMBER, WARD 7 CITY OF OKLAHOMA CITY"
OKLAHOMA,PROPOSITION NO. 1 EDMOND PUBLIC SCHOOLS,FOR THE PROPOSITION - YES,,550063,0,0,40,40,PROPOSITION NO. 1 EDMOND PUBLIC SCHOOLS
OKLAHOMA,PROPOSITION NO. 1 EDMOND PUBLIC SCHOOLS,AGAINST THE PROPOSITION - NO,,550063,0,0,12,12,PROPOSITION NO. 1 EDMOND PUBLIC SCHOOLS
OKLAHOMA,PROPOSITION NO. 2 EDMOND PUBLIC SCHOOLS,FOR THE PROPOSITION - YES,,550063,0,0,41,41,PROPOSITION NO. 2 EDMOND PUBLIC SCHOOLS
OKLAHOMA,PROPOSITION NO. 2 EDMOND PUBLIC SCHOOLS,AGAINST THE PROPOSITION - NO,,550063,0,0,12,12,PROPOSITION NO. 2 EDMOND PUBLIC SCHOOLS
OKLAHOMA,OFFICE NO. 2 FRANCIS TUTTLE TECH CENTER,PETE LEE,,550063,0,0,14,14,OFFICE NO. 2 FRANCIS TUTTLE TECH CENTER
OKLAHOMA,OFFICE NO. 2 FRANCIS TUTTLE TECH CENTER,ROBERT STONE,,550063,0,0,32,32,OFFICE NO. 2 FRANCIS TUTTLE TECH CENTER
OKLAHOMA,PROPOSITION NO. 1 EDMOND PUBLIC SCHOOLS,FOR THE PROPOSITION - YES,,550064,0,0,96,96,PROPOSITION NO. 1 EDMOND PUBLIC SCHOOLS
OKLAHOMA,PROPOSITION NO. 1 EDMOND PUBLIC SCHOOLS,AGAINST THE PROPOSITION - NO,,550064,0,0,25,25,PROPOSITION NO. 1 EDMOND PUBLIC SCHOOLS
OKLAHOMA,PROPOSITION NO. 2 EDMOND PUBLIC SCHOOLS,FOR THE PROPOSITION - YES,,550064,0,0,97,97,PROPOSITION NO. 2 EDMOND PUBLIC SCHOOLS
OKLAHOMA,PROPOSITION NO. 2 EDMOND PUBLIC SCHOOLS,AGAINST THE PROPOSITION - NO,,550064,0,0,25,25,PROPOSITION NO. 2 EDMOND PUBLIC SCHOOLS
OKLAHOMA,OFFICE NO. 2 FRANCIS TUTTLE TECH CENTER,PETE LEE,,550064,0,0,36,36,OFFICE NO. 2 FRANCIS TUTTLE TECH CENTER
OKLAHOMA,OFFICE NO. 2 FRANCIS TUTTLE TECH CENTER,ROBERT STONE,,550064,0,0,70,70,OFFICE NO. 2 FRANCIS TUTTLE TECH CENTER
OKLAHOMA,"COUNCILMEMBER, WARD 7 CITY OF OKLAHOMA CITY","JOHN A. PETTIS, JR.",,550065,0,0,1,1,"COUNCILMEMBER, WARD 7 CITY OF OKLAHOMA CITY"
OKLAHOMA,"COUNCILMEMBER, WARD 7 CITY OF OKLAHOMA CITY",MARINA MANGIARACINA,,550065,0,0,1,1,"COUNCILMEMBER, WARD 7 CITY OF OKLAHOMA CITY"
OKLAHOMA,"COUNCILMEMBER, WARD 7 CITY OF OKLAHOMA CITY",T. SHERI DICKERSON,,550065,0,0,0,0,"COUNCILMEMBER, WARD 7 CITY OF OKLAHOMA CITY"
OKLAHOMA,PROPOSITION NO. 1 EDMOND PUBLIC SCHOOLS,FOR THE PROPOSITION - YES,,550065,0,0,25,25,PROPOSITION NO. 1 EDMOND PUBLIC SCHOOLS
OKLAHOMA,PROPOSITION NO. 1 EDMOND PUBLIC SCHOOLS,AGAINST THE PROPOSITION - NO,,550065,0,0,7,7,PROPOSITION NO. 1 EDMOND PUBLIC SCHOOLS
OKLAHOMA,PROPOSITION NO. 2 EDMOND PUBLIC SCHOOLS,FOR THE PROPOSITION - YES,,550065,0,0,25,25,PROPOSITION NO. 2 EDMOND PUBLIC SCHOOLS
OKLAHOMA,PROPOSITION NO. 2 EDMOND PUBLIC SCHOOLS,AGAINST THE PROPOSITION - NO,,550065,0,0,8,8,PROPOSITION NO. 2 EDMOND PUBLIC SCHOOLS
OKLAHOMA,OFFICE NO. 2 FRANCIS TUTTLE TECH CENTER,PETE LEE,,550065,0,0,11,11,OFFICE NO. 2 FRANCIS TUTTLE TECH CENTER
OKLAHOMA,OFFICE NO. 2 FRANCIS TUTTLE TECH CENTER,ROBERT STONE,,550065,0,0,16,16,OFFICE NO. 2 FRANCIS TUTTLE TECH CENTER
OKLAHOMA,OFFICE NO. 2 LUTHER PUBLIC SCHOOLS,TONY RUMPL,,550065,0,0,20,20,OFFICE NO. 2 LUTHER PUBLIC SCHOOLS
OKLAHOMA,OFFICE NO. 2 LUTHER PUBLIC SCHOOLS,MATTHEW MOHR,,550065,0,0,14,14,OFFICE NO. 2 LUTHER PUBLIC SCHOOLS
OKLAHOMA,OFFICE NO. 2 LUTHER PUBLIC SCHOOLS,GERALD McCAULEY,,550065,0,0,0,0,OFFICE NO. 2 LUTHER PUBLIC SCHOOLS
OKLAHOMA,"COUNCILMEMBER, WARD 7 CITY OF OKLAHOMA CITY","JOHN A. PETTIS, JR.",,550066,0,0,75,75,"COUNCILMEMBER, WARD 7 CITY OF OKLAHOMA CITY"
OKLAHOMA,"COUNCILMEMBER, WARD 7 CITY OF OKLAHOMA CITY",MARINA MANGIARACINA,,550066,0,0,1,1,"COUNCILMEMBER, WARD 7 CITY OF OKLAHOMA CITY"
OKLAHOMA,"COUNCILMEMBER, WARD 7 CITY OF OKLAHOMA CITY",T. SHERI DICKERSON,,550066,0,0,6,6,"COUNCILMEMBER, WARD 7 CITY OF OKLAHOMA CITY"
OKLAHOMA,PROPOSITION CRUTCHO PUBLIC SCHOOLS,FOR THE PROPOSITION - YES,,550066,0,0,0,0,
OKLAHOMA,PROPOSITION CRUTCHO PUBLIC SCHOOLS,AGAINST THE PROPOSITION - NO,,550066,0,0,0,0,
OKLAHOMA,BOARD CHAIRPERSON OKLAHOMA CITY PUBLIC SCHOOLS,PAULA LEWIS,,550066,0,0,0,0,
OKLAHOMA,BOARD CHAIRPERSON OKLAHOMA CITY PUBLIC SCHOOLS,WILFREDO SANTOS RIVERA,,550066,0,0,0,0,
OKLAHOMA,BOARD CHAIRPERSON OKLAHOMA CITY PUBLIC SCHOOLS,GREGORY A. WYATT,,550066,0,0,0,0,
OKLAHOMA,BOARD CHAIRPERSON OKLAHOMA CITY PUBLIC SCHOOLS,BIANCA ROSE,,550066,0,0,0,0,
OKLAHOMA,BOARD CHAIRPERSON OKLAHOMA CITY PUBLIC SCHOOLS,STANLEY HUPFELD,,550066,0,0,0,0,
OKLAHOMA,"COUNCILMEMBER, WARD 4 CITY OF OKLAHOMA CITY",RICHARD D. MORRISSETTE,,550067,0,0,26,26,"COUNCILMEMBER, WARD 4 CITY OF OKLAHOMA CITY"
OKLAHOMA,"COUNCILMEMBER, WARD 4 CITY OF OKLAHOMA CITY",TODD STONE,,550067,0,0,16,16,"COUNCILMEMBER, WARD 4 CITY OF OKLAHOMA CITY"
OKLAHOMA,"COUNCILMEMBER, WARD 4 CITY OF OKLAHOMA CITY",WALTER KULA,,550067,0,0,10,10,"COUNCILMEMBER, WARD 4 CITY OF OKLAHOMA CITY"
OKLAHOMA,"COUNCILMEMBER, WARD 4 CITY OF OKLAHOMA CITY",DORIS MANGIARACINA BENBROOK,,550067,0,0,3,3,"COUNCILMEMBER, WARD 4 CITY OF OKLAHOMA CITY"
OKLAHOMA,OFFICE NO. 2 MCLOUD PUBLIC SCHOOLS,MELANIE KRAUSE,,550067,0,0,12,12,OFFICE NO. 2 MCLOUD PUBLIC SCHOOLS
OKLAHOMA,OFFICE NO. 2 MCLOUD PUBLIC SCHOOLS,STEVEN M. SWARTZ,,550067,0,0,7,7,OFFICE NO. 2 MCLOUD PUBLIC SCHOOLS
OKLAHOMA,OFFICE NO. 2 MCLOUD PUBLIC SCHOOLS,JEANNENE WILLIAMS,,550067,0,0,3,3,OFFICE NO. 2 MCLOUD PUBLIC SCHOOLS
OKLAHOMA,OFFICE NO. 2 MCLOUD PUBLIC SCHOOLS,MELANIE KRAUSE,,550068,0,0,0,0,OFFICE NO. 2 MCLOUD PUBLIC SCHOOLS
OKLAHOMA,OFFICE NO. 2 MCLOUD PUBLIC SCHOOLS,STEVEN M. SWARTZ,,550068,0,0,0,0,OFFICE NO. 2 MCLOUD PUBLIC SCHOOLS
OKLAHOMA,OFFICE NO. 2 MCLOUD PUBLIC SCHOOLS,JEANNENE WILLIAMS,,550068,0,0,0,0,OFFICE NO. 2 MCLOUD PUBLIC SCHOOLS
OKLAHOMA,OFFICE NO. 2 LUTHER PUBLIC SCHOOLS,TONY RUMPL,,550071,0,0,16,16,OFFICE NO. 2 LUTHER PUBLIC SCHOOLS
OKLAHOMA,OFFICE NO. 2 LUTHER PUBLIC SCHOOLS,MATTHEW MOHR,,550071,0,0,10,10,OFFICE NO. 2 LUTHER PUBLIC SCHOOLS
OKLAHOMA,OFFICE NO. 2 LUTHER PUBLIC SCHOOLS,GERALD McCAULEY,,550071,0,0,0,0,OFFICE NO. 2 LUTHER PUBLIC SCHOOLS
OKLAHOMA,"COUNCILMEMBER, WARD 7 CITY OF OKLAHOMA CITY","JOHN A. PETTIS, JR.",,550072,0,0,3,3,"COUNCILMEMBER, WARD 7 CITY OF OKLAHOMA CITY"
OKLAHOMA,"COUNCILMEMBER, WARD 7 CITY OF OKLAHOMA CITY",MARINA MANGIARACINA,,550072,0,0,0,0,"COUNCILMEMBER, WARD 7 CITY OF OKLAHOMA CITY"
OKLAHOMA,"COUNCILMEMBER, WARD 7 CITY OF OKLAHOMA CITY",T. SHERI DICKERSON,,550072,0,0,2,2,"COUNCILMEMBER, WARD 7 CITY OF OKLAHOMA CITY"
OKLAHOMA,OFFICE NO. 2 LUTHER PUBLIC SCHOOLS,TONY RUMPL,,550072,0,0,2,2,OFFICE NO. 2 LUTHER PUBLIC SCHOOLS
OKLAHOMA,OFFICE NO. 2 LUTHER PUBLIC SCHOOLS,MATTHEW MOHR,,550072,0,0,1,1,OFFICE NO. 2 LUTHER PUBLIC SCHOOLS
OKLAHOMA,OFFICE NO. 2 LUTHER PUBLIC SCHOOLS,GERALD McCAULEY,,550072,0,0,0,0,OFFICE NO. 2 LUTHER PUBLIC SCHOOLS
OKLAHOMA,"COUNCILMEMBER, WARD 7 CITY OF OKLAHOMA CITY","JOHN A. PETTIS, JR.",,550073,0,0,1,1,"COUNCILMEMBER, WARD 7 CITY OF OKLAHOMA CITY"
OKLAHOMA,"COUNCILMEMBER, WARD 7 CITY OF OKLAHOMA CITY",MARINA MANGIARACINA,,550073,0,0,0,0,"COUNCILMEMBER, WARD 7 CITY OF OKLAHOMA CITY"
OKLAHOMA,"COUNCILMEMBER, WARD 7 CITY OF OKLAHOMA CITY",T. SHERI DICKERSON,,550073,0,0,2,2,"COUNCILMEMBER, WARD 7 CITY OF OKLAHOMA CITY"
OKLAHOMA,"COUNCILMEMBER, WARD 7 CITY OF OKLAHOMA CITY","JOHN A. PETTIS, JR.",,550074,0,0,25,25,"COUNCILMEMBER, WARD 7 CITY OF OKLAHOMA CITY"
OKLAHOMA,"COUNCILMEMBER, WARD 7 CITY OF OKLAHOMA CITY",MARINA MANGIARACINA,,550074,0,0,0,0,"COUNCILMEMBER, WARD 7 CITY OF OKLAHOMA CITY"
OKLAHOMA,"COUNCILMEMBER, WARD 7 CITY OF OKLAHOMA CITY",T. SHERI DICKERSON,,550074,0,0,1,1,"COUNCILMEMBER, WARD 7 CITY OF OKLAHOMA CITY"
OKLAHOMA,BOARD CHAIRPERSON OKLAHOMA CITY PUBLIC SCHOOLS,PAULA LEWIS,,550074,0,0,10,10,
OKLAHOMA,BOARD CHAIRPERSON OKLAHOMA CITY PUBLIC SCHOOLS,WILFREDO SANTOS RIVERA,,550074,0,0,2,2,
OKLAHOMA,BOARD CHAIRPERSON OKLAHOMA CITY PUBLIC SCHOOLS,GREGORY A. WYATT,,550074,0,0,3,3,
OKLAHOMA,BOARD CHAIRPERSON OKLAHOMA CITY PUBLIC SCHOOLS,BIANCA ROSE,,550074,0,0,3,3,
OKLAHOMA,BOARD CHAIRPERSON OKLAHOMA CITY PUBLIC SCHOOLS,STANLEY HUPFELD,,550074,0,0,7,7,
OKLAHOMA,"COUNCILMEMBER, WARD 7 CITY OF OKLAHOMA CITY","JOHN A. PETTIS, JR.",,550075,0,0,76,76,"COUNCILMEMBER, WARD 7 CITY OF OKLAHOMA CITY"
OKLAHOMA,"COUNCILMEMBER, WARD 7 CITY OF OKLAHOMA CITY",MARINA MANGIARACINA,,550075,0,0,1,1,"COUNCILMEMBER, WARD 7 CITY OF OKLAHOMA CITY"
OKLAHOMA,"COUNCILMEMBER, WARD 7 CITY OF OKLAHOMA CITY",T. SHERI DICKERSON,,550075,0,0,2,2,"COUNCILMEMBER, WARD 7 CITY OF OKLAHOMA CITY"
OKLAHOMA,BOARD CHAIRPERSON OKLAHOMA CITY PUBLIC SCHOOLS,PAULA LEWIS,,550075,0,0,46,46,
OKLAHOMA,BOARD CHAIRPERSON OKLAHOMA CITY PUBLIC SCHOOLS,WILFREDO SANTOS RIVERA,,550075,0,0,3,3,
OKLAHOMA,BOARD CHAIRPERSON OKLAHOMA CITY PUBLIC SCHOOLS,GREGORY A. WYATT,,550075,0,0,7,7,
OKLAHOMA,BOARD CHAIRPERSON OKLAHOMA CITY PUBLIC SCHOOLS,BIANCA ROSE,,550075,0,0,3,3,
OKLAHOMA,BOARD CHAIRPERSON OKLAHOMA CITY PUBLIC SCHOOLS,STANLEY HUPFELD,,550075,0,0,18,18,
OKLAHOMA,"COUNCILMEMBER, WARD 7 CITY OF OKLAHOMA CITY","JOHN A. PETTIS, JR.",,550076,0,0,11,11,"COUNCILMEMBER, WARD 7 CITY OF OKLAHOMA CITY"
OKLAHOMA,"COUNCILMEMBER, WARD 7 CITY OF OKLAHOMA CITY",MARINA MANGIARACINA,,550076,0,0,2,2,"COUNCILMEMBER, WARD 7 CITY OF OKLAHOMA CITY"
OKLAHOMA,"COUNCILMEMBER, WARD 7 CITY OF OKLAHOMA CITY",T. SHERI DICKERSON,,550076,0,0,7,7,"COUNCILMEMBER, WARD 7 CITY OF OKLAHOMA CITY"
OKLAHOMA,OFFICE NO. 2 LUTHER PUBLIC SCHOOLS,TONY RUMPL,,550076,0,0,128,128,OFFICE NO. 2 LUTHER PUBLIC SCHOOLS
OKLAHOMA,OFFICE NO. 2 LUTHER PUBLIC SCHOOLS,MATTHEW MOHR,,550076,0,0,110,110,OFFICE NO. 2 LUTHER PUBLIC SCHOOLS
OKLAHOMA,OFFICE NO. 2 LUTHER PUBLIC SCHOOLS,GERALD McCAULEY,,550076,0,0,7,7,OFFICE NO. 2 LUTHER PUBLIC SCHOOLS
OKLAHOMA,"COUNCILMEMBER, WARD 7 CITY OF OKLAHOMA CITY","JOHN A. PETTIS, JR.",,550077,0,0,19,19,"COUNCILMEMBER, WARD 7 CITY OF OKLAHOMA CITY"
OKLAHOMA,"COUNCILMEMBER, WARD 7 CITY OF OKLAHOMA CITY",MARINA MANGIARACINA,,550077,0,0,5,5,"COUNCILMEMBER, WARD 7 CITY OF OKLAHOMA CITY"
OKLAHOMA,"COUNCILMEMBER, WARD 7 CITY OF OKLAHOMA CITY",T. SHERI DICKERSON,,550077,0,0,6,6,"COUNCILMEMBER, WARD 7 CITY OF OKLAHOMA CITY"
OKLAHOMA,PROPOSITION CRUTCHO PUBLIC SCHOOLS,FOR THE PROPOSITION - YES,,550077,0,0,0,0,
OKLAHOMA,PROPOSITION CRUTCHO PUBLIC SCHOOLS,AGAINST THE PROPOSITION - NO,,550077,0,0,0,0,
OKLAHOMA,BOARD CHAIRPERSON OKLAHOMA CITY PUBLIC SCHOOLS,PAULA LEWIS,,550077,0,0,32,32,
OKLAHOMA,BOARD CHAIRPERSON OKLAHOMA CITY PUBLIC SCHOOLS,WILFREDO SANTOS RIVERA,,550077,0,0,20,20,
OKLAHOMA,BOARD CHAIRPERSON OKLAHOMA CITY PUBLIC SCHOOLS,GREGORY A. WYATT,,550077,0,0,6,6,
OKLAHOMA,BOARD CHAIRPERSON OKLAHOMA CITY PUBLIC SCHOOLS,BIANCA ROSE,,550077,0,0,7,7,
OKLAHOMA,BOARD CHAIRPERSON OKLAHOMA CITY PUBLIC SCHOOLS,STANLEY HUPFELD,,550077,0,0,19,19,
OKLAHOMA,"COUNCILMEMBER, WARD 7 CITY OF OKLAHOMA CITY","JOHN A. PETTIS, JR.",,550078,0,0,0,0,"COUNCILMEMBER, WARD 7 CITY OF OKLAHOMA CITY"
OKLAHOMA,"COUNCILMEMBER, WARD 7 CITY OF OKLAHOMA CITY",MARINA MANGIARACINA,,550078,0,0,0,0,"COUNCILMEMBER, WARD 7 CITY OF OKLAHOMA CITY"
OKLAHOMA,"COUNCILMEMBER, WARD 7 CITY OF OKLAHOMA CITY",T. SHERI DICKERSON,,550078,0,0,0,0,"COUNCILMEMBER, WARD 7 CITY OF OKLAHOMA CITY"
OKLAHOMA,PROPOSITION CRUTCHO PUBLIC SCHOOLS,FOR THE PROPOSITION - YES,,550078,0,0,0,0,
OKLAHOMA,PROPOSITION CRUTCHO PUBLIC SCHOOLS,AGAINST THE PROPOSITION - NO,,550078,0,0,0,0,
OKLAHOMA,BOARD CHAIRPERSON OKLAHOMA CITY PUBLIC SCHOOLS,PAULA LEWIS,,550078,0,0,16,16,
OKLAHOMA,BOARD CHAIRPERSON OKLAHOMA CITY PUBLIC SCHOOLS,WILFREDO SANTOS RIVERA,,550078,0,0,12,12,
OKLAHOMA,BOARD CHAIRPERSON OKLAHOMA CITY PUBLIC SCHOOLS,GREGORY A. WYATT,,550078,0,0,2,2,
OKLAHOMA,BOARD CHAIRPERSON OKLAHOMA CITY PUBLIC SCHOOLS,BIANCA ROSE,,550078,0,0,2,2,
OKLAHOMA,BOARD CHAIRPERSON OKLAHOMA CITY PUBLIC SCHOOLS,STANLEY HUPFELD,,550078,0,0,18,18,
OKLAHOMA,PROPOSITION CRUTCHO PUBLIC SCHOOLS,FOR THE PROPOSITION - YES,,550079,0,0,14,14,
OKLAHOMA,PROPOSITION CRUTCHO PUBLIC SCHOOLS,AGAINST THE PROPOSITION - NO,,550079,0,0,1,1,
OKLAHOMA,BOARD CHAIRPERSON OKLAHOMA CITY PUBLIC SCHOOLS,PAULA LEWIS,,550079,0,0,6,6,
OKLAHOMA,BOARD CHAIRPERSON OKLAHOMA CITY PUBLIC SCHOOLS,WILFREDO SANTOS RIVERA,,550079,0,0,2,2,
OKLAHOMA,BOARD CHAIRPERSON OKLAHOMA CITY PUBLIC SCHOOLS,GREGORY A. WYATT,,550079,0,0,2,2,
OKLAHOMA,BOARD CHAIRPERSON OKLAHOMA CITY PUBLIC SCHOOLS,BIANCA ROSE,,550079,0,0,3,3,
OKLAHOMA,BOARD CHAIRPERSON OKLAHOMA CITY PUBLIC SCHOOLS,STANLEY HUPFELD,,550079,0,0,8,8,
OKLAHOMA,PROPOSITION CRUTCHO PUBLIC SCHOOLS,FOR THE PROPOSITION - YES,,550080,0,0,5,5,
OKLAHOMA,PROPOSITION CRUTCHO PUBLIC SCHOOLS,AGAINST THE PROPOSITION - NO,,550080,0,0,5,5,
OKLAHOMA,"COUNCILMEMBER, WARD 4 CITY OF OKLAHOMA CITY",RICHARD D. MORRISSETTE,,550084,0,0,0,0,"COUNCILMEMBER, WARD 4 CITY OF OKLAHOMA CITY"
OKLAHOMA,"COUNCILMEMBER, WARD 4 CITY OF OKLAHOMA CITY",TODD STONE,,550084,0,0,0,0,"COUNCILMEMBER, WARD 4 CITY OF OKLAHOMA CITY"
OKLAHOMA,"COUNCILMEMBER, WARD 4 CITY OF OKLAHOMA CITY",WALTER KULA,,550084,0,0,0,0,"COUNCILMEMBER, WARD 4 CITY OF OKLAHOMA CITY"
OKLAHOMA,"COUNCILMEMBER, WARD 4 CITY OF OKLAHOMA CITY",DORIS MANGIARACINA BENBROOK,,550084,0,0,0,0,"COUNCILMEMBER, WARD 4 CITY OF OKLAHOMA CITY"
OKLAHOMA,BOARD CHAIRPERSON OKLAHOMA CITY PUBLIC SCHOOLS,PAULA LEWIS,,550086,0,0,1,1,
OKLAHOMA,BOARD CHAIRPERSON OKLAHOMA CITY PUBLIC SCHOOLS,WILFREDO SANTOS RIVERA,,550086,0,0,0,0,
OKLAHOMA,BOARD CHAIRPERSON OKLAHOMA CITY PUBLIC SCHOOLS,GREGORY A. WYATT,,550086,0,0,0,0,
OKLAHOMA,BOARD CHAIRPERSON OKLAHOMA CITY PUBLIC SCHOOLS,BIANCA ROSE,,550086,0,0,0,0,
OKLAHOMA,BOARD CHAIRPERSON OKLAHOMA CITY PUBLIC SCHOOLS,STANLEY HUPFELD,,550086,0,0,3,3,
OKLAHOMA,BOARD CHAIRPERSON OKLAHOMA CITY PUBLIC SCHOOLS,PAULA LEWIS,,550087,0,0,2,2,
OKLAHOMA,BOARD CHAIRPERSON OKLAHOMA CITY PUBLIC SCHOOLS,WILFREDO SANTOS RIVERA,,550087,0,0,3,3,
OKLAHOMA,BOARD CHAIRPERSON OKLAHOMA CITY PUBLIC SCHOOLS,GREGORY A. WYATT,,550087,0,0,1,1,
OKLAHOMA,BOARD CHAIRPERSON OKLAHOMA CITY PUBLIC SCHOOLS,BIANCA ROSE,,550087,0,0,0,0,
OKLAHOMA,BOARD CHAIRPERSON OKLAHOMA CITY PUBLIC SCHOOLS,STANLEY HUPFELD,,550087,0,0,5,5,
OKLAHOMA,BOARD CHAIRPERSON OKLAHOMA CITY PUBLIC SCHOOLS,PAULA LEWIS,,550088,0,0,0,0,
OKLAHOMA,BOARD CHAIRPERSON OKLAHOMA CITY PUBLIC SCHOOLS,WILFREDO SANTOS RIVERA,,550088,0,0,0,0,
OKLAHOMA,BOARD CHAIRPERSON OKLAHOMA CITY PUBLIC SCHOOLS,GREGORY A. WYATT,,550088,0,0,0,0,
OKLAHOMA,BOARD CHAIRPERSON OKLAHOMA CITY PUBLIC SCHOOLS,BIANCA ROSE,,550088,0,0,1,1,
OKLAHOMA,BOARD CHAIRPERSON OKLAHOMA CITY PUBLIC SCHOOLS,STANLEY HUPFELD,,550088,0,0,4,4,
OKLAHOMA,BOARD CHAIRPERSON OKLAHOMA CITY PUBLIC SCHOOLS,PAULA LEWIS,,550089,0,0,9,9,
OKLAHOMA,BOARD CHAIRPERSON OKLAHOMA CITY PUBLIC SCHOOLS,WILFREDO SANTOS RIVERA,,550089,0,0,7,7,
OKLAHOMA,BOARD CHAIRPERSON OKLAHOMA CITY PUBLIC SCHOOLS,GREGORY A. WYATT,,550089,0,0,5,5,
OKLAHOMA,BOARD CHAIRPERSON OKLAHOMA CITY PUBLIC SCHOOLS,BIANCA ROSE,,550089,0,0,4,4,
OKLAHOMA,BOARD CHAIRPERSON OKLAHOMA CITY PUBLIC SCHOOLS,STANLEY HUPFELD,,550089,0,0,13,13,
OKLAHOMA,BOARD CHAIRPERSON OKLAHOMA CITY PUBLIC SCHOOLS,PAULA LEWIS,,550090,0,0,1,1,
OKLAHOMA,BOARD CHAIRPERSON OKLAHOMA CITY PUBLIC SCHOOLS,WILFREDO SANTOS RIVERA,,550090,0,0,0,0,
OKLAHOMA,BOARD CHAIRPERSON OKLAHOMA CITY PUBLIC SCHOOLS,GREGORY A. WYATT,,550090,0,0,2,2,
OKLAHOMA,BOARD CHAIRPERSON OKLAHOMA CITY PUBLIC SCHOOLS,BIANCA ROSE,,550090,0,0,0,0,
OKLAHOMA,BOARD CHAIRPERSON OKLAHOMA CITY PUBLIC SCHOOLS,STANLEY HUPFELD,,550090,0,0,0,0,
OKLAHOMA,BOARD CHAIRPERSON OKLAHOMA CITY PUBLIC SCHOOLS,PAULA LEWIS,,550091,0,0,0,0,
OKLAHOMA,BOARD CHAIRPERSON OKLAHOMA CITY PUBLIC SCHOOLS,WILFREDO SANTOS RIVERA,,550091,0,0,2,2,
OKLAHOMA,BOARD CHAIRPERSON OKLAHOMA CITY PUBLIC SCHOOLS,GREGORY A. WYATT,,550091,0,0,1,1,
OKLAHOMA,BOARD CHAIRPERSON OKLAHOMA CITY PUBLIC SCHOOLS,BIANCA ROSE,,550091,0,0,0,0,
OKLAHOMA,BOARD CHAIRPERSON OKLAHOMA CITY PUBLIC SCHOOLS,STANLEY HUPFELD,,550091,0,0,0,0,
OKLAHOMA,BOARD CHAIRPERSON OKLAHOMA CITY PUBLIC SCHOOLS,PAULA LEWIS,,550092,0,0,2,2,
OKLAHOMA,BOARD CHAIRPERSON OKLAHOMA CITY PUBLIC SCHOOLS,WILFREDO SANTOS RIVERA,,550092,0,0,0,0,
OKLAHOMA,BOARD CHAIRPERSON OKLAHOMA CITY PUBLIC SCHOOLS,GREGORY A. WYATT,,550092,0,0,0,0,
OKLAHOMA,BOARD CHAIRPERSON OKLAHOMA CITY PUBLIC SCHOOLS,BIANCA ROSE,,550092,0,0,1,1,
OKLAHOMA,BOARD CHAIRPERSON OKLAHOMA CITY PUBLIC SCHOOLS,STANLEY HUPFELD,,550092,0,0,7,7,
OKLAHOMA,"COUNCILMEMBER, WARD 4 CITY OF OKLAHOMA CITY",RICHARD D. MORRISSETTE,,550098,0,0,0,0,"COUNCILMEMBER, WARD 4 CITY OF OKLAHOMA CITY"
OKLAHOMA,"COUNCILMEMBER, WARD 4 CITY OF OKLAHOMA CITY",TODD STONE,,550098,0,0,0,0,"COUNCILMEMBER, WARD 4 CITY OF OKLAHOMA CITY"
OKLAHOMA,"COUNCILMEMBER, WARD 4 CITY OF OKLAHOMA CITY",WALTER KULA,,550098,0,0,0,0,"COUNCILMEMBER, WARD 4 CITY OF OKLAHOMA CITY"
OKLAHOMA,"COUNCILMEMBER, WARD 4 CITY OF OKLAHOMA CITY",DORIS MANGIARACINA BENBROOK,,550098,0,0,0,0,"COUNCILMEMBER, WARD 4 CITY OF OKLAHOMA CITY"
OKLAHOMA,BOARD CHAIRPERSON OKLAHOMA CITY PUBLIC SCHOOLS,PAULA LEWIS,,550099,0,0,40,40,
OKLAHOMA,BOARD CHAIRPERSON OKLAHOMA CITY PUBLIC SCHOOLS,WILFREDO SANTOS RIVERA,,550099,0,0,9,9,
OKLAHOMA,BOARD CHAIRPERSON OKLAHOMA CITY PUBLIC SCHOOLS,GREGORY A. WYATT,,550099,0,0,1,1,
OKLAHOMA,BOARD CHAIRPERSON OKLAHOMA CITY PUBLIC SCHOOLS,BIANCA ROSE,,550099,0,0,8,8,
OKLAHOMA,BOARD CHAIRPERSON OKLAHOMA CITY PUBLIC SCHOOLS,STANLEY HUPFELD,,550099,0,0,122,122,
OKLAHOMA,OFFICE NO. 2 OKLAHOMA CITY PUBLIC SCHOOLS,JUSTIN ELLIS,,550099,0,0,67,67,OFFICE NO. 2 OKLAHOMA CITY PUBLIC SCHOOLS
OKLAHOMA,OFFICE NO. 2 OKLAHOMA CITY PUBLIC SCHOOLS,REBECCA L. BUDD,,550099,0,0,66,66,OFFICE NO. 2 OKLAHOMA CITY PUBLIC SCHOOLS
OKLAHOMA,OFFICE NO. 2 OKLAHOMA CITY PUBLIC SCHOOLS,NICK SINGER,,550099,0,0,44,44,OFFICE NO. 2 OKLAHOMA CITY PUBLIC SCHOOLS
OKLAHOMA,BOARD CHAIRPERSON OKLAHOMA CITY PUBLIC SCHOOLS,PAULA LEWIS,,550100,0,0,29,29,
OKLAHOMA,BOARD CHAIRPERSON OKLAHOMA CITY PUBLIC SCHOOLS,WILFREDO SANTOS RIVERA,,550100,0,0,4,4,
OKLAHOMA,BOARD CHAIRPERSON OKLAHOMA CITY PUBLIC SCHOOLS,GREGORY A. WYATT,,550100,0,0,0,0,
OKLAHOMA,BOARD CHAIRPERSON OKLAHOMA CITY PUBLIC SCHOOLS,BIANCA ROSE,,550100,0,0,3,3,
OKLAHOMA,BOARD CHAIRPERSON OKLAHOMA CITY PUBLIC SCHOOLS,STANLEY HUPFELD,,550100,0,0,152,152,
OKLAHOMA,OFFICE NO. 2 OKLAHOMA CITY PUBLIC SCHOOLS,JUSTIN ELLIS,,550100,0,0,113,113,OFFICE NO. 2 OKLAHOMA CITY PUBLIC SCHOOLS
OKLAHOMA,OFFICE NO. 2 OKLAHOMA CITY PUBLIC SCHOOLS,REBECCA L. BUDD,,550100,0,0,53,53,OFFICE NO. 2 OKLAHOMA CITY PUBLIC SCHOOLS
OKLAHOMA,OFFICE NO. 2 OKLAHOMA CITY PUBLIC SCHOOLS,NICK SINGER,,550100,0,0,19,19,OFFICE NO. 2 OKLAHOMA CITY PUBLIC SCHOOLS
OKLAHOMA,BOARD CHAIRPERSON OKLAHOMA CITY PUBLIC SCHOOLS,PAULA LEWIS,,550101,0,0,12,12,
OKLAHOMA,BOARD CHAIRPERSON OKLAHOMA CITY PUBLIC SCHOOLS,WILFREDO SANTOS RIVERA,,550101,0,0,0,0,
OKLAHOMA,BOARD CHAIRPERSON OKLAHOMA CITY PUBLIC SCHOOLS,GREGORY A. WYATT,,550101,0,0,1,1,
OKLAHOMA,BOARD CHAIRPERSON OKLAHOMA CITY PUBLIC SCHOOLS,BIANCA ROSE,,550101,0,0,0,0,
OKLAHOMA,BOARD CHAIRPERSON OKLAHOMA CITY PUBLIC SCHOOLS,STANLEY HUPFELD,,550101,0,0,47,47,
OKLAHOMA,OFFICE NO. 2 OKLAHOMA CITY PUBLIC SCHOOLS,JUSTIN ELLIS,,550101,0,0,33,33,OFFICE NO. 2 OKLAHOMA CITY PUBLIC SCHOOLS
OKLAHOMA,OFFICE NO. 2 OKLAHOMA CITY PUBLIC SCHOOLS,REBECCA L. BUDD,,550101,0,0,21,21,OFFICE NO. 2 OKLAHOMA CITY PUBLIC SCHOOLS
OKLAHOMA,OFFICE NO. 2 OKLAHOMA CITY PUBLIC SCHOOLS,NICK SINGER,,550101,0,0,7,7,OFFICE NO. 2 OKLAHOMA CITY PUBLIC SCHOOLS
OKLAHOMA,BOARD CHAIRPERSON OKLAHOMA CITY PUBLIC SCHOOLS,PAULA LEWIS,,550102,0,0,33,33,
OKLAHOMA,BOARD CHAIRPERSON OKLAHOMA CITY PUBLIC SCHOOLS,WILFREDO SANTOS RIVERA,,550102,0,0,2,2,
OKLAHOMA,BOARD CHAIRPERSON OKLAHOMA CITY PUBLIC SCHOOLS,GREGORY A. WYATT,,550102,0,0,2,2,
OKLAHOMA,BOARD CHAIRPERSON OKLAHOMA CITY PUBLIC SCHOOLS,BIANCA ROSE,,550102,0,0,6,6,
OKLAHOMA,BOARD CHAIRPERSON OKLAHOMA CITY PUBLIC SCHOOLS,STANLEY HUPFELD,,550102,0,0,114,114,
OKLAHOMA,OFFICE NO. 2 OKLAHOMA CITY PUBLIC SCHOOLS,JUSTIN ELLIS,,550102,0,0,67,67,OFFICE NO. 2 OKLAHOMA CITY PUBLIC SCHOOLS
OKLAHOMA,OFFICE NO. 2 OKLAHOMA CITY PUBLIC SCHOOLS,REBECCA L. BUDD,,550102,0,0,55,55,OFFICE NO. 2 OKLAHOMA CITY PUBLIC SCHOOLS
OKLAHOMA,OFFICE NO. 2 OKLAHOMA CITY PUBLIC SCHOOLS,NICK SINGER,,550102,0,0,30,30,OFFICE NO. 2 OKLAHOMA CITY PUBLIC SCHOOLS
OKLAHOMA,BOARD CHAIRPERSON OKLAHOMA CITY PUBLIC SCHOOLS,PAULA LEWIS,,550103,0,0,17,17,
OKLAHOMA,BOARD CHAIRPERSON OKLAHOMA CITY PUBLIC SCHOOLS,WILFREDO SANTOS RIVERA,,550103,0,0,9,9,
OKLAHOMA,BOARD CHAIRPERSON OKLAHOMA CITY PUBLIC SCHOOLS,GREGORY A. WYATT,,550103,0,0,0,0,
OKLAHOMA,BOARD CHAIRPERSON OKLAHOMA CITY PUBLIC SCHOOLS,BIANCA ROSE,,550103,0,0,10,10,
OKLAHOMA,BOARD CHAIRPERSON OKLAHOMA CITY PUBLIC SCHOOLS,STANLEY HUPFELD,,550103,0,0,31,31,
OKLAHOMA,OFFICE NO. 2 OKLAHOMA CITY PUBLIC SCHOOLS,JUSTIN ELLIS,,550103,0,0,24,24,OFFICE NO. 2 OKLAHOMA CITY PUBLIC SCHOOLS
OKLAHOMA,OFFICE NO. 2 OKLAHOMA CITY PUBLIC SCHOOLS,REBECCA L. BUDD,,550103,0,0,28,28,OFFICE NO. 2 OKLAHOMA CITY PUBLIC SCHOOLS
OKLAHOMA,OFFICE NO. 2 OKLAHOMA CITY PUBLIC SCHOOLS,NICK SINGER,,550103,0,0,18,18,OFFICE NO. 2 OKLAHOMA CITY PUBLIC SCHOOLS
OKLAHOMA,BOARD CHAIRPERSON OKLAHOMA CITY PUBLIC SCHOOLS,PAULA LEWIS,,550104,0,0,22,22,
OKLAHOMA,BOARD CHAIRPERSON OKLAHOMA CITY PUBLIC SCHOOLS,WILFREDO SANTOS RIVERA,,550104,0,0,10,10,
OKLAHOMA,BOARD CHAIRPERSON OKLAHOMA CITY PUBLIC SCHOOLS,GREGORY A. WYATT,,550104,0,0,2,2,
OKLAHOMA,BOARD CHAIRPERSON OKLAHOMA CITY PUBLIC SCHOOLS,BIANCA ROSE,,550104,0,0,8,8,
OKLAHOMA,BOARD CHAIRPERSON OKLAHOMA CITY PUBLIC SCHOOLS,STANLEY HUPFELD,,550104,0,0,31,31,
OKLAHOMA,OFFICE NO. 1 OKLAHOMA CITY PUBLIC SCHOOLS,NATHAN SHIRLEY,,550104,0,0,25,25,OFFICE NO. 1 OKLAHOMA CITY PUBLIC SCHOOLS
OKLAHOMA,OFFICE NO. 1 OKLAHOMA CITY PUBLIC SCHOOLS,CHARLES HENRY,,550104,0,0,20,20,OFFICE NO. 1 OKLAHOMA CITY PUBLIC SCHOOLS
OKLAHOMA,OFFICE NO. 1 OKLAHOMA CITY PUBLIC SCHOOLS,CHERYL POOLE,,550104,0,0,32,32,OFFICE NO. 1 OKLAHOMA CITY PUBLIC SCHOOLS
OKLAHOMA,BOARD CHAIRPERSON OKLAHOMA CITY PUBLIC SCHOOLS,PAULA LEWIS,,550105,0,0,37,37,
OKLAHOMA,BOARD CHAIRPERSON OKLAHOMA CITY PUBLIC SCHOOLS,WILFREDO SANTOS RIVERA,,550105,0,0,10,10,
OKLAHOMA,BOARD CHAIRPERSON OKLAHOMA CITY PUBLIC SCHOOLS,GREGORY A. WYATT,,550105,0,0,7,7,
OKLAHOMA,BOARD CHAIRPERSON OKLAHOMA CITY PUBLIC SCHOOLS,BIANCA ROSE,,550105,0,0,10,10,
OKLAHOMA,BOARD CHAIRPERSON OKLAHOMA CITY PUBLIC SCHOOLS,STANLEY HUPFELD,,550105,0,0,56,56,
OKLAHOMA,OFFICE NO. 1 OKLAHOMA CITY PUBLIC SCHOOLS,NATHAN SHIRLEY,,550105,0,0,47,47,OFFICE NO. 1 OKLAHOMA CITY PUBLIC SCHOOLS
OKLAHOMA,OFFICE NO. 1 OKLAHOMA CITY PUBLIC SCHOOLS,CHARLES HENRY,,550105,0,0,13,13,OFFICE NO. 1 OKLAHOMA CITY PUBLIC SCHOOLS
OKLAHOMA,OFFICE NO. 1 OKLAHOMA CITY PUBLIC SCHOOLS,CHERYL POOLE,,550105,0,0,67,67,OFFICE NO. 1 OKLAHOMA CITY PUBLIC SCHOOLS
OKLAHOMA,"COUNCILMEMBER, WARD 1 CITY OF OKLAHOMA CITY",CHRIS GORDON,,550106,0,0,0,0,"COUNCILMEMBER, WARD 1 CITY OF OKLAHOMA CITY"
OKLAHOMA,"COUNCILMEMBER, WARD 1 CITY OF OKLAHOMA CITY",JAMES GREINER,,550106,0,0,0,0,"COUNCILMEMBER, WARD 1 CITY OF OKLAHOMA CITY"
OKLAHOMA,"COUNCILMEMBER, WARD 1 CITY OF OKLAHOMA CITY",JONATHAN CLOUR,,550106,0,0,0,0,"COUNCILMEMBER, WARD 1 CITY OF OKLAHOMA CITY"
OKLAHOMA,OFFICE NO. 2 FRANCIS TUTTLE TECH CENTER,PETE LEE,,550106,0,0,0,0,OFFICE NO. 2 FRANCIS TUTTLE TECH CENTER
OKLAHOMA,OFFICE NO. 2 FRANCIS TUTTLE TECH CENTER,ROBERT STONE,,550106,0,0,0,0,OFFICE NO. 2 FRANCIS TUTTLE TECH CENTER
OKLAHOMA,BOARD CHAIRPERSON OKLAHOMA CITY PUBLIC SCHOOLS,PAULA LEWIS,,550106,0,0,44,44,
OKLAHOMA,BOARD CHAIRPERSON OKLAHOMA CITY PUBLIC SCHOOLS,WILFREDO SANTOS RIVERA,,550106,0,0,0,0,
OKLAHOMA,BOARD CHAIRPERSON OKLAHOMA CITY PUBLIC SCHOOLS,GREGORY A. WYATT,,550106,0,0,5,5,
OKLAHOMA,BOARD CHAIRPERSON OKLAHOMA CITY PUBLIC SCHOOLS,BIANCA ROSE,,550106,0,0,14,14,
OKLAHOMA,BOARD CHAIRPERSON OKLAHOMA CITY PUBLIC SCHOOLS,STANLEY HUPFELD,,550106,0,0,92,92,
OKLAHOMA,OFFICE NO. 1 OKLAHOMA CITY PUBLIC SCHOOLS,NATHAN SHIRLEY,,550106,0,0,57,57,OFFICE NO. 1 OKLAHOMA CITY PUBLIC SCHOOLS
OKLAHOMA,OFFICE NO. 1 OKLAHOMA CITY PUBLIC SCHOOLS,CHARLES HENRY,,550106,0,0,22,22,OFFICE NO. 1 OKLAHOMA CITY PUBLIC SCHOOLS
OKLAHOMA,OFFICE NO. 1 OKLAHOMA CITY PUBLIC SCHOOLS,CHERYL POOLE,,550106,0,0,77,77,OFFICE NO. 1 OKLAHOMA CITY PUBLIC SCHOOLS
OKLAHOMA,OFFICE NO. 2 OKLAHOMA CITY PUBLIC SCHOOLS,JUSTIN ELLIS,,550106,0,0,0,0,OFFICE NO. 2 OKLAHOMA CITY PUBLIC SCHOOLS
OKLAHOMA,OFFICE NO. 2 OKLAHOMA CITY PUBLIC SCHOOLS,REBECCA L. BUDD,,550106,0,0,0,0,OFFICE NO. 2 OKLAHOMA CITY PUBLIC SCHOOLS
OKLAHOMA,OFFICE NO. 2 OKLAHOMA CITY PUBLIC SCHOOLS,NICK SINGER,,550106,0,0,0,0,OFFICE NO. 2 OKLAHOMA CITY PUBLIC SCHOOLS
OKLAHOMA,"COUNCILMEMBER, WARD 7 CITY OF OKLAHOMA CITY","JOHN A. PETTIS, JR.",,550107,0,0,7,7,"COUNCILMEMBER, WARD 7 CITY OF OKLAHOMA CITY"
OKLAHOMA,"COUNCILMEMBER, WARD 7 CITY OF OKLAHOMA CITY",MARINA MANGIARACINA,,550107,0,0,7,7,"COUNCILMEMBER, WARD 7 CITY OF OKLAHOMA CITY"
OKLAHOMA,"COUNCILMEMBER, WARD 7 CITY OF OKLAHOMA CITY",T. SHERI DICKERSON,,550107,0,0,2,2,"COUNCILMEMBER, WARD 7 CITY OF OKLAHOMA CITY"
OKLAHOMA,OFFICE NO. 2 LUTHER PUBLIC SCHOOLS,TONY RUMPL,,550107,0,0,10,10,OFFICE NO. 2 LUTHER PUBLIC SCHOOLS
OKLAHOMA,OFFICE NO. 2 LUTHER PUBLIC SCHOOLS,MATTHEW MOHR,,550107,0,0,11,11,OFFICE NO. 2 LUTHER PUBLIC SCHOOLS
OKLAHOMA,OFFICE NO. 2 LUTHER PUBLIC SCHOOLS,GERALD McCAULEY,,550107,0,0,2,2,OFFICE NO. 2 LUTHER PUBLIC SCHOOLS
OKLAHOMA,"COUNCILMEMBER, WARD 7 CITY OF OKLAHOMA CITY","JOHN A. PETTIS, JR.",,550108,0,0,19,19,"COUNCILMEMBER, WARD 7 CITY OF OKLAHOMA CITY"
OKLAHOMA,"COUNCILMEMBER, WARD 7 CITY OF OKLAHOMA CITY",MARINA MANGIARACINA,,550108,0,0,0,0,"COUNCILMEMBER, WARD 7 CITY OF OKLAHOMA CITY"
OKLAHOMA,"COUNCILMEMBER, WARD 7 CITY OF OKLAHOMA CITY",T. SHERI DICKERSON,,550108,0,0,1,1,"COUNCILMEMBER, WARD 7 CITY OF OKLAHOMA CITY"
OKLAHOMA,PROPOSITION NO. 1 EDMOND PUBLIC SCHOOLS,FOR THE PROPOSITION - YES,,550108,0,0,4,4,PROPOSITION NO. 1 EDMOND PUBLIC SCHOOLS
OKLAHOMA,PROPOSITION NO. 1 EDMOND PUBLIC SCHOOLS,AGAINST THE PROPOSITION - NO,,550108,0,0,3,3,PROPOSITION NO. 1 EDMOND PUBLIC SCHOOLS
OKLAHOMA,PROPOSITION NO. 2 EDMOND PUBLIC SCHOOLS,FOR THE PROPOSITION - YES,,550108,0,0,3,3,PROPOSITION NO. 2 EDMOND PUBLIC SCHOOLS
OKLAHOMA,PROPOSITION NO. 2 EDMOND PUBLIC SCHOOLS,AGAINST THE PROPOSITION - NO,,550108,0,0,3,3,PROPOSITION NO. 2 EDMOND PUBLIC SCHOOLS
OKLAHOMA,OFFICE NO. 2 FRANCIS TUTTLE TECH CENTER,PETE LEE,,550108,0,0,0,0,OFFICE NO. 2 FRANCIS TUTTLE TECH CENTER
OKLAHOMA,OFFICE NO. 2 FRANCIS TUTTLE TECH CENTER,ROBERT STONE,,550108,0,0,5,5,OFFICE NO. 2 FRANCIS TUTTLE TECH CENTER
OKLAHOMA,"COUNCILMEMBER, WARD 7 CITY OF OKLAHOMA CITY","JOHN A. PETTIS, JR.",,550109,0,0,92,92,"COUNCILMEMBER, WARD 7 CITY OF OKLAHOMA CITY"
OKLAHOMA,"COUNCILMEMBER, WARD 7 CITY OF OKLAHOMA CITY",MARINA MANGIARACINA,,550109,0,0,6,6,"COUNCILMEMBER, WARD 7 CITY OF OKLAHOMA CITY"
OKLAHOMA,"COUNCILMEMBER, WARD 7 CITY OF OKLAHOMA CITY",T. SHERI DICKERSON,,550109,0,0,21,21,"COUNCILMEMBER, WARD 7 CITY OF OKLAHOMA CITY"
OKLAHOMA,BOARD CHAIRPERSON OKLAHOMA CITY PUBLIC SCHOOLS,PAULA LEWIS,,550109,0,0,4,4,
OKLAHOMA,BOARD CHAIRPERSON OKLAHOMA CITY PUBLIC SCHOOLS,WILFREDO SANTOS RIVERA,,550109,0,0,0,0,
OKLAHOMA,BOARD CHAIRPERSON OKLAHOMA CITY PUBLIC SCHOOLS,GREGORY A. WYATT,,550109,0,0,1,1,
OKLAHOMA,BOARD CHAIRPERSON OKLAHOMA CITY PUBLIC SCHOOLS,BIANCA ROSE,,550109,0,0,0,0,
OKLAHOMA,BOARD CHAIRPERSON OKLAHOMA CITY PUBLIC SCHOOLS,STANLEY HUPFELD,,550109,0,0,5,5,
OKLAHOMA,OFFICE NO. 1 OKLAHOMA CITY PUBLIC SCHOOLS,NATHAN SHIRLEY,,550109,0,0,0,0,OFFICE NO. 1 OKLAHOMA CITY PUBLIC SCHOOLS
OKLAHOMA,OFFICE NO. 1 OKLAHOMA CITY PUBLIC SCHOOLS,CHARLES HENRY,,550109,0,0,0,0,OFFICE NO. 1 OKLAHOMA CITY PUBLIC SCHOOLS
OKLAHOMA,OFFICE NO. 1 OKLAHOMA CITY PUBLIC SCHOOLS,CHERYL POOLE,,550109,0,0,0,0,OFFICE NO. 1 OKLAHOMA CITY PUBLIC SCHOOLS
OKLAHOMA,"COUNCILMEMBER, WARD 7 CITY OF OKLAHOMA CITY","JOHN A. PETTIS, JR.",,550110,0,0,14,14,"COUNCILMEMBER, WARD 7 CITY OF OKLAHOMA CITY"
OKLAHOMA,"COUNCILMEMBER, WARD 7 CITY OF OKLAHOMA CITY",MARINA MANGIARACINA,,550110,0,0,3,3,"COUNCILMEMBER, WARD 7 CITY OF OKLAHOMA CITY"
OKLAHOMA,"COUNCILMEMBER, WARD 7 CITY OF OKLAHOMA CITY",T. SHERI DICKERSON,,550110,0,0,8,8,"COUNCILMEMBER, WARD 7 CITY OF OKLAHOMA CITY"
OKLAHOMA,BOARD CHAIRPERSON OKLAHOMA CITY PUBLIC SCHOOLS,PAULA LEWIS,,550110,0,0,2,2,
OKLAHOMA,BOARD CHAIRPERSON OKLAHOMA CITY PUBLIC SCHOOLS,WILFREDO SANTOS RIVERA,,550110,0,0,2,2,
OKLAHOMA,BOARD CHAIRPERSON OKLAHOMA CITY PUBLIC SCHOOLS,GREGORY A. WYATT,,550110,0,0,0,0,
OKLAHOMA,BOARD CHAIRPERSON OKLAHOMA CITY PUBLIC SCHOOLS,BIANCA ROSE,,550110,0,0,0,0,
OKLAHOMA,BOARD CHAIRPERSON OKLAHOMA CITY PUBLIC SCHOOLS,STANLEY HUPFELD,,550110,0,0,3,3,
OKLAHOMA,OFFICE NO. 1 OKLAHOMA CITY PUBLIC SCHOOLS,NATHAN SHIRLEY,,550110,0,0,0,0,OFFICE NO. 1 OKLAHOMA CITY PUBLIC SCHOOLS
OKLAHOMA,OFFICE NO. 1 OKLAHOMA CITY PUBLIC SCHOOLS,CHARLES HENRY,,550110,0,0,6,6,OFFICE NO. 1 OKLAHOMA CITY PUBLIC SCHOOLS
OKLAHOMA,OFFICE NO. 1 OKLAHOMA CITY PUBLIC SCHOOLS,CHERYL POOLE,,550110,0,0,3,3,OFFICE NO. 1 OKLAHOMA CITY PUBLIC SCHOOLS
OKLAHOMA,"COUNCILMEMBER, WARD 7 CITY OF OKLAHOMA CITY","JOHN A. PETTIS, JR.",,550111,0,0,89,89,"COUNCILMEMBER, WARD 7 CITY OF OKLAHOMA CITY"
OKLAHOMA,"COUNCILMEMBER, WARD 7 CITY OF OKLAHOMA CITY",MARINA MANGIARACINA,,550111,0,0,9,9,"COUNCILMEMBER, WARD 7 CITY OF OKLAHOMA CITY"
OKLAHOMA,"COUNCILMEMBER, WARD 7 CITY OF OKLAHOMA CITY",T. SHERI DICKERSON,,550111,0,0,9,9,"COUNCILMEMBER, WARD 7 CITY OF OKLAHOMA CITY"
OKLAHOMA,PROPOSITION NO. 1 EDMOND PUBLIC SCHOOLS,FOR THE PROPOSITION - YES,,550111,0,0,86,86,PROPOSITION NO. 1 EDMOND PUBLIC SCHOOLS
OKLAHOMA,PROPOSITION NO. 1 EDMOND PUBLIC SCHOOLS,AGAINST THE PROPOSITION - NO,,550111,0,0,25,25,PROPOSITION NO. 1 EDMOND PUBLIC SCHOOLS
OKLAHOMA,PROPOSITION NO. 2 EDMOND PUBLIC SCHOOLS,FOR THE PROPOSITION - YES,,550111,0,0,85,85,PROPOSITION NO. 2 EDMOND PUBLIC SCHOOLS
OKLAHOMA,PROPOSITION NO. 2 EDMOND PUBLIC SCHOOLS,AGAINST THE PROPOSITION - NO,,550111,0,0,26,26,PROPOSITION NO. 2 EDMOND PUBLIC SCHOOLS
OKLAHOMA,OFFICE NO. 2 FRANCIS TUTTLE TECH CENTER,PETE LEE,,550111,0,0,28,28,OFFICE NO. 2 FRANCIS TUTTLE TECH CENTER
OKLAHOMA,OFFICE NO. 2 FRANCIS TUTTLE TECH CENTER,ROBERT STONE,,550111,0,0,54,54,OFFICE NO. 2 FRANCIS TUTTLE TECH CENTER
OKLAHOMA,BOARD CHAIRPERSON OKLAHOMA CITY PUBLIC SCHOOLS,PAULA LEWIS,,550111,0,0,0,0,
OKLAHOMA,BOARD CHAIRPERSON OKLAHOMA CITY PUBLIC SCHOOLS,WILFREDO SANTOS RIVERA,,550111,0,0,0,0,
OKLAHOMA,BOARD CHAIRPERSON OKLAHOMA CITY PUBLIC SCHOOLS,GREGORY A. WYATT,,550111,0,0,0,0,
OKLAHOMA,BOARD CHAIRPERSON OKLAHOMA CITY PUBLIC SCHOOLS,BIANCA ROSE,,550111,0,0,0,0,
OKLAHOMA,BOARD CHAIRPERSON OKLAHOMA CITY PUBLIC SCHOOLS,STANLEY HUPFELD,,550111,0,0,0,0,
OKLAHOMA,OFFICE NO. 1 OKLAHOMA CITY PUBLIC SCHOOLS,NATHAN SHIRLEY,,550111,0,0,0,0,OFFICE NO. 1 OKLAHOMA CITY PUBLIC SCHOOLS
OKLAHOMA,OFFICE NO. 1 OKLAHOMA CITY PUBLIC SCHOOLS,CHARLES HENRY,,550111,0,0,0,0,OFFICE NO. 1 OKLAHOMA CITY PUBLIC SCHOOLS
OKLAHOMA,OFFICE NO. 1 OKLAHOMA CITY PUBLIC SCHOOLS,CHERYL POOLE,,550111,0,0,0,0,OFFICE NO. 1 OKLAHOMA CITY PUBLIC SCHOOLS
OKLAHOMA,"COUNCILMEMBER, WARD 7 CITY OF OKLAHOMA CITY","JOHN A. PETTIS, JR.",,550112,0,0,12,12,"COUNCILMEMBER, WARD 7 CITY OF OKLAHOMA CITY"
OKLAHOMA,"COUNCILMEMBER, WARD 7 CITY OF OKLAHOMA CITY",MARINA MANGIARACINA,,550112,0,0,0,0,"COUNCILMEMBER, WARD 7 CITY OF OKLAHOMA CITY"
OKLAHOMA,"COUNCILMEMBER, WARD 7 CITY OF OKLAHOMA CITY",T. SHERI DICKERSON,,550112,0,0,4,4,"COUNCILMEMBER, WARD 7 CITY OF OKLAHOMA CITY"
OKLAHOMA,BOARD CHAIRPERSON OKLAHOMA CITY PUBLIC SCHOOLS,PAULA LEWIS,,550112,0,0,5,5,
OKLAHOMA,BOARD CHAIRPERSON OKLAHOMA CITY PUBLIC SCHOOLS,WILFREDO SANTOS RIVERA,,550112,0,0,0,0,
OKLAHOMA,BOARD CHAIRPERSON OKLAHOMA CITY PUBLIC SCHOOLS,GREGORY A. WYATT,,550112,0,0,0,0,
OKLAHOMA,BOARD CHAIRPERSON OKLAHOMA CITY PUBLIC SCHOOLS,BIANCA ROSE,,550112,0,0,0,0,
OKLAHOMA,BOARD CHAIRPERSON OKLAHOMA CITY PUBLIC SCHOOLS,STANLEY HUPFELD,,550112,0,0,11,11,
OKLAHOMA,OFFICE NO. 1 OKLAHOMA CITY PUBLIC SCHOOLS,NATHAN SHIRLEY,,550112,0,0,2,2,OFFICE NO. 1 OKLAHOMA CITY PUBLIC SCHOOLS
OKLAHOMA,OFFICE NO. 1 OKLAHOMA CITY PUBLIC SCHOOLS,CHARLES HENRY,,550112,0,0,8,8,OFFICE NO. 1 OKLAHOMA CITY PUBLIC SCHOOLS
OKLAHOMA,OFFICE NO. 1 OKLAHOMA CITY PUBLIC SCHOOLS,CHERYL POOLE,,550112,0,0,6,6,OFFICE NO. 1 OKLAHOMA CITY PUBLIC SCHOOLS
OKLAHOMA,"COUNCILMEMBER, WARD 7 CITY OF OKLAHOMA CITY","JOHN A. PETTIS, JR.",,550113,0,0,27,27,"COUNCILMEMBER, WARD 7 CITY OF OKLAHOMA CITY"
OKLAHOMA,"COUNCILMEMBER, WARD 7 CITY OF OKLAHOMA CITY",MARINA MANGIARACINA,,550113,0,0,4,4,"COUNCILMEMBER, WARD 7 CITY OF OKLAHOMA CITY"
OKLAHOMA,"COUNCILMEMBER, WARD 7 CITY OF OKLAHOMA CITY",T. SHERI DICKERSON,,550113,0,0,11,11,"COUNCILMEMBER, WARD 7 CITY OF OKLAHOMA CITY"
OKLAHOMA,BOARD CHAIRPERSON OKLAHOMA CITY PUBLIC SCHOOLS,PAULA LEWIS,,550113,0,0,14,14,
OKLAHOMA,BOARD CHAIRPERSON OKLAHOMA CITY PUBLIC SCHOOLS,WILFREDO SANTOS RIVERA,,550113,0,0,4,4,
OKLAHOMA,BOARD CHAIRPERSON OKLAHOMA CITY PUBLIC SCHOOLS,GREGORY A. WYATT,,550113,0,0,4,4,
OKLAHOMA,BOARD CHAIRPERSON OKLAHOMA CITY PUBLIC SCHOOLS,BIANCA ROSE,,550113,0,0,0,0,
OKLAHOMA,BOARD CHAIRPERSON OKLAHOMA CITY PUBLIC SCHOOLS,STANLEY HUPFELD,,550113,0,0,18,18,
OKLAHOMA,OFFICE NO. 1 OKLAHOMA CITY PUBLIC SCHOOLS,NATHAN SHIRLEY,,550113,0,0,6,6,OFFICE NO. 1 OKLAHOMA CITY PUBLIC SCHOOLS
OKLAHOMA,OFFICE NO. 1 OKLAHOMA CITY PUBLIC SCHOOLS,CHARLES HENRY,,550113,0,0,19,19,OFFICE NO. 1 OKLAHOMA CITY PUBLIC SCHOOLS
OKLAHOMA,OFFICE NO. 1 OKLAHOMA CITY PUBLIC SCHOOLS,CHERYL POOLE,,550113,0,0,15,15,OFFICE NO. 1 OKLAHOMA CITY PUBLIC SCHOOLS
OKLAHOMA,"COUNCILMEMBER, WARD 7 CITY OF OKLAHOMA CITY","JOHN A. PETTIS, JR.",,550114,0,0,202,202,"COUNCILMEMBER, WARD 7 CITY OF OKLAHOMA CITY"
OKLAHOMA,"COUNCILMEMBER, WARD 7 CITY OF OKLAHOMA CITY",MARINA MANGIARACINA,,550114,0,0,8,8,"COUNCILMEMBER, WARD 7 CITY OF OKLAHOMA CITY"
OKLAHOMA,"COUNCILMEMBER, WARD 7 CITY OF OKLAHOMA CITY",T. SHERI DICKERSON,,550114,0,0,22,22,"COUNCILMEMBER, WARD 7 CITY OF OKLAHOMA CITY"
OKLAHOMA,BOARD CHAIRPERSON OKLAHOMA CITY PUBLIC SCHOOLS,PAULA LEWIS,,550114,0,0,2,2,
OKLAHOMA,BOARD CHAIRPERSON OKLAHOMA CITY PUBLIC SCHOOLS,WILFREDO SANTOS RIVERA,,550114,0,0,2,2,
OKLAHOMA,BOARD CHAIRPERSON OKLAHOMA CITY PUBLIC SCHOOLS,GREGORY A. WYATT,,550114,0,0,0,0,
OKLAHOMA,BOARD CHAIRPERSON OKLAHOMA CITY PUBLIC SCHOOLS,BIANCA ROSE,,550114,0,0,0,0,
OKLAHOMA,BOARD CHAIRPERSON OKLAHOMA CITY PUBLIC SCHOOLS,STANLEY HUPFELD,,550114,0,0,4,4,
OKLAHOMA,"COUNCILMEMBER, WARD 7 CITY OF OKLAHOMA CITY","JOHN A. PETTIS, JR.",,550115,0,0,226,226,"COUNCILMEMBER, WARD 7 CITY OF OKLAHOMA CITY"
OKLAHOMA,"COUNCILMEMBER, WARD 7 CITY OF OKLAHOMA CITY",MARINA MANGIARACINA,,550115,0,0,9,9,"COUNCILMEMBER, WARD 7 CITY OF OKLAHOMA CITY"
OKLAHOMA,"COUNCILMEMBER, WARD 7 CITY OF OKLAHOMA CITY",T. SHERI DICKERSON,,550115,0,0,22,22,"COUNCILMEMBER, WARD 7 CITY OF OKLAHOMA CITY"
OKLAHOMA,BOARD CHAIRPERSON OKLAHOMA CITY PUBLIC SCHOOLS,PAULA LEWIS,,550115,0,0,121,121,
OKLAHOMA,BOARD CHAIRPERSON OKLAHOMA CITY PUBLIC SCHOOLS,WILFREDO SANTOS RIVERA,,550115,0,0,35,35,
OKLAHOMA,BOARD CHAIRPERSON OKLAHOMA CITY PUBLIC SCHOOLS,GREGORY A. WYATT,,550115,0,0,8,8,
OKLAHOMA,BOARD CHAIRPERSON OKLAHOMA CITY PUBLIC SCHOOLS,BIANCA ROSE,,550115,0,0,13,13,
OKLAHOMA,BOARD CHAIRPERSON OKLAHOMA CITY PUBLIC SCHOOLS,STANLEY HUPFELD,,550115,0,0,50,50,
OKLAHOMA,"COUNCILMEMBER, WARD 7 CITY OF OKLAHOMA CITY","JOHN A. PETTIS, JR.",,550116,0,0,9,9,"COUNCILMEMBER, WARD 7 CITY OF OKLAHOMA CITY"
OKLAHOMA,"COUNCILMEMBER, WARD 7 CITY OF OKLAHOMA CITY",MARINA MANGIARACINA,,550116,0,0,2,2,"COUNCILMEMBER, WARD 7 CITY OF OKLAHOMA CITY"
OKLAHOMA,"COUNCILMEMBER, WARD 7 CITY OF OKLAHOMA CITY",T. SHERI DICKERSON,,550116,0,0,3,3,"COUNCILMEMBER, WARD 7 CITY OF OKLAHOMA CITY"
OKLAHOMA,BOARD CHAIRPERSON OKLAHOMA CITY PUBLIC SCHOOLS,PAULA LEWIS,,550116,0,0,41,41,
OKLAHOMA,BOARD CHAIRPERSON OKLAHOMA CITY PUBLIC SCHOOLS,WILFREDO SANTOS RIVERA,,550116,0,0,3,3,
OKLAHOMA,BOARD CHAIRPERSON OKLAHOMA CITY PUBLIC SCHOOLS,GREGORY A. WYATT,,550116,0,0,0,0,
OKLAHOMA,BOARD CHAIRPERSON OKLAHOMA CITY PUBLIC SCHOOLS,BIANCA ROSE,,550116,0,0,2,2,
OKLAHOMA,BOARD CHAIRPERSON OKLAHOMA CITY PUBLIC SCHOOLS,STANLEY HUPFELD,,550116,0,0,7,7,
OKLAHOMA,OFFICE NO. 2 OKLAHOMA CITY PUBLIC SCHOOLS,JUSTIN ELLIS,,550116,0,0,9,9,OFFICE NO. 2 OKLAHOMA CITY PUBLIC SCHOOLS
OKLAHOMA,OFFICE NO. 2 OKLAHOMA CITY PUBLIC SCHOOLS,REBECCA L. BUDD,,550116,0,0,26,26,OFFICE NO. 2 OKLAHOMA CITY PUBLIC SCHOOLS
OKLAHOMA,OFFICE NO. 2 OKLAHOMA CITY PUBLIC SCHOOLS,NICK SINGER,,550116,0,0,18,18,OFFICE NO. 2 OKLAHOMA CITY PUBLIC SCHOOLS
OKLAHOMA,"COUNCILMEMBER, WARD 7 CITY OF OKLAHOMA CITY","JOHN A. PETTIS, JR.",,550117,0,0,259,259,"COUNCILMEMBER, WARD 7 CITY OF OKLAHOMA CITY"
OKLAHOMA,"COUNCILMEMBER, WARD 7 CITY OF OKLAHOMA CITY",MARINA MANGIARACINA,,550117,0,0,6,6,"COUNCILMEMBER, WARD 7 CITY OF OKLAHOMA CITY"
OKLAHOMA,"COUNCILMEMBER, WARD 7 CITY OF OKLAHOMA CITY",T. SHERI DICKERSON,,550117,0,0,17,17,"COUNCILMEMBER, WARD 7 CITY OF OKLAHOMA CITY"
OKLAHOMA,BOARD CHAIRPERSON OKLAHOMA CITY PUBLIC SCHOOLS,PAULA LEWIS,,550117,0,0,40,40,
OKLAHOMA,BOARD CHAIRPERSON OKLAHOMA CITY PUBLIC SCHOOLS,WILFREDO SANTOS RIVERA,,550117,0,0,29,29,
OKLAHOMA,BOARD CHAIRPERSON OKLAHOMA CITY PUBLIC SCHOOLS,GREGORY A. WYATT,,550117,0,0,25,25,
OKLAHOMA,BOARD CHAIRPERSON OKLAHOMA CITY PUBLIC SCHOOLS,BIANCA ROSE,,550117,0,0,17,17,
OKLAHOMA,BOARD CHAIRPERSON OKLAHOMA CITY PUBLIC SCHOOLS,STANLEY HUPFELD,,550117,0,0,66,66,
OKLAHOMA,OFFICE NO. 1 OKLAHOMA CITY PUBLIC SCHOOLS,NATHAN SHIRLEY,,550117,0,0,4,4,OFFICE NO. 1 OKLAHOMA CITY PUBLIC SCHOOLS
OKLAHOMA,OFFICE NO. 1 OKLAHOMA CITY PUBLIC SCHOOLS,CHARLES HENRY,,550117,0,0,41,41,OFFICE NO. 1 OKLAHOMA CITY PUBLIC SCHOOLS
OKLAHOMA,OFFICE NO. 1 OKLAHOMA CITY PUBLIC SCHOOLS,CHERYL POOLE,,550117,0,0,5,5,OFFICE NO. 1 OKLAHOMA CITY PUBLIC SCHOOLS
OKLAHOMA,OFFICE NO. 2 OKLAHOMA CITY PUBLIC SCHOOLS,JUSTIN ELLIS,,550117,0,0,42,42,OFFICE NO. 2 OKLAHOMA CITY PUBLIC SCHOOLS
OKLAHOMA,OFFICE NO. 2 OKLAHOMA CITY PUBLIC SCHOOLS,REBECCA L. BUDD,,550117,0,0,53,53,OFFICE NO. 2 OKLAHOMA CITY PUBLIC SCHOOLS
OKLAHOMA,OFFICE NO. 2 OKLAHOMA CITY PUBLIC SCHOOLS,NICK SINGER,,550117,0,0,21,21,OFFICE NO. 2 OKLAHOMA CITY PUBLIC SCHOOLS
OKLAHOMA,"COUNCILMEMBER, WARD 7 CITY OF OKLAHOMA CITY","JOHN A. PETTIS, JR.",,550118,0,0,66,66,"COUNCILMEMBER, WARD 7 CITY OF OKLAHOMA CITY"
OKLAHOMA,"COUNCILMEMBER, WARD 7 CITY OF OKLAHOMA CITY",MARINA MANGIARACINA,,550118,0,0,2,2,"COUNCILMEMBER, WARD 7 CITY OF OKLAHOMA CITY"
OKLAHOMA,"COUNCILMEMBER, WARD 7 CITY OF OKLAHOMA CITY",T. SHERI DICKERSON,,550118,0,0,8,8,"COUNCILMEMBER, WARD 7 CITY OF OKLAHOMA CITY"
OKLAHOMA,BOARD CHAIRPERSON OKLAHOMA CITY PUBLIC SCHOOLS,PAULA LEWIS,,550118,0,0,27,27,
OKLAHOMA,BOARD CHAIRPERSON OKLAHOMA CITY PUBLIC SCHOOLS,WILFREDO SANTOS RIVERA,,550118,0,0,17,17,
OKLAHOMA,BOARD CHAIRPERSON OKLAHOMA CITY PUBLIC SCHOOLS,GREGORY A. WYATT,,550118,0,0,13,13,
OKLAHOMA,BOARD CHAIRPERSON OKLAHOMA CITY PUBLIC SCHOOLS,BIANCA ROSE,,550118,0,0,19,19,
OKLAHOMA,BOARD CHAIRPERSON OKLAHOMA CITY PUBLIC SCHOOLS,STANLEY HUPFELD,,550118,0,0,34,34,
OKLAHOMA,OFFICE NO. 2 OKLAHOMA CITY PUBLIC SCHOOLS,JUSTIN ELLIS,,550118,0,0,29,29,OFFICE NO. 2 OKLAHOMA CITY PUBLIC SCHOOLS
OKLAHOMA,OFFICE NO. 2 OKLAHOMA CITY PUBLIC SCHOOLS,REBECCA L. BUDD,,550118,0,0,60,60,OFFICE NO. 2 OKLAHOMA CITY PUBLIC SCHOOLS
OKLAHOMA,OFFICE NO. 2 OKLAHOMA CITY PUBLIC SCHOOLS,NICK SINGER,,550118,0,0,25,25,OFFICE NO. 2 OKLAHOMA CITY PUBLIC SCHOOLS
OKLAHOMA,BOARD CHAIRPERSON OKLAHOMA CITY PUBLIC SCHOOLS,PAULA LEWIS,,550119,0,0,10,10,
OKLAHOMA,BOARD CHAIRPERSON OKLAHOMA CITY PUBLIC SCHOOLS,WILFREDO SANTOS RIVERA,,550119,0,0,0,0,
OKLAHOMA,BOARD CHAIRPERSON OKLAHOMA CITY PUBLIC SCHOOLS,GREGORY A. WYATT,,550119,0,0,0,0,
OKLAHOMA,BOARD CHAIRPERSON OKLAHOMA CITY PUBLIC SCHOOLS,BIANCA ROSE,,550119,0,0,1,1,
OKLAHOMA,BOARD CHAIRPERSON OKLAHOMA CITY PUBLIC SCHOOLS,STANLEY HUPFELD,,550119,0,0,25,25,
OKLAHOMA,OFFICE NO. 2 OKLAHOMA CITY PUBLIC SCHOOLS,JUSTIN ELLIS,,550119,0,0,25,25,OFFICE NO. 2 OKLAHOMA CITY PUBLIC SCHOOLS
OKLAHOMA,OFFICE NO. 2 OKLAHOMA CITY PUBLIC SCHOOLS,REBECCA L. BUDD,,550119,0,0,6,6,OFFICE NO. 2 OKLAHOMA CITY PUBLIC SCHOOLS
OKLAHOMA,OFFICE NO. 2 OKLAHOMA CITY PUBLIC SCHOOLS,NICK SINGER,,550119,0,0,7,7,OFFICE NO. 2 OKLAHOMA CITY PUBLIC SCHOOLS
OKLAHOMA,"COUNCILMEMBER, WARD 7 CITY OF OKLAHOMA CITY","JOHN A. PETTIS, JR.",,550120,0,0,10,10,"COUNCILMEMBER, WARD 7 CITY OF OKLAHOMA CITY"
OKLAHOMA,"COUNCILMEMBER, WARD 7 CITY OF OKLAHOMA CITY",MARINA MANGIARACINA,,550120,0,0,2,2,"COUNCILMEMBER, WARD 7 CITY OF OKLAHOMA CITY"
OKLAHOMA,"COUNCILMEMBER, WARD 7 CITY OF OKLAHOMA CITY",T. SHERI DICKERSON,,550120,0,0,4,4,"COUNCILMEMBER, WARD 7 CITY OF OKLAHOMA CITY"
OKLAHOMA,BOARD CHAIRPERSON OKLAHOMA CITY PUBLIC SCHOOLS,PAULA LEWIS,,550120,0,0,15,15,
OKLAHOMA,BOARD CHAIRPERSON OKLAHOMA CITY PUBLIC SCHOOLS,WILFREDO SANTOS RIVERA,,550120,0,0,6,6,
OKLAHOMA,BOARD CHAIRPERSON OKLAHOMA CITY PUBLIC SCHOOLS,GREGORY A. WYATT,,550120,0,0,7,7,
OKLAHOMA,BOARD CHAIRPERSON OKLAHOMA CITY PUBLIC SCHOOLS,BIANCA ROSE,,550120,0,0,9,9,
OKLAHOMA,BOARD CHAIRPERSON OKLAHOMA CITY PUBLIC SCHOOLS,STANLEY HUPFELD,,550120,0,0,55,55,
OKLAHOMA,OFFICE NO. 1 OKLAHOMA CITY PUBLIC SCHOOLS,NATHAN SHIRLEY,,550120,0,0,18,18,OFFICE NO. 1 OKLAHOMA CITY PUBLIC SCHOOLS
OKLAHOMA,OFFICE NO. 1 OKLAHOMA CITY PUBLIC SCHOOLS,CHARLES HENRY,,550120,0,0,58,58,OFFICE NO. 1 OKLAHOMA CITY PUBLIC SCHOOLS
OKLAHOMA,OFFICE NO. 1 OKLAHOMA CITY PUBLIC SCHOOLS,CHERYL POOLE,,550120,0,0,20,20,OFFICE NO. 1 OKLAHOMA CITY PUBLIC SCHOOLS
OKLAHOMA,"COUNCILMEMBER, WARD 7 CITY OF OKLAHOMA CITY","JOHN A. PETTIS, JR.",,550121,0,0,113,113,"COUNCILMEMBER, WARD 7 CITY OF OKLAHOMA CITY"
OKLAHOMA,"COUNCILMEMBER, WARD 7 CITY OF OKLAHOMA CITY",MARINA MANGIARACINA,,550121,0,0,7,7,"COUNCILMEMBER, WARD 7 CITY OF OKLAHOMA CITY"
OKLAHOMA,"COUNCILMEMBER, WARD 7 CITY OF OKLAHOMA CITY",T. SHERI DICKERSON,,550121,0,0,11,11,"COUNCILMEMBER, WARD 7 CITY OF OKLAHOMA CITY"
OKLAHOMA,BOARD CHAIRPERSON OKLAHOMA CITY PUBLIC SCHOOLS,PAULA LEWIS,,550121,0,0,40,40,
OKLAHOMA,BOARD CHAIRPERSON OKLAHOMA CITY PUBLIC SCHOOLS,WILFREDO SANTOS RIVERA,,550121,0,0,22,22,
OKLAHOMA,BOARD CHAIRPERSON OKLAHOMA CITY PUBLIC SCHOOLS,GREGORY A. WYATT,,550121,0,0,9,9,
OKLAHOMA,BOARD CHAIRPERSON OKLAHOMA CITY PUBLIC SCHOOLS,BIANCA ROSE,,550121,0,0,19,19,
OKLAHOMA,BOARD CHAIRPERSON OKLAHOMA CITY PUBLIC SCHOOLS,STANLEY HUPFELD,,550121,0,0,36,36,
OKLAHOMA,OFFICE NO. 1 OKLAHOMA CITY PUBLIC SCHOOLS,NATHAN SHIRLEY,,550121,0,0,19,19,OFFICE NO. 1 OKLAHOMA CITY PUBLIC SCHOOLS
OKLAHOMA,OFFICE NO. 1 OKLAHOMA CITY PUBLIC SCHOOLS,CHARLES HENRY,,550121,0,0,85,85,OFFICE NO. 1 OKLAHOMA CITY PUBLIC SCHOOLS
OKLAHOMA,OFFICE NO. 1 OKLAHOMA CITY PUBLIC SCHOOLS,CHERYL POOLE,,550121,0,0,27,27,OFFICE NO. 1 OKLAHOMA CITY PUBLIC SCHOOLS
OKLAHOMA,BOARD CHAIRPERSON OKLAHOMA CITY PUBLIC SCHOOLS,PAULA LEWIS,,550122,0,0,22,22,
OKLAHOMA,BOARD CHAIRPERSON OKLAHOMA CITY PUBLIC SCHOOLS,WILFREDO SANTOS RIVERA,,550122,0,0,11,11,
OKLAHOMA,BOARD CHAIRPERSON OKLAHOMA CITY PUBLIC SCHOOLS,GREGORY A. WYATT,,550122,0,0,7,7,
OKLAHOMA,BOARD CHAIRPERSON OKLAHOMA CITY PUBLIC SCHOOLS,BIANCA ROSE,,550122,0,0,4,4,
OKLAHOMA,BOARD CHAIRPERSON OKLAHOMA CITY PUBLIC SCHOOLS,STANLEY HUPFELD,,550122,0,0,57,57,
OKLAHOMA,OFFICE NO. 1 OKLAHOMA CITY PUBLIC SCHOOLS,NATHAN SHIRLEY,,550122,0,0,14,14,OFFICE NO. 1 OKLAHOMA CITY PUBLIC SCHOOLS
OKLAHOMA,OFFICE NO. 1 OKLAHOMA CITY PUBLIC SCHOOLS,CHARLES HENRY,,550122,0,0,63,63,OFFICE NO. 1 OKLAHOMA CITY PUBLIC SCHOOLS
OKLAHOMA,OFFICE NO. 1 OKLAHOMA CITY PUBLIC SCHOOLS,CHERYL POOLE,,550122,0,0,28,28,OFFICE NO. 1 OKLAHOMA CITY PUBLIC SCHOOLS
OKLAHOMA,BOARD CHAIRPERSON OKLAHOMA CITY PUBLIC SCHOOLS,PAULA LEWIS,,550123,0,0,34,34,
OKLAHOMA,BOARD CHAIRPERSON OKLAHOMA CITY PUBLIC SCHOOLS,WILFREDO SANTOS RIVERA,,550123,0,0,27,27,
OKLAHOMA,BOARD CHAIRPERSON OKLAHOMA CITY PUBLIC SCHOOLS,GREGORY A. WYATT,,550123,0,0,12,12,
OKLAHOMA,BOARD CHAIRPERSON OKLAHOMA CITY PUBLIC SCHOOLS,BIANCA ROSE,,550123,0,0,14,14,
OKLAHOMA,BOARD CHAIRPERSON OKLAHOMA CITY PUBLIC SCHOOLS,STANLEY HUPFELD,,550123,0,0,86,86,
OKLAHOMA,OFFICE NO. 1 OKLAHOMA CITY PUBLIC SCHOOLS,NATHAN SHIRLEY,,550123,0,0,22,22,OFFICE NO. 1 OKLAHOMA CITY PUBLIC SCHOOLS
OKLAHOMA,OFFICE NO. 1 OKLAHOMA CITY PUBLIC SCHOOLS,CHARLES HENRY,,550123,0,0,100,100,OFFICE NO. 1 OKLAHOMA CITY PUBLIC SCHOOLS
OKLAHOMA,OFFICE NO. 1 OKLAHOMA CITY PUBLIC SCHOOLS,CHERYL POOLE,,550123,0,0,52,52,OFFICE NO. 1 OKLAHOMA CITY PUBLIC SCHOOLS
OKLAHOMA,BOARD CHAIRPERSON OKLAHOMA CITY PUBLIC SCHOOLS,PAULA LEWIS,,550124,0,0,23,23,
OKLAHOMA,BOARD CHAIRPERSON OKLAHOMA CITY PUBLIC SCHOOLS,WILFREDO SANTOS RIVERA,,550124,0,0,12,12,
OKLAHOMA,BOARD CHAIRPERSON OKLAHOMA CITY PUBLIC SCHOOLS,GREGORY A. WYATT,,550124,0,0,2,2,
OKLAHOMA,BOARD CHAIRPERSON OKLAHOMA CITY PUBLIC SCHOOLS,BIANCA ROSE,,550124,0,0,8,8,
OKLAHOMA,BOARD CHAIRPERSON OKLAHOMA CITY PUBLIC SCHOOLS,STANLEY HUPFELD,,550124,0,0,79,79,
OKLAHOMA,OFFICE NO. 1 OKLAHOMA CITY PUBLIC SCHOOLS,NATHAN SHIRLEY,,550124,0,0,30,30,OFFICE NO. 1 OKLAHOMA CITY PUBLIC SCHOOLS
OKLAHOMA,OFFICE NO. 1 OKLAHOMA CITY PUBLIC SCHOOLS,CHARLES HENRY,,550124,0,0,64,64,OFFICE NO. 1 OKLAHOMA CITY PUBLIC SCHOOLS
OKLAHOMA,OFFICE NO. 1 OKLAHOMA CITY PUBLIC SCHOOLS,CHERYL POOLE,,550124,0,0,31,31,OFFICE NO. 1 OKLAHOMA CITY PUBLIC SCHOOLS
OKLAHOMA,BOARD CHAIRPERSON OKLAHOMA CITY PUBLIC SCHOOLS,PAULA LEWIS,,550125,0,0,2,2,
OKLAHOMA,BOARD CHAIRPERSON OKLAHOMA CITY PUBLIC SCHOOLS,WILFREDO SANTOS RIVERA,,550125,0,0,4,4,
OKLAHOMA,BOARD CHAIRPERSON OKLAHOMA CITY PUBLIC SCHOOLS,GREGORY A. WYATT,,550125,0,0,1,1,
OKLAHOMA,BOARD CHAIRPERSON OKLAHOMA CITY PUBLIC SCHOOLS,BIANCA ROSE,,550125,0,0,1,1,
OKLAHOMA,BOARD CHAIRPERSON OKLAHOMA CITY PUBLIC SCHOOLS,STANLEY HUPFELD,,550125,0,0,4,4,
OKLAHOMA,OFFICE NO. 1 OKLAHOMA CITY PUBLIC SCHOOLS,NATHAN SHIRLEY,,550125,0,0,1,1,OFFICE NO. 1 OKLAHOMA CITY PUBLIC SCHOOLS
OKLAHOMA,OFFICE NO. 1 OKLAHOMA CITY PUBLIC SCHOOLS,CHARLES HENRY,,550125,0,0,6,6,OFFICE NO. 1 OKLAHOMA CITY PUBLIC SCHOOLS
OKLAHOMA,OFFICE NO. 1 OKLAHOMA CITY PUBLIC SCHOOLS,CHERYL POOLE,,550125,0,0,5,5,OFFICE NO. 1 OKLAHOMA CITY PUBLIC SCHOOLS
OKLAHOMA,"COUNCILMEMBER, WARD 7 CITY OF OKLAHOMA CITY","JOHN A. PETTIS, JR.",,550126,0,0,0,0,"COUNCILMEMBER, WARD 7 CITY OF OKLAHOMA CITY"
OKLAHOMA,"COUNCILMEMBER, WARD 7 CITY OF OKLAHOMA CITY",MARINA MANGIARACINA,,550126,0,0,0,0,"COUNCILMEMBER, WARD 7 CITY OF OKLAHOMA CITY"
OKLAHOMA,"COUNCILMEMBER, WARD 7 CITY OF OKLAHOMA CITY",T. SHERI DICKERSON,,550126,0,0,0,0,"COUNCILMEMBER, WARD 7 CITY OF OKLAHOMA CITY"
OKLAHOMA,PROPOSITION NO. 1 EDMOND PUBLIC SCHOOLS,FOR THE PROPOSITION - YES,,550126,0,0,3,3,PROPOSITION NO. 1 EDMOND PUBLIC SCHOOLS
OKLAHOMA,PROPOSITION NO. 1 EDMOND PUBLIC SCHOOLS,AGAINST THE PROPOSITION - NO,,550126,0,0,0,0,PROPOSITION NO. 1 EDMOND PUBLIC SCHOOLS
OKLAHOMA,PROPOSITION NO. 2 EDMOND PUBLIC SCHOOLS,FOR THE PROPOSITION - YES,,550126,0,0,3,3,PROPOSITION NO. 2 EDMOND PUBLIC SCHOOLS
OKLAHOMA,PROPOSITION NO. 2 EDMOND PUBLIC SCHOOLS,AGAINST THE PROPOSITION - NO,,550126,0,0,0,0,PROPOSITION NO. 2 EDMOND PUBLIC SCHOOLS
OKLAHOMA,OFFICE NO. 2 FRANCIS TUTTLE TECH CENTER,PETE LEE,,550126,0,0,1,1,OFFICE NO. 2 FRANCIS TUTTLE TECH CENTER
OKLAHOMA,OFFICE NO. 2 FRANCIS TUTTLE TECH CENTER,ROBERT STONE,,550126,0,0,2,2,OFFICE NO. 2 FRANCIS TUTTLE TECH CENTER
OKLAHOMA,BOARD CHAIRPERSON OKLAHOMA CITY PUBLIC SCHOOLS,PAULA LEWIS,,550126,0,0,10,10,
OKLAHOMA,BOARD CHAIRPERSON OKLAHOMA CITY PUBLIC SCHOOLS,WILFREDO SANTOS RIVERA,,550126,0,0,3,3,
OKLAHOMA,BOARD CHAIRPERSON OKLAHOMA CITY PUBLIC SCHOOLS,GREGORY A. WYATT,,550126,0,0,3,3,
OKLAHOMA,BOARD CHAIRPERSON OKLAHOMA CITY PUBLIC SCHOOLS,BIANCA ROSE,,550126,0,0,3,3,
OKLAHOMA,BOARD CHAIRPERSON OKLAHOMA CITY PUBLIC SCHOOLS,STANLEY HUPFELD,,550126,0,0,28,28,
OKLAHOMA,OFFICE NO. 1 OKLAHOMA CITY PUBLIC SCHOOLS,NATHAN SHIRLEY,,550126,0,0,9,9,OFFICE NO. 1 OKLAHOMA CITY PUBLIC SCHOOLS
OKLAHOMA,OFFICE NO. 1 OKLAHOMA CITY PUBLIC SCHOOLS,CHARLES HENRY,,550126,0,0,20,20,OFFICE NO. 1 OKLAHOMA CITY PUBLIC SCHOOLS
OKLAHOMA,OFFICE NO. 1 OKLAHOMA CITY PUBLIC SCHOOLS,CHERYL POOLE,,550126,0,0,18,18,OFFICE NO. 1 OKLAHOMA CITY PUBLIC SCHOOLS
OKLAHOMA,"COUNCILMEMBER, WARD 7 CITY OF OKLAHOMA CITY","JOHN A. PETTIS, JR.",,550127,0,0,66,66,"COUNCILMEMBER, WARD 7 CITY OF OKLAHOMA CITY"
OKLAHOMA,"COUNCILMEMBER, WARD 7 CITY OF OKLAHOMA CITY",MARINA MANGIARACINA,,550127,0,0,13,13,"COUNCILMEMBER, WARD 7 CITY OF OKLAHOMA CITY"
OKLAHOMA,"COUNCILMEMBER, WARD 7 CITY OF OKLAHOMA CITY",T. SHERI DICKERSON,,550127,0,0,16,16,"COUNCILMEMBER, WARD 7 CITY OF OKLAHOMA CITY"
OKLAHOMA,PROPOSITION NO. 1 EDMOND PUBLIC SCHOOLS,FOR THE PROPOSITION - YES,,550127,0,0,81,81,PROPOSITION NO. 1 EDMOND PUBLIC SCHOOLS
OKLAHOMA,PROPOSITION NO. 1 EDMOND PUBLIC SCHOOLS,AGAINST THE PROPOSITION - NO,,550127,0,0,17,17,PROPOSITION NO. 1 EDMOND PUBLIC SCHOOLS
OKLAHOMA,PROPOSITION NO. 2 EDMOND PUBLIC SCHOOLS,FOR THE PROPOSITION - YES,,550127,0,0,78,78,PROPOSITION NO. 2 EDMOND PUBLIC SCHOOLS
OKLAHOMA,PROPOSITION NO. 2 EDMOND PUBLIC SCHOOLS,AGAINST THE PROPOSITION - NO,,550127,0,0,19,19,PROPOSITION NO. 2 EDMOND PUBLIC SCHOOLS
OKLAHOMA,OFFICE NO. 2 FRANCIS TUTTLE TECH CENTER,PETE LEE,,550127,0,0,35,35,OFFICE NO. 2 FRANCIS TUTTLE TECH CENTER
OKLAHOMA,OFFICE NO. 2 FRANCIS TUTTLE TECH CENTER,ROBERT STONE,,550127,0,0,53,53,OFFICE NO. 2 FRANCIS TUTTLE TECH CENTER
OKLAHOMA,PROPOSITION NO. 1 EDMOND PUBLIC SCHOOLS,FOR THE PROPOSITION - YES,,550128,0,0,40,40,PROPOSITION NO. 1 EDMOND PUBLIC SCHOOLS
OKLAHOMA,PROPOSITION NO. 1 EDMOND PUBLIC SCHOOLS,AGAINST THE PROPOSITION - NO,,550128,0,0,6,6,PROPOSITION NO. 1 EDMOND PUBLIC SCHOOLS
OKLAHOMA,PROPOSITION NO. 2 EDMOND PUBLIC SCHOOLS,FOR THE PROPOSITION - YES,,550128,0,0,38,38,PROPOSITION NO. 2 EDMOND PUBLIC SCHOOLS
OKLAHOMA,PROPOSITION NO. 2 EDMOND PUBLIC SCHOOLS,AGAINST THE PROPOSITION - NO,,550128,0,0,7,7,PROPOSITION NO. 2 EDMOND PUBLIC SCHOOLS
OKLAHOMA,OFFICE NO. 2 FRANCIS TUTTLE TECH CENTER,PETE LEE,,550128,0,0,12,12,OFFICE NO. 2 FRANCIS TUTTLE TECH CENTER
OKLAHOMA,OFFICE NO. 2 FRANCIS TUTTLE TECH CENTER,ROBERT STONE,,550128,0,0,27,27,OFFICE NO. 2 FRANCIS TUTTLE TECH CENTER
OKLAHOMA,PROPOSITION NO. 1 EDMOND PUBLIC SCHOOLS,FOR THE PROPOSITION - YES,,550129,0,0,40,40,PROPOSITION NO. 1 EDMOND PUBLIC SCHOOLS
OKLAHOMA,PROPOSITION NO. 1 EDMOND PUBLIC SCHOOLS,AGAINST THE PROPOSITION - NO,,550129,0,0,7,7,PROPOSITION NO. 1 EDMOND PUBLIC SCHOOLS
OKLAHOMA,PROPOSITION NO. 2 EDMOND PUBLIC SCHOOLS,FOR THE PROPOSITION - YES,,550129,0,0,37,37,PROPOSITION NO. 2 EDMOND PUBLIC SCHOOLS
OKLAHOMA,PROPOSITION NO. 2 EDMOND PUBLIC SCHOOLS,AGAINST THE PROPOSITION - NO,,550129,0,0,8,8,PROPOSITION NO. 2 EDMOND PUBLIC SCHOOLS
OKLAHOMA,OFFICE NO. 2 FRANCIS TUTTLE TECH CENTER,PETE LEE,,550129,0,0,6,6,OFFICE NO. 2 FRANCIS TUTTLE TECH CENTER
OKLAHOMA,OFFICE NO. 2 FRANCIS TUTTLE TECH CENTER,ROBERT STONE,,550129,0,0,28,28,OFFICE NO. 2 FRANCIS TUTTLE TECH CENTER
OKLAHOMA,PROPOSITION NO. 1 EDMOND PUBLIC SCHOOLS,FOR THE PROPOSITION - YES,,550130,0,0,67,67,PROPOSITION NO. 1 EDMOND PUBLIC SCHOOLS
OKLAHOMA,PROPOSITION NO. 1 EDMOND PUBLIC SCHOOLS,AGAINST THE PROPOSITION - NO,,550130,0,0,15,15,PROPOSITION NO. 1 EDMOND PUBLIC SCHOOLS
OKLAHOMA,PROPOSITION NO. 2 EDMOND PUBLIC SCHOOLS,FOR THE PROPOSITION - YES,,550130,0,0,65,65,PROPOSITION NO. 2 EDMOND PUBLIC SCHOOLS
OKLAHOMA,PROPOSITION NO. 2 EDMOND PUBLIC SCHOOLS,AGAINST THE PROPOSITION - NO,,550130,0,0,17,17,PROPOSITION NO. 2 EDMOND PUBLIC SCHOOLS
OKLAHOMA,OFFICE NO. 2 FRANCIS TUTTLE TECH CENTER,PETE LEE,,550130,0,0,19,19,OFFICE NO. 2 FRANCIS TUTTLE TECH CENTER
OKLAHOMA,OFFICE NO. 2 FRANCIS TUTTLE TECH CENTER,ROBERT STONE,,550130,0,0,53,53,OFFICE NO. 2 FRANCIS TUTTLE TECH CENTER
OKLAHOMA,PROPOSITION NO. 1 EDMOND PUBLIC SCHOOLS,FOR THE PROPOSITION - YES,,550131,0,0,34,34,PROPOSITION NO. 1 EDMOND PUBLIC SCHOOLS
OKLAHOMA,PROPOSITION NO. 1 EDMOND PUBLIC SCHOOLS,AGAINST THE PROPOSITION - NO,,550131,0,0,4,4,PROPOSITION NO. 1 EDMOND PUBLIC SCHOOLS
OKLAHOMA,PROPOSITION NO. 2 EDMOND PUBLIC SCHOOLS,FOR THE PROPOSITION - YES,,550131,0,0,32,32,PROPOSITION NO. 2 EDMOND PUBLIC SCHOOLS
OKLAHOMA,PROPOSITION NO. 2 EDMOND PUBLIC SCHOOLS,AGAINST THE PROPOSITION - NO,,550131,0,0,6,6,PROPOSITION NO. 2 EDMOND PUBLIC SCHOOLS
OKLAHOMA,OFFICE NO. 2 FRANCIS TUTTLE TECH CENTER,PETE LEE,,550131,0,0,10,10,OFFICE NO. 2 FRANCIS TUTTLE TECH CENTER
OKLAHOMA,OFFICE NO. 2 FRANCIS TUTTLE TECH CENTER,ROBERT STONE,,550131,0,0,22,22,OFFICE NO. 2 FRANCIS TUTTLE TECH CENTER
OKLAHOMA,"COUNCILMEMBER, WARD 7 CITY OF OKLAHOMA CITY","JOHN A. PETTIS, JR.",,550132,0,0,34,34,"COUNCILMEMBER, WARD 7 CITY OF OKLAHOMA CITY"
OKLAHOMA,"COUNCILMEMBER, WARD 7 CITY OF OKLAHOMA CITY",MARINA MANGIARACINA,,550132,0,0,11,11,"COUNCILMEMBER, WARD 7 CITY OF OKLAHOMA CITY"
OKLAHOMA,"COUNCILMEMBER, WARD 7 CITY OF OKLAHOMA CITY",T. SHERI DICKERSON,,550132,0,0,25,25,"COUNCILMEMBER, WARD 7 CITY OF OKLAHOMA CITY"
OKLAHOMA,PROPOSITION NO. 1 EDMOND PUBLIC SCHOOLS,FOR THE PROPOSITION - YES,,550132,0,0,63,63,PROPOSITION NO. 1 EDMOND PUBLIC SCHOOLS
OKLAHOMA,PROPOSITION NO. 1 EDMOND PUBLIC SCHOOLS,AGAINST THE PROPOSITION - NO,,550132,0,0,11,11,PROPOSITION NO. 1 EDMOND PUBLIC SCHOOLS
OKLAHOMA,PROPOSITION NO. 2 EDMOND PUBLIC SCHOOLS,FOR THE PROPOSITION - YES,,550132,0,0,62,62,PROPOSITION NO. 2 EDMOND PUBLIC SCHOOLS
OKLAHOMA,PROPOSITION NO. 2 EDMOND PUBLIC SCHOOLS,AGAINST THE PROPOSITION - NO,,550132,0,0,13,13,PROPOSITION NO. 2 EDMOND PUBLIC SCHOOLS
OKLAHOMA,OFFICE NO. 2 FRANCIS TUTTLE TECH CENTER,PETE LEE,,550132,0,0,20,20,OFFICE NO. 2 FRANCIS TUTTLE TECH CENTER
OKLAHOMA,OFFICE NO. 2 FRANCIS TUTTLE TECH CENTER,ROBERT STONE,,550132,0,0,48,48,OFFICE NO. 2 FRANCIS TUTTLE TECH CENTER
OKLAHOMA,"COUNCILMEMBER, WARD 7 CITY OF OKLAHOMA CITY","JOHN A. PETTIS, JR.",,550133,0,0,44,44,"COUNCILMEMBER, WARD 7 CITY OF OKLAHOMA CITY"
OKLAHOMA,"COUNCILMEMBER, WARD 7 CITY OF OKLAHOMA CITY",MARINA MANGIARACINA,,550133,0,0,12,12,"COUNCILMEMBER, WARD 7 CITY OF OKLAHOMA CITY"
OKLAHOMA,"COUNCILMEMBER, WARD 7 CITY OF OKLAHOMA CITY",T. SHERI DICKERSON,,550133,0,0,15,15,"COUNCILMEMBER, WARD 7 CITY OF OKLAHOMA CITY"
OKLAHOMA,OFFICE NO. 2 EDMOND PUBLIC SCHOOLS,KATHLEEN M. DUNCAN,,550133,0,0,36,36,OFFICE NO. 2 EDMOND PUBLIC SCHOOLS
OKLAHOMA,OFFICE NO. 2 EDMOND PUBLIC SCHOOLS,CHAD MULLEN,,550133,0,0,37,37,OFFICE NO. 2 EDMOND PUBLIC SCHOOLS
OKLAHOMA,PROPOSITION NO. 1 EDMOND PUBLIC SCHOOLS,FOR THE PROPOSITION - YES,,550133,0,0,57,57,PROPOSITION NO. 1 EDMOND PUBLIC SCHOOLS
OKLAHOMA,PROPOSITION NO. 1 EDMOND PUBLIC SCHOOLS,AGAINST THE PROPOSITION - NO,,550133,0,0,16,16,PROPOSITION NO. 1 EDMOND PUBLIC SCHOOLS
OKLAHOMA,PROPOSITION NO. 2 EDMOND PUBLIC SCHOOLS,FOR THE PROPOSITION - YES,,550133,0,0,57,57,PROPOSITION NO. 2 EDMOND PUBLIC SCHOOLS
OKLAHOMA,PROPOSITION NO. 2 EDMOND PUBLIC SCHOOLS,AGAINST THE PROPOSITION - NO,,550133,0,0,15,15,PROPOSITION NO. 2 EDMOND PUBLIC SCHOOLS
OKLAHOMA,OFFICE NO. 2 FRANCIS TUTTLE TECH CENTER,PETE LEE,,550133,0,0,26,26,OFFICE NO. 2 FRANCIS TUTTLE TECH CENTER
OKLAHOMA,OFFICE NO. 2 FRANCIS TUTTLE TECH CENTER,ROBERT STONE,,550133,0,0,42,42,OFFICE NO. 2 FRANCIS TUTTLE TECH CENTER
OKLAHOMA,OFFICE NO. 2 EDMOND PUBLIC SCHOOLS,KATHLEEN M. DUNCAN,,550134,0,0,109,109,OFFICE NO. 2 EDMOND PUBLIC SCHOOLS
OKLAHOMA,OFFICE NO. 2 EDMOND PUBLIC SCHOOLS,CHAD MULLEN,,550134,0,0,49,49,OFFICE NO. 2 EDMOND PUBLIC SCHOOLS
OKLAHOMA,PROPOSITION NO. 1 EDMOND PUBLIC SCHOOLS,FOR THE PROPOSITION - YES,,550134,0,0,153,153,PROPOSITION NO. 1 EDMOND PUBLIC SCHOOLS
OKLAHOMA,PROPOSITION NO. 1 EDMOND PUBLIC SCHOOLS,AGAINST THE PROPOSITION - NO,,550134,0,0,16,16,PROPOSITION NO. 1 EDMOND PUBLIC SCHOOLS
OKLAHOMA,PROPOSITION NO. 2 EDMOND PUBLIC SCHOOLS,FOR THE PROPOSITION - YES,,550134,0,0,149,149,PROPOSITION NO. 2 EDMOND PUBLIC SCHOOLS
OKLAHOMA,PROPOSITION NO. 2 EDMOND PUBLIC SCHOOLS,AGAINST THE PROPOSITION - NO,,550134,0,0,20,20,PROPOSITION NO. 2 EDMOND PUBLIC SCHOOLS
OKLAHOMA,OFFICE NO. 2 FRANCIS TUTTLE TECH CENTER,PETE LEE,,550134,0,0,66,66,OFFICE NO. 2 FRANCIS TUTTLE TECH CENTER
OKLAHOMA,OFFICE NO. 2 FRANCIS TUTTLE TECH CENTER,ROBERT STONE,,550134,0,0,76,76,OFFICE NO. 2 FRANCIS TUTTLE TECH CENTER
OKLAHOMA,OFFICE NO. 2 DEER CREEK PUBLIC SCHOOLS,TOM CORBIN,,550135,0,0,0,0,OFFICE NO. 2 DEER CREEK PUBLIC SCHOOLS
OKLAHOMA,OFFICE NO. 2 DEER CREEK PUBLIC SCHOOLS,ANDI NEAVES,,550135,0,0,2,2,OFFICE NO. 2 DEER CREEK PUBLIC SCHOOLS
OKLAHOMA,OFFICE NO. 2 EDMOND PUBLIC SCHOOLS,KATHLEEN M. DUNCAN,,550135,0,0,22,22,OFFICE NO. 2 EDMOND PUBLIC SCHOOLS
OKLAHOMA,OFFICE NO. 2 EDMOND PUBLIC SCHOOLS,CHAD MULLEN,,550135,0,0,16,16,OFFICE NO. 2 EDMOND PUBLIC SCHOOLS
OKLAHOMA,PROPOSITION NO. 1 EDMOND PUBLIC SCHOOLS,FOR THE PROPOSITION - YES,,550135,0,0,41,41,PROPOSITION NO. 1 EDMOND PUBLIC SCHOOLS
OKLAHOMA,PROPOSITION NO. 1 EDMOND PUBLIC SCHOOLS,AGAINST THE PROPOSITION - NO,,550135,0,0,3,3,PROPOSITION NO. 1 EDMOND PUBLIC SCHOOLS
OKLAHOMA,PROPOSITION NO. 2 EDMOND PUBLIC SCHOOLS,FOR THE PROPOSITION - YES,,550135,0,0,41,41,PROPOSITION NO. 2 EDMOND PUBLIC SCHOOLS
OKLAHOMA,PROPOSITION NO. 2 EDMOND PUBLIC SCHOOLS,AGAINST THE PROPOSITION - NO,,550135,0,0,3,3,PROPOSITION NO. 2 EDMOND PUBLIC SCHOOLS
OKLAHOMA,OFFICE NO. 2 FRANCIS TUTTLE TECH CENTER,PETE LEE,,550135,0,0,21,21,OFFICE NO. 2 FRANCIS TUTTLE TECH CENTER
OKLAHOMA,OFFICE NO. 2 FRANCIS TUTTLE TECH CENTER,ROBERT STONE,,550135,0,0,18,18,OFFICE NO. 2 FRANCIS TUTTLE TECH CENTER
OKLAHOMA,OFFICE NO. 2 DEER CREEK PUBLIC SCHOOLS,TOM CORBIN,,550136,0,0,5,5,OFFICE NO. 2 DEER CREEK PUBLIC SCHOOLS
OKLAHOMA,OFFICE NO. 2 DEER CREEK PUBLIC SCHOOLS,ANDI NEAVES,,550136,0,0,10,10,OFFICE NO. 2 DEER CREEK PUBLIC SCHOOLS
OKLAHOMA,OFFICE NO. 2 EDMOND PUBLIC SCHOOLS,KATHLEEN M. DUNCAN,,550136,0,0,94,94,OFFICE NO. 2 EDMOND PUBLIC SCHOOLS
OKLAHOMA,OFFICE NO. 2 EDMOND PUBLIC SCHOOLS,CHAD MULLEN,,550136,0,0,45,45,OFFICE NO. 2 EDMOND PUBLIC SCHOOLS
OKLAHOMA,PROPOSITION NO. 1 EDMOND PUBLIC SCHOOLS,FOR THE PROPOSITION - YES,,550136,0,0,126,126,PROPOSITION NO. 1 EDMOND PUBLIC SCHOOLS
OKLAHOMA,PROPOSITION NO. 1 EDMOND PUBLIC SCHOOLS,AGAINST THE PROPOSITION - NO,,550136,0,0,20,20,PROPOSITION NO. 1 EDMOND PUBLIC SCHOOLS
OKLAHOMA,PROPOSITION NO. 2 EDMOND PUBLIC SCHOOLS,FOR THE PROPOSITION - YES,,550136,0,0,125,125,PROPOSITION NO. 2 EDMOND PUBLIC SCHOOLS
OKLAHOMA,PROPOSITION NO. 2 EDMOND PUBLIC SCHOOLS,AGAINST THE PROPOSITION - NO,,550136,0,0,21,21,PROPOSITION NO. 2 EDMOND PUBLIC SCHOOLS
OKLAHOMA,OFFICE NO. 2 FRANCIS TUTTLE TECH CENTER,PETE LEE,,550136,0,0,58,58,OFFICE NO. 2 FRANCIS TUTTLE TECH CENTER
OKLAHOMA,OFFICE NO. 2 FRANCIS TUTTLE TECH CENTER,ROBERT STONE,,550136,0,0,83,83,OFFICE NO. 2 FRANCIS TUTTLE TECH CENTER
OKLAHOMA,OFFICE NO. 2 DEER CREEK PUBLIC SCHOOLS,TOM CORBIN,,550137,0,0,20,20,OFFICE NO. 2 DEER CREEK PUBLIC SCHOOLS
OKLAHOMA,OFFICE NO. 2 DEER CREEK PUBLIC SCHOOLS,ANDI NEAVES,,550137,0,0,83,83,OFFICE NO. 2 DEER CREEK PUBLIC SCHOOLS
OKLAHOMA,OFFICE NO. 2 EDMOND PUBLIC SCHOOLS,KATHLEEN M. DUNCAN,,550137,0,0,2,2,OFFICE NO. 2 EDMOND PUBLIC SCHOOLS
OKLAHOMA,OFFICE NO. 2 EDMOND PUBLIC SCHOOLS,CHAD MULLEN,,550137,0,0,0,0,OFFICE NO. 2 EDMOND PUBLIC SCHOOLS
OKLAHOMA,PROPOSITION NO. 1 EDMOND PUBLIC SCHOOLS,FOR THE PROPOSITION - YES,,550137,0,0,2,2,PROPOSITION NO. 1 EDMOND PUBLIC SCHOOLS
OKLAHOMA,PROPOSITION NO. 1 EDMOND PUBLIC SCHOOLS,AGAINST THE PROPOSITION - NO,,550137,0,0,0,0,PROPOSITION NO. 1 EDMOND PUBLIC SCHOOLS
OKLAHOMA,PROPOSITION NO. 2 EDMOND PUBLIC SCHOOLS,FOR THE PROPOSITION - YES,,550137,0,0,2,2,PROPOSITION NO. 2 EDMOND PUBLIC SCHOOLS
OKLAHOMA,PROPOSITION NO. 2 EDMOND PUBLIC SCHOOLS,AGAINST THE PROPOSITION - NO,,550137,0,0,0,0,PROPOSITION NO. 2 EDMOND PUBLIC SCHOOLS
OKLAHOMA,OFFICE NO. 2 FRANCIS TUTTLE TECH CENTER,PETE LEE,,550137,0,0,42,42,OFFICE NO. 2 FRANCIS TUTTLE TECH CENTER
OKLAHOMA,OFFICE NO. 2 FRANCIS TUTTLE TECH CENTER,ROBERT STONE,,550137,0,0,45,45,OFFICE NO. 2 FRANCIS TUTTLE TECH CENTER
OKLAHOMA,OFFICE NO. 2 DEER CREEK PUBLIC SCHOOLS,TOM CORBIN,,550138,0,0,0,0,OFFICE NO. 2 DEER CREEK PUBLIC SCHOOLS
OKLAHOMA,OFFICE NO. 2 DEER CREEK PUBLIC SCHOOLS,ANDI NEAVES,,550138,0,0,9,9,OFFICE NO. 2 DEER CREEK PUBLIC SCHOOLS
OKLAHOMA,OFFICE NO. 2 FRANCIS TUTTLE TECH CENTER,PETE LEE,,550138,0,0,4,4,OFFICE NO. 2 FRANCIS TUTTLE TECH CENTER
OKLAHOMA,OFFICE NO. 2 FRANCIS TUTTLE TECH CENTER,ROBERT STONE,,550138,0,0,4,4,OFFICE NO. 2 FRANCIS TUTTLE TECH CENTER
OKLAHOMA,OFFICE NO. 2 DEER CREEK PUBLIC SCHOOLS,TOM CORBIN,,550139,0,0,24,24,OFFICE NO. 2 DEER CREEK PUBLIC SCHOOLS
OKLAHOMA,OFFICE NO. 2 DEER CREEK PUBLIC SCHOOLS,ANDI NEAVES,,550139,0,0,113,113,OFFICE NO. 2 DEER CREEK PUBLIC SCHOOLS
OKLAHOMA,PROPOSITION NO. 1 EDMOND PUBLIC SCHOOLS,FOR THE PROPOSITION - YES,,550139,0,0,14,14,PROPOSITION NO. 1 EDMOND PUBLIC SCHOOLS
OKLAHOMA,PROPOSITION NO. 1 EDMOND PUBLIC SCHOOLS,AGAINST THE PROPOSITION - NO,,550139,0,0,0,0,PROPOSITION NO. 1 EDMOND PUBLIC SCHOOLS
OKLAHOMA,PROPOSITION NO. 2 EDMOND PUBLIC SCHOOLS,FOR THE PROPOSITION - YES,,550139,0,0,14,14,PROPOSITION NO. 2 EDMOND PUBLIC SCHOOLS
OKLAHOMA,PROPOSITION NO. 2 EDMOND PUBLIC SCHOOLS,AGAINST THE PROPOSITION - NO,,550139,0,0,0,0,PROPOSITION NO. 2 EDMOND PUBLIC SCHOOLS
OKLAHOMA,OFFICE NO. 2 FRANCIS TUTTLE TECH CENTER,PETE LEE,,550139,0,0,54,54,OFFICE NO. 2 FRANCIS TUTTLE TECH CENTER
OKLAHOMA,OFFICE NO. 2 FRANCIS TUTTLE TECH CENTER,ROBERT STONE,,550139,0,0,83,83,OFFICE NO. 2 FRANCIS TUTTLE TECH CENTER
OKLAHOMA,OFFICE NO. 2 DEER CREEK PUBLIC SCHOOLS,TOM CORBIN,,550140,0,0,7,7,OFFICE NO. 2 DEER CREEK PUBLIC SCHOOLS
OKLAHOMA,OFFICE NO. 2 DEER CREEK PUBLIC SCHOOLS,ANDI NEAVES,,550140,0,0,89,89,OFFICE NO. 2 DEER CREEK PUBLIC SCHOOLS
OKLAHOMA,PROPOSITION NO. 1 EDMOND PUBLIC SCHOOLS,FOR THE PROPOSITION - YES,,550140,0,0,0,0,PROPOSITION NO. 1 EDMOND PUBLIC SCHOOLS
OKLAHOMA,PROPOSITION NO. 1 EDMOND PUBLIC SCHOOLS,AGAINST THE PROPOSITION - NO,,550140,0,0,1,1,PROPOSITION NO. 1 EDMOND PUBLIC SCHOOLS
OKLAHOMA,PROPOSITION NO. 2 EDMOND PUBLIC SCHOOLS,FOR THE PROPOSITION - YES,,550140,0,0,0,0,PROPOSITION NO. 2 EDMOND PUBLIC SCHOOLS
OKLAHOMA,PROPOSITION NO. 2 EDMOND PUBLIC SCHOOLS,AGAINST THE PROPOSITION - NO,,550140,0,0,1,1,PROPOSITION NO. 2 EDMOND PUBLIC SCHOOLS
OKLAHOMA,OFFICE NO. 2 FRANCIS TUTTLE TECH CENTER,PETE LEE,,550140,0,0,19,19,OFFICE NO. 2 FRANCIS TUTTLE TECH CENTER
OKLAHOMA,OFFICE NO. 2 FRANCIS TUTTLE TECH CENTER,ROBERT STONE,,550140,0,0,65,65,OFFICE NO. 2 FRANCIS TUTTLE TECH CENTER
OKLAHOMA,OFFICE NO. 2 DEER CREEK PUBLIC SCHOOLS,TOM CORBIN,,550141,0,0,13,13,OFFICE NO. 2 DEER CREEK PUBLIC SCHOOLS
OKLAHOMA,OFFICE NO. 2 DEER CREEK PUBLIC SCHOOLS,ANDI NEAVES,,550141,0,0,31,31,OFFICE NO. 2 DEER CREEK PUBLIC SCHOOLS
OKLAHOMA,OFFICE NO. 2 FRANCIS TUTTLE TECH CENTER,PETE LEE,,550141,0,0,20,20,OFFICE NO. 2 FRANCIS TUTTLE TECH CENTER
OKLAHOMA,OFFICE NO. 2 FRANCIS TUTTLE TECH CENTER,ROBERT STONE,,550141,0,0,26,26,OFFICE NO. 2 FRANCIS TUTTLE TECH CENTER
OKLAHOMA,OFFICE NO. 2 DEER CREEK PUBLIC SCHOOLS,TOM CORBIN,,550142,0,0,7,7,OFFICE NO. 2 DEER CREEK PUBLIC SCHOOLS
OKLAHOMA,OFFICE NO. 2 DEER CREEK PUBLIC SCHOOLS,ANDI NEAVES,,550142,0,0,40,40,OFFICE NO. 2 DEER CREEK PUBLIC SCHOOLS
OKLAHOMA,OFFICE NO. 2 FRANCIS TUTTLE TECH CENTER,PETE LEE,,550142,0,0,26,26,OFFICE NO. 2 FRANCIS TUTTLE TECH CENTER
OKLAHOMA,OFFICE NO. 2 FRANCIS TUTTLE TECH CENTER,ROBERT STONE,,550142,0,0,31,31,OFFICE NO. 2 FRANCIS TUTTLE TECH CENTER
OKLAHOMA,OFFICE NO. 2 DEER CREEK PUBLIC SCHOOLS,TOM CORBIN,,550143,0,0,2,2,OFFICE NO. 2 DEER CREEK PUBLIC SCHOOLS
OKLAHOMA,OFFICE NO. 2 DEER CREEK PUBLIC SCHOOLS,ANDI NEAVES,,550143,0,0,9,9,OFFICE NO. 2 DEER CREEK PUBLIC SCHOOLS
OKLAHOMA,PROPOSITION NO. 1 EDMOND PUBLIC SCHOOLS,FOR THE PROPOSITION - YES,,550143,0,0,0,0,PROPOSITION NO. 1 EDMOND PUBLIC SCHOOLS
OKLAHOMA,PROPOSITION NO. 1 EDMOND PUBLIC SCHOOLS,AGAINST THE PROPOSITION - NO,,550143,0,0,0,0,PROPOSITION NO. 1 EDMOND PUBLIC SCHOOLS
OKLAHOMA,PROPOSITION NO. 2 EDMOND PUBLIC SCHOOLS,FOR THE PROPOSITION - YES,,550143,0,0,0,0,PROPOSITION NO. 2 EDMOND PUBLIC SCHOOLS
OKLAHOMA,PROPOSITION NO. 2 EDMOND PUBLIC SCHOOLS,AGAINST THE PROPOSITION - NO,,550143,0,0,0,0,PROPOSITION NO. 2 EDMOND PUBLIC SCHOOLS
OKLAHOMA,OFFICE NO. 2 FRANCIS TUTTLE TECH CENTER,PETE LEE,,550143,0,0,9,9,OFFICE NO. 2 FRANCIS TUTTLE TECH CENTER
OKLAHOMA,OFFICE NO. 2 FRANCIS TUTTLE TECH CENTER,ROBERT STONE,,550143,0,0,8,8,OFFICE NO. 2 FRANCIS TUTTLE TECH CENTER
OKLAHOMA,BOARD CHAIRPERSON OKLAHOMA CITY PUBLIC SCHOOLS,PAULA LEWIS,,550143,0,0,6,6,
OKLAHOMA,BOARD CHAIRPERSON OKLAHOMA CITY PUBLIC SCHOOLS,WILFREDO SANTOS RIVERA,,550143,0,0,0,0,
OKLAHOMA,BOARD CHAIRPERSON OKLAHOMA CITY PUBLIC SCHOOLS,GREGORY A. WYATT,,550143,0,0,0,0,
OKLAHOMA,BOARD CHAIRPERSON OKLAHOMA CITY PUBLIC SCHOOLS,BIANCA ROSE,,550143,0,0,1,1,
OKLAHOMA,BOARD CHAIRPERSON OKLAHOMA CITY PUBLIC SCHOOLS,STANLEY HUPFELD,,550143,0,0,33,33,
OKLAHOMA,OFFICE NO. 1 OKLAHOMA CITY PUBLIC SCHOOLS,NATHAN SHIRLEY,,550143,0,0,15,15,OFFICE NO. 1 OKLAHOMA CITY PUBLIC SCHOOLS
OKLAHOMA,OFFICE NO. 1 OKLAHOMA CITY PUBLIC SCHOOLS,CHARLES HENRY,,550143,0,0,7,7,OFFICE NO. 1 OKLAHOMA CITY PUBLIC SCHOOLS
OKLAHOMA,OFFICE NO. 1 OKLAHOMA CITY PUBLIC SCHOOLS,CHERYL POOLE,,550143,0,0,19,19,OFFICE NO. 1 OKLAHOMA CITY PUBLIC SCHOOLS
OKLAHOMA,PROPOSITION NO. 1 EDMOND PUBLIC SCHOOLS,FOR THE PROPOSITION - YES,,550144,0,0,13,13,PROPOSITION NO. 1 EDMOND PUBLIC SCHOOLS
OKLAHOMA,PROPOSITION NO. 1 EDMOND PUBLIC SCHOOLS,AGAINST THE PROPOSITION - NO,,550144,0,0,3,3,PROPOSITION NO. 1 EDMOND PUBLIC SCHOOLS
OKLAHOMA,PROPOSITION NO. 2 EDMOND PUBLIC SCHOOLS,FOR THE PROPOSITION - YES,,550144,0,0,13,13,PROPOSITION NO. 2 EDMOND PUBLIC SCHOOLS
OKLAHOMA,PROPOSITION NO. 2 EDMOND PUBLIC SCHOOLS,AGAINST THE PROPOSITION - NO,,550144,0,0,2,2,PROPOSITION NO. 2 EDMOND PUBLIC SCHOOLS
OKLAHOMA,OFFICE NO. 2 FRANCIS TUTTLE TECH CENTER,PETE LEE,,550144,0,0,3,3,OFFICE NO. 2 FRANCIS TUTTLE TECH CENTER
OKLAHOMA,OFFICE NO. 2 FRANCIS TUTTLE TECH CENTER,ROBERT STONE,,550144,0,0,7,7,OFFICE NO. 2 FRANCIS TUTTLE TECH CENTER
OKLAHOMA,BOARD CHAIRPERSON OKLAHOMA CITY PUBLIC SCHOOLS,PAULA LEWIS,,550144,0,0,11,11,
OKLAHOMA,BOARD CHAIRPERSON OKLAHOMA CITY PUBLIC SCHOOLS,WILFREDO SANTOS RIVERA,,550144,0,0,6,6,
OKLAHOMA,BOARD CHAIRPERSON OKLAHOMA CITY PUBLIC SCHOOLS,GREGORY A. WYATT,,550144,0,0,2,2,
OKLAHOMA,BOARD CHAIRPERSON OKLAHOMA CITY PUBLIC SCHOOLS,BIANCA ROSE,,550144,0,0,1,1,
OKLAHOMA,BOARD CHAIRPERSON OKLAHOMA CITY PUBLIC SCHOOLS,STANLEY HUPFELD,,550144,0,0,53,53,
OKLAHOMA,OFFICE NO. 1 OKLAHOMA CITY PUBLIC SCHOOLS,NATHAN SHIRLEY,,550144,0,0,16,16,OFFICE NO. 1 OKLAHOMA CITY PUBLIC SCHOOLS
OKLAHOMA,OFFICE NO. 1 OKLAHOMA CITY PUBLIC SCHOOLS,CHARLES HENRY,,550144,0,0,23,23,OFFICE NO. 1 OKLAHOMA CITY PUBLIC SCHOOLS
OKLAHOMA,OFFICE NO. 1 OKLAHOMA CITY PUBLIC SCHOOLS,CHERYL POOLE,,550144,0,0,35,35,OFFICE NO. 1 OKLAHOMA CITY PUBLIC SCHOOLS
OKLAHOMA,PROPOSITION NO. 1 EDMOND PUBLIC SCHOOLS,FOR THE PROPOSITION - YES,,550145,0,0,24,24,PROPOSITION NO. 1 EDMOND PUBLIC SCHOOLS
OKLAHOMA,PROPOSITION NO. 1 EDMOND PUBLIC SCHOOLS,AGAINST THE PROPOSITION - NO,,550145,0,0,3,3,PROPOSITION NO. 1 EDMOND PUBLIC SCHOOLS
OKLAHOMA,PROPOSITION NO. 2 EDMOND PUBLIC SCHOOLS,FOR THE PROPOSITION - YES,,550145,0,0,25,25,PROPOSITION NO. 2 EDMOND PUBLIC SCHOOLS
OKLAHOMA,PROPOSITION NO. 2 EDMOND PUBLIC SCHOOLS,AGAINST THE PROPOSITION - NO,,550145,0,0,4,4,PROPOSITION NO. 2 EDMOND PUBLIC SCHOOLS
OKLAHOMA,OFFICE NO. 2 FRANCIS TUTTLE TECH CENTER,PETE LEE,,550145,0,0,9,9,OFFICE NO. 2 FRANCIS TUTTLE TECH CENTER
OKLAHOMA,OFFICE NO. 2 FRANCIS TUTTLE TECH CENTER,ROBERT STONE,,550145,0,0,16,16,OFFICE NO. 2 FRANCIS TUTTLE TECH CENTER
OKLAHOMA,BOARD CHAIRPERSON OKLAHOMA CITY PUBLIC SCHOOLS,PAULA LEWIS,,550145,0,0,6,6,
OKLAHOMA,BOARD CHAIRPERSON OKLAHOMA CITY PUBLIC SCHOOLS,WILFREDO SANTOS RIVERA,,550145,0,0,1,1,
OKLAHOMA,BOARD CHAIRPERSON OKLAHOMA CITY PUBLIC SCHOOLS,GREGORY A. WYATT,,550145,0,0,0,0,
OKLAHOMA,BOARD CHAIRPERSON OKLAHOMA CITY PUBLIC SCHOOLS,BIANCA ROSE,,550145,0,0,2,2,
OKLAHOMA,BOARD CHAIRPERSON OKLAHOMA CITY PUBLIC SCHOOLS,STANLEY HUPFELD,,550145,0,0,63,63,
OKLAHOMA,OFFICE NO. 1 OKLAHOMA CITY PUBLIC SCHOOLS,NATHAN SHIRLEY,,550145,0,0,42,42,OFFICE NO. 1 OKLAHOMA CITY PUBLIC SCHOOLS
OKLAHOMA,OFFICE NO. 1 OKLAHOMA CITY PUBLIC SCHOOLS,CHARLES HENRY,,550145,0,0,17,17,OFFICE NO. 1 OKLAHOMA CITY PUBLIC SCHOOLS
OKLAHOMA,OFFICE NO. 1 OKLAHOMA CITY PUBLIC SCHOOLS,CHERYL POOLE,,550145,0,0,15,15,OFFICE NO. 1 OKLAHOMA CITY PUBLIC SCHOOLS
OKLAHOMA,BOARD CHAIRPERSON OKLAHOMA CITY PUBLIC SCHOOLS,PAULA LEWIS,,550146,0,0,65,65,
OKLAHOMA,BOARD CHAIRPERSON OKLAHOMA CITY PUBLIC SCHOOLS,WILFREDO SANTOS RIVERA,,550146,0,0,7,7,
OKLAHOMA,BOARD CHAIRPERSON OKLAHOMA CITY PUBLIC SCHOOLS,GREGORY A. WYATT,,550146,0,0,4,4,
OKLAHOMA,BOARD CHAIRPERSON OKLAHOMA CITY PUBLIC SCHOOLS,BIANCA ROSE,,550146,0,0,11,11,
OKLAHOMA,BOARD CHAIRPERSON OKLAHOMA CITY PUBLIC SCHOOLS,STANLEY HUPFELD,,550146,0,0,143,143,
OKLAHOMA,OFFICE NO. 1 OKLAHOMA CITY PUBLIC SCHOOLS,NATHAN SHIRLEY,,550146,0,0,93,93,OFFICE NO. 1 OKLAHOMA CITY PUBLIC SCHOOLS
OKLAHOMA,OFFICE NO. 1 OKLAHOMA CITY PUBLIC SCHOOLS,CHARLES HENRY,,550146,0,0,47,47,OFFICE NO. 1 OKLAHOMA CITY PUBLIC SCHOOLS
OKLAHOMA,OFFICE NO. 1 OKLAHOMA CITY PUBLIC SCHOOLS,CHERYL POOLE,,550146,0,0,89,89,OFFICE NO. 1 OKLAHOMA CITY PUBLIC SCHOOLS
OKLAHOMA,BOARD CHAIRPERSON OKLAHOMA CITY PUBLIC SCHOOLS,PAULA LEWIS,,550147,0,0,17,17,
OKLAHOMA,BOARD CHAIRPERSON OKLAHOMA CITY PUBLIC SCHOOLS,WILFREDO SANTOS RIVERA,,550147,0,0,3,3,
OKLAHOMA,BOARD CHAIRPERSON OKLAHOMA CITY PUBLIC SCHOOLS,GREGORY A. WYATT,,550147,0,0,1,1,
OKLAHOMA,BOARD CHAIRPERSON OKLAHOMA CITY PUBLIC SCHOOLS,BIANCA ROSE,,550147,0,0,3,3,
OKLAHOMA,BOARD CHAIRPERSON OKLAHOMA CITY PUBLIC SCHOOLS,STANLEY HUPFELD,,550147,0,0,20,20,
OKLAHOMA,OFFICE NO. 1 OKLAHOMA CITY PUBLIC SCHOOLS,NATHAN SHIRLEY,,550147,0,0,16,16,OFFICE NO. 1 OKLAHOMA CITY PUBLIC SCHOOLS
OKLAHOMA,OFFICE NO. 1 OKLAHOMA CITY PUBLIC SCHOOLS,CHARLES HENRY,,550147,0,0,12,12,OFFICE NO. 1 OKLAHOMA CITY PUBLIC SCHOOLS
OKLAHOMA,OFFICE NO. 1 OKLAHOMA CITY PUBLIC SCHOOLS,CHERYL POOLE,,550147,0,0,19,19,OFFICE NO. 1 OKLAHOMA CITY PUBLIC SCHOOLS
OKLAHOMA,OFFICE NO. 2 FRANCIS TUTTLE TECH CENTER,PETE LEE,,550148,0,0,10,10,OFFICE NO. 2 FRANCIS TUTTLE TECH CENTER
OKLAHOMA,OFFICE NO. 2 FRANCIS TUTTLE TECH CENTER,ROBERT STONE,,550148,0,0,12,12,OFFICE NO. 2 FRANCIS TUTTLE TECH CENTER
OKLAHOMA,BOARD CHAIRPERSON OKLAHOMA CITY PUBLIC SCHOOLS,PAULA LEWIS,,550148,0,0,3,3,
OKLAHOMA,BOARD CHAIRPERSON OKLAHOMA CITY PUBLIC SCHOOLS,WILFREDO SANTOS RIVERA,,550148,0,0,2,2,
OKLAHOMA,BOARD CHAIRPERSON OKLAHOMA CITY PUBLIC SCHOOLS,GREGORY A. WYATT,,550148,0,0,0,0,
OKLAHOMA,BOARD CHAIRPERSON OKLAHOMA CITY PUBLIC SCHOOLS,BIANCA ROSE,,550148,0,0,1,1,
OKLAHOMA,BOARD CHAIRPERSON OKLAHOMA CITY PUBLIC SCHOOLS,STANLEY HUPFELD,,550148,0,0,16,16,
OKLAHOMA,OFFICE NO. 1 OKLAHOMA CITY PUBLIC SCHOOLS,NATHAN SHIRLEY,,550148,0,0,3,3,OFFICE NO. 1 OKLAHOMA CITY PUBLIC SCHOOLS
OKLAHOMA,OFFICE NO. 1 OKLAHOMA CITY PUBLIC SCHOOLS,CHARLES HENRY,,550148,0,0,5,5,OFFICE NO. 1 OKLAHOMA CITY PUBLIC SCHOOLS
OKLAHOMA,OFFICE NO. 1 OKLAHOMA CITY PUBLIC SCHOOLS,CHERYL POOLE,,550148,0,0,16,16,OFFICE NO. 1 OKLAHOMA CITY PUBLIC SCHOOLS
OKLAHOMA,OFFICE NO. 2 FRANCIS TUTTLE TECH CENTER,PETE LEE,,550149,0,0,8,8,OFFICE NO. 2 FRANCIS TUTTLE TECH CENTER
OKLAHOMA,OFFICE NO. 2 FRANCIS TUTTLE TECH CENTER,ROBERT STONE,,550149,0,0,15,15,OFFICE NO. 2 FRANCIS TUTTLE TECH CENTER
OKLAHOMA,OFFICE NO. 2 FRANCIS TUTTLE TECH CENTER,PETE LEE,,550150,0,0,6,6,OFFICE NO. 2 FRANCIS TUTTLE TECH CENTER
OKLAHOMA,OFFICE NO. 2 FRANCIS TUTTLE TECH CENTER,ROBERT STONE,,550150,0,0,22,22,OFFICE NO. 2 FRANCIS TUTTLE TECH CENTER
OKLAHOMA,OFFICE NO. 2 FRANCIS TUTTLE TECH CENTER,PETE LEE,,550151,0,0,2,2,OFFICE NO. 2 FRANCIS TUTTLE TECH CENTER
OKLAHOMA,OFFICE NO. 2 FRANCIS TUTTLE TECH CENTER,ROBERT STONE,,550151,0,0,11,11,OFFICE NO. 2 FRANCIS TUTTLE TECH CENTER
OKLAHOMA,"COUNCILMEMBER, WARD 1 CITY OF OKLAHOMA CITY",CHRIS GORDON,,550152,0,0,36,36,"COUNCILMEMBER, WARD 1 CITY OF OKLAHOMA CITY"
OKLAHOMA,"COUNCILMEMBER, WARD 1 CITY OF OKLAHOMA CITY",JAMES GREINER,,550152,0,0,29,29,"COUNCILMEMBER, WARD 1 CITY OF OKLAHOMA CITY"
OKLAHOMA,"COUNCILMEMBER, WARD 1 CITY OF OKLAHOMA CITY",JONATHAN CLOUR,,550152,0,0,2,2,"COUNCILMEMBER, WARD 1 CITY OF OKLAHOMA CITY"
OKLAHOMA,OFFICE NO. 2 FRANCIS TUTTLE TECH CENTER,PETE LEE,,550152,0,0,9,9,OFFICE NO. 2 FRANCIS TUTTLE TECH CENTER
OKLAHOMA,OFFICE NO. 2 FRANCIS TUTTLE TECH CENTER,ROBERT STONE,,550152,0,0,42,42,OFFICE NO. 2 FRANCIS TUTTLE TECH CENTER
OKLAHOMA,"COUNCILMEMBER, WARD 1 CITY OF OKLAHOMA CITY",CHRIS GORDON,,550153,0,0,50,50,"COUNCILMEMBER, WARD 1 CITY OF OKLAHOMA CITY"
OKLAHOMA,"COUNCILMEMBER, WARD 1 CITY OF OKLAHOMA CITY",JAMES GREINER,,550153,0,0,75,75,"COUNCILMEMBER, WARD 1 CITY OF OKLAHOMA CITY"
OKLAHOMA,"COUNCILMEMBER, WARD 1 CITY OF OKLAHOMA CITY",JONATHAN CLOUR,,550153,0,0,6,6,"COUNCILMEMBER, WARD 1 CITY OF OKLAHOMA CITY"
OKLAHOMA,OFFICE NO. 2 FRANCIS TUTTLE TECH CENTER,PETE LEE,,550153,0,0,43,43,OFFICE NO. 2 FRANCIS TUTTLE TECH CENTER
OKLAHOMA,OFFICE NO. 2 FRANCIS TUTTLE TECH CENTER,ROBERT STONE,,550153,0,0,70,70,OFFICE NO. 2 FRANCIS TUTTLE TECH CENTER
OKLAHOMA,"COUNCILMEMBER, WARD 1 CITY OF OKLAHOMA CITY",CHRIS GORDON,,550154,0,0,70,70,"COUNCILMEMBER, WARD 1 CITY OF OKLAHOMA CITY"
OKLAHOMA,"COUNCILMEMBER, WARD 1 CITY OF OKLAHOMA CITY",JAMES GREINER,,550154,0,0,80,80,"COUNCILMEMBER, WARD 1 CITY OF OKLAHOMA CITY"
OKLAHOMA,"COUNCILMEMBER, WARD 1 CITY OF OKLAHOMA CITY",JONATHAN CLOUR,,550154,0,0,8,8,"COUNCILMEMBER, WARD 1 CITY OF OKLAHOMA CITY"
OKLAHOMA,OFFICE NO. 2 FRANCIS TUTTLE TECH CENTER,PETE LEE,,550154,0,0,55,55,OFFICE NO. 2 FRANCIS TUTTLE TECH CENTER
OKLAHOMA,OFFICE NO. 2 FRANCIS TUTTLE TECH CENTER,ROBERT STONE,,550154,0,0,86,86,OFFICE NO. 2 FRANCIS TUTTLE TECH CENTER
OKLAHOMA,BOARD CHAIRPERSON OKLAHOMA CITY PUBLIC SCHOOLS,PAULA LEWIS,,550154,0,0,0,0,
OKLAHOMA,BOARD CHAIRPERSON OKLAHOMA CITY PUBLIC SCHOOLS,WILFREDO SANTOS RIVERA,,550154,0,0,0,0,
OKLAHOMA,BOARD CHAIRPERSON OKLAHOMA CITY PUBLIC SCHOOLS,GREGORY A. WYATT,,550154,0,0,0,0,
OKLAHOMA,BOARD CHAIRPERSON OKLAHOMA CITY PUBLIC SCHOOLS,BIANCA ROSE,,550154,0,0,0,0,
OKLAHOMA,BOARD CHAIRPERSON OKLAHOMA CITY PUBLIC SCHOOLS,STANLEY HUPFELD,,550154,0,0,1,1,
OKLAHOMA,OFFICE NO. 1 OKLAHOMA CITY PUBLIC SCHOOLS,NATHAN SHIRLEY,,550154,0,0,0,0,OFFICE NO. 1 OKLAHOMA CITY PUBLIC SCHOOLS
OKLAHOMA,OFFICE NO. 1 OKLAHOMA CITY PUBLIC SCHOOLS,CHARLES HENRY,,550154,0,0,1,1,OFFICE NO. 1 OKLAHOMA CITY PUBLIC SCHOOLS
OKLAHOMA,OFFICE NO. 1 OKLAHOMA CITY PUBLIC SCHOOLS,CHERYL POOLE,,550154,0,0,0,0,OFFICE NO. 1 OKLAHOMA CITY PUBLIC SCHOOLS
OKLAHOMA,"COUNCILMEMBER, WARD 1 CITY OF OKLAHOMA CITY",CHRIS GORDON,,550155,0,0,16,16,"COUNCILMEMBER, WARD 1 CITY OF OKLAHOMA CITY"
OKLAHOMA,"COUNCILMEMBER, WARD 1 CITY OF OKLAHOMA CITY",JAMES GREINER,,550155,0,0,22,22,"COUNCILMEMBER, WARD 1 CITY OF OKLAHOMA CITY"
OKLAHOMA,"COUNCILMEMBER, WARD 1 CITY OF OKLAHOMA CITY",JONATHAN CLOUR,,550155,0,0,4,4,"COUNCILMEMBER, WARD 1 CITY OF OKLAHOMA CITY"
OKLAHOMA,OFFICE NO. 2 FRANCIS TUTTLE TECH CENTER,PETE LEE,,550155,0,0,11,11,OFFICE NO. 2 FRANCIS TUTTLE TECH CENTER
OKLAHOMA,OFFICE NO. 2 FRANCIS TUTTLE TECH CENTER,ROBERT STONE,,550155,0,0,23,23,OFFICE NO. 2 FRANCIS TUTTLE TECH CENTER
OKLAHOMA,"COUNCILMEMBER, WARD 1 CITY OF OKLAHOMA CITY",CHRIS GORDON,,550156,0,0,49,49,"COUNCILMEMBER, WARD 1 CITY OF OKLAHOMA CITY"
OKLAHOMA,"COUNCILMEMBER, WARD 1 CITY OF OKLAHOMA CITY",JAMES GREINER,,550156,0,0,65,65,"COUNCILMEMBER, WARD 1 CITY OF OKLAHOMA CITY"
OKLAHOMA,"COUNCILMEMBER, WARD 1 CITY OF OKLAHOMA CITY",JONATHAN CLOUR,,550156,0,0,9,9,"COUNCILMEMBER, WARD 1 CITY OF OKLAHOMA CITY"
OKLAHOMA,OFFICE NO. 2 FRANCIS TUTTLE TECH CENTER,PETE LEE,,550156,0,0,38,38,OFFICE NO. 2 FRANCIS TUTTLE TECH CENTER
OKLAHOMA,OFFICE NO. 2 FRANCIS TUTTLE TECH CENTER,ROBERT STONE,,550156,0,0,71,71,OFFICE NO. 2 FRANCIS TUTTLE TECH CENTER
OKLAHOMA,"COUNCILMEMBER, WARD 1 CITY OF OKLAHOMA CITY",CHRIS GORDON,,550157,0,0,0,0,"COUNCILMEMBER, WARD 1 CITY OF OKLAHOMA CITY"
OKLAHOMA,"COUNCILMEMBER, WARD 1 CITY OF OKLAHOMA CITY",JAMES GREINER,,550157,0,0,0,0,"COUNCILMEMBER, WARD 1 CITY OF OKLAHOMA CITY"
OKLAHOMA,"COUNCILMEMBER, WARD 1 CITY OF OKLAHOMA CITY",JONATHAN CLOUR,,550157,0,0,0,0,"COUNCILMEMBER, WARD 1 CITY OF OKLAHOMA CITY"
OKLAHOMA,OFFICE NO. 2 FRANCIS TUTTLE TECH CENTER,PETE LEE,,550157,0,0,0,0,OFFICE NO. 2 FRANCIS TUTTLE TECH CENTER
OKLAHOMA,OFFICE NO. 2 FRANCIS TUTTLE TECH CENTER,ROBERT STONE,,550157,0,0,0,0,OFFICE NO. 2 FRANCIS TUTTLE TECH CENTER
OKLAHOMA,"COUNCILMEMBER, WARD 1 CITY OF OKLAHOMA CITY",CHRIS GORDON,,550158,0,0,27,27,"COUNCILMEMBER, WARD 1 CITY OF OKLAHOMA CITY"
OKLAHOMA,"COUNCILMEMBER, WARD 1 CITY OF OKLAHOMA CITY",JAMES GREINER,,550158,0,0,35,35,"COUNCILMEMBER, WARD 1 CITY OF OKLAHOMA CITY"
OKLAHOMA,"COUNCILMEMBER, WARD 1 CITY OF OKLAHOMA CITY",JONATHAN CLOUR,,550158,0,0,7,7,"COUNCILMEMBER, WARD 1 CITY OF OKLAHOMA CITY"
OKLAHOMA,OFFICE NO. 2 FRANCIS TUTTLE TECH CENTER,PETE LEE,,550158,0,0,22,22,OFFICE NO. 2 FRANCIS TUTTLE TECH CENTER
OKLAHOMA,OFFICE NO. 2 FRANCIS TUTTLE TECH CENTER,ROBERT STONE,,550158,0,0,42,42,OFFICE NO. 2 FRANCIS TUTTLE TECH CENTER
OKLAHOMA,"COUNCILMEMBER, WARD 1 CITY OF OKLAHOMA CITY",CHRIS GORDON,,550159,0,0,31,31,"COUNCILMEMBER, WARD 1 CITY OF OKLAHOMA CITY"
OKLAHOMA,"COUNCILMEMBER, WARD 1 CITY OF OKLAHOMA CITY",JAMES GREINER,,550159,0,0,34,34,"COUNCILMEMBER, WARD 1 CITY OF OKLAHOMA CITY"
OKLAHOMA,"COUNCILMEMBER, WARD 1 CITY OF OKLAHOMA CITY",JONATHAN CLOUR,,550159,0,0,2,2,"COUNCILMEMBER, WARD 1 CITY OF OKLAHOMA CITY"
OKLAHOMA,OFFICE NO. 2 FRANCIS TUTTLE TECH CENTER,PETE LEE,,550159,0,0,16,16,OFFICE NO. 2 FRANCIS TUTTLE TECH CENTER
OKLAHOMA,OFFICE NO. 2 FRANCIS TUTTLE TECH CENTER,ROBERT STONE,,550159,0,0,45,45,OFFICE NO. 2 FRANCIS TUTTLE TECH CENTER
OKLAHOMA,"COUNCILMEMBER, WARD 1 CITY OF OKLAHOMA CITY",CHRIS GORDON,,550160,0,0,46,46,"COUNCILMEMBER, WARD 1 CITY OF OKLAHOMA CITY"
OKLAHOMA,"COUNCILMEMBER, WARD 1 CITY OF OKLAHOMA CITY",JAMES GREINER,,550160,0,0,92,92,"COUNCILMEMBER, WARD 1 CITY OF OKLAHOMA CITY"
OKLAHOMA,"COUNCILMEMBER, WARD 1 CITY OF OKLAHOMA CITY",JONATHAN CLOUR,,550160,0,0,6,6,"COUNCILMEMBER, WARD 1 CITY OF OKLAHOMA CITY"
OKLAHOMA,OFFICE NO. 2 FRANCIS TUTTLE TECH CENTER,PETE LEE,,550160,0,0,33,33,OFFICE NO. 2 FRANCIS TUTTLE TECH CENTER
OKLAHOMA,OFFICE NO. 2 FRANCIS TUTTLE TECH CENTER,ROBERT STONE,,550160,0,0,90,90,OFFICE NO. 2 FRANCIS TUTTLE TECH CENTER
OKLAHOMA,"COUNCILMEMBER, WARD 1 CITY OF OKLAHOMA CITY",CHRIS GORDON,,550161,0,0,17,17,"COUNCILMEMBER, WARD 1 CITY OF OKLAHOMA CITY"
OKLAHOMA,"COUNCILMEMBER, WARD 1 CITY OF OKLAHOMA CITY",JAMES GREINER,,550161,0,0,16,16,"COUNCILMEMBER, WARD 1 CITY OF OKLAHOMA CITY"
OKLAHOMA,"COUNCILMEMBER, WARD 1 CITY OF OKLAHOMA CITY",JONATHAN CLOUR,,550161,0,0,3,3,"COUNCILMEMBER, WARD 1 CITY OF OKLAHOMA CITY"
OKLAHOMA,OFFICE NO. 2 FRANCIS TUTTLE TECH CENTER,PETE LEE,,550161,0,0,13,13,OFFICE NO. 2 FRANCIS TUTTLE TECH CENTER
OKLAHOMA,OFFICE NO. 2 FRANCIS TUTTLE TECH CENTER,ROBERT STONE,,550161,0,0,18,18,OFFICE NO. 2 FRANCIS TUTTLE TECH CENTER
OKLAHOMA,"COUNCILMEMBER, WARD 1 CITY OF OKLAHOMA CITY",CHRIS GORDON,,550162,0,0,25,25,"COUNCILMEMBER, WARD 1 CITY OF OKLAHOMA CITY"
OKLAHOMA,"COUNCILMEMBER, WARD 1 CITY OF OKLAHOMA CITY",JAMES GREINER,,550162,0,0,63,63,"COUNCILMEMBER, WARD 1 CITY OF OKLAHOMA CITY"
OKLAHOMA,"COUNCILMEMBER, WARD 1 CITY OF OKLAHOMA CITY",JONATHAN CLOUR,,550162,0,0,3,3,"COUNCILMEMBER, WARD 1 CITY OF OKLAHOMA CITY"
OKLAHOMA,OFFICE NO. 2 FRANCIS TUTTLE TECH CENTER,PETE LEE,,550162,0,0,32,32,OFFICE NO. 2 FRANCIS TUTTLE TECH CENTER
OKLAHOMA,OFFICE NO. 2 FRANCIS TUTTLE TECH CENTER,ROBERT STONE,,550162,0,0,47,47,OFFICE NO. 2 FRANCIS TUTTLE TECH CENTER
OKLAHOMA,"COUNCILMEMBER, WARD 1 CITY OF OKLAHOMA CITY",CHRIS GORDON,,550163,0,0,11,11,"COUNCILMEMBER, WARD 1 CITY OF OKLAHOMA CITY"
OKLAHOMA,"COUNCILMEMBER, WARD 1 CITY OF OKLAHOMA CITY",JAMES GREINER,,550163,0,0,26,26,"COUNCILMEMBER, WARD 1 CITY OF OKLAHOMA CITY"
OKLAHOMA,"COUNCILMEMBER, WARD 1 CITY OF OKLAHOMA CITY",JONATHAN CLOUR,,550163,0,0,1,1,"COUNCILMEMBER, WARD 1 CITY OF OKLAHOMA CITY"
OKLAHOMA,"COUNCILMEMBER, WARD 3 CITY OF OKLAHOMA CITY",LARRY McATEE,,550163,0,0,13,13,"COUNCILMEMBER, WARD 3 CITY OF OKLAHOMA CITY"
OKLAHOMA,"COUNCILMEMBER, WARD 3 CITY OF OKLAHOMA CITY",MATTHEW W. OLSEN,,550163,0,0,8,8,"COUNCILMEMBER, WARD 3 CITY OF OKLAHOMA CITY"
OKLAHOMA,"COUNCILMEMBER, WARD 3 CITY OF OKLAHOMA CITY",JOE SARGE NELSON,,550163,0,0,3,3,"COUNCILMEMBER, WARD 3 CITY OF OKLAHOMA CITY"
OKLAHOMA,OFFICE NO. 2 FRANCIS TUTTLE TECH CENTER,PETE LEE,,550163,0,0,20,20,OFFICE NO. 2 FRANCIS TUTTLE TECH CENTER
OKLAHOMA,OFFICE NO. 2 FRANCIS TUTTLE TECH CENTER,ROBERT STONE,,550163,0,0,36,36,OFFICE NO. 2 FRANCIS TUTTLE TECH CENTER
OKLAHOMA,"COUNCILMEMBER, WARD 1 CITY OF OKLAHOMA CITY",CHRIS GORDON,,550164,0,0,0,0,"COUNCILMEMBER, WARD 1 CITY OF OKLAHOMA CITY"
OKLAHOMA,"COUNCILMEMBER, WARD 1 CITY OF OKLAHOMA CITY",JAMES GREINER,,550164,0,0,0,0,"COUNCILMEMBER, WARD 1 CITY OF OKLAHOMA CITY"
OKLAHOMA,"COUNCILMEMBER, WARD 1 CITY OF OKLAHOMA CITY",JONATHAN CLOUR,,550164,0,0,0,0,"COUNCILMEMBER, WARD 1 CITY OF OKLAHOMA CITY"
OKLAHOMA,"COUNCILMEMBER, WARD 3 CITY OF OKLAHOMA CITY",LARRY McATEE,,550164,0,0,15,15,"COUNCILMEMBER, WARD 3 CITY OF OKLAHOMA CITY"
OKLAHOMA,"COUNCILMEMBER, WARD 3 CITY OF OKLAHOMA CITY",MATTHEW W. OLSEN,,550164,0,0,10,10,"COUNCILMEMBER, WARD 3 CITY OF OKLAHOMA CITY"
OKLAHOMA,"COUNCILMEMBER, WARD 3 CITY OF OKLAHOMA CITY",JOE SARGE NELSON,,550164,0,0,6,6,"COUNCILMEMBER, WARD 3 CITY OF OKLAHOMA CITY"
OKLAHOMA,OFFICE NO. 4 (UNEXPIRED TERM) MUSTANG PUBLIC SCHOOLS,BARBARA YOUNG,,550164,0,0,13,13,OFFICE NO. 4 (UNEXPIRED TERM) MUSTANG PUBLIC SCHOOLS
OKLAHOMA,OFFICE NO. 4 (UNEXPIRED TERM) MUSTANG PUBLIC SCHOOLS,CHAD SCHROEDER,,550164,0,0,4,4,OFFICE NO. 4 (UNEXPIRED TERM) MUSTANG PUBLIC SCHOOLS
OKLAHOMA,PROPOSITION NO. 1 MUSTANG PUBLIC SCHOOLS,FOR THE PROPOSITION - YES,,550164,0,0,14,14,PROPOSITION NO. 1 MUSTANG PUBLIC SCHOOLS
OKLAHOMA,PROPOSITION NO. 1 MUSTANG PUBLIC SCHOOLS,AGAINST THE PROPOSITION - NO,,550164,0,0,3,3,PROPOSITION NO. 1 MUSTANG PUBLIC SCHOOLS
OKLAHOMA,PROPOSITION NO. 2 MUSTANG PUBLIC SCHOOLS,FOR THE PROPOSITION - YES,,550164,0,0,14,14,PROPOSITION NO. 2 MUSTANG PUBLIC SCHOOLS
OKLAHOMA,PROPOSITION NO. 2 MUSTANG PUBLIC SCHOOLS,AGAINST THE PROPOSITION - NO,,550164,0,0,3,3,PROPOSITION NO. 2 MUSTANG PUBLIC SCHOOLS
OKLAHOMA,OFFICE NO. 2 FRANCIS TUTTLE TECH CENTER,PETE LEE,,550164,0,0,3,3,OFFICE NO. 2 FRANCIS TUTTLE TECH CENTER
OKLAHOMA,OFFICE NO. 2 FRANCIS TUTTLE TECH CENTER,ROBERT STONE,,550164,0,0,12,12,OFFICE NO. 2 FRANCIS TUTTLE TECH CENTER
OKLAHOMA,"COUNCILMEMBER, WARD 3 CITY OF OKLAHOMA CITY",LARRY McATEE,,550165,0,0,56,56,"COUNCILMEMBER, WARD 3 CITY OF OKLAHOMA CITY"
OKLAHOMA,"COUNCILMEMBER, WARD 3 CITY OF OKLAHOMA CITY",MATTHEW W. OLSEN,,550165,0,0,31,31,"COUNCILMEMBER, WARD 3 CITY OF OKLAHOMA CITY"
OKLAHOMA,"COUNCILMEMBER, WARD 3 CITY OF OKLAHOMA CITY",JOE SARGE NELSON,,550165,0,0,24,24,"COUNCILMEMBER, WARD 3 CITY OF OKLAHOMA CITY"
OKLAHOMA,OFFICE NO. 4 (UNEXPIRED TERM) MUSTANG PUBLIC SCHOOLS,BARBARA YOUNG,,550165,0,0,37,37,OFFICE NO. 4 (UNEXPIRED TERM) MUSTANG PUBLIC SCHOOLS
OKLAHOMA,OFFICE NO. 4 (UNEXPIRED TERM) MUSTANG PUBLIC SCHOOLS,CHAD SCHROEDER,,550165,0,0,47,47,OFFICE NO. 4 (UNEXPIRED TERM) MUSTANG PUBLIC SCHOOLS
OKLAHOMA,PROPOSITION NO. 1 MUSTANG PUBLIC SCHOOLS,FOR THE PROPOSITION - YES,,550165,0,0,74,74,PROPOSITION NO. 1 MUSTANG PUBLIC SCHOOLS
OKLAHOMA,PROPOSITION NO. 1 MUSTANG PUBLIC SCHOOLS,AGAINST THE PROPOSITION - NO,,550165,0,0,27,27,PROPOSITION NO. 1 MUSTANG PUBLIC SCHOOLS
OKLAHOMA,PROPOSITION NO. 2 MUSTANG PUBLIC SCHOOLS,FOR THE PROPOSITION - YES,,550165,0,0,78,78,PROPOSITION NO. 2 MUSTANG PUBLIC SCHOOLS
OKLAHOMA,PROPOSITION NO. 2 MUSTANG PUBLIC SCHOOLS,AGAINST THE PROPOSITION - NO,,550165,0,0,22,22,PROPOSITION NO. 2 MUSTANG PUBLIC SCHOOLS
OKLAHOMA,OFFICE NO. 2 FRANCIS TUTTLE TECH CENTER,PETE LEE,,550165,0,0,5,5,OFFICE NO. 2 FRANCIS TUTTLE TECH CENTER
OKLAHOMA,OFFICE NO. 2 FRANCIS TUTTLE TECH CENTER,ROBERT STONE,,550165,0,0,7,7,OFFICE NO. 2 FRANCIS TUTTLE TECH CENTER
OKLAHOMA,BOARD CHAIRPERSON OKLAHOMA CITY PUBLIC SCHOOLS,PAULA LEWIS,,550165,0,0,0,0,
OKLAHOMA,BOARD CHAIRPERSON OKLAHOMA CITY PUBLIC SCHOOLS,WILFREDO SANTOS RIVERA,,550165,0,0,0,0,
OKLAHOMA,BOARD CHAIRPERSON OKLAHOMA CITY PUBLIC SCHOOLS,GREGORY A. WYATT,,550165,0,0,0,0,
OKLAHOMA,BOARD CHAIRPERSON OKLAHOMA CITY PUBLIC SCHOOLS,BIANCA ROSE,,550165,0,0,0,0,
OKLAHOMA,BOARD CHAIRPERSON OKLAHOMA CITY PUBLIC SCHOOLS,STANLEY HUPFELD,,550165,0,0,0,0,
OKLAHOMA,"COUNCILMEMBER, WARD 3 CITY OF OKLAHOMA CITY",LARRY McATEE,,550166,0,0,1,1,"COUNCILMEMBER, WARD 3 CITY OF OKLAHOMA CITY"
OKLAHOMA,"COUNCILMEMBER, WARD 3 CITY OF OKLAHOMA CITY",MATTHEW W. OLSEN,,550166,0,0,2,2,"COUNCILMEMBER, WARD 3 CITY OF OKLAHOMA CITY"
OKLAHOMA,"COUNCILMEMBER, WARD 3 CITY OF OKLAHOMA CITY",JOE SARGE NELSON,,550166,0,0,11,11,"COUNCILMEMBER, WARD 3 CITY OF OKLAHOMA CITY"
OKLAHOMA,OFFICE NO. 2 FRANCIS TUTTLE TECH CENTER,PETE LEE,,550166,0,0,3,3,OFFICE NO. 2 FRANCIS TUTTLE TECH CENTER
OKLAHOMA,OFFICE NO. 2 FRANCIS TUTTLE TECH CENTER,ROBERT STONE,,550166,0,0,9,9,OFFICE NO. 2 FRANCIS TUTTLE TECH CENTER
OKLAHOMA,BOARD CHAIRPERSON OKLAHOMA CITY PUBLIC SCHOOLS,PAULA LEWIS,,550166,0,0,0,0,
OKLAHOMA,BOARD CHAIRPERSON OKLAHOMA CITY PUBLIC SCHOOLS,WILFREDO SANTOS RIVERA,,550166,0,0,0,0,
OKLAHOMA,BOARD CHAIRPERSON OKLAHOMA CITY PUBLIC SCHOOLS,GREGORY A. WYATT,,550166,0,0,0,0,
OKLAHOMA,BOARD CHAIRPERSON OKLAHOMA CITY PUBLIC SCHOOLS,BIANCA ROSE,,550166,0,0,0,0,
OKLAHOMA,BOARD CHAIRPERSON OKLAHOMA CITY PUBLIC SCHOOLS,STANLEY HUPFELD,,550166,0,0,0,0,
OKLAHOMA,"COUNCILMEMBER, WARD 3 CITY OF OKLAHOMA CITY",LARRY McATEE,,550167,0,0,10,10,"COUNCILMEMBER, WARD 3 CITY OF OKLAHOMA CITY"
OKLAHOMA,"COUNCILMEMBER, WARD 3 CITY OF OKLAHOMA CITY",MATTHEW W. OLSEN,,550167,0,0,4,4,"COUNCILMEMBER, WARD 3 CITY OF OKLAHOMA CITY"
OKLAHOMA,"COUNCILMEMBER, WARD 3 CITY OF OKLAHOMA CITY",JOE SARGE NELSON,,550167,0,0,1,1,"COUNCILMEMBER, WARD 3 CITY OF OKLAHOMA CITY"
OKLAHOMA,BOARD CHAIRPERSON OKLAHOMA CITY PUBLIC SCHOOLS,PAULA LEWIS,,550167,0,0,2,2,
OKLAHOMA,BOARD CHAIRPERSON OKLAHOMA CITY PUBLIC SCHOOLS,WILFREDO SANTOS RIVERA,,550167,0,0,1,1,
OKLAHOMA,BOARD CHAIRPERSON OKLAHOMA CITY PUBLIC SCHOOLS,GREGORY A. WYATT,,550167,0,0,2,2,
OKLAHOMA,BOARD CHAIRPERSON OKLAHOMA CITY PUBLIC SCHOOLS,BIANCA ROSE,,550167,0,0,7,7,
OKLAHOMA,BOARD CHAIRPERSON OKLAHOMA CITY PUBLIC SCHOOLS,STANLEY HUPFELD,,550167,0,0,3,3,
OKLAHOMA,"COUNCILMEMBER, WARD 3 CITY OF OKLAHOMA CITY",LARRY McATEE,,550168,0,0,5,5,"COUNCILMEMBER, WARD 3 CITY OF OKLAHOMA CITY"
OKLAHOMA,"COUNCILMEMBER, WARD 3 CITY OF OKLAHOMA CITY",MATTHEW W. OLSEN,,550168,0,0,3,3,"COUNCILMEMBER, WARD 3 CITY OF OKLAHOMA CITY"
OKLAHOMA,"COUNCILMEMBER, WARD 3 CITY OF OKLAHOMA CITY",JOE SARGE NELSON,,550168,0,0,1,1,"COUNCILMEMBER, WARD 3 CITY OF OKLAHOMA CITY"
OKLAHOMA,OFFICE NO. 2 FRANCIS TUTTLE TECH CENTER,PETE LEE,,550168,0,0,2,2,OFFICE NO. 2 FRANCIS TUTTLE TECH CENTER
OKLAHOMA,OFFICE NO. 2 FRANCIS TUTTLE TECH CENTER,ROBERT STONE,,550168,0,0,6,6,OFFICE NO. 2 FRANCIS TUTTLE TECH CENTER
OKLAHOMA,"COUNCILMEMBER, WARD 3 CITY OF OKLAHOMA CITY",LARRY McATEE,,550169,0,0,43,43,"COUNCILMEMBER, WARD 3 CITY OF OKLAHOMA CITY"
OKLAHOMA,"COUNCILMEMBER, WARD 3 CITY OF OKLAHOMA CITY",MATTHEW W. OLSEN,,550169,0,0,21,21,"COUNCILMEMBER, WARD 3 CITY OF OKLAHOMA CITY"
OKLAHOMA,"COUNCILMEMBER, WARD 3 CITY OF OKLAHOMA CITY",JOE SARGE NELSON,,550169,0,0,2,2,"COUNCILMEMBER, WARD 3 CITY OF OKLAHOMA CITY"
OKLAHOMA,OFFICE NO. 2 FRANCIS TUTTLE TECH CENTER,PETE LEE,,550169,0,0,26,26,OFFICE NO. 2 FRANCIS TUTTLE TECH CENTER
OKLAHOMA,OFFICE NO. 2 FRANCIS TUTTLE TECH CENTER,ROBERT STONE,,550169,0,0,32,32,OFFICE NO. 2 FRANCIS TUTTLE TECH CENTER
OKLAHOMA,"COUNCILMEMBER, WARD 3 CITY OF OKLAHOMA CITY",LARRY McATEE,,550170,0,0,11,11,"COUNCILMEMBER, WARD 3 CITY OF OKLAHOMA CITY"
OKLAHOMA,"COUNCILMEMBER, WARD 3 CITY OF OKLAHOMA CITY",MATTHEW W. OLSEN,,550170,0,0,19,19,"COUNCILMEMBER, WARD 3 CITY OF OKLAHOMA CITY"
OKLAHOMA,"COUNCILMEMBER, WARD 3 CITY OF OKLAHOMA CITY",JOE SARGE NELSON,,550170,0,0,4,4,"COUNCILMEMBER, WARD 3 CITY OF OKLAHOMA CITY"
OKLAHOMA,BOARD CHAIRPERSON OKLAHOMA CITY PUBLIC SCHOOLS,PAULA LEWIS,,550170,0,0,8,8,
OKLAHOMA,BOARD CHAIRPERSON OKLAHOMA CITY PUBLIC SCHOOLS,WILFREDO SANTOS RIVERA,,550170,0,0,10,10,
OKLAHOMA,BOARD CHAIRPERSON OKLAHOMA CITY PUBLIC SCHOOLS,GREGORY A. WYATT,,550170,0,0,3,3,
OKLAHOMA,BOARD CHAIRPERSON OKLAHOMA CITY PUBLIC SCHOOLS,BIANCA ROSE,,550170,0,0,8,8,
OKLAHOMA,BOARD CHAIRPERSON OKLAHOMA CITY PUBLIC SCHOOLS,STANLEY HUPFELD,,550170,0,0,15,15,
OKLAHOMA,"COUNCILMEMBER, WARD 3 CITY OF OKLAHOMA CITY",LARRY McATEE,,550171,0,0,50,50,"COUNCILMEMBER, WARD 3 CITY OF OKLAHOMA CITY"
OKLAHOMA,"COUNCILMEMBER, WARD 3 CITY OF OKLAHOMA CITY",MATTHEW W. OLSEN,,550171,0,0,32,32,"COUNCILMEMBER, WARD 3 CITY OF OKLAHOMA CITY"
OKLAHOMA,"COUNCILMEMBER, WARD 3 CITY OF OKLAHOMA CITY",JOE SARGE NELSON,,550171,0,0,6,6,"COUNCILMEMBER, WARD 3 CITY OF OKLAHOMA CITY"
OKLAHOMA,BOARD CHAIRPERSON OKLAHOMA CITY PUBLIC SCHOOLS,PAULA LEWIS,,550171,0,0,32,32,
OKLAHOMA,BOARD CHAIRPERSON OKLAHOMA CITY PUBLIC SCHOOLS,WILFREDO SANTOS RIVERA,,550171,0,0,14,14,
OKLAHOMA,BOARD CHAIRPERSON OKLAHOMA CITY PUBLIC SCHOOLS,GREGORY A. WYATT,,550171,0,0,2,2,
OKLAHOMA,BOARD CHAIRPERSON OKLAHOMA CITY PUBLIC SCHOOLS,BIANCA ROSE,,550171,0,0,15,15,
OKLAHOMA,BOARD CHAIRPERSON OKLAHOMA CITY PUBLIC SCHOOLS,STANLEY HUPFELD,,550171,0,0,31,31,
OKLAHOMA,OFFICE NO. 2 FRANCIS TUTTLE TECH CENTER,PETE LEE,,550172,0,0,3,3,OFFICE NO. 2 FRANCIS TUTTLE TECH CENTER
OKLAHOMA,OFFICE NO. 2 FRANCIS TUTTLE TECH CENTER,ROBERT STONE,,550172,0,0,4,4,OFFICE NO. 2 FRANCIS TUTTLE TECH CENTER
OKLAHOMA,BOARD CHAIRPERSON OKLAHOMA CITY PUBLIC SCHOOLS,PAULA LEWIS,,550172,0,0,20,20,
OKLAHOMA,BOARD CHAIRPERSON OKLAHOMA CITY PUBLIC SCHOOLS,WILFREDO SANTOS RIVERA,,550172,0,0,1,1,
OKLAHOMA,BOARD CHAIRPERSON OKLAHOMA CITY PUBLIC SCHOOLS,GREGORY A. WYATT,,550172,0,0,1,1,
OKLAHOMA,BOARD CHAIRPERSON OKLAHOMA CITY PUBLIC SCHOOLS,BIANCA ROSE,,550172,0,0,5,5,
OKLAHOMA,BOARD CHAIRPERSON OKLAHOMA CITY PUBLIC SCHOOLS,STANLEY HUPFELD,,550172,0,0,15,15,
OKLAHOMA,"COUNCILMEMBER, WARD 3 CITY OF OKLAHOMA CITY",LARRY McATEE,,550173,0,0,92,92,"COUNCILMEMBER, WARD 3 CITY OF OKLAHOMA CITY"
OKLAHOMA,"COUNCILMEMBER, WARD 3 CITY OF OKLAHOMA CITY",MATTHEW W. OLSEN,,550173,0,0,35,35,"COUNCILMEMBER, WARD 3 CITY OF OKLAHOMA CITY"
OKLAHOMA,"COUNCILMEMBER, WARD 3 CITY OF OKLAHOMA CITY",JOE SARGE NELSON,,550173,0,0,6,6,"COUNCILMEMBER, WARD 3 CITY OF OKLAHOMA CITY"
OKLAHOMA,OFFICE NO. 2 FRANCIS TUTTLE TECH CENTER,PETE LEE,,550173,0,0,52,52,OFFICE NO. 2 FRANCIS TUTTLE TECH CENTER
OKLAHOMA,OFFICE NO. 2 FRANCIS TUTTLE TECH CENTER,ROBERT STONE,,550173,0,0,60,60,OFFICE NO. 2 FRANCIS TUTTLE TECH CENTER
OKLAHOMA,"COUNCILMEMBER, WARD 3 CITY OF OKLAHOMA CITY",LARRY McATEE,,550174,0,0,53,53,"COUNCILMEMBER, WARD 3 CITY OF OKLAHOMA CITY"
OKLAHOMA,"COUNCILMEMBER, WARD 3 CITY OF OKLAHOMA CITY",MATTHEW W. OLSEN,,550174,0,0,13,13,"COUNCILMEMBER, WARD 3 CITY OF OKLAHOMA CITY"
OKLAHOMA,"COUNCILMEMBER, WARD 3 CITY OF OKLAHOMA CITY",JOE SARGE NELSON,,550174,0,0,2,2,"COUNCILMEMBER, WARD 3 CITY OF OKLAHOMA CITY"
OKLAHOMA,OFFICE NO. 2 FRANCIS TUTTLE TECH CENTER,PETE LEE,,550174,0,0,24,24,OFFICE NO. 2 FRANCIS TUTTLE TECH CENTER
OKLAHOMA,OFFICE NO. 2 FRANCIS TUTTLE TECH CENTER,ROBERT STONE,,550174,0,0,39,39,OFFICE NO. 2 FRANCIS TUTTLE TECH CENTER
OKLAHOMA,"COUNCILMEMBER, WARD 1 CITY OF OKLAHOMA CITY",CHRIS GORDON,,550175,0,0,10,10,"COUNCILMEMBER, WARD 1 CITY OF OKLAHOMA CITY"
OKLAHOMA,"COUNCILMEMBER, WARD 1 CITY OF OKLAHOMA CITY",JAMES GREINER,,550175,0,0,13,13,"COUNCILMEMBER, WARD 1 CITY OF OKLAHOMA CITY"
OKLAHOMA,"COUNCILMEMBER, WARD 1 CITY OF OKLAHOMA CITY",JONATHAN CLOUR,,550175,0,0,0,0,"COUNCILMEMBER, WARD 1 CITY OF OKLAHOMA CITY"
OKLAHOMA,OFFICE NO. 2 FRANCIS TUTTLE TECH CENTER,PETE LEE,,550175,0,0,6,6,OFFICE NO. 2 FRANCIS TUTTLE TECH CENTER
OKLAHOMA,OFFICE NO. 2 FRANCIS TUTTLE TECH CENTER,ROBERT STONE,,550175,0,0,17,17,OFFICE NO. 2 FRANCIS TUTTLE TECH CENTER
OKLAHOMA,"COUNCILMEMBER, WARD 1 CITY OF OKLAHOMA CITY",CHRIS GORDON,,550176,0,0,25,25,"COUNCILMEMBER, WARD 1 CITY OF OKLAHOMA CITY"
OKLAHOMA,"COUNCILMEMBER, WARD 1 CITY OF OKLAHOMA CITY",JAMES GREINER,,550176,0,0,25,25,"COUNCILMEMBER, WARD 1 CITY OF OKLAHOMA CITY"
OKLAHOMA,"COUNCILMEMBER, WARD 1 CITY OF OKLAHOMA CITY",JONATHAN CLOUR,,550176,0,0,5,5,"COUNCILMEMBER, WARD 1 CITY OF OKLAHOMA CITY"
OKLAHOMA,OFFICE NO. 2 FRANCIS TUTTLE TECH CENTER,PETE LEE,,550176,0,0,28,28,OFFICE NO. 2 FRANCIS TUTTLE TECH CENTER
OKLAHOMA,OFFICE NO. 2 FRANCIS TUTTLE TECH CENTER,ROBERT STONE,,550176,0,0,39,39,OFFICE NO. 2 FRANCIS TUTTLE TECH CENTER
OKLAHOMA,"COUNCILMEMBER, WARD 1 CITY OF OKLAHOMA CITY",CHRIS GORDON,,550177,0,0,34,34,"COUNCILMEMBER, WARD 1 CITY OF OKLAHOMA CITY"
OKLAHOMA,"COUNCILMEMBER, WARD 1 CITY OF OKLAHOMA CITY",JAMES GREINER,,550177,0,0,40,40,"COUNCILMEMBER, WARD 1 CITY OF OKLAHOMA CITY"
OKLAHOMA,"COUNCILMEMBER, WARD 1 CITY OF OKLAHOMA CITY",JONATHAN CLOUR,,550177,0,0,1,1,"COUNCILMEMBER, WARD 1 CITY OF OKLAHOMA CITY"
OKLAHOMA,OFFICE NO. 2 FRANCIS TUTTLE TECH CENTER,PETE LEE,,550177,0,0,19,19,OFFICE NO. 2 FRANCIS TUTTLE TECH CENTER
OKLAHOMA,OFFICE NO. 2 FRANCIS TUTTLE TECH CENTER,ROBERT STONE,,550177,0,0,49,49,OFFICE NO. 2 FRANCIS TUTTLE TECH CENTER
OKLAHOMA,OFFICE NO. 2 FRANCIS TUTTLE TECH CENTER,PETE LEE,,550178,0,0,9,9,OFFICE NO. 2 FRANCIS TUTTLE TECH CENTER
OKLAHOMA,OFFICE NO. 2 FRANCIS TUTTLE TECH CENTER,ROBERT STONE,,550178,0,0,11,11,OFFICE NO. 2 FRANCIS TUTTLE TECH CENTER
OKLAHOMA,"COUNCILMEMBER, WARD 1 CITY OF OKLAHOMA CITY",CHRIS GORDON,,550179,0,0,54,54,"COUNCILMEMBER, WARD 1 CITY OF OKLAHOMA CITY"
OKLAHOMA,"COUNCILMEMBER, WARD 1 CITY OF OKLAHOMA CITY",JAMES GREINER,,550179,0,0,30,30,"COUNCILMEMBER, WARD 1 CITY OF OKLAHOMA CITY"
OKLAHOMA,"COUNCILMEMBER, WARD 1 CITY OF OKLAHOMA CITY",JONATHAN CLOUR,,550179,0,0,2,2,"COUNCILMEMBER, WARD 1 CITY OF OKLAHOMA CITY"
OKLAHOMA,OFFICE NO. 2 FRANCIS TUTTLE TECH CENTER,PETE LEE,,550179,0,0,29,29,OFFICE NO. 2 FRANCIS TUTTLE TECH CENTER
OKLAHOMA,OFFICE NO. 2 FRANCIS TUTTLE TECH CENTER,ROBERT STONE,,550179,0,0,60,60,OFFICE NO. 2 FRANCIS TUTTLE TECH CENTER
OKLAHOMA,OFFICE NO. 2 FRANCIS TUTTLE TECH CENTER,PETE LEE,,550180,0,0,2,2,OFFICE NO. 2 FRANCIS TUTTLE TECH CENTER
OKLAHOMA,OFFICE NO. 2 FRANCIS TUTTLE TECH CENTER,ROBERT STONE,,550180,0,0,1,1,OFFICE NO. 2 FRANCIS TUTTLE TECH CENTER
OKLAHOMA,BOARD CHAIRPERSON OKLAHOMA CITY PUBLIC SCHOOLS,PAULA LEWIS,,550180,0,0,29,29,
OKLAHOMA,BOARD CHAIRPERSON OKLAHOMA CITY PUBLIC SCHOOLS,WILFREDO SANTOS RIVERA,,550180,0,0,2,2,
OKLAHOMA,BOARD CHAIRPERSON OKLAHOMA CITY PUBLIC SCHOOLS,GREGORY A. WYATT,,550180,0,0,1,1,
OKLAHOMA,BOARD CHAIRPERSON OKLAHOMA CITY PUBLIC SCHOOLS,BIANCA ROSE,,550180,0,0,5,5,
OKLAHOMA,BOARD CHAIRPERSON OKLAHOMA CITY PUBLIC SCHOOLS,STANLEY HUPFELD,,550180,0,0,32,32,
OKLAHOMA,OFFICE NO. 2 OKLAHOMA CITY PUBLIC SCHOOLS,JUSTIN ELLIS,,550180,0,0,24,24,OFFICE NO. 2 OKLAHOMA CITY PUBLIC SCHOOLS
OKLAHOMA,OFFICE NO. 2 OKLAHOMA CITY PUBLIC SCHOOLS,REBECCA L. BUDD,,550180,0,0,24,24,OFFICE NO. 2 OKLAHOMA CITY PUBLIC SCHOOLS
OKLAHOMA,OFFICE NO. 2 OKLAHOMA CITY PUBLIC SCHOOLS,NICK SINGER,,550180,0,0,23,23,OFFICE NO. 2 OKLAHOMA CITY PUBLIC SCHOOLS
OKLAHOMA,"COUNCILMEMBER, WARD 1 CITY OF OKLAHOMA CITY",CHRIS GORDON,,550181,0,0,0,0,"COUNCILMEMBER, WARD 1 CITY OF OKLAHOMA CITY"
OKLAHOMA,"COUNCILMEMBER, WARD 1 CITY OF OKLAHOMA CITY",JAMES GREINER,,550181,0,0,0,0,"COUNCILMEMBER, WARD 1 CITY OF OKLAHOMA CITY"
OKLAHOMA,"COUNCILMEMBER, WARD 1 CITY OF OKLAHOMA CITY",JONATHAN CLOUR,,550181,0,0,0,0,"COUNCILMEMBER, WARD 1 CITY OF OKLAHOMA CITY"
OKLAHOMA,OFFICE NO. 2 FRANCIS TUTTLE TECH CENTER,PETE LEE,,550181,0,0,5,5,OFFICE NO. 2 FRANCIS TUTTLE TECH CENTER
OKLAHOMA,OFFICE NO. 2 FRANCIS TUTTLE TECH CENTER,ROBERT STONE,,550181,0,0,12,12,OFFICE NO. 2 FRANCIS TUTTLE TECH CENTER
OKLAHOMA,OFFICE NO. 2 FRANCIS TUTTLE TECH CENTER,PETE LEE,,550182,0,0,1,1,OFFICE NO. 2 FRANCIS TUTTLE TECH CENTER
OKLAHOMA,OFFICE NO. 2 FRANCIS TUTTLE TECH CENTER,ROBERT STONE,,550182,0,0,3,3,OFFICE NO. 2 FRANCIS TUTTLE TECH CENTER
OKLAHOMA,BOARD CHAIRPERSON OKLAHOMA CITY PUBLIC SCHOOLS,PAULA LEWIS,,550182,0,0,6,6,
OKLAHOMA,BOARD CHAIRPERSON OKLAHOMA CITY PUBLIC SCHOOLS,WILFREDO SANTOS RIVERA,,550182,0,0,0,0,
OKLAHOMA,BOARD CHAIRPERSON OKLAHOMA CITY PUBLIC SCHOOLS,GREGORY A. WYATT,,550182,0,0,0,0,
OKLAHOMA,BOARD CHAIRPERSON OKLAHOMA CITY PUBLIC SCHOOLS,BIANCA ROSE,,550182,0,0,0,0,
OKLAHOMA,BOARD CHAIRPERSON OKLAHOMA CITY PUBLIC SCHOOLS,STANLEY HUPFELD,,550182,0,0,3,3,
OKLAHOMA,OFFICE NO. 2 OKLAHOMA CITY PUBLIC SCHOOLS,JUSTIN ELLIS,,550182,0,0,0,0,OFFICE NO. 2 OKLAHOMA CITY PUBLIC SCHOOLS
OKLAHOMA,OFFICE NO. 2 OKLAHOMA CITY PUBLIC SCHOOLS,REBECCA L. BUDD,,550182,0,0,3,3,OFFICE NO. 2 OKLAHOMA CITY PUBLIC SCHOOLS
OKLAHOMA,OFFICE NO. 2 OKLAHOMA CITY PUBLIC SCHOOLS,NICK SINGER,,550182,0,0,5,5,OFFICE NO. 2 OKLAHOMA CITY PUBLIC SCHOOLS
OKLAHOMA,OFFICE NO. 2 FRANCIS TUTTLE TECH CENTER,PETE LEE,,550183,0,0,0,0,OFFICE NO. 2 FRANCIS TUTTLE TECH CENTER
OKLAHOMA,OFFICE NO. 2 FRANCIS TUTTLE TECH CENTER,ROBERT STONE,,550183,0,0,2,2,OFFICE NO. 2 FRANCIS TUTTLE TECH CENTER
OKLAHOMA,BOARD CHAIRPERSON OKLAHOMA CITY PUBLIC SCHOOLS,PAULA LEWIS,,550183,0,0,31,31,
OKLAHOMA,BOARD CHAIRPERSON OKLAHOMA CITY PUBLIC SCHOOLS,WILFREDO SANTOS RIVERA,,550183,0,0,7,7,
OKLAHOMA,BOARD CHAIRPERSON OKLAHOMA CITY PUBLIC SCHOOLS,GREGORY A. WYATT,,550183,0,0,4,4,
OKLAHOMA,BOARD CHAIRPERSON OKLAHOMA CITY PUBLIC SCHOOLS,BIANCA ROSE,,550183,0,0,8,8,
OKLAHOMA,BOARD CHAIRPERSON OKLAHOMA CITY PUBLIC SCHOOLS,STANLEY HUPFELD,,550183,0,0,27,27,
OKLAHOMA,OFFICE NO. 2 OKLAHOMA CITY PUBLIC SCHOOLS,JUSTIN ELLIS,,550183,0,0,11,11,OFFICE NO. 2 OKLAHOMA CITY PUBLIC SCHOOLS
OKLAHOMA,OFFICE NO. 2 OKLAHOMA CITY PUBLIC SCHOOLS,REBECCA L. BUDD,,550183,0,0,34,34,OFFICE NO. 2 OKLAHOMA CITY PUBLIC SCHOOLS
OKLAHOMA,OFFICE NO. 2 OKLAHOMA CITY PUBLIC SCHOOLS,NICK SINGER,,550183,0,0,30,30,OFFICE NO. 2 OKLAHOMA CITY PUBLIC SCHOOLS
OKLAHOMA,OFFICE NO. 2 FRANCIS TUTTLE TECH CENTER,PETE LEE,,550184,0,0,0,0,OFFICE NO. 2 FRANCIS TUTTLE TECH CENTER
OKLAHOMA,OFFICE NO. 2 FRANCIS TUTTLE TECH CENTER,ROBERT STONE,,550184,0,0,2,2,OFFICE NO. 2 FRANCIS TUTTLE TECH CENTER
OKLAHOMA,BOARD CHAIRPERSON OKLAHOMA CITY PUBLIC SCHOOLS,PAULA LEWIS,,550184,0,0,29,29,
OKLAHOMA,BOARD CHAIRPERSON OKLAHOMA CITY PUBLIC SCHOOLS,WILFREDO SANTOS RIVERA,,550184,0,0,6,6,
OKLAHOMA,BOARD CHAIRPERSON OKLAHOMA CITY PUBLIC SCHOOLS,GREGORY A. WYATT,,550184,0,0,1,1,
OKLAHOMA,BOARD CHAIRPERSON OKLAHOMA CITY PUBLIC SCHOOLS,BIANCA ROSE,,550184,0,0,5,5,
OKLAHOMA,BOARD CHAIRPERSON OKLAHOMA CITY PUBLIC SCHOOLS,STANLEY HUPFELD,,550184,0,0,14,14,
OKLAHOMA,OFFICE NO. 2 OKLAHOMA CITY PUBLIC SCHOOLS,JUSTIN ELLIS,,550184,0,0,6,6,OFFICE NO. 2 OKLAHOMA CITY PUBLIC SCHOOLS
OKLAHOMA,OFFICE NO. 2 OKLAHOMA CITY PUBLIC SCHOOLS,REBECCA L. BUDD,,550184,0,0,7,7,OFFICE NO. 2 OKLAHOMA CITY PUBLIC SCHOOLS
OKLAHOMA,OFFICE NO. 2 OKLAHOMA CITY PUBLIC SCHOOLS,NICK SINGER,,550184,0,0,6,6,OFFICE NO. 2 OKLAHOMA CITY PUBLIC SCHOOLS
OKLAHOMA,BOARD CHAIRPERSON OKLAHOMA CITY PUBLIC SCHOOLS,PAULA LEWIS,,550185,0,0,15,15,
OKLAHOMA,BOARD CHAIRPERSON OKLAHOMA CITY PUBLIC SCHOOLS,WILFREDO SANTOS RIVERA,,550185,0,0,4,4,
OKLAHOMA,BOARD CHAIRPERSON OKLAHOMA CITY PUBLIC SCHOOLS,GREGORY A. WYATT,,550185,0,0,0,0,
OKLAHOMA,BOARD CHAIRPERSON OKLAHOMA CITY PUBLIC SCHOOLS,BIANCA ROSE,,550185,0,0,5,5,
OKLAHOMA,BOARD CHAIRPERSON OKLAHOMA CITY PUBLIC SCHOOLS,STANLEY HUPFELD,,550185,0,0,8,8,
OKLAHOMA,BOARD CHAIRPERSON OKLAHOMA CITY PUBLIC SCHOOLS,PAULA LEWIS,,550186,0,0,32,32,
OKLAHOMA,BOARD CHAIRPERSON OKLAHOMA CITY PUBLIC SCHOOLS,WILFREDO SANTOS RIVERA,,550186,0,0,4,4,
OKLAHOMA,BOARD CHAIRPERSON OKLAHOMA CITY PUBLIC SCHOOLS,GREGORY A. WYATT,,550186,0,0,1,1,
OKLAHOMA,BOARD CHAIRPERSON OKLAHOMA CITY PUBLIC SCHOOLS,BIANCA ROSE,,550186,0,0,2,2,
OKLAHOMA,BOARD CHAIRPERSON OKLAHOMA CITY PUBLIC SCHOOLS,STANLEY HUPFELD,,550186,0,0,21,21,
OKLAHOMA,BOARD CHAIRPERSON OKLAHOMA CITY PUBLIC SCHOOLS,PAULA LEWIS,,550187,0,0,2,2,
OKLAHOMA,BOARD CHAIRPERSON OKLAHOMA CITY PUBLIC SCHOOLS,WILFREDO SANTOS RIVERA,,550187,0,0,1,1,
OKLAHOMA,BOARD CHAIRPERSON OKLAHOMA CITY PUBLIC SCHOOLS,GREGORY A. WYATT,,550187,0,0,0,0,
OKLAHOMA,BOARD CHAIRPERSON OKLAHOMA CITY PUBLIC SCHOOLS,BIANCA ROSE,,550187,0,0,1,1,
OKLAHOMA,BOARD CHAIRPERSON OKLAHOMA CITY PUBLIC SCHOOLS,STANLEY HUPFELD,,550187,0,0,3,3,
OKLAHOMA,OFFICE NO. 2 FRANCIS TUTTLE TECH CENTER,PETE LEE,,550188,0,0,1,1,OFFICE NO. 2 FRANCIS TUTTLE TECH CENTER
OKLAHOMA,OFFICE NO. 2 FRANCIS TUTTLE TECH CENTER,ROBERT STONE,,550188,0,0,0,0,OFFICE NO. 2 FRANCIS TUTTLE TECH CENTER
OKLAHOMA,BOARD CHAIRPERSON OKLAHOMA CITY PUBLIC SCHOOLS,PAULA LEWIS,,550188,0,0,0,0,
OKLAHOMA,BOARD CHAIRPERSON OKLAHOMA CITY PUBLIC SCHOOLS,WILFREDO SANTOS RIVERA,,550188,0,0,0,0,
OKLAHOMA,BOARD CHAIRPERSON OKLAHOMA CITY PUBLIC SCHOOLS,GREGORY A. WYATT,,550188,0,0,0,0,
OKLAHOMA,BOARD CHAIRPERSON OKLAHOMA CITY PUBLIC SCHOOLS,BIANCA ROSE,,550188,0,0,0,0,
OKLAHOMA,BOARD CHAIRPERSON OKLAHOMA CITY PUBLIC SCHOOLS,STANLEY HUPFELD,,550188,0,0,0,0,
OKLAHOMA,BOARD CHAIRPERSON OKLAHOMA CITY PUBLIC SCHOOLS,PAULA LEWIS,,550189,0,0,0,0,
OKLAHOMA,BOARD CHAIRPERSON OKLAHOMA CITY PUBLIC SCHOOLS,WILFREDO SANTOS RIVERA,,550189,0,0,0,0,
OKLAHOMA,BOARD CHAIRPERSON OKLAHOMA CITY PUBLIC SCHOOLS,GREGORY A. WYATT,,550189,0,0,1,1,
OKLAHOMA,BOARD CHAIRPERSON OKLAHOMA CITY PUBLIC SCHOOLS,BIANCA ROSE,,550189,0,0,0,0,
OKLAHOMA,BOARD CHAIRPERSON OKLAHOMA CITY PUBLIC SCHOOLS,STANLEY HUPFELD,,550189,0,0,3,3,
OKLAHOMA,BOARD CHAIRPERSON OKLAHOMA CITY PUBLIC SCHOOLS,PAULA LEWIS,,550190,0,0,6,6,
OKLAHOMA,BOARD CHAIRPERSON OKLAHOMA CITY PUBLIC SCHOOLS,WILFREDO SANTOS RIVERA,,550190,0,0,1,1,
OKLAHOMA,BOARD CHAIRPERSON OKLAHOMA CITY PUBLIC SCHOOLS,GREGORY A. WYATT,,550190,0,0,0,0,
OKLAHOMA,BOARD CHAIRPERSON OKLAHOMA CITY PUBLIC SCHOOLS,BIANCA ROSE,,550190,0,0,7,7,
OKLAHOMA,BOARD CHAIRPERSON OKLAHOMA CITY PUBLIC SCHOOLS,STANLEY HUPFELD,,550190,0,0,3,3,
OKLAHOMA,BOARD CHAIRPERSON OKLAHOMA CITY PUBLIC SCHOOLS,PAULA LEWIS,,550191,0,0,20,20,
OKLAHOMA,BOARD CHAIRPERSON OKLAHOMA CITY PUBLIC SCHOOLS,WILFREDO SANTOS RIVERA,,550191,0,0,5,5,
OKLAHOMA,BOARD CHAIRPERSON OKLAHOMA CITY PUBLIC SCHOOLS,GREGORY A. WYATT,,550191,0,0,0,0,
OKLAHOMA,BOARD CHAIRPERSON OKLAHOMA CITY PUBLIC SCHOOLS,BIANCA ROSE,,550191,0,0,8,8,
OKLAHOMA,BOARD CHAIRPERSON OKLAHOMA CITY PUBLIC SCHOOLS,STANLEY HUPFELD,,550191,0,0,5,5,
OKLAHOMA,BOARD CHAIRPERSON OKLAHOMA CITY PUBLIC SCHOOLS,PAULA LEWIS,,550192,0,0,94,94,
OKLAHOMA,BOARD CHAIRPERSON OKLAHOMA CITY PUBLIC SCHOOLS,WILFREDO SANTOS RIVERA,,550192,0,0,11,11,
OKLAHOMA,BOARD CHAIRPERSON OKLAHOMA CITY PUBLIC SCHOOLS,GREGORY A. WYATT,,550192,0,0,2,2,
OKLAHOMA,BOARD CHAIRPERSON OKLAHOMA CITY PUBLIC SCHOOLS,BIANCA ROSE,,550192,0,0,9,9,
OKLAHOMA,BOARD CHAIRPERSON OKLAHOMA CITY PUBLIC SCHOOLS,STANLEY HUPFELD,,550192,0,0,27,27,
OKLAHOMA,BOARD CHAIRPERSON OKLAHOMA CITY PUBLIC SCHOOLS,PAULA LEWIS,,550193,0,0,67,67,
OKLAHOMA,BOARD CHAIRPERSON OKLAHOMA CITY PUBLIC SCHOOLS,WILFREDO SANTOS RIVERA,,550193,0,0,10,10,
OKLAHOMA,BOARD CHAIRPERSON OKLAHOMA CITY PUBLIC SCHOOLS,GREGORY A. WYATT,,550193,0,0,0,0,
OKLAHOMA,BOARD CHAIRPERSON OKLAHOMA CITY PUBLIC SCHOOLS,BIANCA ROSE,,550193,0,0,6,6,
OKLAHOMA,BOARD CHAIRPERSON OKLAHOMA CITY PUBLIC SCHOOLS,STANLEY HUPFELD,,550193,0,0,18,18,
OKLAHOMA,BOARD CHAIRPERSON OKLAHOMA CITY PUBLIC SCHOOLS,PAULA LEWIS,,550194,0,0,21,21,
OKLAHOMA,BOARD CHAIRPERSON OKLAHOMA CITY PUBLIC SCHOOLS,WILFREDO SANTOS RIVERA,,550194,0,0,8,8,
OKLAHOMA,BOARD CHAIRPERSON OKLAHOMA CITY PUBLIC SCHOOLS,GREGORY A. WYATT,,550194,0,0,0,0,
OKLAHOMA,BOARD CHAIRPERSON OKLAHOMA CITY PUBLIC SCHOOLS,BIANCA ROSE,,550194,0,0,12,12,
OKLAHOMA,BOARD CHAIRPERSON OKLAHOMA CITY PUBLIC SCHOOLS,STANLEY HUPFELD,,550194,0,0,15,15,
OKLAHOMA,OFFICE NO. 2 OKLAHOMA CITY PUBLIC SCHOOLS,JUSTIN ELLIS,,550194,0,0,2,2,OFFICE NO. 2 OKLAHOMA CITY PUBLIC SCHOOLS
OKLAHOMA,OFFICE NO. 2 OKLAHOMA CITY PUBLIC SCHOOLS,REBECCA L. BUDD,,550194,0,0,13,13,OFFICE NO. 2 OKLAHOMA CITY PUBLIC SCHOOLS
OKLAHOMA,OFFICE NO. 2 OKLAHOMA CITY PUBLIC SCHOOLS,NICK SINGER,,550194,0,0,3,3,OFFICE NO. 2 OKLAHOMA CITY PUBLIC SCHOOLS
OKLAHOMA,BOARD CHAIRPERSON OKLAHOMA CITY PUBLIC SCHOOLS,PAULA LEWIS,,550195,0,0,69,69,
OKLAHOMA,BOARD CHAIRPERSON OKLAHOMA CITY PUBLIC SCHOOLS,WILFREDO SANTOS RIVERA,,550195,0,0,16,16,
OKLAHOMA,BOARD CHAIRPERSON OKLAHOMA CITY PUBLIC SCHOOLS,GREGORY A. WYATT,,550195,0,0,7,7,
OKLAHOMA,BOARD CHAIRPERSON OKLAHOMA CITY PUBLIC SCHOOLS,BIANCA ROSE,,550195,0,0,16,16,
OKLAHOMA,BOARD CHAIRPERSON OKLAHOMA CITY PUBLIC SCHOOLS,STANLEY HUPFELD,,550195,0,0,55,55,
OKLAHOMA,OFFICE NO. 2 OKLAHOMA CITY PUBLIC SCHOOLS,JUSTIN ELLIS,,550195,0,0,26,26,OFFICE NO. 2 OKLAHOMA CITY PUBLIC SCHOOLS
OKLAHOMA,OFFICE NO. 2 OKLAHOMA CITY PUBLIC SCHOOLS,REBECCA L. BUDD,,550195,0,0,48,48,OFFICE NO. 2 OKLAHOMA CITY PUBLIC SCHOOLS
OKLAHOMA,OFFICE NO. 2 OKLAHOMA CITY PUBLIC SCHOOLS,NICK SINGER,,550195,0,0,90,90,OFFICE NO. 2 OKLAHOMA CITY PUBLIC SCHOOLS
OKLAHOMA,BOARD CHAIRPERSON OKLAHOMA CITY PUBLIC SCHOOLS,PAULA LEWIS,,550196,0,0,89,89,
OKLAHOMA,BOARD CHAIRPERSON OKLAHOMA CITY PUBLIC SCHOOLS,WILFREDO SANTOS RIVERA,,550196,0,0,21,21,
OKLAHOMA,BOARD CHAIRPERSON OKLAHOMA CITY PUBLIC SCHOOLS,GREGORY A. WYATT,,550196,0,0,5,5,
OKLAHOMA,BOARD CHAIRPERSON OKLAHOMA CITY PUBLIC SCHOOLS,BIANCA ROSE,,550196,0,0,10,10,
OKLAHOMA,BOARD CHAIRPERSON OKLAHOMA CITY PUBLIC SCHOOLS,STANLEY HUPFELD,,550196,0,0,160,160,
OKLAHOMA,OFFICE NO. 2 OKLAHOMA CITY PUBLIC SCHOOLS,JUSTIN ELLIS,,550196,0,0,80,80,OFFICE NO. 2 OKLAHOMA CITY PUBLIC SCHOOLS
OKLAHOMA,OFFICE NO. 2 OKLAHOMA CITY PUBLIC SCHOOLS,REBECCA L. BUDD,,550196,0,0,82,82,OFFICE NO. 2 OKLAHOMA CITY PUBLIC SCHOOLS
OKLAHOMA,OFFICE NO. 2 OKLAHOMA CITY PUBLIC SCHOOLS,NICK SINGER,,550196,0,0,125,125,OFFICE NO. 2 OKLAHOMA CITY PUBLIC SCHOOLS
OKLAHOMA,BOARD CHAIRPERSON OKLAHOMA CITY PUBLIC SCHOOLS,PAULA LEWIS,,550197,0,0,77,77,
OKLAHOMA,BOARD CHAIRPERSON OKLAHOMA CITY PUBLIC SCHOOLS,WILFREDO SANTOS RIVERA,,550197,0,0,15,15,
OKLAHOMA,BOARD CHAIRPERSON OKLAHOMA CITY PUBLIC SCHOOLS,GREGORY A. WYATT,,550197,0,0,0,0,
OKLAHOMA,BOARD CHAIRPERSON OKLAHOMA CITY PUBLIC SCHOOLS,BIANCA ROSE,,550197,0,0,12,12,
OKLAHOMA,BOARD CHAIRPERSON OKLAHOMA CITY PUBLIC SCHOOLS,STANLEY HUPFELD,,550197,0,0,27,27,
OKLAHOMA,OFFICE NO. 2 OKLAHOMA CITY PUBLIC SCHOOLS,JUSTIN ELLIS,,550197,0,0,17,17,OFFICE NO. 2 OKLAHOMA CITY PUBLIC SCHOOLS
OKLAHOMA,OFFICE NO. 2 OKLAHOMA CITY PUBLIC SCHOOLS,REBECCA L. BUDD,,550197,0,0,37,37,OFFICE NO. 2 OKLAHOMA CITY PUBLIC SCHOOLS
OKLAHOMA,OFFICE NO. 2 OKLAHOMA CITY PUBLIC SCHOOLS,NICK SINGER,,550197,0,0,76,76,OFFICE NO. 2 OKLAHOMA CITY PUBLIC SCHOOLS
OKLAHOMA,BOARD CHAIRPERSON OKLAHOMA CITY PUBLIC SCHOOLS,PAULA LEWIS,,550198,0,0,79,79,
OKLAHOMA,BOARD CHAIRPERSON OKLAHOMA CITY PUBLIC SCHOOLS,WILFREDO SANTOS RIVERA,,550198,0,0,19,19,
OKLAHOMA,BOARD CHAIRPERSON OKLAHOMA CITY PUBLIC SCHOOLS,GREGORY A. WYATT,,550198,0,0,3,3,
OKLAHOMA,BOARD CHAIRPERSON OKLAHOMA CITY PUBLIC SCHOOLS,BIANCA ROSE,,550198,0,0,17,17,
OKLAHOMA,BOARD CHAIRPERSON OKLAHOMA CITY PUBLIC SCHOOLS,STANLEY HUPFELD,,550198,0,0,40,40,
OKLAHOMA,OFFICE NO. 2 OKLAHOMA CITY PUBLIC SCHOOLS,JUSTIN ELLIS,,550198,0,0,31,31,OFFICE NO. 2 OKLAHOMA CITY PUBLIC SCHOOLS
OKLAHOMA,OFFICE NO. 2 OKLAHOMA CITY PUBLIC SCHOOLS,REBECCA L. BUDD,,550198,0,0,58,58,OFFICE NO. 2 OKLAHOMA CITY PUBLIC SCHOOLS
OKLAHOMA,OFFICE NO. 2 OKLAHOMA CITY PUBLIC SCHOOLS,NICK SINGER,,550198,0,0,68,68,OFFICE NO. 2 OKLAHOMA CITY PUBLIC SCHOOLS
OKLAHOMA,BOARD CHAIRPERSON OKLAHOMA CITY PUBLIC SCHOOLS,PAULA LEWIS,,550199,0,0,106,106,
OKLAHOMA,BOARD CHAIRPERSON OKLAHOMA CITY PUBLIC SCHOOLS,WILFREDO SANTOS RIVERA,,550199,0,0,15,15,
OKLAHOMA,BOARD CHAIRPERSON OKLAHOMA CITY PUBLIC SCHOOLS,GREGORY A. WYATT,,550199,0,0,5,5,
OKLAHOMA,BOARD CHAIRPERSON OKLAHOMA CITY PUBLIC SCHOOLS,BIANCA ROSE,,550199,0,0,14,14,
OKLAHOMA,BOARD CHAIRPERSON OKLAHOMA CITY PUBLIC SCHOOLS,STANLEY HUPFELD,,550199,0,0,63,63,
OKLAHOMA,OFFICE NO. 2 OKLAHOMA CITY PUBLIC SCHOOLS,JUSTIN ELLIS,,550199,0,0,36,36,OFFICE NO. 2 OKLAHOMA CITY PUBLIC SCHOOLS
OKLAHOMA,OFFICE NO. 2 OKLAHOMA CITY PUBLIC SCHOOLS,REBECCA L. BUDD,,550199,0,0,83,83,OFFICE NO. 2 OKLAHOMA CITY PUBLIC SCHOOLS
OKLAHOMA,OFFICE NO. 2 OKLAHOMA CITY PUBLIC SCHOOLS,NICK SINGER,,550199,0,0,81,81,OFFICE NO. 2 OKLAHOMA CITY PUBLIC SCHOOLS
OKLAHOMA,BOARD CHAIRPERSON OKLAHOMA CITY PUBLIC SCHOOLS,PAULA LEWIS,,550200,0,0,115,115,
OKLAHOMA,BOARD CHAIRPERSON OKLAHOMA CITY PUBLIC SCHOOLS,WILFREDO SANTOS RIVERA,,550200,0,0,16,16,
OKLAHOMA,BOARD CHAIRPERSON OKLAHOMA CITY PUBLIC SCHOOLS,GREGORY A. WYATT,,550200,0,0,1,1,
OKLAHOMA,BOARD CHAIRPERSON OKLAHOMA CITY PUBLIC SCHOOLS,BIANCA ROSE,,550200,0,0,13,13,
OKLAHOMA,BOARD CHAIRPERSON OKLAHOMA CITY PUBLIC SCHOOLS,STANLEY HUPFELD,,550200,0,0,35,35,
OKLAHOMA,BOARD CHAIRPERSON OKLAHOMA CITY PUBLIC SCHOOLS,PAULA LEWIS,,550201,0,0,33,33,
OKLAHOMA,BOARD CHAIRPERSON OKLAHOMA CITY PUBLIC SCHOOLS,WILFREDO SANTOS RIVERA,,550201,0,0,14,14,
OKLAHOMA,BOARD CHAIRPERSON OKLAHOMA CITY PUBLIC SCHOOLS,GREGORY A. WYATT,,550201,0,0,1,1,
OKLAHOMA,BOARD CHAIRPERSON OKLAHOMA CITY PUBLIC SCHOOLS,BIANCA ROSE,,550201,0,0,8,8,
OKLAHOMA,BOARD CHAIRPERSON OKLAHOMA CITY PUBLIC SCHOOLS,STANLEY HUPFELD,,550201,0,0,8,8,
OKLAHOMA,BOARD CHAIRPERSON OKLAHOMA CITY PUBLIC SCHOOLS,PAULA LEWIS,,550202,0,0,44,44,
OKLAHOMA,BOARD CHAIRPERSON OKLAHOMA CITY PUBLIC SCHOOLS,WILFREDO SANTOS RIVERA,,550202,0,0,7,7,
OKLAHOMA,BOARD CHAIRPERSON OKLAHOMA CITY PUBLIC SCHOOLS,GREGORY A. WYATT,,550202,0,0,1,1,
OKLAHOMA,BOARD CHAIRPERSON OKLAHOMA CITY PUBLIC SCHOOLS,BIANCA ROSE,,550202,0,0,10,10,
OKLAHOMA,BOARD CHAIRPERSON OKLAHOMA CITY PUBLIC SCHOOLS,STANLEY HUPFELD,,550202,0,0,22,22,
OKLAHOMA,BOARD CHAIRPERSON OKLAHOMA CITY PUBLIC SCHOOLS,PAULA LEWIS,,550203,0,0,34,34,
OKLAHOMA,BOARD CHAIRPERSON OKLAHOMA CITY PUBLIC SCHOOLS,WILFREDO SANTOS RIVERA,,550203,0,0,14,14,
OKLAHOMA,BOARD CHAIRPERSON OKLAHOMA CITY PUBLIC SCHOOLS,GREGORY A. WYATT,,550203,0,0,1,1,
OKLAHOMA,BOARD CHAIRPERSON OKLAHOMA CITY PUBLIC SCHOOLS,BIANCA ROSE,,550203,0,0,8,8,
OKLAHOMA,BOARD CHAIRPERSON OKLAHOMA CITY PUBLIC SCHOOLS,STANLEY HUPFELD,,550203,0,0,19,19,
OKLAHOMA,BOARD CHAIRPERSON OKLAHOMA CITY PUBLIC SCHOOLS,PAULA LEWIS,,550204,0,0,259,259,
OKLAHOMA,BOARD CHAIRPERSON OKLAHOMA CITY PUBLIC SCHOOLS,WILFREDO SANTOS RIVERA,,550204,0,0,14,14,
OKLAHOMA,BOARD CHAIRPERSON OKLAHOMA CITY PUBLIC SCHOOLS,GREGORY A. WYATT,,550204,0,0,1,1,
OKLAHOMA,BOARD CHAIRPERSON OKLAHOMA CITY PUBLIC SCHOOLS,BIANCA ROSE,,550204,0,0,14,14,
OKLAHOMA,BOARD CHAIRPERSON OKLAHOMA CITY PUBLIC SCHOOLS,STANLEY HUPFELD,,550204,0,0,55,55,
OKLAHOMA,"COUNCILMEMBER, WARD 7 CITY OF OKLAHOMA CITY","JOHN A. PETTIS, JR.",,550205,0,0,0,0,"COUNCILMEMBER, WARD 7 CITY OF OKLAHOMA CITY"
OKLAHOMA,"COUNCILMEMBER, WARD 7 CITY OF OKLAHOMA CITY",MARINA MANGIARACINA,,550205,0,0,0,0,"COUNCILMEMBER, WARD 7 CITY OF OKLAHOMA CITY"
OKLAHOMA,"COUNCILMEMBER, WARD 7 CITY OF OKLAHOMA CITY",T. SHERI DICKERSON,,550205,0,0,0,0,"COUNCILMEMBER, WARD 7 CITY OF OKLAHOMA CITY"
OKLAHOMA,BOARD CHAIRPERSON OKLAHOMA CITY PUBLIC SCHOOLS,PAULA LEWIS,,550205,0,0,24,24,
OKLAHOMA,BOARD CHAIRPERSON OKLAHOMA CITY PUBLIC SCHOOLS,WILFREDO SANTOS RIVERA,,550205,0,0,5,5,
OKLAHOMA,BOARD CHAIRPERSON OKLAHOMA CITY PUBLIC SCHOOLS,GREGORY A. WYATT,,550205,0,0,0,0,
OKLAHOMA,BOARD CHAIRPERSON OKLAHOMA CITY PUBLIC SCHOOLS,BIANCA ROSE,,550205,0,0,7,7,
OKLAHOMA,BOARD CHAIRPERSON OKLAHOMA CITY PUBLIC SCHOOLS,STANLEY HUPFELD,,550205,0,0,10,10,
OKLAHOMA,"COUNCILMEMBER, WARD 4 CITY OF OKLAHOMA CITY",RICHARD D. MORRISSETTE,,550206,0,0,16,16,"COUNCILMEMBER, WARD 4 CITY OF OKLAHOMA CITY"
OKLAHOMA,"COUNCILMEMBER, WARD 4 CITY OF OKLAHOMA CITY",TODD STONE,,550206,0,0,7,7,"COUNCILMEMBER, WARD 4 CITY OF OKLAHOMA CITY"
OKLAHOMA,"COUNCILMEMBER, WARD 4 CITY OF OKLAHOMA CITY",WALTER KULA,,550206,0,0,0,0,"COUNCILMEMBER, WARD 4 CITY OF OKLAHOMA CITY"
OKLAHOMA,"COUNCILMEMBER, WARD 4 CITY OF OKLAHOMA CITY",DORIS MANGIARACINA BENBROOK,,550206,0,0,3,3,"COUNCILMEMBER, WARD 4 CITY OF OKLAHOMA CITY"
OKLAHOMA,"COUNCILMEMBER, WARD 7 CITY OF OKLAHOMA CITY","JOHN A. PETTIS, JR.",,550206,0,0,1,1,"COUNCILMEMBER, WARD 7 CITY OF OKLAHOMA CITY"
OKLAHOMA,"COUNCILMEMBER, WARD 7 CITY OF OKLAHOMA CITY",MARINA MANGIARACINA,,550206,0,0,4,4,"COUNCILMEMBER, WARD 7 CITY OF OKLAHOMA CITY"
OKLAHOMA,"COUNCILMEMBER, WARD 7 CITY OF OKLAHOMA CITY",T. SHERI DICKERSON,,550206,0,0,1,1,"COUNCILMEMBER, WARD 7 CITY OF OKLAHOMA CITY"
OKLAHOMA,BOARD CHAIRPERSON OKLAHOMA CITY PUBLIC SCHOOLS,PAULA LEWIS,,550206,0,0,10,10,
OKLAHOMA,BOARD CHAIRPERSON OKLAHOMA CITY PUBLIC SCHOOLS,WILFREDO SANTOS RIVERA,,550206,0,0,7,7,
OKLAHOMA,BOARD CHAIRPERSON OKLAHOMA CITY PUBLIC SCHOOLS,GREGORY A. WYATT,,550206,0,0,6,6,
OKLAHOMA,BOARD CHAIRPERSON OKLAHOMA CITY PUBLIC SCHOOLS,BIANCA ROSE,,550206,0,0,5,5,
OKLAHOMA,BOARD CHAIRPERSON OKLAHOMA CITY PUBLIC SCHOOLS,STANLEY HUPFELD,,550206,0,0,6,6,
OKLAHOMA,BOARD CHAIRPERSON OKLAHOMA CITY PUBLIC SCHOOLS,PAULA LEWIS,,550207,0,0,7,7,
OKLAHOMA,BOARD CHAIRPERSON OKLAHOMA CITY PUBLIC SCHOOLS,WILFREDO SANTOS RIVERA,,550207,0,0,9,9,
OKLAHOMA,BOARD CHAIRPERSON OKLAHOMA CITY PUBLIC SCHOOLS,GREGORY A. WYATT,,550207,0,0,0,0,
OKLAHOMA,BOARD CHAIRPERSON OKLAHOMA CITY PUBLIC SCHOOLS,BIANCA ROSE,,550207,0,0,1,1,
OKLAHOMA,BOARD CHAIRPERSON OKLAHOMA CITY PUBLIC SCHOOLS,STANLEY HUPFELD,,550207,0,0,3,3,
OKLAHOMA,BOARD CHAIRPERSON OKLAHOMA CITY PUBLIC SCHOOLS,PAULA LEWIS,,550208,0,0,0,0,
OKLAHOMA,BOARD CHAIRPERSON OKLAHOMA CITY PUBLIC SCHOOLS,WILFREDO SANTOS RIVERA,,550208,0,0,0,0,
OKLAHOMA,BOARD CHAIRPERSON OKLAHOMA CITY PUBLIC SCHOOLS,GREGORY A. WYATT,,550208,0,0,0,0,
OKLAHOMA,BOARD CHAIRPERSON OKLAHOMA CITY PUBLIC SCHOOLS,BIANCA ROSE,,550208,0,0,0,0,
OKLAHOMA,BOARD CHAIRPERSON OKLAHOMA CITY PUBLIC SCHOOLS,STANLEY HUPFELD,,550208,0,0,0,0,
OKLAHOMA,"COUNCILMEMBER, WARD 3 CITY OF OKLAHOMA CITY",LARRY McATEE,,550209,0,0,5,5,"COUNCILMEMBER, WARD 3 CITY OF OKLAHOMA CITY"
OKLAHOMA,"COUNCILMEMBER, WARD 3 CITY OF OKLAHOMA CITY",MATTHEW W. OLSEN,,550209,0,0,4,4,"COUNCILMEMBER, WARD 3 CITY OF OKLAHOMA CITY"
OKLAHOMA,"COUNCILMEMBER, WARD 3 CITY OF OKLAHOMA CITY",JOE SARGE NELSON,,550209,0,0,0,0,"COUNCILMEMBER, WARD 3 CITY OF OKLAHOMA CITY"
OKLAHOMA,BOARD CHAIRPERSON OKLAHOMA CITY PUBLIC SCHOOLS,PAULA LEWIS,,550209,0,0,4,4,
OKLAHOMA,BOARD CHAIRPERSON OKLAHOMA CITY PUBLIC SCHOOLS,WILFREDO SANTOS RIVERA,,550209,0,0,1,1,
OKLAHOMA,BOARD CHAIRPERSON OKLAHOMA CITY PUBLIC SCHOOLS,GREGORY A. WYATT,,550209,0,0,4,4,
OKLAHOMA,BOARD CHAIRPERSON OKLAHOMA CITY PUBLIC SCHOOLS,BIANCA ROSE,,550209,0,0,1,1,
OKLAHOMA,BOARD CHAIRPERSON OKLAHOMA CITY PUBLIC SCHOOLS,STANLEY HUPFELD,,550209,0,0,7,7,
OKLAHOMA,"COUNCILMEMBER, WARD 3 CITY OF OKLAHOMA CITY",LARRY McATEE,,550210,0,0,7,7,"COUNCILMEMBER, WARD 3 CITY OF OKLAHOMA CITY"
OKLAHOMA,"COUNCILMEMBER, WARD 3 CITY OF OKLAHOMA CITY",MATTHEW W. OLSEN,,550210,0,0,3,3,"COUNCILMEMBER, WARD 3 CITY OF OKLAHOMA CITY"
OKLAHOMA,"COUNCILMEMBER, WARD 3 CITY OF OKLAHOMA CITY",JOE SARGE NELSON,,550210,0,0,1,1,"COUNCILMEMBER, WARD 3 CITY OF OKLAHOMA CITY"
OKLAHOMA,BOARD CHAIRPERSON OKLAHOMA CITY PUBLIC SCHOOLS,PAULA LEWIS,,550210,0,0,6,6,
OKLAHOMA,BOARD CHAIRPERSON OKLAHOMA CITY PUBLIC SCHOOLS,WILFREDO SANTOS RIVERA,,550210,0,0,6,6,
OKLAHOMA,BOARD CHAIRPERSON OKLAHOMA CITY PUBLIC SCHOOLS,GREGORY A. WYATT,,550210,0,0,2,2,
OKLAHOMA,BOARD CHAIRPERSON OKLAHOMA CITY PUBLIC SCHOOLS,BIANCA ROSE,,550210,0,0,1,1,
OKLAHOMA,BOARD CHAIRPERSON OKLAHOMA CITY PUBLIC SCHOOLS,STANLEY HUPFELD,,550210,0,0,10,10,
OKLAHOMA,BOARD CHAIRPERSON OKLAHOMA CITY PUBLIC SCHOOLS,PAULA LEWIS,,550211,0,0,7,7,
OKLAHOMA,BOARD CHAIRPERSON OKLAHOMA CITY PUBLIC SCHOOLS,WILFREDO SANTOS RIVERA,,550211,0,0,0,0,
OKLAHOMA,BOARD CHAIRPERSON OKLAHOMA CITY PUBLIC SCHOOLS,GREGORY A. WYATT,,550211,0,0,2,2,
OKLAHOMA,BOARD CHAIRPERSON OKLAHOMA CITY PUBLIC SCHOOLS,BIANCA ROSE,,550211,0,0,3,3,
OKLAHOMA,BOARD CHAIRPERSON OKLAHOMA CITY PUBLIC SCHOOLS,STANLEY HUPFELD,,550211,0,0,8,8,
OKLAHOMA,BOARD CHAIRPERSON OKLAHOMA CITY PUBLIC SCHOOLS,PAULA LEWIS,,550212,0,0,4,4,
OKLAHOMA,BOARD CHAIRPERSON OKLAHOMA CITY PUBLIC SCHOOLS,WILFREDO SANTOS RIVERA,,550212,0,0,3,3,
OKLAHOMA,BOARD CHAIRPERSON OKLAHOMA CITY PUBLIC SCHOOLS,GREGORY A. WYATT,,550212,0,0,0,0,
OKLAHOMA,BOARD CHAIRPERSON OKLAHOMA CITY PUBLIC SCHOOLS,BIANCA ROSE,,550212,0,0,0,0,
OKLAHOMA,BOARD CHAIRPERSON OKLAHOMA CITY PUBLIC SCHOOLS,STANLEY HUPFELD,,550212,0,0,7,7,
OKLAHOMA,"COUNCILMEMBER, WARD 4 CITY OF OKLAHOMA CITY",RICHARD D. MORRISSETTE,,550213,0,0,13,13,"COUNCILMEMBER, WARD 4 CITY OF OKLAHOMA CITY"
OKLAHOMA,"COUNCILMEMBER, WARD 4 CITY OF OKLAHOMA CITY",TODD STONE,,550213,0,0,7,7,"COUNCILMEMBER, WARD 4 CITY OF OKLAHOMA CITY"
OKLAHOMA,"COUNCILMEMBER, WARD 4 CITY OF OKLAHOMA CITY",WALTER KULA,,550213,0,0,3,3,"COUNCILMEMBER, WARD 4 CITY OF OKLAHOMA CITY"
OKLAHOMA,"COUNCILMEMBER, WARD 4 CITY OF OKLAHOMA CITY",DORIS MANGIARACINA BENBROOK,,550213,0,0,4,4,"COUNCILMEMBER, WARD 4 CITY OF OKLAHOMA CITY"
OKLAHOMA,BOARD CHAIRPERSON OKLAHOMA CITY PUBLIC SCHOOLS,PAULA LEWIS,,550213,0,0,9,9,
OKLAHOMA,BOARD CHAIRPERSON OKLAHOMA CITY PUBLIC SCHOOLS,WILFREDO SANTOS RIVERA,,550213,0,0,5,5,
OKLAHOMA,BOARD CHAIRPERSON OKLAHOMA CITY PUBLIC SCHOOLS,GREGORY A. WYATT,,550213,0,0,2,2,
OKLAHOMA,BOARD CHAIRPERSON OKLAHOMA CITY PUBLIC SCHOOLS,BIANCA ROSE,,550213,0,0,1,1,
OKLAHOMA,BOARD CHAIRPERSON OKLAHOMA CITY PUBLIC SCHOOLS,STANLEY HUPFELD,,550213,0,0,10,10,
OKLAHOMA,"COUNCILMEMBER, WARD 4 CITY OF OKLAHOMA CITY",RICHARD D. MORRISSETTE,,550214,0,0,11,11,"COUNCILMEMBER, WARD 4 CITY OF OKLAHOMA CITY"
OKLAHOMA,"COUNCILMEMBER, WARD 4 CITY OF OKLAHOMA CITY",TODD STONE,,550214,0,0,17,17,"COUNCILMEMBER, WARD 4 CITY OF OKLAHOMA CITY"
OKLAHOMA,"COUNCILMEMBER, WARD 4 CITY OF OKLAHOMA CITY",WALTER KULA,,550214,0,0,0,0,"COUNCILMEMBER, WARD 4 CITY OF OKLAHOMA CITY"
OKLAHOMA,"COUNCILMEMBER, WARD 4 CITY OF OKLAHOMA CITY",DORIS MANGIARACINA BENBROOK,,550214,0,0,1,1,"COUNCILMEMBER, WARD 4 CITY OF OKLAHOMA CITY"
OKLAHOMA,BOARD CHAIRPERSON OKLAHOMA CITY PUBLIC SCHOOLS,PAULA LEWIS,,550214,0,0,8,8,
OKLAHOMA,BOARD CHAIRPERSON OKLAHOMA CITY PUBLIC SCHOOLS,WILFREDO SANTOS RIVERA,,550214,0,0,4,4,
OKLAHOMA,BOARD CHAIRPERSON OKLAHOMA CITY PUBLIC SCHOOLS,GREGORY A. WYATT,,550214,0,0,1,1,
OKLAHOMA,BOARD CHAIRPERSON OKLAHOMA CITY PUBLIC SCHOOLS,BIANCA ROSE,,550214,0,0,0,0,
OKLAHOMA,BOARD CHAIRPERSON OKLAHOMA CITY PUBLIC SCHOOLS,STANLEY HUPFELD,,550214,0,0,16,16,
OKLAHOMA,"COUNCILMEMBER, WARD 4 CITY OF OKLAHOMA CITY",RICHARD D. MORRISSETTE,,550215,0,0,23,23,"COUNCILMEMBER, WARD 4 CITY OF OKLAHOMA CITY"
OKLAHOMA,"COUNCILMEMBER, WARD 4 CITY OF OKLAHOMA CITY",TODD STONE,,550215,0,0,5,5,"COUNCILMEMBER, WARD 4 CITY OF OKLAHOMA CITY"
OKLAHOMA,"COUNCILMEMBER, WARD 4 CITY OF OKLAHOMA CITY",WALTER KULA,,550215,0,0,1,1,"COUNCILMEMBER, WARD 4 CITY OF OKLAHOMA CITY"
OKLAHOMA,"COUNCILMEMBER, WARD 4 CITY OF OKLAHOMA CITY",DORIS MANGIARACINA BENBROOK,,550215,0,0,2,2,"COUNCILMEMBER, WARD 4 CITY OF OKLAHOMA CITY"
OKLAHOMA,"COUNCILMEMBER, WARD 7 CITY OF OKLAHOMA CITY","JOHN A. PETTIS, JR.",,550215,0,0,11,11,"COUNCILMEMBER, WARD 7 CITY OF OKLAHOMA CITY"
OKLAHOMA,"COUNCILMEMBER, WARD 7 CITY OF OKLAHOMA CITY",MARINA MANGIARACINA,,550215,0,0,3,3,"COUNCILMEMBER, WARD 7 CITY OF OKLAHOMA CITY"
OKLAHOMA,"COUNCILMEMBER, WARD 7 CITY OF OKLAHOMA CITY",T. SHERI DICKERSON,,550215,0,0,4,4,"COUNCILMEMBER, WARD 7 CITY OF OKLAHOMA CITY"
OKLAHOMA,BOARD CHAIRPERSON OKLAHOMA CITY PUBLIC SCHOOLS,PAULA LEWIS,,550215,0,0,12,12,
OKLAHOMA,BOARD CHAIRPERSON OKLAHOMA CITY PUBLIC SCHOOLS,WILFREDO SANTOS RIVERA,,550215,0,0,14,14,
OKLAHOMA,BOARD CHAIRPERSON OKLAHOMA CITY PUBLIC SCHOOLS,GREGORY A. WYATT,,550215,0,0,7,7,
OKLAHOMA,BOARD CHAIRPERSON OKLAHOMA CITY PUBLIC SCHOOLS,BIANCA ROSE,,550215,0,0,3,3,
OKLAHOMA,BOARD CHAIRPERSON OKLAHOMA CITY PUBLIC SCHOOLS,STANLEY HUPFELD,,550215,0,0,12,12,
OKLAHOMA,"COUNCILMEMBER, WARD 4 CITY OF OKLAHOMA CITY",RICHARD D. MORRISSETTE,,550216,0,0,0,0,"COUNCILMEMBER, WARD 4 CITY OF OKLAHOMA CITY"
OKLAHOMA,"COUNCILMEMBER, WARD 4 CITY OF OKLAHOMA CITY",TODD STONE,,550216,0,0,0,0,"COUNCILMEMBER, WARD 4 CITY OF OKLAHOMA CITY"
OKLAHOMA,"COUNCILMEMBER, WARD 4 CITY OF OKLAHOMA CITY",WALTER KULA,,550216,0,0,0,0,"COUNCILMEMBER, WARD 4 CITY OF OKLAHOMA CITY"
OKLAHOMA,"COUNCILMEMBER, WARD 4 CITY OF OKLAHOMA CITY",DORIS MANGIARACINA BENBROOK,,550216,0,0,0,0,"COUNCILMEMBER, WARD 4 CITY OF OKLAHOMA CITY"
OKLAHOMA,BOARD CHAIRPERSON OKLAHOMA CITY PUBLIC SCHOOLS,PAULA LEWIS,,550216,0,0,0,0,
OKLAHOMA,BOARD CHAIRPERSON OKLAHOMA CITY PUBLIC SCHOOLS,WILFREDO SANTOS RIVERA,,550216,0,0,0,0,
OKLAHOMA,BOARD CHAIRPERSON OKLAHOMA CITY PUBLIC SCHOOLS,GREGORY A. WYATT,,550216,0,0,0,0,
OKLAHOMA,BOARD CHAIRPERSON OKLAHOMA CITY PUBLIC SCHOOLS,BIANCA ROSE,,550216,0,0,0,0,
OKLAHOMA,BOARD CHAIRPERSON OKLAHOMA CITY PUBLIC SCHOOLS,STANLEY HUPFELD,,550216,0,0,0,0,
OKLAHOMA,"COUNCILMEMBER, WARD 4 CITY OF OKLAHOMA CITY",RICHARD D. MORRISSETTE,,550217,0,0,63,63,"COUNCILMEMBER, WARD 4 CITY OF OKLAHOMA CITY"
OKLAHOMA,"COUNCILMEMBER, WARD 4 CITY OF OKLAHOMA CITY",TODD STONE,,550217,0,0,37,37,"COUNCILMEMBER, WARD 4 CITY OF OKLAHOMA CITY"
OKLAHOMA,"COUNCILMEMBER, WARD 4 CITY OF OKLAHOMA CITY",WALTER KULA,,550217,0,0,3,3,"COUNCILMEMBER, WARD 4 CITY OF OKLAHOMA CITY"
OKLAHOMA,"COUNCILMEMBER, WARD 4 CITY OF OKLAHOMA CITY",DORIS MANGIARACINA BENBROOK,,550217,0,0,14,14,"COUNCILMEMBER, WARD 4 CITY OF OKLAHOMA CITY"
OKLAHOMA,BOARD CHAIRPERSON OKLAHOMA CITY PUBLIC SCHOOLS,PAULA LEWIS,,550217,0,0,45,45,
OKLAHOMA,BOARD CHAIRPERSON OKLAHOMA CITY PUBLIC SCHOOLS,WILFREDO SANTOS RIVERA,,550217,0,0,17,17,
OKLAHOMA,BOARD CHAIRPERSON OKLAHOMA CITY PUBLIC SCHOOLS,GREGORY A. WYATT,,550217,0,0,11,11,
OKLAHOMA,BOARD CHAIRPERSON OKLAHOMA CITY PUBLIC SCHOOLS,BIANCA ROSE,,550217,0,0,8,8,
OKLAHOMA,BOARD CHAIRPERSON OKLAHOMA CITY PUBLIC SCHOOLS,STANLEY HUPFELD,,550217,0,0,33,33,
OKLAHOMA,"COUNCILMEMBER, WARD 4 CITY OF OKLAHOMA CITY",RICHARD D. MORRISSETTE,,550218,0,0,48,48,"COUNCILMEMBER, WARD 4 CITY OF OKLAHOMA CITY"
OKLAHOMA,"COUNCILMEMBER, WARD 4 CITY OF OKLAHOMA CITY",TODD STONE,,550218,0,0,21,21,"COUNCILMEMBER, WARD 4 CITY OF OKLAHOMA CITY"
OKLAHOMA,"COUNCILMEMBER, WARD 4 CITY OF OKLAHOMA CITY",WALTER KULA,,550218,0,0,3,3,"COUNCILMEMBER, WARD 4 CITY OF OKLAHOMA CITY"
OKLAHOMA,"COUNCILMEMBER, WARD 4 CITY OF OKLAHOMA CITY",DORIS MANGIARACINA BENBROOK,,550218,0,0,2,2,"COUNCILMEMBER, WARD 4 CITY OF OKLAHOMA CITY"
OKLAHOMA,BOARD CHAIRPERSON OKLAHOMA CITY PUBLIC SCHOOLS,PAULA LEWIS,,550218,0,0,24,24,
OKLAHOMA,BOARD CHAIRPERSON OKLAHOMA CITY PUBLIC SCHOOLS,WILFREDO SANTOS RIVERA,,550218,0,0,9,9,
OKLAHOMA,BOARD CHAIRPERSON OKLAHOMA CITY PUBLIC SCHOOLS,GREGORY A. WYATT,,550218,0,0,9,9,
OKLAHOMA,BOARD CHAIRPERSON OKLAHOMA CITY PUBLIC SCHOOLS,BIANCA ROSE,,550218,0,0,7,7,
OKLAHOMA,BOARD CHAIRPERSON OKLAHOMA CITY PUBLIC SCHOOLS,STANLEY HUPFELD,,550218,0,0,35,35,
OKLAHOMA,BOARD CHAIRPERSON OKLAHOMA CITY PUBLIC SCHOOLS,PAULA LEWIS,,550219,0,0,1,1,
OKLAHOMA,BOARD CHAIRPERSON OKLAHOMA CITY PUBLIC SCHOOLS,WILFREDO SANTOS RIVERA,,550219,0,0,0,0,
OKLAHOMA,BOARD CHAIRPERSON OKLAHOMA CITY PUBLIC SCHOOLS,GREGORY A. WYATT,,550219,0,0,1,1,
OKLAHOMA,BOARD CHAIRPERSON OKLAHOMA CITY PUBLIC SCHOOLS,BIANCA ROSE,,550219,0,0,1,1,
OKLAHOMA,BOARD CHAIRPERSON OKLAHOMA CITY PUBLIC SCHOOLS,STANLEY HUPFELD,,550219,0,0,8,8,
OKLAHOMA,BOARD CHAIRPERSON OKLAHOMA CITY PUBLIC SCHOOLS,PAULA LEWIS,,550220,0,0,6,6,
OKLAHOMA,BOARD CHAIRPERSON OKLAHOMA CITY PUBLIC SCHOOLS,WILFREDO SANTOS RIVERA,,550220,0,0,2,2,
OKLAHOMA,BOARD CHAIRPERSON OKLAHOMA CITY PUBLIC SCHOOLS,GREGORY A. WYATT,,550220,0,0,1,1,
OKLAHOMA,BOARD CHAIRPERSON OKLAHOMA CITY PUBLIC SCHOOLS,BIANCA ROSE,,550220,0,0,2,2,
OKLAHOMA,BOARD CHAIRPERSON OKLAHOMA CITY PUBLIC SCHOOLS,STANLEY HUPFELD,,550220,0,0,3,3,
OKLAHOMA,BOARD CHAIRPERSON OKLAHOMA CITY PUBLIC SCHOOLS,PAULA LEWIS,,550221,0,0,13,13,
OKLAHOMA,BOARD CHAIRPERSON OKLAHOMA CITY PUBLIC SCHOOLS,WILFREDO SANTOS RIVERA,,550221,0,0,2,2,
OKLAHOMA,BOARD CHAIRPERSON OKLAHOMA CITY PUBLIC SCHOOLS,GREGORY A. WYATT,,550221,0,0,1,1,
OKLAHOMA,BOARD CHAIRPERSON OKLAHOMA CITY PUBLIC SCHOOLS,BIANCA ROSE,,550221,0,0,1,1,
OKLAHOMA,BOARD CHAIRPERSON OKLAHOMA CITY PUBLIC SCHOOLS,STANLEY HUPFELD,,550221,0,0,18,18,
OKLAHOMA,BOARD CHAIRPERSON OKLAHOMA CITY PUBLIC SCHOOLS,PAULA LEWIS,,550222,0,0,7,7,
OKLAHOMA,BOARD CHAIRPERSON OKLAHOMA CITY PUBLIC SCHOOLS,WILFREDO SANTOS RIVERA,,550222,0,0,4,4,
OKLAHOMA,BOARD CHAIRPERSON OKLAHOMA CITY PUBLIC SCHOOLS,GREGORY A. WYATT,,550222,0,0,0,0,
OKLAHOMA,BOARD CHAIRPERSON OKLAHOMA CITY PUBLIC SCHOOLS,BIANCA ROSE,,550222,0,0,2,2,
OKLAHOMA,BOARD CHAIRPERSON OKLAHOMA CITY PUBLIC SCHOOLS,STANLEY HUPFELD,,550222,0,0,8,8,
OKLAHOMA,BOARD CHAIRPERSON OKLAHOMA CITY PUBLIC SCHOOLS,PAULA LEWIS,,550223,0,0,6,6,
OKLAHOMA,BOARD CHAIRPERSON OKLAHOMA CITY PUBLIC SCHOOLS,WILFREDO SANTOS RIVERA,,550223,0,0,3,3,
OKLAHOMA,BOARD CHAIRPERSON OKLAHOMA CITY PUBLIC SCHOOLS,GREGORY A. WYATT,,550223,0,0,0,0,
OKLAHOMA,BOARD CHAIRPERSON OKLAHOMA CITY PUBLIC SCHOOLS,BIANCA ROSE,,550223,0,0,0,0,
OKLAHOMA,BOARD CHAIRPERSON OKLAHOMA CITY PUBLIC SCHOOLS,STANLEY HUPFELD,,550223,0,0,4,4,
OKLAHOMA,BOARD CHAIRPERSON OKLAHOMA CITY PUBLIC SCHOOLS,PAULA LEWIS,,550224,0,0,9,9,
OKLAHOMA,BOARD CHAIRPERSON OKLAHOMA CITY PUBLIC SCHOOLS,WILFREDO SANTOS RIVERA,,550224,0,0,2,2,
OKLAHOMA,BOARD CHAIRPERSON OKLAHOMA CITY PUBLIC SCHOOLS,GREGORY A. WYATT,,550224,0,0,0,0,
OKLAHOMA,BOARD CHAIRPERSON OKLAHOMA CITY PUBLIC SCHOOLS,BIANCA ROSE,,550224,0,0,1,1,
OKLAHOMA,BOARD CHAIRPERSON OKLAHOMA CITY PUBLIC SCHOOLS,STANLEY HUPFELD,,550224,0,0,12,12,
OKLAHOMA,"COUNCILMEMBER, WARD 3 CITY OF OKLAHOMA CITY",LARRY McATEE,,550225,0,0,5,5,"COUNCILMEMBER, WARD 3 CITY OF OKLAHOMA CITY"
OKLAHOMA,"COUNCILMEMBER, WARD 3 CITY OF OKLAHOMA CITY",MATTHEW W. OLSEN,,550225,0,0,3,3,"COUNCILMEMBER, WARD 3 CITY OF OKLAHOMA CITY"
OKLAHOMA,"COUNCILMEMBER, WARD 3 CITY OF OKLAHOMA CITY",JOE SARGE NELSON,,550225,0,0,1,1,"COUNCILMEMBER, WARD 3 CITY OF OKLAHOMA CITY"
OKLAHOMA,BOARD CHAIRPERSON OKLAHOMA CITY PUBLIC SCHOOLS,PAULA LEWIS,,550225,0,0,3,3,
OKLAHOMA,BOARD CHAIRPERSON OKLAHOMA CITY PUBLIC SCHOOLS,WILFREDO SANTOS RIVERA,,550225,0,0,0,0,
OKLAHOMA,BOARD CHAIRPERSON OKLAHOMA CITY PUBLIC SCHOOLS,GREGORY A. WYATT,,550225,0,0,1,1,
OKLAHOMA,BOARD CHAIRPERSON OKLAHOMA CITY PUBLIC SCHOOLS,BIANCA ROSE,,550225,0,0,2,2,
OKLAHOMA,BOARD CHAIRPERSON OKLAHOMA CITY PUBLIC SCHOOLS,STANLEY HUPFELD,,550225,0,0,3,3,
OKLAHOMA,"COUNCILMEMBER, WARD 3 CITY OF OKLAHOMA CITY",LARRY McATEE,,550226,0,0,12,12,"COUNCILMEMBER, WARD 3 CITY OF OKLAHOMA CITY"
OKLAHOMA,"COUNCILMEMBER, WARD 3 CITY OF OKLAHOMA CITY",MATTHEW W. OLSEN,,550226,0,0,12,12,"COUNCILMEMBER, WARD 3 CITY OF OKLAHOMA CITY"
OKLAHOMA,"COUNCILMEMBER, WARD 3 CITY OF OKLAHOMA CITY",JOE SARGE NELSON,,550226,0,0,8,8,"COUNCILMEMBER, WARD 3 CITY OF OKLAHOMA CITY"
OKLAHOMA,OFFICE NO. 2 FRANCIS TUTTLE TECH CENTER,PETE LEE,,550226,0,0,1,1,OFFICE NO. 2 FRANCIS TUTTLE TECH CENTER
OKLAHOMA,OFFICE NO. 2 FRANCIS TUTTLE TECH CENTER,ROBERT STONE,,550226,0,0,2,2,OFFICE NO. 2 FRANCIS TUTTLE TECH CENTER
OKLAHOMA,BOARD CHAIRPERSON OKLAHOMA CITY PUBLIC SCHOOLS,PAULA LEWIS,,550226,0,0,8,8,
OKLAHOMA,BOARD CHAIRPERSON OKLAHOMA CITY PUBLIC SCHOOLS,WILFREDO SANTOS RIVERA,,550226,0,0,2,2,
OKLAHOMA,BOARD CHAIRPERSON OKLAHOMA CITY PUBLIC SCHOOLS,GREGORY A. WYATT,,550226,0,0,1,1,
OKLAHOMA,BOARD CHAIRPERSON OKLAHOMA CITY PUBLIC SCHOOLS,BIANCA ROSE,,550226,0,0,3,3,
OKLAHOMA,BOARD CHAIRPERSON OKLAHOMA CITY PUBLIC SCHOOLS,STANLEY HUPFELD,,550226,0,0,15,15,
OKLAHOMA,"COUNCILMEMBER, WARD 3 CITY OF OKLAHOMA CITY",LARRY McATEE,,550227,0,0,10,10,"COUNCILMEMBER, WARD 3 CITY OF OKLAHOMA CITY"
OKLAHOMA,"COUNCILMEMBER, WARD 3 CITY OF OKLAHOMA CITY",MATTHEW W. OLSEN,,550227,0,0,8,8,"COUNCILMEMBER, WARD 3 CITY OF OKLAHOMA CITY"
OKLAHOMA,"COUNCILMEMBER, WARD 3 CITY OF OKLAHOMA CITY",JOE SARGE NELSON,,550227,0,0,1,1,"COUNCILMEMBER, WARD 3 CITY OF OKLAHOMA CITY"
OKLAHOMA,OFFICE NO. 2 FRANCIS TUTTLE TECH CENTER,PETE LEE,,550227,0,0,4,4,OFFICE NO. 2 FRANCIS TUTTLE TECH CENTER
OKLAHOMA,OFFICE NO. 2 FRANCIS TUTTLE TECH CENTER,ROBERT STONE,,550227,0,0,3,3,OFFICE NO. 2 FRANCIS TUTTLE TECH CENTER
OKLAHOMA,BOARD CHAIRPERSON OKLAHOMA CITY PUBLIC SCHOOLS,PAULA LEWIS,,550227,0,0,3,3,
OKLAHOMA,BOARD CHAIRPERSON OKLAHOMA CITY PUBLIC SCHOOLS,WILFREDO SANTOS RIVERA,,550227,0,0,0,0,
OKLAHOMA,BOARD CHAIRPERSON OKLAHOMA CITY PUBLIC SCHOOLS,GREGORY A. WYATT,,550227,0,0,0,0,
OKLAHOMA,BOARD CHAIRPERSON OKLAHOMA CITY PUBLIC SCHOOLS,BIANCA ROSE,,550227,0,0,1,1,
OKLAHOMA,BOARD CHAIRPERSON OKLAHOMA CITY PUBLIC SCHOOLS,STANLEY HUPFELD,,550227,0,0,6,6,
OKLAHOMA,"COUNCILMEMBER, WARD 3 CITY OF OKLAHOMA CITY",LARRY McATEE,,550228,0,0,0,0,"COUNCILMEMBER, WARD 3 CITY OF OKLAHOMA CITY"
OKLAHOMA,"COUNCILMEMBER, WARD 3 CITY OF OKLAHOMA CITY",MATTHEW W. OLSEN,,550228,0,0,3,3,"COUNCILMEMBER, WARD 3 CITY OF OKLAHOMA CITY"
OKLAHOMA,"COUNCILMEMBER, WARD 3 CITY OF OKLAHOMA CITY",JOE SARGE NELSON,,550228,0,0,0,0,"COUNCILMEMBER, WARD 3 CITY OF OKLAHOMA CITY"
OKLAHOMA,OFFICE NO. 2 FRANCIS TUTTLE TECH CENTER,PETE LEE,,550228,0,0,2,2,OFFICE NO. 2 FRANCIS TUTTLE TECH CENTER
OKLAHOMA,OFFICE NO. 2 FRANCIS TUTTLE TECH CENTER,ROBERT STONE,,550228,0,0,1,1,OFFICE NO. 2 FRANCIS TUTTLE TECH CENTER
OKLAHOMA,OFFICE NO. 2 FRANCIS TUTTLE TECH CENTER,PETE LEE,,550229,0,0,3,3,OFFICE NO. 2 FRANCIS TUTTLE TECH CENTER
OKLAHOMA,OFFICE NO. 2 FRANCIS TUTTLE TECH CENTER,ROBERT STONE,,550229,0,0,0,0,OFFICE NO. 2 FRANCIS TUTTLE TECH CENTER
OKLAHOMA,BOARD CHAIRPERSON OKLAHOMA CITY PUBLIC SCHOOLS,PAULA LEWIS,,550229,0,0,0,0,
OKLAHOMA,BOARD CHAIRPERSON OKLAHOMA CITY PUBLIC SCHOOLS,WILFREDO SANTOS RIVERA,,550229,0,0,0,0,
OKLAHOMA,BOARD CHAIRPERSON OKLAHOMA CITY PUBLIC SCHOOLS,GREGORY A. WYATT,,550229,0,0,0,0,
OKLAHOMA,BOARD CHAIRPERSON OKLAHOMA CITY PUBLIC SCHOOLS,BIANCA ROSE,,550229,0,0,0,0,
OKLAHOMA,BOARD CHAIRPERSON OKLAHOMA CITY PUBLIC SCHOOLS,STANLEY HUPFELD,,550229,0,0,1,1,
OKLAHOMA,OFFICE NO. 2 FRANCIS TUTTLE TECH CENTER,PETE LEE,,550230,0,0,0,0,OFFICE NO. 2 FRANCIS TUTTLE TECH CENTER
OKLAHOMA,OFFICE NO. 2 FRANCIS TUTTLE TECH CENTER,ROBERT STONE,,550230,0,0,0,0,OFFICE NO. 2 FRANCIS TUTTLE TECH CENTER
OKLAHOMA,BOARD CHAIRPERSON OKLAHOMA CITY PUBLIC SCHOOLS,PAULA LEWIS,,550230,0,0,3,3,
OKLAHOMA,BOARD CHAIRPERSON OKLAHOMA CITY PUBLIC SCHOOLS,WILFREDO SANTOS RIVERA,,550230,0,0,1,1,
OKLAHOMA,BOARD CHAIRPERSON OKLAHOMA CITY PUBLIC SCHOOLS,GREGORY A. WYATT,,550230,0,0,0,0,
OKLAHOMA,BOARD CHAIRPERSON OKLAHOMA CITY PUBLIC SCHOOLS,BIANCA ROSE,,550230,0,0,3,3,
OKLAHOMA,BOARD CHAIRPERSON OKLAHOMA CITY PUBLIC SCHOOLS,STANLEY HUPFELD,,550230,0,0,9,9,
OKLAHOMA,BOARD CHAIRPERSON OKLAHOMA CITY PUBLIC SCHOOLS,PAULA LEWIS,,550231,0,0,7,7,
OKLAHOMA,BOARD CHAIRPERSON OKLAHOMA CITY PUBLIC SCHOOLS,WILFREDO SANTOS RIVERA,,550231,0,0,1,1,
OKLAHOMA,BOARD CHAIRPERSON OKLAHOMA CITY PUBLIC SCHOOLS,GREGORY A. WYATT,,550231,0,0,0,0,
OKLAHOMA,BOARD CHAIRPERSON OKLAHOMA CITY PUBLIC SCHOOLS,BIANCA ROSE,,550231,0,0,2,2,
OKLAHOMA,BOARD CHAIRPERSON OKLAHOMA CITY PUBLIC SCHOOLS,STANLEY HUPFELD,,550231,0,0,10,10,
OKLAHOMA,"COUNCILMEMBER, WARD 4 CITY OF OKLAHOMA CITY",RICHARD D. MORRISSETTE,,550232,0,0,11,11,"COUNCILMEMBER, WARD 4 CITY OF OKLAHOMA CITY"
OKLAHOMA,"COUNCILMEMBER, WARD 4 CITY OF OKLAHOMA CITY",TODD STONE,,550232,0,0,14,14,"COUNCILMEMBER, WARD 4 CITY OF OKLAHOMA CITY"
OKLAHOMA,"COUNCILMEMBER, WARD 4 CITY OF OKLAHOMA CITY",WALTER KULA,,550232,0,0,0,0,"COUNCILMEMBER, WARD 4 CITY OF OKLAHOMA CITY"
OKLAHOMA,"COUNCILMEMBER, WARD 4 CITY OF OKLAHOMA CITY",DORIS MANGIARACINA BENBROOK,,550232,0,0,1,1,"COUNCILMEMBER, WARD 4 CITY OF OKLAHOMA CITY"
OKLAHOMA,BOARD CHAIRPERSON OKLAHOMA CITY PUBLIC SCHOOLS,PAULA LEWIS,,550232,0,0,0,0,
OKLAHOMA,BOARD CHAIRPERSON OKLAHOMA CITY PUBLIC SCHOOLS,WILFREDO SANTOS RIVERA,,550232,0,0,0,0,
OKLAHOMA,BOARD CHAIRPERSON OKLAHOMA CITY PUBLIC SCHOOLS,GREGORY A. WYATT,,550232,0,0,0,0,
OKLAHOMA,BOARD CHAIRPERSON OKLAHOMA CITY PUBLIC SCHOOLS,BIANCA ROSE,,550232,0,0,0,0,
OKLAHOMA,BOARD CHAIRPERSON OKLAHOMA CITY PUBLIC SCHOOLS,STANLEY HUPFELD,,550232,0,0,4,4,
OKLAHOMA,"COUNCILMEMBER, WARD 4 CITY OF OKLAHOMA CITY",RICHARD D. MORRISSETTE,,550233,0,0,3,3,"COUNCILMEMBER, WARD 4 CITY OF OKLAHOMA CITY"
OKLAHOMA,"COUNCILMEMBER, WARD 4 CITY OF OKLAHOMA CITY",TODD STONE,,550233,0,0,5,5,"COUNCILMEMBER, WARD 4 CITY OF OKLAHOMA CITY"
OKLAHOMA,"COUNCILMEMBER, WARD 4 CITY OF OKLAHOMA CITY",WALTER KULA,,550233,0,0,0,0,"COUNCILMEMBER, WARD 4 CITY OF OKLAHOMA CITY"
OKLAHOMA,"COUNCILMEMBER, WARD 4 CITY OF OKLAHOMA CITY",DORIS MANGIARACINA BENBROOK,,550233,0,0,1,1,"COUNCILMEMBER, WARD 4 CITY OF OKLAHOMA CITY"
OKLAHOMA,BOARD CHAIRPERSON OKLAHOMA CITY PUBLIC SCHOOLS,PAULA LEWIS,,550233,0,0,6,6,
OKLAHOMA,BOARD CHAIRPERSON OKLAHOMA CITY PUBLIC SCHOOLS,WILFREDO SANTOS RIVERA,,550233,0,0,3,3,
OKLAHOMA,BOARD CHAIRPERSON OKLAHOMA CITY PUBLIC SCHOOLS,GREGORY A. WYATT,,550233,0,0,3,3,
OKLAHOMA,BOARD CHAIRPERSON OKLAHOMA CITY PUBLIC SCHOOLS,BIANCA ROSE,,550233,0,0,1,1,
OKLAHOMA,BOARD CHAIRPERSON OKLAHOMA CITY PUBLIC SCHOOLS,STANLEY HUPFELD,,550233,0,0,6,6,
OKLAHOMA,"COUNCILMEMBER, WARD 4 CITY OF OKLAHOMA CITY",RICHARD D. MORRISSETTE,,550234,0,0,44,44,"COUNCILMEMBER, WARD 4 CITY OF OKLAHOMA CITY"
OKLAHOMA,"COUNCILMEMBER, WARD 4 CITY OF OKLAHOMA CITY",TODD STONE,,550234,0,0,12,12,"COUNCILMEMBER, WARD 4 CITY OF OKLAHOMA CITY"
OKLAHOMA,"COUNCILMEMBER, WARD 4 CITY OF OKLAHOMA CITY",WALTER KULA,,550234,0,0,4,4,"COUNCILMEMBER, WARD 4 CITY OF OKLAHOMA CITY"
OKLAHOMA,"COUNCILMEMBER, WARD 4 CITY OF OKLAHOMA CITY",DORIS MANGIARACINA BENBROOK,,550234,0,0,3,3,"COUNCILMEMBER, WARD 4 CITY OF OKLAHOMA CITY"
OKLAHOMA,"COUNCILMEMBER, WARD 7 CITY OF OKLAHOMA CITY","JOHN A. PETTIS, JR.",,550234,0,0,4,4,"COUNCILMEMBER, WARD 7 CITY OF OKLAHOMA CITY"
OKLAHOMA,"COUNCILMEMBER, WARD 7 CITY OF OKLAHOMA CITY",MARINA MANGIARACINA,,550234,0,0,0,0,"COUNCILMEMBER, WARD 7 CITY OF OKLAHOMA CITY"
OKLAHOMA,"COUNCILMEMBER, WARD 7 CITY OF OKLAHOMA CITY",T. SHERI DICKERSON,,550234,0,0,1,1,"COUNCILMEMBER, WARD 7 CITY OF OKLAHOMA CITY"
OKLAHOMA,BOARD CHAIRPERSON OKLAHOMA CITY PUBLIC SCHOOLS,PAULA LEWIS,,550234,0,0,22,22,
OKLAHOMA,BOARD CHAIRPERSON OKLAHOMA CITY PUBLIC SCHOOLS,WILFREDO SANTOS RIVERA,,550234,0,0,6,6,
OKLAHOMA,BOARD CHAIRPERSON OKLAHOMA CITY PUBLIC SCHOOLS,GREGORY A. WYATT,,550234,0,0,6,6,
OKLAHOMA,BOARD CHAIRPERSON OKLAHOMA CITY PUBLIC SCHOOLS,BIANCA ROSE,,550234,0,0,4,4,
OKLAHOMA,BOARD CHAIRPERSON OKLAHOMA CITY PUBLIC SCHOOLS,STANLEY HUPFELD,,550234,0,0,24,24,
OKLAHOMA,"COUNCILMEMBER, WARD 7 CITY OF OKLAHOMA CITY","JOHN A. PETTIS, JR.",,550235,0,0,22,22,"COUNCILMEMBER, WARD 7 CITY OF OKLAHOMA CITY"
OKLAHOMA,"COUNCILMEMBER, WARD 7 CITY OF OKLAHOMA CITY",MARINA MANGIARACINA,,550235,0,0,3,3,"COUNCILMEMBER, WARD 7 CITY OF OKLAHOMA CITY"
OKLAHOMA,"COUNCILMEMBER, WARD 7 CITY OF OKLAHOMA CITY",T. SHERI DICKERSON,,550235,0,0,5,5,"COUNCILMEMBER, WARD 7 CITY OF OKLAHOMA CITY"
OKLAHOMA,BOARD CHAIRPERSON OKLAHOMA CITY PUBLIC SCHOOLS,PAULA LEWIS,,550235,0,0,3,3,
OKLAHOMA,BOARD CHAIRPERSON OKLAHOMA CITY PUBLIC SCHOOLS,WILFREDO SANTOS RIVERA,,550235,0,0,9,9,
OKLAHOMA,BOARD CHAIRPERSON OKLAHOMA CITY PUBLIC SCHOOLS,GREGORY A. WYATT,,550235,0,0,2,2,
OKLAHOMA,BOARD CHAIRPERSON OKLAHOMA CITY PUBLIC SCHOOLS,BIANCA ROSE,,550235,0,0,2,2,
OKLAHOMA,BOARD CHAIRPERSON OKLAHOMA CITY PUBLIC SCHOOLS,STANLEY HUPFELD,,550235,0,0,1,1,
OKLAHOMA,"COUNCILMEMBER, WARD 7 CITY OF OKLAHOMA CITY","JOHN A. PETTIS, JR.",,550236,0,0,0,0,"COUNCILMEMBER, WARD 7 CITY OF OKLAHOMA CITY"
OKLAHOMA,"COUNCILMEMBER, WARD 7 CITY OF OKLAHOMA CITY",MARINA MANGIARACINA,,550236,0,0,0,0,"COUNCILMEMBER, WARD 7 CITY OF OKLAHOMA CITY"
OKLAHOMA,"COUNCILMEMBER, WARD 7 CITY OF OKLAHOMA CITY",T. SHERI DICKERSON,,550236,0,0,0,0,"COUNCILMEMBER, WARD 7 CITY OF OKLAHOMA CITY"
OKLAHOMA,BOARD CHAIRPERSON OKLAHOMA CITY PUBLIC SCHOOLS,PAULA LEWIS,,550236,0,0,0,0,
OKLAHOMA,BOARD CHAIRPERSON OKLAHOMA CITY PUBLIC SCHOOLS,WILFREDO SANTOS RIVERA,,550236,0,0,0,0,
OKLAHOMA,BOARD CHAIRPERSON OKLAHOMA CITY PUBLIC SCHOOLS,GREGORY A. WYATT,,550236,0,0,0,0,
OKLAHOMA,BOARD CHAIRPERSON OKLAHOMA CITY PUBLIC SCHOOLS,BIANCA ROSE,,550236,0,0,0,0,
OKLAHOMA,BOARD CHAIRPERSON OKLAHOMA CITY PUBLIC SCHOOLS,STANLEY HUPFELD,,550236,0,0,0,0,
OKLAHOMA,"COUNCILMEMBER, WARD 7 CITY OF OKLAHOMA CITY","JOHN A. PETTIS, JR.",,550237,0,0,0,0,"COUNCILMEMBER, WARD 7 CITY OF OKLAHOMA CITY"
OKLAHOMA,"COUNCILMEMBER, WARD 7 CITY OF OKLAHOMA CITY",MARINA MANGIARACINA,,550237,0,0,0,0,"COUNCILMEMBER, WARD 7 CITY OF OKLAHOMA CITY"
OKLAHOMA,"COUNCILMEMBER, WARD 7 CITY OF OKLAHOMA CITY",T. SHERI DICKERSON,,550237,0,0,0,0,"COUNCILMEMBER, WARD 7 CITY OF OKLAHOMA CITY"
OKLAHOMA,BOARD CHAIRPERSON OKLAHOMA CITY PUBLIC SCHOOLS,PAULA LEWIS,,550237,0,0,0,0,
OKLAHOMA,BOARD CHAIRPERSON OKLAHOMA CITY PUBLIC SCHOOLS,WILFREDO SANTOS RIVERA,,550237,0,0,0,0,
OKLAHOMA,BOARD CHAIRPERSON OKLAHOMA CITY PUBLIC SCHOOLS,GREGORY A. WYATT,,550237,0,0,0,0,
OKLAHOMA,BOARD CHAIRPERSON OKLAHOMA CITY PUBLIC SCHOOLS,BIANCA ROSE,,550237,0,0,0,0,
OKLAHOMA,BOARD CHAIRPERSON OKLAHOMA CITY PUBLIC SCHOOLS,STANLEY HUPFELD,,550237,0,0,0,0,
OKLAHOMA,"COUNCILMEMBER, WARD 7 CITY OF OKLAHOMA CITY","JOHN A. PETTIS, JR.",,550238,0,0,0,0,"COUNCILMEMBER, WARD 7 CITY OF OKLAHOMA CITY"
OKLAHOMA,"COUNCILMEMBER, WARD 7 CITY OF OKLAHOMA CITY",MARINA MANGIARACINA,,550238,0,0,0,0,"COUNCILMEMBER, WARD 7 CITY OF OKLAHOMA CITY"
OKLAHOMA,"COUNCILMEMBER, WARD 7 CITY OF OKLAHOMA CITY",T. SHERI DICKERSON,,550238,0,0,0,0,"COUNCILMEMBER, WARD 7 CITY OF OKLAHOMA CITY"
OKLAHOMA,BOARD CHAIRPERSON OKLAHOMA CITY PUBLIC SCHOOLS,PAULA LEWIS,,550238,0,0,0,0,
OKLAHOMA,BOARD CHAIRPERSON OKLAHOMA CITY PUBLIC SCHOOLS,WILFREDO SANTOS RIVERA,,550238,0,0,0,0,
OKLAHOMA,BOARD CHAIRPERSON OKLAHOMA CITY PUBLIC SCHOOLS,GREGORY A. WYATT,,550238,0,0,0,0,
OKLAHOMA,BOARD CHAIRPERSON OKLAHOMA CITY PUBLIC SCHOOLS,BIANCA ROSE,,550238,0,0,0,0,
OKLAHOMA,BOARD CHAIRPERSON OKLAHOMA CITY PUBLIC SCHOOLS,STANLEY HUPFELD,,550238,0,0,0,0,
OKLAHOMA,"COUNCILMEMBER, WARD 7 CITY OF OKLAHOMA CITY","JOHN A. PETTIS, JR.",,550239,0,0,72,72,"COUNCILMEMBER, WARD 7 CITY OF OKLAHOMA CITY"
OKLAHOMA,"COUNCILMEMBER, WARD 7 CITY OF OKLAHOMA CITY",MARINA MANGIARACINA,,550239,0,0,2,2,"COUNCILMEMBER, WARD 7 CITY OF OKLAHOMA CITY"
OKLAHOMA,"COUNCILMEMBER, WARD 7 CITY OF OKLAHOMA CITY",T. SHERI DICKERSON,,550239,0,0,15,15,"COUNCILMEMBER, WARD 7 CITY OF OKLAHOMA CITY"
OKLAHOMA,BOARD CHAIRPERSON OKLAHOMA CITY PUBLIC SCHOOLS,PAULA LEWIS,,550239,0,0,29,29,
OKLAHOMA,BOARD CHAIRPERSON OKLAHOMA CITY PUBLIC SCHOOLS,WILFREDO SANTOS RIVERA,,550239,0,0,12,12,
OKLAHOMA,BOARD CHAIRPERSON OKLAHOMA CITY PUBLIC SCHOOLS,GREGORY A. WYATT,,550239,0,0,5,5,
OKLAHOMA,BOARD CHAIRPERSON OKLAHOMA CITY PUBLIC SCHOOLS,BIANCA ROSE,,550239,0,0,5,5,
OKLAHOMA,BOARD CHAIRPERSON OKLAHOMA CITY PUBLIC SCHOOLS,STANLEY HUPFELD,,550239,0,0,39,39,
OKLAHOMA,"COUNCILMEMBER, WARD 7 CITY OF OKLAHOMA CITY","JOHN A. PETTIS, JR.",,550240,0,0,112,112,"COUNCILMEMBER, WARD 7 CITY OF OKLAHOMA CITY"
OKLAHOMA,"COUNCILMEMBER, WARD 7 CITY OF OKLAHOMA CITY",MARINA MANGIARACINA,,550240,0,0,7,7,"COUNCILMEMBER, WARD 7 CITY OF OKLAHOMA CITY"
OKLAHOMA,"COUNCILMEMBER, WARD 7 CITY OF OKLAHOMA CITY",T. SHERI DICKERSON,,550240,0,0,9,9,"COUNCILMEMBER, WARD 7 CITY OF OKLAHOMA CITY"
OKLAHOMA,BOARD CHAIRPERSON OKLAHOMA CITY PUBLIC SCHOOLS,PAULA LEWIS,,550240,0,0,45,45,
OKLAHOMA,BOARD CHAIRPERSON OKLAHOMA CITY PUBLIC SCHOOLS,WILFREDO SANTOS RIVERA,,550240,0,0,20,20,
OKLAHOMA,BOARD CHAIRPERSON OKLAHOMA CITY PUBLIC SCHOOLS,GREGORY A. WYATT,,550240,0,0,20,20,
OKLAHOMA,BOARD CHAIRPERSON OKLAHOMA CITY PUBLIC SCHOOLS,BIANCA ROSE,,550240,0,0,5,5,
OKLAHOMA,BOARD CHAIRPERSON OKLAHOMA CITY PUBLIC SCHOOLS,STANLEY HUPFELD,,550240,0,0,34,34,
OKLAHOMA,"COUNCILMEMBER, WARD 7 CITY OF OKLAHOMA CITY","JOHN A. PETTIS, JR.",,550241,0,0,69,69,"COUNCILMEMBER, WARD 7 CITY OF OKLAHOMA CITY"
OKLAHOMA,"COUNCILMEMBER, WARD 7 CITY OF OKLAHOMA CITY",MARINA MANGIARACINA,,550241,0,0,9,9,"COUNCILMEMBER, WARD 7 CITY OF OKLAHOMA CITY"
OKLAHOMA,"COUNCILMEMBER, WARD 7 CITY OF OKLAHOMA CITY",T. SHERI DICKERSON,,550241,0,0,20,20,"COUNCILMEMBER, WARD 7 CITY OF OKLAHOMA CITY"
OKLAHOMA,BOARD CHAIRPERSON OKLAHOMA CITY PUBLIC SCHOOLS,PAULA LEWIS,,550241,0,0,39,39,
OKLAHOMA,BOARD CHAIRPERSON OKLAHOMA CITY PUBLIC SCHOOLS,WILFREDO SANTOS RIVERA,,550241,0,0,26,26,
OKLAHOMA,BOARD CHAIRPERSON OKLAHOMA CITY PUBLIC SCHOOLS,GREGORY A. WYATT,,550241,0,0,6,6,
OKLAHOMA,BOARD CHAIRPERSON OKLAHOMA CITY PUBLIC SCHOOLS,BIANCA ROSE,,550241,0,0,7,7,
OKLAHOMA,BOARD CHAIRPERSON OKLAHOMA CITY PUBLIC SCHOOLS,STANLEY HUPFELD,,550241,0,0,19,19,
OKLAHOMA,"COUNCILMEMBER, WARD 7 CITY OF OKLAHOMA CITY","JOHN A. PETTIS, JR.",,550242,0,0,79,79,"COUNCILMEMBER, WARD 7 CITY OF OKLAHOMA CITY"
OKLAHOMA,"COUNCILMEMBER, WARD 7 CITY OF OKLAHOMA CITY",MARINA MANGIARACINA,,550242,0,0,1,1,"COUNCILMEMBER, WARD 7 CITY OF OKLAHOMA CITY"
OKLAHOMA,"COUNCILMEMBER, WARD 7 CITY OF OKLAHOMA CITY",T. SHERI DICKERSON,,550242,0,0,12,12,"COUNCILMEMBER, WARD 7 CITY OF OKLAHOMA CITY"
OKLAHOMA,BOARD CHAIRPERSON OKLAHOMA CITY PUBLIC SCHOOLS,PAULA LEWIS,,550242,0,0,27,27,
OKLAHOMA,BOARD CHAIRPERSON OKLAHOMA CITY PUBLIC SCHOOLS,WILFREDO SANTOS RIVERA,,550242,0,0,18,18,
OKLAHOMA,BOARD CHAIRPERSON OKLAHOMA CITY PUBLIC SCHOOLS,GREGORY A. WYATT,,550242,0,0,9,9,
OKLAHOMA,BOARD CHAIRPERSON OKLAHOMA CITY PUBLIC SCHOOLS,BIANCA ROSE,,550242,0,0,3,3,
OKLAHOMA,BOARD CHAIRPERSON OKLAHOMA CITY PUBLIC SCHOOLS,STANLEY HUPFELD,,550242,0,0,34,34,
OKLAHOMA,"COUNCILMEMBER, WARD 7 CITY OF OKLAHOMA CITY","JOHN A. PETTIS, JR.",,550243,0,0,92,92,"COUNCILMEMBER, WARD 7 CITY OF OKLAHOMA CITY"
OKLAHOMA,"COUNCILMEMBER, WARD 7 CITY OF OKLAHOMA CITY",MARINA MANGIARACINA,,550243,0,0,0,0,"COUNCILMEMBER, WARD 7 CITY OF OKLAHOMA CITY"
OKLAHOMA,"COUNCILMEMBER, WARD 7 CITY OF OKLAHOMA CITY",T. SHERI DICKERSON,,550243,0,0,9,9,"COUNCILMEMBER, WARD 7 CITY OF OKLAHOMA CITY"
OKLAHOMA,BOARD CHAIRPERSON OKLAHOMA CITY PUBLIC SCHOOLS,PAULA LEWIS,,550243,0,0,32,32,
OKLAHOMA,BOARD CHAIRPERSON OKLAHOMA CITY PUBLIC SCHOOLS,WILFREDO SANTOS RIVERA,,550243,0,0,13,13,
OKLAHOMA,BOARD CHAIRPERSON OKLAHOMA CITY PUBLIC SCHOOLS,GREGORY A. WYATT,,550243,0,0,11,11,
OKLAHOMA,BOARD CHAIRPERSON OKLAHOMA CITY PUBLIC SCHOOLS,BIANCA ROSE,,550243,0,0,3,3,
OKLAHOMA,BOARD CHAIRPERSON OKLAHOMA CITY PUBLIC SCHOOLS,STANLEY HUPFELD,,550243,0,0,42,42,
OKLAHOMA,"COUNCILMEMBER, WARD 7 CITY OF OKLAHOMA CITY","JOHN A. PETTIS, JR.",,550244,0,0,81,81,"COUNCILMEMBER, WARD 7 CITY OF OKLAHOMA CITY"
OKLAHOMA,"COUNCILMEMBER, WARD 7 CITY OF OKLAHOMA CITY",MARINA MANGIARACINA,,550244,0,0,2,2,"COUNCILMEMBER, WARD 7 CITY OF OKLAHOMA CITY"
OKLAHOMA,"COUNCILMEMBER, WARD 7 CITY OF OKLAHOMA CITY",T. SHERI DICKERSON,,550244,0,0,9,9,"COUNCILMEMBER, WARD 7 CITY OF OKLAHOMA CITY"
OKLAHOMA,PROPOSITION CRUTCHO PUBLIC SCHOOLS,FOR THE PROPOSITION - YES,,550244,0,0,0,0,
OKLAHOMA,PROPOSITION CRUTCHO PUBLIC SCHOOLS,AGAINST THE PROPOSITION - NO,,550244,0,0,0,0,
OKLAHOMA,BOARD CHAIRPERSON OKLAHOMA CITY PUBLIC SCHOOLS,PAULA LEWIS,,550244,0,0,41,41,
OKLAHOMA,BOARD CHAIRPERSON OKLAHOMA CITY PUBLIC SCHOOLS,WILFREDO SANTOS RIVERA,,550244,0,0,14,14,
OKLAHOMA,BOARD CHAIRPERSON OKLAHOMA CITY PUBLIC SCHOOLS,GREGORY A. WYATT,,550244,0,0,10,10,
OKLAHOMA,BOARD CHAIRPERSON OKLAHOMA CITY PUBLIC SCHOOLS,BIANCA ROSE,,550244,0,0,5,5,
OKLAHOMA,BOARD CHAIRPERSON OKLAHOMA CITY PUBLIC SCHOOLS,STANLEY HUPFELD,,550244,0,0,19,19,
OKLAHOMA,"COUNCILMEMBER, WARD 7 CITY OF OKLAHOMA CITY","JOHN A. PETTIS, JR.",,550245,0,0,138,138,"COUNCILMEMBER, WARD 7 CITY OF OKLAHOMA CITY"
OKLAHOMA,"COUNCILMEMBER, WARD 7 CITY OF OKLAHOMA CITY",MARINA MANGIARACINA,,550245,0,0,6,6,"COUNCILMEMBER, WARD 7 CITY OF OKLAHOMA CITY"
OKLAHOMA,"COUNCILMEMBER, WARD 7 CITY OF OKLAHOMA CITY",T. SHERI DICKERSON,,550245,0,0,10,10,"COUNCILMEMBER, WARD 7 CITY OF OKLAHOMA CITY"
OKLAHOMA,BOARD CHAIRPERSON OKLAHOMA CITY PUBLIC SCHOOLS,PAULA LEWIS,,550245,0,0,69,69,
OKLAHOMA,BOARD CHAIRPERSON OKLAHOMA CITY PUBLIC SCHOOLS,WILFREDO SANTOS RIVERA,,550245,0,0,21,21,
OKLAHOMA,BOARD CHAIRPERSON OKLAHOMA CITY PUBLIC SCHOOLS,GREGORY A. WYATT,,550245,0,0,13,13,
OKLAHOMA,BOARD CHAIRPERSON OKLAHOMA CITY PUBLIC SCHOOLS,BIANCA ROSE,,550245,0,0,9,9,
OKLAHOMA,BOARD CHAIRPERSON OKLAHOMA CITY PUBLIC SCHOOLS,STANLEY HUPFELD,,550245,0,0,42,42,
OKLAHOMA,"COUNCILMEMBER, WARD 7 CITY OF OKLAHOMA CITY","JOHN A. PETTIS, JR.",,550246,0,0,6,6,"COUNCILMEMBER, WARD 7 CITY OF OKLAHOMA CITY"
OKLAHOMA,"COUNCILMEMBER, WARD 7 CITY OF OKLAHOMA CITY",MARINA MANGIARACINA,,550246,0,0,0,0,"COUNCILMEMBER, WARD 7 CITY OF OKLAHOMA CITY"
OKLAHOMA,"COUNCILMEMBER, WARD 7 CITY OF OKLAHOMA CITY",T. SHERI DICKERSON,,550246,0,0,4,4,"COUNCILMEMBER, WARD 7 CITY OF OKLAHOMA CITY"
OKLAHOMA,BOARD CHAIRPERSON OKLAHOMA CITY PUBLIC SCHOOLS,PAULA LEWIS,,550246,0,0,0,0,
OKLAHOMA,BOARD CHAIRPERSON OKLAHOMA CITY PUBLIC SCHOOLS,WILFREDO SANTOS RIVERA,,550246,0,0,0,0,
OKLAHOMA,BOARD CHAIRPERSON OKLAHOMA CITY PUBLIC SCHOOLS,GREGORY A. WYATT,,550246,0,0,0,0,
OKLAHOMA,BOARD CHAIRPERSON OKLAHOMA CITY PUBLIC SCHOOLS,BIANCA ROSE,,550246,0,0,0,0,
OKLAHOMA,BOARD CHAIRPERSON OKLAHOMA CITY PUBLIC SCHOOLS,STANLEY HUPFELD,,550246,0,0,0,0,
OKLAHOMA,"COUNCILMEMBER, WARD 4 CITY OF OKLAHOMA CITY",RICHARD D. MORRISSETTE,,550247,0,0,41,41,"COUNCILMEMBER, WARD 4 CITY OF OKLAHOMA CITY"
OKLAHOMA,"COUNCILMEMBER, WARD 4 CITY OF OKLAHOMA CITY",TODD STONE,,550247,0,0,9,9,"COUNCILMEMBER, WARD 4 CITY OF OKLAHOMA CITY"
OKLAHOMA,"COUNCILMEMBER, WARD 4 CITY OF OKLAHOMA CITY",WALTER KULA,,550247,0,0,3,3,"COUNCILMEMBER, WARD 4 CITY OF OKLAHOMA CITY"
OKLAHOMA,"COUNCILMEMBER, WARD 4 CITY OF OKLAHOMA CITY",DORIS MANGIARACINA BENBROOK,,550247,0,0,8,8,"COUNCILMEMBER, WARD 4 CITY OF OKLAHOMA CITY"
OKLAHOMA,BOARD CHAIRPERSON OKLAHOMA CITY PUBLIC SCHOOLS,PAULA LEWIS,,550247,0,0,18,18,
OKLAHOMA,BOARD CHAIRPERSON OKLAHOMA CITY PUBLIC SCHOOLS,WILFREDO SANTOS RIVERA,,550247,0,0,12,12,
OKLAHOMA,BOARD CHAIRPERSON OKLAHOMA CITY PUBLIC SCHOOLS,GREGORY A. WYATT,,550247,0,0,7,7,
OKLAHOMA,BOARD CHAIRPERSON OKLAHOMA CITY PUBLIC SCHOOLS,BIANCA ROSE,,550247,0,0,6,6,
OKLAHOMA,BOARD CHAIRPERSON OKLAHOMA CITY PUBLIC SCHOOLS,STANLEY HUPFELD,,550247,0,0,16,16,
OKLAHOMA,"COUNCILMEMBER, WARD 4 CITY OF OKLAHOMA CITY",RICHARD D. MORRISSETTE,,550248,0,0,76,76,"COUNCILMEMBER, WARD 4 CITY OF OKLAHOMA CITY"
OKLAHOMA,"COUNCILMEMBER, WARD 4 CITY OF OKLAHOMA CITY",TODD STONE,,550248,0,0,19,19,"COUNCILMEMBER, WARD 4 CITY OF OKLAHOMA CITY"
OKLAHOMA,"COUNCILMEMBER, WARD 4 CITY OF OKLAHOMA CITY",WALTER KULA,,550248,0,0,1,1,"COUNCILMEMBER, WARD 4 CITY OF OKLAHOMA CITY"
OKLAHOMA,"COUNCILMEMBER, WARD 4 CITY OF OKLAHOMA CITY",DORIS MANGIARACINA BENBROOK,,550248,0,0,5,5,"COUNCILMEMBER, WARD 4 CITY OF OKLAHOMA CITY"
OKLAHOMA,BOARD CHAIRPERSON OKLAHOMA CITY PUBLIC SCHOOLS,PAULA LEWIS,,550248,0,0,13,13,
OKLAHOMA,BOARD CHAIRPERSON OKLAHOMA CITY PUBLIC SCHOOLS,WILFREDO SANTOS RIVERA,,550248,0,0,5,5,
OKLAHOMA,BOARD CHAIRPERSON OKLAHOMA CITY PUBLIC SCHOOLS,GREGORY A. WYATT,,550248,0,0,2,2,
OKLAHOMA,BOARD CHAIRPERSON OKLAHOMA CITY PUBLIC SCHOOLS,BIANCA ROSE,,550248,0,0,1,1,
OKLAHOMA,BOARD CHAIRPERSON OKLAHOMA CITY PUBLIC SCHOOLS,STANLEY HUPFELD,,550248,0,0,8,8,
OKLAHOMA,"COUNCILMEMBER, WARD 4 CITY OF OKLAHOMA CITY",RICHARD D. MORRISSETTE,,550249,0,0,77,77,"COUNCILMEMBER, WARD 4 CITY OF OKLAHOMA CITY"
OKLAHOMA,"COUNCILMEMBER, WARD 4 CITY OF OKLAHOMA CITY",TODD STONE,,550249,0,0,47,47,"COUNCILMEMBER, WARD 4 CITY OF OKLAHOMA CITY"
OKLAHOMA,"COUNCILMEMBER, WARD 4 CITY OF OKLAHOMA CITY",WALTER KULA,,550249,0,0,8,8,"COUNCILMEMBER, WARD 4 CITY OF OKLAHOMA CITY"
OKLAHOMA,"COUNCILMEMBER, WARD 4 CITY OF OKLAHOMA CITY",DORIS MANGIARACINA BENBROOK,,550249,0,0,13,13,"COUNCILMEMBER, WARD 4 CITY OF OKLAHOMA CITY"
OKLAHOMA,"COUNCILMEMBER, WARD 4 CITY OF OKLAHOMA CITY",RICHARD D. MORRISSETTE,,550250,0,0,36,36,"COUNCILMEMBER, WARD 4 CITY OF OKLAHOMA CITY"
OKLAHOMA,"COUNCILMEMBER, WARD 4 CITY OF OKLAHOMA CITY",TODD STONE,,550250,0,0,14,14,"COUNCILMEMBER, WARD 4 CITY OF OKLAHOMA CITY"
OKLAHOMA,"COUNCILMEMBER, WARD 4 CITY OF OKLAHOMA CITY",WALTER KULA,,550250,0,0,5,5,"COUNCILMEMBER, WARD 4 CITY OF OKLAHOMA CITY"
OKLAHOMA,"COUNCILMEMBER, WARD 4 CITY OF OKLAHOMA CITY",DORIS MANGIARACINA BENBROOK,,550250,0,0,10,10,"COUNCILMEMBER, WARD 4 CITY OF OKLAHOMA CITY"
OKLAHOMA,"COUNCILMEMBER, WARD 4 CITY OF OKLAHOMA CITY",RICHARD D. MORRISSETTE,,550251,0,0,40,40,"COUNCILMEMBER, WARD 4 CITY OF OKLAHOMA CITY"
OKLAHOMA,"COUNCILMEMBER, WARD 4 CITY OF OKLAHOMA CITY",TODD STONE,,550251,0,0,39,39,"COUNCILMEMBER, WARD 4 CITY OF OKLAHOMA CITY"
OKLAHOMA,"COUNCILMEMBER, WARD 4 CITY OF OKLAHOMA CITY",WALTER KULA,,550251,0,0,12,12,"COUNCILMEMBER, WARD 4 CITY OF OKLAHOMA CITY"
OKLAHOMA,"COUNCILMEMBER, WARD 4 CITY OF OKLAHOMA CITY",DORIS MANGIARACINA BENBROOK,,550251,0,0,13,13,"COUNCILMEMBER, WARD 4 CITY OF OKLAHOMA CITY"
OKLAHOMA,"COUNCILMEMBER, WARD 4 CITY OF OKLAHOMA CITY",RICHARD D. MORRISSETTE,,550252,0,0,53,53,"COUNCILMEMBER, WARD 4 CITY OF OKLAHOMA CITY"
OKLAHOMA,"COUNCILMEMBER, WARD 4 CITY OF OKLAHOMA CITY",TODD STONE,,550252,0,0,45,45,"COUNCILMEMBER, WARD 4 CITY OF OKLAHOMA CITY"
OKLAHOMA,"COUNCILMEMBER, WARD 4 CITY OF OKLAHOMA CITY",WALTER KULA,,550252,0,0,19,19,"COUNCILMEMBER, WARD 4 CITY OF OKLAHOMA CITY"
OKLAHOMA,"COUNCILMEMBER, WARD 4 CITY OF OKLAHOMA CITY",DORIS MANGIARACINA BENBROOK,,550252,0,0,8,8,"COUNCILMEMBER, WARD 4 CITY OF OKLAHOMA CITY"
OKLAHOMA,"COUNCILMEMBER, WARD 4 CITY OF OKLAHOMA CITY",RICHARD D. MORRISSETTE,,550253,0,0,10,10,"COUNCILMEMBER, WARD 4 CITY OF OKLAHOMA CITY"
OKLAHOMA,"COUNCILMEMBER, WARD 4 CITY OF OKLAHOMA CITY",TODD STONE,,550253,0,0,20,20,"COUNCILMEMBER, WARD 4 CITY OF OKLAHOMA CITY"
OKLAHOMA,"COUNCILMEMBER, WARD 4 CITY OF OKLAHOMA CITY",WALTER KULA,,550253,0,0,2,2,"COUNCILMEMBER, WARD 4 CITY OF OKLAHOMA CITY"
OKLAHOMA,"COUNCILMEMBER, WARD 4 CITY OF OKLAHOMA CITY",DORIS MANGIARACINA BENBROOK,,550253,0,0,2,2,"COUNCILMEMBER, WARD 4 CITY OF OKLAHOMA CITY"
OKLAHOMA,"COUNCILMEMBER, WARD 4 CITY OF OKLAHOMA CITY",RICHARD D. MORRISSETTE,,550254,0,0,32,32,"COUNCILMEMBER, WARD 4 CITY OF OKLAHOMA CITY"
OKLAHOMA,"COUNCILMEMBER, WARD 4 CITY OF OKLAHOMA CITY",TODD STONE,,550254,0,0,24,24,"COUNCILMEMBER, WARD 4 CITY OF OKLAHOMA CITY"
OKLAHOMA,"COUNCILMEMBER, WARD 4 CITY OF OKLAHOMA CITY",WALTER KULA,,550254,0,0,41,41,"COUNCILMEMBER, WARD 4 CITY OF OKLAHOMA CITY"
OKLAHOMA,"COUNCILMEMBER, WARD 4 CITY OF OKLAHOMA CITY",DORIS MANGIARACINA BENBROOK,,550254,0,0,11,11,"COUNCILMEMBER, WARD 4 CITY OF OKLAHOMA CITY"
OKLAHOMA,OFFICE NO. 2 MCLOUD PUBLIC SCHOOLS,MELANIE KRAUSE,,550254,0,0,3,3,OFFICE NO. 2 MCLOUD PUBLIC SCHOOLS
OKLAHOMA,OFFICE NO. 2 MCLOUD PUBLIC SCHOOLS,STEVEN M. SWARTZ,,550254,0,0,6,6,OFFICE NO. 2 MCLOUD PUBLIC SCHOOLS
OKLAHOMA,OFFICE NO. 2 MCLOUD PUBLIC SCHOOLS,JEANNENE WILLIAMS,,550254,0,0,6,6,OFFICE NO. 2 MCLOUD PUBLIC SCHOOLS
OKLAHOMA,"COUNCILMEMBER, WARD 4 CITY OF OKLAHOMA CITY",RICHARD D. MORRISSETTE,,550255,0,0,0,0,"COUNCILMEMBER, WARD 4 CITY OF OKLAHOMA CITY"
OKLAHOMA,"COUNCILMEMBER, WARD 4 CITY OF OKLAHOMA CITY",TODD STONE,,550255,0,0,0,0,"COUNCILMEMBER, WARD 4 CITY OF OKLAHOMA CITY"
OKLAHOMA,"COUNCILMEMBER, WARD 4 CITY OF OKLAHOMA CITY",WALTER KULA,,550255,0,0,0,0,"COUNCILMEMBER, WARD 4 CITY OF OKLAHOMA CITY"
OKLAHOMA,"COUNCILMEMBER, WARD 4 CITY OF OKLAHOMA CITY",DORIS MANGIARACINA BENBROOK,,550255,0,0,0,0,"COUNCILMEMBER, WARD 4 CITY OF OKLAHOMA CITY"
OKLAHOMA,OFFICE NO. 2 DEER CREEK PUBLIC SCHOOLS,TOM CORBIN,,550256,0,0,0,0,OFFICE NO. 2 DEER CREEK PUBLIC SCHOOLS
OKLAHOMA,OFFICE NO. 2 DEER CREEK PUBLIC SCHOOLS,ANDI NEAVES,,550256,0,0,0,0,OFFICE NO. 2 DEER CREEK PUBLIC SCHOOLS
OKLAHOMA,OFFICE NO. 2 FRANCIS TUTTLE TECH CENTER,PETE LEE,,550256,0,0,0,0,OFFICE NO. 2 FRANCIS TUTTLE TECH CENTER
OKLAHOMA,OFFICE NO. 2 FRANCIS TUTTLE TECH CENTER,ROBERT STONE,,550256,0,0,0,0,OFFICE NO. 2 FRANCIS TUTTLE TECH CENTER
OKLAHOMA,BOARD CHAIRPERSON OKLAHOMA CITY PUBLIC SCHOOLS,PAULA LEWIS,,550257,0,0,1,1,
OKLAHOMA,BOARD CHAIRPERSON OKLAHOMA CITY PUBLIC SCHOOLS,WILFREDO SANTOS RIVERA,,550257,0,0,1,1,
OKLAHOMA,BOARD CHAIRPERSON OKLAHOMA CITY PUBLIC SCHOOLS,GREGORY A. WYATT,,550257,0,0,0,0,
OKLAHOMA,BOARD CHAIRPERSON OKLAHOMA CITY PUBLIC SCHOOLS,BIANCA ROSE,,550257,0,0,1,1,
OKLAHOMA,BOARD CHAIRPERSON OKLAHOMA CITY PUBLIC SCHOOLS,STANLEY HUPFELD,,550257,0,0,6,6,
OKLAHOMA,OFFICE NO. 2 OKLAHOMA CITY PUBLIC SCHOOLS,JUSTIN ELLIS,,550257,0,0,0,0,OFFICE NO. 2 OKLAHOMA CITY PUBLIC SCHOOLS
OKLAHOMA,OFFICE NO. 2 OKLAHOMA CITY PUBLIC SCHOOLS,REBECCA L. BUDD,,550257,0,0,4,4,OFFICE NO. 2 OKLAHOMA CITY PUBLIC SCHOOLS
OKLAHOMA,OFFICE NO. 2 OKLAHOMA CITY PUBLIC SCHOOLS,NICK SINGER,,550257,0,0,5,5,OFFICE NO. 2 OKLAHOMA CITY PUBLIC SCHOOLS
OKLAHOMA,MAYOR CITY OF BETHANY,KATHY LARSEN,,559999,26,5,0,31,
OKLAHOMA,MAYOR CITY OF BETHANY,KP WESTMORELAND,,559999,39,6,0,45,
OKLAHOMA,"COUNCILMEMBER, WARD 1 CITY OF BETHANY",PAUL TODD,,559999,7,1,0,8,"COUNCILMEMBER, WARD 1 CITY OF BETHANY"
OKLAHOMA,"COUNCILMEMBER, WARD 1 CITY OF BETHANY",MATTHEW PALLARES,,559999,1,3,0,4,"COUNCILMEMBER, WARD 1 CITY OF BETHANY"
OKLAHOMA,"COUNCILMEMBER, WARD 2 CITY OF BETHANY",DON RICHARDS,,559999,1,0,0,1,"COUNCILMEMBER, WARD 2 CITY OF BETHANY"
OKLAHOMA,"COUNCILMEMBER, WARD 2 CITY OF BETHANY",KATHI HOLLOWAY,,559999,4,1,0,5,"COUNCILMEMBER, WARD 2 CITY OF BETHANY"
OKLAHOMA,"COUNCILMEMBER, WARD 2 CITY OF BETHANY",STEVE PALMER,,559999,10,2,0,12,"COUNCILMEMBER, WARD 2 CITY OF BETHANY"
OKLAHOMA,"COUNCILMEMBER, WARD 3 CITY OF BETHANY",ARVEL L. WILLIAMS,,559999,8,0,0,8,"COUNCILMEMBER, WARD 3 CITY OF BETHANY"
OKLAHOMA,"COUNCILMEMBER, WARD 3 CITY OF BETHANY",JOHN HERREN,,559999,24,3,0,27,"COUNCILMEMBER, WARD 3 CITY OF BETHANY"
OKLAHOMA,"COUNCILMEMBER, WARD 1 CITY OF OKLAHOMA CITY",CHRIS GORDON,,559999,36,3,0,39,"COUNCILMEMBER, WARD 1 CITY OF OKLAHOMA CITY"
OKLAHOMA,"COUNCILMEMBER, WARD 1 CITY OF OKLAHOMA CITY",JAMES GREINER,,559999,68,5,0,73,"COUNCILMEMBER, WARD 1 CITY OF OKLAHOMA CITY"
OKLAHOMA,"COUNCILMEMBER, WARD 1 CITY OF OKLAHOMA CITY",JONATHAN CLOUR,,559999,12,1,0,13,"COUNCILMEMBER, WARD 1 CITY OF OKLAHOMA CITY"
OKLAHOMA,"COUNCILMEMBER, WARD 3 CITY OF OKLAHOMA CITY",LARRY McATEE,,559999,23,6,0,29,"COUNCILMEMBER, WARD 3 CITY OF OKLAHOMA CITY"
OKLAHOMA,"COUNCILMEMBER, WARD 3 CITY OF OKLAHOMA CITY",MATTHEW W. OLSEN,,559999,8,2,0,10,"COUNCILMEMBER, WARD 3 CITY OF OKLAHOMA CITY"
OKLAHOMA,"COUNCILMEMBER, WARD 3 CITY OF OKLAHOMA CITY",JOE SARGE NELSON,,559999,4,0,0,4,"COUNCILMEMBER, WARD 3 CITY OF OKLAHOMA CITY"
OKLAHOMA,"COUNCILMEMBER, WARD 4 CITY OF OKLAHOMA CITY",RICHARD D. MORRISSETTE,,559999,42,6,0,48,"COUNCILMEMBER, WARD 4 CITY OF OKLAHOMA CITY"
OKLAHOMA,"COUNCILMEMBER, WARD 4 CITY OF OKLAHOMA CITY",TODD STONE,,559999,22,6,0,28,"COUNCILMEMBER, WARD 4 CITY OF OKLAHOMA CITY"
OKLAHOMA,"COUNCILMEMBER, WARD 4 CITY OF OKLAHOMA CITY",WALTER KULA,,559999,7,0,0,7,"COUNCILMEMBER, WARD 4 CITY OF OKLAHOMA CITY"
OKLAHOMA,"COUNCILMEMBER, WARD 4 CITY OF OKLAHOMA CITY",DORIS MANGIARACINA BENBROOK,,559999,11,0,0,11,"COUNCILMEMBER, WARD 4 CITY OF OKLAHOMA CITY"
OKLAHOMA,"COUNCILMEMBER, WARD 7 CITY OF OKLAHOMA CITY","JOHN A. PETTIS, JR.",,559999,82,84,0,166,"COUNCILMEMBER, WARD 7 CITY OF OKLAHOMA CITY"
OKLAHOMA,"COUNCILMEMBER, WARD 7 CITY OF OKLAHOMA CITY",MARINA MANGIARACINA,,559999,14,5,0,19,"COUNCILMEMBER, WARD 7 CITY OF OKLAHOMA CITY"
OKLAHOMA,"COUNCILMEMBER, WARD 7 CITY OF OKLAHOMA CITY",T. SHERI DICKERSON,,559999,16,5,0,21,"COUNCILMEMBER, WARD 7 CITY OF OKLAHOMA CITY"
OKLAHOMA,"COUNCILMAN, WARD 3 CITY OF WARR ACRES",JIMMY BULLEN,,559999,1,0,0,1,"COUNCILMAN, WARD 3 CITY OF WARR ACRES"
OKLAHOMA,"COUNCILMAN, WARD 3 CITY OF WARR ACRES",ROGER GODWIN,,559999,1,0,0,1,"COUNCILMAN, WARD 3 CITY OF WARR ACRES"
OKLAHOMA,"COUNCILPERSON, WARD 2 CITY OF DEL CITY",JACK McBRAYER,,559999,3,0,0,3,"COUNCILPERSON, WARD 2 CITY OF DEL CITY"
OKLAHOMA,"COUNCILPERSON, WARD 2 CITY OF DEL CITY",PAM FINCH,,559999,2,0,0,2,"COUNCILPERSON, WARD 2 CITY OF DEL CITY"
OKLAHOMA,"COUNCILPERSON, WARD 4 CITY OF DEL CITY",FLOYD EASON,,559999,2,0,0,2,"COUNCILPERSON, WARD 4 CITY OF DEL CITY"
OKLAHOMA,"COUNCILPERSON, WARD 4 CITY OF DEL CITY",BEVERLY SMITH,,559999,5,1,0,6,"COUNCILPERSON, WARD 4 CITY OF DEL CITY"
OKLAHOMA,OFFICE NO. 4 (UNEXPIRED TERM) MUSTANG PUBLIC SCHOOLS,BARBARA YOUNG,,559999,0,0,0,0,OFFICE NO. 4 (UNEXPIRED TERM) MUSTANG PUBLIC SCHOOLS
OKLAHOMA,OFFICE NO. 4 (UNEXPIRED TERM) MUSTANG PUBLIC SCHOOLS,CHAD SCHROEDER,,559999,0,0,0,0,OFFICE NO. 4 (UNEXPIRED TERM) MUSTANG PUBLIC SCHOOLS
OKLAHOMA,PROPOSITION NO. 1 MUSTANG PUBLIC SCHOOLS,FOR THE PROPOSITION - YES,,559999,0,0,0,0,PROPOSITION NO. 1 MUSTANG PUBLIC SCHOOLS
OKLAHOMA,PROPOSITION NO. 1 MUSTANG PUBLIC SCHOOLS,AGAINST THE PROPOSITION - NO,,559999,0,1,0,1,PROPOSITION NO. 1 MUSTANG PUBLIC SCHOOLS
OKLAHOMA,PROPOSITION NO. 2 MUSTANG PUBLIC SCHOOLS,FOR THE PROPOSITION - YES,,559999,0,0,0,0,PROPOSITION NO. 2 MUSTANG PUBLIC SCHOOLS
OKLAHOMA,PROPOSITION NO. 2 MUSTANG PUBLIC SCHOOLS,AGAINST THE PROPOSITION - NO,,559999,0,1,0,1,PROPOSITION NO. 2 MUSTANG PUBLIC SCHOOLS
OKLAHOMA,PROPOSITION CRUTCHO PUBLIC SCHOOLS,FOR THE PROPOSITION - YES,,559999,0,0,0,0,
OKLAHOMA,PROPOSITION CRUTCHO PUBLIC SCHOOLS,AGAINST THE PROPOSITION - NO,,559999,3,0,0,3,
OKLAHOMA,OFFICE NO. 2 DEER CREEK PUBLIC SCHOOLS,TOM CORBIN,,559999,7,2,0,9,OFFICE NO. 2 DEER CREEK PUBLIC SCHOOLS
OKLAHOMA,OFFICE NO. 2 DEER CREEK PUBLIC SCHOOLS,ANDI NEAVES,,559999,15,1,0,16,OFFICE NO. 2 DEER CREEK PUBLIC SCHOOLS
OKLAHOMA,OFFICE NO. 2 EDMOND PUBLIC SCHOOLS,KATHLEEN M. DUNCAN,,559999,61,4,0,65,OFFICE NO. 2 EDMOND PUBLIC SCHOOLS
OKLAHOMA,OFFICE NO. 2 EDMOND PUBLIC SCHOOLS,CHAD MULLEN,,559999,19,2,0,21,OFFICE NO. 2 EDMOND PUBLIC SCHOOLS
OKLAHOMA,PROPOSITION NO. 1 EDMOND PUBLIC SCHOOLS,FOR THE PROPOSITION - YES,,559999,168,19,0,187,PROPOSITION NO. 1 EDMOND PUBLIC SCHOOLS
OKLAHOMA,PROPOSITION NO. 1 EDMOND PUBLIC SCHOOLS,AGAINST THE PROPOSITION - NO,,559999,75,8,0,83,PROPOSITION NO. 1 EDMOND PUBLIC SCHOOLS
OKLAHOMA,PROPOSITION NO. 2 EDMOND PUBLIC SCHOOLS,FOR THE PROPOSITION - YES,,559999,166,20,0,186,PROPOSITION NO. 2 EDMOND PUBLIC SCHOOLS
OKLAHOMA,PROPOSITION NO. 2 EDMOND PUBLIC SCHOOLS,AGAINST THE PROPOSITION - NO,,559999,77,7,0,84,PROPOSITION NO. 2 EDMOND PUBLIC SCHOOLS
OKLAHOMA,OFFICE NO. 2 FRANCIS TUTTLE TECH CENTER,PETE LEE,,559999,163,22,0,185,OFFICE NO. 2 FRANCIS TUTTLE TECH CENTER
OKLAHOMA,OFFICE NO. 2 FRANCIS TUTTLE TECH CENTER,ROBERT STONE,,559999,272,23,0,295,OFFICE NO. 2 FRANCIS TUTTLE TECH CENTER
OKLAHOMA,OFFICE NO. 2 LUTHER PUBLIC SCHOOLS,TONY RUMPL,,559999,8,3,0,11,OFFICE NO. 2 LUTHER PUBLIC SCHOOLS
OKLAHOMA,OFFICE NO. 2 LUTHER PUBLIC SCHOOLS,MATTHEW MOHR,,559999,2,0,0,2,OFFICE NO. 2 LUTHER PUBLIC SCHOOLS
OKLAHOMA,OFFICE NO. 2 LUTHER PUBLIC SCHOOLS,GERALD McCAULEY,,559999,0,0,0,0,OFFICE NO. 2 LUTHER PUBLIC SCHOOLS
OKLAHOMA,BOARD CHAIRPERSON OKLAHOMA CITY PUBLIC SCHOOLS,PAULA LEWIS,,559999,116,38,0,154,
OKLAHOMA,BOARD CHAIRPERSON OKLAHOMA CITY PUBLIC SCHOOLS,WILFREDO SANTOS RIVERA,,559999,47,25,0,72,
OKLAHOMA,BOARD CHAIRPERSON OKLAHOMA CITY PUBLIC SCHOOLS,GREGORY A. WYATT,,559999,17,8,0,25,
OKLAHOMA,BOARD CHAIRPERSON OKLAHOMA CITY PUBLIC SCHOOLS,BIANCA ROSE,,559999,24,7,0,31,
OKLAHOMA,BOARD CHAIRPERSON OKLAHOMA CITY PUBLIC SCHOOLS,STANLEY HUPFELD,,559999,138,59,0,197,
OKLAHOMA,OFFICE NO. 1 OKLAHOMA CITY PUBLIC SCHOOLS,NATHAN SHIRLEY,,559999,36,3,0,39,OFFICE NO. 1 OKLAHOMA CITY PUBLIC SCHOOLS
OKLAHOMA,OFFICE NO. 1 OKLAHOMA CITY PUBLIC SCHOOLS,CHARLES HENRY,,559999,17,7,0,24,OFFICE NO. 1 OKLAHOMA CITY PUBLIC SCHOOLS
OKLAHOMA,OFFICE NO. 1 OKLAHOMA CITY PUBLIC SCHOOLS,CHERYL POOLE,,559999,29,10,0,39,OFFICE NO. 1 OKLAHOMA CITY PUBLIC SCHOOLS
OKLAHOMA,OFFICE NO. 2 OKLAHOMA CITY PUBLIC SCHOOLS,JUSTIN ELLIS,,559999,23,5,0,28,OFFICE NO. 2 OKLAHOMA CITY PUBLIC SCHOOLS
OKLAHOMA,OFFICE NO. 2 OKLAHOMA CITY PUBLIC SCHOOLS,REBECCA L. BUDD,,559999,44,14,0,58,OFFICE NO. 2 OKLAHOMA CITY PUBLIC SCHOOLS
OKLAHOMA,OFFICE NO. 2 OKLAHOMA CITY PUBLIC SCHOOLS,NICK SINGER,,559999,39,5,0,44,OFFICE NO. 2 OKLAHOMA CITY PUBLIC SCHOOLS
OKLAHOMA,OFFICE NO. 2 MCLOUD PUBLIC SCHOOLS,MELANIE KRAUSE,,559999,0,0,0,0,OFFICE NO. 2 MCLOUD PUBLIC SCHOOLS
OKLAHOMA,OFFICE NO. 2 MCLOUD PUBLIC SCHOOLS,STEVEN M. SWARTZ,,559999,0,0,0,0,OFFICE NO. 2 MCLOUD PUBLIC SCHOOLS
OKLAHOMA,OFFICE NO. 2 MCLOUD PUBLIC SCHOOLS,JEANNENE WILLIAMS,,559999,0,0,0,0,OFFICE NO. 2 MCLOUD PUBLIC SCHOOLS
OKMULGEE,OFFICE NO. 2 OKMULGEE PUBLIC SCHOOLS,MARCUS D. JEFFREY,,560001,0,2,16,18,OFFICE NO. 2 OKMULGEE PUBLIC SCHOOLS
OKMULGEE,OFFICE NO. 2 OKMULGEE PUBLIC SCHOOLS,VICKIE JONES,,560001,0,2,17,19,OFFICE NO. 2 OKMULGEE PUBLIC SCHOOLS
OKMULGEE,OFFICE NO. 2 OKMULGEE PUBLIC SCHOOLS,JOHN P. DELSO,,560001,0,0,0,0,OFFICE NO. 2 OKMULGEE PUBLIC SCHOOLS
OKMULGEE,OFFICE NO. 2 OKMULGEE PUBLIC SCHOOLS,MARCUS D. JEFFREY,,560002,0,11,68,79,OFFICE NO. 2 OKMULGEE PUBLIC SCHOOLS
OKMULGEE,OFFICE NO. 2 OKMULGEE PUBLIC SCHOOLS,VICKIE JONES,,560002,1,7,65,73,OFFICE NO. 2 OKMULGEE PUBLIC SCHOOLS
OKMULGEE,OFFICE NO. 2 OKMULGEE PUBLIC SCHOOLS,JOHN P. DELSO,,560002,0,0,4,4,OFFICE NO. 2 OKMULGEE PUBLIC SCHOOLS
OKMULGEE,OFFICE NO. 2 OKMULGEE PUBLIC SCHOOLS,MARCUS D. JEFFREY,,560004,0,0,1,1,OFFICE NO. 2 OKMULGEE PUBLIC SCHOOLS
OKMULGEE,OFFICE NO. 2 OKMULGEE PUBLIC SCHOOLS,VICKIE JONES,,560004,1,0,2,3,OFFICE NO. 2 OKMULGEE PUBLIC SCHOOLS
OKMULGEE,OFFICE NO. 2 OKMULGEE PUBLIC SCHOOLS,JOHN P. DELSO,,560004,0,0,0,0,OFFICE NO. 2 OKMULGEE PUBLIC SCHOOLS
OKMULGEE,OFFICE NO. 2 OKMULGEE PUBLIC SCHOOLS,MARCUS D. JEFFREY,,560005,2,1,14,17,OFFICE NO. 2 OKMULGEE PUBLIC SCHOOLS
OKMULGEE,OFFICE NO. 2 OKMULGEE PUBLIC SCHOOLS,VICKIE JONES,,560005,0,4,24,28,OFFICE NO. 2 OKMULGEE PUBLIC SCHOOLS
OKMULGEE,OFFICE NO. 2 OKMULGEE PUBLIC SCHOOLS,JOHN P. DELSO,,560005,0,0,9,9,OFFICE NO. 2 OKMULGEE PUBLIC SCHOOLS
OKMULGEE,OFFICE NO. 2 OKMULGEE PUBLIC SCHOOLS,MARCUS D. JEFFREY,,560006,0,0,5,5,OFFICE NO. 2 OKMULGEE PUBLIC SCHOOLS
OKMULGEE,OFFICE NO. 2 OKMULGEE PUBLIC SCHOOLS,VICKIE JONES,,560006,0,2,13,15,OFFICE NO. 2 OKMULGEE PUBLIC SCHOOLS
OKMULGEE,OFFICE NO. 2 OKMULGEE PUBLIC SCHOOLS,JOHN P. DELSO,,560006,0,0,7,7,OFFICE NO. 2 OKMULGEE PUBLIC SCHOOLS
OKMULGEE,OFFICE NO. 2 OKMULGEE PUBLIC SCHOOLS,MARCUS D. JEFFREY,,560007,1,5,14,20,OFFICE NO. 2 OKMULGEE PUBLIC SCHOOLS
OKMULGEE,OFFICE NO. 2 OKMULGEE PUBLIC SCHOOLS,VICKIE JONES,,560007,0,3,13,16,OFFICE NO. 2 OKMULGEE PUBLIC SCHOOLS
OKMULGEE,OFFICE NO. 2 OKMULGEE PUBLIC SCHOOLS,JOHN P. DELSO,,560007,0,1,6,7,OFFICE NO. 2 OKMULGEE PUBLIC SCHOOLS
OKMULGEE,OFFICE NO. 2 OKMULGEE PUBLIC SCHOOLS,MARCUS D. JEFFREY,,560008,1,1,1,3,OFFICE NO. 2 OKMULGEE PUBLIC SCHOOLS
OKMULGEE,OFFICE NO. 2 OKMULGEE PUBLIC SCHOOLS,VICKIE JONES,,560008,0,3,16,19,OFFICE NO. 2 OKMULGEE PUBLIC SCHOOLS
OKMULGEE,OFFICE NO. 2 OKMULGEE PUBLIC SCHOOLS,JOHN P. DELSO,,560008,1,0,3,4,OFFICE NO. 2 OKMULGEE PUBLIC SCHOOLS
OKMULGEE,OFFICE NO. 2 OKMULGEE PUBLIC SCHOOLS,MARCUS D. JEFFREY,,560009,1,3,6,10,OFFICE NO. 2 OKMULGEE PUBLIC SCHOOLS
OKMULGEE,OFFICE NO. 2 OKMULGEE PUBLIC SCHOOLS,VICKIE JONES,,560009,2,4,14,20,OFFICE NO. 2 OKMULGEE PUBLIC SCHOOLS
OKMULGEE,OFFICE NO. 2 OKMULGEE PUBLIC SCHOOLS,JOHN P. DELSO,,560009,0,1,2,3,OFFICE NO. 2 OKMULGEE PUBLIC SCHOOLS
OKMULGEE,OFFICE NO. 2 OKMULGEE PUBLIC SCHOOLS,MARCUS D. JEFFREY,,560010,0,0,2,2,OFFICE NO. 2 OKMULGEE PUBLIC SCHOOLS
OKMULGEE,OFFICE NO. 2 OKMULGEE PUBLIC SCHOOLS,VICKIE JONES,,560010,0,0,8,8,OFFICE NO. 2 OKMULGEE PUBLIC SCHOOLS
OKMULGEE,OFFICE NO. 2 OKMULGEE PUBLIC SCHOOLS,JOHN P. DELSO,,560010,0,0,1,1,OFFICE NO. 2 OKMULGEE PUBLIC SCHOOLS
OKMULGEE,OFFICE NO. 2 OKMULGEE PUBLIC SCHOOLS,MARCUS D. JEFFREY,,560011,1,2,19,22,OFFICE NO. 2 OKMULGEE PUBLIC SCHOOLS
OKMULGEE,OFFICE NO. 2 OKMULGEE PUBLIC SCHOOLS,VICKIE JONES,,560011,5,5,20,30,OFFICE NO. 2 OKMULGEE PUBLIC SCHOOLS
OKMULGEE,OFFICE NO. 2 OKMULGEE PUBLIC SCHOOLS,JOHN P. DELSO,,560011,3,2,8,13,OFFICE NO. 2 OKMULGEE PUBLIC SCHOOLS
OKMULGEE,OFFICE NO. 2 MORRIS PUBLIC SCHOOLS,RODNEY KING,,560012,4,0,4,8,OFFICE NO. 2 MORRIS PUBLIC SCHOOLS
OKMULGEE,OFFICE NO. 2 MORRIS PUBLIC SCHOOLS,DANA MIMS,,560012,0,3,3,6,OFFICE NO. 2 MORRIS PUBLIC SCHOOLS
OKMULGEE,OFFICE NO. 2 MORRIS PUBLIC SCHOOLS,CHARLIE A WHITLEY,,560012,0,0,1,1,OFFICE NO. 2 MORRIS PUBLIC SCHOOLS
OKMULGEE,OFFICE NO. 2 MORRIS PUBLIC SCHOOLS,JOHN POWELL,,560012,1,1,3,5,OFFICE NO. 2 MORRIS PUBLIC SCHOOLS
OKMULGEE,OFFICE NO. 2 OKMULGEE PUBLIC SCHOOLS,MARCUS D. JEFFREY,,560012,2,3,20,25,OFFICE NO. 2 OKMULGEE PUBLIC SCHOOLS
OKMULGEE,OFFICE NO. 2 OKMULGEE PUBLIC SCHOOLS,VICKIE JONES,,560012,0,3,25,28,OFFICE NO. 2 OKMULGEE PUBLIC SCHOOLS
OKMULGEE,OFFICE NO. 2 OKMULGEE PUBLIC SCHOOLS,JOHN P. DELSO,,560012,0,1,11,12,OFFICE NO. 2 OKMULGEE PUBLIC SCHOOLS
OKMULGEE,OFFICE NO. 2 HENRYETTA PUBLIC SCHOOLS,JAMES WILLIAMS,,560013,0,3,0,3,OFFICE NO. 2 HENRYETTA PUBLIC SCHOOLS
OKMULGEE,OFFICE NO. 2 HENRYETTA PUBLIC SCHOOLS,DAVID BULLARD,,560013,0,2,0,2,OFFICE NO. 2 HENRYETTA PUBLIC SCHOOLS
OKMULGEE,OFFICE NO. 4 (UNEXPIRED TERM) HENRYETTA PUBLIC SCHOOLS,GARY CLASON,,560013,0,1,0,1,OFFICE NO. 4 (UNEXPIRED TERM) HENRYETTA PUBLIC SCHOOLS
OKMULGEE,OFFICE NO. 4 (UNEXPIRED TERM) HENRYETTA PUBLIC SCHOOLS,CASEY JONES,,560013,0,4,0,4,OFFICE NO. 4 (UNEXPIRED TERM) HENRYETTA PUBLIC SCHOOLS
OKMULGEE,OFFICE NO. 2 HENRYETTA PUBLIC SCHOOLS,JAMES WILLIAMS,,560014,4,0,24,28,OFFICE NO. 2 HENRYETTA PUBLIC SCHOOLS
OKMULGEE,OFFICE NO. 2 HENRYETTA PUBLIC SCHOOLS,DAVID BULLARD,,560014,3,1,15,19,OFFICE NO. 2 HENRYETTA PUBLIC SCHOOLS
OKMULGEE,OFFICE NO. 4 (UNEXPIRED TERM) HENRYETTA PUBLIC SCHOOLS,GARY CLASON,,560014,1,0,7,8,OFFICE NO. 4 (UNEXPIRED TERM) HENRYETTA PUBLIC SCHOOLS
OKMULGEE,OFFICE NO. 4 (UNEXPIRED TERM) HENRYETTA PUBLIC SCHOOLS,CASEY JONES,,560014,6,1,32,39,OFFICE NO. 4 (UNEXPIRED TERM) HENRYETTA PUBLIC SCHOOLS
OKMULGEE,OFFICE NO. 2 HENRYETTA PUBLIC SCHOOLS,JAMES WILLIAMS,,560015,6,0,92,98,OFFICE NO. 2 HENRYETTA PUBLIC SCHOOLS
OKMULGEE,OFFICE NO. 2 HENRYETTA PUBLIC SCHOOLS,DAVID BULLARD,,560015,5,0,65,70,OFFICE NO. 2 HENRYETTA PUBLIC SCHOOLS
OKMULGEE,OFFICE NO. 4 (UNEXPIRED TERM) HENRYETTA PUBLIC SCHOOLS,GARY CLASON,,560015,3,0,40,43,OFFICE NO. 4 (UNEXPIRED TERM) HENRYETTA PUBLIC SCHOOLS
OKMULGEE,OFFICE NO. 4 (UNEXPIRED TERM) HENRYETTA PUBLIC SCHOOLS,CASEY JONES,,560015,8,1,120,129,OFFICE NO. 4 (UNEXPIRED TERM) HENRYETTA PUBLIC SCHOOLS
OKMULGEE,OFFICE NO. 2 HENRYETTA PUBLIC SCHOOLS,JAMES WILLIAMS,,560016,1,0,33,34,OFFICE NO. 2 HENRYETTA PUBLIC SCHOOLS
OKMULGEE,OFFICE NO. 2 HENRYETTA PUBLIC SCHOOLS,DAVID BULLARD,,560016,2,0,44,46,OFFICE NO. 2 HENRYETTA PUBLIC SCHOOLS
OKMULGEE,OFFICE NO. 4 (UNEXPIRED TERM) HENRYETTA PUBLIC SCHOOLS,GARY CLASON,,560016,3,0,23,26,OFFICE NO. 4 (UNEXPIRED TERM) HENRYETTA PUBLIC SCHOOLS
OKMULGEE,OFFICE NO. 4 (UNEXPIRED TERM) HENRYETTA PUBLIC SCHOOLS,CASEY JONES,,560016,0,0,54,54,OFFICE NO. 4 (UNEXPIRED TERM) HENRYETTA PUBLIC SCHOOLS
OKMULGEE,OFFICE NO. 2 INDIAN CAPITAL TECH CENTER,TOM STILES,,560018,0,0,1,1,OFFICE NO. 2 INDIAN CAPITAL TECH CENTER
OKMULGEE,OFFICE NO. 2 INDIAN CAPITAL TECH CENTER,RAY KIRK,,560018,0,0,0,0,OFFICE NO. 2 INDIAN CAPITAL TECH CENTER
OKMULGEE,PROPOSITION NO. 1 GRAHAM-DUSTIN PUBLIC SCHOOLS,FOR THE PROPOSITION - YES,,560018,0,0,1,1,PROPOSITION NO. 1 GRAHAM-DUSTIN PUBLIC SCHOOLS
OKMULGEE,PROPOSITION NO. 1 GRAHAM-DUSTIN PUBLIC SCHOOLS,AGAINST THE PROPOSITION - NO,,560018,0,0,0,0,PROPOSITION NO. 1 GRAHAM-DUSTIN PUBLIC SCHOOLS
OKMULGEE,PROPOSITION NO. 2 GRAHAM-DUSTIN PUBLIC SCHOOLS,FOR THE PROPOSITION - YES,,560018,0,0,1,1,PROPOSITION NO. 2 GRAHAM-DUSTIN PUBLIC SCHOOLS
OKMULGEE,PROPOSITION NO. 2 GRAHAM-DUSTIN PUBLIC SCHOOLS,AGAINST THE PROPOSITION - NO,,560018,0,0,0,0,PROPOSITION NO. 2 GRAHAM-DUSTIN PUBLIC SCHOOLS
OKMULGEE,OFFICE NO. 2 HENRYETTA PUBLIC SCHOOLS,JAMES WILLIAMS,,560018,7,0,34,41,OFFICE NO. 2 HENRYETTA PUBLIC SCHOOLS
OKMULGEE,OFFICE NO. 2 HENRYETTA PUBLIC SCHOOLS,DAVID BULLARD,,560018,5,1,38,44,OFFICE NO. 2 HENRYETTA PUBLIC SCHOOLS
OKMULGEE,OFFICE NO. 4 (UNEXPIRED TERM) HENRYETTA PUBLIC SCHOOLS,GARY CLASON,,560018,6,0,26,32,OFFICE NO. 4 (UNEXPIRED TERM) HENRYETTA PUBLIC SCHOOLS
OKMULGEE,OFFICE NO. 4 (UNEXPIRED TERM) HENRYETTA PUBLIC SCHOOLS,CASEY JONES,,560018,6,1,47,54,OFFICE NO. 4 (UNEXPIRED TERM) HENRYETTA PUBLIC SCHOOLS
OKMULGEE,OFFICE NO. 2 HENRYETTA PUBLIC SCHOOLS,JAMES WILLIAMS,,560019,2,1,47,50,OFFICE NO. 2 HENRYETTA PUBLIC SCHOOLS
OKMULGEE,OFFICE NO. 2 HENRYETTA PUBLIC SCHOOLS,DAVID BULLARD,,560019,0,0,52,52,OFFICE NO. 2 HENRYETTA PUBLIC SCHOOLS
OKMULGEE,OFFICE NO. 4 (UNEXPIRED TERM) HENRYETTA PUBLIC SCHOOLS,GARY CLASON,,560019,0,1,26,27,OFFICE NO. 4 (UNEXPIRED TERM) HENRYETTA PUBLIC SCHOOLS
OKMULGEE,OFFICE NO. 4 (UNEXPIRED TERM) HENRYETTA PUBLIC SCHOOLS,CASEY JONES,,560019,2,0,73,75,OFFICE NO. 4 (UNEXPIRED TERM) HENRYETTA PUBLIC SCHOOLS
OKMULGEE,OFFICE NO. 2 BEGGS PUBLIC SCHOOLS,MICKEY SHAFFER,,560020,0,2,75,77,OFFICE NO. 2 BEGGS PUBLIC SCHOOLS
OKMULGEE,OFFICE NO. 2 BEGGS PUBLIC SCHOOLS,LARRY CHRISTY,,560020,3,1,95,99,OFFICE NO. 2 BEGGS PUBLIC SCHOOLS
OKMULGEE,OFFICE NO. 2 BEGGS PUBLIC SCHOOLS,O G CORKY THOMPSON,,560020,0,0,6,6,OFFICE NO. 2 BEGGS PUBLIC SCHOOLS
OKMULGEE,OFFICE NO. 2 MORRIS PUBLIC SCHOOLS,RODNEY KING,,560021,0,2,15,17,OFFICE NO. 2 MORRIS PUBLIC SCHOOLS
OKMULGEE,OFFICE NO. 2 MORRIS PUBLIC SCHOOLS,DANA MIMS,,560021,0,0,1,1,OFFICE NO. 2 MORRIS PUBLIC SCHOOLS
OKMULGEE,OFFICE NO. 2 MORRIS PUBLIC SCHOOLS,CHARLIE A WHITLEY,,560021,0,0,5,5,OFFICE NO. 2 MORRIS PUBLIC SCHOOLS
OKMULGEE,OFFICE NO. 2 MORRIS PUBLIC SCHOOLS,JOHN POWELL,,560021,0,0,5,5,OFFICE NO. 2 MORRIS PUBLIC SCHOOLS
OKMULGEE,OFFICE NO. 2 MIDWAY PUBLIC SCHOOLS,CAL HORSLEY,,560026,0,0,0,0,OFFICE NO. 2 MIDWAY PUBLIC SCHOOLS
OKMULGEE,OFFICE NO. 2 MIDWAY PUBLIC SCHOOLS,GARY LEE DUVALL,,560026,0,0,0,0,OFFICE NO. 2 MIDWAY PUBLIC SCHOOLS
OKMULGEE,OFFICE NO. 2 MORRIS PUBLIC SCHOOLS,RODNEY KING,,560026,0,3,82,85,OFFICE NO. 2 MORRIS PUBLIC SCHOOLS
OKMULGEE,OFFICE NO. 2 MORRIS PUBLIC SCHOOLS,DANA MIMS,,560026,0,5,57,62,OFFICE NO. 2 MORRIS PUBLIC SCHOOLS
OKMULGEE,OFFICE NO. 2 MORRIS PUBLIC SCHOOLS,CHARLIE A WHITLEY,,560026,1,0,8,9,OFFICE NO. 2 MORRIS PUBLIC SCHOOLS
OKMULGEE,OFFICE NO. 2 MORRIS PUBLIC SCHOOLS,JOHN POWELL,,560026,0,0,13,13,OFFICE NO. 2 MORRIS PUBLIC SCHOOLS
OKMULGEE,OFFICE NO. 2 INDIAN CAPITAL TECH CENTER,TOM STILES,,560027,0,0,0,0,OFFICE NO. 2 INDIAN CAPITAL TECH CENTER
OKMULGEE,OFFICE NO. 2 INDIAN CAPITAL TECH CENTER,RAY KIRK,,560027,0,0,0,0,OFFICE NO. 2 INDIAN CAPITAL TECH CENTER
OKMULGEE,OFFICE NO. 2 MORRIS PUBLIC SCHOOLS,RODNEY KING,,560027,0,0,1,1,OFFICE NO. 2 MORRIS PUBLIC SCHOOLS
OKMULGEE,OFFICE NO. 2 MORRIS PUBLIC SCHOOLS,DANA MIMS,,560027,0,0,0,0,OFFICE NO. 2 MORRIS PUBLIC SCHOOLS
OKMULGEE,OFFICE NO. 2 MORRIS PUBLIC SCHOOLS,CHARLIE A WHITLEY,,560027,0,0,1,1,OFFICE NO. 2 MORRIS PUBLIC SCHOOLS
OKMULGEE,OFFICE NO. 2 MORRIS PUBLIC SCHOOLS,JOHN POWELL,,560027,0,0,0,0,OFFICE NO. 2 MORRIS PUBLIC SCHOOLS
OKMULGEE,OFFICE NO. 2 BEGGS PUBLIC SCHOOLS,MICKEY SHAFFER,,560029,1,2,10,13,OFFICE NO. 2 BEGGS PUBLIC SCHOOLS
OKMULGEE,OFFICE NO. 2 BEGGS PUBLIC SCHOOLS,LARRY CHRISTY,,560029,0,0,8,8,OFFICE NO. 2 BEGGS PUBLIC SCHOOLS
OKMULGEE,OFFICE NO. 2 BEGGS PUBLIC SCHOOLS,O G CORKY THOMPSON,,560029,0,2,2,4,OFFICE NO. 2 BEGGS PUBLIC SCHOOLS
OKMULGEE,OFFICE NO. 2 BEGGS PUBLIC SCHOOLS,MICKEY SHAFFER,,560031,0,0,0,0,OFFICE NO. 2 BEGGS PUBLIC SCHOOLS
OKMULGEE,OFFICE NO. 2 BEGGS PUBLIC SCHOOLS,LARRY CHRISTY,,560031,0,0,14,14,OFFICE NO. 2 BEGGS PUBLIC SCHOOLS
OKMULGEE,OFFICE NO. 2 BEGGS PUBLIC SCHOOLS,O G CORKY THOMPSON,,560031,0,0,0,0,OFFICE NO. 2 BEGGS PUBLIC SCHOOLS
OKMULGEE,OFFICE NO. 2 OKMULGEE PUBLIC SCHOOLS,MARCUS D. JEFFREY,,560031,0,0,3,3,OFFICE NO. 2 OKMULGEE PUBLIC SCHOOLS
OKMULGEE,OFFICE NO. 2 OKMULGEE PUBLIC SCHOOLS,VICKIE JONES,,560031,0,0,0,0,OFFICE NO. 2 OKMULGEE PUBLIC SCHOOLS
OKMULGEE,OFFICE NO. 2 OKMULGEE PUBLIC SCHOOLS,JOHN P. DELSO,,560031,0,0,0,0,OFFICE NO. 2 OKMULGEE PUBLIC SCHOOLS
OKMULGEE,OFFICE NO. 2 BEGGS PUBLIC SCHOOLS,MICKEY SHAFFER,,560032,0,0,0,0,OFFICE NO. 2 BEGGS PUBLIC SCHOOLS
OKMULGEE,OFFICE NO. 2 BEGGS PUBLIC SCHOOLS,LARRY CHRISTY,,560032,0,0,7,7,OFFICE NO. 2 BEGGS PUBLIC SCHOOLS
OKMULGEE,OFFICE NO. 2 BEGGS PUBLIC SCHOOLS,O G CORKY THOMPSON,,560032,0,0,0,0,OFFICE NO. 2 BEGGS PUBLIC SCHOOLS
OKMULGEE,OFFICE NO. 2 OKMULGEE PUBLIC SCHOOLS,MARCUS D. JEFFREY,,560032,1,2,5,8,OFFICE NO. 2 OKMULGEE PUBLIC SCHOOLS
OKMULGEE,OFFICE NO. 2 OKMULGEE PUBLIC SCHOOLS,VICKIE JONES,,560032,0,1,6,7,OFFICE NO. 2 OKMULGEE PUBLIC SCHOOLS
OKMULGEE,OFFICE NO. 2 OKMULGEE PUBLIC SCHOOLS,JOHN P. DELSO,,560032,0,0,2,2,OFFICE NO. 2 OKMULGEE PUBLIC SCHOOLS
OKMULGEE,OFFICE NO. 2 BEGGS PUBLIC SCHOOLS,MICKEY SHAFFER,,560033,0,0,2,2,OFFICE NO. 2 BEGGS PUBLIC SCHOOLS
OKMULGEE,OFFICE NO. 2 BEGGS PUBLIC SCHOOLS,LARRY CHRISTY,,560033,0,0,4,4,OFFICE NO. 2 BEGGS PUBLIC SCHOOLS
OKMULGEE,OFFICE NO. 2 BEGGS PUBLIC SCHOOLS,O G CORKY THOMPSON,,560033,0,0,0,0,OFFICE NO. 2 BEGGS PUBLIC SCHOOLS
OKMULGEE,OFFICE NO. 2 MORRIS PUBLIC SCHOOLS,RODNEY KING,,560034,0,1,20,21,OFFICE NO. 2 MORRIS PUBLIC SCHOOLS
OKMULGEE,OFFICE NO. 2 MORRIS PUBLIC SCHOOLS,DANA MIMS,,560034,0,0,10,10,OFFICE NO. 2 MORRIS PUBLIC SCHOOLS
OKMULGEE,OFFICE NO. 2 MORRIS PUBLIC SCHOOLS,CHARLIE A WHITLEY,,560034,1,0,4,5,OFFICE NO. 2 MORRIS PUBLIC SCHOOLS
OKMULGEE,OFFICE NO. 2 MORRIS PUBLIC SCHOOLS,JOHN POWELL,,560034,0,0,12,12,OFFICE NO. 2 MORRIS PUBLIC SCHOOLS
OKMULGEE,OFFICE NO. 2 OKMULGEE PUBLIC SCHOOLS,MARCUS D. JEFFREY,,560034,0,0,0,0,OFFICE NO. 2 OKMULGEE PUBLIC SCHOOLS
OKMULGEE,OFFICE NO. 2 OKMULGEE PUBLIC SCHOOLS,VICKIE JONES,,560034,0,0,0,0,OFFICE NO. 2 OKMULGEE PUBLIC SCHOOLS
OKMULGEE,OFFICE NO. 2 OKMULGEE PUBLIC SCHOOLS,JOHN P. DELSO,,560034,0,0,0,0,OFFICE NO. 2 OKMULGEE PUBLIC SCHOOLS
OKMULGEE,OFFICE NO. 2 MORRIS PUBLIC SCHOOLS,RODNEY KING,,560036,1,0,29,30,OFFICE NO. 2 MORRIS PUBLIC SCHOOLS
OKMULGEE,OFFICE NO. 2 MORRIS PUBLIC SCHOOLS,DANA MIMS,,560036,3,4,19,26,OFFICE NO. 2 MORRIS PUBLIC SCHOOLS
OKMULGEE,OFFICE NO. 2 MORRIS PUBLIC SCHOOLS,CHARLIE A WHITLEY,,560036,0,0,3,3,OFFICE NO. 2 MORRIS PUBLIC SCHOOLS
OKMULGEE,OFFICE NO. 2 MORRIS PUBLIC SCHOOLS,JOHN POWELL,,560036,0,0,7,7,OFFICE NO. 2 MORRIS PUBLIC SCHOOLS
OKMULGEE,OFFICE NO. 2 OKMULGEE PUBLIC SCHOOLS,MARCUS D. JEFFREY,,560036,0,0,8,8,OFFICE NO. 2 OKMULGEE PUBLIC SCHOOLS
OKMULGEE,OFFICE NO. 2 OKMULGEE PUBLIC SCHOOLS,VICKIE JONES,,560036,0,0,6,6,OFFICE NO. 2 OKMULGEE PUBLIC SCHOOLS
OKMULGEE,OFFICE NO. 2 OKMULGEE PUBLIC SCHOOLS,JOHN P. DELSO,,560036,0,0,1,1,OFFICE NO. 2 OKMULGEE PUBLIC SCHOOLS
OKMULGEE,OFFICE NO. 2 OKMULGEE PUBLIC SCHOOLS,MARCUS D. JEFFREY,,560038,0,0,0,0,OFFICE NO. 2 OKMULGEE PUBLIC SCHOOLS
OKMULGEE,OFFICE NO. 2 OKMULGEE PUBLIC SCHOOLS,VICKIE JONES,,560038,0,0,0,0,OFFICE NO. 2 OKMULGEE PUBLIC SCHOOLS
OKMULGEE,OFFICE NO. 2 OKMULGEE PUBLIC SCHOOLS,JOHN P. DELSO,,560038,0,0,0,0,OFFICE NO. 2 OKMULGEE PUBLIC SCHOOLS
OSAGE,COUNTY COMMISSIONER DISTRICT NO. 1 (UNEXPIRED TERM),RANDALL JONES,Republican,570101,0,0,3,3,COUNTY COMMISSIONER DISTRICT NO. 1 (UNEXPIRED TERM)
OSAGE,COUNTY COMMISSIONER DISTRICT NO. 1 (UNEXPIRED TERM),WILL CUBBAGE,Republican,570101,0,2,18,20,COUNTY COMMISSIONER DISTRICT NO. 1 (UNEXPIRED TERM)
OSAGE,OFFICE NO. 1 BOWRING PUBLIC SCHOOL,WHITNEY VIRDEN,,570101,0,2,22,24,OFFICE NO. 1 BOWRING PUBLIC SCHOOL
OSAGE,OFFICE NO. 1 BOWRING PUBLIC SCHOOL,DONNA L JOHNSON,,570101,0,0,19,19,OFFICE NO. 1 BOWRING PUBLIC SCHOOL
OSAGE,COUNTY COMMISSIONER DISTRICT NO. 1 (UNEXPIRED TERM),RANDALL JONES,Republican,570102,0,0,5,5,COUNTY COMMISSIONER DISTRICT NO. 1 (UNEXPIRED TERM)
OSAGE,COUNTY COMMISSIONER DISTRICT NO. 1 (UNEXPIRED TERM),WILL CUBBAGE,Republican,570102,1,1,11,13,COUNTY COMMISSIONER DISTRICT NO. 1 (UNEXPIRED TERM)
OSAGE,OFFICE NO. 1 BOWRING PUBLIC SCHOOL,WHITNEY VIRDEN,,570102,1,0,4,5,OFFICE NO. 1 BOWRING PUBLIC SCHOOL
OSAGE,OFFICE NO. 1 BOWRING PUBLIC SCHOOL,DONNA L JOHNSON,,570102,2,0,0,2,OFFICE NO. 1 BOWRING PUBLIC SCHOOL
OSAGE,OFFICE NO. 2 PAWHUSKA PUBLIC SCHOOLS,JEFF W. BUTE,,570102,0,0,0,0,OFFICE NO. 2 PAWHUSKA PUBLIC SCHOOLS
OSAGE,OFFICE NO. 2 PAWHUSKA PUBLIC SCHOOLS,THOMAS J BOONE JR,,570102,1,3,2,6,OFFICE NO. 2 PAWHUSKA PUBLIC SCHOOLS
OSAGE,COUNTY COMMISSIONER DISTRICT NO. 1 (UNEXPIRED TERM),RANDALL JONES,Republican,570103,0,0,7,7,COUNTY COMMISSIONER DISTRICT NO. 1 (UNEXPIRED TERM)
OSAGE,COUNTY COMMISSIONER DISTRICT NO. 1 (UNEXPIRED TERM),WILL CUBBAGE,Republican,570103,0,0,30,30,COUNTY COMMISSIONER DISTRICT NO. 1 (UNEXPIRED TERM)
OSAGE,OFFICE NO. 2 PAWHUSKA PUBLIC SCHOOLS,JEFF W. BUTE,,570103,0,0,0,0,OFFICE NO. 2 PAWHUSKA PUBLIC SCHOOLS
OSAGE,OFFICE NO. 2 PAWHUSKA PUBLIC SCHOOLS,THOMAS J BOONE JR,,570103,0,0,0,0,OFFICE NO. 2 PAWHUSKA PUBLIC SCHOOLS
OSAGE,OFFICE NO. 2 SHIDLER PUBLIC SCHOOLS,WILLY HARGRAVES,,570103,1,0,59,60,OFFICE NO. 2 SHIDLER PUBLIC SCHOOLS
OSAGE,OFFICE NO. 2 SHIDLER PUBLIC SCHOOLS,NICHOLAS L SMITH,,570103,1,0,27,28,OFFICE NO. 2 SHIDLER PUBLIC SCHOOLS
OSAGE,COUNTY COMMISSIONER DISTRICT NO. 1 (UNEXPIRED TERM),RANDALL JONES,Republican,570105,0,0,5,5,COUNTY COMMISSIONER DISTRICT NO. 1 (UNEXPIRED TERM)
OSAGE,COUNTY COMMISSIONER DISTRICT NO. 1 (UNEXPIRED TERM),WILL CUBBAGE,Republican,570105,0,1,37,38,COUNTY COMMISSIONER DISTRICT NO. 1 (UNEXPIRED TERM)
OSAGE,OFFICE NO. 2 SHIDLER PUBLIC SCHOOLS,WILLY HARGRAVES,,570105,5,0,11,16,OFFICE NO. 2 SHIDLER PUBLIC SCHOOLS
OSAGE,OFFICE NO. 2 SHIDLER PUBLIC SCHOOLS,NICHOLAS L SMITH,,570105,0,0,1,1,OFFICE NO. 2 SHIDLER PUBLIC SCHOOLS
OSAGE,COUNTY COMMISSIONER DISTRICT NO. 1 (UNEXPIRED TERM),RANDALL JONES,Republican,570106,0,0,3,3,COUNTY COMMISSIONER DISTRICT NO. 1 (UNEXPIRED TERM)
OSAGE,COUNTY COMMISSIONER DISTRICT NO. 1 (UNEXPIRED TERM),WILL CUBBAGE,Republican,570106,0,0,6,6,COUNTY COMMISSIONER DISTRICT NO. 1 (UNEXPIRED TERM)
OSAGE,OFFICE NO. 2 SHIDLER PUBLIC SCHOOLS,WILLY HARGRAVES,,570106,0,0,12,12,OFFICE NO. 2 SHIDLER PUBLIC SCHOOLS
OSAGE,OFFICE NO. 2 SHIDLER PUBLIC SCHOOLS,NICHOLAS L SMITH,,570106,0,0,1,1,OFFICE NO. 2 SHIDLER PUBLIC SCHOOLS
OSAGE,COUNTY COMMISSIONER DISTRICT NO. 1 (UNEXPIRED TERM),RANDALL JONES,Republican,570107,4,4,60,68,COUNTY COMMISSIONER DISTRICT NO. 1 (UNEXPIRED TERM)
OSAGE,COUNTY COMMISSIONER DISTRICT NO. 1 (UNEXPIRED TERM),WILL CUBBAGE,Republican,570107,1,6,91,98,COUNTY COMMISSIONER DISTRICT NO. 1 (UNEXPIRED TERM)
OSAGE,COUNCILMAN AT LARGE CITY OF PAWHUSKA,RODGER MILLESON,,570107,2,23,196,221,
OSAGE,COUNCILMAN AT LARGE CITY OF PAWHUSKA,CINDY TILLMAN,,570107,3,17,141,161,
OSAGE,OFFICE NO. 1 BOWRING PUBLIC SCHOOL,WHITNEY VIRDEN,,570107,1,1,5,7,OFFICE NO. 1 BOWRING PUBLIC SCHOOL
OSAGE,OFFICE NO. 1 BOWRING PUBLIC SCHOOL,DONNA L JOHNSON,,570107,1,1,6,8,OFFICE NO. 1 BOWRING PUBLIC SCHOOL
OSAGE,OFFICE NO. 2 PAWHUSKA PUBLIC SCHOOLS,JEFF W. BUTE,,570107,3,14,178,195,OFFICE NO. 2 PAWHUSKA PUBLIC SCHOOLS
OSAGE,OFFICE NO. 2 PAWHUSKA PUBLIC SCHOOLS,THOMAS J BOONE JR,,570107,7,30,217,254,OFFICE NO. 2 PAWHUSKA PUBLIC SCHOOLS
OSAGE,COUNTY COMMISSIONER DISTRICT NO. 1 (UNEXPIRED TERM),RANDALL JONES,Republican,570108,1,1,29,31,COUNTY COMMISSIONER DISTRICT NO. 1 (UNEXPIRED TERM)
OSAGE,COUNTY COMMISSIONER DISTRICT NO. 1 (UNEXPIRED TERM),WILL CUBBAGE,Republican,570108,2,10,38,50,COUNTY COMMISSIONER DISTRICT NO. 1 (UNEXPIRED TERM)
OSAGE,COUNCILMAN AT LARGE CITY OF PAWHUSKA,RODGER MILLESON,,570108,4,10,58,72,
OSAGE,COUNCILMAN AT LARGE CITY OF PAWHUSKA,CINDY TILLMAN,,570108,1,4,52,57,
OSAGE,OFFICE NO. 2 PAWHUSKA PUBLIC SCHOOLS,JEFF W. BUTE,,570108,2,9,91,102,OFFICE NO. 2 PAWHUSKA PUBLIC SCHOOLS
OSAGE,OFFICE NO. 2 PAWHUSKA PUBLIC SCHOOLS,THOMAS J BOONE JR,,570108,3,18,117,138,OFFICE NO. 2 PAWHUSKA PUBLIC SCHOOLS
OSAGE,COUNTY COMMISSIONER DISTRICT NO. 1 (UNEXPIRED TERM),RANDALL JONES,Republican,570109,1,0,10,11,COUNTY COMMISSIONER DISTRICT NO. 1 (UNEXPIRED TERM)
OSAGE,COUNTY COMMISSIONER DISTRICT NO. 1 (UNEXPIRED TERM),WILL CUBBAGE,Republican,570109,2,0,52,54,COUNTY COMMISSIONER DISTRICT NO. 1 (UNEXPIRED TERM)
OSAGE,OFFICE NO. 1 BOWRING PUBLIC SCHOOL,WHITNEY VIRDEN,,570109,0,0,0,0,OFFICE NO. 1 BOWRING PUBLIC SCHOOL
OSAGE,OFFICE NO. 1 BOWRING PUBLIC SCHOOL,DONNA L JOHNSON,,570109,0,0,0,0,OFFICE NO. 1 BOWRING PUBLIC SCHOOL
OSAGE,PROPOSITION OSAGE HILLS PUBLIC SCHOOL,FOR THE PROPOSITION - YES,,570109,0,0,48,48,
OSAGE,PROPOSITION OSAGE HILLS PUBLIC SCHOOL,AGAINST THE PROPOSITION - NO,,570109,0,0,13,13,
OSAGE,PROPOSITION NO. 1 SKIATOOK PUBLIC SCHOOLS,FOR THE PROPOSITION - YES,,570109,0,0,0,0,PROPOSITION NO. 1 SKIATOOK PUBLIC SCHOOLS
OSAGE,PROPOSITION NO. 1 SKIATOOK PUBLIC SCHOOLS,AGAINST THE PROPOSITION - NO,,570109,0,0,0,0,PROPOSITION NO. 1 SKIATOOK PUBLIC SCHOOLS
OSAGE,PROPOSITION NO. 2 SKIATOOK PUBLIC SCHOOLS,FOR THE PROPOSITION - YES,,570109,0,0,0,0,PROPOSITION NO. 2 SKIATOOK PUBLIC SCHOOLS
OSAGE,PROPOSITION NO. 2 SKIATOOK PUBLIC SCHOOLS,AGAINST THE PROPOSITION - NO,,570109,0,0,0,0,PROPOSITION NO. 2 SKIATOOK PUBLIC SCHOOLS
OSAGE,OFFICE NO. 5 (UNEXPIRED TERM) TULSA TECH CENTER,ROY D. McCLAIN,,570109,0,0,0,0,OFFICE NO. 5 (UNEXPIRED TERM) TULSA TECH CENTER
OSAGE,OFFICE NO. 5 (UNEXPIRED TERM) TULSA TECH CENTER,DANNY HANCOCK,,570109,0,0,0,0,OFFICE NO. 5 (UNEXPIRED TERM) TULSA TECH CENTER
OSAGE,COUNTY COMMISSIONER DISTRICT NO. 1 (UNEXPIRED TERM),RANDALL JONES,Republican,570110,1,0,9,10,COUNTY COMMISSIONER DISTRICT NO. 1 (UNEXPIRED TERM)
OSAGE,COUNTY COMMISSIONER DISTRICT NO. 1 (UNEXPIRED TERM),WILL CUBBAGE,Republican,570110,3,0,24,27,COUNTY COMMISSIONER DISTRICT NO. 1 (UNEXPIRED TERM)
OSAGE,OFFICE NO. 2 PAWHUSKA PUBLIC SCHOOLS,JEFF W. BUTE,,570110,0,0,2,2,OFFICE NO. 2 PAWHUSKA PUBLIC SCHOOLS
OSAGE,OFFICE NO. 2 PAWHUSKA PUBLIC SCHOOLS,THOMAS J BOONE JR,,570110,0,0,1,1,OFFICE NO. 2 PAWHUSKA PUBLIC SCHOOLS
OSAGE,COUNTY COMMISSIONER DISTRICT NO. 1 (UNEXPIRED TERM),RANDALL JONES,Republican,570111,0,0,7,7,COUNTY COMMISSIONER DISTRICT NO. 1 (UNEXPIRED TERM)
OSAGE,COUNTY COMMISSIONER DISTRICT NO. 1 (UNEXPIRED TERM),WILL CUBBAGE,Republican,570111,0,3,10,13,COUNTY COMMISSIONER DISTRICT NO. 1 (UNEXPIRED TERM)
OSAGE,OFFICE NO. 2 PAWHUSKA PUBLIC SCHOOLS,JEFF W. BUTE,,570111,0,0,0,0,OFFICE NO. 2 PAWHUSKA PUBLIC SCHOOLS
OSAGE,OFFICE NO. 2 PAWHUSKA PUBLIC SCHOOLS,THOMAS J BOONE JR,,570111,0,0,0,0,OFFICE NO. 2 PAWHUSKA PUBLIC SCHOOLS
OSAGE,COUNTY COMMISSIONER DISTRICT NO. 1 (UNEXPIRED TERM),RANDALL JONES,Republican,570112,0,0,2,2,COUNTY COMMISSIONER DISTRICT NO. 1 (UNEXPIRED TERM)
OSAGE,COUNTY COMMISSIONER DISTRICT NO. 1 (UNEXPIRED TERM),WILL CUBBAGE,Republican,570112,6,5,12,23,COUNTY COMMISSIONER DISTRICT NO. 1 (UNEXPIRED TERM)
OSAGE,PROPOSITION NO. 1 SKIATOOK PUBLIC SCHOOLS,FOR THE PROPOSITION - YES,,570112,0,0,0,0,PROPOSITION NO. 1 SKIATOOK PUBLIC SCHOOLS
OSAGE,PROPOSITION NO. 1 SKIATOOK PUBLIC SCHOOLS,AGAINST THE PROPOSITION - NO,,570112,2,0,0,2,PROPOSITION NO. 1 SKIATOOK PUBLIC SCHOOLS
OSAGE,PROPOSITION NO. 2 SKIATOOK PUBLIC SCHOOLS,FOR THE PROPOSITION - YES,,570112,0,0,0,0,PROPOSITION NO. 2 SKIATOOK PUBLIC SCHOOLS
OSAGE,PROPOSITION NO. 2 SKIATOOK PUBLIC SCHOOLS,AGAINST THE PROPOSITION - NO,,570112,2,0,0,2,PROPOSITION NO. 2 SKIATOOK PUBLIC SCHOOLS
OSAGE,OFFICE NO. 5 (UNEXPIRED TERM) TULSA TECH CENTER,ROY D. McCLAIN,,570112,0,0,0,0,OFFICE NO. 5 (UNEXPIRED TERM) TULSA TECH CENTER
OSAGE,OFFICE NO. 5 (UNEXPIRED TERM) TULSA TECH CENTER,DANNY HANCOCK,,570112,2,0,0,2,OFFICE NO. 5 (UNEXPIRED TERM) TULSA TECH CENTER
OSAGE,COUNTY COMMISSIONER DISTRICT NO. 1 (UNEXPIRED TERM),RANDALL JONES,Republican,570113,0,0,0,0,COUNTY COMMISSIONER DISTRICT NO. 1 (UNEXPIRED TERM)
OSAGE,COUNTY COMMISSIONER DISTRICT NO. 1 (UNEXPIRED TERM),WILL CUBBAGE,Republican,570113,1,0,4,5,COUNTY COMMISSIONER DISTRICT NO. 1 (UNEXPIRED TERM)
OSAGE,OFFICE NO. 2 PAWHUSKA PUBLIC SCHOOLS,JEFF W. BUTE,,570113,0,0,0,0,OFFICE NO. 2 PAWHUSKA PUBLIC SCHOOLS
OSAGE,OFFICE NO. 2 PAWHUSKA PUBLIC SCHOOLS,THOMAS J BOONE JR,,570113,0,0,0,0,OFFICE NO. 2 PAWHUSKA PUBLIC SCHOOLS
OSAGE,OFFICE NO. 2 SHIDLER PUBLIC SCHOOLS,WILLY HARGRAVES,,570113,0,0,5,5,OFFICE NO. 2 SHIDLER PUBLIC SCHOOLS
OSAGE,OFFICE NO. 2 SHIDLER PUBLIC SCHOOLS,NICHOLAS L SMITH,,570113,1,0,8,9,OFFICE NO. 2 SHIDLER PUBLIC SCHOOLS
OSAGE,PROPOSITION NO. 1 SKIATOOK PUBLIC SCHOOLS,FOR THE PROPOSITION - YES,,570201,17,1,272,290,PROPOSITION NO. 1 SKIATOOK PUBLIC SCHOOLS
OSAGE,PROPOSITION NO. 1 SKIATOOK PUBLIC SCHOOLS,AGAINST THE PROPOSITION - NO,,570201,5,0,39,44,PROPOSITION NO. 1 SKIATOOK PUBLIC SCHOOLS
OSAGE,PROPOSITION NO. 2 SKIATOOK PUBLIC SCHOOLS,FOR THE PROPOSITION - YES,,570201,17,1,271,289,PROPOSITION NO. 2 SKIATOOK PUBLIC SCHOOLS
OSAGE,PROPOSITION NO. 2 SKIATOOK PUBLIC SCHOOLS,AGAINST THE PROPOSITION - NO,,570201,5,0,41,46,PROPOSITION NO. 2 SKIATOOK PUBLIC SCHOOLS
OSAGE,OFFICE NO. 5 (UNEXPIRED TERM) TULSA TECH CENTER,ROY D. McCLAIN,,570201,7,1,128,136,OFFICE NO. 5 (UNEXPIRED TERM) TULSA TECH CENTER
OSAGE,OFFICE NO. 5 (UNEXPIRED TERM) TULSA TECH CENTER,DANNY HANCOCK,,570201,11,0,152,163,OFFICE NO. 5 (UNEXPIRED TERM) TULSA TECH CENTER
OSAGE,OFFICE NO. 3 TULSA PUBLIC SCHOOLS,LANA TURNER,,570202,10,0,106,116,OFFICE NO. 3 TULSA PUBLIC SCHOOLS
OSAGE,OFFICE NO. 3 TULSA PUBLIC SCHOOLS,WHITNEY COLE,,570202,3,0,6,9,OFFICE NO. 3 TULSA PUBLIC SCHOOLS
OSAGE,OFFICE NO. 3 TULSA PUBLIC SCHOOLS,JENNETTIE P. MARSHALL,,570202,17,1,115,133,OFFICE NO. 3 TULSA PUBLIC SCHOOLS
OSAGE,OFFICE NO. 1 TULSA TECH CENTER,RAY A. OWENS,,570202,28,1,148,177,OFFICE NO. 1 TULSA TECH CENTER
OSAGE,OFFICE NO. 1 TULSA TECH CENTER,MELANIE SWEENEY McINTOSH,,570202,5,0,43,48,OFFICE NO. 1 TULSA TECH CENTER
OSAGE,OFFICE NO. 1 TULSA TECH CENTER,KEENAN H. MEADORS,,570202,5,0,39,44,OFFICE NO. 1 TULSA TECH CENTER
OSAGE,PROPOSITION NO. 1 SKIATOOK PUBLIC SCHOOLS,FOR THE PROPOSITION - YES,,570203,10,0,225,235,PROPOSITION NO. 1 SKIATOOK PUBLIC SCHOOLS
OSAGE,PROPOSITION NO. 1 SKIATOOK PUBLIC SCHOOLS,AGAINST THE PROPOSITION - NO,,570203,6,0,38,44,PROPOSITION NO. 1 SKIATOOK PUBLIC SCHOOLS
OSAGE,PROPOSITION NO. 2 SKIATOOK PUBLIC SCHOOLS,FOR THE PROPOSITION - YES,,570203,10,0,220,230,PROPOSITION NO. 2 SKIATOOK PUBLIC SCHOOLS
OSAGE,PROPOSITION NO. 2 SKIATOOK PUBLIC SCHOOLS,AGAINST THE PROPOSITION - NO,,570203,6,0,39,45,PROPOSITION NO. 2 SKIATOOK PUBLIC SCHOOLS
OSAGE,OFFICE NO. 5 (UNEXPIRED TERM) TULSA TECH CENTER,ROY D. McCLAIN,,570203,4,0,117,121,OFFICE NO. 5 (UNEXPIRED TERM) TULSA TECH CENTER
OSAGE,OFFICE NO. 5 (UNEXPIRED TERM) TULSA TECH CENTER,DANNY HANCOCK,,570203,11,0,122,133,OFFICE NO. 5 (UNEXPIRED TERM) TULSA TECH CENTER
OSAGE,OFFICE NO. 3 TULSA PUBLIC SCHOOLS,LANA TURNER,,570204,0,0,0,0,OFFICE NO. 3 TULSA PUBLIC SCHOOLS
OSAGE,OFFICE NO. 3 TULSA PUBLIC SCHOOLS,WHITNEY COLE,,570204,0,0,0,0,OFFICE NO. 3 TULSA PUBLIC SCHOOLS
OSAGE,OFFICE NO. 3 TULSA PUBLIC SCHOOLS,JENNETTIE P. MARSHALL,,570204,0,0,0,0,OFFICE NO. 3 TULSA PUBLIC SCHOOLS
OSAGE,OFFICE NO. 5 (UNEXPIRED TERM) TULSA TECH CENTER,ROY D. McCLAIN,,570204,1,0,1,2,OFFICE NO. 5 (UNEXPIRED TERM) TULSA TECH CENTER
OSAGE,OFFICE NO. 5 (UNEXPIRED TERM) TULSA TECH CENTER,DANNY HANCOCK,,570204,5,1,3,9,OFFICE NO. 5 (UNEXPIRED TERM) TULSA TECH CENTER
OSAGE,OFFICE NO. 3 TULSA PUBLIC SCHOOLS,LANA TURNER,,570205,1,0,0,1,OFFICE NO. 3 TULSA PUBLIC SCHOOLS
OSAGE,OFFICE NO. 3 TULSA PUBLIC SCHOOLS,WHITNEY COLE,,570205,0,0,2,2,OFFICE NO. 3 TULSA PUBLIC SCHOOLS
OSAGE,OFFICE NO. 3 TULSA PUBLIC SCHOOLS,JENNETTIE P. MARSHALL,,570205,1,0,1,2,OFFICE NO. 3 TULSA PUBLIC SCHOOLS
OSAGE,OFFICE NO. 5 (UNEXPIRED TERM) TULSA TECH CENTER,ROY D. McCLAIN,,570205,2,0,0,2,OFFICE NO. 5 (UNEXPIRED TERM) TULSA TECH CENTER
OSAGE,OFFICE NO. 5 (UNEXPIRED TERM) TULSA TECH CENTER,DANNY HANCOCK,,570205,2,0,3,5,OFFICE NO. 5 (UNEXPIRED TERM) TULSA TECH CENTER
OSAGE,OFFICE NO. 2 PAWHUSKA PUBLIC SCHOOLS,JEFF W. BUTE,,570301,0,0,0,0,OFFICE NO. 2 PAWHUSKA PUBLIC SCHOOLS
OSAGE,OFFICE NO. 2 PAWHUSKA PUBLIC SCHOOLS,THOMAS J BOONE JR,,570301,0,0,0,0,OFFICE NO. 2 PAWHUSKA PUBLIC SCHOOLS
OSAGE,OFFICE NO. 2 PAWHUSKA PUBLIC SCHOOLS,JEFF W. BUTE,,570306,0,0,0,0,OFFICE NO. 2 PAWHUSKA PUBLIC SCHOOLS
OSAGE,OFFICE NO. 2 PAWHUSKA PUBLIC SCHOOLS,THOMAS J BOONE JR,,570306,0,0,0,0,OFFICE NO. 2 PAWHUSKA PUBLIC SCHOOLS
OSAGE,OFFICE NO. 5 (UNEXPIRED TERM) TULSA TECH CENTER,ROY D. McCLAIN,,570306,0,0,0,0,OFFICE NO. 5 (UNEXPIRED TERM) TULSA TECH CENTER
OSAGE,OFFICE NO. 5 (UNEXPIRED TERM) TULSA TECH CENTER,DANNY HANCOCK,,570306,0,0,0,0,OFFICE NO. 5 (UNEXPIRED TERM) TULSA TECH CENTER
OSAGE,OFFICE NO. 5 (UNEXPIRED TERM) TULSA TECH CENTER,ROY D. McCLAIN,,570308,0,0,0,0,OFFICE NO. 5 (UNEXPIRED TERM) TULSA TECH CENTER
OSAGE,OFFICE NO. 5 (UNEXPIRED TERM) TULSA TECH CENTER,DANNY HANCOCK,,570308,0,0,0,0,OFFICE NO. 5 (UNEXPIRED TERM) TULSA TECH CENTER
OSAGE,OFFICE NO. 5 (UNEXPIRED TERM) TULSA TECH CENTER,ROY D. McCLAIN,,570309,0,0,5,5,OFFICE NO. 5 (UNEXPIRED TERM) TULSA TECH CENTER
OSAGE,OFFICE NO. 5 (UNEXPIRED TERM) TULSA TECH CENTER,DANNY HANCOCK,,570309,3,0,6,9,OFFICE NO. 5 (UNEXPIRED TERM) TULSA TECH CENTER
OSAGE,OFFICE NO. 3 TULSA PUBLIC SCHOOLS,LANA TURNER,,570310,4,0,14,18,OFFICE NO. 3 TULSA PUBLIC SCHOOLS
OSAGE,OFFICE NO. 3 TULSA PUBLIC SCHOOLS,WHITNEY COLE,,570310,1,0,0,1,OFFICE NO. 3 TULSA PUBLIC SCHOOLS
OSAGE,OFFICE NO. 3 TULSA PUBLIC SCHOOLS,JENNETTIE P. MARSHALL,,570310,0,0,18,18,OFFICE NO. 3 TULSA PUBLIC SCHOOLS
OSAGE,OFFICE NO. 1 TULSA TECH CENTER,RAY A. OWENS,,570310,4,0,65,69,OFFICE NO. 1 TULSA TECH CENTER
OSAGE,OFFICE NO. 1 TULSA TECH CENTER,MELANIE SWEENEY McINTOSH,,570310,6,0,14,20,OFFICE NO. 1 TULSA TECH CENTER
OSAGE,OFFICE NO. 1 TULSA TECH CENTER,KEENAN H. MEADORS,,570310,5,0,22,27,OFFICE NO. 1 TULSA TECH CENTER
OSAGE,OFFICE NO. 3 TULSA PUBLIC SCHOOLS,LANA TURNER,,570311,2,0,0,2,OFFICE NO. 3 TULSA PUBLIC SCHOOLS
OSAGE,OFFICE NO. 3 TULSA PUBLIC SCHOOLS,WHITNEY COLE,,570311,2,0,0,2,OFFICE NO. 3 TULSA PUBLIC SCHOOLS
OSAGE,OFFICE NO. 3 TULSA PUBLIC SCHOOLS,JENNETTIE P. MARSHALL,,570311,0,0,0,0,OFFICE NO. 3 TULSA PUBLIC SCHOOLS
OSAGE,OFFICE NO. 5 (UNEXPIRED TERM) TULSA TECH CENTER,ROY D. McCLAIN,,570311,2,0,0,2,OFFICE NO. 5 (UNEXPIRED TERM) TULSA TECH CENTER
OSAGE,OFFICE NO. 5 (UNEXPIRED TERM) TULSA TECH CENTER,DANNY HANCOCK,,570311,2,0,0,2,OFFICE NO. 5 (UNEXPIRED TERM) TULSA TECH CENTER
OSAGE,OFFICE NO. 5 (UNEXPIRED TERM) TULSA TECH CENTER,ROY D. McCLAIN,,570312,0,0,0,0,OFFICE NO. 5 (UNEXPIRED TERM) TULSA TECH CENTER
OSAGE,OFFICE NO. 5 (UNEXPIRED TERM) TULSA TECH CENTER,DANNY HANCOCK,,570312,2,0,3,5,OFFICE NO. 5 (UNEXPIRED TERM) TULSA TECH CENTER
OTTAWA,OFFICE NO. 2 NORTHEAST TECH CENTER,BILLY F. HENDRICKSON,,580002,0,1,3,4,OFFICE NO. 2 NORTHEAST TECH CENTER
OTTAWA,OFFICE NO. 2 NORTHEAST TECH CENTER,SHERMAN WEAVER,,580002,3,0,3,6,OFFICE NO. 2 NORTHEAST TECH CENTER
OTTAWA,OFFICE NO. 2 NORTHEAST TECH CENTER,BILLY F. HENDRICKSON,,580003,6,0,2,8,OFFICE NO. 2 NORTHEAST TECH CENTER
OTTAWA,OFFICE NO. 2 NORTHEAST TECH CENTER,SHERMAN WEAVER,,580003,2,0,2,4,OFFICE NO. 2 NORTHEAST TECH CENTER
OTTAWA,OFFICE NO. 2 NORTHEAST TECH CENTER,BILLY F. HENDRICKSON,,580004,0,1,4,5,OFFICE NO. 2 NORTHEAST TECH CENTER
OTTAWA,OFFICE NO. 2 NORTHEAST TECH CENTER,SHERMAN WEAVER,,580004,0,0,6,6,OFFICE NO. 2 NORTHEAST TECH CENTER
OTTAWA,OFFICE NO. 2 NORTHEAST TECH CENTER,BILLY F. HENDRICKSON,,580005,3,0,6,9,OFFICE NO. 2 NORTHEAST TECH CENTER
OTTAWA,OFFICE NO. 2 NORTHEAST TECH CENTER,SHERMAN WEAVER,,580005,1,1,5,7,OFFICE NO. 2 NORTHEAST TECH CENTER
OTTAWA,OFFICE NO. 2 NORTHEAST TECH CENTER,BILLY F. HENDRICKSON,,580007,2,0,5,7,OFFICE NO. 2 NORTHEAST TECH CENTER
OTTAWA,OFFICE NO. 2 NORTHEAST TECH CENTER,SHERMAN WEAVER,,580007,0,1,2,3,OFFICE NO. 2 NORTHEAST TECH CENTER
OTTAWA,OFFICE NO. 2 NORTHEAST TECH CENTER,BILLY F. HENDRICKSON,,580008,0,0,4,4,OFFICE NO. 2 NORTHEAST TECH CENTER
OTTAWA,OFFICE NO. 2 NORTHEAST TECH CENTER,SHERMAN WEAVER,,580008,0,0,1,1,OFFICE NO. 2 NORTHEAST TECH CENTER
OTTAWA,OFFICE NO. 2 NORTHEAST TECH CENTER,BILLY F. HENDRICKSON,,580009,1,0,4,5,OFFICE NO. 2 NORTHEAST TECH CENTER
OTTAWA,OFFICE NO. 2 NORTHEAST TECH CENTER,SHERMAN WEAVER,,580009,0,0,3,3,OFFICE NO. 2 NORTHEAST TECH CENTER
OTTAWA,OFFICE NO. 2 NORTHEAST TECH CENTER,BILLY F. HENDRICKSON,,580011,2,0,7,9,OFFICE NO. 2 NORTHEAST TECH CENTER
OTTAWA,OFFICE NO. 2 NORTHEAST TECH CENTER,SHERMAN WEAVER,,580011,4,1,6,11,OFFICE NO. 2 NORTHEAST TECH CENTER
OTTAWA,OFFICE NO. 2 NORTHEAST TECH CENTER,BILLY F. HENDRICKSON,,580012,0,1,4,5,OFFICE NO. 2 NORTHEAST TECH CENTER
OTTAWA,OFFICE NO. 2 NORTHEAST TECH CENTER,SHERMAN WEAVER,,580012,0,1,0,1,OFFICE NO. 2 NORTHEAST TECH CENTER
OTTAWA,OFFICE NO. 2 NORTHEAST TECH CENTER,BILLY F. HENDRICKSON,,580014,0,1,6,7,OFFICE NO. 2 NORTHEAST TECH CENTER
OTTAWA,OFFICE NO. 2 NORTHEAST TECH CENTER,SHERMAN WEAVER,,580014,0,0,3,3,OFFICE NO. 2 NORTHEAST TECH CENTER
OTTAWA,OFFICE NO. 2 NORTHEAST TECH CENTER,BILLY F. HENDRICKSON,,580023,1,1,85,87,OFFICE NO. 2 NORTHEAST TECH CENTER
OTTAWA,OFFICE NO. 2 NORTHEAST TECH CENTER,SHERMAN WEAVER,,580023,0,0,84,84,OFFICE NO. 2 NORTHEAST TECH CENTER
OTTAWA,OFFICE NO. 2 QUAPAW PUBLIC SCHOOLS,PAULA SUMAN,,580023,1,1,114,116,OFFICE NO. 2 QUAPAW PUBLIC SCHOOLS
OTTAWA,OFFICE NO. 2 QUAPAW PUBLIC SCHOOLS,WAYNE MOREY,,580023,0,1,55,56,OFFICE NO. 2 QUAPAW PUBLIC SCHOOLS
OTTAWA,OFFICE NO. 2 NORTHEAST TECH CENTER,BILLY F. HENDRICKSON,,580024,1,0,13,14,OFFICE NO. 2 NORTHEAST TECH CENTER
OTTAWA,OFFICE NO. 2 NORTHEAST TECH CENTER,SHERMAN WEAVER,,580024,0,0,19,19,OFFICE NO. 2 NORTHEAST TECH CENTER
OTTAWA,OFFICE NO. 2 QUAPAW PUBLIC SCHOOLS,PAULA SUMAN,,580024,1,0,15,16,OFFICE NO. 2 QUAPAW PUBLIC SCHOOLS
OTTAWA,OFFICE NO. 2 QUAPAW PUBLIC SCHOOLS,WAYNE MOREY,,580024,0,0,17,17,OFFICE NO. 2 QUAPAW PUBLIC SCHOOLS
OTTAWA,OFFICE NO. 2 NORTHEAST TECH CENTER,BILLY F. HENDRICKSON,,580025,0,0,13,13,OFFICE NO. 2 NORTHEAST TECH CENTER
OTTAWA,OFFICE NO. 2 NORTHEAST TECH CENTER,SHERMAN WEAVER,,580025,0,0,13,13,OFFICE NO. 2 NORTHEAST TECH CENTER
OTTAWA,OFFICE NO. 2 QUAPAW PUBLIC SCHOOLS,PAULA SUMAN,,580025,0,0,5,5,OFFICE NO. 2 QUAPAW PUBLIC SCHOOLS
OTTAWA,OFFICE NO. 2 QUAPAW PUBLIC SCHOOLS,WAYNE MOREY,,580025,0,0,8,8,OFFICE NO. 2 QUAPAW PUBLIC SCHOOLS
OTTAWA,OFFICE NO. 2 NORTHEAST TECH CENTER,BILLY F. HENDRICKSON,,580026,1,0,9,10,OFFICE NO. 2 NORTHEAST TECH CENTER
OTTAWA,OFFICE NO. 2 NORTHEAST TECH CENTER,SHERMAN WEAVER,,580026,0,0,2,2,OFFICE NO. 2 NORTHEAST TECH CENTER
OTTAWA,OFFICE NO. 2 NORTHEAST TECH CENTER,BILLY F. HENDRICKSON,,580028,1,2,9,12,OFFICE NO. 2 NORTHEAST TECH CENTER
OTTAWA,OFFICE NO. 2 NORTHEAST TECH CENTER,SHERMAN WEAVER,,580028,1,0,15,16,OFFICE NO. 2 NORTHEAST TECH CENTER
OTTAWA,OFFICE NO. 2 NORTHEAST TECH CENTER,BILLY F. HENDRICKSON,,580031,0,1,5,6,OFFICE NO. 2 NORTHEAST TECH CENTER
OTTAWA,OFFICE NO. 2 NORTHEAST TECH CENTER,SHERMAN WEAVER,,580031,0,0,4,4,OFFICE NO. 2 NORTHEAST TECH CENTER
OTTAWA,OFFICE NO. 2 NORTHEAST TECH CENTER,BILLY F. HENDRICKSON,,580034,2,1,14,17,OFFICE NO. 2 NORTHEAST TECH CENTER
OTTAWA,OFFICE NO. 2 NORTHEAST TECH CENTER,SHERMAN WEAVER,,580034,0,2,12,14,OFFICE NO. 2 NORTHEAST TECH CENTER
PAWNEE,OFFICE NO. 2 YALE PUBLIC SCHOOLS,BECKI FOSTER,,590104,0,0,2,2,OFFICE NO. 2 YALE PUBLIC SCHOOLS
PAWNEE,OFFICE NO. 2 YALE PUBLIC SCHOOLS,CURTIS MORPHEW,,590104,0,0,8,8,OFFICE NO. 2 YALE PUBLIC SCHOOLS
PAWNEE,OFFICE NO. 2 YALE PUBLIC SCHOOLS,BECKI FOSTER,,590112,0,0,2,2,OFFICE NO. 2 YALE PUBLIC SCHOOLS
PAWNEE,OFFICE NO. 2 YALE PUBLIC SCHOOLS,CURTIS MORPHEW,,590112,0,0,0,0,OFFICE NO. 2 YALE PUBLIC SCHOOLS
PAWNEE,PROPOSITION MORRISON PUBLIC SCHOOLS,FOR THE PROPOSITION - YES,,590202,0,0,4,4,
PAWNEE,PROPOSITION MORRISON PUBLIC SCHOOLS,AGAINST THE PROPOSITION - NO,,590202,0,0,0,0,
PAWNEE,OFFICE NO. 5 (UNEXPIRED TERM) TULSA TECH CENTER,ROY D. McCLAIN,,590307,0,0,0,0,OFFICE NO. 5 (UNEXPIRED TERM) TULSA TECH CENTER
PAWNEE,OFFICE NO. 5 (UNEXPIRED TERM) TULSA TECH CENTER,DANNY HANCOCK,,590307,0,0,0,0,OFFICE NO. 5 (UNEXPIRED TERM) TULSA TECH CENTER
PAYNE,OFFICE NO. 2 STILLWATER PUBLIC SCHOOLS,MARSHALL A. BAKER,,600001,0,0,18,18,OFFICE NO. 2 STILLWATER PUBLIC SCHOOLS
PAYNE,OFFICE NO. 2 STILLWATER PUBLIC SCHOOLS,LAURA ANN CLARK,,600001,1,0,10,11,OFFICE NO. 2 STILLWATER PUBLIC SCHOOLS
PAYNE,OFFICE NO. 2 STILLWATER PUBLIC SCHOOLS,PAM FRIEDEN,,600001,0,0,4,4,OFFICE NO. 2 STILLWATER PUBLIC SCHOOLS
PAYNE,PROPOSITION NO. 1 STILLWATER PUBLIC SCHOOLS,FOR THE PROPOSITION - YES,,600001,0,0,27,27,PROPOSITION NO. 1 STILLWATER PUBLIC SCHOOLS
PAYNE,PROPOSITION NO. 1 STILLWATER PUBLIC SCHOOLS,AGAINST THE PROPOSITION - NO,,600001,1,0,9,10,PROPOSITION NO. 1 STILLWATER PUBLIC SCHOOLS
PAYNE,PROPOSITION NO. 2 STILLWATER PUBLIC SCHOOLS,FOR THE PROPOSITION - YES,,600001,0,0,26,26,PROPOSITION NO. 2 STILLWATER PUBLIC SCHOOLS
PAYNE,PROPOSITION NO. 2 STILLWATER PUBLIC SCHOOLS,AGAINST THE PROPOSITION - NO,,600001,1,0,10,11,PROPOSITION NO. 2 STILLWATER PUBLIC SCHOOLS
PAYNE,OFFICE NO. 2 STILLWATER PUBLIC SCHOOLS,MARSHALL A. BAKER,,600002,0,3,40,43,OFFICE NO. 2 STILLWATER PUBLIC SCHOOLS
PAYNE,OFFICE NO. 2 STILLWATER PUBLIC SCHOOLS,LAURA ANN CLARK,,600002,2,1,38,41,OFFICE NO. 2 STILLWATER PUBLIC SCHOOLS
PAYNE,OFFICE NO. 2 STILLWATER PUBLIC SCHOOLS,PAM FRIEDEN,,600002,1,2,41,44,OFFICE NO. 2 STILLWATER PUBLIC SCHOOLS
PAYNE,PROPOSITION NO. 1 STILLWATER PUBLIC SCHOOLS,FOR THE PROPOSITION - YES,,600002,1,2,82,85,PROPOSITION NO. 1 STILLWATER PUBLIC SCHOOLS
PAYNE,PROPOSITION NO. 1 STILLWATER PUBLIC SCHOOLS,AGAINST THE PROPOSITION - NO,,600002,2,4,42,48,PROPOSITION NO. 1 STILLWATER PUBLIC SCHOOLS
PAYNE,PROPOSITION NO. 2 STILLWATER PUBLIC SCHOOLS,FOR THE PROPOSITION - YES,,600002,1,2,81,84,PROPOSITION NO. 2 STILLWATER PUBLIC SCHOOLS
PAYNE,PROPOSITION NO. 2 STILLWATER PUBLIC SCHOOLS,AGAINST THE PROPOSITION - NO,,600002,2,4,42,48,PROPOSITION NO. 2 STILLWATER PUBLIC SCHOOLS
PAYNE,OFFICE NO. 2 STILLWATER PUBLIC SCHOOLS,MARSHALL A. BAKER,,600003,1,6,21,28,OFFICE NO. 2 STILLWATER PUBLIC SCHOOLS
PAYNE,OFFICE NO. 2 STILLWATER PUBLIC SCHOOLS,LAURA ANN CLARK,,600003,0,1,18,19,OFFICE NO. 2 STILLWATER PUBLIC SCHOOLS
PAYNE,OFFICE NO. 2 STILLWATER PUBLIC SCHOOLS,PAM FRIEDEN,,600003,0,1,11,12,OFFICE NO. 2 STILLWATER PUBLIC SCHOOLS
PAYNE,PROPOSITION NO. 1 STILLWATER PUBLIC SCHOOLS,FOR THE PROPOSITION - YES,,600003,0,5,34,39,PROPOSITION NO. 1 STILLWATER PUBLIC SCHOOLS
PAYNE,PROPOSITION NO. 1 STILLWATER PUBLIC SCHOOLS,AGAINST THE PROPOSITION - NO,,600003,1,3,20,24,PROPOSITION NO. 1 STILLWATER PUBLIC SCHOOLS
PAYNE,PROPOSITION NO. 2 STILLWATER PUBLIC SCHOOLS,FOR THE PROPOSITION - YES,,600003,0,6,35,41,PROPOSITION NO. 2 STILLWATER PUBLIC SCHOOLS
PAYNE,PROPOSITION NO. 2 STILLWATER PUBLIC SCHOOLS,AGAINST THE PROPOSITION - NO,,600003,1,2,19,22,PROPOSITION NO. 2 STILLWATER PUBLIC SCHOOLS
PAYNE,OFFICE NO. 2 STILLWATER PUBLIC SCHOOLS,MARSHALL A. BAKER,,600004,0,16,157,173,OFFICE NO. 2 STILLWATER PUBLIC SCHOOLS
PAYNE,OFFICE NO. 2 STILLWATER PUBLIC SCHOOLS,LAURA ANN CLARK,,600004,0,6,86,92,OFFICE NO. 2 STILLWATER PUBLIC SCHOOLS
PAYNE,OFFICE NO. 2 STILLWATER PUBLIC SCHOOLS,PAM FRIEDEN,,600004,1,6,31,38,OFFICE NO. 2 STILLWATER PUBLIC SCHOOLS
PAYNE,PROPOSITION NO. 1 STILLWATER PUBLIC SCHOOLS,FOR THE PROPOSITION - YES,,600004,0,28,213,241,PROPOSITION NO. 1 STILLWATER PUBLIC SCHOOLS
PAYNE,PROPOSITION NO. 1 STILLWATER PUBLIC SCHOOLS,AGAINST THE PROPOSITION - NO,,600004,1,4,66,71,PROPOSITION NO. 1 STILLWATER PUBLIC SCHOOLS
PAYNE,PROPOSITION NO. 2 STILLWATER PUBLIC SCHOOLS,FOR THE PROPOSITION - YES,,600004,0,28,212,240,PROPOSITION NO. 2 STILLWATER PUBLIC SCHOOLS
PAYNE,PROPOSITION NO. 2 STILLWATER PUBLIC SCHOOLS,AGAINST THE PROPOSITION - NO,,600004,1,4,68,73,PROPOSITION NO. 2 STILLWATER PUBLIC SCHOOLS
PAYNE,OFFICE NO. 2 STILLWATER PUBLIC SCHOOLS,MARSHALL A. BAKER,,600005,0,3,32,35,OFFICE NO. 2 STILLWATER PUBLIC SCHOOLS
PAYNE,OFFICE NO. 2 STILLWATER PUBLIC SCHOOLS,LAURA ANN CLARK,,600005,0,2,16,18,OFFICE NO. 2 STILLWATER PUBLIC SCHOOLS
PAYNE,OFFICE NO. 2 STILLWATER PUBLIC SCHOOLS,PAM FRIEDEN,,600005,0,0,4,4,OFFICE NO. 2 STILLWATER PUBLIC SCHOOLS
PAYNE,PROPOSITION NO. 1 STILLWATER PUBLIC SCHOOLS,FOR THE PROPOSITION - YES,,600005,0,5,31,36,PROPOSITION NO. 1 STILLWATER PUBLIC SCHOOLS
PAYNE,PROPOSITION NO. 1 STILLWATER PUBLIC SCHOOLS,AGAINST THE PROPOSITION - NO,,600005,0,0,24,24,PROPOSITION NO. 1 STILLWATER PUBLIC SCHOOLS
PAYNE,PROPOSITION NO. 2 STILLWATER PUBLIC SCHOOLS,FOR THE PROPOSITION - YES,,600005,0,3,38,41,PROPOSITION NO. 2 STILLWATER PUBLIC SCHOOLS
PAYNE,PROPOSITION NO. 2 STILLWATER PUBLIC SCHOOLS,AGAINST THE PROPOSITION - NO,,600005,0,2,17,19,PROPOSITION NO. 2 STILLWATER PUBLIC SCHOOLS
PAYNE,OFFICE NO. 2 STILLWATER PUBLIC SCHOOLS,MARSHALL A. BAKER,,600006,4,22,132,158,OFFICE NO. 2 STILLWATER PUBLIC SCHOOLS
PAYNE,OFFICE NO. 2 STILLWATER PUBLIC SCHOOLS,LAURA ANN CLARK,,600006,0,4,74,78,OFFICE NO. 2 STILLWATER PUBLIC SCHOOLS
PAYNE,OFFICE NO. 2 STILLWATER PUBLIC SCHOOLS,PAM FRIEDEN,,600006,1,1,31,33,OFFICE NO. 2 STILLWATER PUBLIC SCHOOLS
PAYNE,PROPOSITION NO. 1 STILLWATER PUBLIC SCHOOLS,FOR THE PROPOSITION - YES,,600006,3,23,193,219,PROPOSITION NO. 1 STILLWATER PUBLIC SCHOOLS
PAYNE,PROPOSITION NO. 1 STILLWATER PUBLIC SCHOOLS,AGAINST THE PROPOSITION - NO,,600006,2,4,47,53,PROPOSITION NO. 1 STILLWATER PUBLIC SCHOOLS
PAYNE,PROPOSITION NO. 2 STILLWATER PUBLIC SCHOOLS,FOR THE PROPOSITION - YES,,600006,3,23,191,217,PROPOSITION NO. 2 STILLWATER PUBLIC SCHOOLS
PAYNE,PROPOSITION NO. 2 STILLWATER PUBLIC SCHOOLS,AGAINST THE PROPOSITION - NO,,600006,2,4,49,55,PROPOSITION NO. 2 STILLWATER PUBLIC SCHOOLS
PAYNE,OFFICE NO. 2 STILLWATER PUBLIC SCHOOLS,MARSHALL A. BAKER,,600007,1,1,13,15,OFFICE NO. 2 STILLWATER PUBLIC SCHOOLS
PAYNE,OFFICE NO. 2 STILLWATER PUBLIC SCHOOLS,LAURA ANN CLARK,,600007,0,1,7,8,OFFICE NO. 2 STILLWATER PUBLIC SCHOOLS
PAYNE,OFFICE NO. 2 STILLWATER PUBLIC SCHOOLS,PAM FRIEDEN,,600007,1,0,4,5,OFFICE NO. 2 STILLWATER PUBLIC SCHOOLS
PAYNE,PROPOSITION NO. 1 STILLWATER PUBLIC SCHOOLS,FOR THE PROPOSITION - YES,,600007,2,2,19,23,PROPOSITION NO. 1 STILLWATER PUBLIC SCHOOLS
PAYNE,PROPOSITION NO. 1 STILLWATER PUBLIC SCHOOLS,AGAINST THE PROPOSITION - NO,,600007,0,0,6,6,PROPOSITION NO. 1 STILLWATER PUBLIC SCHOOLS
PAYNE,PROPOSITION NO. 2 STILLWATER PUBLIC SCHOOLS,FOR THE PROPOSITION - YES,,600007,2,2,19,23,PROPOSITION NO. 2 STILLWATER PUBLIC SCHOOLS
PAYNE,PROPOSITION NO. 2 STILLWATER PUBLIC SCHOOLS,AGAINST THE PROPOSITION - NO,,600007,0,0,6,6,PROPOSITION NO. 2 STILLWATER PUBLIC SCHOOLS
PAYNE,OFFICE NO. 2 STILLWATER PUBLIC SCHOOLS,MARSHALL A. BAKER,,600008,0,5,86,91,OFFICE NO. 2 STILLWATER PUBLIC SCHOOLS
PAYNE,OFFICE NO. 2 STILLWATER PUBLIC SCHOOLS,LAURA ANN CLARK,,600008,0,1,37,38,OFFICE NO. 2 STILLWATER PUBLIC SCHOOLS
PAYNE,OFFICE NO. 2 STILLWATER PUBLIC SCHOOLS,PAM FRIEDEN,,600008,1,0,19,20,OFFICE NO. 2 STILLWATER PUBLIC SCHOOLS
PAYNE,PROPOSITION NO. 1 STILLWATER PUBLIC SCHOOLS,FOR THE PROPOSITION - YES,,600008,1,7,120,128,PROPOSITION NO. 1 STILLWATER PUBLIC SCHOOLS
PAYNE,PROPOSITION NO. 1 STILLWATER PUBLIC SCHOOLS,AGAINST THE PROPOSITION - NO,,600008,0,1,30,31,PROPOSITION NO. 1 STILLWATER PUBLIC SCHOOLS
PAYNE,PROPOSITION NO. 2 STILLWATER PUBLIC SCHOOLS,FOR THE PROPOSITION - YES,,600008,1,8,119,128,PROPOSITION NO. 2 STILLWATER PUBLIC SCHOOLS
PAYNE,PROPOSITION NO. 2 STILLWATER PUBLIC SCHOOLS,AGAINST THE PROPOSITION - NO,,600008,0,0,29,29,PROPOSITION NO. 2 STILLWATER PUBLIC SCHOOLS
PAYNE,OFFICE NO. 2 STILLWATER PUBLIC SCHOOLS,MARSHALL A. BAKER,,600009,1,19,263,283,OFFICE NO. 2 STILLWATER PUBLIC SCHOOLS
PAYNE,OFFICE NO. 2 STILLWATER PUBLIC SCHOOLS,LAURA ANN CLARK,,600009,0,6,122,128,OFFICE NO. 2 STILLWATER PUBLIC SCHOOLS
PAYNE,OFFICE NO. 2 STILLWATER PUBLIC SCHOOLS,PAM FRIEDEN,,600009,0,2,25,27,OFFICE NO. 2 STILLWATER PUBLIC SCHOOLS
PAYNE,PROPOSITION NO. 1 STILLWATER PUBLIC SCHOOLS,FOR THE PROPOSITION - YES,,600009,1,24,340,365,PROPOSITION NO. 1 STILLWATER PUBLIC SCHOOLS
PAYNE,PROPOSITION NO. 1 STILLWATER PUBLIC SCHOOLS,AGAINST THE PROPOSITION - NO,,600009,1,3,84,88,PROPOSITION NO. 1 STILLWATER PUBLIC SCHOOLS
PAYNE,PROPOSITION NO. 2 STILLWATER PUBLIC SCHOOLS,FOR THE PROPOSITION - YES,,600009,1,25,343,369,PROPOSITION NO. 2 STILLWATER PUBLIC SCHOOLS
PAYNE,PROPOSITION NO. 2 STILLWATER PUBLIC SCHOOLS,AGAINST THE PROPOSITION - NO,,600009,1,2,81,84,PROPOSITION NO. 2 STILLWATER PUBLIC SCHOOLS
PAYNE,OFFICE NO. 2 STILLWATER PUBLIC SCHOOLS,MARSHALL A. BAKER,,600010,0,7,59,66,OFFICE NO. 2 STILLWATER PUBLIC SCHOOLS
PAYNE,OFFICE NO. 2 STILLWATER PUBLIC SCHOOLS,LAURA ANN CLARK,,600010,1,0,36,37,OFFICE NO. 2 STILLWATER PUBLIC SCHOOLS
PAYNE,OFFICE NO. 2 STILLWATER PUBLIC SCHOOLS,PAM FRIEDEN,,600010,0,3,9,12,OFFICE NO. 2 STILLWATER PUBLIC SCHOOLS
PAYNE,PROPOSITION NO. 1 STILLWATER PUBLIC SCHOOLS,FOR THE PROPOSITION - YES,,600010,1,8,74,83,PROPOSITION NO. 1 STILLWATER PUBLIC SCHOOLS
PAYNE,PROPOSITION NO. 1 STILLWATER PUBLIC SCHOOLS,AGAINST THE PROPOSITION - NO,,600010,0,2,29,31,PROPOSITION NO. 1 STILLWATER PUBLIC SCHOOLS
PAYNE,PROPOSITION NO. 2 STILLWATER PUBLIC SCHOOLS,FOR THE PROPOSITION - YES,,600010,1,9,79,89,PROPOSITION NO. 2 STILLWATER PUBLIC SCHOOLS
PAYNE,PROPOSITION NO. 2 STILLWATER PUBLIC SCHOOLS,AGAINST THE PROPOSITION - NO,,600010,0,1,24,25,PROPOSITION NO. 2 STILLWATER PUBLIC SCHOOLS
PAYNE,OFFICE NO. 2 STILLWATER PUBLIC SCHOOLS,MARSHALL A. BAKER,,600011,4,7,59,70,OFFICE NO. 2 STILLWATER PUBLIC SCHOOLS
PAYNE,OFFICE NO. 2 STILLWATER PUBLIC SCHOOLS,LAURA ANN CLARK,,600011,0,2,19,21,OFFICE NO. 2 STILLWATER PUBLIC SCHOOLS
PAYNE,OFFICE NO. 2 STILLWATER PUBLIC SCHOOLS,PAM FRIEDEN,,600011,0,1,3,4,OFFICE NO. 2 STILLWATER PUBLIC SCHOOLS
PAYNE,PROPOSITION NO. 1 STILLWATER PUBLIC SCHOOLS,FOR THE PROPOSITION - YES,,600011,4,9,74,87,PROPOSITION NO. 1 STILLWATER PUBLIC SCHOOLS
PAYNE,PROPOSITION NO. 1 STILLWATER PUBLIC SCHOOLS,AGAINST THE PROPOSITION - NO,,600011,0,2,10,12,PROPOSITION NO. 1 STILLWATER PUBLIC SCHOOLS
PAYNE,PROPOSITION NO. 2 STILLWATER PUBLIC SCHOOLS,FOR THE PROPOSITION - YES,,600011,4,10,75,89,PROPOSITION NO. 2 STILLWATER PUBLIC SCHOOLS
PAYNE,PROPOSITION NO. 2 STILLWATER PUBLIC SCHOOLS,AGAINST THE PROPOSITION - NO,,600011,0,1,9,10,PROPOSITION NO. 2 STILLWATER PUBLIC SCHOOLS
PAYNE,OFFICE NO. 2 STILLWATER PUBLIC SCHOOLS,MARSHALL A. BAKER,,600012,0,7,32,39,OFFICE NO. 2 STILLWATER PUBLIC SCHOOLS
PAYNE,OFFICE NO. 2 STILLWATER PUBLIC SCHOOLS,LAURA ANN CLARK,,600012,0,0,11,11,OFFICE NO. 2 STILLWATER PUBLIC SCHOOLS
PAYNE,OFFICE NO. 2 STILLWATER PUBLIC SCHOOLS,PAM FRIEDEN,,600012,1,2,3,6,OFFICE NO. 2 STILLWATER PUBLIC SCHOOLS
PAYNE,PROPOSITION NO. 1 STILLWATER PUBLIC SCHOOLS,FOR THE PROPOSITION - YES,,600012,1,6,45,52,PROPOSITION NO. 1 STILLWATER PUBLIC SCHOOLS
PAYNE,PROPOSITION NO. 1 STILLWATER PUBLIC SCHOOLS,AGAINST THE PROPOSITION - NO,,600012,0,3,4,7,PROPOSITION NO. 1 STILLWATER PUBLIC SCHOOLS
PAYNE,PROPOSITION NO. 2 STILLWATER PUBLIC SCHOOLS,FOR THE PROPOSITION - YES,,600012,1,6,44,51,PROPOSITION NO. 2 STILLWATER PUBLIC SCHOOLS
PAYNE,PROPOSITION NO. 2 STILLWATER PUBLIC SCHOOLS,AGAINST THE PROPOSITION - NO,,600012,0,2,5,7,PROPOSITION NO. 2 STILLWATER PUBLIC SCHOOLS
PAYNE,OFFICE NO. 2 STILLWATER PUBLIC SCHOOLS,MARSHALL A. BAKER,,600013,2,17,140,159,OFFICE NO. 2 STILLWATER PUBLIC SCHOOLS
PAYNE,OFFICE NO. 2 STILLWATER PUBLIC SCHOOLS,LAURA ANN CLARK,,600013,3,8,72,83,OFFICE NO. 2 STILLWATER PUBLIC SCHOOLS
PAYNE,OFFICE NO. 2 STILLWATER PUBLIC SCHOOLS,PAM FRIEDEN,,600013,0,4,53,57,OFFICE NO. 2 STILLWATER PUBLIC SCHOOLS
PAYNE,PROPOSITION NO. 1 STILLWATER PUBLIC SCHOOLS,FOR THE PROPOSITION - YES,,600013,4,17,204,225,PROPOSITION NO. 1 STILLWATER PUBLIC SCHOOLS
PAYNE,PROPOSITION NO. 1 STILLWATER PUBLIC SCHOOLS,AGAINST THE PROPOSITION - NO,,600013,1,15,70,86,PROPOSITION NO. 1 STILLWATER PUBLIC SCHOOLS
PAYNE,PROPOSITION NO. 2 STILLWATER PUBLIC SCHOOLS,FOR THE PROPOSITION - YES,,600013,3,19,198,220,PROPOSITION NO. 2 STILLWATER PUBLIC SCHOOLS
PAYNE,PROPOSITION NO. 2 STILLWATER PUBLIC SCHOOLS,AGAINST THE PROPOSITION - NO,,600013,2,13,77,92,PROPOSITION NO. 2 STILLWATER PUBLIC SCHOOLS
PAYNE,OFFICE NO. 2 STILLWATER PUBLIC SCHOOLS,MARSHALL A. BAKER,,600014,0,0,2,2,OFFICE NO. 2 STILLWATER PUBLIC SCHOOLS
PAYNE,OFFICE NO. 2 STILLWATER PUBLIC SCHOOLS,LAURA ANN CLARK,,600014,0,0,1,1,OFFICE NO. 2 STILLWATER PUBLIC SCHOOLS
PAYNE,OFFICE NO. 2 STILLWATER PUBLIC SCHOOLS,PAM FRIEDEN,,600014,0,0,0,0,OFFICE NO. 2 STILLWATER PUBLIC SCHOOLS
PAYNE,PROPOSITION NO. 1 STILLWATER PUBLIC SCHOOLS,FOR THE PROPOSITION - YES,,600014,0,0,3,3,PROPOSITION NO. 1 STILLWATER PUBLIC SCHOOLS
PAYNE,PROPOSITION NO. 1 STILLWATER PUBLIC SCHOOLS,AGAINST THE PROPOSITION - NO,,600014,0,0,0,0,PROPOSITION NO. 1 STILLWATER PUBLIC SCHOOLS
PAYNE,PROPOSITION NO. 2 STILLWATER PUBLIC SCHOOLS,FOR THE PROPOSITION - YES,,600014,0,0,3,3,PROPOSITION NO. 2 STILLWATER PUBLIC SCHOOLS
PAYNE,PROPOSITION NO. 2 STILLWATER PUBLIC SCHOOLS,AGAINST THE PROPOSITION - NO,,600014,0,0,0,0,PROPOSITION NO. 2 STILLWATER PUBLIC SCHOOLS
PAYNE,OFFICE NO. 2 STILLWATER PUBLIC SCHOOLS,MARSHALL A. BAKER,,600015,1,8,85,94,OFFICE NO. 2 STILLWATER PUBLIC SCHOOLS
PAYNE,OFFICE NO. 2 STILLWATER PUBLIC SCHOOLS,LAURA ANN CLARK,,600015,0,2,51,53,OFFICE NO. 2 STILLWATER PUBLIC SCHOOLS
PAYNE,OFFICE NO. 2 STILLWATER PUBLIC SCHOOLS,PAM FRIEDEN,,600015,2,5,20,27,OFFICE NO. 2 STILLWATER PUBLIC SCHOOLS
PAYNE,PROPOSITION NO. 1 STILLWATER PUBLIC SCHOOLS,FOR THE PROPOSITION - YES,,600015,2,11,122,135,PROPOSITION NO. 1 STILLWATER PUBLIC SCHOOLS
PAYNE,PROPOSITION NO. 1 STILLWATER PUBLIC SCHOOLS,AGAINST THE PROPOSITION - NO,,600015,1,4,40,45,PROPOSITION NO. 1 STILLWATER PUBLIC SCHOOLS
PAYNE,PROPOSITION NO. 2 STILLWATER PUBLIC SCHOOLS,FOR THE PROPOSITION - YES,,600015,2,13,121,136,PROPOSITION NO. 2 STILLWATER PUBLIC SCHOOLS
PAYNE,PROPOSITION NO. 2 STILLWATER PUBLIC SCHOOLS,AGAINST THE PROPOSITION - NO,,600015,1,2,41,44,PROPOSITION NO. 2 STILLWATER PUBLIC SCHOOLS
PAYNE,OFFICE NO. 2 STILLWATER PUBLIC SCHOOLS,MARSHALL A. BAKER,,600016,17,57,369,443,OFFICE NO. 2 STILLWATER PUBLIC SCHOOLS
PAYNE,OFFICE NO. 2 STILLWATER PUBLIC SCHOOLS,LAURA ANN CLARK,,600016,11,28,161,200,OFFICE NO. 2 STILLWATER PUBLIC SCHOOLS
PAYNE,OFFICE NO. 2 STILLWATER PUBLIC SCHOOLS,PAM FRIEDEN,,600016,3,15,45,63,OFFICE NO. 2 STILLWATER PUBLIC SCHOOLS
PAYNE,PROPOSITION NO. 1 STILLWATER PUBLIC SCHOOLS,FOR THE PROPOSITION - YES,,600016,30,91,510,631,PROPOSITION NO. 1 STILLWATER PUBLIC SCHOOLS
PAYNE,PROPOSITION NO. 1 STILLWATER PUBLIC SCHOOLS,AGAINST THE PROPOSITION - NO,,600016,3,10,83,96,PROPOSITION NO. 1 STILLWATER PUBLIC SCHOOLS
PAYNE,PROPOSITION NO. 2 STILLWATER PUBLIC SCHOOLS,FOR THE PROPOSITION - YES,,600016,31,94,503,628,PROPOSITION NO. 2 STILLWATER PUBLIC SCHOOLS
PAYNE,PROPOSITION NO. 2 STILLWATER PUBLIC SCHOOLS,AGAINST THE PROPOSITION - NO,,600016,2,8,88,98,PROPOSITION NO. 2 STILLWATER PUBLIC SCHOOLS
PAYNE,COMMISSIONER OF WARD 3 CITY OF DRUMRIGHT,JUDY BURRIS,,600104,0,0,0,0,COMMISSIONER OF WARD 3 CITY OF DRUMRIGHT
PAYNE,COMMISSIONER OF WARD 3 CITY OF DRUMRIGHT,RICK CREEKMORE,,600104,0,0,0,0,COMMISSIONER OF WARD 3 CITY OF DRUMRIGHT
PAYNE,COMMISSIONER AT LARGE CITY OF DRUMRIGHT,JEREMY SNOW,,600104,0,0,0,0,
PAYNE,COMMISSIONER AT LARGE CITY OF DRUMRIGHT,WILLIAM SCRIBNER,,600104,0,0,0,0,
PAYNE,OFFICE NO. 2 YALE PUBLIC SCHOOLS,BECKI FOSTER,,600104,0,0,0,0,OFFICE NO. 2 YALE PUBLIC SCHOOLS
PAYNE,OFFICE NO. 2 YALE PUBLIC SCHOOLS,CURTIS MORPHEW,,600104,0,0,0,0,OFFICE NO. 2 YALE PUBLIC SCHOOLS
PAYNE,OFFICE NO. 2 YALE PUBLIC SCHOOLS,BECKI FOSTER,,600201,4,2,92,98,OFFICE NO. 2 YALE PUBLIC SCHOOLS
PAYNE,OFFICE NO. 2 YALE PUBLIC SCHOOLS,CURTIS MORPHEW,,600201,4,0,111,115,OFFICE NO. 2 YALE PUBLIC SCHOOLS
PAYNE,OFFICE NO. 2 COYLE PUBLIC SCHOOLS,CHAD MAKER,,600401,0,0,0,0,OFFICE NO. 2 COYLE PUBLIC SCHOOLS
PAYNE,OFFICE NO. 2 COYLE PUBLIC SCHOOLS,LEIGH BENTON,,600401,0,0,0,0,OFFICE NO. 2 COYLE PUBLIC SCHOOLS
PAYNE,OFFICE NO. 2 STILLWATER PUBLIC SCHOOLS,MARSHALL A. BAKER,,600401,5,38,260,303,OFFICE NO. 2 STILLWATER PUBLIC SCHOOLS
PAYNE,OFFICE NO. 2 STILLWATER PUBLIC SCHOOLS,LAURA ANN CLARK,,600401,1,21,148,170,OFFICE NO. 2 STILLWATER PUBLIC SCHOOLS
PAYNE,OFFICE NO. 2 STILLWATER PUBLIC SCHOOLS,PAM FRIEDEN,,600401,1,3,32,36,OFFICE NO. 2 STILLWATER PUBLIC SCHOOLS
PAYNE,PROPOSITION NO. 1 STILLWATER PUBLIC SCHOOLS,FOR THE PROPOSITION - YES,,600401,4,58,379,441,PROPOSITION NO. 1 STILLWATER PUBLIC SCHOOLS
PAYNE,PROPOSITION NO. 1 STILLWATER PUBLIC SCHOOLS,AGAINST THE PROPOSITION - NO,,600401,4,6,72,82,PROPOSITION NO. 1 STILLWATER PUBLIC SCHOOLS
PAYNE,PROPOSITION NO. 2 STILLWATER PUBLIC SCHOOLS,FOR THE PROPOSITION - YES,,600401,4,58,382,444,PROPOSITION NO. 2 STILLWATER PUBLIC SCHOOLS
PAYNE,PROPOSITION NO. 2 STILLWATER PUBLIC SCHOOLS,AGAINST THE PROPOSITION - NO,,600401,4,6,68,78,PROPOSITION NO. 2 STILLWATER PUBLIC SCHOOLS
PAYNE,OFFICE NO. 2 STILLWATER PUBLIC SCHOOLS,MARSHALL A. BAKER,,600402,3,12,97,112,OFFICE NO. 2 STILLWATER PUBLIC SCHOOLS
PAYNE,OFFICE NO. 2 STILLWATER PUBLIC SCHOOLS,LAURA ANN CLARK,,600402,0,2,42,44,OFFICE NO. 2 STILLWATER PUBLIC SCHOOLS
PAYNE,OFFICE NO. 2 STILLWATER PUBLIC SCHOOLS,PAM FRIEDEN,,600402,0,0,11,11,OFFICE NO. 2 STILLWATER PUBLIC SCHOOLS
PAYNE,PROPOSITION NO. 1 STILLWATER PUBLIC SCHOOLS,FOR THE PROPOSITION - YES,,600402,3,10,124,137,PROPOSITION NO. 1 STILLWATER PUBLIC SCHOOLS
PAYNE,PROPOSITION NO. 1 STILLWATER PUBLIC SCHOOLS,AGAINST THE PROPOSITION - NO,,600402,0,5,33,38,PROPOSITION NO. 1 STILLWATER PUBLIC SCHOOLS
PAYNE,PROPOSITION NO. 2 STILLWATER PUBLIC SCHOOLS,FOR THE PROPOSITION - YES,,600402,2,9,127,138,PROPOSITION NO. 2 STILLWATER PUBLIC SCHOOLS
PAYNE,PROPOSITION NO. 2 STILLWATER PUBLIC SCHOOLS,AGAINST THE PROPOSITION - NO,,600402,1,6,30,37,PROPOSITION NO. 2 STILLWATER PUBLIC SCHOOLS
PAYNE,PROPOSITION MORRISON PUBLIC SCHOOLS,FOR THE PROPOSITION - YES,,600403,0,0,11,11,
PAYNE,PROPOSITION MORRISON PUBLIC SCHOOLS,AGAINST THE PROPOSITION - NO,,600403,0,2,3,5,
PAYNE,OFFICE NO. 2 STILLWATER PUBLIC SCHOOLS,MARSHALL A. BAKER,,600403,0,10,65,75,OFFICE NO. 2 STILLWATER PUBLIC SCHOOLS
PAYNE,OFFICE NO. 2 STILLWATER PUBLIC SCHOOLS,LAURA ANN CLARK,,600403,0,6,25,31,OFFICE NO. 2 STILLWATER PUBLIC SCHOOLS
PAYNE,OFFICE NO. 2 STILLWATER PUBLIC SCHOOLS,PAM FRIEDEN,,600403,0,2,13,15,OFFICE NO. 2 STILLWATER PUBLIC SCHOOLS
PAYNE,PROPOSITION NO. 1 STILLWATER PUBLIC SCHOOLS,FOR THE PROPOSITION - YES,,600403,0,15,79,94,PROPOSITION NO. 1 STILLWATER PUBLIC SCHOOLS
PAYNE,PROPOSITION NO. 1 STILLWATER PUBLIC SCHOOLS,AGAINST THE PROPOSITION - NO,,600403,0,3,26,29,PROPOSITION NO. 1 STILLWATER PUBLIC SCHOOLS
PAYNE,PROPOSITION NO. 2 STILLWATER PUBLIC SCHOOLS,FOR THE PROPOSITION - YES,,600403,0,16,83,99,PROPOSITION NO. 2 STILLWATER PUBLIC SCHOOLS
PAYNE,PROPOSITION NO. 2 STILLWATER PUBLIC SCHOOLS,AGAINST THE PROPOSITION - NO,,600403,0,2,22,24,PROPOSITION NO. 2 STILLWATER PUBLIC SCHOOLS
PAYNE,PROPOSITION MORRISON PUBLIC SCHOOLS,FOR THE PROPOSITION - YES,,600404,0,0,0,0,
PAYNE,PROPOSITION MORRISON PUBLIC SCHOOLS,AGAINST THE PROPOSITION - NO,,600404,0,0,0,0,
PAYNE,OFFICE NO. 2 STILLWATER PUBLIC SCHOOLS,MARSHALL A. BAKER,,600404,2,0,6,8,OFFICE NO. 2 STILLWATER PUBLIC SCHOOLS
PAYNE,OFFICE NO. 2 STILLWATER PUBLIC SCHOOLS,LAURA ANN CLARK,,600404,0,1,8,9,OFFICE NO. 2 STILLWATER PUBLIC SCHOOLS
PAYNE,OFFICE NO. 2 STILLWATER PUBLIC SCHOOLS,PAM FRIEDEN,,600404,0,1,1,2,OFFICE NO. 2 STILLWATER PUBLIC SCHOOLS
PAYNE,PROPOSITION NO. 1 STILLWATER PUBLIC SCHOOLS,FOR THE PROPOSITION - YES,,600404,1,3,7,11,PROPOSITION NO. 1 STILLWATER PUBLIC SCHOOLS
PAYNE,PROPOSITION NO. 1 STILLWATER PUBLIC SCHOOLS,AGAINST THE PROPOSITION - NO,,600404,1,0,7,8,PROPOSITION NO. 1 STILLWATER PUBLIC SCHOOLS
PAYNE,PROPOSITION NO. 2 STILLWATER PUBLIC SCHOOLS,FOR THE PROPOSITION - YES,,600404,1,3,6,10,PROPOSITION NO. 2 STILLWATER PUBLIC SCHOOLS
PAYNE,PROPOSITION NO. 2 STILLWATER PUBLIC SCHOOLS,AGAINST THE PROPOSITION - NO,,600404,1,0,8,9,PROPOSITION NO. 2 STILLWATER PUBLIC SCHOOLS
PAYNE,OFFICE NO. 2 COYLE PUBLIC SCHOOLS,CHAD MAKER,,600405,0,2,3,5,OFFICE NO. 2 COYLE PUBLIC SCHOOLS
PAYNE,OFFICE NO. 2 COYLE PUBLIC SCHOOLS,LEIGH BENTON,,600405,0,0,0,0,OFFICE NO. 2 COYLE PUBLIC SCHOOLS
PAYNE,PROPOSITION MORRISON PUBLIC SCHOOLS,FOR THE PROPOSITION - YES,,600406,0,0,2,2,
PAYNE,PROPOSITION MORRISON PUBLIC SCHOOLS,AGAINST THE PROPOSITION - NO,,600406,0,0,0,0,
PAYNE,OFFICE NO. 2 STILLWATER PUBLIC SCHOOLS,MARSHALL A. BAKER,,600406,0,0,0,0,OFFICE NO. 2 STILLWATER PUBLIC SCHOOLS
PAYNE,OFFICE NO. 2 STILLWATER PUBLIC SCHOOLS,LAURA ANN CLARK,,600406,0,0,0,0,OFFICE NO. 2 STILLWATER PUBLIC SCHOOLS
PAYNE,OFFICE NO. 2 STILLWATER PUBLIC SCHOOLS,PAM FRIEDEN,,600406,0,0,0,0,OFFICE NO. 2 STILLWATER PUBLIC SCHOOLS
PAYNE,PROPOSITION NO. 1 STILLWATER PUBLIC SCHOOLS,FOR THE PROPOSITION - YES,,600406,0,0,0,0,PROPOSITION NO. 1 STILLWATER PUBLIC SCHOOLS
PAYNE,PROPOSITION NO. 1 STILLWATER PUBLIC SCHOOLS,AGAINST THE PROPOSITION - NO,,600406,0,0,0,0,PROPOSITION NO. 1 STILLWATER PUBLIC SCHOOLS
PAYNE,PROPOSITION NO. 2 STILLWATER PUBLIC SCHOOLS,FOR THE PROPOSITION - YES,,600406,0,0,0,0,PROPOSITION NO. 2 STILLWATER PUBLIC SCHOOLS
PAYNE,PROPOSITION NO. 2 STILLWATER PUBLIC SCHOOLS,AGAINST THE PROPOSITION - NO,,600406,0,0,0,0,PROPOSITION NO. 2 STILLWATER PUBLIC SCHOOLS
PAYNE,OFFICE NO. 2 YALE PUBLIC SCHOOLS,BECKI FOSTER,,600406,0,0,0,0,OFFICE NO. 2 YALE PUBLIC SCHOOLS
PAYNE,OFFICE NO. 2 YALE PUBLIC SCHOOLS,CURTIS MORPHEW,,600406,0,0,0,0,OFFICE NO. 2 YALE PUBLIC SCHOOLS
PAYNE,OFFICE NO. 2 STILLWATER PUBLIC SCHOOLS,MARSHALL A. BAKER,,600407,0,4,52,56,OFFICE NO. 2 STILLWATER PUBLIC SCHOOLS
PAYNE,OFFICE NO. 2 STILLWATER PUBLIC SCHOOLS,LAURA ANN CLARK,,600407,0,4,14,18,OFFICE NO. 2 STILLWATER PUBLIC SCHOOLS
PAYNE,OFFICE NO. 2 STILLWATER PUBLIC SCHOOLS,PAM FRIEDEN,,600407,1,3,9,13,OFFICE NO. 2 STILLWATER PUBLIC SCHOOLS
PAYNE,PROPOSITION NO. 1 STILLWATER PUBLIC SCHOOLS,FOR THE PROPOSITION - YES,,600407,1,8,63,72,PROPOSITION NO. 1 STILLWATER PUBLIC SCHOOLS
PAYNE,PROPOSITION NO. 1 STILLWATER PUBLIC SCHOOLS,AGAINST THE PROPOSITION - NO,,600407,0,2,16,18,PROPOSITION NO. 1 STILLWATER PUBLIC SCHOOLS
PAYNE,PROPOSITION NO. 2 STILLWATER PUBLIC SCHOOLS,FOR THE PROPOSITION - YES,,600407,1,8,64,73,PROPOSITION NO. 2 STILLWATER PUBLIC SCHOOLS
PAYNE,PROPOSITION NO. 2 STILLWATER PUBLIC SCHOOLS,AGAINST THE PROPOSITION - NO,,600407,0,2,14,16,PROPOSITION NO. 2 STILLWATER PUBLIC SCHOOLS
PAYNE,PROPOSITION MORRISON PUBLIC SCHOOLS,FOR THE PROPOSITION - YES,,600408,0,0,0,0,
PAYNE,PROPOSITION MORRISON PUBLIC SCHOOLS,AGAINST THE PROPOSITION - NO,,600408,0,0,0,0,
PAYNE,OFFICE NO. 2 STILLWATER PUBLIC SCHOOLS,MARSHALL A. BAKER,,600408,0,0,31,31,OFFICE NO. 2 STILLWATER PUBLIC SCHOOLS
PAYNE,OFFICE NO. 2 STILLWATER PUBLIC SCHOOLS,LAURA ANN CLARK,,600408,0,1,17,18,OFFICE NO. 2 STILLWATER PUBLIC SCHOOLS
PAYNE,OFFICE NO. 2 STILLWATER PUBLIC SCHOOLS,PAM FRIEDEN,,600408,0,1,7,8,OFFICE NO. 2 STILLWATER PUBLIC SCHOOLS
PAYNE,PROPOSITION NO. 1 STILLWATER PUBLIC SCHOOLS,FOR THE PROPOSITION - YES,,600408,0,1,43,44,PROPOSITION NO. 1 STILLWATER PUBLIC SCHOOLS
PAYNE,PROPOSITION NO. 1 STILLWATER PUBLIC SCHOOLS,AGAINST THE PROPOSITION - NO,,600408,0,1,14,15,PROPOSITION NO. 1 STILLWATER PUBLIC SCHOOLS
PAYNE,PROPOSITION NO. 2 STILLWATER PUBLIC SCHOOLS,FOR THE PROPOSITION - YES,,600408,0,1,44,45,PROPOSITION NO. 2 STILLWATER PUBLIC SCHOOLS
PAYNE,PROPOSITION NO. 2 STILLWATER PUBLIC SCHOOLS,AGAINST THE PROPOSITION - NO,,600408,0,1,13,14,PROPOSITION NO. 2 STILLWATER PUBLIC SCHOOLS
PAYNE,OFFICE NO. 2 STILLWATER PUBLIC SCHOOLS,MARSHALL A. BAKER,,600409,0,1,1,2,OFFICE NO. 2 STILLWATER PUBLIC SCHOOLS
PAYNE,OFFICE NO. 2 STILLWATER PUBLIC SCHOOLS,LAURA ANN CLARK,,600409,0,0,4,4,OFFICE NO. 2 STILLWATER PUBLIC SCHOOLS
PAYNE,OFFICE NO. 2 STILLWATER PUBLIC SCHOOLS,PAM FRIEDEN,,600409,0,0,0,0,OFFICE NO. 2 STILLWATER PUBLIC SCHOOLS
PAYNE,PROPOSITION NO. 1 STILLWATER PUBLIC SCHOOLS,FOR THE PROPOSITION - YES,,600409,0,1,4,5,PROPOSITION NO. 1 STILLWATER PUBLIC SCHOOLS
PAYNE,PROPOSITION NO. 1 STILLWATER PUBLIC SCHOOLS,AGAINST THE PROPOSITION - NO,,600409,0,0,3,3,PROPOSITION NO. 1 STILLWATER PUBLIC SCHOOLS
PAYNE,PROPOSITION NO. 2 STILLWATER PUBLIC SCHOOLS,FOR THE PROPOSITION - YES,,600409,0,1,4,5,PROPOSITION NO. 2 STILLWATER PUBLIC SCHOOLS
PAYNE,PROPOSITION NO. 2 STILLWATER PUBLIC SCHOOLS,AGAINST THE PROPOSITION - NO,,600409,0,0,3,3,PROPOSITION NO. 2 STILLWATER PUBLIC SCHOOLS
PAYNE,OFFICE NO. 2 YALE PUBLIC SCHOOLS,BECKI FOSTER,,600409,0,0,3,3,OFFICE NO. 2 YALE PUBLIC SCHOOLS
PAYNE,OFFICE NO. 2 YALE PUBLIC SCHOOLS,CURTIS MORPHEW,,600409,0,0,0,0,OFFICE NO. 2 YALE PUBLIC SCHOOLS
PITTSBURG,OFFICE NO. 1 KREBS PUBLIC SCHOOL,BILLY SUMNER,,610001,0,0,0,0,OFFICE NO. 1 KREBS PUBLIC SCHOOL
PITTSBURG,OFFICE NO. 1 KREBS PUBLIC SCHOOL,BILLY VICARS,,610001,0,0,0,0,OFFICE NO. 1 KREBS PUBLIC SCHOOL
PITTSBURG,OFFICE NO. 1 KREBS PUBLIC SCHOOL,BILLY SUMNER,,610003,0,0,0,0,OFFICE NO. 1 KREBS PUBLIC SCHOOL
PITTSBURG,OFFICE NO. 1 KREBS PUBLIC SCHOOL,BILLY VICARS,,610003,0,0,0,0,OFFICE NO. 1 KREBS PUBLIC SCHOOL
PITTSBURG,PROPOSITION CROWDER PUBLIC SCHOOLS,FOR THE PROPOSITION - YES,,610014,0,0,0,0,
PITTSBURG,PROPOSITION CROWDER PUBLIC SCHOOLS,AGAINST THE PROPOSITION - NO,,610014,0,0,0,0,
PITTSBURG,OFFICE NO. 1 KREBS PUBLIC SCHOOL,BILLY SUMNER,,610014,0,0,0,0,OFFICE NO. 1 KREBS PUBLIC SCHOOL
PITTSBURG,OFFICE NO. 1 KREBS PUBLIC SCHOOL,BILLY VICARS,,610014,0,0,0,0,OFFICE NO. 1 KREBS PUBLIC SCHOOL
PITTSBURG,PROPOSITION HAILEYVILLE PUBLIC SCHOOLS,FOR THE PROPOSITION - YES,,610019,0,0,8,8,
PITTSBURG,PROPOSITION HAILEYVILLE PUBLIC SCHOOLS,AGAINST THE PROPOSITION - NO,,610019,0,0,0,0,
PITTSBURG,OFFICE NO. 1 KREBS PUBLIC SCHOOL,BILLY SUMNER,,610019,0,0,0,0,OFFICE NO. 1 KREBS PUBLIC SCHOOL
PITTSBURG,OFFICE NO. 1 KREBS PUBLIC SCHOOL,BILLY VICARS,,610019,0,0,0,0,OFFICE NO. 1 KREBS PUBLIC SCHOOL
PITTSBURG,PROPOSITION HAILEYVILLE PUBLIC SCHOOLS,FOR THE PROPOSITION - YES,,610020,0,1,8,9,
PITTSBURG,PROPOSITION HAILEYVILLE PUBLIC SCHOOLS,AGAINST THE PROPOSITION - NO,,610020,0,1,2,3,
PITTSBURG,PROPOSITION NO. 1 STUART PUBLIC SCHOOLS,FOR THE PROPOSITION - YES,,610021,0,0,27,27,PROPOSITION NO. 1 STUART PUBLIC SCHOOLS
PITTSBURG,PROPOSITION NO. 1 STUART PUBLIC SCHOOLS,AGAINST THE PROPOSITION - NO,,610021,0,4,4,8,PROPOSITION NO. 1 STUART PUBLIC SCHOOLS
PITTSBURG,PROPOSITION NO. 2 STUART PUBLIC SCHOOLS,FOR THE PROPOSITION - YES,,610021,0,0,25,25,PROPOSITION NO. 2 STUART PUBLIC SCHOOLS
PITTSBURG,PROPOSITION NO. 2 STUART PUBLIC SCHOOLS,AGAINST THE PROPOSITION - NO,,610021,0,4,6,10,PROPOSITION NO. 2 STUART PUBLIC SCHOOLS
PITTSBURG,PROPOSITION NO. 1 STUART PUBLIC SCHOOLS,FOR THE PROPOSITION - YES,,610023,0,0,5,5,PROPOSITION NO. 1 STUART PUBLIC SCHOOLS
PITTSBURG,PROPOSITION NO. 1 STUART PUBLIC SCHOOLS,AGAINST THE PROPOSITION - NO,,610023,0,0,1,1,PROPOSITION NO. 1 STUART PUBLIC SCHOOLS
PITTSBURG,PROPOSITION NO. 2 STUART PUBLIC SCHOOLS,FOR THE PROPOSITION - YES,,610023,0,0,5,5,PROPOSITION NO. 2 STUART PUBLIC SCHOOLS
PITTSBURG,PROPOSITION NO. 2 STUART PUBLIC SCHOOLS,AGAINST THE PROPOSITION - NO,,610023,0,0,1,1,PROPOSITION NO. 2 STUART PUBLIC SCHOOLS
PITTSBURG,OFFICE NO. 2 KIOWA PUBLIC SCHOOLS,RICK SARTOR,,610023,0,0,13,13,OFFICE NO. 2 KIOWA PUBLIC SCHOOLS
PITTSBURG,OFFICE NO. 2 KIOWA PUBLIC SCHOOLS,DIANA LINSCOTT,,610023,0,0,2,2,OFFICE NO. 2 KIOWA PUBLIC SCHOOLS
PITTSBURG,OFFICE NO. 2 CANADIAN PUBLIC SCHOOLS,DONDI PRATT,,610026,0,0,1,1,OFFICE NO. 2 CANADIAN PUBLIC SCHOOLS
PITTSBURG,OFFICE NO. 2 CANADIAN PUBLIC SCHOOLS,MATTHEW MICHAEL GRAHAM,,610026,0,0,0,0,OFFICE NO. 2 CANADIAN PUBLIC SCHOOLS
PITTSBURG,PROPOSITION CROWDER PUBLIC SCHOOLS,FOR THE PROPOSITION - YES,,610026,0,2,29,31,
PITTSBURG,PROPOSITION CROWDER PUBLIC SCHOOLS,AGAINST THE PROPOSITION - NO,,610026,0,0,2,2,
PITTSBURG,OFFICE NO. 2 CANADIAN PUBLIC SCHOOLS,DONDI PRATT,,610027,0,3,50,53,OFFICE NO. 2 CANADIAN PUBLIC SCHOOLS
PITTSBURG,OFFICE NO. 2 CANADIAN PUBLIC SCHOOLS,MATTHEW MICHAEL GRAHAM,,610027,0,0,43,43,OFFICE NO. 2 CANADIAN PUBLIC SCHOOLS
PITTSBURG,OFFICE NO. 2 CANADIAN PUBLIC SCHOOLS,DONDI PRATT,,610028,0,0,26,26,OFFICE NO. 2 CANADIAN PUBLIC SCHOOLS
PITTSBURG,OFFICE NO. 2 CANADIAN PUBLIC SCHOOLS,MATTHEW MICHAEL GRAHAM,,610028,0,0,18,18,OFFICE NO. 2 CANADIAN PUBLIC SCHOOLS
PITTSBURG,PROPOSITION CROWDER PUBLIC SCHOOLS,FOR THE PROPOSITION - YES,,610028,0,0,4,4,
PITTSBURG,PROPOSITION CROWDER PUBLIC SCHOOLS,AGAINST THE PROPOSITION - NO,,610028,0,0,0,0,
PITTSBURG,PROPOSITION HAILEYVILLE PUBLIC SCHOOLS,FOR THE PROPOSITION - YES,,610029,0,0,5,5,
PITTSBURG,PROPOSITION HAILEYVILLE PUBLIC SCHOOLS,AGAINST THE PROPOSITION - NO,,610029,0,0,1,1,
PITTSBURG,PROPOSITION CROWDER PUBLIC SCHOOLS,FOR THE PROPOSITION - YES,,610030,0,0,48,48,
PITTSBURG,PROPOSITION CROWDER PUBLIC SCHOOLS,AGAINST THE PROPOSITION - NO,,610030,0,0,4,4,
PITTSBURG,OFFICE NO. 2 CANADIAN PUBLIC SCHOOLS,DONDI PRATT,,610031,0,0,29,29,OFFICE NO. 2 CANADIAN PUBLIC SCHOOLS
PITTSBURG,OFFICE NO. 2 CANADIAN PUBLIC SCHOOLS,MATTHEW MICHAEL GRAHAM,,610031,0,1,15,16,OFFICE NO. 2 CANADIAN PUBLIC SCHOOLS
PITTSBURG,PROPOSITION CROWDER PUBLIC SCHOOLS,FOR THE PROPOSITION - YES,,610031,0,0,0,0,
PITTSBURG,PROPOSITION CROWDER PUBLIC SCHOOLS,AGAINST THE PROPOSITION - NO,,610031,0,0,0,0,
PITTSBURG,PROPOSITION HAILEYVILLE PUBLIC SCHOOLS,FOR THE PROPOSITION - YES,,610032,0,1,2,3,
PITTSBURG,PROPOSITION HAILEYVILLE PUBLIC SCHOOLS,AGAINST THE PROPOSITION - NO,,610032,0,0,1,1,
PITTSBURG,OFFICE NO. 1 KREBS PUBLIC SCHOOL,BILLY SUMNER,,610032,0,0,0,0,OFFICE NO. 1 KREBS PUBLIC SCHOOL
PITTSBURG,OFFICE NO. 1 KREBS PUBLIC SCHOOL,BILLY VICARS,,610032,0,0,0,0,OFFICE NO. 1 KREBS PUBLIC SCHOOL
PITTSBURG,PROPOSITION HAILEYVILLE PUBLIC SCHOOLS,FOR THE PROPOSITION - YES,,610033,0,0,27,27,
PITTSBURG,PROPOSITION HAILEYVILLE PUBLIC SCHOOLS,AGAINST THE PROPOSITION - NO,,610033,1,1,5,7,
PITTSBURG,PROPOSITION HAILEYVILLE PUBLIC SCHOOLS,FOR THE PROPOSITION - YES,,610034,0,0,0,0,
PITTSBURG,PROPOSITION HAILEYVILLE PUBLIC SCHOOLS,AGAINST THE PROPOSITION - NO,,610034,0,0,0,0,
PITTSBURG,PROPOSITION HAILEYVILLE PUBLIC SCHOOLS,FOR THE PROPOSITION - YES,,610035,0,0,0,0,
PITTSBURG,PROPOSITION HAILEYVILLE PUBLIC SCHOOLS,AGAINST THE PROPOSITION - NO,,610035,0,0,0,0,
PITTSBURG,OFFICE NO. 2 CANADIAN PUBLIC SCHOOLS,DONDI PRATT,,610037,0,0,0,0,OFFICE NO. 2 CANADIAN PUBLIC SCHOOLS
PITTSBURG,OFFICE NO. 2 CANADIAN PUBLIC SCHOOLS,MATTHEW MICHAEL GRAHAM,,610037,0,0,2,2,OFFICE NO. 2 CANADIAN PUBLIC SCHOOLS
PITTSBURG,PROPOSITION CROWDER PUBLIC SCHOOLS,FOR THE PROPOSITION - YES,,610037,0,0,11,11,
PITTSBURG,PROPOSITION CROWDER PUBLIC SCHOOLS,AGAINST THE PROPOSITION - NO,,610037,0,0,5,5,
PITTSBURG,PROPOSITION HAILEYVILLE PUBLIC SCHOOLS,FOR THE PROPOSITION - YES,,610038,0,0,2,2,
PITTSBURG,PROPOSITION HAILEYVILLE PUBLIC SCHOOLS,AGAINST THE PROPOSITION - NO,,610038,0,0,0,0,
PITTSBURG,OFFICE NO. 2 KIOWA PUBLIC SCHOOLS,RICK SARTOR,,610039,1,0,40,41,OFFICE NO. 2 KIOWA PUBLIC SCHOOLS
PITTSBURG,OFFICE NO. 2 KIOWA PUBLIC SCHOOLS,DIANA LINSCOTT,,610039,2,0,48,50,OFFICE NO. 2 KIOWA PUBLIC SCHOOLS
PITTSBURG,OFFICE NO. 1 KREBS PUBLIC SCHOOL,BILLY SUMNER,,610041,0,2,17,19,OFFICE NO. 1 KREBS PUBLIC SCHOOL
PITTSBURG,OFFICE NO. 1 KREBS PUBLIC SCHOOL,BILLY VICARS,,610041,0,0,14,14,OFFICE NO. 1 KREBS PUBLIC SCHOOL
PITTSBURG,PROPOSITION CROWDER PUBLIC SCHOOLS,FOR THE PROPOSITION - YES,,610042,0,0,10,10,
PITTSBURG,PROPOSITION CROWDER PUBLIC SCHOOLS,AGAINST THE PROPOSITION - NO,,610042,0,0,1,1,
PITTSBURG,OFFICE NO. 1 KREBS PUBLIC SCHOOL,BILLY SUMNER,,610042,0,0,0,0,OFFICE NO. 1 KREBS PUBLIC SCHOOL
PITTSBURG,OFFICE NO. 1 KREBS PUBLIC SCHOOL,BILLY VICARS,,610042,0,0,0,0,OFFICE NO. 1 KREBS PUBLIC SCHOOL
PITTSBURG,PROPOSITION HAILEYVILLE PUBLIC SCHOOLS,FOR THE PROPOSITION - YES,,610043,0,0,0,0,
PITTSBURG,PROPOSITION HAILEYVILLE PUBLIC SCHOOLS,AGAINST THE PROPOSITION - NO,,610043,1,0,0,1,
PITTSBURG,PROPOSITION CROWDER PUBLIC SCHOOLS,FOR THE PROPOSITION - YES,,610044,0,0,0,0,
PITTSBURG,PROPOSITION CROWDER PUBLIC SCHOOLS,AGAINST THE PROPOSITION - NO,,610044,0,0,0,0,
PITTSBURG,PROPOSITION CROWDER PUBLIC SCHOOLS,FOR THE PROPOSITION - YES,,610046,0,0,4,4,
PITTSBURG,PROPOSITION CROWDER PUBLIC SCHOOLS,AGAINST THE PROPOSITION - NO,,610046,0,0,2,2,
PITTSBURG,OFFICE NO. 2 KIOWA PUBLIC SCHOOLS,RICK SARTOR,,610047,0,0,3,3,OFFICE NO. 2 KIOWA PUBLIC SCHOOLS
PITTSBURG,OFFICE NO. 2 KIOWA PUBLIC SCHOOLS,DIANA LINSCOTT,,610047,0,0,8,8,OFFICE NO. 2 KIOWA PUBLIC SCHOOLS
PITTSBURG,PROPOSITION NO. 1 STUART PUBLIC SCHOOLS,FOR THE PROPOSITION - YES,,610048,0,0,0,0,PROPOSITION NO. 1 STUART PUBLIC SCHOOLS
PITTSBURG,PROPOSITION NO. 1 STUART PUBLIC SCHOOLS,AGAINST THE PROPOSITION - NO,,610048,0,0,0,0,PROPOSITION NO. 1 STUART PUBLIC SCHOOLS
PITTSBURG,PROPOSITION NO. 2 STUART PUBLIC SCHOOLS,FOR THE PROPOSITION - YES,,610048,0,0,0,0,PROPOSITION NO. 2 STUART PUBLIC SCHOOLS
PITTSBURG,PROPOSITION NO. 2 STUART PUBLIC SCHOOLS,AGAINST THE PROPOSITION - NO,,610048,0,0,0,0,PROPOSITION NO. 2 STUART PUBLIC SCHOOLS
PITTSBURG,PROPOSITION NO. 1 STUART PUBLIC SCHOOLS,FOR THE PROPOSITION - YES,,610049,0,0,0,0,PROPOSITION NO. 1 STUART PUBLIC SCHOOLS
PITTSBURG,PROPOSITION NO. 1 STUART PUBLIC SCHOOLS,AGAINST THE PROPOSITION - NO,,610049,0,0,0,0,PROPOSITION NO. 1 STUART PUBLIC SCHOOLS
PITTSBURG,PROPOSITION NO. 2 STUART PUBLIC SCHOOLS,FOR THE PROPOSITION - YES,,610049,0,0,0,0,PROPOSITION NO. 2 STUART PUBLIC SCHOOLS
PITTSBURG,PROPOSITION NO. 2 STUART PUBLIC SCHOOLS,AGAINST THE PROPOSITION - NO,,610049,0,0,0,0,PROPOSITION NO. 2 STUART PUBLIC SCHOOLS
PITTSBURG,PROPOSITION CROWDER PUBLIC SCHOOLS,FOR THE PROPOSITION - YES,,610051,0,0,0,0,
PITTSBURG,PROPOSITION CROWDER PUBLIC SCHOOLS,AGAINST THE PROPOSITION - NO,,610051,0,0,0,0,
PITTSBURG,PROPOSITION HAILEYVILLE PUBLIC SCHOOLS,FOR THE PROPOSITION - YES,,610051,2,0,0,2,
PITTSBURG,PROPOSITION HAILEYVILLE PUBLIC SCHOOLS,AGAINST THE PROPOSITION - NO,,610051,0,0,0,0,
PITTSBURG,OFFICE NO. 2 KIOWA PUBLIC SCHOOLS,RICK SARTOR,,610053,0,0,0,0,OFFICE NO. 2 KIOWA PUBLIC SCHOOLS
PITTSBURG,OFFICE NO. 2 KIOWA PUBLIC SCHOOLS,DIANA LINSCOTT,,610053,0,0,0,0,OFFICE NO. 2 KIOWA PUBLIC SCHOOLS
PONTOTOC,COUNCILMEMBER WARD 3 CITY OF ADA,RANDY McFARLIN,,620013,5,6,39,50,COUNCILMEMBER WARD 3 CITY OF ADA
PONTOTOC,COUNCILMEMBER WARD 3 CITY OF ADA,PRESTON DRAPER,,620013,0,6,35,41,COUNCILMEMBER WARD 3 CITY OF ADA
PONTOTOC,COUNCILMEMBER WARD 3 CITY OF ADA,RANDY McFARLIN,,620016,2,7,23,32,COUNCILMEMBER WARD 3 CITY OF ADA
PONTOTOC,COUNCILMEMBER WARD 3 CITY OF ADA,PRESTON DRAPER,,620016,1,5,17,23,COUNCILMEMBER WARD 3 CITY OF ADA
PONTOTOC,OFFICE NO. 2 LATTA PUBLIC SCHOOLS,SAMMY ESTES,,620016,2,1,18,21,OFFICE NO. 2 LATTA PUBLIC SCHOOLS
PONTOTOC,OFFICE NO. 2 LATTA PUBLIC SCHOOLS,DARRELL MONROE,,620016,2,0,16,18,OFFICE NO. 2 LATTA PUBLIC SCHOOLS
PONTOTOC,COUNCILMEMBER WARD 3 CITY OF ADA,RANDY McFARLIN,,620022,2,4,23,29,COUNCILMEMBER WARD 3 CITY OF ADA
PONTOTOC,COUNCILMEMBER WARD 3 CITY OF ADA,PRESTON DRAPER,,620022,2,1,28,31,COUNCILMEMBER WARD 3 CITY OF ADA
PONTOTOC,COUNCILMEMBER WARD 3 CITY OF ADA,RANDY McFARLIN,,620025,7,0,8,15,COUNCILMEMBER WARD 3 CITY OF ADA
PONTOTOC,COUNCILMEMBER WARD 3 CITY OF ADA,PRESTON DRAPER,,620025,2,0,3,5,COUNCILMEMBER WARD 3 CITY OF ADA
PONTOTOC,COUNCILMEMBER WARD 3 CITY OF ADA,RANDY McFARLIN,,620031,5,1,19,25,COUNCILMEMBER WARD 3 CITY OF ADA
PONTOTOC,COUNCILMEMBER WARD 3 CITY OF ADA,PRESTON DRAPER,,620031,1,0,13,14,COUNCILMEMBER WARD 3 CITY OF ADA
PONTOTOC,OFFICE NO. 2 ALLEN PUBLIC SCHOOLS,JAMI RINEHART,,620051,0,0,60,60,OFFICE NO. 2 ALLEN PUBLIC SCHOOLS
PONTOTOC,OFFICE NO. 2 ALLEN PUBLIC SCHOOLS,CINDY DAVIS,,620051,1,0,27,28,OFFICE NO. 2 ALLEN PUBLIC SCHOOLS
PONTOTOC,COUNCILMEMBER WARD 3 CITY OF ADA,RANDY McFARLIN,,620052,0,0,7,7,COUNCILMEMBER WARD 3 CITY OF ADA
PONTOTOC,COUNCILMEMBER WARD 3 CITY OF ADA,PRESTON DRAPER,,620052,0,0,4,4,COUNCILMEMBER WARD 3 CITY OF ADA
PONTOTOC,COUNCILMEMBER WARD 3 CITY OF ADA,RANDY McFARLIN,,620053,7,8,29,44,COUNCILMEMBER WARD 3 CITY OF ADA
PONTOTOC,COUNCILMEMBER WARD 3 CITY OF ADA,PRESTON DRAPER,,620053,4,3,56,63,COUNCILMEMBER WARD 3 CITY OF ADA
PONTOTOC,COUNCILMEMBER WARD 3 CITY OF ADA,RANDY McFARLIN,,620055,0,0,0,0,COUNCILMEMBER WARD 3 CITY OF ADA
PONTOTOC,COUNCILMEMBER WARD 3 CITY OF ADA,PRESTON DRAPER,,620055,0,0,0,0,COUNCILMEMBER WARD 3 CITY OF ADA
PONTOTOC,OFFICE NO. 2 LATTA PUBLIC SCHOOLS,SAMMY ESTES,,620055,0,0,0,0,OFFICE NO. 2 LATTA PUBLIC SCHOOLS
PONTOTOC,OFFICE NO. 2 LATTA PUBLIC SCHOOLS,DARRELL MONROE,,620055,0,0,0,0,OFFICE NO. 2 LATTA PUBLIC SCHOOLS
PONTOTOC,OFFICE NO. 2 LATTA PUBLIC SCHOOLS,SAMMY ESTES,,620058,2,3,82,87,OFFICE NO. 2 LATTA PUBLIC SCHOOLS
PONTOTOC,OFFICE NO. 2 LATTA PUBLIC SCHOOLS,DARRELL MONROE,,620058,1,1,30,32,OFFICE NO. 2 LATTA PUBLIC SCHOOLS
PONTOTOC,COUNCILMEMBER WARD 3 CITY OF ADA,RANDY McFARLIN,,620060,0,0,0,0,COUNCILMEMBER WARD 3 CITY OF ADA
PONTOTOC,COUNCILMEMBER WARD 3 CITY OF ADA,PRESTON DRAPER,,620060,0,0,0,0,COUNCILMEMBER WARD 3 CITY OF ADA
PONTOTOC,OFFICE NO. 2 TUPELO PUBLIC SCHOOLS,CHARITY WOODS-EIDSON,,620061,0,0,1,1,OFFICE NO. 2 TUPELO PUBLIC SCHOOLS
PONTOTOC,OFFICE NO. 2 TUPELO PUBLIC SCHOOLS,BRAD GOULD,,620061,0,0,2,2,OFFICE NO. 2 TUPELO PUBLIC SCHOOLS
PONTOTOC,OFFICE NO. 2 LATTA PUBLIC SCHOOLS,SAMMY ESTES,,620062,0,0,0,0,OFFICE NO. 2 LATTA PUBLIC SCHOOLS
PONTOTOC,OFFICE NO. 2 LATTA PUBLIC SCHOOLS,DARRELL MONROE,,620062,0,0,0,0,OFFICE NO. 2 LATTA PUBLIC SCHOOLS
PONTOTOC,OFFICE NO. 2 TUPELO PUBLIC SCHOOLS,CHARITY WOODS-EIDSON,,620064,0,0,0,0,OFFICE NO. 2 TUPELO PUBLIC SCHOOLS
PONTOTOC,OFFICE NO. 2 TUPELO PUBLIC SCHOOLS,BRAD GOULD,,620064,0,0,0,0,OFFICE NO. 2 TUPELO PUBLIC SCHOOLS
PONTOTOC,OFFICE NO. 2 ALLEN PUBLIC SCHOOLS,JAMI RINEHART,,620064,0,0,4,4,OFFICE NO. 2 ALLEN PUBLIC SCHOOLS
PONTOTOC,OFFICE NO. 2 ALLEN PUBLIC SCHOOLS,CINDY DAVIS,,620064,3,0,2,5,OFFICE NO. 2 ALLEN PUBLIC SCHOOLS
PONTOTOC,OFFICE NO. 2 LATTA PUBLIC SCHOOLS,SAMMY ESTES,,620066,0,2,11,13,OFFICE NO. 2 LATTA PUBLIC SCHOOLS
PONTOTOC,OFFICE NO. 2 LATTA PUBLIC SCHOOLS,DARRELL MONROE,,620066,0,0,5,5,OFFICE NO. 2 LATTA PUBLIC SCHOOLS
POTTAWATOMIE,OFFICE NO. 5 SHAWNEE PUBLIC SCHOOLS,GERRY PFEIL,,630001,0,0,0,0,OFFICE NO. 5 SHAWNEE PUBLIC SCHOOLS
POTTAWATOMIE,OFFICE NO. 5 SHAWNEE PUBLIC SCHOOLS,MARK BETTERTON,,630001,0,0,0,0,OFFICE NO. 5 SHAWNEE PUBLIC SCHOOLS
POTTAWATOMIE,OFFICE NO. 7 SHAWNEE PUBLIC SCHOOLS,CHAD SELF,,630001,0,0,0,0,OFFICE NO. 7 SHAWNEE PUBLIC SCHOOLS
POTTAWATOMIE,OFFICE NO. 7 SHAWNEE PUBLIC SCHOOLS,BOBBY CANTY,,630001,0,0,0,0,OFFICE NO. 7 SHAWNEE PUBLIC SCHOOLS
POTTAWATOMIE,OFFICE NO. 2 SOUTH ROCK CREEK PUBLIC SCHOOL,MONROE BUD JEFFREY,,630001,0,0,2,2,OFFICE NO. 2 SOUTH ROCK CREEK PUBLIC SCHOOL
POTTAWATOMIE,OFFICE NO. 2 SOUTH ROCK CREEK PUBLIC SCHOOL,MELISSA MAHAFFEY,,630001,0,0,18,18,OFFICE NO. 2 SOUTH ROCK CREEK PUBLIC SCHOOL
POTTAWATOMIE,OFFICE NO. 2 BETHEL PUBLIC SCHOOLS,DAVID ELMORE,,630002,0,0,4,4,OFFICE NO. 2 BETHEL PUBLIC SCHOOLS
POTTAWATOMIE,OFFICE NO. 2 BETHEL PUBLIC SCHOOLS,BRYAN NEWELL,,630002,0,0,2,2,OFFICE NO. 2 BETHEL PUBLIC SCHOOLS
POTTAWATOMIE,OFFICE NO. 5 SHAWNEE PUBLIC SCHOOLS,GERRY PFEIL,,630002,1,0,3,4,OFFICE NO. 5 SHAWNEE PUBLIC SCHOOLS
POTTAWATOMIE,OFFICE NO. 5 SHAWNEE PUBLIC SCHOOLS,MARK BETTERTON,,630002,1,0,16,17,OFFICE NO. 5 SHAWNEE PUBLIC SCHOOLS
POTTAWATOMIE,OFFICE NO. 7 SHAWNEE PUBLIC SCHOOLS,CHAD SELF,,630002,1,0,12,13,OFFICE NO. 7 SHAWNEE PUBLIC SCHOOLS
POTTAWATOMIE,OFFICE NO. 7 SHAWNEE PUBLIC SCHOOLS,BOBBY CANTY,,630002,1,0,5,6,OFFICE NO. 7 SHAWNEE PUBLIC SCHOOLS
POTTAWATOMIE,OFFICE NO. 5 SHAWNEE PUBLIC SCHOOLS,GERRY PFEIL,,630003,0,0,19,19,OFFICE NO. 5 SHAWNEE PUBLIC SCHOOLS
POTTAWATOMIE,OFFICE NO. 5 SHAWNEE PUBLIC SCHOOLS,MARK BETTERTON,,630003,1,0,20,21,OFFICE NO. 5 SHAWNEE PUBLIC SCHOOLS
POTTAWATOMIE,OFFICE NO. 7 SHAWNEE PUBLIC SCHOOLS,CHAD SELF,,630003,1,0,15,16,OFFICE NO. 7 SHAWNEE PUBLIC SCHOOLS
POTTAWATOMIE,OFFICE NO. 7 SHAWNEE PUBLIC SCHOOLS,BOBBY CANTY,,630003,0,0,23,23,OFFICE NO. 7 SHAWNEE PUBLIC SCHOOLS
POTTAWATOMIE,OFFICE NO. 5 SHAWNEE PUBLIC SCHOOLS,GERRY PFEIL,,630006,3,0,20,23,OFFICE NO. 5 SHAWNEE PUBLIC SCHOOLS
POTTAWATOMIE,OFFICE NO. 5 SHAWNEE PUBLIC SCHOOLS,MARK BETTERTON,,630006,1,2,20,23,OFFICE NO. 5 SHAWNEE PUBLIC SCHOOLS
POTTAWATOMIE,OFFICE NO. 7 SHAWNEE PUBLIC SCHOOLS,CHAD SELF,,630006,2,3,15,20,OFFICE NO. 7 SHAWNEE PUBLIC SCHOOLS
POTTAWATOMIE,OFFICE NO. 7 SHAWNEE PUBLIC SCHOOLS,BOBBY CANTY,,630006,2,0,24,26,OFFICE NO. 7 SHAWNEE PUBLIC SCHOOLS
POTTAWATOMIE,OFFICE NO. 5 SHAWNEE PUBLIC SCHOOLS,GERRY PFEIL,,630007,2,0,17,19,OFFICE NO. 5 SHAWNEE PUBLIC SCHOOLS
POTTAWATOMIE,OFFICE NO. 5 SHAWNEE PUBLIC SCHOOLS,MARK BETTERTON,,630007,3,2,31,36,OFFICE NO. 5 SHAWNEE PUBLIC SCHOOLS
POTTAWATOMIE,OFFICE NO. 7 SHAWNEE PUBLIC SCHOOLS,CHAD SELF,,630007,0,1,27,28,OFFICE NO. 7 SHAWNEE PUBLIC SCHOOLS
POTTAWATOMIE,OFFICE NO. 7 SHAWNEE PUBLIC SCHOOLS,BOBBY CANTY,,630007,5,1,21,27,OFFICE NO. 7 SHAWNEE PUBLIC SCHOOLS
POTTAWATOMIE,OFFICE NO. 2 BETHEL PUBLIC SCHOOLS,DAVID ELMORE,,630009,0,0,2,2,OFFICE NO. 2 BETHEL PUBLIC SCHOOLS
POTTAWATOMIE,OFFICE NO. 2 BETHEL PUBLIC SCHOOLS,BRYAN NEWELL,,630009,0,0,1,1,OFFICE NO. 2 BETHEL PUBLIC SCHOOLS
POTTAWATOMIE,PROPOSITION DALE PUBLIC SCHOOLS,FOR THE PROPOSITION - YES,,630009,2,7,59,68,
POTTAWATOMIE,PROPOSITION DALE PUBLIC SCHOOLS,AGAINST THE PROPOSITION - NO,,630009,4,1,22,27,
POTTAWATOMIE,OFFICE NO. 5 SHAWNEE PUBLIC SCHOOLS,GERRY PFEIL,,630009,3,5,11,19,OFFICE NO. 5 SHAWNEE PUBLIC SCHOOLS
POTTAWATOMIE,OFFICE NO. 5 SHAWNEE PUBLIC SCHOOLS,MARK BETTERTON,,630009,2,0,21,23,OFFICE NO. 5 SHAWNEE PUBLIC SCHOOLS
POTTAWATOMIE,OFFICE NO. 7 SHAWNEE PUBLIC SCHOOLS,CHAD SELF,,630009,1,0,15,16,OFFICE NO. 7 SHAWNEE PUBLIC SCHOOLS
POTTAWATOMIE,OFFICE NO. 7 SHAWNEE PUBLIC SCHOOLS,BOBBY CANTY,,630009,4,5,17,26,OFFICE NO. 7 SHAWNEE PUBLIC SCHOOLS
POTTAWATOMIE,OFFICE NO. 5 SHAWNEE PUBLIC SCHOOLS,GERRY PFEIL,,630011,0,0,0,0,OFFICE NO. 5 SHAWNEE PUBLIC SCHOOLS
POTTAWATOMIE,OFFICE NO. 5 SHAWNEE PUBLIC SCHOOLS,MARK BETTERTON,,630011,0,0,0,0,OFFICE NO. 5 SHAWNEE PUBLIC SCHOOLS
POTTAWATOMIE,OFFICE NO. 7 SHAWNEE PUBLIC SCHOOLS,CHAD SELF,,630011,0,0,0,0,OFFICE NO. 7 SHAWNEE PUBLIC SCHOOLS
POTTAWATOMIE,OFFICE NO. 7 SHAWNEE PUBLIC SCHOOLS,BOBBY CANTY,,630011,0,0,0,0,OFFICE NO. 7 SHAWNEE PUBLIC SCHOOLS
POTTAWATOMIE,OFFICE NO. 2 SOUTH ROCK CREEK PUBLIC SCHOOL,MONROE BUD JEFFREY,,630011,0,0,0,0,OFFICE NO. 2 SOUTH ROCK CREEK PUBLIC SCHOOL
POTTAWATOMIE,OFFICE NO. 2 SOUTH ROCK CREEK PUBLIC SCHOOL,MELISSA MAHAFFEY,,630011,0,0,0,0,OFFICE NO. 2 SOUTH ROCK CREEK PUBLIC SCHOOL
POTTAWATOMIE,OFFICE NO. 5 SHAWNEE PUBLIC SCHOOLS,GERRY PFEIL,,630012,2,0,46,48,OFFICE NO. 5 SHAWNEE PUBLIC SCHOOLS
POTTAWATOMIE,OFFICE NO. 5 SHAWNEE PUBLIC SCHOOLS,MARK BETTERTON,,630012,3,0,43,46,OFFICE NO. 5 SHAWNEE PUBLIC SCHOOLS
POTTAWATOMIE,OFFICE NO. 7 SHAWNEE PUBLIC SCHOOLS,CHAD SELF,,630012,2,0,35,37,OFFICE NO. 7 SHAWNEE PUBLIC SCHOOLS
POTTAWATOMIE,OFFICE NO. 7 SHAWNEE PUBLIC SCHOOLS,BOBBY CANTY,,630012,3,0,54,57,OFFICE NO. 7 SHAWNEE PUBLIC SCHOOLS
POTTAWATOMIE,OFFICE NO. 5 SHAWNEE PUBLIC SCHOOLS,GERRY PFEIL,,630013,2,0,7,9,OFFICE NO. 5 SHAWNEE PUBLIC SCHOOLS
POTTAWATOMIE,OFFICE NO. 5 SHAWNEE PUBLIC SCHOOLS,MARK BETTERTON,,630013,2,0,7,9,OFFICE NO. 5 SHAWNEE PUBLIC SCHOOLS
POTTAWATOMIE,OFFICE NO. 7 SHAWNEE PUBLIC SCHOOLS,CHAD SELF,,630013,2,0,9,11,OFFICE NO. 7 SHAWNEE PUBLIC SCHOOLS
POTTAWATOMIE,OFFICE NO. 7 SHAWNEE PUBLIC SCHOOLS,BOBBY CANTY,,630013,2,0,5,7,OFFICE NO. 7 SHAWNEE PUBLIC SCHOOLS
POTTAWATOMIE,OFFICE NO. 5 SHAWNEE PUBLIC SCHOOLS,GERRY PFEIL,,630015,2,2,28,32,OFFICE NO. 5 SHAWNEE PUBLIC SCHOOLS
POTTAWATOMIE,OFFICE NO. 5 SHAWNEE PUBLIC SCHOOLS,MARK BETTERTON,,630015,6,5,45,56,OFFICE NO. 5 SHAWNEE PUBLIC SCHOOLS
POTTAWATOMIE,OFFICE NO. 7 SHAWNEE PUBLIC SCHOOLS,CHAD SELF,,630015,4,5,33,42,OFFICE NO. 7 SHAWNEE PUBLIC SCHOOLS
POTTAWATOMIE,OFFICE NO. 7 SHAWNEE PUBLIC SCHOOLS,BOBBY CANTY,,630015,4,2,39,45,OFFICE NO. 7 SHAWNEE PUBLIC SCHOOLS
POTTAWATOMIE,PROPOSITION PLEASANT GROVE PUBLIC SCHOOL,FOR THE PROPOSITION - YES,,630018,3,1,17,21,
POTTAWATOMIE,PROPOSITION PLEASANT GROVE PUBLIC SCHOOL,AGAINST THE PROPOSITION - NO,,630018,4,0,51,55,
POTTAWATOMIE,OFFICE NO. 5 SHAWNEE PUBLIC SCHOOLS,GERRY PFEIL,,630018,1,0,9,10,OFFICE NO. 5 SHAWNEE PUBLIC SCHOOLS
POTTAWATOMIE,OFFICE NO. 5 SHAWNEE PUBLIC SCHOOLS,MARK BETTERTON,,630018,1,0,7,8,OFFICE NO. 5 SHAWNEE PUBLIC SCHOOLS
POTTAWATOMIE,OFFICE NO. 7 SHAWNEE PUBLIC SCHOOLS,CHAD SELF,,630018,1,0,4,5,OFFICE NO. 7 SHAWNEE PUBLIC SCHOOLS
POTTAWATOMIE,OFFICE NO. 7 SHAWNEE PUBLIC SCHOOLS,BOBBY CANTY,,630018,1,0,12,13,OFFICE NO. 7 SHAWNEE PUBLIC SCHOOLS
POTTAWATOMIE,OFFICE NO. 2 SOUTH ROCK CREEK PUBLIC SCHOOL,MONROE BUD JEFFREY,,630018,0,0,0,0,OFFICE NO. 2 SOUTH ROCK CREEK PUBLIC SCHOOL
POTTAWATOMIE,OFFICE NO. 2 SOUTH ROCK CREEK PUBLIC SCHOOL,MELISSA MAHAFFEY,,630018,0,0,0,0,OFFICE NO. 2 SOUTH ROCK CREEK PUBLIC SCHOOL
POTTAWATOMIE,OFFICE NO. 2 SOUTH ROCK CREEK PUBLIC SCHOOL,MONROE BUD JEFFREY,,630021,0,0,2,2,OFFICE NO. 2 SOUTH ROCK CREEK PUBLIC SCHOOL
POTTAWATOMIE,OFFICE NO. 2 SOUTH ROCK CREEK PUBLIC SCHOOL,MELISSA MAHAFFEY,,630021,0,0,12,12,OFFICE NO. 2 SOUTH ROCK CREEK PUBLIC SCHOOL
POTTAWATOMIE,OFFICE NO. 2 STROTHER PUBLIC SCHOOLS,TRAVIS GILLESPIE,,630021,0,0,10,10,OFFICE NO. 2 STROTHER PUBLIC SCHOOLS
POTTAWATOMIE,OFFICE NO. 2 STROTHER PUBLIC SCHOOLS,HEATH SAPP,,630021,0,0,0,0,OFFICE NO. 2 STROTHER PUBLIC SCHOOLS
POTTAWATOMIE,OFFICE NO. 2 BETHEL PUBLIC SCHOOLS,DAVID ELMORE,,630022,3,0,46,49,OFFICE NO. 2 BETHEL PUBLIC SCHOOLS
POTTAWATOMIE,OFFICE NO. 2 BETHEL PUBLIC SCHOOLS,BRYAN NEWELL,,630022,0,0,12,12,OFFICE NO. 2 BETHEL PUBLIC SCHOOLS
POTTAWATOMIE,OFFICE NO. 2 TECUMSEH PUBLIC SCHOOLS,JIM BRENNER,,630022,0,0,0,0,OFFICE NO. 2 TECUMSEH PUBLIC SCHOOLS
POTTAWATOMIE,OFFICE NO. 2 TECUMSEH PUBLIC SCHOOLS,SHAWN FLEMING,,630022,0,0,3,3,OFFICE NO. 2 TECUMSEH PUBLIC SCHOOLS
POTTAWATOMIE,OFFICE NO. 2 MEEKER PUBLIC SCHOOLS,JESSICA GABEAU,,630024,0,0,0,0,OFFICE NO. 2 MEEKER PUBLIC SCHOOLS
POTTAWATOMIE,OFFICE NO. 2 MEEKER PUBLIC SCHOOLS,BRET WOOD,,630024,0,0,1,1,OFFICE NO. 2 MEEKER PUBLIC SCHOOLS
POTTAWATOMIE,PROPOSITION DALE PUBLIC SCHOOLS,FOR THE PROPOSITION - YES,,630024,0,0,3,3,
POTTAWATOMIE,PROPOSITION DALE PUBLIC SCHOOLS,AGAINST THE PROPOSITION - NO,,630024,0,0,0,0,
POTTAWATOMIE,OFFICE NO. 5 SHAWNEE PUBLIC SCHOOLS,GERRY PFEIL,,630024,0,0,0,0,OFFICE NO. 5 SHAWNEE PUBLIC SCHOOLS
POTTAWATOMIE,OFFICE NO. 5 SHAWNEE PUBLIC SCHOOLS,MARK BETTERTON,,630024,0,0,0,0,OFFICE NO. 5 SHAWNEE PUBLIC SCHOOLS
POTTAWATOMIE,OFFICE NO. 7 SHAWNEE PUBLIC SCHOOLS,CHAD SELF,,630024,0,0,0,0,OFFICE NO. 7 SHAWNEE PUBLIC SCHOOLS
POTTAWATOMIE,OFFICE NO. 7 SHAWNEE PUBLIC SCHOOLS,BOBBY CANTY,,630024,0,0,0,0,OFFICE NO. 7 SHAWNEE PUBLIC SCHOOLS
POTTAWATOMIE,"COUNCILMEMBER, WARD 4 CITY OF OKLAHOMA CITY",RICHARD D. MORRISSETTE,,630025,0,0,0,0,"COUNCILMEMBER, WARD 4 CITY OF OKLAHOMA CITY"
POTTAWATOMIE,"COUNCILMEMBER, WARD 4 CITY OF OKLAHOMA CITY",TODD STONE,,630025,0,0,0,0,"COUNCILMEMBER, WARD 4 CITY OF OKLAHOMA CITY"
POTTAWATOMIE,"COUNCILMEMBER, WARD 4 CITY OF OKLAHOMA CITY",WALTER KULA,,630025,0,0,0,0,"COUNCILMEMBER, WARD 4 CITY OF OKLAHOMA CITY"
POTTAWATOMIE,"COUNCILMEMBER, WARD 4 CITY OF OKLAHOMA CITY",DORIS MANGIARACINA BENBROOK,,630025,0,0,0,0,"COUNCILMEMBER, WARD 4 CITY OF OKLAHOMA CITY"
POTTAWATOMIE,OFFICE NO. 2 BETHEL PUBLIC SCHOOLS,DAVID ELMORE,,630025,0,0,5,5,OFFICE NO. 2 BETHEL PUBLIC SCHOOLS
POTTAWATOMIE,OFFICE NO. 2 BETHEL PUBLIC SCHOOLS,BRYAN NEWELL,,630025,2,0,4,6,OFFICE NO. 2 BETHEL PUBLIC SCHOOLS
POTTAWATOMIE,PROPOSITION DALE PUBLIC SCHOOLS,FOR THE PROPOSITION - YES,,630025,2,2,73,77,
POTTAWATOMIE,PROPOSITION DALE PUBLIC SCHOOLS,AGAINST THE PROPOSITION - NO,,630025,0,0,20,20,
POTTAWATOMIE,OFFICE NO. 2 MCLOUD PUBLIC SCHOOLS,MELANIE KRAUSE,,630025,0,0,10,10,OFFICE NO. 2 MCLOUD PUBLIC SCHOOLS
POTTAWATOMIE,OFFICE NO. 2 MCLOUD PUBLIC SCHOOLS,STEVEN M. SWARTZ,,630025,0,0,16,16,OFFICE NO. 2 MCLOUD PUBLIC SCHOOLS
POTTAWATOMIE,OFFICE NO. 2 MCLOUD PUBLIC SCHOOLS,JEANNENE WILLIAMS,,630025,0,0,4,4,OFFICE NO. 2 MCLOUD PUBLIC SCHOOLS
POTTAWATOMIE,OFFICE NO. 2 BETHEL PUBLIC SCHOOLS,DAVID ELMORE,,630026,3,3,48,54,OFFICE NO. 2 BETHEL PUBLIC SCHOOLS
POTTAWATOMIE,OFFICE NO. 2 BETHEL PUBLIC SCHOOLS,BRYAN NEWELL,,630026,3,2,29,34,OFFICE NO. 2 BETHEL PUBLIC SCHOOLS
POTTAWATOMIE,PROPOSITION DALE PUBLIC SCHOOLS,FOR THE PROPOSITION - YES,,630026,0,0,10,10,
POTTAWATOMIE,PROPOSITION DALE PUBLIC SCHOOLS,AGAINST THE PROPOSITION - NO,,630026,0,0,2,2,
POTTAWATOMIE,OFFICE NO. 5 SHAWNEE PUBLIC SCHOOLS,GERRY PFEIL,,630026,0,0,0,0,OFFICE NO. 5 SHAWNEE PUBLIC SCHOOLS
POTTAWATOMIE,OFFICE NO. 5 SHAWNEE PUBLIC SCHOOLS,MARK BETTERTON,,630026,1,0,2,3,OFFICE NO. 5 SHAWNEE PUBLIC SCHOOLS
POTTAWATOMIE,OFFICE NO. 7 SHAWNEE PUBLIC SCHOOLS,CHAD SELF,,630026,0,0,2,2,OFFICE NO. 7 SHAWNEE PUBLIC SCHOOLS
POTTAWATOMIE,OFFICE NO. 7 SHAWNEE PUBLIC SCHOOLS,BOBBY CANTY,,630026,1,0,0,1,OFFICE NO. 7 SHAWNEE PUBLIC SCHOOLS
POTTAWATOMIE,OFFICE NO. 2 TECUMSEH PUBLIC SCHOOLS,JIM BRENNER,,630027,2,0,2,4,OFFICE NO. 2 TECUMSEH PUBLIC SCHOOLS
POTTAWATOMIE,OFFICE NO. 2 TECUMSEH PUBLIC SCHOOLS,SHAWN FLEMING,,630027,1,0,0,1,OFFICE NO. 2 TECUMSEH PUBLIC SCHOOLS
POTTAWATOMIE,OFFICE NO. 2 BETHEL PUBLIC SCHOOLS,DAVID ELMORE,,630029,0,0,2,2,OFFICE NO. 2 BETHEL PUBLIC SCHOOLS
POTTAWATOMIE,OFFICE NO. 2 BETHEL PUBLIC SCHOOLS,BRYAN NEWELL,,630029,0,0,0,0,OFFICE NO. 2 BETHEL PUBLIC SCHOOLS
POTTAWATOMIE,OFFICE NO. 2 SOUTH ROCK CREEK PUBLIC SCHOOL,MONROE BUD JEFFREY,,630029,0,0,0,0,OFFICE NO. 2 SOUTH ROCK CREEK PUBLIC SCHOOL
POTTAWATOMIE,OFFICE NO. 2 SOUTH ROCK CREEK PUBLIC SCHOOL,MELISSA MAHAFFEY,,630029,0,0,0,0,OFFICE NO. 2 SOUTH ROCK CREEK PUBLIC SCHOOL
POTTAWATOMIE,OFFICE NO. 2 TECUMSEH PUBLIC SCHOOLS,JIM BRENNER,,630029,0,0,7,7,OFFICE NO. 2 TECUMSEH PUBLIC SCHOOLS
POTTAWATOMIE,OFFICE NO. 2 TECUMSEH PUBLIC SCHOOLS,SHAWN FLEMING,,630029,6,2,24,32,OFFICE NO. 2 TECUMSEH PUBLIC SCHOOLS
POTTAWATOMIE,OFFICE NO. 2 SOUTH ROCK CREEK PUBLIC SCHOOL,MONROE BUD JEFFREY,,630030,0,0,0,0,OFFICE NO. 2 SOUTH ROCK CREEK PUBLIC SCHOOL
POTTAWATOMIE,OFFICE NO. 2 SOUTH ROCK CREEK PUBLIC SCHOOL,MELISSA MAHAFFEY,,630030,0,0,12,12,OFFICE NO. 2 SOUTH ROCK CREEK PUBLIC SCHOOL
POTTAWATOMIE,OFFICE NO. 2 TECUMSEH PUBLIC SCHOOLS,JIM BRENNER,,630030,3,0,4,7,OFFICE NO. 2 TECUMSEH PUBLIC SCHOOLS
POTTAWATOMIE,OFFICE NO. 2 TECUMSEH PUBLIC SCHOOLS,SHAWN FLEMING,,630030,5,1,31,37,OFFICE NO. 2 TECUMSEH PUBLIC SCHOOLS
POTTAWATOMIE,PROPOSITION DALE PUBLIC SCHOOLS,FOR THE PROPOSITION - YES,,630031,7,9,108,124,
POTTAWATOMIE,PROPOSITION DALE PUBLIC SCHOOLS,AGAINST THE PROPOSITION - NO,,630031,4,6,31,41,
POTTAWATOMIE,OFFICE NO. 2 MCLOUD PUBLIC SCHOOLS,MELANIE KRAUSE,,630031,6,2,39,47,OFFICE NO. 2 MCLOUD PUBLIC SCHOOLS
POTTAWATOMIE,OFFICE NO. 2 MCLOUD PUBLIC SCHOOLS,STEVEN M. SWARTZ,,630031,1,0,59,60,OFFICE NO. 2 MCLOUD PUBLIC SCHOOLS
POTTAWATOMIE,OFFICE NO. 2 MCLOUD PUBLIC SCHOOLS,JEANNENE WILLIAMS,,630031,0,0,9,9,OFFICE NO. 2 MCLOUD PUBLIC SCHOOLS
POTTAWATOMIE,OFFICE NO. 5 SHAWNEE PUBLIC SCHOOLS,GERRY PFEIL,,630033,0,0,5,5,OFFICE NO. 5 SHAWNEE PUBLIC SCHOOLS
POTTAWATOMIE,OFFICE NO. 5 SHAWNEE PUBLIC SCHOOLS,MARK BETTERTON,,630033,0,0,2,2,OFFICE NO. 5 SHAWNEE PUBLIC SCHOOLS
POTTAWATOMIE,OFFICE NO. 7 SHAWNEE PUBLIC SCHOOLS,CHAD SELF,,630033,0,0,4,4,OFFICE NO. 7 SHAWNEE PUBLIC SCHOOLS
POTTAWATOMIE,OFFICE NO. 7 SHAWNEE PUBLIC SCHOOLS,BOBBY CANTY,,630033,0,0,3,3,OFFICE NO. 7 SHAWNEE PUBLIC SCHOOLS
POTTAWATOMIE,OFFICE NO. 2 SOUTH ROCK CREEK PUBLIC SCHOOL,MONROE BUD JEFFREY,,630033,0,0,0,0,OFFICE NO. 2 SOUTH ROCK CREEK PUBLIC SCHOOL
POTTAWATOMIE,OFFICE NO. 2 SOUTH ROCK CREEK PUBLIC SCHOOL,MELISSA MAHAFFEY,,630033,0,0,0,0,OFFICE NO. 2 SOUTH ROCK CREEK PUBLIC SCHOOL
POTTAWATOMIE,OFFICE NO. 2 TECUMSEH PUBLIC SCHOOLS,JIM BRENNER,,630033,0,0,0,0,OFFICE NO. 2 TECUMSEH PUBLIC SCHOOLS
POTTAWATOMIE,OFFICE NO. 2 TECUMSEH PUBLIC SCHOOLS,SHAWN FLEMING,,630033,0,0,0,0,OFFICE NO. 2 TECUMSEH PUBLIC SCHOOLS
POTTAWATOMIE,OFFICE NO. 2 TECUMSEH PUBLIC SCHOOLS,JIM BRENNER,,630037,0,0,0,0,OFFICE NO. 2 TECUMSEH PUBLIC SCHOOLS
POTTAWATOMIE,OFFICE NO. 2 TECUMSEH PUBLIC SCHOOLS,SHAWN FLEMING,,630037,0,0,0,0,OFFICE NO. 2 TECUMSEH PUBLIC SCHOOLS
POTTAWATOMIE,OFFICE NO. 2 TECUMSEH PUBLIC SCHOOLS,JIM BRENNER,,630038,0,0,0,0,OFFICE NO. 2 TECUMSEH PUBLIC SCHOOLS
POTTAWATOMIE,OFFICE NO. 2 TECUMSEH PUBLIC SCHOOLS,SHAWN FLEMING,,630038,0,0,0,0,OFFICE NO. 2 TECUMSEH PUBLIC SCHOOLS
PUSHMATAHA,OFFICE NO. 2 ANTLERS PUBLIC SCHOOLS,COREY M BOUFFLEUR,,640001,1,9,61,71,OFFICE NO. 2 ANTLERS PUBLIC SCHOOLS
PUSHMATAHA,OFFICE NO. 2 ANTLERS PUBLIC SCHOOLS,VICKIE LEATHERS,,640001,2,7,62,71,OFFICE NO. 2 ANTLERS PUBLIC SCHOOLS
PUSHMATAHA,OFFICE NO. 2 SOPER PUBLIC SCHOOLS,ANGELLA ANNETTE DANCER,,640002,0,0,0,0,OFFICE NO. 2 SOPER PUBLIC SCHOOLS
PUSHMATAHA,OFFICE NO. 2 SOPER PUBLIC SCHOOLS,ALVIE SKIP PERKINS JR,,640002,0,0,0,0,OFFICE NO. 2 SOPER PUBLIC SCHOOLS
PUSHMATAHA,OFFICE NO. 2 ANTLERS PUBLIC SCHOOLS,COREY M BOUFFLEUR,,640002,6,45,125,176,OFFICE NO. 2 ANTLERS PUBLIC SCHOOLS
PUSHMATAHA,OFFICE NO. 2 ANTLERS PUBLIC SCHOOLS,VICKIE LEATHERS,,640002,1,18,86,105,OFFICE NO. 2 ANTLERS PUBLIC SCHOOLS
PUSHMATAHA,OFFICE NO. 2 SOPER PUBLIC SCHOOLS,ANGELLA ANNETTE DANCER,,640003,0,0,0,0,OFFICE NO. 2 SOPER PUBLIC SCHOOLS
PUSHMATAHA,OFFICE NO. 2 SOPER PUBLIC SCHOOLS,ALVIE SKIP PERKINS JR,,640003,0,0,0,0,OFFICE NO. 2 SOPER PUBLIC SCHOOLS
PUSHMATAHA,OFFICE NO. 2 ANTLERS PUBLIC SCHOOLS,COREY M BOUFFLEUR,,640003,1,12,76,89,OFFICE NO. 2 ANTLERS PUBLIC SCHOOLS
PUSHMATAHA,OFFICE NO. 2 ANTLERS PUBLIC SCHOOLS,VICKIE LEATHERS,,640003,1,5,33,39,OFFICE NO. 2 ANTLERS PUBLIC SCHOOLS
PUSHMATAHA,OFFICE NO. 2 RATTAN PUBLIC SCHOOLS,CHANCE LAWLESS,,640003,0,0,9,9,OFFICE NO. 2 RATTAN PUBLIC SCHOOLS
PUSHMATAHA,OFFICE NO. 2 RATTAN PUBLIC SCHOOLS,VALERIE CLAY MERIDA,,640003,0,0,6,6,OFFICE NO. 2 RATTAN PUBLIC SCHOOLS
PUSHMATAHA,OFFICE NO. 2 ANTLERS PUBLIC SCHOOLS,COREY M BOUFFLEUR,,640004,1,18,105,124,OFFICE NO. 2 ANTLERS PUBLIC SCHOOLS
PUSHMATAHA,OFFICE NO. 2 ANTLERS PUBLIC SCHOOLS,VICKIE LEATHERS,,640004,5,20,72,97,OFFICE NO. 2 ANTLERS PUBLIC SCHOOLS
PUSHMATAHA,OFFICE NO. 2 RATTAN PUBLIC SCHOOLS,CHANCE LAWLESS,,640004,0,0,0,0,OFFICE NO. 2 RATTAN PUBLIC SCHOOLS
PUSHMATAHA,OFFICE NO. 2 RATTAN PUBLIC SCHOOLS,VALERIE CLAY MERIDA,,640004,0,0,2,2,OFFICE NO. 2 RATTAN PUBLIC SCHOOLS
PUSHMATAHA,OFFICE NO. 2 ANTLERS PUBLIC SCHOOLS,COREY M BOUFFLEUR,,640007,0,0,0,0,OFFICE NO. 2 ANTLERS PUBLIC SCHOOLS
PUSHMATAHA,OFFICE NO. 2 ANTLERS PUBLIC SCHOOLS,VICKIE LEATHERS,,640007,0,0,0,0,OFFICE NO. 2 ANTLERS PUBLIC SCHOOLS
PUSHMATAHA,OFFICE NO. 2 ANTLERS PUBLIC SCHOOLS,COREY M BOUFFLEUR,,640008,0,3,38,41,OFFICE NO. 2 ANTLERS PUBLIC SCHOOLS
PUSHMATAHA,OFFICE NO. 2 ANTLERS PUBLIC SCHOOLS,VICKIE LEATHERS,,640008,0,3,15,18,OFFICE NO. 2 ANTLERS PUBLIC SCHOOLS
PUSHMATAHA,OFFICE NO. 2 RATTAN PUBLIC SCHOOLS,CHANCE LAWLESS,,640008,0,0,0,0,OFFICE NO. 2 RATTAN PUBLIC SCHOOLS
PUSHMATAHA,OFFICE NO. 2 RATTAN PUBLIC SCHOOLS,VALERIE CLAY MERIDA,,640008,0,0,0,0,OFFICE NO. 2 RATTAN PUBLIC SCHOOLS
PUSHMATAHA,OFFICE NO. 2 ANTLERS PUBLIC SCHOOLS,COREY M BOUFFLEUR,,640009,0,1,0,1,OFFICE NO. 2 ANTLERS PUBLIC SCHOOLS
PUSHMATAHA,OFFICE NO. 2 ANTLERS PUBLIC SCHOOLS,VICKIE LEATHERS,,640009,0,0,0,0,OFFICE NO. 2 ANTLERS PUBLIC SCHOOLS
PUSHMATAHA,OFFICE NO. 2 ANTLERS PUBLIC SCHOOLS,COREY M BOUFFLEUR,,640010,0,0,28,28,OFFICE NO. 2 ANTLERS PUBLIC SCHOOLS
PUSHMATAHA,OFFICE NO. 2 ANTLERS PUBLIC SCHOOLS,VICKIE LEATHERS,,640010,0,0,9,9,OFFICE NO. 2 ANTLERS PUBLIC SCHOOLS
PUSHMATAHA,OFFICE NO. 2 ANTLERS PUBLIC SCHOOLS,COREY M BOUFFLEUR,,640011,0,0,0,0,OFFICE NO. 2 ANTLERS PUBLIC SCHOOLS
PUSHMATAHA,OFFICE NO. 2 ANTLERS PUBLIC SCHOOLS,VICKIE LEATHERS,,640011,0,0,0,0,OFFICE NO. 2 ANTLERS PUBLIC SCHOOLS
PUSHMATAHA,OFFICE NO. 2 RATTAN PUBLIC SCHOOLS,CHANCE LAWLESS,,640011,0,0,110,110,OFFICE NO. 2 RATTAN PUBLIC SCHOOLS
PUSHMATAHA,OFFICE NO. 2 RATTAN PUBLIC SCHOOLS,VALERIE CLAY MERIDA,,640011,3,2,112,117,OFFICE NO. 2 RATTAN PUBLIC SCHOOLS
PUSHMATAHA,OFFICE NO. 2 RATTAN PUBLIC SCHOOLS,CHANCE LAWLESS,,640012,0,0,6,6,OFFICE NO. 2 RATTAN PUBLIC SCHOOLS
PUSHMATAHA,OFFICE NO. 2 RATTAN PUBLIC SCHOOLS,VALERIE CLAY MERIDA,,640012,0,1,41,42,OFFICE NO. 2 RATTAN PUBLIC SCHOOLS
PUSHMATAHA,OFFICE NO. 2 BATTIEST PUBLIC SCHOOLS,JAMES HAMILTON,,640014,0,0,0,0,OFFICE NO. 2 BATTIEST PUBLIC SCHOOLS
PUSHMATAHA,OFFICE NO. 2 BATTIEST PUBLIC SCHOOLS,JEFF PERRIN,,640014,0,0,0,0,OFFICE NO. 2 BATTIEST PUBLIC SCHOOLS
PUSHMATAHA,OFFICE NO. 2 ANTLERS PUBLIC SCHOOLS,COREY M BOUFFLEUR,,640014,0,0,0,0,OFFICE NO. 2 ANTLERS PUBLIC SCHOOLS
PUSHMATAHA,OFFICE NO. 2 ANTLERS PUBLIC SCHOOLS,VICKIE LEATHERS,,640014,0,0,0,0,OFFICE NO. 2 ANTLERS PUBLIC SCHOOLS
PUSHMATAHA,OFFICE NO. 2 RATTAN PUBLIC SCHOOLS,CHANCE LAWLESS,,640014,0,0,20,20,OFFICE NO. 2 RATTAN PUBLIC SCHOOLS
PUSHMATAHA,OFFICE NO. 2 RATTAN PUBLIC SCHOOLS,VALERIE CLAY MERIDA,,640014,0,1,11,12,OFFICE NO. 2 RATTAN PUBLIC SCHOOLS
ROGER MILLS,OFFICE NO. 2 SWEETWATER PUBLIC SCHOOLS,FLOYD PICKERING,,650101,0,0,12,12,OFFICE NO. 2 SWEETWATER PUBLIC SCHOOLS
ROGER MILLS,OFFICE NO. 2 SWEETWATER PUBLIC SCHOOLS,BOB CAREY,,650101,0,0,16,16,OFFICE NO. 2 SWEETWATER PUBLIC SCHOOLS
ROGER MILLS,OFFICE NO. 2 WESTERN TECH CENTER,GARY D. SMITH,,650101,0,0,17,17,OFFICE NO. 2 WESTERN TECH CENTER
ROGER MILLS,OFFICE NO. 2 WESTERN TECH CENTER,BILL JOHANNING,,650101,0,0,6,6,OFFICE NO. 2 WESTERN TECH CENTER
ROGER MILLS,OFFICE NO. 2 SAYRE PUBLIC SCHOOLS,MATT THORNBROUGH,,650102,0,0,1,1,OFFICE NO. 2 SAYRE PUBLIC SCHOOLS
ROGER MILLS,OFFICE NO. 2 SAYRE PUBLIC SCHOOLS,BRIAN CHAPMAN,,650102,0,0,0,0,OFFICE NO. 2 SAYRE PUBLIC SCHOOLS
ROGER MILLS,OFFICE NO. 2 WESTERN TECH CENTER,GARY D. SMITH,,650102,0,0,0,0,OFFICE NO. 2 WESTERN TECH CENTER
ROGER MILLS,OFFICE NO. 2 WESTERN TECH CENTER,BILL JOHANNING,,650102,0,0,1,1,OFFICE NO. 2 WESTERN TECH CENTER
ROGER MILLS,OFFICE NO. 2 HAMMON PUBLIC SCHOOLS,VIC McCALLAY,,650201,2,2,122,126,OFFICE NO. 2 HAMMON PUBLIC SCHOOLS
ROGER MILLS,OFFICE NO. 2 HAMMON PUBLIC SCHOOLS,RECTOR CANDY,,650201,0,0,50,50,OFFICE NO. 2 HAMMON PUBLIC SCHOOLS
ROGER MILLS,OFFICE NO. 2 WESTERN TECH CENTER,GARY D. SMITH,,650201,2,1,139,142,OFFICE NO. 2 WESTERN TECH CENTER
ROGER MILLS,OFFICE NO. 2 WESTERN TECH CENTER,BILL JOHANNING,,650201,0,0,22,22,OFFICE NO. 2 WESTERN TECH CENTER
ROGER MILLS,OFFICE NO. 2 HAMMON PUBLIC SCHOOLS,VIC McCALLAY,,650202,0,0,3,3,OFFICE NO. 2 HAMMON PUBLIC SCHOOLS
ROGER MILLS,OFFICE NO. 2 HAMMON PUBLIC SCHOOLS,RECTOR CANDY,,650202,0,0,0,0,OFFICE NO. 2 HAMMON PUBLIC SCHOOLS
ROGER MILLS,OFFICE NO. 2 WESTERN TECH CENTER,GARY D. SMITH,,650202,0,0,1,1,OFFICE NO. 2 WESTERN TECH CENTER
ROGER MILLS,OFFICE NO. 2 WESTERN TECH CENTER,BILL JOHANNING,,650202,0,0,0,0,OFFICE NO. 2 WESTERN TECH CENTER
ROGER MILLS,OFFICE NO. 2 HAMMON PUBLIC SCHOOLS,VIC McCALLAY,,650203,0,0,0,0,OFFICE NO. 2 HAMMON PUBLIC SCHOOLS
ROGER MILLS,OFFICE NO. 2 HAMMON PUBLIC SCHOOLS,RECTOR CANDY,,650203,2,0,0,2,OFFICE NO. 2 HAMMON PUBLIC SCHOOLS
ROGER MILLS,OFFICE NO. 2 WESTERN TECH CENTER,GARY D. SMITH,,650203,0,0,0,0,OFFICE NO. 2 WESTERN TECH CENTER
ROGER MILLS,OFFICE NO. 2 WESTERN TECH CENTER,BILL JOHANNING,,650203,2,0,0,2,OFFICE NO. 2 WESTERN TECH CENTER
ROGER MILLS,OFFICE NO. 2 HAMMON PUBLIC SCHOOLS,VIC McCALLAY,,650302,0,0,0,0,OFFICE NO. 2 HAMMON PUBLIC SCHOOLS
ROGER MILLS,OFFICE NO. 2 HAMMON PUBLIC SCHOOLS,RECTOR CANDY,,650302,0,0,0,0,OFFICE NO. 2 HAMMON PUBLIC SCHOOLS
ROGER MILLS,OFFICE NO. 2 WESTERN TECH CENTER,GARY D. SMITH,,650302,0,0,0,0,OFFICE NO. 2 WESTERN TECH CENTER
ROGER MILLS,OFFICE NO. 2 WESTERN TECH CENTER,BILL JOHANNING,,650302,0,0,0,0,OFFICE NO. 2 WESTERN TECH CENTER
ROGERS,OFFICE NO. 2 NORTHEAST TECH CENTER,BILLY F. HENDRICKSON,,660001,6,0,12,18,OFFICE NO. 2 NORTHEAST TECH CENTER
ROGERS,OFFICE NO. 2 NORTHEAST TECH CENTER,SHERMAN WEAVER,,660001,5,0,8,13,OFFICE NO. 2 NORTHEAST TECH CENTER
ROGERS,OFFICE NO. 2 NORTHEAST TECH CENTER,BILLY F. HENDRICKSON,,660002,1,0,4,5,OFFICE NO. 2 NORTHEAST TECH CENTER
ROGERS,OFFICE NO. 2 NORTHEAST TECH CENTER,SHERMAN WEAVER,,660002,1,0,3,4,OFFICE NO. 2 NORTHEAST TECH CENTER
ROGERS,OFFICE NO. 2 NORTHEAST TECH CENTER,BILLY F. HENDRICKSON,,660003,5,0,1,6,OFFICE NO. 2 NORTHEAST TECH CENTER
ROGERS,OFFICE NO. 2 NORTHEAST TECH CENTER,SHERMAN WEAVER,,660003,3,0,4,7,OFFICE NO. 2 NORTHEAST TECH CENTER
ROGERS,OFFICE NO. 2 NORTHEAST TECH CENTER,BILLY F. HENDRICKSON,,660004,1,2,14,17,OFFICE NO. 2 NORTHEAST TECH CENTER
ROGERS,OFFICE NO. 2 NORTHEAST TECH CENTER,SHERMAN WEAVER,,660004,1,0,6,7,OFFICE NO. 2 NORTHEAST TECH CENTER
ROGERS,OFFICE NO. 2 NORTHEAST TECH CENTER,BILLY F. HENDRICKSON,,660005,0,1,5,6,OFFICE NO. 2 NORTHEAST TECH CENTER
ROGERS,OFFICE NO. 2 NORTHEAST TECH CENTER,SHERMAN WEAVER,,660005,0,0,5,5,OFFICE NO. 2 NORTHEAST TECH CENTER
ROGERS,OFFICE NO. 2 NORTHEAST TECH CENTER,BILLY F. HENDRICKSON,,660006,1,0,1,2,OFFICE NO. 2 NORTHEAST TECH CENTER
ROGERS,OFFICE NO. 2 NORTHEAST TECH CENTER,SHERMAN WEAVER,,660006,1,1,0,2,OFFICE NO. 2 NORTHEAST TECH CENTER
ROGERS,OFFICE NO. 2 COLLINSVILLE PUBLIC SCHOOLS,C. KEVIN MORRISON,,660006,0,0,0,0,OFFICE NO. 2 COLLINSVILLE PUBLIC SCHOOLS
ROGERS,OFFICE NO. 2 COLLINSVILLE PUBLIC SCHOOLS,TIM BESS,,660006,1,0,1,2,OFFICE NO. 2 COLLINSVILLE PUBLIC SCHOOLS
ROGERS,OFFICE NO. 2 NORTHEAST TECH CENTER,BILLY F. HENDRICKSON,,660007,1,0,14,15,OFFICE NO. 2 NORTHEAST TECH CENTER
ROGERS,OFFICE NO. 2 NORTHEAST TECH CENTER,SHERMAN WEAVER,,660007,0,1,6,7,OFFICE NO. 2 NORTHEAST TECH CENTER
ROGERS,OFFICE NO. 2 NORTHEAST TECH CENTER,BILLY F. HENDRICKSON,,660008,12,0,18,30,OFFICE NO. 2 NORTHEAST TECH CENTER
ROGERS,OFFICE NO. 2 NORTHEAST TECH CENTER,SHERMAN WEAVER,,660008,7,1,7,15,OFFICE NO. 2 NORTHEAST TECH CENTER
ROGERS,OFFICE NO. 2 NORTHEAST TECH CENTER,BILLY F. HENDRICKSON,,660009,0,0,4,4,OFFICE NO. 2 NORTHEAST TECH CENTER
ROGERS,OFFICE NO. 2 NORTHEAST TECH CENTER,SHERMAN WEAVER,,660009,0,2,4,6,OFFICE NO. 2 NORTHEAST TECH CENTER
ROGERS,OFFICE NO. 2 OOLOGAH-TALALA PUBLIC SCHOOLS,TY KNOTT,,660009,0,0,3,3,OFFICE NO. 2 OOLOGAH-TALALA PUBLIC SCHOOLS
ROGERS,OFFICE NO. 2 OOLOGAH-TALALA PUBLIC SCHOOLS,BRIAN WIGGINTON,,660009,0,2,5,7,OFFICE NO. 2 OOLOGAH-TALALA PUBLIC SCHOOLS
ROGERS,OFFICE NO. 2 NORTHEAST TECH CENTER,BILLY F. HENDRICKSON,,660010,0,0,0,0,OFFICE NO. 2 NORTHEAST TECH CENTER
ROGERS,OFFICE NO. 2 NORTHEAST TECH CENTER,SHERMAN WEAVER,,660010,0,0,0,0,OFFICE NO. 2 NORTHEAST TECH CENTER
ROGERS,OFFICE NO. 2 NORTHEAST TECH CENTER,BILLY F. HENDRICKSON,,660011,0,0,18,18,OFFICE NO. 2 NORTHEAST TECH CENTER
ROGERS,OFFICE NO. 2 NORTHEAST TECH CENTER,SHERMAN WEAVER,,660011,1,0,8,9,OFFICE NO. 2 NORTHEAST TECH CENTER
ROGERS,OFFICE NO. 2 OOLOGAH-TALALA PUBLIC SCHOOLS,TY KNOTT,,660011,0,0,0,0,OFFICE NO. 2 OOLOGAH-TALALA PUBLIC SCHOOLS
ROGERS,OFFICE NO. 2 OOLOGAH-TALALA PUBLIC SCHOOLS,BRIAN WIGGINTON,,660011,1,0,0,1,OFFICE NO. 2 OOLOGAH-TALALA PUBLIC SCHOOLS
ROGERS,OFFICE NO. 2 NORTHEAST TECH CENTER,BILLY F. HENDRICKSON,,660012,0,0,4,4,OFFICE NO. 2 NORTHEAST TECH CENTER
ROGERS,OFFICE NO. 2 NORTHEAST TECH CENTER,SHERMAN WEAVER,,660012,0,0,4,4,OFFICE NO. 2 NORTHEAST TECH CENTER
ROGERS,OFFICE NO. 2 NORTHEAST TECH CENTER,BILLY F. HENDRICKSON,,660013,0,0,11,11,OFFICE NO. 2 NORTHEAST TECH CENTER
ROGERS,OFFICE NO. 2 NORTHEAST TECH CENTER,SHERMAN WEAVER,,660013,1,0,4,5,OFFICE NO. 2 NORTHEAST TECH CENTER
ROGERS,OFFICE NO. 2 NORTHEAST TECH CENTER,BILLY F. HENDRICKSON,,660014,3,0,11,14,OFFICE NO. 2 NORTHEAST TECH CENTER
ROGERS,OFFICE NO. 2 NORTHEAST TECH CENTER,SHERMAN WEAVER,,660014,0,0,10,10,OFFICE NO. 2 NORTHEAST TECH CENTER
ROGERS,OFFICE NO. 2 NORTHEAST TECH CENTER,BILLY F. HENDRICKSON,,660015,7,1,73,81,OFFICE NO. 2 NORTHEAST TECH CENTER
ROGERS,OFFICE NO. 2 NORTHEAST TECH CENTER,SHERMAN WEAVER,,660015,1,1,33,35,OFFICE NO. 2 NORTHEAST TECH CENTER
ROGERS,OFFICE NO. 2 OOLOGAH-TALALA PUBLIC SCHOOLS,TY KNOTT,,660015,0,0,36,36,OFFICE NO. 2 OOLOGAH-TALALA PUBLIC SCHOOLS
ROGERS,OFFICE NO. 2 OOLOGAH-TALALA PUBLIC SCHOOLS,BRIAN WIGGINTON,,660015,8,2,73,83,OFFICE NO. 2 OOLOGAH-TALALA PUBLIC SCHOOLS
ROGERS,OFFICE NO. 2 NORTHEAST TECH CENTER,BILLY F. HENDRICKSON,,660017,0,0,15,15,OFFICE NO. 2 NORTHEAST TECH CENTER
ROGERS,OFFICE NO. 2 NORTHEAST TECH CENTER,SHERMAN WEAVER,,660017,0,0,5,5,OFFICE NO. 2 NORTHEAST TECH CENTER
ROGERS,OFFICE NO. 2 OOLOGAH-TALALA PUBLIC SCHOOLS,TY KNOTT,,660017,0,0,6,6,OFFICE NO. 2 OOLOGAH-TALALA PUBLIC SCHOOLS
ROGERS,OFFICE NO. 2 OOLOGAH-TALALA PUBLIC SCHOOLS,BRIAN WIGGINTON,,660017,0,0,10,10,OFFICE NO. 2 OOLOGAH-TALALA PUBLIC SCHOOLS
ROGERS,OFFICE NO. 2 NORTHEAST TECH CENTER,BILLY F. HENDRICKSON,,660018,1,0,12,13,OFFICE NO. 2 NORTHEAST TECH CENTER
ROGERS,OFFICE NO. 2 NORTHEAST TECH CENTER,SHERMAN WEAVER,,660018,2,0,11,13,OFFICE NO. 2 NORTHEAST TECH CENTER
ROGERS,OFFICE NO. 2 OOLOGAH-TALALA PUBLIC SCHOOLS,TY KNOTT,,660018,0,0,4,4,OFFICE NO. 2 OOLOGAH-TALALA PUBLIC SCHOOLS
ROGERS,OFFICE NO. 2 OOLOGAH-TALALA PUBLIC SCHOOLS,BRIAN WIGGINTON,,660018,2,0,8,10,OFFICE NO. 2 OOLOGAH-TALALA PUBLIC SCHOOLS
ROGERS,OFFICE NO. 2 NORTHEAST TECH CENTER,BILLY F. HENDRICKSON,,660019,0,0,5,5,OFFICE NO. 2 NORTHEAST TECH CENTER
ROGERS,OFFICE NO. 2 NORTHEAST TECH CENTER,SHERMAN WEAVER,,660019,1,0,6,7,OFFICE NO. 2 NORTHEAST TECH CENTER
ROGERS,OFFICE NO. 2 NORTHEAST TECH CENTER,BILLY F. HENDRICKSON,,660020,2,0,5,7,OFFICE NO. 2 NORTHEAST TECH CENTER
ROGERS,OFFICE NO. 2 NORTHEAST TECH CENTER,SHERMAN WEAVER,,660020,2,0,10,12,OFFICE NO. 2 NORTHEAST TECH CENTER
ROGERS,OFFICE NO. 2 NORTHEAST TECH CENTER,BILLY F. HENDRICKSON,,660021,1,0,2,3,OFFICE NO. 2 NORTHEAST TECH CENTER
ROGERS,OFFICE NO. 2 NORTHEAST TECH CENTER,SHERMAN WEAVER,,660021,1,0,3,4,OFFICE NO. 2 NORTHEAST TECH CENTER
ROGERS,OFFICE NO. 2 NORTHEAST TECH CENTER,BILLY F. HENDRICKSON,,660022,0,0,15,15,OFFICE NO. 2 NORTHEAST TECH CENTER
ROGERS,OFFICE NO. 2 NORTHEAST TECH CENTER,SHERMAN WEAVER,,660022,0,0,6,6,OFFICE NO. 2 NORTHEAST TECH CENTER
ROGERS,OFFICE NO. 2 NORTHEAST TECH CENTER,BILLY F. HENDRICKSON,,660023,2,1,52,55,OFFICE NO. 2 NORTHEAST TECH CENTER
ROGERS,OFFICE NO. 2 NORTHEAST TECH CENTER,SHERMAN WEAVER,,660023,1,0,9,10,OFFICE NO. 2 NORTHEAST TECH CENTER
ROGERS,OFFICE NO. 2 NORTHEAST TECH CENTER,BILLY F. HENDRICKSON,,660024,0,2,42,44,OFFICE NO. 2 NORTHEAST TECH CENTER
ROGERS,OFFICE NO. 2 NORTHEAST TECH CENTER,SHERMAN WEAVER,,660024,0,0,9,9,OFFICE NO. 2 NORTHEAST TECH CENTER
ROGERS,OFFICE NO. 2 OOLOGAH-TALALA PUBLIC SCHOOLS,TY KNOTT,,660024,0,0,28,28,OFFICE NO. 2 OOLOGAH-TALALA PUBLIC SCHOOLS
ROGERS,OFFICE NO. 2 OOLOGAH-TALALA PUBLIC SCHOOLS,BRIAN WIGGINTON,,660024,0,2,26,28,OFFICE NO. 2 OOLOGAH-TALALA PUBLIC SCHOOLS
ROGERS,OFFICE NO. 2 NORTHEAST TECH CENTER,BILLY F. HENDRICKSON,,660026,4,0,12,16,OFFICE NO. 2 NORTHEAST TECH CENTER
ROGERS,OFFICE NO. 2 NORTHEAST TECH CENTER,SHERMAN WEAVER,,660026,2,0,2,4,OFFICE NO. 2 NORTHEAST TECH CENTER
ROGERS,OFFICE NO. 2 NORTHEAST TECH CENTER,BILLY F. HENDRICKSON,,660027,0,0,6,6,OFFICE NO. 2 NORTHEAST TECH CENTER
ROGERS,OFFICE NO. 2 NORTHEAST TECH CENTER,SHERMAN WEAVER,,660027,1,1,4,6,OFFICE NO. 2 NORTHEAST TECH CENTER
ROGERS,OFFICE NO. 2 NORTHEAST TECH CENTER,BILLY F. HENDRICKSON,,660029,0,0,1,1,OFFICE NO. 2 NORTHEAST TECH CENTER
ROGERS,OFFICE NO. 2 NORTHEAST TECH CENTER,SHERMAN WEAVER,,660029,1,0,0,1,OFFICE NO. 2 NORTHEAST TECH CENTER
ROGERS,OFFICE NO. 2 NORTHEAST TECH CENTER,BILLY F. HENDRICKSON,,660030,1,0,8,9,OFFICE NO. 2 NORTHEAST TECH CENTER
ROGERS,OFFICE NO. 2 NORTHEAST TECH CENTER,SHERMAN WEAVER,,660030,3,0,1,4,OFFICE NO. 2 NORTHEAST TECH CENTER
ROGERS,COUNCIL MEMBER WARD 3 CITY OF OWASSO,RANDY COWLING,,660031,0,0,2,2,COUNCIL MEMBER WARD 3 CITY OF OWASSO
ROGERS,COUNCIL MEMBER WARD 3 CITY OF OWASSO,JC PRINCE,,660031,0,0,1,1,COUNCIL MEMBER WARD 3 CITY OF OWASSO
ROGERS,COUNCIL MEMBER WARD 3 CITY OF OWASSO,BILL BUSH,,660031,0,0,12,12,COUNCIL MEMBER WARD 3 CITY OF OWASSO
ROGERS,OFFICE NO. 2 NORTHEAST TECH CENTER,BILLY F. HENDRICKSON,,660031,3,0,11,14,OFFICE NO. 2 NORTHEAST TECH CENTER
ROGERS,OFFICE NO. 2 NORTHEAST TECH CENTER,SHERMAN WEAVER,,660031,2,2,7,11,OFFICE NO. 2 NORTHEAST TECH CENTER
ROGERS,OFFICE NO. 2 NORTHEAST TECH CENTER,BILLY F. HENDRICKSON,,660032,6,0,7,13,OFFICE NO. 2 NORTHEAST TECH CENTER
ROGERS,OFFICE NO. 2 NORTHEAST TECH CENTER,SHERMAN WEAVER,,660032,3,0,7,10,OFFICE NO. 2 NORTHEAST TECH CENTER
ROGERS,OFFICE NO. 2 OOLOGAH-TALALA PUBLIC SCHOOLS,TY KNOTT,,660032,0,0,0,0,OFFICE NO. 2 OOLOGAH-TALALA PUBLIC SCHOOLS
ROGERS,OFFICE NO. 2 OOLOGAH-TALALA PUBLIC SCHOOLS,BRIAN WIGGINTON,,660032,0,0,3,3,OFFICE NO. 2 OOLOGAH-TALALA PUBLIC SCHOOLS
ROGERS,OFFICE NO. 2 COLLINSVILLE PUBLIC SCHOOLS,C. KEVIN MORRISON,,660032,4,0,0,4,OFFICE NO. 2 COLLINSVILLE PUBLIC SCHOOLS
ROGERS,OFFICE NO. 2 COLLINSVILLE PUBLIC SCHOOLS,TIM BESS,,660032,5,0,12,17,OFFICE NO. 2 COLLINSVILLE PUBLIC SCHOOLS
ROGERS,OFFICE NO. 2 NORTHEAST TECH CENTER,BILLY F. HENDRICKSON,,660033,3,0,11,14,OFFICE NO. 2 NORTHEAST TECH CENTER
ROGERS,OFFICE NO. 2 NORTHEAST TECH CENTER,SHERMAN WEAVER,,660033,1,0,6,7,OFFICE NO. 2 NORTHEAST TECH CENTER
ROGERS,OFFICE NO. 2 OOLOGAH-TALALA PUBLIC SCHOOLS,TY KNOTT,,660033,1,0,7,8,OFFICE NO. 2 OOLOGAH-TALALA PUBLIC SCHOOLS
ROGERS,OFFICE NO. 2 OOLOGAH-TALALA PUBLIC SCHOOLS,BRIAN WIGGINTON,,660033,3,0,12,15,OFFICE NO. 2 OOLOGAH-TALALA PUBLIC SCHOOLS
ROGERS,OFFICE NO. 2 NORTHEAST TECH CENTER,BILLY F. HENDRICKSON,,660110,0,0,5,5,OFFICE NO. 2 NORTHEAST TECH CENTER
ROGERS,OFFICE NO. 2 NORTHEAST TECH CENTER,SHERMAN WEAVER,,660110,0,0,2,2,OFFICE NO. 2 NORTHEAST TECH CENTER
ROGERS,OFFICE NO. 2 NORTHEAST TECH CENTER,BILLY F. HENDRICKSON,,660116,0,0,33,33,OFFICE NO. 2 NORTHEAST TECH CENTER
ROGERS,OFFICE NO. 2 NORTHEAST TECH CENTER,SHERMAN WEAVER,,660116,0,0,16,16,OFFICE NO. 2 NORTHEAST TECH CENTER
ROGERS,OFFICE NO. 2 OOLOGAH-TALALA PUBLIC SCHOOLS,TY KNOTT,,660116,0,0,13,13,OFFICE NO. 2 OOLOGAH-TALALA PUBLIC SCHOOLS
ROGERS,OFFICE NO. 2 OOLOGAH-TALALA PUBLIC SCHOOLS,BRIAN WIGGINTON,,660116,0,0,37,37,OFFICE NO. 2 OOLOGAH-TALALA PUBLIC SCHOOLS
ROGERS,OFFICE NO. 2 NORTHEAST TECH CENTER,BILLY F. HENDRICKSON,,660120,2,0,7,9,OFFICE NO. 2 NORTHEAST TECH CENTER
ROGERS,OFFICE NO. 2 NORTHEAST TECH CENTER,SHERMAN WEAVER,,660120,0,0,5,5,OFFICE NO. 2 NORTHEAST TECH CENTER
ROGERS,COUNCIL MEMBER WARD 3 CITY OF OWASSO,RANDY COWLING,,660130,0,0,7,7,COUNCIL MEMBER WARD 3 CITY OF OWASSO
ROGERS,COUNCIL MEMBER WARD 3 CITY OF OWASSO,JC PRINCE,,660130,0,0,3,3,COUNCIL MEMBER WARD 3 CITY OF OWASSO
ROGERS,COUNCIL MEMBER WARD 3 CITY OF OWASSO,BILL BUSH,,660130,2,0,28,30,COUNCIL MEMBER WARD 3 CITY OF OWASSO
ROGERS,OFFICE NO. 2 NORTHEAST TECH CENTER,BILLY F. HENDRICKSON,,660130,8,0,26,34,OFFICE NO. 2 NORTHEAST TECH CENTER
ROGERS,OFFICE NO. 2 NORTHEAST TECH CENTER,SHERMAN WEAVER,,660130,7,1,19,27,OFFICE NO. 2 NORTHEAST TECH CENTER
SEMINOLE,MAYOR CITY OF SEMINOLE,LEE RANDLE,,670010,1,2,79,82,
SEMINOLE,MAYOR CITY OF SEMINOLE,MICHAEL LEONARD,,670010,0,0,23,23,
SEMINOLE,MAYOR CITY OF SEMINOLE,CHAYNE FISHER,,670010,4,6,187,197,
SEMINOLE,COUNCILMEMBER WARD 1 CITY OF SEMINOLE,WILLIAM C. WANTLAND,,670010,1,0,21,22,COUNCILMEMBER WARD 1 CITY OF SEMINOLE
SEMINOLE,COUNCILMEMBER WARD 1 CITY OF SEMINOLE,ANTHONY DAVIDSON,,670010,0,1,26,27,COUNCILMEMBER WARD 1 CITY OF SEMINOLE
SEMINOLE,COUNCILMEMBER WARD 2 CITY OF SEMINOLE,MARTHA LEONARD,,670010,0,0,18,18,COUNCILMEMBER WARD 2 CITY OF SEMINOLE
SEMINOLE,COUNCILMEMBER WARD 2 CITY OF SEMINOLE,JOSHUA L. PYRON,,670010,1,1,30,32,COUNCILMEMBER WARD 2 CITY OF SEMINOLE
SEMINOLE,COUNCILMEMBER WARD 2 CITY OF SEMINOLE,STEPHANEY LAMBERT,,670010,1,0,22,23,COUNCILMEMBER WARD 2 CITY OF SEMINOLE
SEMINOLE,COUNCILMEMBER WARD 3 CITY OF SEMINOLE,TIM L. POPLIN,,670010,1,5,110,116,COUNCILMEMBER WARD 3 CITY OF SEMINOLE
SEMINOLE,COUNCILMEMBER WARD 3 CITY OF SEMINOLE,ALVIN BARNES,,670010,0,0,8,8,COUNCILMEMBER WARD 3 CITY OF SEMINOLE
SEMINOLE,COUNCILMEMBER WARD 3 CITY OF SEMINOLE,STEVEN LOCKEY,,670010,0,0,5,5,COUNCILMEMBER WARD 3 CITY OF SEMINOLE
SEMINOLE,COUNCILMEMBER WARD 3 CITY OF SEMINOLE,DAVID HOFFMEIER,,670010,0,0,12,12,COUNCILMEMBER WARD 3 CITY OF SEMINOLE
SEMINOLE,OFFICE NO. 2 BOWLEGS PUBLIC SCHOOLS,TIM GENTRY,,670010,0,0,0,0,OFFICE NO. 2 BOWLEGS PUBLIC SCHOOLS
SEMINOLE,OFFICE NO. 2 BOWLEGS PUBLIC SCHOOLS,JEREMY W ELLIOTT,,670010,0,1,0,1,OFFICE NO. 2 BOWLEGS PUBLIC SCHOOLS
SEMINOLE,OFFICE NO. 2 SEMINOLE PUBLIC SCHOOLS,LINDA HAMPTON,,670010,3,6,203,212,OFFICE NO. 2 SEMINOLE PUBLIC SCHOOLS
SEMINOLE,OFFICE NO. 2 SEMINOLE PUBLIC SCHOOLS,JERRY CALLAHAN,,670010,0,0,11,11,OFFICE NO. 2 SEMINOLE PUBLIC SCHOOLS
SEMINOLE,OFFICE NO. 2 SEMINOLE PUBLIC SCHOOLS,REBECCA LEONARD,,670010,0,0,24,24,OFFICE NO. 2 SEMINOLE PUBLIC SCHOOLS
SEMINOLE,OFFICE NO. 2 SEMINOLE PUBLIC SCHOOLS,STEVEN L. CHOATE,,670010,2,2,52,56,OFFICE NO. 2 SEMINOLE PUBLIC SCHOOLS
SEMINOLE,OFFICE NO. 2 VARNUM PUBLIC SCHOOLS,THOMASENE DAVIS,,670010,0,0,0,0,OFFICE NO. 2 VARNUM PUBLIC SCHOOLS
SEMINOLE,OFFICE NO. 2 VARNUM PUBLIC SCHOOLS,AMY MICHELLE PORTER,,670010,0,0,0,0,OFFICE NO. 2 VARNUM PUBLIC SCHOOLS
SEMINOLE,COUNCILMEMBER WARD 1 (UNEXPIRED TERM) CITY OF KONAWA,JOSEPH L SCOGGINS JR,,670014,1,0,13,14,COUNCILMEMBER WARD 1 (UNEXPIRED TERM) CITY OF KONAWA
SEMINOLE,COUNCILMEMBER WARD 1 (UNEXPIRED TERM) CITY OF KONAWA,JAMES M. BLACKWOOD,,670014,0,0,20,20,COUNCILMEMBER WARD 1 (UNEXPIRED TERM) CITY OF KONAWA
SEMINOLE,COUNCILMEMBER WARD 1 (UNEXPIRED TERM) CITY OF KONAWA,BOB BISHOP,,670014,3,0,24,27,COUNCILMEMBER WARD 1 (UNEXPIRED TERM) CITY OF KONAWA
SEMINOLE,PROPOSITION CITY OF KONAWA,FOR THE PROPOSITION - YES,,670014,0,0,9,9,
SEMINOLE,PROPOSITION CITY OF KONAWA,AGAINST THE PROPOSITION - NO,,670014,4,0,50,54,
SEMINOLE,OFFICE NO. 2 BOWLEGS PUBLIC SCHOOLS,TIM GENTRY,,670014,0,0,0,0,OFFICE NO. 2 BOWLEGS PUBLIC SCHOOLS
SEMINOLE,OFFICE NO. 2 BOWLEGS PUBLIC SCHOOLS,JEREMY W ELLIOTT,,670014,0,0,1,1,OFFICE NO. 2 BOWLEGS PUBLIC SCHOOLS
SEMINOLE,OFFICE NO. 2 SEMINOLE PUBLIC SCHOOLS,LINDA HAMPTON,,670020,0,0,1,1,OFFICE NO. 2 SEMINOLE PUBLIC SCHOOLS
SEMINOLE,OFFICE NO. 2 SEMINOLE PUBLIC SCHOOLS,JERRY CALLAHAN,,670020,0,0,0,0,OFFICE NO. 2 SEMINOLE PUBLIC SCHOOLS
SEMINOLE,OFFICE NO. 2 SEMINOLE PUBLIC SCHOOLS,REBECCA LEONARD,,670020,0,0,0,0,OFFICE NO. 2 SEMINOLE PUBLIC SCHOOLS
SEMINOLE,OFFICE NO. 2 SEMINOLE PUBLIC SCHOOLS,STEVEN L. CHOATE,,670020,0,0,0,0,OFFICE NO. 2 SEMINOLE PUBLIC SCHOOLS
SEMINOLE,OFFICE NO. 2 STROTHER PUBLIC SCHOOLS,TRAVIS GILLESPIE,,670020,0,0,34,34,OFFICE NO. 2 STROTHER PUBLIC SCHOOLS
SEMINOLE,OFFICE NO. 2 STROTHER PUBLIC SCHOOLS,HEATH SAPP,,670020,2,0,22,24,OFFICE NO. 2 STROTHER PUBLIC SCHOOLS
SEMINOLE,OFFICE NO. 2 VARNUM PUBLIC SCHOOLS,THOMASENE DAVIS,,670020,0,0,23,23,OFFICE NO. 2 VARNUM PUBLIC SCHOOLS
SEMINOLE,OFFICE NO. 2 VARNUM PUBLIC SCHOOLS,AMY MICHELLE PORTER,,670020,0,0,50,50,OFFICE NO. 2 VARNUM PUBLIC SCHOOLS
SEMINOLE,MAYOR CITY OF SEMINOLE,LEE RANDLE,,670022,1,2,24,27,
SEMINOLE,MAYOR CITY OF SEMINOLE,MICHAEL LEONARD,,670022,0,0,7,7,
SEMINOLE,MAYOR CITY OF SEMINOLE,CHAYNE FISHER,,670022,0,1,77,78,
SEMINOLE,COUNCILMEMBER WARD 2 CITY OF SEMINOLE,MARTHA LEONARD,,670022,0,0,6,6,COUNCILMEMBER WARD 2 CITY OF SEMINOLE
SEMINOLE,COUNCILMEMBER WARD 2 CITY OF SEMINOLE,JOSHUA L. PYRON,,670022,1,1,19,21,COUNCILMEMBER WARD 2 CITY OF SEMINOLE
SEMINOLE,COUNCILMEMBER WARD 2 CITY OF SEMINOLE,STEPHANEY LAMBERT,,670022,0,0,35,35,COUNCILMEMBER WARD 2 CITY OF SEMINOLE
SEMINOLE,COUNCILMEMBER WARD 3 CITY OF SEMINOLE,TIM L. POPLIN,,670022,0,2,29,31,COUNCILMEMBER WARD 3 CITY OF SEMINOLE
SEMINOLE,COUNCILMEMBER WARD 3 CITY OF SEMINOLE,ALVIN BARNES,,670022,0,0,4,4,COUNCILMEMBER WARD 3 CITY OF SEMINOLE
SEMINOLE,COUNCILMEMBER WARD 3 CITY OF SEMINOLE,STEVEN LOCKEY,,670022,0,0,3,3,COUNCILMEMBER WARD 3 CITY OF SEMINOLE
SEMINOLE,COUNCILMEMBER WARD 3 CITY OF SEMINOLE,DAVID HOFFMEIER,,670022,0,0,7,7,COUNCILMEMBER WARD 3 CITY OF SEMINOLE
SEMINOLE,OFFICE NO. 2 SEMINOLE PUBLIC SCHOOLS,LINDA HAMPTON,,670022,3,2,100,105,OFFICE NO. 2 SEMINOLE PUBLIC SCHOOLS
SEMINOLE,OFFICE NO. 2 SEMINOLE PUBLIC SCHOOLS,JERRY CALLAHAN,,670022,0,0,5,5,OFFICE NO. 2 SEMINOLE PUBLIC SCHOOLS
SEMINOLE,OFFICE NO. 2 SEMINOLE PUBLIC SCHOOLS,REBECCA LEONARD,,670022,0,0,4,4,OFFICE NO. 2 SEMINOLE PUBLIC SCHOOLS
SEMINOLE,OFFICE NO. 2 SEMINOLE PUBLIC SCHOOLS,STEVEN L. CHOATE,,670022,1,3,21,25,OFFICE NO. 2 SEMINOLE PUBLIC SCHOOLS
SEMINOLE,OFFICE NO. 2 VARNUM PUBLIC SCHOOLS,THOMASENE DAVIS,,670022,1,0,9,10,OFFICE NO. 2 VARNUM PUBLIC SCHOOLS
SEMINOLE,OFFICE NO. 2 VARNUM PUBLIC SCHOOLS,AMY MICHELLE PORTER,,670022,0,1,30,31,OFFICE NO. 2 VARNUM PUBLIC SCHOOLS
SEMINOLE,MAYOR CITY OF SEMINOLE,LEE RANDLE,,670023,1,0,48,49,
SEMINOLE,MAYOR CITY OF SEMINOLE,MICHAEL LEONARD,,670023,0,0,10,10,
SEMINOLE,MAYOR CITY OF SEMINOLE,CHAYNE FISHER,,670023,6,5,185,196,
SEMINOLE,COUNCILMEMBER WARD 1 CITY OF SEMINOLE,WILLIAM C. WANTLAND,,670023,0,0,41,41,COUNCILMEMBER WARD 1 CITY OF SEMINOLE
SEMINOLE,COUNCILMEMBER WARD 1 CITY OF SEMINOLE,ANTHONY DAVIDSON,,670023,2,0,26,28,COUNCILMEMBER WARD 1 CITY OF SEMINOLE
SEMINOLE,OFFICE NO. 2 SEMINOLE PUBLIC SCHOOLS,LINDA HAMPTON,,670023,5,4,181,190,OFFICE NO. 2 SEMINOLE PUBLIC SCHOOLS
SEMINOLE,OFFICE NO. 2 SEMINOLE PUBLIC SCHOOLS,JERRY CALLAHAN,,670023,0,0,10,10,OFFICE NO. 2 SEMINOLE PUBLIC SCHOOLS
SEMINOLE,OFFICE NO. 2 SEMINOLE PUBLIC SCHOOLS,REBECCA LEONARD,,670023,0,0,10,10,OFFICE NO. 2 SEMINOLE PUBLIC SCHOOLS
SEMINOLE,OFFICE NO. 2 SEMINOLE PUBLIC SCHOOLS,STEVEN L. CHOATE,,670023,2,1,42,45,OFFICE NO. 2 SEMINOLE PUBLIC SCHOOLS
SEMINOLE,MAYOR CITY OF SEMINOLE,LEE RANDLE,,670024,0,0,3,3,
SEMINOLE,MAYOR CITY OF SEMINOLE,MICHAEL LEONARD,,670024,0,0,3,3,
SEMINOLE,MAYOR CITY OF SEMINOLE,CHAYNE FISHER,,670024,0,0,2,2,
SEMINOLE,COUNCILMEMBER WARD 1 CITY OF SEMINOLE,WILLIAM C. WANTLAND,,670024,0,0,3,3,COUNCILMEMBER WARD 1 CITY OF SEMINOLE
SEMINOLE,COUNCILMEMBER WARD 1 CITY OF SEMINOLE,ANTHONY DAVIDSON,,670024,0,0,5,5,COUNCILMEMBER WARD 1 CITY OF SEMINOLE
SEMINOLE,COUNCILMEMBER WARD 2 CITY OF SEMINOLE,MARTHA LEONARD,,670024,0,0,0,0,COUNCILMEMBER WARD 2 CITY OF SEMINOLE
SEMINOLE,COUNCILMEMBER WARD 2 CITY OF SEMINOLE,JOSHUA L. PYRON,,670024,0,0,0,0,COUNCILMEMBER WARD 2 CITY OF SEMINOLE
SEMINOLE,COUNCILMEMBER WARD 2 CITY OF SEMINOLE,STEPHANEY LAMBERT,,670024,0,0,0,0,COUNCILMEMBER WARD 2 CITY OF SEMINOLE
SEMINOLE,OFFICE NO. 2 BOWLEGS PUBLIC SCHOOLS,TIM GENTRY,,670024,0,0,26,26,OFFICE NO. 2 BOWLEGS PUBLIC SCHOOLS
SEMINOLE,OFFICE NO. 2 BOWLEGS PUBLIC SCHOOLS,JEREMY W ELLIOTT,,670024,0,0,13,13,OFFICE NO. 2 BOWLEGS PUBLIC SCHOOLS
SEMINOLE,OFFICE NO. 2 SEMINOLE PUBLIC SCHOOLS,LINDA HAMPTON,,670024,1,0,22,23,OFFICE NO. 2 SEMINOLE PUBLIC SCHOOLS
SEMINOLE,OFFICE NO. 2 SEMINOLE PUBLIC SCHOOLS,JERRY CALLAHAN,,670024,0,0,2,2,OFFICE NO. 2 SEMINOLE PUBLIC SCHOOLS
SEMINOLE,OFFICE NO. 2 SEMINOLE PUBLIC SCHOOLS,REBECCA LEONARD,,670024,0,0,4,4,OFFICE NO. 2 SEMINOLE PUBLIC SCHOOLS
SEMINOLE,OFFICE NO. 2 SEMINOLE PUBLIC SCHOOLS,STEVEN L. CHOATE,,670024,0,0,15,15,OFFICE NO. 2 SEMINOLE PUBLIC SCHOOLS
SEMINOLE,OFFICE NO. 2 BOWLEGS PUBLIC SCHOOLS,TIM GENTRY,,670025,0,0,0,0,OFFICE NO. 2 BOWLEGS PUBLIC SCHOOLS
SEMINOLE,OFFICE NO. 2 BOWLEGS PUBLIC SCHOOLS,JEREMY W ELLIOTT,,670025,0,0,5,5,OFFICE NO. 2 BOWLEGS PUBLIC SCHOOLS
SEMINOLE,OFFICE NO. 2 BUTNER PUBLIC SCHOOLS,HOLLIE MURRAY BEELER,,670030,1,1,17,19,OFFICE NO. 2 BUTNER PUBLIC SCHOOLS
SEMINOLE,OFFICE NO. 2 BUTNER PUBLIC SCHOOLS,BUTCH HOUSER,,670030,0,0,16,16,OFFICE NO. 2 BUTNER PUBLIC SCHOOLS
SEMINOLE,OFFICE NO. 2 STROTHER PUBLIC SCHOOLS,TRAVIS GILLESPIE,,670030,0,0,0,0,OFFICE NO. 2 STROTHER PUBLIC SCHOOLS
SEMINOLE,OFFICE NO. 2 STROTHER PUBLIC SCHOOLS,HEATH SAPP,,670030,0,0,0,0,OFFICE NO. 2 STROTHER PUBLIC SCHOOLS
SEMINOLE,MAYOR CITY OF SEMINOLE,LEE RANDLE,,670032,0,0,0,0,
SEMINOLE,MAYOR CITY OF SEMINOLE,MICHAEL LEONARD,,670032,0,0,0,0,
SEMINOLE,MAYOR CITY OF SEMINOLE,CHAYNE FISHER,,670032,0,0,0,0,
SEMINOLE,COUNCILMEMBER WARD 1 CITY OF SEMINOLE,WILLIAM C. WANTLAND,,670032,0,0,0,0,COUNCILMEMBER WARD 1 CITY OF SEMINOLE
SEMINOLE,COUNCILMEMBER WARD 1 CITY OF SEMINOLE,ANTHONY DAVIDSON,,670032,0,0,0,0,COUNCILMEMBER WARD 1 CITY OF SEMINOLE
SEMINOLE,OFFICE NO. 2 BUTNER PUBLIC SCHOOLS,HOLLIE MURRAY BEELER,,670032,0,0,8,8,OFFICE NO. 2 BUTNER PUBLIC SCHOOLS
SEMINOLE,OFFICE NO. 2 BUTNER PUBLIC SCHOOLS,BUTCH HOUSER,,670032,2,3,14,19,OFFICE NO. 2 BUTNER PUBLIC SCHOOLS
SEMINOLE,OFFICE NO. 2 STROTHER PUBLIC SCHOOLS,TRAVIS GILLESPIE,,670032,0,0,0,0,OFFICE NO. 2 STROTHER PUBLIC SCHOOLS
SEMINOLE,OFFICE NO. 2 STROTHER PUBLIC SCHOOLS,HEATH SAPP,,670032,0,0,0,0,OFFICE NO. 2 STROTHER PUBLIC SCHOOLS
SEMINOLE,OFFICE NO. 2 BOWLEGS PUBLIC SCHOOLS,TIM GENTRY,,670033,0,0,0,0,OFFICE NO. 2 BOWLEGS PUBLIC SCHOOLS
SEMINOLE,OFFICE NO. 2 BOWLEGS PUBLIC SCHOOLS,JEREMY W ELLIOTT,,670033,0,0,0,0,OFFICE NO. 2 BOWLEGS PUBLIC SCHOOLS
SEMINOLE,OFFICE NO. 2 BUTNER PUBLIC SCHOOLS,HOLLIE MURRAY BEELER,,670034,0,0,0,0,OFFICE NO. 2 BUTNER PUBLIC SCHOOLS
SEMINOLE,OFFICE NO. 2 BUTNER PUBLIC SCHOOLS,BUTCH HOUSER,,670034,0,0,0,0,OFFICE NO. 2 BUTNER PUBLIC SCHOOLS
SEMINOLE,OFFICE NO. 2 BUTNER PUBLIC SCHOOLS,HOLLIE MURRAY BEELER,,670035,0,0,0,0,OFFICE NO. 2 BUTNER PUBLIC SCHOOLS
SEMINOLE,OFFICE NO. 2 BUTNER PUBLIC SCHOOLS,BUTCH HOUSER,,670035,0,0,0,0,OFFICE NO. 2 BUTNER PUBLIC SCHOOLS
SEMINOLE,OFFICE NO. 2 SEMINOLE PUBLIC SCHOOLS,LINDA HAMPTON,,670035,0,0,0,0,OFFICE NO. 2 SEMINOLE PUBLIC SCHOOLS
SEMINOLE,OFFICE NO. 2 SEMINOLE PUBLIC SCHOOLS,JERRY CALLAHAN,,670035,0,0,0,0,OFFICE NO. 2 SEMINOLE PUBLIC SCHOOLS
SEMINOLE,OFFICE NO. 2 SEMINOLE PUBLIC SCHOOLS,REBECCA LEONARD,,670035,0,0,0,0,OFFICE NO. 2 SEMINOLE PUBLIC SCHOOLS
SEMINOLE,OFFICE NO. 2 SEMINOLE PUBLIC SCHOOLS,STEVEN L. CHOATE,,670035,0,0,0,0,OFFICE NO. 2 SEMINOLE PUBLIC SCHOOLS
SEMINOLE,OFFICE NO. 2 STROTHER PUBLIC SCHOOLS,TRAVIS GILLESPIE,,670035,2,1,46,49,OFFICE NO. 2 STROTHER PUBLIC SCHOOLS
SEMINOLE,OFFICE NO. 2 STROTHER PUBLIC SCHOOLS,HEATH SAPP,,670035,2,0,33,35,OFFICE NO. 2 STROTHER PUBLIC SCHOOLS
SEMINOLE,OFFICE NO. 2 VARNUM PUBLIC SCHOOLS,THOMASENE DAVIS,,670035,0,0,0,0,OFFICE NO. 2 VARNUM PUBLIC SCHOOLS
SEMINOLE,OFFICE NO. 2 VARNUM PUBLIC SCHOOLS,AMY MICHELLE PORTER,,670035,0,0,2,2,OFFICE NO. 2 VARNUM PUBLIC SCHOOLS
SEQUOYAH,OFFICE NO. 2 INDIAN CAPITAL TECH CENTER,TOM STILES,,680101,0,3,50,53,OFFICE NO. 2 INDIAN CAPITAL TECH CENTER
SEQUOYAH,OFFICE NO. 2 INDIAN CAPITAL TECH CENTER,RAY KIRK,,680101,0,0,1,1,OFFICE NO. 2 INDIAN CAPITAL TECH CENTER
SEQUOYAH,OFFICE NO. 2 INDIAN CAPITAL TECH CENTER,TOM STILES,,680102,0,0,19,19,OFFICE NO. 2 INDIAN CAPITAL TECH CENTER
SEQUOYAH,OFFICE NO. 2 INDIAN CAPITAL TECH CENTER,RAY KIRK,,680102,0,0,1,1,OFFICE NO. 2 INDIAN CAPITAL TECH CENTER
SEQUOYAH,OFFICE NO. 2 INDIAN CAPITAL TECH CENTER,TOM STILES,,680103,0,0,25,25,OFFICE NO. 2 INDIAN CAPITAL TECH CENTER
SEQUOYAH,OFFICE NO. 2 INDIAN CAPITAL TECH CENTER,RAY KIRK,,680103,0,0,1,1,OFFICE NO. 2 INDIAN CAPITAL TECH CENTER
SEQUOYAH,OFFICE NO. 2 INDIAN CAPITAL TECH CENTER,TOM STILES,,680104,0,2,6,8,OFFICE NO. 2 INDIAN CAPITAL TECH CENTER
SEQUOYAH,OFFICE NO. 2 INDIAN CAPITAL TECH CENTER,RAY KIRK,,680104,1,1,3,5,OFFICE NO. 2 INDIAN CAPITAL TECH CENTER
SEQUOYAH,OFFICE NO. 2 INDIAN CAPITAL TECH CENTER,TOM STILES,,680105,0,0,2,2,OFFICE NO. 2 INDIAN CAPITAL TECH CENTER
SEQUOYAH,OFFICE NO. 2 INDIAN CAPITAL TECH CENTER,RAY KIRK,,680105,0,0,1,1,OFFICE NO. 2 INDIAN CAPITAL TECH CENTER
SEQUOYAH,OFFICE NO. 2 INDIAN CAPITAL TECH CENTER,TOM STILES,,680106,0,0,6,6,OFFICE NO. 2 INDIAN CAPITAL TECH CENTER
SEQUOYAH,OFFICE NO. 2 INDIAN CAPITAL TECH CENTER,RAY KIRK,,680106,0,0,0,0,OFFICE NO. 2 INDIAN CAPITAL TECH CENTER
SEQUOYAH,OFFICE NO. 2 INDIAN CAPITAL TECH CENTER,TOM STILES,,680201,0,0,16,16,OFFICE NO. 2 INDIAN CAPITAL TECH CENTER
SEQUOYAH,OFFICE NO. 2 INDIAN CAPITAL TECH CENTER,RAY KIRK,,680201,0,0,4,4,OFFICE NO. 2 INDIAN CAPITAL TECH CENTER
SEQUOYAH,OFFICE NO. 2 VIAN PUBLIC SCHOOLS,GARRETT FORD,,680201,0,0,6,6,OFFICE NO. 2 VIAN PUBLIC SCHOOLS
SEQUOYAH,OFFICE NO. 2 VIAN PUBLIC SCHOOLS,JERRY CAUGHMAN,,680201,0,0,13,13,OFFICE NO. 2 VIAN PUBLIC SCHOOLS
SEQUOYAH,OFFICE NO. 2 INDIAN CAPITAL TECH CENTER,TOM STILES,,680202,11,1,121,133,OFFICE NO. 2 INDIAN CAPITAL TECH CENTER
SEQUOYAH,OFFICE NO. 2 INDIAN CAPITAL TECH CENTER,RAY KIRK,,680202,2,1,45,48,OFFICE NO. 2 INDIAN CAPITAL TECH CENTER
SEQUOYAH,OFFICE NO. 2 VIAN PUBLIC SCHOOLS,GARRETT FORD,,680202,1,1,65,67,OFFICE NO. 2 VIAN PUBLIC SCHOOLS
SEQUOYAH,OFFICE NO. 2 VIAN PUBLIC SCHOOLS,JERRY CAUGHMAN,,680202,12,1,104,117,OFFICE NO. 2 VIAN PUBLIC SCHOOLS
SEQUOYAH,OFFICE NO. 2 INDIAN CAPITAL TECH CENTER,TOM STILES,,680203,0,1,54,55,OFFICE NO. 2 INDIAN CAPITAL TECH CENTER
SEQUOYAH,OFFICE NO. 2 INDIAN CAPITAL TECH CENTER,RAY KIRK,,680203,0,1,22,23,OFFICE NO. 2 INDIAN CAPITAL TECH CENTER
SEQUOYAH,OFFICE NO. 2 VIAN PUBLIC SCHOOLS,GARRETT FORD,,680203,0,1,50,51,OFFICE NO. 2 VIAN PUBLIC SCHOOLS
SEQUOYAH,OFFICE NO. 2 VIAN PUBLIC SCHOOLS,JERRY CAUGHMAN,,680203,0,1,33,34,OFFICE NO. 2 VIAN PUBLIC SCHOOLS
SEQUOYAH,MAYOR - AT LARGE CITY OF SALLISAW,JIM HUDGENS,,680204,0,0,0,0,
SEQUOYAH,MAYOR - AT LARGE CITY OF SALLISAW,GEORGE BORMANN,,680204,0,0,2,2,
SEQUOYAH,OFFICE NO. 2 INDIAN CAPITAL TECH CENTER,TOM STILES,,680204,0,0,2,2,OFFICE NO. 2 INDIAN CAPITAL TECH CENTER
SEQUOYAH,OFFICE NO. 2 INDIAN CAPITAL TECH CENTER,RAY KIRK,,680204,0,0,2,2,OFFICE NO. 2 INDIAN CAPITAL TECH CENTER
SEQUOYAH,OFFICE NO. 2 VIAN PUBLIC SCHOOLS,GARRETT FORD,,680204,0,0,0,0,OFFICE NO. 2 VIAN PUBLIC SCHOOLS
SEQUOYAH,OFFICE NO. 2 VIAN PUBLIC SCHOOLS,JERRY CAUGHMAN,,680204,0,0,1,1,OFFICE NO. 2 VIAN PUBLIC SCHOOLS
SEQUOYAH,MAYOR - AT LARGE CITY OF SALLISAW,JIM HUDGENS,,680205,0,1,15,16,
SEQUOYAH,MAYOR - AT LARGE CITY OF SALLISAW,GEORGE BORMANN,,680205,2,3,34,39,
SEQUOYAH,OFFICE NO. 2 INDIAN CAPITAL TECH CENTER,TOM STILES,,680205,2,2,41,45,OFFICE NO. 2 INDIAN CAPITAL TECH CENTER
SEQUOYAH,OFFICE NO. 2 INDIAN CAPITAL TECH CENTER,RAY KIRK,,680205,0,1,8,9,OFFICE NO. 2 INDIAN CAPITAL TECH CENTER
SEQUOYAH,MAYOR - AT LARGE CITY OF SALLISAW,JIM HUDGENS,,680206,0,0,4,4,
SEQUOYAH,MAYOR - AT LARGE CITY OF SALLISAW,GEORGE BORMANN,,680206,0,0,8,8,
SEQUOYAH,OFFICE NO. 2 INDIAN CAPITAL TECH CENTER,TOM STILES,,680206,0,0,22,22,OFFICE NO. 2 INDIAN CAPITAL TECH CENTER
SEQUOYAH,OFFICE NO. 2 INDIAN CAPITAL TECH CENTER,RAY KIRK,,680206,0,0,11,11,OFFICE NO. 2 INDIAN CAPITAL TECH CENTER
SEQUOYAH,OFFICE NO. 2 VIAN PUBLIC SCHOOLS,GARRETT FORD,,680206,0,0,6,6,OFFICE NO. 2 VIAN PUBLIC SCHOOLS
SEQUOYAH,OFFICE NO. 2 VIAN PUBLIC SCHOOLS,JERRY CAUGHMAN,,680206,0,0,10,10,OFFICE NO. 2 VIAN PUBLIC SCHOOLS
SEQUOYAH,OFFICE NO. 2 INDIAN CAPITAL TECH CENTER,TOM STILES,,680207,3,1,43,47,OFFICE NO. 2 INDIAN CAPITAL TECH CENTER
SEQUOYAH,OFFICE NO. 2 INDIAN CAPITAL TECH CENTER,RAY KIRK,,680207,3,0,28,31,OFFICE NO. 2 INDIAN CAPITAL TECH CENTER
SEQUOYAH,OFFICE NO. 2 MARBLE CITY PUBLIC SCHOOL,NANCY FIELDS,,680207,4,0,35,39,OFFICE NO. 2 MARBLE CITY PUBLIC SCHOOL
SEQUOYAH,OFFICE NO. 2 MARBLE CITY PUBLIC SCHOOL,DAVID CROW,,680207,0,0,34,34,OFFICE NO. 2 MARBLE CITY PUBLIC SCHOOL
SEQUOYAH,OFFICE NO. 2 VIAN PUBLIC SCHOOLS,GARRETT FORD,,680207,0,1,3,4,OFFICE NO. 2 VIAN PUBLIC SCHOOLS
SEQUOYAH,OFFICE NO. 2 VIAN PUBLIC SCHOOLS,JERRY CAUGHMAN,,680207,2,0,1,3,OFFICE NO. 2 VIAN PUBLIC SCHOOLS
SEQUOYAH,OFFICE NO. 2 INDIAN CAPITAL TECH CENTER,TOM STILES,,680208,0,1,52,53,OFFICE NO. 2 INDIAN CAPITAL TECH CENTER
SEQUOYAH,OFFICE NO. 2 INDIAN CAPITAL TECH CENTER,RAY KIRK,,680208,0,0,20,20,OFFICE NO. 2 INDIAN CAPITAL TECH CENTER
SEQUOYAH,OFFICE NO. 2 VIAN PUBLIC SCHOOLS,GARRETT FORD,,680208,0,1,24,25,OFFICE NO. 2 VIAN PUBLIC SCHOOLS
SEQUOYAH,OFFICE NO. 2 VIAN PUBLIC SCHOOLS,JERRY CAUGHMAN,,680208,0,0,77,77,OFFICE NO. 2 VIAN PUBLIC SCHOOLS
SEQUOYAH,OFFICE NO. 2 INDIAN CAPITAL TECH CENTER,TOM STILES,,680209,1,0,1,2,OFFICE NO. 2 INDIAN CAPITAL TECH CENTER
SEQUOYAH,OFFICE NO. 2 INDIAN CAPITAL TECH CENTER,RAY KIRK,,680209,2,0,0,2,OFFICE NO. 2 INDIAN CAPITAL TECH CENTER
SEQUOYAH,OFFICE NO. 2 VIAN PUBLIC SCHOOLS,GARRETT FORD,,680209,0,0,0,0,OFFICE NO. 2 VIAN PUBLIC SCHOOLS
SEQUOYAH,OFFICE NO. 2 VIAN PUBLIC SCHOOLS,JERRY CAUGHMAN,,680209,0,0,3,3,OFFICE NO. 2 VIAN PUBLIC SCHOOLS
SEQUOYAH,OFFICE NO. 2 INDIAN CAPITAL TECH CENTER,TOM STILES,,680210,1,0,7,8,OFFICE NO. 2 INDIAN CAPITAL TECH CENTER
SEQUOYAH,OFFICE NO. 2 INDIAN CAPITAL TECH CENTER,RAY KIRK,,680210,1,0,2,3,OFFICE NO. 2 INDIAN CAPITAL TECH CENTER
SEQUOYAH,MAYOR - AT LARGE CITY OF SALLISAW,JIM HUDGENS,,680301,0,0,35,35,
SEQUOYAH,MAYOR - AT LARGE CITY OF SALLISAW,GEORGE BORMANN,,680301,0,1,33,34,
SEQUOYAH,OFFICE NO. 2 INDIAN CAPITAL TECH CENTER,TOM STILES,,680301,0,1,60,61,OFFICE NO. 2 INDIAN CAPITAL TECH CENTER
SEQUOYAH,OFFICE NO. 2 INDIAN CAPITAL TECH CENTER,RAY KIRK,,680301,0,0,8,8,OFFICE NO. 2 INDIAN CAPITAL TECH CENTER
SEQUOYAH,MAYOR - AT LARGE CITY OF SALLISAW,JIM HUDGENS,,680302,0,1,15,16,
SEQUOYAH,MAYOR - AT LARGE CITY OF SALLISAW,GEORGE BORMANN,,680302,0,1,10,11,
SEQUOYAH,OFFICE NO. 2 INDIAN CAPITAL TECH CENTER,TOM STILES,,680302,0,2,21,23,OFFICE NO. 2 INDIAN CAPITAL TECH CENTER
SEQUOYAH,OFFICE NO. 2 INDIAN CAPITAL TECH CENTER,RAY KIRK,,680302,0,0,4,4,OFFICE NO. 2 INDIAN CAPITAL TECH CENTER
SEQUOYAH,MAYOR - AT LARGE CITY OF SALLISAW,JIM HUDGENS,,680303,1,1,30,32,
SEQUOYAH,MAYOR - AT LARGE CITY OF SALLISAW,GEORGE BORMANN,,680303,0,4,44,48,
SEQUOYAH,OFFICE NO. 2 INDIAN CAPITAL TECH CENTER,TOM STILES,,680303,1,5,61,67,OFFICE NO. 2 INDIAN CAPITAL TECH CENTER
SEQUOYAH,OFFICE NO. 2 INDIAN CAPITAL TECH CENTER,RAY KIRK,,680303,0,0,11,11,OFFICE NO. 2 INDIAN CAPITAL TECH CENTER
SEQUOYAH,OFFICE NO. 2 INDIAN CAPITAL TECH CENTER,TOM STILES,,680304,0,0,2,2,OFFICE NO. 2 INDIAN CAPITAL TECH CENTER
SEQUOYAH,OFFICE NO. 2 INDIAN CAPITAL TECH CENTER,RAY KIRK,,680304,0,0,1,1,OFFICE NO. 2 INDIAN CAPITAL TECH CENTER
SEQUOYAH,OFFICE NO. 2 INDIAN CAPITAL TECH CENTER,TOM STILES,,680305,2,0,11,13,OFFICE NO. 2 INDIAN CAPITAL TECH CENTER
SEQUOYAH,OFFICE NO. 2 INDIAN CAPITAL TECH CENTER,RAY KIRK,,680305,0,0,2,2,OFFICE NO. 2 INDIAN CAPITAL TECH CENTER
SEQUOYAH,OFFICE NO. 2 INDIAN CAPITAL TECH CENTER,TOM STILES,,680306,2,0,10,12,OFFICE NO. 2 INDIAN CAPITAL TECH CENTER
SEQUOYAH,OFFICE NO. 2 INDIAN CAPITAL TECH CENTER,RAY KIRK,,680306,0,0,1,1,OFFICE NO. 2 INDIAN CAPITAL TECH CENTER
SEQUOYAH,OFFICE NO. 2 INDIAN CAPITAL TECH CENTER,TOM STILES,,680307,0,0,9,9,OFFICE NO. 2 INDIAN CAPITAL TECH CENTER
SEQUOYAH,OFFICE NO. 2 INDIAN CAPITAL TECH CENTER,RAY KIRK,,680307,0,1,0,1,OFFICE NO. 2 INDIAN CAPITAL TECH CENTER
SEQUOYAH,OFFICE NO. 2 INDIAN CAPITAL TECH CENTER,TOM STILES,,680308,0,0,1,1,OFFICE NO. 2 INDIAN CAPITAL TECH CENTER
SEQUOYAH,OFFICE NO. 2 INDIAN CAPITAL TECH CENTER,RAY KIRK,,680308,0,0,0,0,OFFICE NO. 2 INDIAN CAPITAL TECH CENTER
SEQUOYAH,OFFICE NO. 2 MARBLE CITY PUBLIC SCHOOL,NANCY FIELDS,,680308,0,0,1,1,OFFICE NO. 2 MARBLE CITY PUBLIC SCHOOL
SEQUOYAH,OFFICE NO. 2 MARBLE CITY PUBLIC SCHOOL,DAVID CROW,,680308,0,0,0,0,OFFICE NO. 2 MARBLE CITY PUBLIC SCHOOL
SEQUOYAH,OFFICE NO. 2 INDIAN CAPITAL TECH CENTER,TOM STILES,,680309,0,0,13,13,OFFICE NO. 2 INDIAN CAPITAL TECH CENTER
SEQUOYAH,OFFICE NO. 2 INDIAN CAPITAL TECH CENTER,RAY KIRK,,680309,0,0,1,1,OFFICE NO. 2 INDIAN CAPITAL TECH CENTER
SEQUOYAH,OFFICE NO. 2 INDIAN CAPITAL TECH CENTER,TOM STILES,,680310,0,0,7,7,OFFICE NO. 2 INDIAN CAPITAL TECH CENTER
SEQUOYAH,OFFICE NO. 2 INDIAN CAPITAL TECH CENTER,RAY KIRK,,680310,0,0,6,6,OFFICE NO. 2 INDIAN CAPITAL TECH CENTER
STEPHENS,OFFICE NO. 2 EMPIRE PUBLIC SCHOOLS,DEE CARRIO,,690013,0,0,0,0,OFFICE NO. 2 EMPIRE PUBLIC SCHOOLS
STEPHENS,OFFICE NO. 2 EMPIRE PUBLIC SCHOOLS,GALE FLOYD,,690013,0,0,0,0,OFFICE NO. 2 EMPIRE PUBLIC SCHOOLS
STEPHENS,OFFICE NO. 2 EMPIRE PUBLIC SCHOOLS,DEE CARRIO,,690014,0,0,27,27,OFFICE NO. 2 EMPIRE PUBLIC SCHOOLS
STEPHENS,OFFICE NO. 2 EMPIRE PUBLIC SCHOOLS,GALE FLOYD,,690014,0,0,18,18,OFFICE NO. 2 EMPIRE PUBLIC SCHOOLS
STEPHENS,OFFICE NO. 2 EMPIRE PUBLIC SCHOOLS,DEE CARRIO,,690015,0,0,0,0,OFFICE NO. 2 EMPIRE PUBLIC SCHOOLS
STEPHENS,OFFICE NO. 2 EMPIRE PUBLIC SCHOOLS,GALE FLOYD,,690015,0,0,1,1,OFFICE NO. 2 EMPIRE PUBLIC SCHOOLS
STEPHENS,OFFICE NO. 2 EMPIRE PUBLIC SCHOOLS,DEE CARRIO,,690016,0,0,5,5,OFFICE NO. 2 EMPIRE PUBLIC SCHOOLS
STEPHENS,OFFICE NO. 2 EMPIRE PUBLIC SCHOOLS,GALE FLOYD,,690016,0,1,2,3,OFFICE NO. 2 EMPIRE PUBLIC SCHOOLS
STEPHENS,OFFICE NO. 2 EMPIRE PUBLIC SCHOOLS,DEE CARRIO,,690019,0,0,0,0,OFFICE NO. 2 EMPIRE PUBLIC SCHOOLS
STEPHENS,OFFICE NO. 2 EMPIRE PUBLIC SCHOOLS,GALE FLOYD,,690019,0,0,0,0,OFFICE NO. 2 EMPIRE PUBLIC SCHOOLS
STEPHENS,OFFICE NO. 2 BRAY-DOYLE PUBLIC SCHOOLS,WAYNE TURNER,,690032,0,1,1,2,OFFICE NO. 2 BRAY-DOYLE PUBLIC SCHOOLS
STEPHENS,OFFICE NO. 2 BRAY-DOYLE PUBLIC SCHOOLS,ERIC DORMAN,,690032,0,0,4,4,OFFICE NO. 2 BRAY-DOYLE PUBLIC SCHOOLS
STEPHENS,OFFICE NO. 2 BRAY-DOYLE PUBLIC SCHOOLS,WAYNE TURNER,,690033,0,0,3,3,OFFICE NO. 2 BRAY-DOYLE PUBLIC SCHOOLS
STEPHENS,OFFICE NO. 2 BRAY-DOYLE PUBLIC SCHOOLS,ERIC DORMAN,,690033,0,0,0,0,OFFICE NO. 2 BRAY-DOYLE PUBLIC SCHOOLS
STEPHENS,OFFICE NO. 2 BRAY-DOYLE PUBLIC SCHOOLS,WAYNE TURNER,,690050,0,0,0,0,OFFICE NO. 2 BRAY-DOYLE PUBLIC SCHOOLS
STEPHENS,OFFICE NO. 2 BRAY-DOYLE PUBLIC SCHOOLS,ERIC DORMAN,,690050,0,0,4,4,OFFICE NO. 2 BRAY-DOYLE PUBLIC SCHOOLS
STEPHENS,OFFICE NO. 2 EMPIRE PUBLIC SCHOOLS,DEE CARRIO,,690051,0,0,0,0,OFFICE NO. 2 EMPIRE PUBLIC SCHOOLS
STEPHENS,OFFICE NO. 2 EMPIRE PUBLIC SCHOOLS,GALE FLOYD,,690051,0,0,0,0,OFFICE NO. 2 EMPIRE PUBLIC SCHOOLS
STEPHENS,OFFICE NO. 2 BRAY-DOYLE PUBLIC SCHOOLS,WAYNE TURNER,,690053,1,3,1,5,OFFICE NO. 2 BRAY-DOYLE PUBLIC SCHOOLS
STEPHENS,OFFICE NO. 2 BRAY-DOYLE PUBLIC SCHOOLS,ERIC DORMAN,,690053,0,0,13,13,OFFICE NO. 2 BRAY-DOYLE PUBLIC SCHOOLS
STEPHENS,OFFICE NO. 2 BRAY-DOYLE PUBLIC SCHOOLS,WAYNE TURNER,,690054,0,0,8,8,OFFICE NO. 2 BRAY-DOYLE PUBLIC SCHOOLS
STEPHENS,OFFICE NO. 2 BRAY-DOYLE PUBLIC SCHOOLS,ERIC DORMAN,,690054,3,1,55,59,OFFICE NO. 2 BRAY-DOYLE PUBLIC SCHOOLS
STEPHENS,OFFICE NO. 2 BRAY-DOYLE PUBLIC SCHOOLS,WAYNE TURNER,,690055,0,0,8,8,OFFICE NO. 2 BRAY-DOYLE PUBLIC SCHOOLS
STEPHENS,OFFICE NO. 2 BRAY-DOYLE PUBLIC SCHOOLS,ERIC DORMAN,,690055,0,0,32,32,OFFICE NO. 2 BRAY-DOYLE PUBLIC SCHOOLS
STEPHENS,OFFICE NO. 2 BRAY-DOYLE PUBLIC SCHOOLS,WAYNE TURNER,,690056,0,0,0,0,OFFICE NO. 2 BRAY-DOYLE PUBLIC SCHOOLS
STEPHENS,OFFICE NO. 2 BRAY-DOYLE PUBLIC SCHOOLS,ERIC DORMAN,,690056,0,0,0,0,OFFICE NO. 2 BRAY-DOYLE PUBLIC SCHOOLS
STEPHENS,OFFICE NO. 2 BRAY-DOYLE PUBLIC SCHOOLS,WAYNE TURNER,,690057,0,0,0,0,OFFICE NO. 2 BRAY-DOYLE PUBLIC SCHOOLS
STEPHENS,OFFICE NO. 2 BRAY-DOYLE PUBLIC SCHOOLS,ERIC DORMAN,,690057,0,0,0,0,OFFICE NO. 2 BRAY-DOYLE PUBLIC SCHOOLS
STEPHENS,OFFICE NO. 2 EMPIRE PUBLIC SCHOOLS,DEE CARRIO,,690060,0,1,1,2,OFFICE NO. 2 EMPIRE PUBLIC SCHOOLS
STEPHENS,OFFICE NO. 2 EMPIRE PUBLIC SCHOOLS,GALE FLOYD,,690060,0,0,3,3,OFFICE NO. 2 EMPIRE PUBLIC SCHOOLS
STEPHENS,OFFICE NO. 2 EMPIRE PUBLIC SCHOOLS,DEE CARRIO,,690061,0,0,0,0,OFFICE NO. 2 EMPIRE PUBLIC SCHOOLS
STEPHENS,OFFICE NO. 2 EMPIRE PUBLIC SCHOOLS,GALE FLOYD,,690061,0,0,0,0,OFFICE NO. 2 EMPIRE PUBLIC SCHOOLS
STEPHENS,OFFICE NO. 2 WALTERS PUBLIC SCHOOLS,SCOTTY REED,,690062,0,0,0,0,OFFICE NO. 2 WALTERS PUBLIC SCHOOLS
STEPHENS,OFFICE NO. 2 WALTERS PUBLIC SCHOOLS,JIM KEESEE,,690062,0,0,0,0,OFFICE NO. 2 WALTERS PUBLIC SCHOOLS
STEPHENS,OFFICE NO. 2 EMPIRE PUBLIC SCHOOLS,DEE CARRIO,,690062,0,0,0,0,OFFICE NO. 2 EMPIRE PUBLIC SCHOOLS
STEPHENS,OFFICE NO. 2 EMPIRE PUBLIC SCHOOLS,GALE FLOYD,,690062,0,0,0,0,OFFICE NO. 2 EMPIRE PUBLIC SCHOOLS
STEPHENS,OFFICE NO. 2 WALTERS PUBLIC SCHOOLS,SCOTTY REED,,690063,0,0,0,0,OFFICE NO. 2 WALTERS PUBLIC SCHOOLS
STEPHENS,OFFICE NO. 2 WALTERS PUBLIC SCHOOLS,JIM KEESEE,,690063,0,0,0,0,OFFICE NO. 2 WALTERS PUBLIC SCHOOLS
STEPHENS,OFFICE NO. 2 EMPIRE PUBLIC SCHOOLS,DEE CARRIO,,690063,0,0,18,18,OFFICE NO. 2 EMPIRE PUBLIC SCHOOLS
STEPHENS,OFFICE NO. 2 EMPIRE PUBLIC SCHOOLS,GALE FLOYD,,690063,0,0,31,31,OFFICE NO. 2 EMPIRE PUBLIC SCHOOLS
TEXAS,OFFICE NO. 2 TURPIN PUBLIC SCHOOLS,KEVIN WILLIAMS,,700104,2,0,7,9,OFFICE NO. 2 TURPIN PUBLIC SCHOOLS
TEXAS,OFFICE NO. 2 TURPIN PUBLIC SCHOOLS,SARAH ARCHER,,700104,2,0,3,5,OFFICE NO. 2 TURPIN PUBLIC SCHOOLS
TEXAS,OFFICE NO. 1 (UNEXPIRED TERM) TURPIN PUBLIC SCHOOLS,BLAINE BECKLEY,,700104,2,0,4,6,OFFICE NO. 1 (UNEXPIRED TERM) TURPIN PUBLIC SCHOOLS
TEXAS,OFFICE NO. 1 (UNEXPIRED TERM) TURPIN PUBLIC SCHOOLS,CHARLIE DELAY,,700104,2,0,5,7,OFFICE NO. 1 (UNEXPIRED TERM) TURPIN PUBLIC SCHOOLS
TEXAS,OFFICE NO. 2 TURPIN PUBLIC SCHOOLS,KEVIN WILLIAMS,,700107,0,2,0,2,OFFICE NO. 2 TURPIN PUBLIC SCHOOLS
TEXAS,OFFICE NO. 2 TURPIN PUBLIC SCHOOLS,SARAH ARCHER,,700107,0,0,0,0,OFFICE NO. 2 TURPIN PUBLIC SCHOOLS
TEXAS,OFFICE NO. 1 (UNEXPIRED TERM) TURPIN PUBLIC SCHOOLS,BLAINE BECKLEY,,700107,0,2,0,2,OFFICE NO. 1 (UNEXPIRED TERM) TURPIN PUBLIC SCHOOLS
TEXAS,OFFICE NO. 1 (UNEXPIRED TERM) TURPIN PUBLIC SCHOOLS,CHARLIE DELAY,,700107,0,0,0,0,OFFICE NO. 1 (UNEXPIRED TERM) TURPIN PUBLIC SCHOOLS
TEXAS,PROPOSITION HARDESTY PUBLIC SCHOOLS,FOR THE PROPOSITION - YES,,700107,0,3,43,46,
TEXAS,PROPOSITION HARDESTY PUBLIC SCHOOLS,AGAINST THE PROPOSITION - NO,,700107,2,0,8,10,
TEXAS,PROPOSITION HARDESTY PUBLIC SCHOOLS,FOR THE PROPOSITION - YES,,700202,0,0,0,0,
TEXAS,PROPOSITION HARDESTY PUBLIC SCHOOLS,AGAINST THE PROPOSITION - NO,,700202,0,0,0,0,
TEXAS,OFFICE NO. 5 (UNEXPIRED TERM) TEXHOMA PUBLIC SCHOOLS,DAVID GIDEON,,700303,3,0,26,29,OFFICE NO. 5 (UNEXPIRED TERM) TEXHOMA PUBLIC SCHOOLS
TEXAS,OFFICE NO. 5 (UNEXPIRED TERM) TEXHOMA PUBLIC SCHOOLS,MICHAEL YATES,,700303,8,1,145,154,OFFICE NO. 5 (UNEXPIRED TERM) TEXHOMA PUBLIC SCHOOLS
TEXAS,PROPOSITION TEXHOMA PUBLIC SCHOOLS,FOR THE PROPOSITION - YES,,700303,10,1,127,138,
TEXAS,PROPOSITION TEXHOMA PUBLIC SCHOOLS,AGAINST THE PROPOSITION - NO,,700303,2,0,47,49,
TEXAS,OFFICE NO. 5 (UNEXPIRED TERM) TEXHOMA PUBLIC SCHOOLS,DAVID GIDEON,,700304,2,0,0,2,OFFICE NO. 5 (UNEXPIRED TERM) TEXHOMA PUBLIC SCHOOLS
TEXAS,OFFICE NO. 5 (UNEXPIRED TERM) TEXHOMA PUBLIC SCHOOLS,MICHAEL YATES,,700304,2,2,0,4,OFFICE NO. 5 (UNEXPIRED TERM) TEXHOMA PUBLIC SCHOOLS
TEXAS,PROPOSITION TEXHOMA PUBLIC SCHOOLS,FOR THE PROPOSITION - YES,,700304,4,2,0,6,
TEXAS,PROPOSITION TEXHOMA PUBLIC SCHOOLS,AGAINST THE PROPOSITION - NO,,700304,0,0,0,0,
TILLMAN,OFFICE NO. 3 SNYDER PUBLIC SCHOOLS,DREW JANZ,,710010,3,0,0,3,OFFICE NO. 3 SNYDER PUBLIC SCHOOLS
TILLMAN,OFFICE NO. 3 SNYDER PUBLIC SCHOOLS,CARMEN McCORKLE,,710010,1,0,0,1,OFFICE NO. 3 SNYDER PUBLIC SCHOOLS
TILLMAN,OFFICE NO. 3 SNYDER PUBLIC SCHOOLS,DREW JANZ,,710012,0,0,0,0,OFFICE NO. 3 SNYDER PUBLIC SCHOOLS
TILLMAN,OFFICE NO. 3 SNYDER PUBLIC SCHOOLS,CARMEN McCORKLE,,710012,0,0,2,2,OFFICE NO. 3 SNYDER PUBLIC SCHOOLS
TULSA,OFFICE NO. 3 TULSA PUBLIC SCHOOLS,LANA TURNER,,720001,0,0,51,51,OFFICE NO. 3 TULSA PUBLIC SCHOOLS
TULSA,OFFICE NO. 3 TULSA PUBLIC SCHOOLS,WHITNEY COLE,,720001,0,0,3,3,OFFICE NO. 3 TULSA PUBLIC SCHOOLS
TULSA,OFFICE NO. 3 TULSA PUBLIC SCHOOLS,JENNETTIE P. MARSHALL,,720001,0,0,31,31,OFFICE NO. 3 TULSA PUBLIC SCHOOLS
TULSA,OFFICE NO. 1 TULSA TECH CENTER,RAY A. OWENS,,720001,0,0,41,41,OFFICE NO. 1 TULSA TECH CENTER
TULSA,OFFICE NO. 1 TULSA TECH CENTER,MELANIE SWEENEY McINTOSH,,720001,0,0,19,19,OFFICE NO. 1 TULSA TECH CENTER
TULSA,OFFICE NO. 1 TULSA TECH CENTER,KEENAN H. MEADORS,,720001,0,0,25,25,OFFICE NO. 1 TULSA TECH CENTER
TULSA,OFFICE NO. 3 TULSA PUBLIC SCHOOLS,LANA TURNER,,720002,0,0,24,24,OFFICE NO. 3 TULSA PUBLIC SCHOOLS
TULSA,OFFICE NO. 3 TULSA PUBLIC SCHOOLS,WHITNEY COLE,,720002,0,0,2,2,OFFICE NO. 3 TULSA PUBLIC SCHOOLS
TULSA,OFFICE NO. 3 TULSA PUBLIC SCHOOLS,JENNETTIE P. MARSHALL,,720002,0,0,38,38,OFFICE NO. 3 TULSA PUBLIC SCHOOLS
TULSA,OFFICE NO. 1 TULSA TECH CENTER,RAY A. OWENS,,720002,0,0,33,33,OFFICE NO. 1 TULSA TECH CENTER
TULSA,OFFICE NO. 1 TULSA TECH CENTER,MELANIE SWEENEY McINTOSH,,720002,0,0,10,10,OFFICE NO. 1 TULSA TECH CENTER
TULSA,OFFICE NO. 1 TULSA TECH CENTER,KEENAN H. MEADORS,,720002,0,0,20,20,OFFICE NO. 1 TULSA TECH CENTER
TULSA,OFFICE NO. 3 TULSA PUBLIC SCHOOLS,LANA TURNER,,720003,0,0,4,4,OFFICE NO. 3 TULSA PUBLIC SCHOOLS
TULSA,OFFICE NO. 3 TULSA PUBLIC SCHOOLS,WHITNEY COLE,,720003,0,0,4,4,OFFICE NO. 3 TULSA PUBLIC SCHOOLS
TULSA,OFFICE NO. 3 TULSA PUBLIC SCHOOLS,JENNETTIE P. MARSHALL,,720003,0,0,4,4,OFFICE NO. 3 TULSA PUBLIC SCHOOLS
TULSA,OFFICE NO. 1 TULSA TECH CENTER,RAY A. OWENS,,720003,0,0,6,6,OFFICE NO. 1 TULSA TECH CENTER
TULSA,OFFICE NO. 1 TULSA TECH CENTER,MELANIE SWEENEY McINTOSH,,720003,0,0,3,3,OFFICE NO. 1 TULSA TECH CENTER
TULSA,OFFICE NO. 1 TULSA TECH CENTER,KEENAN H. MEADORS,,720003,0,0,3,3,OFFICE NO. 1 TULSA TECH CENTER
TULSA,OFFICE NO. 3 TULSA PUBLIC SCHOOLS,LANA TURNER,,720004,0,0,58,58,OFFICE NO. 3 TULSA PUBLIC SCHOOLS
TULSA,OFFICE NO. 3 TULSA PUBLIC SCHOOLS,WHITNEY COLE,,720004,0,0,5,5,OFFICE NO. 3 TULSA PUBLIC SCHOOLS
TULSA,OFFICE NO. 3 TULSA PUBLIC SCHOOLS,JENNETTIE P. MARSHALL,,720004,0,0,46,46,OFFICE NO. 3 TULSA PUBLIC SCHOOLS
TULSA,OFFICE NO. 1 TULSA TECH CENTER,RAY A. OWENS,,720004,0,0,72,72,OFFICE NO. 1 TULSA TECH CENTER
TULSA,OFFICE NO. 1 TULSA TECH CENTER,MELANIE SWEENEY McINTOSH,,720004,0,0,12,12,OFFICE NO. 1 TULSA TECH CENTER
TULSA,OFFICE NO. 1 TULSA TECH CENTER,KEENAN H. MEADORS,,720004,0,0,24,24,OFFICE NO. 1 TULSA TECH CENTER
TULSA,OFFICE NO. 3 TULSA PUBLIC SCHOOLS,LANA TURNER,,720005,0,0,10,10,OFFICE NO. 3 TULSA PUBLIC SCHOOLS
TULSA,OFFICE NO. 3 TULSA PUBLIC SCHOOLS,WHITNEY COLE,,720005,0,0,2,2,OFFICE NO. 3 TULSA PUBLIC SCHOOLS
TULSA,OFFICE NO. 3 TULSA PUBLIC SCHOOLS,JENNETTIE P. MARSHALL,,720005,0,0,16,16,OFFICE NO. 3 TULSA PUBLIC SCHOOLS
TULSA,OFFICE NO. 1 TULSA TECH CENTER,RAY A. OWENS,,720005,0,0,18,18,OFFICE NO. 1 TULSA TECH CENTER
TULSA,OFFICE NO. 1 TULSA TECH CENTER,MELANIE SWEENEY McINTOSH,,720005,0,0,4,4,OFFICE NO. 1 TULSA TECH CENTER
TULSA,OFFICE NO. 1 TULSA TECH CENTER,KEENAN H. MEADORS,,720005,0,0,6,6,OFFICE NO. 1 TULSA TECH CENTER
TULSA,OFFICE NO. 3 TULSA PUBLIC SCHOOLS,LANA TURNER,,720006,0,0,70,70,OFFICE NO. 3 TULSA PUBLIC SCHOOLS
TULSA,OFFICE NO. 3 TULSA PUBLIC SCHOOLS,WHITNEY COLE,,720006,0,0,6,6,OFFICE NO. 3 TULSA PUBLIC SCHOOLS
TULSA,OFFICE NO. 3 TULSA PUBLIC SCHOOLS,JENNETTIE P. MARSHALL,,720006,0,0,54,54,OFFICE NO. 3 TULSA PUBLIC SCHOOLS
TULSA,OFFICE NO. 1 TULSA TECH CENTER,RAY A. OWENS,,720006,0,0,77,77,OFFICE NO. 1 TULSA TECH CENTER
TULSA,OFFICE NO. 1 TULSA TECH CENTER,MELANIE SWEENEY McINTOSH,,720006,0,0,30,30,OFFICE NO. 1 TULSA TECH CENTER
TULSA,OFFICE NO. 1 TULSA TECH CENTER,KEENAN H. MEADORS,,720006,0,0,24,24,OFFICE NO. 1 TULSA TECH CENTER
TULSA,OFFICE NO. 3 TULSA PUBLIC SCHOOLS,LANA TURNER,,720007,0,0,33,33,OFFICE NO. 3 TULSA PUBLIC SCHOOLS
TULSA,OFFICE NO. 3 TULSA PUBLIC SCHOOLS,WHITNEY COLE,,720007,0,0,3,3,OFFICE NO. 3 TULSA PUBLIC SCHOOLS
TULSA,OFFICE NO. 3 TULSA PUBLIC SCHOOLS,JENNETTIE P. MARSHALL,,720007,0,0,35,35,OFFICE NO. 3 TULSA PUBLIC SCHOOLS
TULSA,OFFICE NO. 1 TULSA TECH CENTER,RAY A. OWENS,,720007,0,0,39,39,OFFICE NO. 1 TULSA TECH CENTER
TULSA,OFFICE NO. 1 TULSA TECH CENTER,MELANIE SWEENEY McINTOSH,,720007,0,0,13,13,OFFICE NO. 1 TULSA TECH CENTER
TULSA,OFFICE NO. 1 TULSA TECH CENTER,KEENAN H. MEADORS,,720007,0,0,19,19,OFFICE NO. 1 TULSA TECH CENTER
TULSA,OFFICE NO. 3 TULSA PUBLIC SCHOOLS,LANA TURNER,,720008,0,0,20,20,OFFICE NO. 3 TULSA PUBLIC SCHOOLS
TULSA,OFFICE NO. 3 TULSA PUBLIC SCHOOLS,WHITNEY COLE,,720008,0,0,1,1,OFFICE NO. 3 TULSA PUBLIC SCHOOLS
TULSA,OFFICE NO. 3 TULSA PUBLIC SCHOOLS,JENNETTIE P. MARSHALL,,720008,0,0,29,29,OFFICE NO. 3 TULSA PUBLIC SCHOOLS
TULSA,OFFICE NO. 1 TULSA TECH CENTER,RAY A. OWENS,,720008,0,0,31,31,OFFICE NO. 1 TULSA TECH CENTER
TULSA,OFFICE NO. 1 TULSA TECH CENTER,MELANIE SWEENEY McINTOSH,,720008,0,0,6,6,OFFICE NO. 1 TULSA TECH CENTER
TULSA,OFFICE NO. 1 TULSA TECH CENTER,KEENAN H. MEADORS,,720008,0,0,13,13,OFFICE NO. 1 TULSA TECH CENTER
TULSA,OFFICE NO. 3 TULSA PUBLIC SCHOOLS,LANA TURNER,,720009,0,0,16,16,OFFICE NO. 3 TULSA PUBLIC SCHOOLS
TULSA,OFFICE NO. 3 TULSA PUBLIC SCHOOLS,WHITNEY COLE,,720009,0,0,1,1,OFFICE NO. 3 TULSA PUBLIC SCHOOLS
TULSA,OFFICE NO. 3 TULSA PUBLIC SCHOOLS,JENNETTIE P. MARSHALL,,720009,0,0,9,9,OFFICE NO. 3 TULSA PUBLIC SCHOOLS
TULSA,OFFICE NO. 1 TULSA TECH CENTER,RAY A. OWENS,,720009,0,0,11,11,OFFICE NO. 1 TULSA TECH CENTER
TULSA,OFFICE NO. 1 TULSA TECH CENTER,MELANIE SWEENEY McINTOSH,,720009,0,0,4,4,OFFICE NO. 1 TULSA TECH CENTER
TULSA,OFFICE NO. 1 TULSA TECH CENTER,KEENAN H. MEADORS,,720009,0,0,11,11,OFFICE NO. 1 TULSA TECH CENTER
TULSA,OFFICE NO. 2 TULSA PUBLIC SCHOOLS,PHIL ARMSTRONG,,720010,0,0,32,32,OFFICE NO. 2 TULSA PUBLIC SCHOOLS
TULSA,OFFICE NO. 2 TULSA PUBLIC SCHOOLS,WILBERT E. COLLINS SR.,,720010,0,0,13,13,OFFICE NO. 2 TULSA PUBLIC SCHOOLS
TULSA,OFFICE NO. 2 TULSA PUBLIC SCHOOLS,AMY SHELTON,,720010,0,0,10,10,OFFICE NO. 2 TULSA PUBLIC SCHOOLS
TULSA,OFFICE NO. 1 TULSA TECH CENTER,RAY A. OWENS,,720010,0,0,21,21,OFFICE NO. 1 TULSA TECH CENTER
TULSA,OFFICE NO. 1 TULSA TECH CENTER,MELANIE SWEENEY McINTOSH,,720010,0,0,17,17,OFFICE NO. 1 TULSA TECH CENTER
TULSA,OFFICE NO. 1 TULSA TECH CENTER,KEENAN H. MEADORS,,720010,0,0,17,17,OFFICE NO. 1 TULSA TECH CENTER
TULSA,OFFICE NO. 3 TULSA PUBLIC SCHOOLS,LANA TURNER,,720011,0,0,10,10,OFFICE NO. 3 TULSA PUBLIC SCHOOLS
TULSA,OFFICE NO. 3 TULSA PUBLIC SCHOOLS,WHITNEY COLE,,720011,0,0,2,2,OFFICE NO. 3 TULSA PUBLIC SCHOOLS
TULSA,OFFICE NO. 3 TULSA PUBLIC SCHOOLS,JENNETTIE P. MARSHALL,,720011,0,0,4,4,OFFICE NO. 3 TULSA PUBLIC SCHOOLS
TULSA,OFFICE NO. 1 TULSA TECH CENTER,RAY A. OWENS,,720011,0,0,7,7,OFFICE NO. 1 TULSA TECH CENTER
TULSA,OFFICE NO. 1 TULSA TECH CENTER,MELANIE SWEENEY McINTOSH,,720011,0,0,7,7,OFFICE NO. 1 TULSA TECH CENTER
TULSA,OFFICE NO. 1 TULSA TECH CENTER,KEENAN H. MEADORS,,720011,0,0,2,2,OFFICE NO. 1 TULSA TECH CENTER
TULSA,OFFICE NO. 3 TULSA PUBLIC SCHOOLS,LANA TURNER,,720012,0,0,2,2,OFFICE NO. 3 TULSA PUBLIC SCHOOLS
TULSA,OFFICE NO. 3 TULSA PUBLIC SCHOOLS,WHITNEY COLE,,720012,0,0,0,0,OFFICE NO. 3 TULSA PUBLIC SCHOOLS
TULSA,OFFICE NO. 3 TULSA PUBLIC SCHOOLS,JENNETTIE P. MARSHALL,,720012,0,0,3,3,OFFICE NO. 3 TULSA PUBLIC SCHOOLS
TULSA,OFFICE NO. 1 TULSA TECH CENTER,RAY A. OWENS,,720012,0,0,2,2,OFFICE NO. 1 TULSA TECH CENTER
TULSA,OFFICE NO. 1 TULSA TECH CENTER,MELANIE SWEENEY McINTOSH,,720012,0,0,3,3,OFFICE NO. 1 TULSA TECH CENTER
TULSA,OFFICE NO. 1 TULSA TECH CENTER,KEENAN H. MEADORS,,720012,0,0,0,0,OFFICE NO. 1 TULSA TECH CENTER
TULSA,OFFICE NO. 2 TULSA PUBLIC SCHOOLS,PHIL ARMSTRONG,,720013,0,0,90,90,OFFICE NO. 2 TULSA PUBLIC SCHOOLS
TULSA,OFFICE NO. 2 TULSA PUBLIC SCHOOLS,WILBERT E. COLLINS SR.,,720013,0,0,30,30,OFFICE NO. 2 TULSA PUBLIC SCHOOLS
TULSA,OFFICE NO. 2 TULSA PUBLIC SCHOOLS,AMY SHELTON,,720013,0,0,15,15,OFFICE NO. 2 TULSA PUBLIC SCHOOLS
TULSA,OFFICE NO. 1 TULSA TECH CENTER,RAY A. OWENS,,720013,0,0,80,80,OFFICE NO. 1 TULSA TECH CENTER
TULSA,OFFICE NO. 1 TULSA TECH CENTER,MELANIE SWEENEY McINTOSH,,720013,0,0,22,22,OFFICE NO. 1 TULSA TECH CENTER
TULSA,OFFICE NO. 1 TULSA TECH CENTER,KEENAN H. MEADORS,,720013,0,0,34,34,OFFICE NO. 1 TULSA TECH CENTER
TULSA,OFFICE NO. 1 TULSA TECH CENTER,RAY A. OWENS,,720014,0,0,29,29,OFFICE NO. 1 TULSA TECH CENTER
TULSA,OFFICE NO. 1 TULSA TECH CENTER,MELANIE SWEENEY McINTOSH,,720014,0,0,17,17,OFFICE NO. 1 TULSA TECH CENTER
TULSA,OFFICE NO. 1 TULSA TECH CENTER,KEENAN H. MEADORS,,720014,0,0,13,13,OFFICE NO. 1 TULSA TECH CENTER
TULSA,OFFICE NO. 2 TULSA PUBLIC SCHOOLS,PHIL ARMSTRONG,,720015,0,0,22,22,OFFICE NO. 2 TULSA PUBLIC SCHOOLS
TULSA,OFFICE NO. 2 TULSA PUBLIC SCHOOLS,WILBERT E. COLLINS SR.,,720015,0,0,8,8,OFFICE NO. 2 TULSA PUBLIC SCHOOLS
TULSA,OFFICE NO. 2 TULSA PUBLIC SCHOOLS,AMY SHELTON,,720015,0,0,4,4,OFFICE NO. 2 TULSA PUBLIC SCHOOLS
TULSA,OFFICE NO. 1 TULSA TECH CENTER,RAY A. OWENS,,720015,0,0,20,20,OFFICE NO. 1 TULSA TECH CENTER
TULSA,OFFICE NO. 1 TULSA TECH CENTER,MELANIE SWEENEY McINTOSH,,720015,0,0,8,8,OFFICE NO. 1 TULSA TECH CENTER
TULSA,OFFICE NO. 1 TULSA TECH CENTER,KEENAN H. MEADORS,,720015,0,0,6,6,OFFICE NO. 1 TULSA TECH CENTER
TULSA,OFFICE NO. 2 TULSA PUBLIC SCHOOLS,PHIL ARMSTRONG,,720016,0,0,2,2,OFFICE NO. 2 TULSA PUBLIC SCHOOLS
TULSA,OFFICE NO. 2 TULSA PUBLIC SCHOOLS,WILBERT E. COLLINS SR.,,720016,0,0,0,0,OFFICE NO. 2 TULSA PUBLIC SCHOOLS
TULSA,OFFICE NO. 2 TULSA PUBLIC SCHOOLS,AMY SHELTON,,720016,0,0,5,5,OFFICE NO. 2 TULSA PUBLIC SCHOOLS
TULSA,OFFICE NO. 1 TULSA TECH CENTER,RAY A. OWENS,,720016,0,0,1,1,OFFICE NO. 1 TULSA TECH CENTER
TULSA,OFFICE NO. 1 TULSA TECH CENTER,MELANIE SWEENEY McINTOSH,,720016,0,0,4,4,OFFICE NO. 1 TULSA TECH CENTER
TULSA,OFFICE NO. 1 TULSA TECH CENTER,KEENAN H. MEADORS,,720016,0,0,2,2,OFFICE NO. 1 TULSA TECH CENTER
TULSA,OFFICE NO. 2 TULSA PUBLIC SCHOOLS,PHIL ARMSTRONG,,720017,0,0,1,1,OFFICE NO. 2 TULSA PUBLIC SCHOOLS
TULSA,OFFICE NO. 2 TULSA PUBLIC SCHOOLS,WILBERT E. COLLINS SR.,,720017,0,0,0,0,OFFICE NO. 2 TULSA PUBLIC SCHOOLS
TULSA,OFFICE NO. 2 TULSA PUBLIC SCHOOLS,AMY SHELTON,,720017,0,0,12,12,OFFICE NO. 2 TULSA PUBLIC SCHOOLS
TULSA,OFFICE NO. 1 TULSA TECH CENTER,RAY A. OWENS,,720017,0,0,5,5,OFFICE NO. 1 TULSA TECH CENTER
TULSA,OFFICE NO. 1 TULSA TECH CENTER,MELANIE SWEENEY McINTOSH,,720017,0,0,7,7,OFFICE NO. 1 TULSA TECH CENTER
TULSA,OFFICE NO. 1 TULSA TECH CENTER,KEENAN H. MEADORS,,720017,0,0,1,1,OFFICE NO. 1 TULSA TECH CENTER
TULSA,OFFICE NO. 2 TULSA PUBLIC SCHOOLS,PHIL ARMSTRONG,,720018,0,0,2,2,OFFICE NO. 2 TULSA PUBLIC SCHOOLS
TULSA,OFFICE NO. 2 TULSA PUBLIC SCHOOLS,WILBERT E. COLLINS SR.,,720018,0,0,0,0,OFFICE NO. 2 TULSA PUBLIC SCHOOLS
TULSA,OFFICE NO. 2 TULSA PUBLIC SCHOOLS,AMY SHELTON,,720018,0,0,16,16,OFFICE NO. 2 TULSA PUBLIC SCHOOLS
TULSA,OFFICE NO. 1 TULSA TECH CENTER,RAY A. OWENS,,720018,0,0,3,3,OFFICE NO. 1 TULSA TECH CENTER
TULSA,OFFICE NO. 1 TULSA TECH CENTER,MELANIE SWEENEY McINTOSH,,720018,0,0,9,9,OFFICE NO. 1 TULSA TECH CENTER
TULSA,OFFICE NO. 1 TULSA TECH CENTER,KEENAN H. MEADORS,,720018,0,0,5,5,OFFICE NO. 1 TULSA TECH CENTER
TULSA,OFFICE NO. 2 TULSA PUBLIC SCHOOLS,PHIL ARMSTRONG,,720019,0,0,4,4,OFFICE NO. 2 TULSA PUBLIC SCHOOLS
TULSA,OFFICE NO. 2 TULSA PUBLIC SCHOOLS,WILBERT E. COLLINS SR.,,720019,0,0,3,3,OFFICE NO. 2 TULSA PUBLIC SCHOOLS
TULSA,OFFICE NO. 2 TULSA PUBLIC SCHOOLS,AMY SHELTON,,720019,0,0,10,10,OFFICE NO. 2 TULSA PUBLIC SCHOOLS
TULSA,OFFICE NO. 1 TULSA TECH CENTER,RAY A. OWENS,,720019,0,0,7,7,OFFICE NO. 1 TULSA TECH CENTER
TULSA,OFFICE NO. 1 TULSA TECH CENTER,MELANIE SWEENEY McINTOSH,,720019,0,0,9,9,OFFICE NO. 1 TULSA TECH CENTER
TULSA,OFFICE NO. 1 TULSA TECH CENTER,KEENAN H. MEADORS,,720019,0,0,0,0,OFFICE NO. 1 TULSA TECH CENTER
TULSA,OFFICE NO. 2 TULSA PUBLIC SCHOOLS,PHIL ARMSTRONG,,720020,0,0,4,4,OFFICE NO. 2 TULSA PUBLIC SCHOOLS
TULSA,OFFICE NO. 2 TULSA PUBLIC SCHOOLS,WILBERT E. COLLINS SR.,,720020,0,0,2,2,OFFICE NO. 2 TULSA PUBLIC SCHOOLS
TULSA,OFFICE NO. 2 TULSA PUBLIC SCHOOLS,AMY SHELTON,,720020,0,0,26,26,OFFICE NO. 2 TULSA PUBLIC SCHOOLS
TULSA,OFFICE NO. 1 TULSA TECH CENTER,RAY A. OWENS,,720020,0,0,9,9,OFFICE NO. 1 TULSA TECH CENTER
TULSA,OFFICE NO. 1 TULSA TECH CENTER,MELANIE SWEENEY McINTOSH,,720020,0,0,17,17,OFFICE NO. 1 TULSA TECH CENTER
TULSA,OFFICE NO. 1 TULSA TECH CENTER,KEENAN H. MEADORS,,720020,0,0,6,6,OFFICE NO. 1 TULSA TECH CENTER
TULSA,OFFICE NO. 1 TULSA TECH CENTER,RAY A. OWENS,,720021,0,0,0,0,OFFICE NO. 1 TULSA TECH CENTER
TULSA,OFFICE NO. 1 TULSA TECH CENTER,MELANIE SWEENEY McINTOSH,,720021,0,0,1,1,OFFICE NO. 1 TULSA TECH CENTER
TULSA,OFFICE NO. 1 TULSA TECH CENTER,KEENAN H. MEADORS,,720021,0,0,0,0,OFFICE NO. 1 TULSA TECH CENTER
TULSA,OFFICE NO. 3 TULSA PUBLIC SCHOOLS,LANA TURNER,,720023,0,0,0,0,OFFICE NO. 3 TULSA PUBLIC SCHOOLS
TULSA,OFFICE NO. 3 TULSA PUBLIC SCHOOLS,WHITNEY COLE,,720023,0,0,1,1,OFFICE NO. 3 TULSA PUBLIC SCHOOLS
TULSA,OFFICE NO. 3 TULSA PUBLIC SCHOOLS,JENNETTIE P. MARSHALL,,720023,0,0,0,0,OFFICE NO. 3 TULSA PUBLIC SCHOOLS
TULSA,OFFICE NO. 3 TULSA PUBLIC SCHOOLS,LANA TURNER,,720024,0,0,5,5,OFFICE NO. 3 TULSA PUBLIC SCHOOLS
TULSA,OFFICE NO. 3 TULSA PUBLIC SCHOOLS,WHITNEY COLE,,720024,0,0,3,3,OFFICE NO. 3 TULSA PUBLIC SCHOOLS
TULSA,OFFICE NO. 3 TULSA PUBLIC SCHOOLS,JENNETTIE P. MARSHALL,,720024,0,0,1,1,OFFICE NO. 3 TULSA PUBLIC SCHOOLS
TULSA,OFFICE NO. 2 TULSA PUBLIC SCHOOLS,PHIL ARMSTRONG,,720025,0,0,1,1,OFFICE NO. 2 TULSA PUBLIC SCHOOLS
TULSA,OFFICE NO. 2 TULSA PUBLIC SCHOOLS,WILBERT E. COLLINS SR.,,720025,0,0,0,0,OFFICE NO. 2 TULSA PUBLIC SCHOOLS
TULSA,OFFICE NO. 2 TULSA PUBLIC SCHOOLS,AMY SHELTON,,720025,0,0,12,12,OFFICE NO. 2 TULSA PUBLIC SCHOOLS
TULSA,OFFICE NO. 2 TULSA PUBLIC SCHOOLS,PHIL ARMSTRONG,,720026,0,0,0,0,OFFICE NO. 2 TULSA PUBLIC SCHOOLS
TULSA,OFFICE NO. 2 TULSA PUBLIC SCHOOLS,WILBERT E. COLLINS SR.,,720026,0,0,0,0,OFFICE NO. 2 TULSA PUBLIC SCHOOLS
TULSA,OFFICE NO. 2 TULSA PUBLIC SCHOOLS,AMY SHELTON,,720026,0,0,10,10,OFFICE NO. 2 TULSA PUBLIC SCHOOLS
TULSA,OFFICE NO. 2 TULSA PUBLIC SCHOOLS,PHIL ARMSTRONG,,720027,0,0,1,1,OFFICE NO. 2 TULSA PUBLIC SCHOOLS
TULSA,OFFICE NO. 2 TULSA PUBLIC SCHOOLS,WILBERT E. COLLINS SR.,,720027,0,0,1,1,OFFICE NO. 2 TULSA PUBLIC SCHOOLS
TULSA,OFFICE NO. 2 TULSA PUBLIC SCHOOLS,AMY SHELTON,,720027,0,0,8,8,OFFICE NO. 2 TULSA PUBLIC SCHOOLS
TULSA,OFFICE NO. 2 TULSA PUBLIC SCHOOLS,PHIL ARMSTRONG,,720028,0,0,4,4,OFFICE NO. 2 TULSA PUBLIC SCHOOLS
TULSA,OFFICE NO. 2 TULSA PUBLIC SCHOOLS,WILBERT E. COLLINS SR.,,720028,0,0,0,0,OFFICE NO. 2 TULSA PUBLIC SCHOOLS
TULSA,OFFICE NO. 2 TULSA PUBLIC SCHOOLS,AMY SHELTON,,720028,0,0,20,20,OFFICE NO. 2 TULSA PUBLIC SCHOOLS
TULSA,OFFICE NO. 3 TULSA PUBLIC SCHOOLS,LANA TURNER,,720029,0,0,1,1,OFFICE NO. 3 TULSA PUBLIC SCHOOLS
TULSA,OFFICE NO. 3 TULSA PUBLIC SCHOOLS,WHITNEY COLE,,720029,0,0,3,3,OFFICE NO. 3 TULSA PUBLIC SCHOOLS
TULSA,OFFICE NO. 3 TULSA PUBLIC SCHOOLS,JENNETTIE P. MARSHALL,,720029,0,0,3,3,OFFICE NO. 3 TULSA PUBLIC SCHOOLS
TULSA,OFFICE NO. 1 TULSA TECH CENTER,RAY A. OWENS,,720030,0,0,6,6,OFFICE NO. 1 TULSA TECH CENTER
TULSA,OFFICE NO. 1 TULSA TECH CENTER,MELANIE SWEENEY McINTOSH,,720030,0,0,5,5,OFFICE NO. 1 TULSA TECH CENTER
TULSA,OFFICE NO. 1 TULSA TECH CENTER,KEENAN H. MEADORS,,720030,0,0,0,0,OFFICE NO. 1 TULSA TECH CENTER
TULSA,OFFICE NO. 2 TULSA PUBLIC SCHOOLS,PHIL ARMSTRONG,,720031,0,0,1,1,OFFICE NO. 2 TULSA PUBLIC SCHOOLS
TULSA,OFFICE NO. 2 TULSA PUBLIC SCHOOLS,WILBERT E. COLLINS SR.,,720031,0,0,0,0,OFFICE NO. 2 TULSA PUBLIC SCHOOLS
TULSA,OFFICE NO. 2 TULSA PUBLIC SCHOOLS,AMY SHELTON,,720031,0,0,20,20,OFFICE NO. 2 TULSA PUBLIC SCHOOLS
TULSA,OFFICE NO. 1 TULSA TECH CENTER,RAY A. OWENS,,720031,0,0,0,0,OFFICE NO. 1 TULSA TECH CENTER
TULSA,OFFICE NO. 1 TULSA TECH CENTER,MELANIE SWEENEY McINTOSH,,720031,0,0,19,19,OFFICE NO. 1 TULSA TECH CENTER
TULSA,OFFICE NO. 1 TULSA TECH CENTER,KEENAN H. MEADORS,,720031,0,0,2,2,OFFICE NO. 1 TULSA TECH CENTER
TULSA,OFFICE NO. 2 TULSA PUBLIC SCHOOLS,PHIL ARMSTRONG,,720032,0,0,3,3,OFFICE NO. 2 TULSA PUBLIC SCHOOLS
TULSA,OFFICE NO. 2 TULSA PUBLIC SCHOOLS,WILBERT E. COLLINS SR.,,720032,0,0,0,0,OFFICE NO. 2 TULSA PUBLIC SCHOOLS
TULSA,OFFICE NO. 2 TULSA PUBLIC SCHOOLS,AMY SHELTON,,720032,0,0,40,40,OFFICE NO. 2 TULSA PUBLIC SCHOOLS
TULSA,OFFICE NO. 1 TULSA TECH CENTER,RAY A. OWENS,,720032,0,0,14,14,OFFICE NO. 1 TULSA TECH CENTER
TULSA,OFFICE NO. 1 TULSA TECH CENTER,MELANIE SWEENEY McINTOSH,,720032,0,0,21,21,OFFICE NO. 1 TULSA TECH CENTER
TULSA,OFFICE NO. 1 TULSA TECH CENTER,KEENAN H. MEADORS,,720032,0,0,6,6,OFFICE NO. 1 TULSA TECH CENTER
TULSA,OFFICE NO. 2 TULSA PUBLIC SCHOOLS,PHIL ARMSTRONG,,720033,0,0,1,1,OFFICE NO. 2 TULSA PUBLIC SCHOOLS
TULSA,OFFICE NO. 2 TULSA PUBLIC SCHOOLS,WILBERT E. COLLINS SR.,,720033,0,0,1,1,OFFICE NO. 2 TULSA PUBLIC SCHOOLS
TULSA,OFFICE NO. 2 TULSA PUBLIC SCHOOLS,AMY SHELTON,,720033,0,0,26,26,OFFICE NO. 2 TULSA PUBLIC SCHOOLS
TULSA,OFFICE NO. 1 TULSA TECH CENTER,RAY A. OWENS,,720033,0,0,3,3,OFFICE NO. 1 TULSA TECH CENTER
TULSA,OFFICE NO. 1 TULSA TECH CENTER,MELANIE SWEENEY McINTOSH,,720033,0,0,20,20,OFFICE NO. 1 TULSA TECH CENTER
TULSA,OFFICE NO. 1 TULSA TECH CENTER,KEENAN H. MEADORS,,720033,0,0,1,1,OFFICE NO. 1 TULSA TECH CENTER
TULSA,OFFICE NO. 2 TULSA PUBLIC SCHOOLS,PHIL ARMSTRONG,,720034,0,0,1,1,OFFICE NO. 2 TULSA PUBLIC SCHOOLS
TULSA,OFFICE NO. 2 TULSA PUBLIC SCHOOLS,WILBERT E. COLLINS SR.,,720034,0,0,0,0,OFFICE NO. 2 TULSA PUBLIC SCHOOLS
TULSA,OFFICE NO. 2 TULSA PUBLIC SCHOOLS,AMY SHELTON,,720034,0,0,11,11,OFFICE NO. 2 TULSA PUBLIC SCHOOLS
TULSA,OFFICE NO. 1 TULSA TECH CENTER,RAY A. OWENS,,720034,0,0,0,0,OFFICE NO. 1 TULSA TECH CENTER
TULSA,OFFICE NO. 1 TULSA TECH CENTER,MELANIE SWEENEY McINTOSH,,720034,0,0,8,8,OFFICE NO. 1 TULSA TECH CENTER
TULSA,OFFICE NO. 1 TULSA TECH CENTER,KEENAN H. MEADORS,,720034,0,0,3,3,OFFICE NO. 1 TULSA TECH CENTER
TULSA,OFFICE NO. 2 TULSA PUBLIC SCHOOLS,PHIL ARMSTRONG,,720035,0,0,3,3,OFFICE NO. 2 TULSA PUBLIC SCHOOLS
TULSA,OFFICE NO. 2 TULSA PUBLIC SCHOOLS,WILBERT E. COLLINS SR.,,720035,0,0,3,3,OFFICE NO. 2 TULSA PUBLIC SCHOOLS
TULSA,OFFICE NO. 2 TULSA PUBLIC SCHOOLS,AMY SHELTON,,720035,0,0,64,64,OFFICE NO. 2 TULSA PUBLIC SCHOOLS
TULSA,OFFICE NO. 1 TULSA TECH CENTER,RAY A. OWENS,,720035,0,0,12,12,OFFICE NO. 1 TULSA TECH CENTER
TULSA,OFFICE NO. 1 TULSA TECH CENTER,MELANIE SWEENEY McINTOSH,,720035,0,0,44,44,OFFICE NO. 1 TULSA TECH CENTER
TULSA,OFFICE NO. 1 TULSA TECH CENTER,KEENAN H. MEADORS,,720035,0,0,9,9,OFFICE NO. 1 TULSA TECH CENTER
TULSA,OFFICE NO. 1 TULSA TECH CENTER,RAY A. OWENS,,720037,0,0,3,3,OFFICE NO. 1 TULSA TECH CENTER
TULSA,OFFICE NO. 1 TULSA TECH CENTER,MELANIE SWEENEY McINTOSH,,720037,0,0,5,5,OFFICE NO. 1 TULSA TECH CENTER
TULSA,OFFICE NO. 1 TULSA TECH CENTER,KEENAN H. MEADORS,,720037,0,0,0,0,OFFICE NO. 1 TULSA TECH CENTER
TULSA,OFFICE NO. 1 TULSA TECH CENTER,RAY A. OWENS,,720046,0,0,8,8,OFFICE NO. 1 TULSA TECH CENTER
TULSA,OFFICE NO. 1 TULSA TECH CENTER,MELANIE SWEENEY McINTOSH,,720046,0,0,14,14,OFFICE NO. 1 TULSA TECH CENTER
TULSA,OFFICE NO. 1 TULSA TECH CENTER,KEENAN H. MEADORS,,720046,0,0,7,7,OFFICE NO. 1 TULSA TECH CENTER
TULSA,OFFICE NO. 1 TULSA TECH CENTER,RAY A. OWENS,,720047,0,0,1,1,OFFICE NO. 1 TULSA TECH CENTER
TULSA,OFFICE NO. 1 TULSA TECH CENTER,MELANIE SWEENEY McINTOSH,,720047,0,0,0,0,OFFICE NO. 1 TULSA TECH CENTER
TULSA,OFFICE NO. 1 TULSA TECH CENTER,KEENAN H. MEADORS,,720047,0,0,0,0,OFFICE NO. 1 TULSA TECH CENTER
TULSA,OFFICE NO. 1 TULSA TECH CENTER,RAY A. OWENS,,720048,0,0,5,5,OFFICE NO. 1 TULSA TECH CENTER
TULSA,OFFICE NO. 1 TULSA TECH CENTER,MELANIE SWEENEY McINTOSH,,720048,0,0,9,9,OFFICE NO. 1 TULSA TECH CENTER
TULSA,OFFICE NO. 1 TULSA TECH CENTER,KEENAN H. MEADORS,,720048,0,0,5,5,OFFICE NO. 1 TULSA TECH CENTER
TULSA,OFFICE NO. 1 TULSA TECH CENTER,RAY A. OWENS,,720049,0,0,5,5,OFFICE NO. 1 TULSA TECH CENTER
TULSA,OFFICE NO. 1 TULSA TECH CENTER,MELANIE SWEENEY McINTOSH,,720049,0,0,5,5,OFFICE NO. 1 TULSA TECH CENTER
TULSA,OFFICE NO. 1 TULSA TECH CENTER,KEENAN H. MEADORS,,720049,0,0,0,0,OFFICE NO. 1 TULSA TECH CENTER
TULSA,OFFICE NO. 1 TULSA TECH CENTER,RAY A. OWENS,,720050,0,0,2,2,OFFICE NO. 1 TULSA TECH CENTER
TULSA,OFFICE NO. 1 TULSA TECH CENTER,MELANIE SWEENEY McINTOSH,,720050,0,0,4,4,OFFICE NO. 1 TULSA TECH CENTER
TULSA,OFFICE NO. 1 TULSA TECH CENTER,KEENAN H. MEADORS,,720050,0,0,1,1,OFFICE NO. 1 TULSA TECH CENTER
TULSA,OFFICE NO. 1 TULSA TECH CENTER,RAY A. OWENS,,720051,0,0,4,4,OFFICE NO. 1 TULSA TECH CENTER
TULSA,OFFICE NO. 1 TULSA TECH CENTER,MELANIE SWEENEY McINTOSH,,720051,0,0,4,4,OFFICE NO. 1 TULSA TECH CENTER
TULSA,OFFICE NO. 1 TULSA TECH CENTER,KEENAN H. MEADORS,,720051,0,0,1,1,OFFICE NO. 1 TULSA TECH CENTER
TULSA,OFFICE NO. 1 TULSA TECH CENTER,RAY A. OWENS,,720052,0,0,4,4,OFFICE NO. 1 TULSA TECH CENTER
TULSA,OFFICE NO. 1 TULSA TECH CENTER,MELANIE SWEENEY McINTOSH,,720052,0,0,14,14,OFFICE NO. 1 TULSA TECH CENTER
TULSA,OFFICE NO. 1 TULSA TECH CENTER,KEENAN H. MEADORS,,720052,0,0,2,2,OFFICE NO. 1 TULSA TECH CENTER
TULSA,OFFICE NO. 1 TULSA TECH CENTER,RAY A. OWENS,,720054,0,0,11,11,OFFICE NO. 1 TULSA TECH CENTER
TULSA,OFFICE NO. 1 TULSA TECH CENTER,MELANIE SWEENEY McINTOSH,,720054,0,0,18,18,OFFICE NO. 1 TULSA TECH CENTER
TULSA,OFFICE NO. 1 TULSA TECH CENTER,KEENAN H. MEADORS,,720054,0,0,3,3,OFFICE NO. 1 TULSA TECH CENTER
TULSA,PROPOSITION UNION PUBLIC SCHOOLS,FOR THE PROPOSITION - YES,,720086,0,0,55,55,
TULSA,PROPOSITION UNION PUBLIC SCHOOLS,AGAINST THE PROPOSITION - NO,,720086,0,0,31,31,
TULSA,PROPOSITION UNION PUBLIC SCHOOLS,FOR THE PROPOSITION - YES,,720090,0,0,10,10,
TULSA,PROPOSITION UNION PUBLIC SCHOOLS,AGAINST THE PROPOSITION - NO,,720090,0,0,0,0,
TULSA,PROPOSITION UNION PUBLIC SCHOOLS,FOR THE PROPOSITION - YES,,720095,0,0,1,1,
TULSA,PROPOSITION UNION PUBLIC SCHOOLS,AGAINST THE PROPOSITION - NO,,720095,0,0,0,0,
TULSA,PROPOSITION UNION PUBLIC SCHOOLS,FOR THE PROPOSITION - YES,,720096,0,0,12,12,
TULSA,PROPOSITION UNION PUBLIC SCHOOLS,AGAINST THE PROPOSITION - NO,,720096,0,0,6,6,
TULSA,PROPOSITION UNION PUBLIC SCHOOLS,FOR THE PROPOSITION - YES,,720097,0,0,0,0,
TULSA,PROPOSITION UNION PUBLIC SCHOOLS,AGAINST THE PROPOSITION - NO,,720097,0,0,0,0,
TULSA,PROPOSITION UNION PUBLIC SCHOOLS,FOR THE PROPOSITION - YES,,720100,0,0,12,12,
TULSA,PROPOSITION UNION PUBLIC SCHOOLS,AGAINST THE PROPOSITION - NO,,720100,0,0,6,6,
TULSA,PROPOSITION UNION PUBLIC SCHOOLS,FOR THE PROPOSITION - YES,,720101,0,0,40,40,
TULSA,PROPOSITION UNION PUBLIC SCHOOLS,AGAINST THE PROPOSITION - NO,,720101,0,0,11,11,
TULSA,PROPOSITION UNION PUBLIC SCHOOLS,FOR THE PROPOSITION - YES,,720102,0,0,38,38,
TULSA,PROPOSITION UNION PUBLIC SCHOOLS,AGAINST THE PROPOSITION - NO,,720102,0,0,17,17,
TULSA,PROPOSITION UNION PUBLIC SCHOOLS,FOR THE PROPOSITION - YES,,720104,0,0,33,33,
TULSA,PROPOSITION UNION PUBLIC SCHOOLS,AGAINST THE PROPOSITION - NO,,720104,0,0,9,9,
TULSA,PROPOSITION UNION PUBLIC SCHOOLS,FOR THE PROPOSITION - YES,,720105,0,0,39,39,
TULSA,PROPOSITION UNION PUBLIC SCHOOLS,AGAINST THE PROPOSITION - NO,,720105,0,0,7,7,
TULSA,PROPOSITION UNION PUBLIC SCHOOLS,FOR THE PROPOSITION - YES,,720106,0,0,23,23,
TULSA,PROPOSITION UNION PUBLIC SCHOOLS,AGAINST THE PROPOSITION - NO,,720106,0,0,4,4,
TULSA,PROPOSITION NO. 1 JENKS PUBLIC SCHOOLS,FOR THE PROPOSITION - YES,,720110,0,0,2,2,PROPOSITION NO. 1 JENKS PUBLIC SCHOOLS
TULSA,PROPOSITION NO. 1 JENKS PUBLIC SCHOOLS,AGAINST THE PROPOSITION - NO,,720110,0,0,1,1,PROPOSITION NO. 1 JENKS PUBLIC SCHOOLS
TULSA,PROPOSITION NO. 2 JENKS PUBLIC SCHOOLS,FOR THE PROPOSITION - YES,,720110,0,0,2,2,PROPOSITION NO. 2 JENKS PUBLIC SCHOOLS
TULSA,PROPOSITION NO. 2 JENKS PUBLIC SCHOOLS,AGAINST THE PROPOSITION - NO,,720110,0,0,1,1,PROPOSITION NO. 2 JENKS PUBLIC SCHOOLS
TULSA,PROPOSITION NO. 1 JENKS PUBLIC SCHOOLS,FOR THE PROPOSITION - YES,,720112,0,0,4,4,PROPOSITION NO. 1 JENKS PUBLIC SCHOOLS
TULSA,PROPOSITION NO. 1 JENKS PUBLIC SCHOOLS,AGAINST THE PROPOSITION - NO,,720112,0,0,0,0,PROPOSITION NO. 1 JENKS PUBLIC SCHOOLS
TULSA,PROPOSITION NO. 2 JENKS PUBLIC SCHOOLS,FOR THE PROPOSITION - YES,,720112,0,0,4,4,PROPOSITION NO. 2 JENKS PUBLIC SCHOOLS
TULSA,PROPOSITION NO. 2 JENKS PUBLIC SCHOOLS,AGAINST THE PROPOSITION - NO,,720112,0,0,0,0,PROPOSITION NO. 2 JENKS PUBLIC SCHOOLS
TULSA,PROPOSITION NO. 1 JENKS PUBLIC SCHOOLS,FOR THE PROPOSITION - YES,,720113,0,0,37,37,PROPOSITION NO. 1 JENKS PUBLIC SCHOOLS
TULSA,PROPOSITION NO. 1 JENKS PUBLIC SCHOOLS,AGAINST THE PROPOSITION - NO,,720113,0,0,0,0,PROPOSITION NO. 1 JENKS PUBLIC SCHOOLS
TULSA,PROPOSITION NO. 2 JENKS PUBLIC SCHOOLS,FOR THE PROPOSITION - YES,,720113,0,0,38,38,PROPOSITION NO. 2 JENKS PUBLIC SCHOOLS
TULSA,PROPOSITION NO. 2 JENKS PUBLIC SCHOOLS,AGAINST THE PROPOSITION - NO,,720113,0,0,1,1,PROPOSITION NO. 2 JENKS PUBLIC SCHOOLS
TULSA,PROPOSITION NO. 1 JENKS PUBLIC SCHOOLS,FOR THE PROPOSITION - YES,,720116,0,0,28,28,PROPOSITION NO. 1 JENKS PUBLIC SCHOOLS
TULSA,PROPOSITION NO. 1 JENKS PUBLIC SCHOOLS,AGAINST THE PROPOSITION - NO,,720116,0,0,3,3,PROPOSITION NO. 1 JENKS PUBLIC SCHOOLS
TULSA,PROPOSITION NO. 2 JENKS PUBLIC SCHOOLS,FOR THE PROPOSITION - YES,,720116,0,0,28,28,PROPOSITION NO. 2 JENKS PUBLIC SCHOOLS
TULSA,PROPOSITION NO. 2 JENKS PUBLIC SCHOOLS,AGAINST THE PROPOSITION - NO,,720116,0,0,3,3,PROPOSITION NO. 2 JENKS PUBLIC SCHOOLS
TULSA,PROPOSITION NO. 1 JENKS PUBLIC SCHOOLS,FOR THE PROPOSITION - YES,,720117,0,0,66,66,PROPOSITION NO. 1 JENKS PUBLIC SCHOOLS
TULSA,PROPOSITION NO. 1 JENKS PUBLIC SCHOOLS,AGAINST THE PROPOSITION - NO,,720117,0,0,9,9,PROPOSITION NO. 1 JENKS PUBLIC SCHOOLS
TULSA,PROPOSITION NO. 2 JENKS PUBLIC SCHOOLS,FOR THE PROPOSITION - YES,,720117,0,0,66,66,PROPOSITION NO. 2 JENKS PUBLIC SCHOOLS
TULSA,PROPOSITION NO. 2 JENKS PUBLIC SCHOOLS,AGAINST THE PROPOSITION - NO,,720117,0,0,10,10,PROPOSITION NO. 2 JENKS PUBLIC SCHOOLS
TULSA,PROPOSITION UNION PUBLIC SCHOOLS,FOR THE PROPOSITION - YES,,720118,0,0,72,72,
TULSA,PROPOSITION UNION PUBLIC SCHOOLS,AGAINST THE PROPOSITION - NO,,720118,0,0,14,14,
TULSA,PROPOSITION NO. 1 JENKS PUBLIC SCHOOLS,FOR THE PROPOSITION - YES,,720119,0,0,33,33,PROPOSITION NO. 1 JENKS PUBLIC SCHOOLS
TULSA,PROPOSITION NO. 1 JENKS PUBLIC SCHOOLS,AGAINST THE PROPOSITION - NO,,720119,0,0,13,13,PROPOSITION NO. 1 JENKS PUBLIC SCHOOLS
TULSA,PROPOSITION NO. 2 JENKS PUBLIC SCHOOLS,FOR THE PROPOSITION - YES,,720119,0,0,33,33,PROPOSITION NO. 2 JENKS PUBLIC SCHOOLS
TULSA,PROPOSITION NO. 2 JENKS PUBLIC SCHOOLS,AGAINST THE PROPOSITION - NO,,720119,0,0,13,13,PROPOSITION NO. 2 JENKS PUBLIC SCHOOLS
TULSA,PROPOSITION UNION PUBLIC SCHOOLS,FOR THE PROPOSITION - YES,,720120,0,0,26,26,
TULSA,PROPOSITION UNION PUBLIC SCHOOLS,AGAINST THE PROPOSITION - NO,,720120,0,0,8,8,
TULSA,PROPOSITION UNION PUBLIC SCHOOLS,FOR THE PROPOSITION - YES,,720122,0,0,33,33,
TULSA,PROPOSITION UNION PUBLIC SCHOOLS,AGAINST THE PROPOSITION - NO,,720122,0,0,3,3,
TULSA,PROPOSITION NO. 1 JENKS PUBLIC SCHOOLS,FOR THE PROPOSITION - YES,,720123,0,0,18,18,PROPOSITION NO. 1 JENKS PUBLIC SCHOOLS
TULSA,PROPOSITION NO. 1 JENKS PUBLIC SCHOOLS,AGAINST THE PROPOSITION - NO,,720123,0,0,5,5,PROPOSITION NO. 1 JENKS PUBLIC SCHOOLS
TULSA,PROPOSITION NO. 2 JENKS PUBLIC SCHOOLS,FOR THE PROPOSITION - YES,,720123,0,0,18,18,PROPOSITION NO. 2 JENKS PUBLIC SCHOOLS
TULSA,PROPOSITION NO. 2 JENKS PUBLIC SCHOOLS,AGAINST THE PROPOSITION - NO,,720123,0,0,5,5,PROPOSITION NO. 2 JENKS PUBLIC SCHOOLS
TULSA,PROPOSITION NO. 1 JENKS PUBLIC SCHOOLS,FOR THE PROPOSITION - YES,,720124,0,0,34,34,PROPOSITION NO. 1 JENKS PUBLIC SCHOOLS
TULSA,PROPOSITION NO. 1 JENKS PUBLIC SCHOOLS,AGAINST THE PROPOSITION - NO,,720124,0,0,17,17,PROPOSITION NO. 1 JENKS PUBLIC SCHOOLS
TULSA,PROPOSITION NO. 2 JENKS PUBLIC SCHOOLS,FOR THE PROPOSITION - YES,,720124,0,0,35,35,PROPOSITION NO. 2 JENKS PUBLIC SCHOOLS
TULSA,PROPOSITION NO. 2 JENKS PUBLIC SCHOOLS,AGAINST THE PROPOSITION - NO,,720124,0,0,16,16,PROPOSITION NO. 2 JENKS PUBLIC SCHOOLS
TULSA,PROPOSITION UNION PUBLIC SCHOOLS,FOR THE PROPOSITION - YES,,720127,0,0,40,40,
TULSA,PROPOSITION UNION PUBLIC SCHOOLS,AGAINST THE PROPOSITION - NO,,720127,0,0,1,1,
TULSA,PROPOSITION UNION PUBLIC SCHOOLS,FOR THE PROPOSITION - YES,,720128,0,0,3,3,
TULSA,PROPOSITION UNION PUBLIC SCHOOLS,AGAINST THE PROPOSITION - NO,,720128,0,0,0,0,
TULSA,PROPOSITION UNION PUBLIC SCHOOLS,FOR THE PROPOSITION - YES,,720131,0,0,11,11,
TULSA,PROPOSITION UNION PUBLIC SCHOOLS,AGAINST THE PROPOSITION - NO,,720131,0,0,0,0,
TULSA,PROPOSITION UNION PUBLIC SCHOOLS,FOR THE PROPOSITION - YES,,720134,0,0,52,52,
TULSA,PROPOSITION UNION PUBLIC SCHOOLS,AGAINST THE PROPOSITION - NO,,720134,0,0,25,25,
TULSA,PROPOSITION NO. 1 JENKS PUBLIC SCHOOLS,FOR THE PROPOSITION - YES,,720135,0,0,9,9,PROPOSITION NO. 1 JENKS PUBLIC SCHOOLS
TULSA,PROPOSITION NO. 1 JENKS PUBLIC SCHOOLS,AGAINST THE PROPOSITION - NO,,720135,0,0,2,2,PROPOSITION NO. 1 JENKS PUBLIC SCHOOLS
TULSA,PROPOSITION NO. 2 JENKS PUBLIC SCHOOLS,FOR THE PROPOSITION - YES,,720135,0,0,8,8,PROPOSITION NO. 2 JENKS PUBLIC SCHOOLS
TULSA,PROPOSITION NO. 2 JENKS PUBLIC SCHOOLS,AGAINST THE PROPOSITION - NO,,720135,0,0,3,3,PROPOSITION NO. 2 JENKS PUBLIC SCHOOLS
TULSA,PROPOSITION UNION PUBLIC SCHOOLS,FOR THE PROPOSITION - YES,,720135,0,0,55,55,
TULSA,PROPOSITION UNION PUBLIC SCHOOLS,AGAINST THE PROPOSITION - NO,,720135,0,0,9,9,
TULSA,PROPOSITION UNION PUBLIC SCHOOLS,FOR THE PROPOSITION - YES,,720136,0,0,75,75,
TULSA,PROPOSITION UNION PUBLIC SCHOOLS,AGAINST THE PROPOSITION - NO,,720136,0,0,5,5,
TULSA,PROPOSITION UNION PUBLIC SCHOOLS,FOR THE PROPOSITION - YES,,720137,0,0,30,30,
TULSA,PROPOSITION UNION PUBLIC SCHOOLS,AGAINST THE PROPOSITION - NO,,720137,0,0,3,3,
TULSA,PROPOSITION UNION PUBLIC SCHOOLS,FOR THE PROPOSITION - YES,,720138,0,0,7,7,
TULSA,PROPOSITION UNION PUBLIC SCHOOLS,AGAINST THE PROPOSITION - NO,,720138,0,0,5,5,
TULSA,OFFICE NO. 1 TULSA TECH CENTER,RAY A. OWENS,,720140,0,0,0,0,OFFICE NO. 1 TULSA TECH CENTER
TULSA,OFFICE NO. 1 TULSA TECH CENTER,MELANIE SWEENEY McINTOSH,,720140,0,0,3,3,OFFICE NO. 1 TULSA TECH CENTER
TULSA,OFFICE NO. 1 TULSA TECH CENTER,KEENAN H. MEADORS,,720140,0,0,0,0,OFFICE NO. 1 TULSA TECH CENTER
TULSA,OFFICE NO. 5 (UNEXPIRED TERM) TULSA TECH CENTER,ROY D. McCLAIN,,720142,0,0,4,4,OFFICE NO. 5 (UNEXPIRED TERM) TULSA TECH CENTER
TULSA,OFFICE NO. 5 (UNEXPIRED TERM) TULSA TECH CENTER,DANNY HANCOCK,,720142,0,0,8,8,OFFICE NO. 5 (UNEXPIRED TERM) TULSA TECH CENTER
TULSA,PROPOSITION NO. 1 JENKS PUBLIC SCHOOLS,FOR THE PROPOSITION - YES,,720145,0,0,44,44,PROPOSITION NO. 1 JENKS PUBLIC SCHOOLS
TULSA,PROPOSITION NO. 1 JENKS PUBLIC SCHOOLS,AGAINST THE PROPOSITION - NO,,720145,0,0,9,9,PROPOSITION NO. 1 JENKS PUBLIC SCHOOLS
TULSA,PROPOSITION NO. 2 JENKS PUBLIC SCHOOLS,FOR THE PROPOSITION - YES,,720145,0,0,44,44,PROPOSITION NO. 2 JENKS PUBLIC SCHOOLS
TULSA,PROPOSITION NO. 2 JENKS PUBLIC SCHOOLS,AGAINST THE PROPOSITION - NO,,720145,0,0,9,9,PROPOSITION NO. 2 JENKS PUBLIC SCHOOLS
TULSA,PROPOSITION NO. 1 JENKS PUBLIC SCHOOLS,FOR THE PROPOSITION - YES,,720146,0,0,27,27,PROPOSITION NO. 1 JENKS PUBLIC SCHOOLS
TULSA,PROPOSITION NO. 1 JENKS PUBLIC SCHOOLS,AGAINST THE PROPOSITION - NO,,720146,0,0,8,8,PROPOSITION NO. 1 JENKS PUBLIC SCHOOLS
TULSA,PROPOSITION NO. 2 JENKS PUBLIC SCHOOLS,FOR THE PROPOSITION - YES,,720146,0,0,28,28,PROPOSITION NO. 2 JENKS PUBLIC SCHOOLS
TULSA,PROPOSITION NO. 2 JENKS PUBLIC SCHOOLS,AGAINST THE PROPOSITION - NO,,720146,0,0,7,7,PROPOSITION NO. 2 JENKS PUBLIC SCHOOLS
TULSA,OFFICE NO. 1 TULSA TECH CENTER,RAY A. OWENS,,720147,0,0,1,1,OFFICE NO. 1 TULSA TECH CENTER
TULSA,OFFICE NO. 1 TULSA TECH CENTER,MELANIE SWEENEY McINTOSH,,720147,0,0,2,2,OFFICE NO. 1 TULSA TECH CENTER
TULSA,OFFICE NO. 1 TULSA TECH CENTER,KEENAN H. MEADORS,,720147,0,0,0,0,OFFICE NO. 1 TULSA TECH CENTER
TULSA,OFFICE NO. 1 TULSA TECH CENTER,RAY A. OWENS,,720148,0,0,2,2,OFFICE NO. 1 TULSA TECH CENTER
TULSA,OFFICE NO. 1 TULSA TECH CENTER,MELANIE SWEENEY McINTOSH,,720148,0,0,3,3,OFFICE NO. 1 TULSA TECH CENTER
TULSA,OFFICE NO. 1 TULSA TECH CENTER,KEENAN H. MEADORS,,720148,0,0,0,0,OFFICE NO. 1 TULSA TECH CENTER
TULSA,OFFICE NO. 5 (UNEXPIRED TERM) TULSA TECH CENTER,ROY D. McCLAIN,,720149,0,0,6,6,OFFICE NO. 5 (UNEXPIRED TERM) TULSA TECH CENTER
TULSA,OFFICE NO. 5 (UNEXPIRED TERM) TULSA TECH CENTER,DANNY HANCOCK,,720149,0,0,11,11,OFFICE NO. 5 (UNEXPIRED TERM) TULSA TECH CENTER
TULSA,PROPOSITION UNION PUBLIC SCHOOLS,FOR THE PROPOSITION - YES,,720151,0,0,34,34,
TULSA,PROPOSITION UNION PUBLIC SCHOOLS,AGAINST THE PROPOSITION - NO,,720151,0,0,5,5,
TULSA,OFFICE NO. 2 UNION PUBLIC SCHOOLS,PATRICK COYLE,,720153,0,0,21,21,OFFICE NO. 2 UNION PUBLIC SCHOOLS
TULSA,OFFICE NO. 2 UNION PUBLIC SCHOOLS,LISA FORD,,720153,0,0,17,17,OFFICE NO. 2 UNION PUBLIC SCHOOLS
TULSA,OFFICE NO. 2 UNION PUBLIC SCHOOLS,GLENDA K. PUETT,,720153,0,0,10,10,OFFICE NO. 2 UNION PUBLIC SCHOOLS
TULSA,PROPOSITION UNION PUBLIC SCHOOLS,FOR THE PROPOSITION - YES,,720153,0,0,99,99,
TULSA,PROPOSITION UNION PUBLIC SCHOOLS,AGAINST THE PROPOSITION - NO,,720153,0,0,10,10,
TULSA,PROPOSITION NO. 1 JENKS PUBLIC SCHOOLS,FOR THE PROPOSITION - YES,,720154,0,0,57,57,PROPOSITION NO. 1 JENKS PUBLIC SCHOOLS
TULSA,PROPOSITION NO. 1 JENKS PUBLIC SCHOOLS,AGAINST THE PROPOSITION - NO,,720154,0,0,17,17,PROPOSITION NO. 1 JENKS PUBLIC SCHOOLS
TULSA,PROPOSITION NO. 2 JENKS PUBLIC SCHOOLS,FOR THE PROPOSITION - YES,,720154,0,0,58,58,PROPOSITION NO. 2 JENKS PUBLIC SCHOOLS
TULSA,PROPOSITION NO. 2 JENKS PUBLIC SCHOOLS,AGAINST THE PROPOSITION - NO,,720154,0,0,16,16,PROPOSITION NO. 2 JENKS PUBLIC SCHOOLS
TULSA,PROPOSITION NO. 1 JENKS PUBLIC SCHOOLS,FOR THE PROPOSITION - YES,,720155,0,0,133,133,PROPOSITION NO. 1 JENKS PUBLIC SCHOOLS
TULSA,PROPOSITION NO. 1 JENKS PUBLIC SCHOOLS,AGAINST THE PROPOSITION - NO,,720155,0,0,16,16,PROPOSITION NO. 1 JENKS PUBLIC SCHOOLS
TULSA,PROPOSITION NO. 2 JENKS PUBLIC SCHOOLS,FOR THE PROPOSITION - YES,,720155,0,0,133,133,PROPOSITION NO. 2 JENKS PUBLIC SCHOOLS
TULSA,PROPOSITION NO. 2 JENKS PUBLIC SCHOOLS,AGAINST THE PROPOSITION - NO,,720155,0,0,16,16,PROPOSITION NO. 2 JENKS PUBLIC SCHOOLS
TULSA,PROPOSITION UNION PUBLIC SCHOOLS,FOR THE PROPOSITION - YES,,720156,0,0,9,9,
TULSA,PROPOSITION UNION PUBLIC SCHOOLS,AGAINST THE PROPOSITION - NO,,720156,0,0,0,0,
TULSA,PROPOSITION NO. 1 JENKS PUBLIC SCHOOLS,FOR THE PROPOSITION - YES,,720157,0,0,85,85,PROPOSITION NO. 1 JENKS PUBLIC SCHOOLS
TULSA,PROPOSITION NO. 1 JENKS PUBLIC SCHOOLS,AGAINST THE PROPOSITION - NO,,720157,0,0,19,19,PROPOSITION NO. 1 JENKS PUBLIC SCHOOLS
TULSA,PROPOSITION NO. 2 JENKS PUBLIC SCHOOLS,FOR THE PROPOSITION - YES,,720157,0,0,84,84,PROPOSITION NO. 2 JENKS PUBLIC SCHOOLS
TULSA,PROPOSITION NO. 2 JENKS PUBLIC SCHOOLS,AGAINST THE PROPOSITION - NO,,720157,0,0,20,20,PROPOSITION NO. 2 JENKS PUBLIC SCHOOLS
TULSA,PROPOSITION NO. 1 JENKS PUBLIC SCHOOLS,FOR THE PROPOSITION - YES,,720158,0,0,13,13,PROPOSITION NO. 1 JENKS PUBLIC SCHOOLS
TULSA,PROPOSITION NO. 1 JENKS PUBLIC SCHOOLS,AGAINST THE PROPOSITION - NO,,720158,0,0,2,2,PROPOSITION NO. 1 JENKS PUBLIC SCHOOLS
TULSA,PROPOSITION NO. 2 JENKS PUBLIC SCHOOLS,FOR THE PROPOSITION - YES,,720158,0,0,13,13,PROPOSITION NO. 2 JENKS PUBLIC SCHOOLS
TULSA,PROPOSITION NO. 2 JENKS PUBLIC SCHOOLS,AGAINST THE PROPOSITION - NO,,720158,0,0,2,2,PROPOSITION NO. 2 JENKS PUBLIC SCHOOLS
TULSA,PROPOSITION UNION PUBLIC SCHOOLS,FOR THE PROPOSITION - YES,,720158,0,0,35,35,
TULSA,PROPOSITION UNION PUBLIC SCHOOLS,AGAINST THE PROPOSITION - NO,,720158,0,0,10,10,
TULSA,PROPOSITION UNION PUBLIC SCHOOLS,FOR THE PROPOSITION - YES,,720159,0,0,62,62,
TULSA,PROPOSITION UNION PUBLIC SCHOOLS,AGAINST THE PROPOSITION - NO,,720159,0,0,16,16,
TULSA,PROPOSITION NO. 1 JENKS PUBLIC SCHOOLS,FOR THE PROPOSITION - YES,,720161,0,0,12,12,PROPOSITION NO. 1 JENKS PUBLIC SCHOOLS
TULSA,PROPOSITION NO. 1 JENKS PUBLIC SCHOOLS,AGAINST THE PROPOSITION - NO,,720161,0,0,4,4,PROPOSITION NO. 1 JENKS PUBLIC SCHOOLS
TULSA,PROPOSITION NO. 2 JENKS PUBLIC SCHOOLS,FOR THE PROPOSITION - YES,,720161,0,0,12,12,PROPOSITION NO. 2 JENKS PUBLIC SCHOOLS
TULSA,PROPOSITION NO. 2 JENKS PUBLIC SCHOOLS,AGAINST THE PROPOSITION - NO,,720161,0,0,4,4,PROPOSITION NO. 2 JENKS PUBLIC SCHOOLS
TULSA,PROPOSITION NO. 1 JENKS PUBLIC SCHOOLS,FOR THE PROPOSITION - YES,,720162,0,0,0,0,PROPOSITION NO. 1 JENKS PUBLIC SCHOOLS
TULSA,PROPOSITION NO. 1 JENKS PUBLIC SCHOOLS,AGAINST THE PROPOSITION - NO,,720162,0,0,1,1,PROPOSITION NO. 1 JENKS PUBLIC SCHOOLS
TULSA,PROPOSITION NO. 2 JENKS PUBLIC SCHOOLS,FOR THE PROPOSITION - YES,,720162,0,0,0,0,PROPOSITION NO. 2 JENKS PUBLIC SCHOOLS
TULSA,PROPOSITION NO. 2 JENKS PUBLIC SCHOOLS,AGAINST THE PROPOSITION - NO,,720162,0,0,1,1,PROPOSITION NO. 2 JENKS PUBLIC SCHOOLS
TULSA,PROPOSITION NO. 1 JENKS PUBLIC SCHOOLS,FOR THE PROPOSITION - YES,,720165,0,0,10,10,PROPOSITION NO. 1 JENKS PUBLIC SCHOOLS
TULSA,PROPOSITION NO. 1 JENKS PUBLIC SCHOOLS,AGAINST THE PROPOSITION - NO,,720165,0,0,3,3,PROPOSITION NO. 1 JENKS PUBLIC SCHOOLS
TULSA,PROPOSITION NO. 2 JENKS PUBLIC SCHOOLS,FOR THE PROPOSITION - YES,,720165,0,0,10,10,PROPOSITION NO. 2 JENKS PUBLIC SCHOOLS
TULSA,PROPOSITION NO. 2 JENKS PUBLIC SCHOOLS,AGAINST THE PROPOSITION - NO,,720165,0,0,3,3,PROPOSITION NO. 2 JENKS PUBLIC SCHOOLS
TULSA,PROPOSITION NO. 1 JENKS PUBLIC SCHOOLS,FOR THE PROPOSITION - YES,,720166,0,0,59,59,PROPOSITION NO. 1 JENKS PUBLIC SCHOOLS
TULSA,PROPOSITION NO. 1 JENKS PUBLIC SCHOOLS,AGAINST THE PROPOSITION - NO,,720166,0,0,14,14,PROPOSITION NO. 1 JENKS PUBLIC SCHOOLS
TULSA,PROPOSITION NO. 2 JENKS PUBLIC SCHOOLS,FOR THE PROPOSITION - YES,,720166,0,0,62,62,PROPOSITION NO. 2 JENKS PUBLIC SCHOOLS
TULSA,PROPOSITION NO. 2 JENKS PUBLIC SCHOOLS,AGAINST THE PROPOSITION - NO,,720166,0,0,12,12,PROPOSITION NO. 2 JENKS PUBLIC SCHOOLS
TULSA,PROPOSITION NO. 1 JENKS PUBLIC SCHOOLS,FOR THE PROPOSITION - YES,,720167,0,0,46,46,PROPOSITION NO. 1 JENKS PUBLIC SCHOOLS
TULSA,PROPOSITION NO. 1 JENKS PUBLIC SCHOOLS,AGAINST THE PROPOSITION - NO,,720167,0,0,7,7,PROPOSITION NO. 1 JENKS PUBLIC SCHOOLS
TULSA,PROPOSITION NO. 2 JENKS PUBLIC SCHOOLS,FOR THE PROPOSITION - YES,,720167,0,0,43,43,PROPOSITION NO. 2 JENKS PUBLIC SCHOOLS
TULSA,PROPOSITION NO. 2 JENKS PUBLIC SCHOOLS,AGAINST THE PROPOSITION - NO,,720167,0,0,10,10,PROPOSITION NO. 2 JENKS PUBLIC SCHOOLS
TULSA,PROPOSITION UNION PUBLIC SCHOOLS,FOR THE PROPOSITION - YES,,720169,0,0,53,53,
TULSA,PROPOSITION UNION PUBLIC SCHOOLS,AGAINST THE PROPOSITION - NO,,720169,0,0,10,10,
TULSA,PROPOSITION NO. 1 JENKS PUBLIC SCHOOLS,FOR THE PROPOSITION - YES,,720170,0,0,23,23,PROPOSITION NO. 1 JENKS PUBLIC SCHOOLS
TULSA,PROPOSITION NO. 1 JENKS PUBLIC SCHOOLS,AGAINST THE PROPOSITION - NO,,720170,0,0,4,4,PROPOSITION NO. 1 JENKS PUBLIC SCHOOLS
TULSA,PROPOSITION NO. 2 JENKS PUBLIC SCHOOLS,FOR THE PROPOSITION - YES,,720170,0,0,23,23,PROPOSITION NO. 2 JENKS PUBLIC SCHOOLS
TULSA,PROPOSITION NO. 2 JENKS PUBLIC SCHOOLS,AGAINST THE PROPOSITION - NO,,720170,0,0,4,4,PROPOSITION NO. 2 JENKS PUBLIC SCHOOLS
TULSA,PROPOSITION NO. 1 JENKS PUBLIC SCHOOLS,FOR THE PROPOSITION - YES,,720171,0,0,16,16,PROPOSITION NO. 1 JENKS PUBLIC SCHOOLS
TULSA,PROPOSITION NO. 1 JENKS PUBLIC SCHOOLS,AGAINST THE PROPOSITION - NO,,720171,0,0,8,8,PROPOSITION NO. 1 JENKS PUBLIC SCHOOLS
TULSA,PROPOSITION NO. 2 JENKS PUBLIC SCHOOLS,FOR THE PROPOSITION - YES,,720171,0,0,16,16,PROPOSITION NO. 2 JENKS PUBLIC SCHOOLS
TULSA,PROPOSITION NO. 2 JENKS PUBLIC SCHOOLS,AGAINST THE PROPOSITION - NO,,720171,0,0,8,8,PROPOSITION NO. 2 JENKS PUBLIC SCHOOLS
TULSA,PROPOSITION UNION PUBLIC SCHOOLS,FOR THE PROPOSITION - YES,,720172,0,0,82,82,
TULSA,PROPOSITION UNION PUBLIC SCHOOLS,AGAINST THE PROPOSITION - NO,,720172,0,0,10,10,
TULSA,PROPOSITION NO. 1 JENKS PUBLIC SCHOOLS,FOR THE PROPOSITION - YES,,720173,0,0,34,34,PROPOSITION NO. 1 JENKS PUBLIC SCHOOLS
TULSA,PROPOSITION NO. 1 JENKS PUBLIC SCHOOLS,AGAINST THE PROPOSITION - NO,,720173,0,0,9,9,PROPOSITION NO. 1 JENKS PUBLIC SCHOOLS
TULSA,PROPOSITION NO. 2 JENKS PUBLIC SCHOOLS,FOR THE PROPOSITION - YES,,720173,0,0,34,34,PROPOSITION NO. 2 JENKS PUBLIC SCHOOLS
TULSA,PROPOSITION NO. 2 JENKS PUBLIC SCHOOLS,AGAINST THE PROPOSITION - NO,,720173,0,0,9,9,PROPOSITION NO. 2 JENKS PUBLIC SCHOOLS
TULSA,OFFICE NO. 3 TULSA PUBLIC SCHOOLS,LANA TURNER,,720174,0,0,0,0,OFFICE NO. 3 TULSA PUBLIC SCHOOLS
TULSA,OFFICE NO. 3 TULSA PUBLIC SCHOOLS,WHITNEY COLE,,720174,0,0,0,0,OFFICE NO. 3 TULSA PUBLIC SCHOOLS
TULSA,OFFICE NO. 3 TULSA PUBLIC SCHOOLS,JENNETTIE P. MARSHALL,,720174,0,0,0,0,OFFICE NO. 3 TULSA PUBLIC SCHOOLS
TULSA,OFFICE NO. 1 TULSA TECH CENTER,RAY A. OWENS,,720174,0,0,0,0,OFFICE NO. 1 TULSA TECH CENTER
TULSA,OFFICE NO. 1 TULSA TECH CENTER,MELANIE SWEENEY McINTOSH,,720174,0,0,0,0,OFFICE NO. 1 TULSA TECH CENTER
TULSA,OFFICE NO. 1 TULSA TECH CENTER,KEENAN H. MEADORS,,720174,0,0,0,0,OFFICE NO. 1 TULSA TECH CENTER
TULSA,OFFICE NO. 3 TULSA PUBLIC SCHOOLS,LANA TURNER,,720175,0,0,0,0,OFFICE NO. 3 TULSA PUBLIC SCHOOLS
TULSA,OFFICE NO. 3 TULSA PUBLIC SCHOOLS,WHITNEY COLE,,720175,0,0,0,0,OFFICE NO. 3 TULSA PUBLIC SCHOOLS
TULSA,OFFICE NO. 3 TULSA PUBLIC SCHOOLS,JENNETTIE P. MARSHALL,,720175,0,0,0,0,OFFICE NO. 3 TULSA PUBLIC SCHOOLS
TULSA,OFFICE NO. 1 TULSA TECH CENTER,RAY A. OWENS,,720175,0,0,0,0,OFFICE NO. 1 TULSA TECH CENTER
TULSA,OFFICE NO. 1 TULSA TECH CENTER,MELANIE SWEENEY McINTOSH,,720175,0,0,0,0,OFFICE NO. 1 TULSA TECH CENTER
TULSA,OFFICE NO. 1 TULSA TECH CENTER,KEENAN H. MEADORS,,720175,0,0,0,0,OFFICE NO. 1 TULSA TECH CENTER
TULSA,PROPOSITION NO. 1 JENKS PUBLIC SCHOOLS,FOR THE PROPOSITION - YES,,720401,0,0,21,21,PROPOSITION NO. 1 JENKS PUBLIC SCHOOLS
TULSA,PROPOSITION NO. 1 JENKS PUBLIC SCHOOLS,AGAINST THE PROPOSITION - NO,,720401,0,0,6,6,PROPOSITION NO. 1 JENKS PUBLIC SCHOOLS
TULSA,PROPOSITION NO. 2 JENKS PUBLIC SCHOOLS,FOR THE PROPOSITION - YES,,720401,0,0,21,21,PROPOSITION NO. 2 JENKS PUBLIC SCHOOLS
TULSA,PROPOSITION NO. 2 JENKS PUBLIC SCHOOLS,AGAINST THE PROPOSITION - NO,,720401,0,0,6,6,PROPOSITION NO. 2 JENKS PUBLIC SCHOOLS
TULSA,OFFICE NO. 2 UNION PUBLIC SCHOOLS,PATRICK COYLE,,720410,0,0,29,29,OFFICE NO. 2 UNION PUBLIC SCHOOLS
TULSA,OFFICE NO. 2 UNION PUBLIC SCHOOLS,LISA FORD,,720410,0,0,9,9,OFFICE NO. 2 UNION PUBLIC SCHOOLS
TULSA,OFFICE NO. 2 UNION PUBLIC SCHOOLS,GLENDA K. PUETT,,720410,0,0,1,1,OFFICE NO. 2 UNION PUBLIC SCHOOLS
TULSA,PROPOSITION UNION PUBLIC SCHOOLS,FOR THE PROPOSITION - YES,,720410,0,0,30,30,
TULSA,PROPOSITION UNION PUBLIC SCHOOLS,AGAINST THE PROPOSITION - NO,,720410,0,0,10,10,
TULSA,PROPOSITION UNION PUBLIC SCHOOLS,FOR THE PROPOSITION - YES,,720451,0,0,0,0,
TULSA,PROPOSITION UNION PUBLIC SCHOOLS,AGAINST THE PROPOSITION - NO,,720451,0,0,0,0,
TULSA,OFFICE NO. 2 UNION PUBLIC SCHOOLS,PATRICK COYLE,,720454,0,0,64,64,OFFICE NO. 2 UNION PUBLIC SCHOOLS
TULSA,OFFICE NO. 2 UNION PUBLIC SCHOOLS,LISA FORD,,720454,0,0,98,98,OFFICE NO. 2 UNION PUBLIC SCHOOLS
TULSA,OFFICE NO. 2 UNION PUBLIC SCHOOLS,GLENDA K. PUETT,,720454,0,0,22,22,OFFICE NO. 2 UNION PUBLIC SCHOOLS
TULSA,PROPOSITION UNION PUBLIC SCHOOLS,FOR THE PROPOSITION - YES,,720454,0,0,157,157,
TULSA,PROPOSITION UNION PUBLIC SCHOOLS,AGAINST THE PROPOSITION - NO,,720454,0,0,34,34,
TULSA,PROPOSITION UNION PUBLIC SCHOOLS,FOR THE PROPOSITION - YES,,720465,0,0,61,61,
TULSA,PROPOSITION UNION PUBLIC SCHOOLS,AGAINST THE PROPOSITION - NO,,720465,0,0,14,14,
TULSA,OFFICE NO. 2 UNION PUBLIC SCHOOLS,PATRICK COYLE,,720468,0,0,56,56,OFFICE NO. 2 UNION PUBLIC SCHOOLS
TULSA,OFFICE NO. 2 UNION PUBLIC SCHOOLS,LISA FORD,,720468,0,0,91,91,OFFICE NO. 2 UNION PUBLIC SCHOOLS
TULSA,OFFICE NO. 2 UNION PUBLIC SCHOOLS,GLENDA K. PUETT,,720468,0,0,27,27,OFFICE NO. 2 UNION PUBLIC SCHOOLS
TULSA,PROPOSITION UNION PUBLIC SCHOOLS,FOR THE PROPOSITION - YES,,720468,0,0,141,141,
TULSA,PROPOSITION UNION PUBLIC SCHOOLS,AGAINST THE PROPOSITION - NO,,720468,0,0,39,39,
TULSA,OFFICE NO. 2 UNION PUBLIC SCHOOLS,PATRICK COYLE,,720470,0,0,57,57,OFFICE NO. 2 UNION PUBLIC SCHOOLS
TULSA,OFFICE NO. 2 UNION PUBLIC SCHOOLS,LISA FORD,,720470,0,0,91,91,OFFICE NO. 2 UNION PUBLIC SCHOOLS
TULSA,OFFICE NO. 2 UNION PUBLIC SCHOOLS,GLENDA K. PUETT,,720470,0,0,24,24,OFFICE NO. 2 UNION PUBLIC SCHOOLS
TULSA,PROPOSITION UNION PUBLIC SCHOOLS,FOR THE PROPOSITION - YES,,720470,0,0,167,167,
TULSA,PROPOSITION UNION PUBLIC SCHOOLS,AGAINST THE PROPOSITION - NO,,720470,0,0,18,18,
TULSA,OFFICE NO. 2 UNION PUBLIC SCHOOLS,PATRICK COYLE,,720471,0,0,14,14,OFFICE NO. 2 UNION PUBLIC SCHOOLS
TULSA,OFFICE NO. 2 UNION PUBLIC SCHOOLS,LISA FORD,,720471,0,0,18,18,OFFICE NO. 2 UNION PUBLIC SCHOOLS
TULSA,OFFICE NO. 2 UNION PUBLIC SCHOOLS,GLENDA K. PUETT,,720471,0,0,7,7,OFFICE NO. 2 UNION PUBLIC SCHOOLS
TULSA,PROPOSITION UNION PUBLIC SCHOOLS,FOR THE PROPOSITION - YES,,720471,0,0,41,41,
TULSA,PROPOSITION UNION PUBLIC SCHOOLS,AGAINST THE PROPOSITION - NO,,720471,0,0,1,1,
TULSA,OFFICE NO. 2 UNION PUBLIC SCHOOLS,PATRICK COYLE,,720474,0,0,31,31,OFFICE NO. 2 UNION PUBLIC SCHOOLS
TULSA,OFFICE NO. 2 UNION PUBLIC SCHOOLS,LISA FORD,,720474,0,0,92,92,OFFICE NO. 2 UNION PUBLIC SCHOOLS
TULSA,OFFICE NO. 2 UNION PUBLIC SCHOOLS,GLENDA K. PUETT,,720474,0,0,25,25,OFFICE NO. 2 UNION PUBLIC SCHOOLS
TULSA,PROPOSITION UNION PUBLIC SCHOOLS,FOR THE PROPOSITION - YES,,720474,0,0,119,119,
TULSA,PROPOSITION UNION PUBLIC SCHOOLS,AGAINST THE PROPOSITION - NO,,720474,0,0,34,34,
TULSA,OFFICE NO. 2 COLLINSVILLE PUBLIC SCHOOLS,C. KEVIN MORRISON,,720501,0,0,13,13,OFFICE NO. 2 COLLINSVILLE PUBLIC SCHOOLS
TULSA,OFFICE NO. 2 COLLINSVILLE PUBLIC SCHOOLS,TIM BESS,,720501,0,0,20,20,OFFICE NO. 2 COLLINSVILLE PUBLIC SCHOOLS
TULSA,OFFICE NO. 5 (UNEXPIRED TERM) TULSA TECH CENTER,ROY D. McCLAIN,,720501,0,0,12,12,OFFICE NO. 5 (UNEXPIRED TERM) TULSA TECH CENTER
TULSA,OFFICE NO. 5 (UNEXPIRED TERM) TULSA TECH CENTER,DANNY HANCOCK,,720501,0,0,19,19,OFFICE NO. 5 (UNEXPIRED TERM) TULSA TECH CENTER
TULSA,OFFICE NO. 2 COLLINSVILLE PUBLIC SCHOOLS,C. KEVIN MORRISON,,720502,0,0,25,25,OFFICE NO. 2 COLLINSVILLE PUBLIC SCHOOLS
TULSA,OFFICE NO. 2 COLLINSVILLE PUBLIC SCHOOLS,TIM BESS,,720502,0,0,31,31,OFFICE NO. 2 COLLINSVILLE PUBLIC SCHOOLS
TULSA,OFFICE NO. 5 (UNEXPIRED TERM) TULSA TECH CENTER,ROY D. McCLAIN,,720502,0,0,20,20,OFFICE NO. 5 (UNEXPIRED TERM) TULSA TECH CENTER
TULSA,OFFICE NO. 5 (UNEXPIRED TERM) TULSA TECH CENTER,DANNY HANCOCK,,720502,0,0,35,35,OFFICE NO. 5 (UNEXPIRED TERM) TULSA TECH CENTER
TULSA,OFFICE NO. 2 COLLINSVILLE PUBLIC SCHOOLS,C. KEVIN MORRISON,,720503,0,0,18,18,OFFICE NO. 2 COLLINSVILLE PUBLIC SCHOOLS
TULSA,OFFICE NO. 2 COLLINSVILLE PUBLIC SCHOOLS,TIM BESS,,720503,0,0,35,35,OFFICE NO. 2 COLLINSVILLE PUBLIC SCHOOLS
TULSA,OFFICE NO. 5 (UNEXPIRED TERM) TULSA TECH CENTER,ROY D. McCLAIN,,720503,0,0,19,19,OFFICE NO. 5 (UNEXPIRED TERM) TULSA TECH CENTER
TULSA,OFFICE NO. 5 (UNEXPIRED TERM) TULSA TECH CENTER,DANNY HANCOCK,,720503,0,0,34,34,OFFICE NO. 5 (UNEXPIRED TERM) TULSA TECH CENTER
TULSA,OFFICE NO. 2 COLLINSVILLE PUBLIC SCHOOLS,C. KEVIN MORRISON,,720504,0,0,22,22,OFFICE NO. 2 COLLINSVILLE PUBLIC SCHOOLS
TULSA,OFFICE NO. 2 COLLINSVILLE PUBLIC SCHOOLS,TIM BESS,,720504,0,0,66,66,OFFICE NO. 2 COLLINSVILLE PUBLIC SCHOOLS
TULSA,OFFICE NO. 5 (UNEXPIRED TERM) TULSA TECH CENTER,ROY D. McCLAIN,,720504,0,0,34,34,OFFICE NO. 5 (UNEXPIRED TERM) TULSA TECH CENTER
TULSA,OFFICE NO. 5 (UNEXPIRED TERM) TULSA TECH CENTER,DANNY HANCOCK,,720504,0,0,52,52,OFFICE NO. 5 (UNEXPIRED TERM) TULSA TECH CENTER
TULSA,OFFICE NO. 3 TULSA PUBLIC SCHOOLS,LANA TURNER,,720551,0,0,2,2,OFFICE NO. 3 TULSA PUBLIC SCHOOLS
TULSA,OFFICE NO. 3 TULSA PUBLIC SCHOOLS,WHITNEY COLE,,720551,0,0,0,0,OFFICE NO. 3 TULSA PUBLIC SCHOOLS
TULSA,OFFICE NO. 3 TULSA PUBLIC SCHOOLS,JENNETTIE P. MARSHALL,,720551,0,0,0,0,OFFICE NO. 3 TULSA PUBLIC SCHOOLS
TULSA,OFFICE NO. 1 TULSA TECH CENTER,RAY A. OWENS,,720551,0,0,0,0,OFFICE NO. 1 TULSA TECH CENTER
TULSA,OFFICE NO. 1 TULSA TECH CENTER,MELANIE SWEENEY McINTOSH,,720551,0,0,2,2,OFFICE NO. 1 TULSA TECH CENTER
TULSA,OFFICE NO. 1 TULSA TECH CENTER,KEENAN H. MEADORS,,720551,0,0,0,0,OFFICE NO. 1 TULSA TECH CENTER
TULSA,PROPOSITION NO. 1 SKIATOOK PUBLIC SCHOOLS,FOR THE PROPOSITION - YES,,720552,0,0,0,0,PROPOSITION NO. 1 SKIATOOK PUBLIC SCHOOLS
TULSA,PROPOSITION NO. 1 SKIATOOK PUBLIC SCHOOLS,AGAINST THE PROPOSITION - NO,,720552,0,0,0,0,PROPOSITION NO. 1 SKIATOOK PUBLIC SCHOOLS
TULSA,PROPOSITION NO. 2 SKIATOOK PUBLIC SCHOOLS,FOR THE PROPOSITION - YES,,720552,0,0,0,0,PROPOSITION NO. 2 SKIATOOK PUBLIC SCHOOLS
TULSA,PROPOSITION NO. 2 SKIATOOK PUBLIC SCHOOLS,AGAINST THE PROPOSITION - NO,,720552,0,0,0,0,PROPOSITION NO. 2 SKIATOOK PUBLIC SCHOOLS
TULSA,OFFICE NO. 3 TULSA PUBLIC SCHOOLS,LANA TURNER,,720552,0,0,1,1,OFFICE NO. 3 TULSA PUBLIC SCHOOLS
TULSA,OFFICE NO. 3 TULSA PUBLIC SCHOOLS,WHITNEY COLE,,720552,0,0,0,0,OFFICE NO. 3 TULSA PUBLIC SCHOOLS
TULSA,OFFICE NO. 3 TULSA PUBLIC SCHOOLS,JENNETTIE P. MARSHALL,,720552,0,0,1,1,OFFICE NO. 3 TULSA PUBLIC SCHOOLS
TULSA,OFFICE NO. 5 (UNEXPIRED TERM) TULSA TECH CENTER,ROY D. McCLAIN,,720552,0,0,4,4,OFFICE NO. 5 (UNEXPIRED TERM) TULSA TECH CENTER
TULSA,OFFICE NO. 5 (UNEXPIRED TERM) TULSA TECH CENTER,DANNY HANCOCK,,720552,0,0,2,2,OFFICE NO. 5 (UNEXPIRED TERM) TULSA TECH CENTER
TULSA,OFFICE NO. 5 (UNEXPIRED TERM) TULSA TECH CENTER,ROY D. McCLAIN,,720553,0,0,3,3,OFFICE NO. 5 (UNEXPIRED TERM) TULSA TECH CENTER
TULSA,OFFICE NO. 5 (UNEXPIRED TERM) TULSA TECH CENTER,DANNY HANCOCK,,720553,0,0,6,6,OFFICE NO. 5 (UNEXPIRED TERM) TULSA TECH CENTER
TULSA,PROPOSITION NO. 1 JENKS PUBLIC SCHOOLS,FOR THE PROPOSITION - YES,,720700,0,0,99,99,PROPOSITION NO. 1 JENKS PUBLIC SCHOOLS
TULSA,PROPOSITION NO. 1 JENKS PUBLIC SCHOOLS,AGAINST THE PROPOSITION - NO,,720700,0,0,19,19,PROPOSITION NO. 1 JENKS PUBLIC SCHOOLS
TULSA,PROPOSITION NO. 2 JENKS PUBLIC SCHOOLS,FOR THE PROPOSITION - YES,,720700,0,0,98,98,PROPOSITION NO. 2 JENKS PUBLIC SCHOOLS
TULSA,PROPOSITION NO. 2 JENKS PUBLIC SCHOOLS,AGAINST THE PROPOSITION - NO,,720700,0,0,20,20,PROPOSITION NO. 2 JENKS PUBLIC SCHOOLS
TULSA,PROPOSITION NO. 1 JENKS PUBLIC SCHOOLS,FOR THE PROPOSITION - YES,,720701,0,0,95,95,PROPOSITION NO. 1 JENKS PUBLIC SCHOOLS
TULSA,PROPOSITION NO. 1 JENKS PUBLIC SCHOOLS,AGAINST THE PROPOSITION - NO,,720701,0,0,11,11,PROPOSITION NO. 1 JENKS PUBLIC SCHOOLS
TULSA,PROPOSITION NO. 2 JENKS PUBLIC SCHOOLS,FOR THE PROPOSITION - YES,,720701,0,0,95,95,PROPOSITION NO. 2 JENKS PUBLIC SCHOOLS
TULSA,PROPOSITION NO. 2 JENKS PUBLIC SCHOOLS,AGAINST THE PROPOSITION - NO,,720701,0,0,12,12,PROPOSITION NO. 2 JENKS PUBLIC SCHOOLS
TULSA,PROPOSITION NO. 1 JENKS PUBLIC SCHOOLS,FOR THE PROPOSITION - YES,,720702,0,0,58,58,PROPOSITION NO. 1 JENKS PUBLIC SCHOOLS
TULSA,PROPOSITION NO. 1 JENKS PUBLIC SCHOOLS,AGAINST THE PROPOSITION - NO,,720702,0,0,23,23,PROPOSITION NO. 1 JENKS PUBLIC SCHOOLS
TULSA,PROPOSITION NO. 2 JENKS PUBLIC SCHOOLS,FOR THE PROPOSITION - YES,,720702,0,0,60,60,PROPOSITION NO. 2 JENKS PUBLIC SCHOOLS
TULSA,PROPOSITION NO. 2 JENKS PUBLIC SCHOOLS,AGAINST THE PROPOSITION - NO,,720702,0,0,21,21,PROPOSITION NO. 2 JENKS PUBLIC SCHOOLS
TULSA,PROPOSITION NO. 1 JENKS PUBLIC SCHOOLS,FOR THE PROPOSITION - YES,,720703,0,0,94,94,PROPOSITION NO. 1 JENKS PUBLIC SCHOOLS
TULSA,PROPOSITION NO. 1 JENKS PUBLIC SCHOOLS,AGAINST THE PROPOSITION - NO,,720703,0,0,15,15,PROPOSITION NO. 1 JENKS PUBLIC SCHOOLS
TULSA,PROPOSITION NO. 2 JENKS PUBLIC SCHOOLS,FOR THE PROPOSITION - YES,,720703,0,0,94,94,PROPOSITION NO. 2 JENKS PUBLIC SCHOOLS
TULSA,PROPOSITION NO. 2 JENKS PUBLIC SCHOOLS,AGAINST THE PROPOSITION - NO,,720703,0,0,15,15,PROPOSITION NO. 2 JENKS PUBLIC SCHOOLS
TULSA,PROPOSITION NO. 1 JENKS PUBLIC SCHOOLS,FOR THE PROPOSITION - YES,,720709,0,0,68,68,PROPOSITION NO. 1 JENKS PUBLIC SCHOOLS
TULSA,PROPOSITION NO. 1 JENKS PUBLIC SCHOOLS,AGAINST THE PROPOSITION - NO,,720709,0,0,23,23,PROPOSITION NO. 1 JENKS PUBLIC SCHOOLS
TULSA,PROPOSITION NO. 2 JENKS PUBLIC SCHOOLS,FOR THE PROPOSITION - YES,,720709,0,0,70,70,PROPOSITION NO. 2 JENKS PUBLIC SCHOOLS
TULSA,PROPOSITION NO. 2 JENKS PUBLIC SCHOOLS,AGAINST THE PROPOSITION - NO,,720709,0,0,22,22,PROPOSITION NO. 2 JENKS PUBLIC SCHOOLS
TULSA,COUNCIL MEMBER WARD 3 CITY OF OWASSO,RANDY COWLING,,720750,0,0,9,9,COUNCIL MEMBER WARD 3 CITY OF OWASSO
TULSA,COUNCIL MEMBER WARD 3 CITY OF OWASSO,JC PRINCE,,720750,0,0,13,13,COUNCIL MEMBER WARD 3 CITY OF OWASSO
TULSA,COUNCIL MEMBER WARD 3 CITY OF OWASSO,BILL BUSH,,720750,0,0,51,51,COUNCIL MEMBER WARD 3 CITY OF OWASSO
TULSA,OFFICE NO. 5 (UNEXPIRED TERM) TULSA TECH CENTER,ROY D. McCLAIN,,720750,0,0,34,34,OFFICE NO. 5 (UNEXPIRED TERM) TULSA TECH CENTER
TULSA,OFFICE NO. 5 (UNEXPIRED TERM) TULSA TECH CENTER,DANNY HANCOCK,,720750,0,0,32,32,OFFICE NO. 5 (UNEXPIRED TERM) TULSA TECH CENTER
TULSA,COUNCIL MEMBER WARD 3 CITY OF OWASSO,RANDY COWLING,,720751,0,0,24,24,COUNCIL MEMBER WARD 3 CITY OF OWASSO
TULSA,COUNCIL MEMBER WARD 3 CITY OF OWASSO,JC PRINCE,,720751,0,0,16,16,COUNCIL MEMBER WARD 3 CITY OF OWASSO
TULSA,COUNCIL MEMBER WARD 3 CITY OF OWASSO,BILL BUSH,,720751,0,0,77,77,COUNCIL MEMBER WARD 3 CITY OF OWASSO
TULSA,OFFICE NO. 5 (UNEXPIRED TERM) TULSA TECH CENTER,ROY D. McCLAIN,,720751,0,0,41,41,OFFICE NO. 5 (UNEXPIRED TERM) TULSA TECH CENTER
TULSA,OFFICE NO. 5 (UNEXPIRED TERM) TULSA TECH CENTER,DANNY HANCOCK,,720751,0,0,68,68,OFFICE NO. 5 (UNEXPIRED TERM) TULSA TECH CENTER
TULSA,COUNCIL MEMBER WARD 3 CITY OF OWASSO,RANDY COWLING,,720752,0,0,4,4,COUNCIL MEMBER WARD 3 CITY OF OWASSO
TULSA,COUNCIL MEMBER WARD 3 CITY OF OWASSO,JC PRINCE,,720752,0,0,4,4,COUNCIL MEMBER WARD 3 CITY OF OWASSO
TULSA,COUNCIL MEMBER WARD 3 CITY OF OWASSO,BILL BUSH,,720752,0,0,13,13,COUNCIL MEMBER WARD 3 CITY OF OWASSO
TULSA,OFFICE NO. 2 COLLINSVILLE PUBLIC SCHOOLS,C. KEVIN MORRISON,,720752,0,0,4,4,OFFICE NO. 2 COLLINSVILLE PUBLIC SCHOOLS
TULSA,OFFICE NO. 2 COLLINSVILLE PUBLIC SCHOOLS,TIM BESS,,720752,0,0,2,2,OFFICE NO. 2 COLLINSVILLE PUBLIC SCHOOLS
TULSA,OFFICE NO. 5 (UNEXPIRED TERM) TULSA TECH CENTER,ROY D. McCLAIN,,720752,0,0,12,12,OFFICE NO. 5 (UNEXPIRED TERM) TULSA TECH CENTER
TULSA,OFFICE NO. 5 (UNEXPIRED TERM) TULSA TECH CENTER,DANNY HANCOCK,,720752,0,0,27,27,OFFICE NO. 5 (UNEXPIRED TERM) TULSA TECH CENTER
TULSA,COUNCIL MEMBER WARD 3 CITY OF OWASSO,RANDY COWLING,,720753,0,0,18,18,COUNCIL MEMBER WARD 3 CITY OF OWASSO
TULSA,COUNCIL MEMBER WARD 3 CITY OF OWASSO,JC PRINCE,,720753,0,0,10,10,COUNCIL MEMBER WARD 3 CITY OF OWASSO
TULSA,COUNCIL MEMBER WARD 3 CITY OF OWASSO,BILL BUSH,,720753,0,0,49,49,COUNCIL MEMBER WARD 3 CITY OF OWASSO
TULSA,OFFICE NO. 3 TULSA PUBLIC SCHOOLS,LANA TURNER,,720753,0,0,0,0,OFFICE NO. 3 TULSA PUBLIC SCHOOLS
TULSA,OFFICE NO. 3 TULSA PUBLIC SCHOOLS,WHITNEY COLE,,720753,0,0,0,0,OFFICE NO. 3 TULSA PUBLIC SCHOOLS
TULSA,OFFICE NO. 3 TULSA PUBLIC SCHOOLS,JENNETTIE P. MARSHALL,,720753,0,0,0,0,OFFICE NO. 3 TULSA PUBLIC SCHOOLS
TULSA,OFFICE NO. 5 (UNEXPIRED TERM) TULSA TECH CENTER,ROY D. McCLAIN,,720753,0,0,28,28,OFFICE NO. 5 (UNEXPIRED TERM) TULSA TECH CENTER
TULSA,OFFICE NO. 5 (UNEXPIRED TERM) TULSA TECH CENTER,DANNY HANCOCK,,720753,0,0,45,45,OFFICE NO. 5 (UNEXPIRED TERM) TULSA TECH CENTER
TULSA,COUNCIL MEMBER WARD 3 CITY OF OWASSO,RANDY COWLING,,720754,0,0,25,25,COUNCIL MEMBER WARD 3 CITY OF OWASSO
TULSA,COUNCIL MEMBER WARD 3 CITY OF OWASSO,JC PRINCE,,720754,0,0,21,21,COUNCIL MEMBER WARD 3 CITY OF OWASSO
TULSA,COUNCIL MEMBER WARD 3 CITY OF OWASSO,BILL BUSH,,720754,0,0,68,68,COUNCIL MEMBER WARD 3 CITY OF OWASSO
TULSA,OFFICE NO. 5 (UNEXPIRED TERM) TULSA TECH CENTER,ROY D. McCLAIN,,720754,0,0,38,38,OFFICE NO. 5 (UNEXPIRED TERM) TULSA TECH CENTER
TULSA,OFFICE NO. 5 (UNEXPIRED TERM) TULSA TECH CENTER,DANNY HANCOCK,,720754,0,0,69,69,OFFICE NO. 5 (UNEXPIRED TERM) TULSA TECH CENTER
TULSA,COUNCIL MEMBER WARD 3 CITY OF OWASSO,RANDY COWLING,,720755,0,0,27,27,COUNCIL MEMBER WARD 3 CITY OF OWASSO
TULSA,COUNCIL MEMBER WARD 3 CITY OF OWASSO,JC PRINCE,,720755,0,0,12,12,COUNCIL MEMBER WARD 3 CITY OF OWASSO
TULSA,COUNCIL MEMBER WARD 3 CITY OF OWASSO,BILL BUSH,,720755,0,0,60,60,COUNCIL MEMBER WARD 3 CITY OF OWASSO
TULSA,OFFICE NO. 5 (UNEXPIRED TERM) TULSA TECH CENTER,ROY D. McCLAIN,,720755,0,0,44,44,OFFICE NO. 5 (UNEXPIRED TERM) TULSA TECH CENTER
TULSA,OFFICE NO. 5 (UNEXPIRED TERM) TULSA TECH CENTER,DANNY HANCOCK,,720755,0,0,57,57,OFFICE NO. 5 (UNEXPIRED TERM) TULSA TECH CENTER
TULSA,COUNCIL MEMBER WARD 3 CITY OF OWASSO,RANDY COWLING,,720756,0,0,0,0,COUNCIL MEMBER WARD 3 CITY OF OWASSO
TULSA,COUNCIL MEMBER WARD 3 CITY OF OWASSO,JC PRINCE,,720756,0,0,0,0,COUNCIL MEMBER WARD 3 CITY OF OWASSO
TULSA,COUNCIL MEMBER WARD 3 CITY OF OWASSO,BILL BUSH,,720756,0,0,1,1,COUNCIL MEMBER WARD 3 CITY OF OWASSO
TULSA,OFFICE NO. 5 (UNEXPIRED TERM) TULSA TECH CENTER,ROY D. McCLAIN,,720756,0,0,2,2,OFFICE NO. 5 (UNEXPIRED TERM) TULSA TECH CENTER
TULSA,OFFICE NO. 5 (UNEXPIRED TERM) TULSA TECH CENTER,DANNY HANCOCK,,720756,0,0,1,1,OFFICE NO. 5 (UNEXPIRED TERM) TULSA TECH CENTER
TULSA,COUNCIL MEMBER WARD 3 CITY OF OWASSO,RANDY COWLING,,720757,0,0,29,29,COUNCIL MEMBER WARD 3 CITY OF OWASSO
TULSA,COUNCIL MEMBER WARD 3 CITY OF OWASSO,JC PRINCE,,720757,0,0,39,39,COUNCIL MEMBER WARD 3 CITY OF OWASSO
TULSA,COUNCIL MEMBER WARD 3 CITY OF OWASSO,BILL BUSH,,720757,0,0,125,125,COUNCIL MEMBER WARD 3 CITY OF OWASSO
TULSA,OFFICE NO. 5 (UNEXPIRED TERM) TULSA TECH CENTER,ROY D. McCLAIN,,720757,0,0,62,62,OFFICE NO. 5 (UNEXPIRED TERM) TULSA TECH CENTER
TULSA,OFFICE NO. 5 (UNEXPIRED TERM) TULSA TECH CENTER,DANNY HANCOCK,,720757,0,0,108,108,OFFICE NO. 5 (UNEXPIRED TERM) TULSA TECH CENTER
TULSA,COUNCIL MEMBER WARD 3 CITY OF OWASSO,RANDY COWLING,,720758,0,0,0,0,COUNCIL MEMBER WARD 3 CITY OF OWASSO
TULSA,COUNCIL MEMBER WARD 3 CITY OF OWASSO,JC PRINCE,,720758,0,0,5,5,COUNCIL MEMBER WARD 3 CITY OF OWASSO
TULSA,COUNCIL MEMBER WARD 3 CITY OF OWASSO,BILL BUSH,,720758,0,0,6,6,COUNCIL MEMBER WARD 3 CITY OF OWASSO
TULSA,OFFICE NO. 1 TULSA TECH CENTER,RAY A. OWENS,,720758,0,0,6,6,OFFICE NO. 1 TULSA TECH CENTER
TULSA,OFFICE NO. 1 TULSA TECH CENTER,MELANIE SWEENEY McINTOSH,,720758,0,0,8,8,OFFICE NO. 1 TULSA TECH CENTER
TULSA,OFFICE NO. 1 TULSA TECH CENTER,KEENAN H. MEADORS,,720758,0,0,1,1,OFFICE NO. 1 TULSA TECH CENTER
TULSA,COUNCIL MEMBER WARD 3 CITY OF OWASSO,RANDY COWLING,,720759,0,0,16,16,COUNCIL MEMBER WARD 3 CITY OF OWASSO
TULSA,COUNCIL MEMBER WARD 3 CITY OF OWASSO,JC PRINCE,,720759,0,0,11,11,COUNCIL MEMBER WARD 3 CITY OF OWASSO
TULSA,COUNCIL MEMBER WARD 3 CITY OF OWASSO,BILL BUSH,,720759,0,0,47,47,COUNCIL MEMBER WARD 3 CITY OF OWASSO
TULSA,OFFICE NO. 5 (UNEXPIRED TERM) TULSA TECH CENTER,ROY D. McCLAIN,,720759,0,0,29,29,OFFICE NO. 5 (UNEXPIRED TERM) TULSA TECH CENTER
TULSA,OFFICE NO. 5 (UNEXPIRED TERM) TULSA TECH CENTER,DANNY HANCOCK,,720759,0,0,44,44,OFFICE NO. 5 (UNEXPIRED TERM) TULSA TECH CENTER
TULSA,COUNCIL MEMBER WARD 3 CITY OF OWASSO,RANDY COWLING,,720760,0,0,2,2,COUNCIL MEMBER WARD 3 CITY OF OWASSO
TULSA,COUNCIL MEMBER WARD 3 CITY OF OWASSO,JC PRINCE,,720760,0,0,5,5,COUNCIL MEMBER WARD 3 CITY OF OWASSO
TULSA,COUNCIL MEMBER WARD 3 CITY OF OWASSO,BILL BUSH,,720760,0,0,26,26,COUNCIL MEMBER WARD 3 CITY OF OWASSO
TULSA,OFFICE NO. 5 (UNEXPIRED TERM) TULSA TECH CENTER,ROY D. McCLAIN,,720760,0,0,20,20,OFFICE NO. 5 (UNEXPIRED TERM) TULSA TECH CENTER
TULSA,OFFICE NO. 5 (UNEXPIRED TERM) TULSA TECH CENTER,DANNY HANCOCK,,720760,0,0,16,16,OFFICE NO. 5 (UNEXPIRED TERM) TULSA TECH CENTER
TULSA,"CITY COUNCILMEMBER, WARD 4 CITY OF SAND SPRINGS",CHRISTINE HAMNER,,720801,0,0,34,34,"CITY COUNCILMEMBER, WARD 4 CITY OF SAND SPRINGS"
TULSA,"CITY COUNCILMEMBER, WARD 4 CITY OF SAND SPRINGS",NANCY RILEY,,720801,0,0,22,22,"CITY COUNCILMEMBER, WARD 4 CITY OF SAND SPRINGS"
TULSA,OFFICE NO. 5 (UNEXPIRED TERM) TULSA TECH CENTER,ROY D. McCLAIN,,720801,0,0,15,15,OFFICE NO. 5 (UNEXPIRED TERM) TULSA TECH CENTER
TULSA,OFFICE NO. 5 (UNEXPIRED TERM) TULSA TECH CENTER,DANNY HANCOCK,,720801,0,0,39,39,OFFICE NO. 5 (UNEXPIRED TERM) TULSA TECH CENTER
TULSA,OFFICE NO. 5 (UNEXPIRED TERM) TULSA TECH CENTER,ROY D. McCLAIN,,720802,0,0,0,0,OFFICE NO. 5 (UNEXPIRED TERM) TULSA TECH CENTER
TULSA,OFFICE NO. 5 (UNEXPIRED TERM) TULSA TECH CENTER,DANNY HANCOCK,,720802,0,0,2,2,OFFICE NO. 5 (UNEXPIRED TERM) TULSA TECH CENTER
TULSA,OFFICE NO. 5 (UNEXPIRED TERM) TULSA TECH CENTER,ROY D. McCLAIN,,720851,0,0,7,7,OFFICE NO. 5 (UNEXPIRED TERM) TULSA TECH CENTER
TULSA,OFFICE NO. 5 (UNEXPIRED TERM) TULSA TECH CENTER,DANNY HANCOCK,,720851,0,0,30,30,OFFICE NO. 5 (UNEXPIRED TERM) TULSA TECH CENTER
TULSA,OFFICE NO. 5 (UNEXPIRED TERM) TULSA TECH CENTER,ROY D. McCLAIN,,720852,0,0,3,3,OFFICE NO. 5 (UNEXPIRED TERM) TULSA TECH CENTER
TULSA,OFFICE NO. 5 (UNEXPIRED TERM) TULSA TECH CENTER,DANNY HANCOCK,,720852,0,0,6,6,OFFICE NO. 5 (UNEXPIRED TERM) TULSA TECH CENTER
TULSA,OFFICE NO. 5 (UNEXPIRED TERM) TULSA TECH CENTER,ROY D. McCLAIN,,720853,0,0,0,0,OFFICE NO. 5 (UNEXPIRED TERM) TULSA TECH CENTER
TULSA,OFFICE NO. 5 (UNEXPIRED TERM) TULSA TECH CENTER,DANNY HANCOCK,,720853,0,0,2,2,OFFICE NO. 5 (UNEXPIRED TERM) TULSA TECH CENTER
TULSA,OFFICE NO. 5 (UNEXPIRED TERM) TULSA TECH CENTER,ROY D. McCLAIN,,720854,0,0,8,8,OFFICE NO. 5 (UNEXPIRED TERM) TULSA TECH CENTER
TULSA,OFFICE NO. 5 (UNEXPIRED TERM) TULSA TECH CENTER,DANNY HANCOCK,,720854,0,0,27,27,OFFICE NO. 5 (UNEXPIRED TERM) TULSA TECH CENTER
TULSA,OFFICE NO. 5 (UNEXPIRED TERM) TULSA TECH CENTER,ROY D. McCLAIN,,720855,0,0,13,13,OFFICE NO. 5 (UNEXPIRED TERM) TULSA TECH CENTER
TULSA,OFFICE NO. 5 (UNEXPIRED TERM) TULSA TECH CENTER,DANNY HANCOCK,,720855,0,0,17,17,OFFICE NO. 5 (UNEXPIRED TERM) TULSA TECH CENTER
TULSA,"CITY COUNCILMEMBER, WARD 4 CITY OF SAND SPRINGS",CHRISTINE HAMNER,,720856,0,0,32,32,"CITY COUNCILMEMBER, WARD 4 CITY OF SAND SPRINGS"
TULSA,"CITY COUNCILMEMBER, WARD 4 CITY OF SAND SPRINGS",NANCY RILEY,,720856,0,0,29,29,"CITY COUNCILMEMBER, WARD 4 CITY OF SAND SPRINGS"
TULSA,OFFICE NO. 5 (UNEXPIRED TERM) TULSA TECH CENTER,ROY D. McCLAIN,,720856,0,0,15,15,OFFICE NO. 5 (UNEXPIRED TERM) TULSA TECH CENTER
TULSA,OFFICE NO. 5 (UNEXPIRED TERM) TULSA TECH CENTER,DANNY HANCOCK,,720856,0,0,47,47,OFFICE NO. 5 (UNEXPIRED TERM) TULSA TECH CENTER
TULSA,OFFICE NO. 5 (UNEXPIRED TERM) TULSA TECH CENTER,ROY D. McCLAIN,,720857,0,0,4,4,OFFICE NO. 5 (UNEXPIRED TERM) TULSA TECH CENTER
TULSA,OFFICE NO. 5 (UNEXPIRED TERM) TULSA TECH CENTER,DANNY HANCOCK,,720857,0,0,8,8,OFFICE NO. 5 (UNEXPIRED TERM) TULSA TECH CENTER
TULSA,OFFICE NO. 5 (UNEXPIRED TERM) TULSA TECH CENTER,ROY D. McCLAIN,,720858,0,0,0,0,OFFICE NO. 5 (UNEXPIRED TERM) TULSA TECH CENTER
TULSA,OFFICE NO. 5 (UNEXPIRED TERM) TULSA TECH CENTER,DANNY HANCOCK,,720858,0,0,1,1,OFFICE NO. 5 (UNEXPIRED TERM) TULSA TECH CENTER
TULSA,OFFICE NO. 5 (UNEXPIRED TERM) TULSA TECH CENTER,ROY D. McCLAIN,,720880,0,0,2,2,OFFICE NO. 5 (UNEXPIRED TERM) TULSA TECH CENTER
TULSA,OFFICE NO. 5 (UNEXPIRED TERM) TULSA TECH CENTER,DANNY HANCOCK,,720880,0,0,15,15,OFFICE NO. 5 (UNEXPIRED TERM) TULSA TECH CENTER
TULSA,OFFICE NO. 5 (UNEXPIRED TERM) TULSA TECH CENTER,ROY D. McCLAIN,,720881,0,0,1,1,OFFICE NO. 5 (UNEXPIRED TERM) TULSA TECH CENTER
TULSA,OFFICE NO. 5 (UNEXPIRED TERM) TULSA TECH CENTER,DANNY HANCOCK,,720881,0,0,15,15,OFFICE NO. 5 (UNEXPIRED TERM) TULSA TECH CENTER
TULSA,OFFICE NO. 2 COLLINSVILLE PUBLIC SCHOOLS,C. KEVIN MORRISON,,720900,0,0,3,3,OFFICE NO. 2 COLLINSVILLE PUBLIC SCHOOLS
TULSA,OFFICE NO. 2 COLLINSVILLE PUBLIC SCHOOLS,TIM BESS,,720900,0,0,5,5,OFFICE NO. 2 COLLINSVILLE PUBLIC SCHOOLS
TULSA,PROPOSITION NO. 1 SKIATOOK PUBLIC SCHOOLS,FOR THE PROPOSITION - YES,,720900,0,0,140,140,PROPOSITION NO. 1 SKIATOOK PUBLIC SCHOOLS
TULSA,PROPOSITION NO. 1 SKIATOOK PUBLIC SCHOOLS,AGAINST THE PROPOSITION - NO,,720900,0,0,31,31,PROPOSITION NO. 1 SKIATOOK PUBLIC SCHOOLS
TULSA,PROPOSITION NO. 2 SKIATOOK PUBLIC SCHOOLS,FOR THE PROPOSITION - YES,,720900,0,0,143,143,PROPOSITION NO. 2 SKIATOOK PUBLIC SCHOOLS
TULSA,PROPOSITION NO. 2 SKIATOOK PUBLIC SCHOOLS,AGAINST THE PROPOSITION - NO,,720900,0,0,29,29,PROPOSITION NO. 2 SKIATOOK PUBLIC SCHOOLS
TULSA,OFFICE NO. 5 (UNEXPIRED TERM) TULSA TECH CENTER,ROY D. McCLAIN,,720900,0,0,85,85,OFFICE NO. 5 (UNEXPIRED TERM) TULSA TECH CENTER
TULSA,OFFICE NO. 5 (UNEXPIRED TERM) TULSA TECH CENTER,DANNY HANCOCK,,720900,0,0,89,89,OFFICE NO. 5 (UNEXPIRED TERM) TULSA TECH CENTER
TULSA,COUNCIL MEMBER WARD 3 CITY OF OWASSO,RANDY COWLING,,729999,8,0,0,8,COUNCIL MEMBER WARD 3 CITY OF OWASSO
TULSA,COUNCIL MEMBER WARD 3 CITY OF OWASSO,JC PRINCE,,729999,6,1,0,7,COUNCIL MEMBER WARD 3 CITY OF OWASSO
TULSA,COUNCIL MEMBER WARD 3 CITY OF OWASSO,BILL BUSH,,729999,33,3,0,36,COUNCIL MEMBER WARD 3 CITY OF OWASSO
TULSA,"CITY COUNCILMEMBER, WARD 4 CITY OF SAND SPRINGS",CHRISTINE HAMNER,,729999,1,0,0,1,"CITY COUNCILMEMBER, WARD 4 CITY OF SAND SPRINGS"
TULSA,"CITY COUNCILMEMBER, WARD 4 CITY OF SAND SPRINGS",NANCY RILEY,,729999,2,1,0,3,"CITY COUNCILMEMBER, WARD 4 CITY OF SAND SPRINGS"
TULSA,OFFICE NO. 2 COLLINSVILLE PUBLIC SCHOOLS,C. KEVIN MORRISON,,729999,1,0,0,1,OFFICE NO. 2 COLLINSVILLE PUBLIC SCHOOLS
TULSA,OFFICE NO. 2 COLLINSVILLE PUBLIC SCHOOLS,TIM BESS,,729999,5,0,0,5,OFFICE NO. 2 COLLINSVILLE PUBLIC SCHOOLS
TULSA,PROPOSITION NO. 1 JENKS PUBLIC SCHOOLS,FOR THE PROPOSITION - YES,,729999,119,4,0,123,PROPOSITION NO. 1 JENKS PUBLIC SCHOOLS
TULSA,PROPOSITION NO. 1 JENKS PUBLIC SCHOOLS,AGAINST THE PROPOSITION - NO,,729999,67,2,0,69,PROPOSITION NO. 1 JENKS PUBLIC SCHOOLS
TULSA,PROPOSITION NO. 2 JENKS PUBLIC SCHOOLS,FOR THE PROPOSITION - YES,,729999,119,4,0,123,PROPOSITION NO. 2 JENKS PUBLIC SCHOOLS
TULSA,PROPOSITION NO. 2 JENKS PUBLIC SCHOOLS,AGAINST THE PROPOSITION - NO,,729999,66,2,0,68,PROPOSITION NO. 2 JENKS PUBLIC SCHOOLS
TULSA,PROPOSITION NO. 1 SKIATOOK PUBLIC SCHOOLS,FOR THE PROPOSITION - YES,,729999,1,1,0,2,PROPOSITION NO. 1 SKIATOOK PUBLIC SCHOOLS
TULSA,PROPOSITION NO. 1 SKIATOOK PUBLIC SCHOOLS,AGAINST THE PROPOSITION - NO,,729999,2,0,0,2,PROPOSITION NO. 1 SKIATOOK PUBLIC SCHOOLS
TULSA,PROPOSITION NO. 2 SKIATOOK PUBLIC SCHOOLS,FOR THE PROPOSITION - YES,,729999,1,1,0,2,PROPOSITION NO. 2 SKIATOOK PUBLIC SCHOOLS
TULSA,PROPOSITION NO. 2 SKIATOOK PUBLIC SCHOOLS,AGAINST THE PROPOSITION - NO,,729999,2,0,0,2,PROPOSITION NO. 2 SKIATOOK PUBLIC SCHOOLS
TULSA,OFFICE NO. 2 TULSA PUBLIC SCHOOLS,PHIL ARMSTRONG,,729999,4,5,0,9,OFFICE NO. 2 TULSA PUBLIC SCHOOLS
TULSA,OFFICE NO. 2 TULSA PUBLIC SCHOOLS,WILBERT E. COLLINS SR.,,729999,8,2,0,10,OFFICE NO. 2 TULSA PUBLIC SCHOOLS
TULSA,OFFICE NO. 2 TULSA PUBLIC SCHOOLS,AMY SHELTON,,729999,21,6,0,27,OFFICE NO. 2 TULSA PUBLIC SCHOOLS
TULSA,OFFICE NO. 3 TULSA PUBLIC SCHOOLS,LANA TURNER,,729999,25,5,0,30,OFFICE NO. 3 TULSA PUBLIC SCHOOLS
TULSA,OFFICE NO. 3 TULSA PUBLIC SCHOOLS,WHITNEY COLE,,729999,12,0,0,12,OFFICE NO. 3 TULSA PUBLIC SCHOOLS
TULSA,OFFICE NO. 3 TULSA PUBLIC SCHOOLS,JENNETTIE P. MARSHALL,,729999,13,14,0,27,OFFICE NO. 3 TULSA PUBLIC SCHOOLS
TULSA,OFFICE NO. 1 TULSA TECH CENTER,RAY A. OWENS,,729999,49,23,0,72,OFFICE NO. 1 TULSA TECH CENTER
TULSA,OFFICE NO. 1 TULSA TECH CENTER,MELANIE SWEENEY McINTOSH,,729999,36,12,0,48,OFFICE NO. 1 TULSA TECH CENTER
TULSA,OFFICE NO. 1 TULSA TECH CENTER,KEENAN H. MEADORS,,729999,21,4,0,25,OFFICE NO. 1 TULSA TECH CENTER
TULSA,OFFICE NO. 5 (UNEXPIRED TERM) TULSA TECH CENTER,ROY D. McCLAIN,,729999,41,3,0,44,OFFICE NO. 5 (UNEXPIRED TERM) TULSA TECH CENTER
TULSA,OFFICE NO. 5 (UNEXPIRED TERM) TULSA TECH CENTER,DANNY HANCOCK,,729999,48,9,0,57,OFFICE NO. 5 (UNEXPIRED TERM) TULSA TECH CENTER
TULSA,OFFICE NO. 2 UNION PUBLIC SCHOOLS,PATRICK COYLE,,729999,8,0,0,8,OFFICE NO. 2 UNION PUBLIC SCHOOLS
TULSA,OFFICE NO. 2 UNION PUBLIC SCHOOLS,LISA FORD,,729999,26,3,0,29,OFFICE NO. 2 UNION PUBLIC SCHOOLS
TULSA,OFFICE NO. 2 UNION PUBLIC SCHOOLS,GLENDA K. PUETT,,729999,4,0,0,4,OFFICE NO. 2 UNION PUBLIC SCHOOLS
TULSA,PROPOSITION UNION PUBLIC SCHOOLS,FOR THE PROPOSITION - YES,,729999,79,7,0,86,
TULSA,PROPOSITION UNION PUBLIC SCHOOLS,AGAINST THE PROPOSITION - NO,,729999,79,2,0,81,
WAGONER,OFFICE NO. 2 INDIAN CAPITAL TECH CENTER,TOM STILES,,730102,0,0,1,1,OFFICE NO. 2 INDIAN CAPITAL TECH CENTER
WAGONER,OFFICE NO. 2 INDIAN CAPITAL TECH CENTER,RAY KIRK,,730102,0,0,0,0,OFFICE NO. 2 INDIAN CAPITAL TECH CENTER
WAGONER,OFFICE NO. 2 COWETA PUBLIC SCHOOLS,BRAD ANDERSON,,730102,0,0,0,0,OFFICE NO. 2 COWETA PUBLIC SCHOOLS
WAGONER,OFFICE NO. 2 COWETA PUBLIC SCHOOLS,KURT D. CARDWELL,,730102,0,0,1,1,OFFICE NO. 2 COWETA PUBLIC SCHOOLS
WAGONER,OFFICE NO. 2 NORTHEAST TECH CENTER,BILLY F. HENDRICKSON,,730109,0,0,0,0,OFFICE NO. 2 NORTHEAST TECH CENTER
WAGONER,OFFICE NO. 2 NORTHEAST TECH CENTER,SHERMAN WEAVER,,730109,0,0,0,0,OFFICE NO. 2 NORTHEAST TECH CENTER
WAGONER,OFFICE NO. 2 INDIAN CAPITAL TECH CENTER,TOM STILES,,730109,0,0,16,16,OFFICE NO. 2 INDIAN CAPITAL TECH CENTER
WAGONER,OFFICE NO. 2 INDIAN CAPITAL TECH CENTER,RAY KIRK,,730109,0,0,2,2,OFFICE NO. 2 INDIAN CAPITAL TECH CENTER
WAGONER,OFFICE NO. 2 COWETA PUBLIC SCHOOLS,BRAD ANDERSON,,730109,0,0,10,10,OFFICE NO. 2 COWETA PUBLIC SCHOOLS
WAGONER,OFFICE NO. 2 COWETA PUBLIC SCHOOLS,KURT D. CARDWELL,,730109,0,0,8,8,OFFICE NO. 2 COWETA PUBLIC SCHOOLS
WAGONER,OFFICE NO. 2 INDIAN CAPITAL TECH CENTER,TOM STILES,,730201,0,2,40,42,OFFICE NO. 2 INDIAN CAPITAL TECH CENTER
WAGONER,OFFICE NO. 2 INDIAN CAPITAL TECH CENTER,RAY KIRK,,730201,0,0,7,7,OFFICE NO. 2 INDIAN CAPITAL TECH CENTER
WAGONER,OFFICE NO. 2 COWETA PUBLIC SCHOOLS,BRAD ANDERSON,,730201,0,0,39,39,OFFICE NO. 2 COWETA PUBLIC SCHOOLS
WAGONER,OFFICE NO. 2 COWETA PUBLIC SCHOOLS,KURT D. CARDWELL,,730201,0,2,18,20,OFFICE NO. 2 COWETA PUBLIC SCHOOLS
WAGONER,OFFICE NO. 2 INDIAN CAPITAL TECH CENTER,TOM STILES,,730202,0,1,64,65,OFFICE NO. 2 INDIAN CAPITAL TECH CENTER
WAGONER,OFFICE NO. 2 INDIAN CAPITAL TECH CENTER,RAY KIRK,,730202,0,0,15,15,OFFICE NO. 2 INDIAN CAPITAL TECH CENTER
WAGONER,OFFICE NO. 2 COWETA PUBLIC SCHOOLS,BRAD ANDERSON,,730202,0,1,63,64,OFFICE NO. 2 COWETA PUBLIC SCHOOLS
WAGONER,OFFICE NO. 2 COWETA PUBLIC SCHOOLS,KURT D. CARDWELL,,730202,0,0,22,22,OFFICE NO. 2 COWETA PUBLIC SCHOOLS
WAGONER,OFFICE NO. 2 PORTER CONSOLIDATED SCHOOLS,TYLER LANG,,730202,0,0,0,0,OFFICE NO. 2 PORTER CONSOLIDATED SCHOOLS
WAGONER,OFFICE NO. 2 PORTER CONSOLIDATED SCHOOLS,BRENDA LIVESAY,,730202,0,0,0,0,OFFICE NO. 2 PORTER CONSOLIDATED SCHOOLS
WAGONER,OFFICE NO. 2 NORTHEAST TECH CENTER,BILLY F. HENDRICKSON,,730203,0,0,0,0,OFFICE NO. 2 NORTHEAST TECH CENTER
WAGONER,OFFICE NO. 2 NORTHEAST TECH CENTER,SHERMAN WEAVER,,730203,0,0,0,0,OFFICE NO. 2 NORTHEAST TECH CENTER
WAGONER,OFFICE NO. 2 INDIAN CAPITAL TECH CENTER,TOM STILES,,730203,1,5,68,74,OFFICE NO. 2 INDIAN CAPITAL TECH CENTER
WAGONER,OFFICE NO. 2 INDIAN CAPITAL TECH CENTER,RAY KIRK,,730203,0,1,33,34,OFFICE NO. 2 INDIAN CAPITAL TECH CENTER
WAGONER,OFFICE NO. 2 COWETA PUBLIC SCHOOLS,BRAD ANDERSON,,730203,0,0,0,0,OFFICE NO. 2 COWETA PUBLIC SCHOOLS
WAGONER,OFFICE NO. 2 COWETA PUBLIC SCHOOLS,KURT D. CARDWELL,,730203,0,0,0,0,OFFICE NO. 2 COWETA PUBLIC SCHOOLS
WAGONER,OFFICE NO. 2 PORTER CONSOLIDATED SCHOOLS,TYLER LANG,,730203,0,0,0,0,OFFICE NO. 2 PORTER CONSOLIDATED SCHOOLS
WAGONER,OFFICE NO. 2 PORTER CONSOLIDATED SCHOOLS,BRENDA LIVESAY,,730203,0,0,0,0,OFFICE NO. 2 PORTER CONSOLIDATED SCHOOLS
WAGONER,PROPOSITION WAGONER PUBLIC SCHOOLS,FOR THE PROPOSITION - YES,,730203,1,3,68,72,
WAGONER,PROPOSITION WAGONER PUBLIC SCHOOLS,AGAINST THE PROPOSITION - NO,,730203,0,3,38,41,
WAGONER,OFFICE NO. 2 INDIAN CAPITAL TECH CENTER,TOM STILES,,730204,0,0,11,11,OFFICE NO. 2 INDIAN CAPITAL TECH CENTER
WAGONER,OFFICE NO. 2 INDIAN CAPITAL TECH CENTER,RAY KIRK,,730204,0,0,5,5,OFFICE NO. 2 INDIAN CAPITAL TECH CENTER
WAGONER,PROPOSITION WAGONER PUBLIC SCHOOLS,FOR THE PROPOSITION - YES,,730204,0,0,14,14,
WAGONER,PROPOSITION WAGONER PUBLIC SCHOOLS,AGAINST THE PROPOSITION - NO,,730204,0,0,3,3,
WAGONER,OFFICE NO. 2 NORTHEAST TECH CENTER,BILLY F. HENDRICKSON,,730205,0,0,3,3,OFFICE NO. 2 NORTHEAST TECH CENTER
WAGONER,OFFICE NO. 2 NORTHEAST TECH CENTER,SHERMAN WEAVER,,730205,0,0,4,4,OFFICE NO. 2 NORTHEAST TECH CENTER
WAGONER,OFFICE NO. 2 INDIAN CAPITAL TECH CENTER,TOM STILES,,730205,0,0,0,0,OFFICE NO. 2 INDIAN CAPITAL TECH CENTER
WAGONER,OFFICE NO. 2 INDIAN CAPITAL TECH CENTER,RAY KIRK,,730205,0,0,0,0,OFFICE NO. 2 INDIAN CAPITAL TECH CENTER
WAGONER,OFFICE NO. 2 NORTHEAST TECH CENTER,BILLY F. HENDRICKSON,,730206,0,0,4,4,OFFICE NO. 2 NORTHEAST TECH CENTER
WAGONER,OFFICE NO. 2 NORTHEAST TECH CENTER,SHERMAN WEAVER,,730206,0,0,2,2,OFFICE NO. 2 NORTHEAST TECH CENTER
WAGONER,OFFICE NO. 2 INDIAN CAPITAL TECH CENTER,TOM STILES,,730207,0,0,22,22,OFFICE NO. 2 INDIAN CAPITAL TECH CENTER
WAGONER,OFFICE NO. 2 INDIAN CAPITAL TECH CENTER,RAY KIRK,,730207,0,0,4,4,OFFICE NO. 2 INDIAN CAPITAL TECH CENTER
WAGONER,PROPOSITION WAGONER PUBLIC SCHOOLS,FOR THE PROPOSITION - YES,,730207,0,0,20,20,
WAGONER,PROPOSITION WAGONER PUBLIC SCHOOLS,AGAINST THE PROPOSITION - NO,,730207,0,0,6,6,
WAGONER,OFFICE NO. 2 INDIAN CAPITAL TECH CENTER,TOM STILES,,730208,0,5,86,91,OFFICE NO. 2 INDIAN CAPITAL TECH CENTER
WAGONER,OFFICE NO. 2 INDIAN CAPITAL TECH CENTER,RAY KIRK,,730208,0,1,41,42,OFFICE NO. 2 INDIAN CAPITAL TECH CENTER
WAGONER,PROPOSITION WAGONER PUBLIC SCHOOLS,FOR THE PROPOSITION - YES,,730208,0,2,75,77,
WAGONER,PROPOSITION WAGONER PUBLIC SCHOOLS,AGAINST THE PROPOSITION - NO,,730208,0,4,55,59,
WAGONER,OFFICE NO. 2 INDIAN CAPITAL TECH CENTER,TOM STILES,,730209,0,0,11,11,OFFICE NO. 2 INDIAN CAPITAL TECH CENTER
WAGONER,OFFICE NO. 2 INDIAN CAPITAL TECH CENTER,RAY KIRK,,730209,0,0,2,2,OFFICE NO. 2 INDIAN CAPITAL TECH CENTER
WAGONER,PROPOSITION WAGONER PUBLIC SCHOOLS,FOR THE PROPOSITION - YES,,730209,0,0,10,10,
WAGONER,PROPOSITION WAGONER PUBLIC SCHOOLS,AGAINST THE PROPOSITION - NO,,730209,0,0,3,3,
WAGONER,OFFICE NO. 2 INDIAN CAPITAL TECH CENTER,TOM STILES,,730210,1,0,28,29,OFFICE NO. 2 INDIAN CAPITAL TECH CENTER
WAGONER,OFFICE NO. 2 INDIAN CAPITAL TECH CENTER,RAY KIRK,,730210,0,0,4,4,OFFICE NO. 2 INDIAN CAPITAL TECH CENTER
WAGONER,OFFICE NO. 2 PORTER CONSOLIDATED SCHOOLS,TYLER LANG,,730210,0,0,0,0,OFFICE NO. 2 PORTER CONSOLIDATED SCHOOLS
WAGONER,OFFICE NO. 2 PORTER CONSOLIDATED SCHOOLS,BRENDA LIVESAY,,730210,0,0,1,1,OFFICE NO. 2 PORTER CONSOLIDATED SCHOOLS
WAGONER,OFFICE NO. 2 INDIAN CAPITAL TECH CENTER,TOM STILES,,730305,0,0,0,0,OFFICE NO. 2 INDIAN CAPITAL TECH CENTER
WAGONER,OFFICE NO. 2 INDIAN CAPITAL TECH CENTER,RAY KIRK,,730305,0,0,0,0,OFFICE NO. 2 INDIAN CAPITAL TECH CENTER
WAGONER,OFFICE NO. 2 COWETA PUBLIC SCHOOLS,BRAD ANDERSON,,730305,0,0,0,0,OFFICE NO. 2 COWETA PUBLIC SCHOOLS
WAGONER,OFFICE NO. 2 COWETA PUBLIC SCHOOLS,KURT D. CARDWELL,,730305,0,0,0,0,OFFICE NO. 2 COWETA PUBLIC SCHOOLS
WAGONER,OFFICE NO. 2 INDIAN CAPITAL TECH CENTER,TOM STILES,,730307,0,0,11,11,OFFICE NO. 2 INDIAN CAPITAL TECH CENTER
WAGONER,OFFICE NO. 2 INDIAN CAPITAL TECH CENTER,RAY KIRK,,730307,0,0,1,1,OFFICE NO. 2 INDIAN CAPITAL TECH CENTER
WAGONER,OFFICE NO. 2 COWETA PUBLIC SCHOOLS,BRAD ANDERSON,,730307,0,0,14,14,OFFICE NO. 2 COWETA PUBLIC SCHOOLS
WAGONER,OFFICE NO. 2 COWETA PUBLIC SCHOOLS,KURT D. CARDWELL,,730307,0,0,2,2,OFFICE NO. 2 COWETA PUBLIC SCHOOLS
WAGONER,OFFICE NO. 2 INDIAN CAPITAL TECH CENTER,TOM STILES,,730308,0,1,42,43,OFFICE NO. 2 INDIAN CAPITAL TECH CENTER
WAGONER,OFFICE NO. 2 INDIAN CAPITAL TECH CENTER,RAY KIRK,,730308,0,0,10,10,OFFICE NO. 2 INDIAN CAPITAL TECH CENTER
WAGONER,OFFICE NO. 2 COWETA PUBLIC SCHOOLS,BRAD ANDERSON,,730308,0,1,44,45,OFFICE NO. 2 COWETA PUBLIC SCHOOLS
WAGONER,OFFICE NO. 2 COWETA PUBLIC SCHOOLS,KURT D. CARDWELL,,730308,0,0,11,11,OFFICE NO. 2 COWETA PUBLIC SCHOOLS
WAGONER,OFFICE NO. 2 INDIAN CAPITAL TECH CENTER,TOM STILES,,730309,0,0,57,57,OFFICE NO. 2 INDIAN CAPITAL TECH CENTER
WAGONER,OFFICE NO. 2 INDIAN CAPITAL TECH CENTER,RAY KIRK,,730309,0,0,9,9,OFFICE NO. 2 INDIAN CAPITAL TECH CENTER
WAGONER,OFFICE NO. 2 COWETA PUBLIC SCHOOLS,BRAD ANDERSON,,730309,0,0,58,58,OFFICE NO. 2 COWETA PUBLIC SCHOOLS
WAGONER,OFFICE NO. 2 COWETA PUBLIC SCHOOLS,KURT D. CARDWELL,,730309,0,0,11,11,OFFICE NO. 2 COWETA PUBLIC SCHOOLS
WAGONER,OFFICE NO. 2 INDIAN CAPITAL TECH CENTER,TOM STILES,,730310,0,0,16,16,OFFICE NO. 2 INDIAN CAPITAL TECH CENTER
WAGONER,OFFICE NO. 2 INDIAN CAPITAL TECH CENTER,RAY KIRK,,730310,0,0,3,3,OFFICE NO. 2 INDIAN CAPITAL TECH CENTER
WAGONER,OFFICE NO. 2 COWETA PUBLIC SCHOOLS,BRAD ANDERSON,,730310,0,0,6,6,OFFICE NO. 2 COWETA PUBLIC SCHOOLS
WAGONER,OFFICE NO. 2 COWETA PUBLIC SCHOOLS,KURT D. CARDWELL,,730310,0,0,7,7,OFFICE NO. 2 COWETA PUBLIC SCHOOLS
WAGONER,OFFICE NO. 2 INDIAN CAPITAL TECH CENTER,TOM STILES,,730311,0,0,14,14,OFFICE NO. 2 INDIAN CAPITAL TECH CENTER
WAGONER,OFFICE NO. 2 INDIAN CAPITAL TECH CENTER,RAY KIRK,,730311,0,0,3,3,OFFICE NO. 2 INDIAN CAPITAL TECH CENTER
WAGONER,OFFICE NO. 2 COWETA PUBLIC SCHOOLS,BRAD ANDERSON,,730311,0,0,7,7,OFFICE NO. 2 COWETA PUBLIC SCHOOLS
WAGONER,OFFICE NO. 2 COWETA PUBLIC SCHOOLS,KURT D. CARDWELL,,730311,0,0,2,2,OFFICE NO. 2 COWETA PUBLIC SCHOOLS
WAGONER,OFFICE NO. 2 PORTER CONSOLIDATED SCHOOLS,TYLER LANG,,730311,0,0,3,3,OFFICE NO. 2 PORTER CONSOLIDATED SCHOOLS
WAGONER,OFFICE NO. 2 PORTER CONSOLIDATED SCHOOLS,BRENDA LIVESAY,,730311,0,0,5,5,OFFICE NO. 2 PORTER CONSOLIDATED SCHOOLS
WAGONER,OFFICE NO. 2 INDIAN CAPITAL TECH CENTER,TOM STILES,,730312,3,1,65,69,OFFICE NO. 2 INDIAN CAPITAL TECH CENTER
WAGONER,OFFICE NO. 2 INDIAN CAPITAL TECH CENTER,RAY KIRK,,730312,0,0,30,30,OFFICE NO. 2 INDIAN CAPITAL TECH CENTER
WAGONER,OFFICE NO. 2 COWETA PUBLIC SCHOOLS,BRAD ANDERSON,,730312,0,0,7,7,OFFICE NO. 2 COWETA PUBLIC SCHOOLS
WAGONER,OFFICE NO. 2 COWETA PUBLIC SCHOOLS,KURT D. CARDWELL,,730312,3,0,4,7,OFFICE NO. 2 COWETA PUBLIC SCHOOLS
WAGONER,OFFICE NO. 2 PORTER CONSOLIDATED SCHOOLS,TYLER LANG,,730312,0,0,14,14,OFFICE NO. 2 PORTER CONSOLIDATED SCHOOLS
WAGONER,OFFICE NO. 2 PORTER CONSOLIDATED SCHOOLS,BRENDA LIVESAY,,730312,0,2,79,81,OFFICE NO. 2 PORTER CONSOLIDATED SCHOOLS
WAGONER,OFFICE NO. 2 INDIAN CAPITAL TECH CENTER,TOM STILES,,730313,0,1,38,39,OFFICE NO. 2 INDIAN CAPITAL TECH CENTER
WAGONER,OFFICE NO. 2 INDIAN CAPITAL TECH CENTER,RAY KIRK,,730313,0,0,19,19,OFFICE NO. 2 INDIAN CAPITAL TECH CENTER
WAGONER,OFFICE NO. 2 PORTER CONSOLIDATED SCHOOLS,TYLER LANG,,730313,0,0,11,11,OFFICE NO. 2 PORTER CONSOLIDATED SCHOOLS
WAGONER,OFFICE NO. 2 PORTER CONSOLIDATED SCHOOLS,BRENDA LIVESAY,,730313,0,1,50,51,OFFICE NO. 2 PORTER CONSOLIDATED SCHOOLS
WASHINGTON,OFFICE NO. 2 COLLINSVILLE PUBLIC SCHOOLS,C. KEVIN MORRISON,,740077,0,0,2,2,OFFICE NO. 2 COLLINSVILLE PUBLIC SCHOOLS
WASHINGTON,OFFICE NO. 2 COLLINSVILLE PUBLIC SCHOOLS,TIM BESS,,740077,0,0,2,2,OFFICE NO. 2 COLLINSVILLE PUBLIC SCHOOLS
WASHINGTON,OFFICE NO. 5 (UNEXPIRED TERM) TULSA TECH CENTER,ROY D. McCLAIN,,740077,0,0,0,0,OFFICE NO. 5 (UNEXPIRED TERM) TULSA TECH CENTER
WASHINGTON,OFFICE NO. 5 (UNEXPIRED TERM) TULSA TECH CENTER,DANNY HANCOCK,,740077,0,0,4,4,OFFICE NO. 5 (UNEXPIRED TERM) TULSA TECH CENTER
WASHINGTON,PROPOSITION NO. 1 SKIATOOK PUBLIC SCHOOLS,FOR THE PROPOSITION - YES,,740078,0,0,20,20,PROPOSITION NO. 1 SKIATOOK PUBLIC SCHOOLS
WASHINGTON,PROPOSITION NO. 1 SKIATOOK PUBLIC SCHOOLS,AGAINST THE PROPOSITION - NO,,740078,0,0,3,3,PROPOSITION NO. 1 SKIATOOK PUBLIC SCHOOLS
WASHINGTON,PROPOSITION NO. 2 SKIATOOK PUBLIC SCHOOLS,FOR THE PROPOSITION - YES,,740078,0,0,20,20,PROPOSITION NO. 2 SKIATOOK PUBLIC SCHOOLS
WASHINGTON,PROPOSITION NO. 2 SKIATOOK PUBLIC SCHOOLS,AGAINST THE PROPOSITION - NO,,740078,0,0,3,3,PROPOSITION NO. 2 SKIATOOK PUBLIC SCHOOLS
WASHINGTON,OFFICE NO. 5 (UNEXPIRED TERM) TULSA TECH CENTER,ROY D. McCLAIN,,740078,0,0,12,12,OFFICE NO. 5 (UNEXPIRED TERM) TULSA TECH CENTER
WASHINGTON,OFFICE NO. 5 (UNEXPIRED TERM) TULSA TECH CENTER,DANNY HANCOCK,,740078,0,0,8,8,OFFICE NO. 5 (UNEXPIRED TERM) TULSA TECH CENTER
WASHITA,OFFICE NO. 2 MOUNTAIN VIEW-GOTEBO SCHOOLS,DUSTY HELLER,,750003,0,0,14,14,OFFICE NO. 2 MOUNTAIN VIEW-GOTEBO SCHOOLS
WASHITA,OFFICE NO. 2 MOUNTAIN VIEW-GOTEBO SCHOOLS,CECIL HOOPER,,750003,0,0,25,25,OFFICE NO. 2 MOUNTAIN VIEW-GOTEBO SCHOOLS
WASHITA,OFFICE NO. 2 WESTERN TECH CENTER,GARY D. SMITH,,750003,0,0,1,1,OFFICE NO. 2 WESTERN TECH CENTER
WASHITA,OFFICE NO. 2 WESTERN TECH CENTER,BILL JOHANNING,,750003,0,0,0,0,OFFICE NO. 2 WESTERN TECH CENTER
WASHITA,OFFICE NO. 2 MOUNTAIN VIEW-GOTEBO SCHOOLS,DUSTY HELLER,,750004,0,0,0,0,OFFICE NO. 2 MOUNTAIN VIEW-GOTEBO SCHOOLS
WASHITA,OFFICE NO. 2 MOUNTAIN VIEW-GOTEBO SCHOOLS,CECIL HOOPER,,750004,0,0,0,0,OFFICE NO. 2 MOUNTAIN VIEW-GOTEBO SCHOOLS
WASHITA,OFFICE NO. 2 WESTERN TECH CENTER,GARY D. SMITH,,750004,9,4,11,24,OFFICE NO. 2 WESTERN TECH CENTER
WASHITA,OFFICE NO. 2 WESTERN TECH CENTER,BILL JOHANNING,,750004,3,3,5,11,OFFICE NO. 2 WESTERN TECH CENTER
WASHITA,OFFICE NO. 2 CLINTON PUBLIC SCHOOLS,KIMBERLY L. MEACHAM,,750007,0,0,0,0,OFFICE NO. 2 CLINTON PUBLIC SCHOOLS
WASHITA,OFFICE NO. 2 CLINTON PUBLIC SCHOOLS,KEVIN WOLTERS,,750007,0,0,0,0,OFFICE NO. 2 CLINTON PUBLIC SCHOOLS
WASHITA,OFFICE NO. 2 WESTERN TECH CENTER,GARY D. SMITH,,750007,0,0,10,10,OFFICE NO. 2 WESTERN TECH CENTER
WASHITA,OFFICE NO. 2 WESTERN TECH CENTER,BILL JOHANNING,,750007,0,0,4,4,OFFICE NO. 2 WESTERN TECH CENTER
WASHITA,OFFICE NO. 2 MOUNTAIN VIEW-GOTEBO SCHOOLS,DUSTY HELLER,,750009,0,0,0,0,OFFICE NO. 2 MOUNTAIN VIEW-GOTEBO SCHOOLS
WASHITA,OFFICE NO. 2 MOUNTAIN VIEW-GOTEBO SCHOOLS,CECIL HOOPER,,750009,0,0,0,0,OFFICE NO. 2 MOUNTAIN VIEW-GOTEBO SCHOOLS
WASHITA,OFFICE NO. 2 WESTERN TECH CENTER,GARY D. SMITH,,750009,1,1,2,4,OFFICE NO. 2 WESTERN TECH CENTER
WASHITA,OFFICE NO. 2 WESTERN TECH CENTER,BILL JOHANNING,,750009,0,0,0,0,OFFICE NO. 2 WESTERN TECH CENTER
WASHITA,OFFICE NO. 2 CLINTON PUBLIC SCHOOLS,KIMBERLY L. MEACHAM,,750012,0,0,4,4,OFFICE NO. 2 CLINTON PUBLIC SCHOOLS
WASHITA,OFFICE NO. 2 CLINTON PUBLIC SCHOOLS,KEVIN WOLTERS,,750012,0,0,2,2,OFFICE NO. 2 CLINTON PUBLIC SCHOOLS
WASHITA,OFFICE NO. 2 WESTERN TECH CENTER,GARY D. SMITH,,750012,0,0,5,5,OFFICE NO. 2 WESTERN TECH CENTER
WASHITA,OFFICE NO. 2 WESTERN TECH CENTER,BILL JOHANNING,,750012,0,0,4,4,OFFICE NO. 2 WESTERN TECH CENTER
WASHITA,OFFICE NO. 2 WESTERN TECH CENTER,GARY D. SMITH,,750014,2,1,15,18,OFFICE NO. 2 WESTERN TECH CENTER
WASHITA,OFFICE NO. 2 WESTERN TECH CENTER,BILL JOHANNING,,750014,0,0,6,6,OFFICE NO. 2 WESTERN TECH CENTER
WASHITA,OFFICE NO. 2 BURNS FLAT-DILL CITY SCHOOLS,MARVA WEBB,,750016,0,2,45,47,OFFICE NO. 2 BURNS FLAT-DILL CITY SCHOOLS
WASHITA,OFFICE NO. 2 BURNS FLAT-DILL CITY SCHOOLS,SHANE STRETCH WILCOX,,750016,3,0,10,13,OFFICE NO. 2 BURNS FLAT-DILL CITY SCHOOLS
WASHITA,OFFICE NO. 2 WESTERN TECH CENTER,GARY D. SMITH,,750016,3,2,45,50,OFFICE NO. 2 WESTERN TECH CENTER
WASHITA,OFFICE NO. 2 WESTERN TECH CENTER,BILL JOHANNING,,750016,2,0,11,13,OFFICE NO. 2 WESTERN TECH CENTER
WASHITA,OFFICE NO. 2 BURNS FLAT-DILL CITY SCHOOLS,MARVA WEBB,,750017,0,1,35,36,OFFICE NO. 2 BURNS FLAT-DILL CITY SCHOOLS
WASHITA,OFFICE NO. 2 BURNS FLAT-DILL CITY SCHOOLS,SHANE STRETCH WILCOX,,750017,0,0,2,2,OFFICE NO. 2 BURNS FLAT-DILL CITY SCHOOLS
WASHITA,OFFICE NO. 2 WESTERN TECH CENTER,GARY D. SMITH,,750017,0,1,20,21,OFFICE NO. 2 WESTERN TECH CENTER
WASHITA,OFFICE NO. 2 WESTERN TECH CENTER,BILL JOHANNING,,750017,0,0,5,5,OFFICE NO. 2 WESTERN TECH CENTER
WASHITA,OFFICE NO. 2 BURNS FLAT-DILL CITY SCHOOLS,MARVA WEBB,,750018,5,0,41,46,OFFICE NO. 2 BURNS FLAT-DILL CITY SCHOOLS
WASHITA,OFFICE NO. 2 BURNS FLAT-DILL CITY SCHOOLS,SHANE STRETCH WILCOX,,750018,0,0,17,17,OFFICE NO. 2 BURNS FLAT-DILL CITY SCHOOLS
WASHITA,OFFICE NO. 2 WESTERN TECH CENTER,GARY D. SMITH,,750018,4,0,36,40,OFFICE NO. 2 WESTERN TECH CENTER
WASHITA,OFFICE NO. 2 WESTERN TECH CENTER,BILL JOHANNING,,750018,1,0,13,14,OFFICE NO. 2 WESTERN TECH CENTER
WASHITA,OFFICE NO. 2 BURNS FLAT-DILL CITY SCHOOLS,MARVA WEBB,,750019,0,1,1,2,OFFICE NO. 2 BURNS FLAT-DILL CITY SCHOOLS
WASHITA,OFFICE NO. 2 BURNS FLAT-DILL CITY SCHOOLS,SHANE STRETCH WILCOX,,750019,0,0,0,0,OFFICE NO. 2 BURNS FLAT-DILL CITY SCHOOLS
WASHITA,OFFICE NO. 2 WESTERN TECH CENTER,GARY D. SMITH,,750019,3,1,5,9,OFFICE NO. 2 WESTERN TECH CENTER
WASHITA,OFFICE NO. 2 WESTERN TECH CENTER,BILL JOHANNING,,750019,1,0,1,2,OFFICE NO. 2 WESTERN TECH CENTER
WASHITA,OFFICE NO. 2 WEATHERFORD PUBLIC SCHOOLS,BROCK W. McSPERITT,,750020,0,0,2,2,OFFICE NO. 2 WEATHERFORD PUBLIC SCHOOLS
WASHITA,OFFICE NO. 2 WEATHERFORD PUBLIC SCHOOLS,BRYAN BAYLESS,,750020,1,0,1,2,OFFICE NO. 2 WEATHERFORD PUBLIC SCHOOLS
WASHITA,OFFICE NO. 2 WESTERN TECH CENTER,GARY D. SMITH,,750020,1,0,10,11,OFFICE NO. 2 WESTERN TECH CENTER
WASHITA,OFFICE NO. 2 WESTERN TECH CENTER,BILL JOHANNING,,750020,0,0,4,4,OFFICE NO. 2 WESTERN TECH CENTER
WASHITA,OFFICE NO. 2 WESTERN TECH CENTER,GARY D. SMITH,,750030,4,2,8,14,OFFICE NO. 2 WESTERN TECH CENTER
WASHITA,OFFICE NO. 2 WESTERN TECH CENTER,BILL JOHANNING,,750030,1,0,0,1,OFFICE NO. 2 WESTERN TECH CENTER
WOODS,OFFICE NO. 2 WAYNOKA PUBLIC SCHOOLS,TRAVIS GEORGE,,760001,0,0,0,0,OFFICE NO. 2 WAYNOKA PUBLIC SCHOOLS
WOODS,OFFICE NO. 2 WAYNOKA PUBLIC SCHOOLS,MINDY ZOOK,,760001,0,0,0,0,OFFICE NO. 2 WAYNOKA PUBLIC SCHOOLS
WOODS,OFFICE NO. 2 WAYNOKA PUBLIC SCHOOLS,JENNIFER RICH,,760001,0,0,0,0,OFFICE NO. 2 WAYNOKA PUBLIC SCHOOLS
WOODS,OFFICE NO. 2 WAYNOKA PUBLIC SCHOOLS,TRAVIS GEORGE,,760002,7,2,187,196,OFFICE NO. 2 WAYNOKA PUBLIC SCHOOLS
WOODS,OFFICE NO. 2 WAYNOKA PUBLIC SCHOOLS,MINDY ZOOK,,760002,2,4,159,165,OFFICE NO. 2 WAYNOKA PUBLIC SCHOOLS
WOODS,OFFICE NO. 2 WAYNOKA PUBLIC SCHOOLS,JENNIFER RICH,,760002,0,0,23,23,OFFICE NO. 2 WAYNOKA PUBLIC SCHOOLS
WOODS,OFFICE NO. 2 WAYNOKA PUBLIC SCHOOLS,TRAVIS GEORGE,,760003,0,0,0,0,OFFICE NO. 2 WAYNOKA PUBLIC SCHOOLS
WOODS,OFFICE NO. 2 WAYNOKA PUBLIC SCHOOLS,MINDY ZOOK,,760003,0,0,0,0,OFFICE NO. 2 WAYNOKA PUBLIC SCHOOLS
WOODS,OFFICE NO. 2 WAYNOKA PUBLIC SCHOOLS,JENNIFER RICH,,760003,0,0,0,0,OFFICE NO. 2 WAYNOKA PUBLIC SCHOOLS
WOODS,OFFICE NO. 2 FREEDOM PUBLIC SCHOOLS,CONCHA HERRERA,,760008,7,1,66,74,OFFICE NO. 2 FREEDOM PUBLIC SCHOOLS
WOODS,OFFICE NO. 2 FREEDOM PUBLIC SCHOOLS,DONALD SIMMONS,,760008,0,0,78,78,OFFICE NO. 2 FREEDOM PUBLIC SCHOOLS
WOODS,OFFICE NO. 4 (UNEXPIRED TERM) FREEDOM PUBLIC SCHOOLS,SANDRA J. KAMAS,,760008,7,1,69,77,OFFICE NO. 4 (UNEXPIRED TERM) FREEDOM PUBLIC SCHOOLS
WOODS,OFFICE NO. 4 (UNEXPIRED TERM) FREEDOM PUBLIC SCHOOLS,ROBERT N BABCOCK,,760008,0,0,75,75,OFFICE NO. 4 (UNEXPIRED TERM) FREEDOM PUBLIC SCHOOLS
WOODS,OFFICE NO. 5 (UNEXPIRED TERM) FREEDOM PUBLIC SCHOOLS,SHANE MORRIS,,760008,2,0,71,73,OFFICE NO. 5 (UNEXPIRED TERM) FREEDOM PUBLIC SCHOOLS
WOODS,OFFICE NO. 5 (UNEXPIRED TERM) FREEDOM PUBLIC SCHOOLS,RAUL GALINDO,,760008,5,1,73,79,OFFICE NO. 5 (UNEXPIRED TERM) FREEDOM PUBLIC SCHOOLS
WOODWARD,OFFICE NO. 2 FREEDOM PUBLIC SCHOOLS,CONCHA HERRERA,,770105,0,0,4,4,OFFICE NO. 2 FREEDOM PUBLIC SCHOOLS
WOODWARD,OFFICE NO. 2 FREEDOM PUBLIC SCHOOLS,DONALD SIMMONS,,770105,0,0,9,9,OFFICE NO. 2 FREEDOM PUBLIC SCHOOLS
WOODWARD,OFFICE NO. 4 (UNEXPIRED TERM) FREEDOM PUBLIC SCHOOLS,SANDRA J. KAMAS,,770105,0,0,5,5,OFFICE NO. 4 (UNEXPIRED TERM) FREEDOM PUBLIC SCHOOLS
WOODWARD,OFFICE NO. 4 (UNEXPIRED TERM) FREEDOM PUBLIC SCHOOLS,ROBERT N BABCOCK,,770105,0,0,8,8,OFFICE NO. 4 (UNEXPIRED TERM) FREEDOM PUBLIC SCHOOLS
WOODWARD,OFFICE NO. 5 (UNEXPIRED TERM) FREEDOM PUBLIC SCHOOLS,SHANE MORRIS,,770105,0,0,9,9,OFFICE NO. 5 (UNEXPIRED TERM) FREEDOM PUBLIC SCHOOLS
WOODWARD,OFFICE NO. 5 (UNEXPIRED TERM) FREEDOM PUBLIC SCHOOLS,RAUL GALINDO,,770105,0,0,4,4,OFFICE NO. 5 (UNEXPIRED TERM) FREEDOM PUBLIC SCHOOLS
