county,office,candidate,party,precinct,mail_votes,early_votes,elec_day_votes,total_votes,district
Adair,President,Barack Obama,DEM,10001,10,15,119,144,
Adair,President,Mitt Romney,REP,10001,18,20,178,216,
Adair,U.S. House,Rob Wallace,DEM,10001,12,17,114,143,02
Adair,U.S. House,Markwayne Mullin,REP,10001,16,20,178,214,02
Adair,U.S. House,Michael Fulks,IND,10001,0,0,8,8,02
Adair,State Senate,Jim Bynum,DEM,10001,13,20,160,193,3
Adair,State Senate,Wayne Shaw,REP,10001,15,17,137,169,3
Adair,State House,Will Fourkiller,DEM,10001,26,26,239,291,86
Adair,State House,Russell Don Turner,REP,10001,2,11,64,77,86
Adair,President,Barack Obama,DEM,10002,4,7,79,90,
Adair,President,Mitt Romney,REP,10002,3,42,172,217,
Adair,U.S. House,Rob Wallace,DEM,10002,4,6,76,86,02
Adair,U.S. House,Markwayne Mullin,REP,10002,3,42,166,211,02
Adair,U.S. House,Michael Fulks,IND,10002,0,1,5,6,02
Adair,State Senate,Jim Bynum,DEM,10002,5,14,116,135,3
Adair,State Senate,Wayne Shaw,REP,10002,2,35,129,166,3
Adair,State House,Will Fourkiller,DEM,10002,6,29,171,206,86
Adair,State House,Russell Don Turner,REP,10002,1,20,78,99,86
Adair,President,Barack Obama,DEM,10003,2,0,45,47,
Adair,President,Mitt Romney,REP,10003,10,2,92,104,
Adair,U.S. House,Rob Wallace,DEM,10003,0,0,37,37,02
Adair,U.S. House,Markwayne Mullin,REP,10003,12,2,94,108,02
Adair,U.S. House,Michael Fulks,IND,10003,0,0,6,6,02
Adair,State Senate,Jim Bynum,DEM,10003,4,0,67,71,3
Adair,State Senate,Wayne Shaw,REP,10003,8,2,71,81,3
Adair,State House,Will Fourkiller,DEM,10003,5,0,81,86,86
Adair,State House,Russell Don Turner,REP,10003,7,2,58,67,86
Adair,President,Barack Obama,DEM,10004,15,9,70,94,
Adair,President,Mitt Romney,REP,10004,6,23,157,186,
Adair,U.S. House,Rob Wallace,DEM,10004,13,15,75,103,02
Adair,U.S. House,Markwayne Mullin,REP,10004,7,17,144,168,02
Adair,U.S. House,Michael Fulks,IND,10004,1,0,8,9,02
Adair,State Senate,Jim Bynum,DEM,10004,14,21,120,155,3
Adair,State Senate,Wayne Shaw,REP,10004,7,11,104,122,3
Adair,State House,Will Fourkiller,DEM,10004,17,25,177,219,86
Adair,State House,Russell Don Turner,REP,10004,4,7,51,62,86
Adair,President,Barack Obama,DEM,10005,5,4,38,47,
Adair,President,Mitt Romney,REP,10005,1,5,153,159,
Adair,U.S. House,Rob Wallace,DEM,10005,2,4,42,48,02
Adair,U.S. House,Markwayne Mullin,REP,10005,3,6,144,153,02
Adair,U.S. House,Michael Fulks,IND,10005,1,0,4,5,02
Adair,State Senate,Jim Bynum,DEM,10005,4,7,73,84,3
Adair,State Senate,Wayne Shaw,REP,10005,1,3,112,116,3
Adair,State House,Will Fourkiller,DEM,10005,4,8,149,161,86
Adair,State House,Russell Don Turner,REP,10005,1,2,46,49,86
Adair,President,Barack Obama,DEM,10006,6,14,114,134,
Adair,President,Mitt Romney,REP,10006,6,23,286,315,
Adair,U.S. House,Rob Wallace,DEM,10006,5,14,100,119,02
Adair,U.S. House,Markwayne Mullin,REP,10006,10,22,289,321,02
Adair,U.S. House,Michael Fulks,IND,10006,0,0,11,11,02
Adair,State Senate,Jim Bynum,DEM,10006,10,23,199,232,3
Adair,State Senate,Wayne Shaw,REP,10006,5,13,194,212,3
Adair,State House,Will Fourkiller,DEM,10006,13,33,305,351,86
Adair,State House,Russell Don Turner,REP,10006,2,4,96,102,86
Adair,President,Barack Obama,DEM,10007,17,27,136,180,
Adair,President,Mitt Romney,REP,10007,14,21,284,319,
Adair,U.S. House,Rob Wallace,DEM,10007,18,23,149,190,02
Adair,U.S. House,Markwayne Mullin,REP,10007,12,22,264,298,02
Adair,U.S. House,Michael Fulks,IND,10007,1,3,10,14,02
Adair,State Senate,Jim Bynum,DEM,10007,20,28,221,269,3
Adair,State Senate,Wayne Shaw,REP,10007,10,21,199,230,3
Adair,State House,Will Fourkiller,DEM,10007,24,42,341,407,86
Adair,State House,Russell Don Turner,REP,10007,5,7,83,95,86
Adair,President,Barack Obama,DEM,10008,10,14,116,140,
Adair,President,Mitt Romney,REP,10008,12,22,204,238,
Adair,U.S. House,Rob Wallace,DEM,10008,8,13,99,120,02
Adair,U.S. House,Markwayne Mullin,REP,10008,14,22,216,252,02
Adair,U.S. House,Michael Fulks,IND,10008,0,1,9,10,02
Adair,State Senate,Jim Bynum,DEM,10008,17,23,183,223,3
Adair,State Senate,Wayne Shaw,REP,10008,5,13,142,160,3
Adair,State House,Will Fourkiller,DEM,10008,21,34,272,327,86
Adair,State House,Russell Don Turner,REP,10008,3,2,54,59,86
Adair,President,Barack Obama,DEM,10010,13,1,35,49,
Adair,President,Mitt Romney,REP,10010,12,5,73,90,
Adair,U.S. House,Rob Wallace,DEM,10010,11,2,40,53,02
Adair,U.S. House,Markwayne Mullin,REP,10010,16,4,68,88,02
Adair,U.S. House,Michael Fulks,IND,10010,0,0,4,4,02
Adair,State Senate,Jim Bynum,DEM,10010,24,4,70,98,3
Adair,State Senate,Wayne Shaw,REP,10010,5,2,43,50,3
Adair,State House,Will Fourkiller,DEM,10010,23,5,92,120,86
Adair,State House,Russell Don Turner,REP,10010,5,1,21,27,86
Adair,President,Barack Obama,DEM,10011,12,4,67,83,
Adair,President,Mitt Romney,REP,10011,4,8,112,124,
Adair,U.S. House,Rob Wallace,DEM,10011,13,4,65,82,02
Adair,U.S. House,Markwayne Mullin,REP,10011,3,7,101,111,02
Adair,U.S. House,Michael Fulks,IND,10011,0,1,7,8,02
Adair,State Senate,Jim Bynum,DEM,10011,13,4,73,90,3
Adair,State Senate,Wayne Shaw,REP,10011,3,8,97,108,3
Adair,State House,Will Fourkiller,DEM,10011,16,6,121,143,86
Adair,State House,Russell Don Turner,REP,10011,2,6,51,59,86
Adair,President,Barack Obama,DEM,10012,3,5,103,111,
Adair,President,Mitt Romney,REP,10012,10,17,260,287,
Adair,U.S. House,Rob Wallace,DEM,10012,2,5,114,121,02
Adair,U.S. House,Markwayne Mullin,REP,10012,11,16,242,269,02
Adair,U.S. House,Michael Fulks,IND,10012,0,1,9,10,02
Adair,State Senate,Jim Bynum,DEM,10012,6,11,171,188,3
Adair,State Senate,Wayne Shaw,REP,10012,6,11,196,213,3
Adair,State House,Will Fourkiller,DEM,10012,11,16,269,296,86
Adair,State House,Russell Don Turner,REP,10012,2,6,96,104,86
Adair,President,Barack Obama,DEM,10013,7,13,99,119,
Adair,President,Mitt Romney,REP,10013,4,21,178,203,
Adair,U.S. House,Rob Wallace,DEM,10013,5,19,88,112,02
Adair,U.S. House,Markwayne Mullin,REP,10013,6,14,181,201,02
Adair,U.S. House,Michael Fulks,IND,10013,0,1,7,8,02
Adair,State Senate,Jim Bynum,DEM,10013,8,20,167,195,3
Adair,State Senate,Wayne Shaw,REP,10013,3,14,106,123,3
Adair,State House,Will Fourkiller,DEM,10013,9,31,235,275,86
Adair,State House,Russell Don Turner,REP,10013,3,3,42,48,86
Adair,President,Barack Obama,DEM,10014,12,14,192,218,
Adair,President,Mitt Romney,REP,10014,14,35,251,300,
Adair,U.S. House,Rob Wallace,DEM,10014,11,18,162,191,02
Adair,U.S. House,Markwayne Mullin,REP,10014,14,29,261,304,02
Adair,U.S. House,Michael Fulks,IND,10014,1,1,18,20,02
Adair,State Senate,Jim Bynum,DEM,10014,14,23,258,295,3
Adair,State Senate,Wayne Shaw,REP,10014,11,25,182,218,3
Adair,State House,Will Fourkiller,DEM,10014,21,41,364,426,86
Adair,State House,Russell Don Turner,REP,10014,4,7,76,87,86
Adair,President,Barack Obama,DEM,10016,0,0,69,69,
Adair,President,Mitt Romney,REP,10016,14,6,240,260,
Adair,U.S. House,Rob Wallace,DEM,10016,0,0,58,58,02
Adair,U.S. House,Markwayne Mullin,REP,10016,14,6,236,256,02
Adair,U.S. House,Michael Fulks,IND,10016,0,0,11,11,02
Adair,State Senate,Jim Bynum,DEM,10016,0,0,99,99,3
Adair,State Senate,Wayne Shaw,REP,10016,14,6,206,226,3
Adair,State House,Will Fourkiller,DEM,10016,1,2,112,115,86
Adair,State House,Russell Don Turner,REP,10016,13,4,187,204,86
Adair,President,Barack Obama,DEM,10017,21,8,172,201,
Adair,President,Mitt Romney,REP,10017,19,21,374,414,
Adair,U.S. House,Rob Wallace,DEM,10017,14,8,188,210,02
Adair,U.S. House,Markwayne Mullin,REP,10017,26,18,338,382,02
Adair,U.S. House,Michael Fulks,IND,10017,2,3,17,22,02
Adair,State Senate,Jim Bynum,DEM,10017,24,11,272,307,3
Adair,State Senate,Wayne Shaw,REP,10017,19,16,273,308,3
Adair,State House,Will Fourkiller,DEM,10017,30,13,323,366,86
Adair,State House,Russell Don Turner,REP,10017,12,14,219,245,86
Adair,President,Barack Obama,DEM,10018,43,13,148,204,
Adair,President,Mitt Romney,REP,10018,23,15,339,377,
Adair,U.S. House,Rob Wallace,DEM,10018,26,9,128,163,02
Adair,U.S. House,Markwayne Mullin,REP,10018,41,18,337,396,02
Adair,U.S. House,Michael Fulks,IND,10018,2,1,23,26,02
Adair,State Senate,Jim Bynum,DEM,10018,54,13,268,335,3
Adair,State Senate,Wayne Shaw,REP,10018,16,15,218,249,3
Adair,State House,Will Fourkiller,DEM,10018,64,21,359,444,86
Adair,State House,Russell Don Turner,REP,10018,5,6,128,139,86
Adair,President,Barack Obama,DEM,10019,20,3,174,197,
Adair,President,Mitt Romney,REP,10019,26,16,530,572,
Adair,U.S. House,Rob Wallace,DEM,10019,12,3,161,176,02
Adair,U.S. House,Markwayne Mullin,REP,10019,32,15,520,567,02
Adair,U.S. House,Michael Fulks,IND,10019,4,2,19,25,02
Adair,State Senate,Jim Bynum,DEM,10019,35,9,320,364,3
Adair,State Senate,Wayne Shaw,REP,10019,14,12,377,403,3
Adair,State House,Will Fourkiller,DEM,10019,40,12,462,514,86
Adair,State House,Russell Don Turner,REP,10019,12,9,234,255,86
Alfalfa,President,Barack Obama,DEM,20110,0,0,26,26,
Alfalfa,President,Mitt Romney,REP,20110,10,12,132,154,
Alfalfa,U.S. House,Timothy Ray Murray,DEM,20110,0,0,15,15,03
Alfalfa,U.S. House,Frank Lucas,REP,20110,10,12,141,163,03
Alfalfa,U.S. House,William Sanders,IND,20110,0,0,1,1,03
Alfalfa,President,Barack Obama,DEM,20120,1,3,30,34,
Alfalfa,President,Mitt Romney,REP,20120,11,24,120,155,
Alfalfa,U.S. House,Timothy Ray Murray,DEM,20120,0,2,18,20,03
Alfalfa,U.S. House,Frank Lucas,REP,20120,11,25,125,161,03
Alfalfa,U.S. House,William Sanders,IND,20120,1,0,6,7,03
Alfalfa,President,Barack Obama,DEM,20140,1,9,46,56,
Alfalfa,President,Mitt Romney,REP,20140,11,36,252,299,
Alfalfa,U.S. House,Timothy Ray Murray,DEM,20140,0,5,37,42,03
Alfalfa,U.S. House,Frank Lucas,REP,20140,11,36,248,295,03
Alfalfa,U.S. House,William Sanders,IND,20140,0,4,12,16,03
Alfalfa,President,Barack Obama,DEM,20220,8,8,68,84,
Alfalfa,President,Mitt Romney,REP,20220,21,44,265,330,
Alfalfa,U.S. House,Timothy Ray Murray,DEM,20220,9,6,36,51,03
Alfalfa,U.S. House,Frank Lucas,REP,20220,19,44,285,348,03
Alfalfa,U.S. House,William Sanders,IND,20220,1,2,11,14,03
Alfalfa,President,Barack Obama,DEM,20230,4,1,44,49,
Alfalfa,President,Mitt Romney,REP,20230,9,5,219,233,
Alfalfa,U.S. House,Timothy Ray Murray,DEM,20230,2,1,31,34,03
Alfalfa,U.S. House,Frank Lucas,REP,20230,11,5,215,231,03
Alfalfa,U.S. House,William Sanders,IND,20230,0,1,17,18,03
Alfalfa,President,Barack Obama,DEM,20310,0,2,32,34,
Alfalfa,President,Mitt Romney,REP,20310,10,18,255,283,
Alfalfa,U.S. House,Timothy Ray Murray,DEM,20310,0,1,25,26,03
Alfalfa,U.S. House,Frank Lucas,REP,20310,10,16,255,281,03
Alfalfa,U.S. House,William Sanders,IND,20310,0,2,9,11,03
Alfalfa,President,Barack Obama,DEM,20330,6,2,31,39,
Alfalfa,President,Mitt Romney,REP,20330,43,15,249,307,
Alfalfa,U.S. House,Timothy Ray Murray,DEM,20330,4,2,29,35,03
Alfalfa,U.S. House,Frank Lucas,REP,20330,44,13,247,304,03
Alfalfa,U.S. House,William Sanders,IND,20330,1,2,6,9,03
Atoka,President,Barack Obama,DEM,30001,3,49,104,156,
Atoka,President,Mitt Romney,REP,30001,14,104,254,372,
Atoka,U.S. House,Rob Wallace,DEM,30001,3,69,134,206,02
Atoka,U.S. House,Markwayne Mullin,REP,30001,13,80,202,295,02
Atoka,U.S. House,Michael Fulks,IND,30001,0,1,24,25,02
Atoka,State House,Doris Anne Row,DEM,30001,1,56,103,160,22
Atoka,State House,Charles Mccall,REP,30001,16,96,261,373,22
Atoka,President,Barack Obama,DEM,30002,7,28,44,79,
Atoka,President,Mitt Romney,REP,30002,18,76,197,291,
Atoka,U.S. House,Rob Wallace,DEM,30002,5,36,66,107,02
Atoka,U.S. House,Markwayne Mullin,REP,30002,15,65,159,239,02
Atoka,U.S. House,Michael Fulks,IND,30002,2,1,10,13,02
Atoka,State House,Doris Anne Row,DEM,30002,7,17,46,70,22
Atoka,State House,Charles Mccall,REP,30002,16,86,197,299,22
Atoka,President,Barack Obama,DEM,30003,4,39,96,139,
Atoka,President,Mitt Romney,REP,30003,6,82,127,215,
Atoka,U.S. House,Rob Wallace,DEM,30003,4,48,116,168,02
Atoka,U.S. House,Markwayne Mullin,REP,30003,5,75,88,168,02
Atoka,U.S. House,Michael Fulks,IND,30003,1,0,10,11,02
Atoka,State House,Doris Anne Row,DEM,30003,4,42,84,130,22
Atoka,State House,Charles Mccall,REP,30003,6,82,138,226,22
Atoka,President,Barack Obama,DEM,30006,5,15,45,65,
Atoka,President,Mitt Romney,REP,30006,3,36,148,187,
Atoka,U.S. House,Rob Wallace,DEM,30006,5,19,62,86,02
Atoka,U.S. House,Markwayne Mullin,REP,30006,3,31,117,151,02
Atoka,U.S. House,Michael Fulks,IND,30006,0,1,11,12,02
Atoka,State House,Doris Anne Row,DEM,30006,4,16,55,75,22
Atoka,State House,Charles Mccall,REP,30006,4,36,137,177,22
Atoka,President,Barack Obama,DEM,30007,1,9,92,102,
Atoka,President,Mitt Romney,REP,30007,10,56,267,333,
Atoka,U.S. House,Rob Wallace,DEM,30007,1,20,133,154,02
Atoka,U.S. House,Markwayne Mullin,REP,30007,10,43,215,268,02
Atoka,U.S. House,Michael Fulks,IND,30007,0,1,8,9,02
Atoka,State House,Doris Anne Row,DEM,30007,1,14,129,144,22
Atoka,State House,Charles Mccall,REP,30007,10,51,232,293,22
Atoka,President,Barack Obama,DEM,30008,9,7,139,155,
Atoka,President,Mitt Romney,REP,30008,19,31,419,469,
Atoka,U.S. House,Rob Wallace,DEM,30008,8,10,218,236,02
Atoka,U.S. House,Markwayne Mullin,REP,30008,19,28,324,371,02
Atoka,U.S. House,Michael Fulks,IND,30008,0,0,19,19,02
Atoka,State House,Doris Anne Row,DEM,30008,15,10,204,229,22
Atoka,State House,Charles Mccall,REP,30008,12,28,362,402,22
Atoka,President,Barack Obama,DEM,30009,9,24,80,113,
Atoka,President,Mitt Romney,REP,30009,14,83,208,305,
Atoka,U.S. House,Rob Wallace,DEM,30009,8,39,117,164,02
Atoka,U.S. House,Markwayne Mullin,REP,30009,10,66,161,237,02
Atoka,U.S. House,Michael Fulks,IND,30009,2,2,9,13,02
Atoka,State House,Doris Anne Row,DEM,30009,7,27,89,123,22
Atoka,State House,Charles Mccall,REP,30009,16,81,204,301,22
Atoka,President,Barack Obama,DEM,30010,3,4,25,32,
Atoka,President,Mitt Romney,REP,30010,1,4,121,126,
Atoka,U.S. House,Rob Wallace,DEM,30010,3,4,51,58,02
Atoka,U.S. House,Markwayne Mullin,REP,30010,1,3,86,90,02
Atoka,U.S. House,Michael Fulks,IND,30010,0,1,10,11,02
Atoka,State Senate,Jerry Ellis,DEM,30010,3,4,78,85,5
Atoka,State Senate,Howard Houchen,REP,30010,0,4,67,71,5
Atoka,President,Barack Obama,DEM,30011,4,71,131,206,
Atoka,President,Mitt Romney,REP,30011,17,144,387,548,
Atoka,U.S. House,Rob Wallace,DEM,30011,8,93,213,314,02
Atoka,U.S. House,Markwayne Mullin,REP,30011,11,118,282,411,02
Atoka,U.S. House,Michael Fulks,IND,30011,0,7,20,27,02
Atoka,President,Barack Obama,DEM,30012,0,3,65,68,
Atoka,President,Mitt Romney,REP,30012,4,24,243,271,
Atoka,U.S. House,Rob Wallace,DEM,30012,1,7,102,110,02
Atoka,U.S. House,Markwayne Mullin,REP,30012,3,19,188,210,02
Atoka,U.S. House,Michael Fulks,IND,30012,0,1,15,16,02
Atoka,State Senate,Jerry Ellis,DEM,30012,1,14,192,207,5
Atoka,State Senate,Howard Houchen,REP,30012,3,13,105,121,5
Atoka,President,Barack Obama,DEM,30013,0,4,57,61,
Atoka,President,Mitt Romney,REP,30013,7,16,235,258,
Atoka,U.S. House,Rob Wallace,DEM,30013,1,7,106,114,02
Atoka,U.S. House,Markwayne Mullin,REP,30013,6,13,175,194,02
Atoka,U.S. House,Michael Fulks,IND,30013,0,0,8,8,02
Atoka,State Senate,Jerry Ellis,DEM,30013,0,16,172,188,5
Atoka,State Senate,Howard Houchen,REP,30013,7,4,116,127,5
Atoka,President,Barack Obama,DEM,30014,1,1,20,22,
Atoka,President,Mitt Romney,REP,30014,1,14,77,92,
Atoka,U.S. House,Rob Wallace,DEM,30014,1,8,28,37,02
Atoka,U.S. House,Markwayne Mullin,REP,30014,1,7,62,70,02
Atoka,U.S. House,Michael Fulks,IND,30014,0,0,4,4,02
Atoka,State Senate,Jerry Ellis,DEM,30014,1,9,62,72,5
Atoka,State Senate,Howard Houchen,REP,30014,1,6,34,41,5
Atoka,President,Barack Obama,DEM,30015,2,7,26,35,
Atoka,President,Mitt Romney,REP,30015,3,8,29,40,
Atoka,U.S. House,Rob Wallace,DEM,30015,2,7,32,41,02
Atoka,U.S. House,Markwayne Mullin,REP,30015,3,8,19,30,02
Atoka,U.S. House,Michael Fulks,IND,30015,0,0,5,5,02
Atoka,State Senate,Jerry Ellis,DEM,30015,3,9,39,51,5
Atoka,State Senate,Howard Houchen,REP,30015,2,6,17,25,5
Atoka,President,Barack Obama,DEM,30016,0,0,0,0,
Atoka,President,Mitt Romney,REP,30016,0,0,0,0,
Atoka,U.S. House,Rob Wallace,DEM,30016,0,0,0,0,02
Atoka,U.S. House,Markwayne Mullin,REP,30016,0,0,0,0,02
Atoka,U.S. House,Michael Fulks,IND,30016,0,0,0,0,02
Atoka,President,Barack Obama,DEM,30017,0,0,0,0,
Atoka,President,Mitt Romney,REP,30017,0,0,0,0,
Atoka,U.S. House,Rob Wallace,DEM,30017,0,0,0,0,02
Atoka,U.S. House,Markwayne Mullin,REP,30017,0,0,0,0,02
Atoka,U.S. House,Michael Fulks,IND,30017,0,0,0,0,02
Atoka,President,Barack Obama,DEM,30018,0,0,0,0,
Atoka,President,Mitt Romney,REP,30018,0,0,0,0,
Atoka,U.S. House,Rob Wallace,DEM,30018,0,0,0,0,02
Atoka,U.S. House,Markwayne Mullin,REP,30018,0,0,0,0,02
Atoka,U.S. House,Michael Fulks,IND,30018,0,0,0,0,02
Atoka,State Senate,Jerry Ellis,DEM,30018,0,0,0,0,5
Atoka,State Senate,Howard Houchen,REP,30018,0,0,0,0,5
Atoka,President,Barack Obama,DEM,30019,0,0,10,10,
Atoka,President,Mitt Romney,REP,30019,2,2,27,31,
Atoka,U.S. House,Rob Wallace,DEM,30019,0,0,17,17,02
Atoka,U.S. House,Markwayne Mullin,REP,30019,2,2,19,23,02
Atoka,U.S. House,Michael Fulks,IND,30019,0,0,1,1,02
Beaver,President,Barack Obama,DEM,40011,0,1,14,15,
Beaver,President,Mitt Romney,REP,40011,21,8,149,178,
Beaver,U.S. House,Timothy Ray Murray,DEM,40011,0,1,8,9,03
Beaver,U.S. House,Frank Lucas,REP,40011,21,9,150,180,03
Beaver,U.S. House,William Sanders,IND,40011,0,0,5,5,03
Beaver,State Senate,A. Bryce Marlatt,REP,40011,21,7,142,170,27
Beaver,State Senate,Tommy Nicholson,IND,40011,0,2,17,19,27
Beaver,President,Barack Obama,DEM,40013,0,0,6,6,
Beaver,President,Mitt Romney,REP,40013,10,4,105,119,
Beaver,U.S. House,Timothy Ray Murray,DEM,40013,0,0,4,4,03
Beaver,U.S. House,Frank Lucas,REP,40013,10,4,103,117,03
Beaver,U.S. House,William Sanders,IND,40013,0,0,6,6,03
Beaver,State Senate,A. Bryce Marlatt,REP,40013,10,4,101,115,27
Beaver,State Senate,Tommy Nicholson,IND,40013,0,0,11,11,27
Beaver,President,Barack Obama,DEM,40023,4,12,87,103,
Beaver,President,Mitt Romney,REP,40023,68,154,579,801,
Beaver,U.S. House,Timothy Ray Murray,DEM,40023,2,6,65,73,03
Beaver,U.S. House,Frank Lucas,REP,40023,70,153,582,805,03
Beaver,U.S. House,William Sanders,IND,40023,0,6,21,27,03
Beaver,State Senate,A. Bryce Marlatt,REP,40023,64,141,562,767,27
Beaver,State Senate,Tommy Nicholson,IND,40023,7,18,88,113,27
Beaver,President,Barack Obama,DEM,40025,4,0,18,22,
Beaver,President,Mitt Romney,REP,40025,12,19,153,184,
Beaver,U.S. House,Timothy Ray Murray,DEM,40025,4,1,13,18,03
Beaver,U.S. House,Frank Lucas,REP,40025,11,17,144,172,03
Beaver,U.S. House,William Sanders,IND,40025,1,0,12,13,03
Beaver,State Senate,A. Bryce Marlatt,REP,40025,10,17,137,164,27
Beaver,State Senate,Tommy Nicholson,IND,40025,4,1,21,26,27
Beaver,President,Barack Obama,DEM,40026,1,0,4,5,
Beaver,President,Mitt Romney,REP,40026,3,5,37,45,
Beaver,U.S. House,Timothy Ray Murray,DEM,40026,1,0,4,5,03
Beaver,U.S. House,Frank Lucas,REP,40026,2,5,37,44,03
Beaver,U.S. House,William Sanders,IND,40026,1,0,0,1,03
Beaver,State Senate,A. Bryce Marlatt,REP,40026,3,5,33,41,27
Beaver,State Senate,Tommy Nicholson,IND,40026,1,0,5,6,27
Beaver,President,Barack Obama,DEM,40031,4,0,13,17,
Beaver,President,Mitt Romney,REP,40031,10,30,188,228,
Beaver,U.S. House,Timothy Ray Murray,DEM,40031,1,0,8,9,03
Beaver,U.S. House,Frank Lucas,REP,40031,13,30,180,223,03
Beaver,U.S. House,William Sanders,IND,40031,0,0,10,10,03
Beaver,State Senate,A. Bryce Marlatt,REP,40031,14,29,171,214,27
Beaver,State Senate,Tommy Nicholson,IND,40031,0,1,23,24,27
Beaver,President,Barack Obama,DEM,40033,5,1,70,76,
Beaver,President,Mitt Romney,REP,40033,20,25,462,507,
Beaver,U.S. House,Timothy Ray Murray,DEM,40033,3,1,51,55,03
Beaver,U.S. House,Frank Lucas,REP,40033,20,22,459,501,03
Beaver,U.S. House,William Sanders,IND,40033,2,3,20,25,03
Beaver,State Senate,A. Bryce Marlatt,REP,40033,20,22,449,491,27
Beaver,State Senate,Tommy Nicholson,IND,40033,5,3,65,73,27
Beckham,President,Barack Obama,DEM,50111,10,43,118,171,
Beckham,President,Mitt Romney,REP,50111,15,100,424,539,
Beckham,U.S. House,Timothy Ray Murray,DEM,50111,8,33,77,118,03
Beckham,U.S. House,Frank Lucas,REP,50111,17,107,453,577,03
Beckham,U.S. House,William Sanders,IND,50111,0,3,14,17,03
Beckham,President,Barack Obama,DEM,50112,4,11,82,97,
Beckham,President,Mitt Romney,REP,50112,8,50,196,254,
Beckham,U.S. House,Timothy Ray Murray,DEM,50112,1,6,47,54,03
Beckham,U.S. House,Frank Lucas,REP,50112,7,51,226,284,03
Beckham,U.S. House,William Sanders,IND,50112,1,3,6,10,03
Beckham,President,Barack Obama,DEM,50115,2,8,13,23,
Beckham,President,Mitt Romney,REP,50115,10,53,51,114,
Beckham,U.S. House,Timothy Ray Murray,DEM,50115,0,4,8,12,03
Beckham,U.S. House,Frank Lucas,REP,50115,12,57,54,123,03
Beckham,U.S. House,William Sanders,IND,50115,0,1,3,4,03
Beckham,President,Barack Obama,DEM,50141,3,8,115,126,
Beckham,President,Mitt Romney,REP,50141,20,56,523,599,
Beckham,U.S. House,Timothy Ray Murray,DEM,50141,2,6,88,96,03
Beckham,U.S. House,Frank Lucas,REP,50141,20,55,528,603,03
Beckham,U.S. House,William Sanders,IND,50141,1,3,18,22,03
Beckham,President,Barack Obama,DEM,50231,3,4,55,62,
Beckham,President,Mitt Romney,REP,50231,10,18,264,292,
Beckham,U.S. House,Timothy Ray Murray,DEM,50231,2,2,41,45,03
Beckham,U.S. House,Frank Lucas,REP,50231,11,20,269,300,03
Beckham,U.S. House,William Sanders,IND,50231,0,0,11,11,03
Beckham,President,Barack Obama,DEM,50232,1,0,7,8,
Beckham,President,Mitt Romney,REP,50232,3,4,60,67,
Beckham,U.S. House,Timothy Ray Murray,DEM,50232,1,0,4,5,03
Beckham,U.S. House,Frank Lucas,REP,50232,3,4,62,69,03
Beckham,U.S. House,William Sanders,IND,50232,0,0,1,1,03
Beckham,President,Barack Obama,DEM,50235,9,20,290,319,
Beckham,President,Mitt Romney,REP,50235,54,95,1075,1224,
Beckham,U.S. House,Timothy Ray Murray,DEM,50235,10,19,189,218,03
Beckham,U.S. House,Frank Lucas,REP,50235,52,91,1127,1270,03
Beckham,U.S. House,William Sanders,IND,50235,1,4,50,55,03
Beckham,President,Barack Obama,DEM,50242,1,3,77,81,
Beckham,President,Mitt Romney,REP,50242,3,19,177,199,
Beckham,U.S. House,Timothy Ray Murray,DEM,50242,0,2,45,47,03
Beckham,U.S. House,Frank Lucas,REP,50242,4,19,199,222,03
Beckham,U.S. House,William Sanders,IND,50242,0,1,8,9,03
Beckham,President,Barack Obama,DEM,50320,1,5,109,115,
Beckham,President,Mitt Romney,REP,50320,13,17,332,362,
Beckham,U.S. House,Timothy Ray Murray,DEM,50320,0,2,72,74,03
Beckham,U.S. House,Frank Lucas,REP,50320,11,20,354,385,03
Beckham,U.S. House,William Sanders,IND,50320,3,0,16,19,03
Beckham,President,Barack Obama,DEM,50330,0,8,40,48,
Beckham,President,Mitt Romney,REP,50330,11,41,255,307,
Beckham,U.S. House,Timothy Ray Murray,DEM,50330,0,5,25,30,03
Beckham,U.S. House,Frank Lucas,REP,50330,10,43,254,307,03
Beckham,U.S. House,William Sanders,IND,50330,1,1,16,18,03
Beckham,President,Barack Obama,DEM,50332,7,13,142,162,
Beckham,President,Mitt Romney,REP,50332,29,65,695,789,
Beckham,U.S. House,Timothy Ray Murray,DEM,50332,6,10,99,115,03
Beckham,U.S. House,Frank Lucas,REP,50332,30,67,707,804,03
Beckham,U.S. House,William Sanders,IND,50332,0,1,26,27,03
Beckham,President,Barack Obama,DEM,50333,2,15,158,175,
Beckham,President,Mitt Romney,REP,50333,19,64,566,649,
Beckham,U.S. House,Timothy Ray Murray,DEM,50333,2,11,103,116,03
Beckham,U.S. House,Frank Lucas,REP,50333,19,65,583,667,03
Beckham,U.S. House,William Sanders,IND,50333,0,2,33,35,03
Beckham,President,Barack Obama,DEM,50343,1,9,20,30,
Beckham,President,Mitt Romney,REP,50343,5,28,80,113,
Beckham,U.S. House,Timothy Ray Murray,DEM,50343,1,13,18,32,03
Beckham,U.S. House,Frank Lucas,REP,50343,5,25,78,108,03
Beckham,U.S. House,William Sanders,IND,50343,0,1,6,7,03
Blaine,President,Barack Obama,DEM,60002,8,7,102,117,
Blaine,President,Mitt Romney,REP,60002,18,16,515,549,
Blaine,U.S. House,Timothy Ray Murray,DEM,60002,6,5,48,59,03
Blaine,U.S. House,Frank Lucas,REP,60002,13,15,529,557,03
Blaine,U.S. House,William Sanders,IND,60002,6,3,42,51,03
Blaine,President,Barack Obama,DEM,60007,4,6,135,145,
Blaine,President,Mitt Romney,REP,60007,14,12,421,447,
Blaine,U.S. House,Timothy Ray Murray,DEM,60007,3,5,98,106,03
Blaine,U.S. House,Frank Lucas,REP,60007,15,10,422,447,03
Blaine,U.S. House,William Sanders,IND,60007,0,3,39,42,03
Blaine,President,Barack Obama,DEM,60010,5,12,96,113,
Blaine,President,Mitt Romney,REP,60010,9,42,172,223,
Blaine,U.S. House,Timothy Ray Murray,DEM,60010,0,7,38,45,03
Blaine,U.S. House,Frank Lucas,REP,60010,13,40,210,263,03
Blaine,U.S. House,William Sanders,IND,60010,0,5,19,24,03
Blaine,President,Barack Obama,DEM,60011,0,19,127,146,
Blaine,President,Mitt Romney,REP,60011,8,29,82,119,
Blaine,U.S. House,Timothy Ray Murray,DEM,60011,0,13,85,98,03
Blaine,U.S. House,Frank Lucas,REP,60011,9,30,106,145,03
Blaine,U.S. House,William Sanders,IND,60011,0,5,17,22,03
Blaine,President,Barack Obama,DEM,60012,4,40,182,226,
Blaine,President,Mitt Romney,REP,60012,33,148,587,768,
Blaine,U.S. House,Timothy Ray Murray,DEM,60012,2,32,98,132,03
Blaine,U.S. House,Frank Lucas,REP,60012,33,149,620,802,03
Blaine,U.S. House,William Sanders,IND,60012,2,7,46,55,03
Blaine,President,Barack Obama,DEM,60016,0,1,22,23,
Blaine,President,Mitt Romney,REP,60016,6,24,95,125,
Blaine,U.S. House,Timothy Ray Murray,DEM,60016,0,3,15,18,03
Blaine,U.S. House,Frank Lucas,REP,60016,5,20,93,118,03
Blaine,U.S. House,William Sanders,IND,60016,0,2,9,11,03
Blaine,President,Barack Obama,DEM,60017,11,8,158,177,
Blaine,President,Mitt Romney,REP,60017,12,9,306,327,
Blaine,U.S. House,Timothy Ray Murray,DEM,60017,6,4,117,127,03
Blaine,U.S. House,Frank Lucas,REP,60017,15,11,326,352,03
Blaine,U.S. House,William Sanders,IND,60017,3,2,25,30,03
Blaine,President,Barack Obama,DEM,60020,1,1,33,35,
Blaine,President,Mitt Romney,REP,60020,8,0,214,222,
Blaine,U.S. House,Timothy Ray Murray,DEM,60020,0,1,24,25,03
Blaine,U.S. House,Frank Lucas,REP,60020,9,0,213,222,03
Blaine,U.S. House,William Sanders,IND,60020,0,0,7,7,03
Blaine,President,Barack Obama,DEM,60022,4,0,6,10,
Blaine,President,Mitt Romney,REP,60022,0,4,40,44,
Blaine,U.S. House,Timothy Ray Murray,DEM,60022,3,0,1,4,03
Blaine,U.S. House,Frank Lucas,REP,60022,1,4,41,46,03
Blaine,U.S. House,William Sanders,IND,60022,0,0,4,4,03
Bryan,President,Barack Obama,DEM,70003,2,37,197,236,
Bryan,President,Mitt Romney,REP,70003,3,76,394,473,
Bryan,U.S. House,Rob Wallace,DEM,70003,1,39,259,299,02
Bryan,U.S. House,Markwayne Mullin,REP,70003,1,67,286,354,02
Bryan,U.S. House,Michael Fulks,IND,70003,2,7,36,45,02
Bryan,State House,Jerry Tomlinson,DEM,70003,3,45,261,309,21
Bryan,State House,Dustin Roberts,REP,70003,2,67,327,396,21
Bryan,President,Barack Obama,DEM,70004,7,37,253,297,
Bryan,President,Mitt Romney,REP,70004,15,69,491,575,
Bryan,U.S. House,Rob Wallace,DEM,70004,7,47,333,387,02
Bryan,U.S. House,Markwayne Mullin,REP,70004,12,52,371,435,02
Bryan,U.S. House,Michael Fulks,IND,70004,2,6,43,51,02
Bryan,State House,Jerry Tomlinson,DEM,70004,7,53,289,349,21
Bryan,State House,Dustin Roberts,REP,70004,12,52,456,520,21
Bryan,President,Barack Obama,DEM,70005,6,41,216,263,
Bryan,President,Mitt Romney,REP,70005,17,101,445,563,
Bryan,U.S. House,Rob Wallace,DEM,70005,3,40,257,300,02
Bryan,U.S. House,Markwayne Mullin,REP,70005,15,91,354,460,02
Bryan,U.S. House,Michael Fulks,IND,70005,2,8,45,55,02
Bryan,State House,Jerry Tomlinson,DEM,70005,7,56,288,351,21
Bryan,State House,Dustin Roberts,REP,70005,15,85,375,475,21
Bryan,President,Barack Obama,DEM,70008,15,40,182,237,
Bryan,President,Mitt Romney,REP,70008,23,122,497,642,
Bryan,U.S. House,Rob Wallace,DEM,70008,14,52,242,308,02
Bryan,U.S. House,Markwayne Mullin,REP,70008,21,105,393,519,02
Bryan,U.S. House,Michael Fulks,IND,70008,1,3,37,41,02
Bryan,State House,Jerry Tomlinson,DEM,70008,19,57,252,328,21
Bryan,State House,Dustin Roberts,REP,70008,16,104,421,541,21
Bryan,President,Barack Obama,DEM,70010,2,19,104,125,
Bryan,President,Mitt Romney,REP,70010,4,39,265,308,
Bryan,U.S. House,Rob Wallace,DEM,70010,3,21,160,184,02
Bryan,U.S. House,Markwayne Mullin,REP,70010,3,35,185,223,02
Bryan,U.S. House,Michael Fulks,IND,70010,0,2,23,25,02
Bryan,State House,Jerry Tomlinson,DEM,70010,1,19,147,167,21
Bryan,State House,Dustin Roberts,REP,70010,5,39,225,269,21
Bryan,President,Barack Obama,DEM,70011,1,5,63,69,
Bryan,President,Mitt Romney,REP,70011,1,7,132,140,
Bryan,U.S. House,Rob Wallace,DEM,70011,2,5,89,96,02
Bryan,U.S. House,Markwayne Mullin,REP,70011,0,6,104,110,02
Bryan,U.S. House,Michael Fulks,IND,70011,0,1,6,7,02
Bryan,President,Barack Obama,DEM,70013,2,10,110,122,
Bryan,President,Mitt Romney,REP,70013,9,10,357,376,
Bryan,U.S. House,Rob Wallace,DEM,70013,2,8,166,176,02
Bryan,U.S. House,Markwayne Mullin,REP,70013,8,9,279,296,02
Bryan,U.S. House,Michael Fulks,IND,70013,0,3,13,16,02
Bryan,President,Barack Obama,DEM,70014,0,3,70,73,
Bryan,President,Mitt Romney,REP,70014,2,16,206,224,
Bryan,U.S. House,Rob Wallace,DEM,70014,0,3,97,100,02
Bryan,U.S. House,Markwayne Mullin,REP,70014,2,16,162,180,02
Bryan,U.S. House,Michael Fulks,IND,70014,0,0,17,17,02
Bryan,President,Barack Obama,DEM,70015,4,3,139,146,
Bryan,President,Mitt Romney,REP,70015,12,21,362,395,
Bryan,U.S. House,Rob Wallace,DEM,70015,4,5,214,223,02
Bryan,U.S. House,Markwayne Mullin,REP,70015,12,18,264,294,02
Bryan,U.S. House,Michael Fulks,IND,70015,0,0,23,23,02
Bryan,President,Barack Obama,DEM,70017,2,6,120,128,
Bryan,President,Mitt Romney,REP,70017,5,21,270,296,
Bryan,U.S. House,Rob Wallace,DEM,70017,1,9,167,177,02
Bryan,U.S. House,Markwayne Mullin,REP,70017,6,18,203,227,02
Bryan,U.S. House,Michael Fulks,IND,70017,0,0,19,19,02
Bryan,State House,Jerry Tomlinson,DEM,70017,2,8,150,160,21
Bryan,State House,Dustin Roberts,REP,70017,4,20,242,266,21
Bryan,President,Barack Obama,DEM,70018,5,14,193,212,
Bryan,President,Mitt Romney,REP,70018,18,58,537,613,
Bryan,U.S. House,Rob Wallace,DEM,70018,6,22,282,310,02
Bryan,U.S. House,Markwayne Mullin,REP,70018,15,48,406,469,02
Bryan,U.S. House,Michael Fulks,IND,70018,2,3,31,36,02
Bryan,State House,Jerry Tomlinson,DEM,70018,5,25,231,261,21
Bryan,State House,Dustin Roberts,REP,70018,19,48,495,562,21
Bryan,President,Barack Obama,DEM,70019,3,16,129,148,
Bryan,President,Mitt Romney,REP,70019,24,49,371,444,
Bryan,U.S. House,Rob Wallace,DEM,70019,10,17,191,218,02
Bryan,U.S. House,Markwayne Mullin,REP,70019,12,43,292,347,02
Bryan,U.S. House,Michael Fulks,IND,70019,2,4,18,24,02
Bryan,State House,Jerry Tomlinson,DEM,70019,8,17,163,188,21
Bryan,State House,Dustin Roberts,REP,70019,17,48,338,403,21
Bryan,President,Barack Obama,DEM,70020,0,8,142,150,
Bryan,President,Mitt Romney,REP,70020,8,28,316,352,
Bryan,U.S. House,Rob Wallace,DEM,70020,0,10,169,179,02
Bryan,U.S. House,Markwayne Mullin,REP,70020,8,24,265,297,02
Bryan,U.S. House,Michael Fulks,IND,70020,0,2,16,18,02
Bryan,State House,Jerry Tomlinson,DEM,70020,2,10,176,188,21
Bryan,State House,Dustin Roberts,REP,70020,6,26,278,310,21
Bryan,President,Barack Obama,DEM,70021,2,15,109,126,
Bryan,President,Mitt Romney,REP,70021,22,50,351,423,
Bryan,U.S. House,Rob Wallace,DEM,70021,3,21,159,183,02
Bryan,U.S. House,Markwayne Mullin,REP,70021,20,44,270,334,02
Bryan,U.S. House,Michael Fulks,IND,70021,0,0,24,24,02
Bryan,State House,Jerry Tomlinson,DEM,70021,5,17,128,150,21
Bryan,State House,Dustin Roberts,REP,70021,18,48,333,399,21
Bryan,President,Barack Obama,DEM,70022,10,6,256,272,
Bryan,President,Mitt Romney,REP,70022,15,36,543,594,
Bryan,U.S. House,Rob Wallace,DEM,70022,14,11,301,326,02
Bryan,U.S. House,Markwayne Mullin,REP,70022,10,30,450,490,02
Bryan,U.S. House,Michael Fulks,IND,70022,0,1,38,39,02
Bryan,State House,Jerry Tomlinson,DEM,70022,10,13,313,336,21
Bryan,State House,Dustin Roberts,REP,70022,14,29,473,516,21
Bryan,President,Barack Obama,DEM,70023,4,2,109,115,
Bryan,President,Mitt Romney,REP,70023,1,12,175,188,
Bryan,U.S. House,Rob Wallace,DEM,70023,3,2,126,131,02
Bryan,U.S. House,Markwayne Mullin,REP,70023,1,12,140,153,02
Bryan,U.S. House,Michael Fulks,IND,70023,0,0,10,10,02
Bryan,State House,Jerry Tomlinson,DEM,70023,3,5,135,143,21
Bryan,State House,Dustin Roberts,REP,70023,1,9,144,154,21
Bryan,President,Barack Obama,DEM,70025,6,10,224,240,
Bryan,President,Mitt Romney,REP,70025,26,78,459,563,
Bryan,U.S. House,Rob Wallace,DEM,70025,7,19,290,316,02
Bryan,U.S. House,Markwayne Mullin,REP,70025,25,68,363,456,02
Bryan,U.S. House,Michael Fulks,IND,70025,0,0,25,25,02
Bryan,State House,Jerry Tomlinson,DEM,70025,9,18,268,295,21
Bryan,State House,Dustin Roberts,REP,70025,23,69,412,504,21
Bryan,President,Barack Obama,DEM,70026,3,9,82,94,
Bryan,President,Mitt Romney,REP,70026,3,31,270,304,
Bryan,U.S. House,Rob Wallace,DEM,70026,2,13,101,116,02
Bryan,U.S. House,Markwayne Mullin,REP,70026,2,26,213,241,02
Bryan,U.S. House,Michael Fulks,IND,70026,1,1,30,32,02
Bryan,State House,Jerry Tomlinson,DEM,70026,3,14,113,130,21
Bryan,State House,Dustin Roberts,REP,70026,3,26,236,265,21
Bryan,President,Barack Obama,DEM,70027,1,20,156,177,
Bryan,President,Mitt Romney,REP,70027,17,83,497,597,
Bryan,U.S. House,Rob Wallace,DEM,70027,1,26,220,247,02
Bryan,U.S. House,Markwayne Mullin,REP,70027,16,71,402,489,02
Bryan,U.S. House,Michael Fulks,IND,70027,0,5,19,24,02
Bryan,State House,Jerry Tomlinson,DEM,70027,6,32,220,258,21
Bryan,State House,Dustin Roberts,REP,70027,12,71,431,514,21
Bryan,President,Barack Obama,DEM,70028,0,7,139,146,
Bryan,President,Mitt Romney,REP,70028,4,43,407,454,
Bryan,U.S. House,Rob Wallace,DEM,70028,1,10,199,210,02
Bryan,U.S. House,Markwayne Mullin,REP,70028,3,39,314,356,02
Bryan,U.S. House,Michael Fulks,IND,70028,0,1,28,29,02
Bryan,State House,Jerry Tomlinson,DEM,70028,0,7,158,165,21
Bryan,State House,Dustin Roberts,REP,70028,4,43,380,427,21
Bryan,President,Barack Obama,DEM,70029,0,1,66,67,
Bryan,President,Mitt Romney,REP,70029,1,6,70,77,
Bryan,U.S. House,Rob Wallace,DEM,70029,0,0,87,87,02
Bryan,U.S. House,Markwayne Mullin,REP,70029,1,7,47,55,02
Bryan,U.S. House,Michael Fulks,IND,70029,0,0,4,4,02
Bryan,President,Barack Obama,DEM,70033,4,35,199,238,
Bryan,President,Mitt Romney,REP,70033,27,126,766,919,
Bryan,U.S. House,Rob Wallace,DEM,70033,6,45,292,343,02
Bryan,U.S. House,Markwayne Mullin,REP,70033,20,104,622,746,02
Bryan,U.S. House,Michael Fulks,IND,70033,1,8,36,45,02
Bryan,State House,Jerry Tomlinson,DEM,70033,8,59,281,348,21
Bryan,State House,Dustin Roberts,REP,70033,19,101,677,797,21
Caddo,President,Barack Obama,DEM,80012,2,26,193,221,
Caddo,President,Mitt Romney,REP,80012,2,13,87,102,
Caddo,U.S. House,Timothy Ray Murray,DEM,80012,3,22,161,186,03
Caddo,U.S. House,Frank Lucas,REP,80012,1,15,108,124,03
Caddo,U.S. House,William Sanders,IND,80012,0,2,14,16,03
Caddo,State House,David Perryman,DEM,80012,3,27,220,250,56
Caddo,State House,Chuck Utsler,REP,80012,1,12,63,76,56
Caddo,President,Barack Obama,DEM,80022,5,35,182,222,
Caddo,President,Mitt Romney,REP,80022,7,33,158,198,
Caddo,U.S. House,Timothy Ray Murray,DEM,80022,6,24,144,174,03
Caddo,U.S. House,Frank Lucas,REP,80022,7,40,171,218,03
Caddo,U.S. House,William Sanders,IND,80022,1,3,23,27,03
Caddo,State House,David Perryman,DEM,80022,11,38,211,260,56
Caddo,State House,Chuck Utsler,REP,80022,3,29,125,157,56
Caddo,President,Barack Obama,DEM,80031,4,20,153,177,
Caddo,President,Mitt Romney,REP,80031,7,24,91,122,
Caddo,U.S. House,Timothy Ray Murray,DEM,80031,3,17,125,145,03
Caddo,U.S. House,Frank Lucas,REP,80031,7,25,107,139,03
Caddo,U.S. House,William Sanders,IND,80031,0,1,11,12,03
Caddo,State House,David Perryman,DEM,80031,4,24,172,200,56
Caddo,State House,Chuck Utsler,REP,80031,6,17,71,94,56
Caddo,President,Barack Obama,DEM,80041,11,45,221,277,
Caddo,President,Mitt Romney,REP,80041,22,80,301,403,
Caddo,U.S. House,Timothy Ray Murray,DEM,80041,9,33,155,197,03
Caddo,U.S. House,Frank Lucas,REP,80041,22,88,347,457,03
Caddo,U.S. House,William Sanders,IND,80041,1,6,21,28,03
Caddo,State House,David Perryman,DEM,80041,13,72,279,364,56
Caddo,State House,Chuck Utsler,REP,80041,19,58,242,319,56
Caddo,President,Barack Obama,DEM,80051,8,75,316,399,
Caddo,President,Mitt Romney,REP,80051,19,96,375,490,
Caddo,U.S. House,Timothy Ray Murray,DEM,80051,7,67,244,318,03
Caddo,U.S. House,Frank Lucas,REP,80051,20,103,416,539,03
Caddo,U.S. House,William Sanders,IND,80051,0,1,28,29,03
Caddo,State House,David Perryman,DEM,80051,13,101,412,526,56
Caddo,State House,Chuck Utsler,REP,80051,14,70,277,361,56
Caddo,President,Barack Obama,DEM,80102,14,14,284,312,
Caddo,President,Mitt Romney,REP,80102,21,19,488,528,
Caddo,U.S. House,Timothy Ray Murray,DEM,80102,11,11,222,244,03
Caddo,U.S. House,Frank Lucas,REP,80102,23,21,521,565,03
Caddo,U.S. House,William Sanders,IND,80102,0,1,21,22,03
Caddo,State House,Kendra Menz-Kimble,DEM,80102,16,17,442,475,60
Caddo,State House,Dan Fisher,REP,80102,16,16,314,346,60
Caddo,President,Barack Obama,DEM,80509,0,1,119,120,
Caddo,President,Mitt Romney,REP,80509,5,10,230,245,
Caddo,U.S. House,Timothy Ray Murray,DEM,80509,0,1,117,118,03
Caddo,U.S. House,Frank Lucas,REP,80509,5,10,216,231,03
Caddo,U.S. House,William Sanders,IND,80509,0,0,16,16,03
Caddo,President,Barack Obama,DEM,80510,2,1,160,163,
Caddo,President,Mitt Romney,REP,80510,16,26,400,442,
Caddo,U.S. House,Timothy Ray Murray,DEM,80510,1,1,118,120,03
Caddo,U.S. House,Frank Lucas,REP,80510,16,24,420,460,03
Caddo,U.S. House,William Sanders,IND,80510,1,2,19,22,03
Caddo,President,Barack Obama,DEM,80511,5,9,278,292,
Caddo,President,Mitt Romney,REP,80511,19,12,464,495,
Caddo,U.S. House,Timothy Ray Murray,DEM,80511,5,11,206,222,03
Caddo,U.S. House,Frank Lucas,REP,80511,16,10,508,534,03
Caddo,U.S. House,William Sanders,IND,80511,3,0,26,29,03
Caddo,President,Barack Obama,DEM,80712,6,13,164,183,
Caddo,President,Mitt Romney,REP,80712,2,13,300,315,
Caddo,U.S. House,Timothy Ray Murray,DEM,80712,4,6,110,120,03
Caddo,U.S. House,Frank Lucas,REP,80712,3,19,339,361,03
Caddo,U.S. House,William Sanders,IND,80712,0,1,15,16,03
Caddo,State House,David Perryman,DEM,80712,6,19,281,306,56
Caddo,State House,Chuck Utsler,REP,80712,1,7,182,190,56
Caddo,President,Barack Obama,DEM,80715,0,0,41,41,
Caddo,President,Mitt Romney,REP,80715,4,6,59,69,
Caddo,U.S. House,Timothy Ray Murray,DEM,80715,0,0,30,30,03
Caddo,U.S. House,Frank Lucas,REP,80715,4,6,66,76,03
Caddo,U.S. House,William Sanders,IND,80715,0,0,3,3,03
Caddo,State House,David Perryman,DEM,80715,4,4,72,80,56
Caddo,State House,Chuck Utsler,REP,80715,0,2,27,29,56
Caddo,President,Barack Obama,DEM,80810,0,9,54,63,
Caddo,President,Mitt Romney,REP,80810,8,4,113,125,
Caddo,U.S. House,Timothy Ray Murray,DEM,80810,0,4,38,42,03
Caddo,U.S. House,Frank Lucas,REP,80810,8,11,123,142,03
Caddo,U.S. House,William Sanders,IND,80810,0,0,5,5,03
Caddo,State House,David Perryman,DEM,80810,4,10,82,96,56
Caddo,State House,Chuck Utsler,REP,80810,4,5,84,93,56
Caddo,President,Barack Obama,DEM,80811,2,12,101,115,
Caddo,President,Mitt Romney,REP,80811,11,22,189,222,
Caddo,U.S. House,Timothy Ray Murray,DEM,80811,1,11,82,94,03
Caddo,U.S. House,Frank Lucas,REP,80811,11,23,199,233,03
Caddo,U.S. House,William Sanders,IND,80811,1,0,9,10,03
Caddo,State House,David Perryman,DEM,80811,3,21,145,169,56
Caddo,State House,Chuck Utsler,REP,80811,10,13,144,167,56
Caddo,President,Barack Obama,DEM,80812,3,4,61,68,
Caddo,President,Mitt Romney,REP,80812,3,8,113,124,
Caddo,U.S. House,Timothy Ray Murray,DEM,80812,3,4,42,49,03
Caddo,U.S. House,Frank Lucas,REP,80812,3,8,122,133,03
Caddo,U.S. House,William Sanders,IND,80812,0,0,8,8,03
Caddo,State House,David Perryman,DEM,80812,3,5,87,95,56
Caddo,State House,Chuck Utsler,REP,80812,3,7,88,98,56
Caddo,President,Barack Obama,DEM,81009,0,1,68,69,
Caddo,President,Mitt Romney,REP,81009,5,8,166,179,
Caddo,U.S. House,Timothy Ray Murray,DEM,81009,0,1,38,39,03
Caddo,U.S. House,Frank Lucas,REP,81009,5,8,178,191,03
Caddo,U.S. House,William Sanders,IND,81009,0,0,16,16,03
Caddo,State House,David Perryman,DEM,81009,0,3,81,84,56
Caddo,State House,Chuck Utsler,REP,81009,5,6,151,162,56
Caddo,President,Barack Obama,DEM,81010,0,3,106,109,
Caddo,President,Mitt Romney,REP,81010,9,13,268,290,
Caddo,U.S. House,Timothy Ray Murray,DEM,81010,2,2,86,90,03
Caddo,U.S. House,Frank Lucas,REP,81010,8,14,277,299,03
Caddo,U.S. House,William Sanders,IND,81010,0,0,12,12,03
Caddo,State House,David Perryman,DEM,81010,3,7,192,202,56
Caddo,State House,Chuck Utsler,REP,81010,7,9,181,197,56
Caddo,President,Barack Obama,DEM,81011,1,0,68,69,
Caddo,President,Mitt Romney,REP,81011,8,5,198,211,
Caddo,U.S. House,Timothy Ray Murray,DEM,81011,1,0,42,43,03
Caddo,U.S. House,Frank Lucas,REP,81011,7,5,217,229,03
Caddo,U.S. House,William Sanders,IND,81011,0,0,11,11,03
Caddo,State House,Kendra Menz-Kimble,DEM,81011,2,3,131,136,60
Caddo,State House,Dan Fisher,REP,81011,6,2,134,142,60
Caddo,President,Barack Obama,DEM,81013,4,0,62,66,
Caddo,President,Mitt Romney,REP,81013,22,1,203,226,
Caddo,U.S. House,Timothy Ray Murray,DEM,81013,2,1,50,53,03
Caddo,U.S. House,Frank Lucas,REP,81013,24,0,204,228,03
Caddo,U.S. House,William Sanders,IND,81013,0,0,9,9,03
Caddo,State House,Kendra Menz-Kimble,DEM,81013,12,1,132,145,60
Caddo,State House,Dan Fisher,REP,81013,14,0,126,140,60
Caddo,President,Barack Obama,DEM,81111,1,3,139,143,
Caddo,President,Mitt Romney,REP,81111,20,5,646,671,
Caddo,U.S. House,Timothy Ray Murray,DEM,81111,1,4,106,111,03
Caddo,U.S. House,Frank Lucas,REP,81111,19,4,652,675,03
Caddo,U.S. House,William Sanders,IND,81111,0,0,27,27,03
Caddo,State House,Kendra Menz-Kimble,DEM,81111,2,4,329,335,60
Caddo,State House,Dan Fisher,REP,81111,18,4,457,479,60
Caddo,President,Barack Obama,DEM,81213,1,0,54,55,
Caddo,President,Mitt Romney,REP,81213,8,2,220,230,
Caddo,U.S. House,Timothy Ray Murray,DEM,81213,1,1,43,45,03
Caddo,U.S. House,Frank Lucas,REP,81213,8,1,225,234,03
Caddo,U.S. House,William Sanders,IND,81213,0,0,5,5,03
Canadian,President,Barack Obama,DEM,90100,5,32,175,212,
Canadian,President,Mitt Romney,REP,90100,13,76,424,513,
Canadian,U.S. House,Timothy Ray Murray,DEM,90100,4,26,128,158,03
Canadian,U.S. House,Frank Lucas,REP,90100,14,76,429,519,03
Canadian,U.S. House,William Sanders,IND,90100,0,4,41,45,03
Canadian,State House,Kendra Menz-Kimble,DEM,90100,6,46,245,297,60
Canadian,State House,Dan Fisher,REP,90100,12,61,355,428,60
Canadian,President,Barack Obama,DEM,90102,1,11,52,64,
Canadian,President,Mitt Romney,REP,90102,2,21,116,139,
Canadian,U.S. House,Timothy Ray Murray,DEM,90102,1,6,39,46,03
Canadian,U.S. House,Frank Lucas,REP,90102,2,25,124,151,03
Canadian,U.S. House,William Sanders,IND,90102,0,1,4,5,03
Canadian,President,Barack Obama,DEM,90106,16,54,234,304,
Canadian,President,Mitt Romney,REP,90106,30,98,442,570,
Canadian,U.S. House,Timothy Ray Murray,DEM,90106,11,42,177,230,03
Canadian,U.S. House,Frank Lucas,REP,90106,29,106,458,593,03
Canadian,U.S. House,William Sanders,IND,90106,2,3,38,43,03
Canadian,State House,Kendra Menz-Kimble,DEM,90106,15,66,321,402,60
Canadian,State House,Dan Fisher,REP,90106,26,85,349,460,60
Canadian,President,Barack Obama,DEM,90107,1,5,97,103,
Canadian,President,Mitt Romney,REP,90107,7,29,228,264,
Canadian,U.S. House,Timothy Ray Murray,DEM,90107,1,4,73,78,03
Canadian,U.S. House,Frank Lucas,REP,90107,6,30,243,279,03
Canadian,U.S. House,William Sanders,IND,90107,1,0,9,10,03
Canadian,State House,Kendra Menz-Kimble,DEM,90107,2,10,143,155,60
Canadian,State House,Dan Fisher,REP,90107,6,24,181,211,60
Canadian,President,Barack Obama,DEM,90109,2,2,23,27,
Canadian,President,Mitt Romney,REP,90109,4,19,87,110,
Canadian,U.S. House,Timothy Ray Murray,DEM,90109,2,0,17,19,03
Canadian,U.S. House,Frank Lucas,REP,90109,4,20,93,117,03
Canadian,U.S. House,William Sanders,IND,90109,0,0,0,0,03
Canadian,President,Barack Obama,DEM,90114,9,26,147,182,
Canadian,President,Mitt Romney,REP,90114,23,79,384,486,
Canadian,U.S. House,Timothy Ray Murray,DEM,90114,7,16,112,135,03
Canadian,U.S. House,Frank Lucas,REP,90114,25,81,395,501,03
Canadian,U.S. House,William Sanders,IND,90114,0,7,19,26,03
Canadian,State House,Kendra Menz-Kimble,DEM,90114,14,37,216,267,60
Canadian,State House,Dan Fisher,REP,90114,16,67,308,391,60
Canadian,President,Barack Obama,DEM,90116,8,112,339,459,
Canadian,President,Mitt Romney,REP,90116,25,108,499,632,
Canadian,U.S. House,Timothy Ray Murray,DEM,90116,5,76,250,331,03
Canadian,U.S. House,Frank Lucas,REP,90116,28,127,532,687,03
Canadian,U.S. House,William Sanders,IND,90116,1,13,50,64,03
Canadian,State House,Kendra Menz-Kimble,DEM,90116,12,114,386,512,60
Canadian,State House,Dan Fisher,REP,90116,21,102,436,559,60
Canadian,President,Barack Obama,DEM,90124,10,56,333,399,
Canadian,President,Mitt Romney,REP,90124,15,95,660,770,
Canadian,U.S. House,Timothy Ray Murray,DEM,90124,9,46,236,291,03
Canadian,U.S. House,Frank Lucas,REP,90124,15,98,696,809,03
Canadian,U.S. House,William Sanders,IND,90124,2,5,56,63,03
Canadian,State House,Kendra Menz-Kimble,DEM,90124,12,70,454,536,60
Canadian,State House,Dan Fisher,REP,90124,11,79,529,619,60
Canadian,President,Barack Obama,DEM,90200,37,60,496,593,
Canadian,President,Mitt Romney,REP,90200,139,121,1835,2095,
Canadian,U.S. House,Timothy Ray Murray,DEM,90200,27,48,390,465,03
Canadian,U.S. House,Frank Lucas,REP,90200,140,124,1806,2070,03
Canadian,U.S. House,William Sanders,IND,90200,9,8,108,125,03
Canadian,President,Barack Obama,DEM,90201,15,9,147,171,
Canadian,President,Mitt Romney,REP,90201,49,49,751,849,
Canadian,U.S. House,Timothy Ray Murray,DEM,90201,12,7,101,120,03
Canadian,U.S. House,Frank Lucas,REP,90201,46,49,759,854,03
Canadian,U.S. House,William Sanders,IND,90201,6,3,40,49,03
Canadian,State House,Kendra Menz-Kimble,DEM,90201,15,13,192,220,60
Canadian,State House,Dan Fisher,REP,90201,45,46,698,789,60
Canadian,President,Barack Obama,DEM,90202,0,2,43,45,
Canadian,President,Mitt Romney,REP,90202,18,24,330,372,
Canadian,U.S. House,Timothy Ray Murray,DEM,90202,0,0,30,30,03
Canadian,U.S. House,Frank Lucas,REP,90202,18,25,329,372,03
Canadian,U.S. House,William Sanders,IND,90202,0,1,14,15,03
Canadian,President,Barack Obama,DEM,90204,13,21,240,274,
Canadian,President,Mitt Romney,REP,90204,38,58,803,899,
Canadian,U.S. House,Timothy Ray Murray,DEM,90204,12,18,170,200,03
Canadian,U.S. House,Frank Lucas,REP,90204,32,59,802,893,03
Canadian,U.S. House,William Sanders,IND,90204,5,2,59,66,03
Canadian,State House,Kendra Menz-Kimble,DEM,90204,16,19,226,261,60
Canadian,State House,Dan Fisher,REP,90204,32,60,796,888,60
Canadian,President,Barack Obama,DEM,90206,16,17,297,330,
Canadian,President,Mitt Romney,REP,90206,64,65,984,1113,
Canadian,U.S. House,Timothy Ray Murray,DEM,90206,13,13,226,252,03
Canadian,U.S. House,Frank Lucas,REP,90206,62,67,966,1095,03
Canadian,U.S. House,William Sanders,IND,90206,6,2,74,82,03
Canadian,State House,Kendra Menz-Kimble,DEM,90206,22,22,312,356,60
Canadian,State House,Dan Fisher,REP,90206,59,60,942,1061,60
Canadian,President,Barack Obama,DEM,90208,14,10,300,324,
Canadian,President,Mitt Romney,REP,90208,48,37,797,882,
Canadian,U.S. House,Timothy Ray Murray,DEM,90208,12,7,227,246,03
Canadian,U.S. House,Frank Lucas,REP,90208,47,36,792,875,03
Canadian,U.S. House,William Sanders,IND,90208,2,4,71,77,03
Canadian,President,Barack Obama,DEM,90209,1,0,20,21,
Canadian,President,Mitt Romney,REP,90209,0,0,27,27,
Canadian,U.S. House,Timothy Ray Murray,DEM,90209,1,0,16,17,03
Canadian,U.S. House,Frank Lucas,REP,90209,0,0,30,30,03
Canadian,U.S. House,William Sanders,IND,90209,0,0,2,2,03
Canadian,State House,Kendra Menz-Kimble,DEM,90209,1,0,18,19,60
Canadian,State House,Dan Fisher,REP,90209,0,0,30,30,60
Canadian,President,Barack Obama,DEM,90210,4,14,70,88,
Canadian,President,Mitt Romney,REP,90210,24,35,373,432,
Canadian,U.S. House,Timothy Ray Murray,DEM,90210,2,9,56,67,03
Canadian,U.S. House,Frank Lucas,REP,90210,25,39,372,436,03
Canadian,U.S. House,William Sanders,IND,90210,0,1,14,15,03
Canadian,President,Barack Obama,DEM,90211,3,8,95,106,
Canadian,President,Mitt Romney,REP,90211,20,12,297,329,
Canadian,U.S. House,Timothy Ray Murray,DEM,90211,2,7,76,85,03
Canadian,U.S. House,Frank Lucas,REP,90211,20,10,301,331,03
Canadian,U.S. House,William Sanders,IND,90211,0,2,16,18,03
Canadian,State House,Kendra Menz-Kimble,DEM,90211,3,8,96,107,60
Canadian,State House,Dan Fisher,REP,90211,19,10,294,323,60
Canadian,President,Barack Obama,DEM,90214,7,24,247,278,
Canadian,President,Mitt Romney,REP,90214,46,54,852,952,
Canadian,U.S. House,Timothy Ray Murray,DEM,90214,5,18,186,209,03
Canadian,U.S. House,Frank Lucas,REP,90214,46,54,835,935,03
Canadian,U.S. House,William Sanders,IND,90214,0,6,71,77,03
Canadian,President,Barack Obama,DEM,90215,16,55,312,383,
Canadian,President,Mitt Romney,REP,90215,82,135,931,1148,
Canadian,U.S. House,Timothy Ray Murray,DEM,90215,10,50,234,294,03
Canadian,U.S. House,Frank Lucas,REP,90215,77,134,932,1143,03
Canadian,U.S. House,William Sanders,IND,90215,6,5,70,81,03
Canadian,President,Barack Obama,DEM,90216,21,26,317,364,
Canadian,President,Mitt Romney,REP,90216,95,110,1224,1429,
Canadian,U.S. House,Timothy Ray Murray,DEM,90216,12,18,232,262,03
Canadian,U.S. House,Frank Lucas,REP,90216,90,117,1223,1430,03
Canadian,U.S. House,William Sanders,IND,90216,9,1,64,74,03
Canadian,President,Barack Obama,DEM,90217,17,24,287,328,
Canadian,President,Mitt Romney,REP,90217,93,81,1109,1283,
Canadian,U.S. House,Timothy Ray Murray,DEM,90217,14,20,231,265,03
Canadian,U.S. House,Frank Lucas,REP,90217,89,79,1086,1254,03
Canadian,U.S. House,William Sanders,IND,90217,5,3,65,73,03
Canadian,President,Barack Obama,DEM,90218,9,20,241,270,
Canadian,President,Mitt Romney,REP,90218,45,46,832,923,
Canadian,U.S. House,Timothy Ray Murray,DEM,90218,10,18,196,224,03
Canadian,U.S. House,Frank Lucas,REP,90218,41,47,812,900,03
Canadian,U.S. House,William Sanders,IND,90218,2,0,61,63,03
Canadian,President,Barack Obama,DEM,90220,18,30,369,417,
Canadian,President,Mitt Romney,REP,90220,76,89,1222,1387,
Canadian,U.S. House,Timothy Ray Murray,DEM,90220,16,23,268,307,03
Canadian,U.S. House,Frank Lucas,REP,90220,69,92,1230,1391,03
Canadian,U.S. House,William Sanders,IND,90220,6,5,85,96,03
Canadian,President,Barack Obama,DEM,90221,13,30,272,315,
Canadian,President,Mitt Romney,REP,90221,40,51,735,826,
Canadian,U.S. House,Timothy Ray Murray,DEM,90221,10,29,216,255,03
Canadian,U.S. House,Frank Lucas,REP,90221,39,50,728,817,03
Canadian,U.S. House,William Sanders,IND,90221,1,3,55,59,03
Canadian,President,Barack Obama,DEM,90223,29,45,323,397,
Canadian,President,Mitt Romney,REP,90223,76,105,929,1110,
Canadian,U.S. House,Timothy Ray Murray,DEM,90223,22,35,267,324,03
Canadian,U.S. House,Frank Lucas,REP,90223,73,106,901,1080,03
Canadian,U.S. House,William Sanders,IND,90223,4,7,79,90,03
Canadian,President,Barack Obama,DEM,90224,2,11,133,146,
Canadian,President,Mitt Romney,REP,90224,14,25,446,485,
Canadian,U.S. House,Timothy Ray Murray,DEM,90224,2,11,98,111,03
Canadian,U.S. House,Frank Lucas,REP,90224,12,25,443,480,03
Canadian,U.S. House,William Sanders,IND,90224,2,1,31,34,03
Canadian,President,Barack Obama,DEM,90225,21,41,261,323,
Canadian,President,Mitt Romney,REP,90225,63,92,771,926,
Canadian,U.S. House,Timothy Ray Murray,DEM,90225,19,34,197,250,03
Canadian,U.S. House,Frank Lucas,REP,90225,61,94,774,929,03
Canadian,U.S. House,William Sanders,IND,90225,3,4,56,63,03
Canadian,State House,Leon Pivinski,DEM,90225,21,39,239,299,47
Canadian,State House,Leslie Kathryn Osborn,REP,90225,58,88,777,923,47
Canadian,President,Barack Obama,DEM,90226,6,1,43,50,
Canadian,President,Mitt Romney,REP,90226,11,14,195,220,
Canadian,U.S. House,Timothy Ray Murray,DEM,90226,5,0,27,32,03
Canadian,U.S. House,Frank Lucas,REP,90226,10,14,205,229,03
Canadian,U.S. House,William Sanders,IND,90226,1,1,6,8,03
Canadian,State House,Kendra Menz-Kimble,DEM,90226,8,3,49,60,60
Canadian,State House,Dan Fisher,REP,90226,9,12,190,211,60
Canadian,President,Barack Obama,DEM,90227,27,55,365,447,
Canadian,President,Mitt Romney,REP,90227,135,137,1162,1434,
Canadian,U.S. House,Timothy Ray Murray,DEM,90227,21,48,269,338,03
Canadian,U.S. House,Frank Lucas,REP,90227,132,139,1146,1417,03
Canadian,U.S. House,William Sanders,IND,90227,7,3,90,100,03
Canadian,State House,Leon Pivinski,DEM,90227,30,55,338,423,47
Canadian,State House,Leslie Kathryn Osborn,REP,90227,128,136,1149,1413,47
Canadian,President,Barack Obama,DEM,90228,5,7,112,124,
Canadian,President,Mitt Romney,REP,90228,16,17,283,316,
Canadian,U.S. House,Timothy Ray Murray,DEM,90228,3,6,84,93,03
Canadian,U.S. House,Frank Lucas,REP,90228,15,17,273,305,03
Canadian,U.S. House,William Sanders,IND,90228,2,1,30,33,03
Canadian,President,Barack Obama,DEM,90300,5,17,211,233,
Canadian,President,Mitt Romney,REP,90300,78,77,826,981,
Canadian,U.S. House,Donna Marie Bebo,DEM,90300,5,19,162,186,04
Canadian,U.S. House,Tom Cole,REP,90300,73,70,823,966,04
Canadian,U.S. House,Rj Harris,IND,90300,5,5,49,59,04
Canadian,State House,Leon Pivinski,DEM,90300,7,20,215,242,47
Canadian,State House,Leslie Kathryn Osborn,REP,90300,74,73,795,942,47
Canadian,President,Barack Obama,DEM,90301,16,22,318,356,
Canadian,President,Mitt Romney,REP,90301,80,78,1257,1415,
Canadian,U.S. House,Donna Marie Bebo,DEM,90301,12,14,241,267,04
Canadian,U.S. House,Tom Cole,REP,90301,79,79,1234,1392,04
Canadian,U.S. House,Rj Harris,IND,90301,4,4,81,89,04
Canadian,State House,Leon Pivinski,DEM,90301,14,10,294,318,47
Canadian,State House,Leslie Kathryn Osborn,REP,90301,78,84,1241,1403,47
Canadian,President,Barack Obama,DEM,90302,16,15,268,299,
Canadian,President,Mitt Romney,REP,90302,54,67,962,1083,
Canadian,U.S. House,Donna Marie Bebo,DEM,90302,11,16,214,241,04
Canadian,U.S. House,Tom Cole,REP,90302,54,63,914,1031,04
Canadian,U.S. House,Rj Harris,IND,90302,6,3,100,109,04
Canadian,State House,Leon Pivinski,DEM,90302,13,17,277,307,47
Canadian,State House,Leslie Kathryn Osborn,REP,90302,57,65,931,1053,47
Canadian,President,Barack Obama,DEM,90303,19,33,279,331,
Canadian,President,Mitt Romney,REP,90303,80,128,1007,1215,
Canadian,U.S. House,Timothy Ray Murray,DEM,90303,13,30,226,269,03
Canadian,U.S. House,Frank Lucas,REP,90303,79,125,1004,1208,03
Canadian,U.S. House,William Sanders,IND,90303,5,5,48,58,03
Canadian,State House,Leon Pivinski,DEM,90303,15,33,260,308,47
Canadian,State House,Leslie Kathryn Osborn,REP,90303,78,127,1002,1207,47
Canadian,President,Barack Obama,DEM,90304,14,19,226,259,
Canadian,President,Mitt Romney,REP,90304,41,49,916,1006,
Canadian,U.S. House,Donna Marie Bebo,DEM,90304,13,13,166,192,04
Canadian,U.S. House,Tom Cole,REP,90304,35,53,914,1002,04
Canadian,U.S. House,Rj Harris,IND,90304,7,2,56,65,04
Canadian,State House,Leon Pivinski,DEM,90304,17,11,199,227,47
Canadian,State House,Leslie Kathryn Osborn,REP,90304,38,55,929,1022,47
Canadian,President,Barack Obama,DEM,90306,30,23,351,404,
Canadian,President,Mitt Romney,REP,90306,139,130,1293,1562,
Canadian,U.S. House,Donna Marie Bebo,DEM,90306,27,19,253,299,04
Canadian,U.S. House,Tom Cole,REP,90306,133,130,1300,1563,04
Canadian,U.S. House,Rj Harris,IND,90306,6,4,82,92,04
Canadian,State House,Leon Pivinski,DEM,90306,30,23,311,364,47
Canadian,State House,Leslie Kathryn Osborn,REP,90306,131,129,1301,1561,47
Canadian,President,Barack Obama,DEM,90308,1,8,50,59,
Canadian,President,Mitt Romney,REP,90308,22,28,343,393,
Canadian,U.S. House,Timothy Ray Murray,DEM,90308,0,5,31,36,03
Canadian,U.S. House,Frank Lucas,REP,90308,22,29,335,386,03
Canadian,U.S. House,William Sanders,IND,90308,0,2,22,24,03
Canadian,State House,Leon Pivinski,DEM,90308,0,7,57,64,47
Canadian,State House,Leslie Kathryn Osborn,REP,90308,22,29,327,378,47
Canadian,President,Barack Obama,DEM,90309,0,0,13,13,
Canadian,President,Mitt Romney,REP,90309,7,7,92,106,
Canadian,U.S. House,Donna Marie Bebo,DEM,90309,0,1,9,10,04
Canadian,U.S. House,Tom Cole,REP,90309,7,6,90,103,04
Canadian,U.S. House,Rj Harris,IND,90309,0,0,4,4,04
Canadian,State House,Leon Pivinski,DEM,90309,0,0,12,12,47
Canadian,State House,Leslie Kathryn Osborn,REP,90309,7,7,86,100,47
Canadian,President,Barack Obama,DEM,90398,0,0,0,0,
Canadian,President,Mitt Romney,REP,90398,0,0,0,0,
Canadian,U.S. House,Donna Marie Bebo,DEM,90398,0,0,0,0,04
Canadian,U.S. House,Tom Cole,REP,90398,0,0,0,0,04
Canadian,U.S. House,Rj Harris,IND,90398,0,0,0,0,04
Canadian,State House,Leon Pivinski,DEM,90398,0,0,0,0,47
Canadian,State House,Leslie Kathryn Osborn,REP,90398,0,0,0,0,47
Canadian,President,Barack Obama,DEM,90399,0,0,0,0,
Canadian,President,Mitt Romney,REP,90399,0,0,0,0,
Canadian,U.S. House,Donna Marie Bebo,DEM,90399,0,0,0,0,04
Canadian,U.S. House,Tom Cole,REP,90399,0,0,0,0,04
Canadian,U.S. House,Rj Harris,IND,90399,0,0,0,0,04
Canadian,State House,Leon Pivinski,DEM,90399,0,0,0,0,47
Canadian,State House,Leslie Kathryn Osborn,REP,90399,0,0,0,0,47
Canadian,President,Barack Obama,DEM,90400,2,5,121,128,
Canadian,President,Mitt Romney,REP,90400,18,40,457,515,
Canadian,U.S. House,Timothy Ray Murray,DEM,90400,1,5,87,93,03
Canadian,U.S. House,Frank Lucas,REP,90400,18,38,452,508,03
Canadian,U.S. House,William Sanders,IND,90400,1,2,32,35,03
Canadian,State House,Kendra Menz-Kimble,DEM,90400,3,10,214,227,60
Canadian,State House,Dan Fisher,REP,90400,17,33,358,408,60
Canadian,President,Barack Obama,DEM,90403,2,0,56,58,
Canadian,President,Mitt Romney,REP,90403,10,6,238,254,
Canadian,U.S. House,Timothy Ray Murray,DEM,90403,0,0,35,35,03
Canadian,U.S. House,Frank Lucas,REP,90403,12,6,253,271,03
Canadian,U.S. House,William Sanders,IND,90403,0,0,5,5,03
Canadian,State House,Kendra Menz-Kimble,DEM,90403,4,0,104,108,60
Canadian,State House,Dan Fisher,REP,90403,8,6,187,201,60
Canadian,President,Barack Obama,DEM,90404,1,3,36,40,
Canadian,President,Mitt Romney,REP,90404,13,14,147,174,
Canadian,U.S. House,Timothy Ray Murray,DEM,90404,2,3,28,33,03
Canadian,U.S. House,Frank Lucas,REP,90404,11,14,147,172,03
Canadian,U.S. House,William Sanders,IND,90404,0,0,6,6,03
Canadian,State House,Kendra Menz-Kimble,DEM,90404,3,7,91,101,60
Canadian,State House,Dan Fisher,REP,90404,10,10,87,107,60
Canadian,President,Barack Obama,DEM,90406,1,0,45,46,
Canadian,President,Mitt Romney,REP,90406,1,5,110,116,
Canadian,U.S. House,Timothy Ray Murray,DEM,90406,1,0,30,31,03
Canadian,U.S. House,Frank Lucas,REP,90406,1,5,112,118,03
Canadian,U.S. House,William Sanders,IND,90406,0,0,11,11,03
Canadian,President,Barack Obama,DEM,90408,3,2,80,85,
Canadian,President,Mitt Romney,REP,90408,10,10,206,226,
Canadian,U.S. House,Timothy Ray Murray,DEM,90408,3,1,49,53,03
Canadian,U.S. House,Frank Lucas,REP,90408,10,11,219,240,03
Canadian,U.S. House,William Sanders,IND,90408,0,0,17,17,03
Canadian,President,Barack Obama,DEM,90409,0,1,3,4,
Canadian,President,Mitt Romney,REP,90409,0,2,38,40,
Canadian,U.S. House,Timothy Ray Murray,DEM,90409,0,1,2,3,03
Canadian,U.S. House,Frank Lucas,REP,90409,0,2,38,40,03
Canadian,U.S. House,William Sanders,IND,90409,0,0,0,0,03
Canadian,President,Barack Obama,DEM,90502,0,1,28,29,
Canadian,President,Mitt Romney,REP,90502,6,12,178,196,
Canadian,U.S. House,Timothy Ray Murray,DEM,90502,0,0,17,17,03
Canadian,U.S. House,Frank Lucas,REP,90502,6,13,181,200,03
Canadian,U.S. House,William Sanders,IND,90502,0,0,9,9,03
Canadian,President,Barack Obama,DEM,90503,0,2,36,38,
Canadian,President,Mitt Romney,REP,90503,20,10,243,273,
Canadian,U.S. House,Timothy Ray Murray,DEM,90503,0,2,18,20,03
Canadian,U.S. House,Frank Lucas,REP,90503,20,10,244,274,03
Canadian,U.S. House,William Sanders,IND,90503,0,0,14,14,03
Canadian,President,Barack Obama,DEM,90504,13,18,299,330,
Canadian,President,Mitt Romney,REP,90504,69,48,1424,1541,
Canadian,U.S. House,Timothy Ray Murray,DEM,90504,11,13,222,246,03
Canadian,U.S. House,Frank Lucas,REP,90504,66,53,1420,1539,03
Canadian,U.S. House,William Sanders,IND,90504,2,0,62,64,03
Canadian,President,Barack Obama,DEM,90506,4,12,265,281,
Canadian,President,Mitt Romney,REP,90506,77,67,1464,1608,
Canadian,U.S. House,Timothy Ray Murray,DEM,90506,4,11,204,219,03
Canadian,U.S. House,Frank Lucas,REP,90506,75,68,1440,1583,03
Canadian,U.S. House,William Sanders,IND,90506,1,2,69,72,03
Carter,President,Barack Obama,DEM,100001,11,41,278,330,
Carter,President,Mitt Romney,REP,100001,23,67,361,451,
Carter,U.S. House,Donna Marie Bebo,DEM,100001,10,40,234,284,04
Carter,U.S. House,Tom Cole,REP,100001,22,61,368,451,04
Carter,U.S. House,Rj Harris,IND,100001,2,5,34,41,04
Carter,State House,Brian Spencer,DEM,100001,11,37,233,281,48
Carter,State House,Patrick Ownbey,REP,100001,24,68,405,497,48
Carter,President,Barack Obama,DEM,100002,16,55,234,305,
Carter,President,Mitt Romney,REP,100002,41,56,527,624,
Carter,U.S. House,Donna Marie Bebo,DEM,100002,15,47,202,264,04
Carter,U.S. House,Tom Cole,REP,100002,41,60,522,623,04
Carter,U.S. House,Rj Harris,IND,100002,1,3,27,31,04
Carter,State House,Brian Spencer,DEM,100002,15,47,202,264,48
Carter,State House,Patrick Ownbey,REP,100002,41,63,550,654,48
Carter,President,Barack Obama,DEM,100007,11,89,432,532,
Carter,President,Mitt Romney,REP,100007,1,12,63,76,
Carter,U.S. House,Donna Marie Bebo,DEM,100007,11,79,410,500,04
Carter,U.S. House,Tom Cole,REP,100007,1,20,76,97,04
Carter,U.S. House,Rj Harris,IND,100007,0,2,6,8,04
Carter,State House,Brian Spencer,DEM,100007,11,79,403,493,48
Carter,State House,Patrick Ownbey,REP,100007,1,22,88,111,48
Carter,President,Barack Obama,DEM,100011,9,33,131,173,
Carter,President,Mitt Romney,REP,100011,9,46,242,297,
Carter,U.S. House,Donna Marie Bebo,DEM,100011,9,29,109,147,04
Carter,U.S. House,Tom Cole,REP,100011,9,43,249,301,04
Carter,U.S. House,Rj Harris,IND,100011,0,5,13,18,04
Carter,State House,Brian Spencer,DEM,100011,7,26,104,137,48
Carter,State House,Patrick Ownbey,REP,100011,10,51,267,328,48
Carter,President,Barack Obama,DEM,100014,2,16,160,178,
Carter,President,Mitt Romney,REP,100014,12,45,286,343,
Carter,U.S. House,Donna Marie Bebo,DEM,100014,2,14,138,154,04
Carter,U.S. House,Tom Cole,REP,100014,12,46,284,342,04
Carter,U.S. House,Rj Harris,IND,100014,0,1,23,24,04
Carter,State House,Brian Spencer,DEM,100014,2,14,133,149,48
Carter,State House,Patrick Ownbey,REP,100014,12,47,307,366,48
Carter,President,Barack Obama,DEM,100015,28,42,243,313,
Carter,President,Mitt Romney,REP,100015,29,92,536,657,
Carter,U.S. House,Donna Marie Bebo,DEM,100015,23,35,222,280,04
Carter,U.S. House,Tom Cole,REP,100015,32,89,521,642,04
Carter,U.S. House,Rj Harris,IND,100015,0,9,34,43,04
Carter,State House,Brian Spencer,DEM,100015,22,37,219,278,48
Carter,State House,Patrick Ownbey,REP,100015,33,96,555,684,48
Carter,President,Barack Obama,DEM,100017,10,30,170,210,
Carter,President,Mitt Romney,REP,100017,22,63,428,513,
Carter,U.S. House,Donna Marie Bebo,DEM,100017,11,21,153,185,04
Carter,U.S. House,Tom Cole,REP,100017,20,71,419,510,04
Carter,U.S. House,Rj Harris,IND,100017,0,1,23,24,04
Carter,State House,Brian Spencer,DEM,100017,10,17,155,182,48
Carter,State House,Patrick Ownbey,REP,100017,21,73,439,533,48
Carter,President,Barack Obama,DEM,100019,35,75,279,389,
Carter,President,Mitt Romney,REP,100019,90,272,1134,1496,
Carter,U.S. House,Donna Marie Bebo,DEM,100019,29,61,241,331,04
Carter,U.S. House,Tom Cole,REP,100019,93,271,1116,1480,04
Carter,U.S. House,Rj Harris,IND,100019,1,13,45,59,04
Carter,State House,Brian Spencer,DEM,100019,27,54,223,304,48
Carter,State House,Patrick Ownbey,REP,100019,96,287,1179,1562,48
Carter,President,Barack Obama,DEM,100020,8,33,263,304,
Carter,President,Mitt Romney,REP,100020,18,52,459,529,
Carter,U.S. House,Donna Marie Bebo,DEM,100020,5,29,226,260,04
Carter,U.S. House,Tom Cole,REP,100020,20,51,465,536,04
Carter,U.S. House,Rj Harris,IND,100020,0,4,33,37,04
Carter,State House,Brian Spencer,DEM,100020,3,29,209,241,48
Carter,State House,Patrick Ownbey,REP,100020,23,56,515,594,48
Carter,President,Barack Obama,DEM,100024,12,36,226,274,
Carter,President,Mitt Romney,REP,100024,35,109,716,860,
Carter,U.S. House,Donna Marie Bebo,DEM,100024,10,35,204,249,04
Carter,U.S. House,Tom Cole,REP,100024,35,105,702,842,04
Carter,U.S. House,Rj Harris,IND,100024,1,4,29,34,04
Carter,State House,Brian Spencer,DEM,100024,13,33,177,223,48
Carter,State House,Patrick Ownbey,REP,100024,32,113,752,897,48
Carter,President,Barack Obama,DEM,100025,1,13,50,64,
Carter,President,Mitt Romney,REP,100025,8,19,219,246,
Carter,U.S. House,Donna Marie Bebo,DEM,100025,1,11,38,50,04
Carter,U.S. House,Tom Cole,REP,100025,8,21,217,246,04
Carter,U.S. House,Rj Harris,IND,100025,0,0,13,13,04
Carter,President,Barack Obama,DEM,100026,4,3,77,84,
Carter,President,Mitt Romney,REP,100026,12,8,156,176,
Carter,U.S. House,Donna Marie Bebo,DEM,100026,5,3,70,78,04
Carter,U.S. House,Tom Cole,REP,100026,10,8,146,164,04
Carter,U.S. House,Rj Harris,IND,100026,1,0,13,14,04
Carter,State House,Brian Spencer,DEM,100026,4,3,77,84,48
Carter,State House,Patrick Ownbey,REP,100026,11,8,151,170,48
Carter,President,Barack Obama,DEM,100030,0,0,52,52,
Carter,President,Mitt Romney,REP,100030,7,7,203,217,
Carter,U.S. House,Donna Marie Bebo,DEM,100030,1,1,46,48,04
Carter,U.S. House,Tom Cole,REP,100030,6,5,203,214,04
Carter,U.S. House,Rj Harris,IND,100030,0,0,7,7,04
Carter,President,Barack Obama,DEM,100031,10,25,217,252,
Carter,President,Mitt Romney,REP,100031,31,103,947,1081,
Carter,U.S. House,Donna Marie Bebo,DEM,100031,8,27,195,230,04
Carter,U.S. House,Tom Cole,REP,100031,28,93,923,1044,04
Carter,U.S. House,Rj Harris,IND,100031,4,5,40,49,04
Carter,President,Barack Obama,DEM,100032,0,5,90,95,
Carter,President,Mitt Romney,REP,100032,8,26,139,173,
Carter,U.S. House,Donna Marie Bebo,DEM,100032,0,7,90,97,04
Carter,U.S. House,Tom Cole,REP,100032,8,24,132,164,04
Carter,U.S. House,Rj Harris,IND,100032,0,0,8,8,04
Carter,State House,Brian Spencer,DEM,100032,0,7,91,98,48
Carter,State House,Patrick Ownbey,REP,100032,8,24,139,171,48
Carter,President,Barack Obama,DEM,100033,0,7,106,113,
Carter,President,Mitt Romney,REP,100033,6,14,309,329,
Carter,U.S. House,Donna Marie Bebo,DEM,100033,0,6,88,94,04
Carter,U.S. House,Tom Cole,REP,100033,6,15,307,328,04
Carter,U.S. House,Rj Harris,IND,100033,0,0,17,17,04
Carter,State House,Brian Spencer,DEM,100033,0,6,100,106,48
Carter,State House,Patrick Ownbey,REP,100033,6,15,308,329,48
Carter,President,Barack Obama,DEM,100034,5,12,166,183,
Carter,President,Mitt Romney,REP,100034,8,38,490,536,
Carter,U.S. House,Donna Marie Bebo,DEM,100034,3,10,150,163,04
Carter,U.S. House,Tom Cole,REP,100034,9,37,478,524,04
Carter,U.S. House,Rj Harris,IND,100034,0,1,23,24,04
Carter,President,Barack Obama,DEM,100039,3,1,54,58,
Carter,President,Mitt Romney,REP,100039,7,18,232,257,
Carter,U.S. House,Donna Marie Bebo,DEM,100039,3,2,45,50,04
Carter,U.S. House,Tom Cole,REP,100039,4,17,220,241,04
Carter,U.S. House,Rj Harris,IND,100039,1,0,25,26,04
Carter,State House,Brian Spencer,DEM,100039,3,1,56,60,48
Carter,State House,Patrick Ownbey,REP,100039,3,18,231,252,48
Carter,President,Barack Obama,DEM,100041,2,6,141,149,
Carter,President,Mitt Romney,REP,100041,10,17,630,657,
Carter,U.S. House,Donna Marie Bebo,DEM,100041,2,4,128,134,04
Carter,U.S. House,Tom Cole,REP,100041,10,19,628,657,04
Carter,U.S. House,Rj Harris,IND,100041,0,0,16,16,04
Carter,State House,Brian Spencer,DEM,100041,2,4,127,133,48
Carter,State House,Patrick Ownbey,REP,100041,10,19,639,668,48
Carter,President,Barack Obama,DEM,100051,3,5,133,141,
Carter,President,Mitt Romney,REP,100051,3,7,160,170,
Carter,U.S. House,Donna Marie Bebo,DEM,100051,3,5,118,126,04
Carter,U.S. House,Tom Cole,REP,100051,3,7,162,172,04
Carter,U.S. House,Rj Harris,IND,100051,0,0,10,10,04
Carter,State House,Brian Spencer,DEM,100051,3,4,128,135,48
Carter,State House,Patrick Ownbey,REP,100051,3,8,161,172,48
Carter,President,Barack Obama,DEM,100052,2,0,79,81,
Carter,President,Mitt Romney,REP,100052,5,9,355,369,
Carter,U.S. House,Donna Marie Bebo,DEM,100052,1,0,72,73,04
Carter,U.S. House,Tom Cole,REP,100052,5,9,341,355,04
Carter,U.S. House,Rj Harris,IND,100052,0,0,19,19,04
Carter,State House,Brian Spencer,DEM,100052,1,0,82,83,48
Carter,State House,Patrick Ownbey,REP,100052,5,9,347,361,48
Carter,President,Barack Obama,DEM,100061,1,6,67,74,
Carter,President,Mitt Romney,REP,100061,15,36,276,327,
Carter,U.S. House,Donna Marie Bebo,DEM,100061,0,6,71,77,04
Carter,U.S. House,Tom Cole,REP,100061,15,36,262,313,04
Carter,U.S. House,Rj Harris,IND,100061,1,0,9,10,04
Carter,President,Barack Obama,DEM,100062,7,14,171,192,
Carter,President,Mitt Romney,REP,100062,19,28,508,555,
Carter,U.S. House,Donna Marie Bebo,DEM,100062,6,11,159,176,04
Carter,U.S. House,Tom Cole,REP,100062,18,31,495,544,04
Carter,U.S. House,Rj Harris,IND,100062,1,1,27,29,04
Carter,President,Barack Obama,DEM,100063,0,11,193,204,
Carter,President,Mitt Romney,REP,100063,20,52,614,686,
Carter,U.S. House,Donna Marie Bebo,DEM,100063,0,10,164,174,04
Carter,U.S. House,Tom Cole,REP,100063,19,50,611,680,04
Carter,U.S. House,Rj Harris,IND,100063,2,2,33,37,04
Carter,President,Barack Obama,DEM,100071,13,1,144,158,
Carter,President,Mitt Romney,REP,100071,22,13,554,589,
Carter,U.S. House,Donna Marie Bebo,DEM,100071,10,1,120,131,04
Carter,U.S. House,Tom Cole,REP,100071,23,13,547,583,04
Carter,U.S. House,Rj Harris,IND,100071,1,0,29,30,04
Carter,State House,Brian Spencer,DEM,100071,10,0,133,143,48
Carter,State House,Patrick Ownbey,REP,100071,24,14,560,598,48
Cherokee,President,Barack Obama,DEM,110001,22,99,377,498,
Cherokee,President,Mitt Romney,REP,110001,27,81,362,470,
Cherokee,U.S. House,Rob Wallace,DEM,110001,19,86,339,444,02
Cherokee,U.S. House,Markwayne Mullin,REP,110001,21,85,337,443,02
Cherokee,U.S. House,Michael Fulks,IND,110001,4,12,66,82,02
Cherokee,State Senate,Earl Garrison,DEM,110001,20,109,463,592,9
Cherokee,State Senate,Barney Taylor,REP,110001,13,69,268,350,9
Cherokee,President,Barack Obama,DEM,110002,18,175,424,617,
Cherokee,President,Mitt Romney,REP,110002,41,246,589,876,
Cherokee,U.S. House,Rob Wallace,DEM,110002,17,172,406,595,02
Cherokee,U.S. House,Markwayne Mullin,REP,110002,37,230,568,835,02
Cherokee,U.S. House,Michael Fulks,IND,110002,5,19,45,69,02
Cherokee,State Senate,Earl Garrison,DEM,110002,19,237,573,829,9
Cherokee,State Senate,Barney Taylor,REP,110002,37,176,424,637,9
Cherokee,President,Barack Obama,DEM,110003,19,200,317,536,
Cherokee,President,Mitt Romney,REP,110003,31,178,521,730,
Cherokee,U.S. House,Rob Wallace,DEM,110003,16,184,294,494,02
Cherokee,U.S. House,Markwayne Mullin,REP,110003,30,170,480,680,02
Cherokee,U.S. House,Michael Fulks,IND,110003,2,22,59,83,02
Cherokee,State Senate,Earl Garrison,DEM,110003,24,249,413,686,9
Cherokee,State Senate,Barney Taylor,REP,110003,23,121,411,555,9
Cherokee,President,Barack Obama,DEM,110004,21,140,451,612,
Cherokee,President,Mitt Romney,REP,110004,22,175,443,640,
Cherokee,U.S. House,Rob Wallace,DEM,110004,19,149,430,598,02
Cherokee,U.S. House,Markwayne Mullin,REP,110004,19,153,395,567,02
Cherokee,U.S. House,Michael Fulks,IND,110004,4,9,61,74,02
Cherokee,State Senate,Earl Garrison,DEM,110004,25,176,556,757,9
Cherokee,State Senate,Barney Taylor,REP,110004,17,124,317,458,9
Cherokee,President,Barack Obama,DEM,110005,4,30,104,138,
Cherokee,President,Mitt Romney,REP,110005,3,26,93,122,
Cherokee,U.S. House,Rob Wallace,DEM,110005,6,30,99,135,02
Cherokee,U.S. House,Markwayne Mullin,REP,110005,1,25,84,110,02
Cherokee,U.S. House,Michael Fulks,IND,110005,0,1,13,14,02
Cherokee,State Senate,Earl Garrison,DEM,110005,6,37,122,165,9
Cherokee,State Senate,Barney Taylor,REP,110005,2,18,69,89,9
Cherokee,President,Barack Obama,DEM,110006,3,41,120,164,
Cherokee,President,Mitt Romney,REP,110006,9,57,204,270,
Cherokee,U.S. House,Rob Wallace,DEM,110006,3,39,124,166,02
Cherokee,U.S. House,Markwayne Mullin,REP,110006,8,53,180,241,02
Cherokee,U.S. House,Michael Fulks,IND,110006,1,6,15,22,02
Cherokee,State Senate,Jim Bynum,DEM,110006,4,57,202,263,3
Cherokee,State Senate,Wayne Shaw,REP,110006,7,40,117,164,3
Cherokee,President,Barack Obama,DEM,110007,2,8,27,37,
Cherokee,President,Mitt Romney,REP,110007,2,8,48,58,
Cherokee,U.S. House,Rob Wallace,DEM,110007,2,9,28,39,02
Cherokee,U.S. House,Markwayne Mullin,REP,110007,2,7,44,53,02
Cherokee,U.S. House,Michael Fulks,IND,110007,0,0,4,4,02
Cherokee,State Senate,Jim Bynum,DEM,110007,2,8,41,51,3
Cherokee,State Senate,Wayne Shaw,REP,110007,2,7,35,44,3
Cherokee,President,Barack Obama,DEM,110008,8,22,139,169,
Cherokee,President,Mitt Romney,REP,110008,5,43,114,162,
Cherokee,U.S. House,Rob Wallace,DEM,110008,9,26,129,164,02
Cherokee,U.S. House,Markwayne Mullin,REP,110008,3,37,108,148,02
Cherokee,U.S. House,Michael Fulks,IND,110008,3,3,19,25,02
Cherokee,State Senate,Jim Bynum,DEM,110008,8,40,165,213,3
Cherokee,State Senate,Wayne Shaw,REP,110008,7,25,89,121,3
Cherokee,State House,Will Fourkiller,DEM,110008,10,33,172,215,86
Cherokee,State House,Russell Don Turner,REP,110008,4,33,82,119,86
Cherokee,President,Barack Obama,DEM,110009,16,24,221,261,
Cherokee,President,Mitt Romney,REP,110009,31,41,401,473,
Cherokee,U.S. House,Rob Wallace,DEM,110009,12,20,219,251,02
Cherokee,U.S. House,Markwayne Mullin,REP,110009,29,38,365,432,02
Cherokee,U.S. House,Michael Fulks,IND,110009,5,6,35,46,02
Cherokee,State Senate,Jim Bynum,DEM,110009,14,32,304,350,3
Cherokee,State Senate,Wayne Shaw,REP,110009,31,31,306,368,3
Cherokee,President,Barack Obama,DEM,110010,5,76,367,448,
Cherokee,President,Mitt Romney,REP,110010,25,84,533,642,
Cherokee,U.S. House,Rob Wallace,DEM,110010,5,68,354,427,02
Cherokee,U.S. House,Markwayne Mullin,REP,110010,22,84,496,602,02
Cherokee,U.S. House,Michael Fulks,IND,110010,2,8,50,60,02
Cherokee,State Senate,Earl Garrison,DEM,110010,7,103,504,614,9
Cherokee,State Senate,Barney Taylor,REP,110010,22,53,383,458,9
Cherokee,President,Barack Obama,DEM,110011,4,20,105,129,
Cherokee,President,Mitt Romney,REP,110011,3,24,191,218,
Cherokee,U.S. House,Rob Wallace,DEM,110011,4,17,122,143,02
Cherokee,U.S. House,Markwayne Mullin,REP,110011,3,22,156,181,02
Cherokee,U.S. House,Michael Fulks,IND,110011,1,4,16,21,02
Cherokee,President,Barack Obama,DEM,110012,4,56,237,297,
Cherokee,President,Mitt Romney,REP,110012,15,111,344,470,
Cherokee,U.S. House,Rob Wallace,DEM,110012,4,67,230,301,02
Cherokee,U.S. House,Markwayne Mullin,REP,110012,14,91,325,430,02
Cherokee,U.S. House,Michael Fulks,IND,110012,1,14,27,42,02
Cherokee,State Senate,Jim Bynum,DEM,110012,6,104,365,475,3
Cherokee,State Senate,Wayne Shaw,REP,110012,13,65,215,293,3
Cherokee,State House,Will Fourkiller,DEM,110012,8,115,386,509,86
Cherokee,State House,Russell Don Turner,REP,110012,11,55,190,256,86
Cherokee,President,Barack Obama,DEM,110013,6,31,190,227,
Cherokee,President,Mitt Romney,REP,110013,9,39,199,247,
Cherokee,U.S. House,Rob Wallace,DEM,110013,6,32,189,227,02
Cherokee,U.S. House,Markwayne Mullin,REP,110013,7,35,176,218,02
Cherokee,U.S. House,Michael Fulks,IND,110013,0,4,23,27,02
Cherokee,State Senate,Jim Bynum,DEM,110013,6,44,270,320,3
Cherokee,State Senate,Wayne Shaw,REP,110013,9,27,117,153,3
Cherokee,President,Barack Obama,DEM,110014,4,23,274,301,
Cherokee,President,Mitt Romney,REP,110014,46,24,299,369,
Cherokee,U.S. House,Rob Wallace,DEM,110014,6,25,255,286,02
Cherokee,U.S. House,Markwayne Mullin,REP,110014,38,22,282,342,02
Cherokee,U.S. House,Michael Fulks,IND,110014,3,0,39,42,02
Cherokee,State House,Jerry Rains,DEM,110014,9,26,291,326,14
Cherokee,State House,Arthur Hulbert,REP,110014,38,20,282,340,14
Cherokee,President,Barack Obama,DEM,110015,11,11,266,288,
Cherokee,President,Mitt Romney,REP,110015,24,39,506,569,
Cherokee,U.S. House,Rob Wallace,DEM,110015,14,13,323,350,02
Cherokee,U.S. House,Markwayne Mullin,REP,110015,20,35,422,477,02
Cherokee,U.S. House,Michael Fulks,IND,110015,0,2,34,36,02
Cherokee,State House,Jerry Rains,DEM,110015,10,12,319,341,14
Cherokee,State House,Arthur Hulbert,REP,110015,25,38,456,519,14
Cherokee,President,Barack Obama,DEM,110016,1,10,117,128,
Cherokee,President,Mitt Romney,REP,110016,9,12,139,160,
Cherokee,U.S. House,Rob Wallace,DEM,110016,1,13,115,129,02
Cherokee,U.S. House,Markwayne Mullin,REP,110016,9,10,127,146,02
Cherokee,U.S. House,Michael Fulks,IND,110016,0,0,15,15,02
Cherokee,State Senate,Jim Bynum,DEM,110016,2,15,166,183,3
Cherokee,State Senate,Wayne Shaw,REP,110016,8,7,88,103,3
Cherokee,State House,Will Fourkiller,DEM,110016,5,15,173,193,86
Cherokee,State House,Russell Don Turner,REP,110016,5,7,85,97,86
Cherokee,President,Barack Obama,DEM,110017,3,14,108,125,
Cherokee,President,Mitt Romney,REP,110017,3,19,121,143,
Cherokee,U.S. House,Rob Wallace,DEM,110017,3,16,102,121,02
Cherokee,U.S. House,Markwayne Mullin,REP,110017,3,17,115,135,02
Cherokee,U.S. House,Michael Fulks,IND,110017,0,1,13,14,02
Cherokee,State Senate,Earl Garrison,DEM,110017,3,19,155,177,9
Cherokee,State Senate,Barney Taylor,REP,110017,3,14,75,92,9
Cherokee,President,Barack Obama,DEM,110018,3,8,73,84,
Cherokee,President,Mitt Romney,REP,110018,15,21,93,129,
Cherokee,U.S. House,Rob Wallace,DEM,110018,3,9,77,89,02
Cherokee,U.S. House,Markwayne Mullin,REP,110018,13,20,85,118,02
Cherokee,U.S. House,Michael Fulks,IND,110018,2,0,5,7,02
Cherokee,State Senate,Jim Bynum,DEM,110018,9,11,87,107,3
Cherokee,State Senate,Wayne Shaw,REP,110018,9,18,78,105,3
Cherokee,State House,Will Fourkiller,DEM,110018,10,10,105,125,86
Cherokee,State House,Russell Don Turner,REP,110018,8,19,61,88,86
Cherokee,President,Barack Obama,DEM,110019,3,44,189,236,
Cherokee,President,Mitt Romney,REP,110019,6,48,265,319,
Cherokee,U.S. House,Rob Wallace,DEM,110019,3,45,191,239,02
Cherokee,U.S. House,Markwayne Mullin,REP,110019,5,45,238,288,02
Cherokee,U.S. House,Michael Fulks,IND,110019,1,5,24,30,02
Cherokee,President,Barack Obama,DEM,110020,1,82,216,299,
Cherokee,President,Mitt Romney,REP,110020,13,82,289,384,
Cherokee,U.S. House,Rob Wallace,DEM,110020,1,75,214,290,02
Cherokee,U.S. House,Markwayne Mullin,REP,110020,11,83,267,361,02
Cherokee,U.S. House,Michael Fulks,IND,110020,1,6,23,30,02
Cherokee,State Senate,Earl Garrison,DEM,110020,4,104,288,396,9
Cherokee,State Senate,Barney Taylor,REP,110020,9,58,209,276,9
Cherokee,President,Barack Obama,DEM,110021,3,12,97,112,
Cherokee,President,Mitt Romney,REP,110021,9,17,163,189,
Cherokee,U.S. House,Rob Wallace,DEM,110021,3,5,94,102,02
Cherokee,U.S. House,Markwayne Mullin,REP,110021,9,22,149,180,02
Cherokee,U.S. House,Michael Fulks,IND,110021,0,2,19,21,02
Cherokee,State Senate,Jim Bynum,DEM,110021,3,14,146,163,3
Cherokee,State Senate,Wayne Shaw,REP,110021,9,15,116,140,3
Cherokee,President,Barack Obama,DEM,110022,4,6,77,87,
Cherokee,President,Mitt Romney,REP,110022,1,13,125,139,
Cherokee,U.S. House,Rob Wallace,DEM,110022,4,5,84,93,02
Cherokee,U.S. House,Markwayne Mullin,REP,110022,1,14,110,125,02
Cherokee,U.S. House,Michael Fulks,IND,110022,0,0,10,10,02
Cherokee,State Senate,Jim Bynum,DEM,110022,4,10,122,136,3
Cherokee,State Senate,Wayne Shaw,REP,110022,1,9,81,91,3
Cherokee,President,Barack Obama,DEM,110023,1,25,48,74,
Cherokee,President,Mitt Romney,REP,110023,7,26,92,125,
Cherokee,U.S. House,Rob Wallace,DEM,110023,2,23,57,82,02
Cherokee,U.S. House,Markwayne Mullin,REP,110023,6,27,84,117,02
Cherokee,U.S. House,Michael Fulks,IND,110023,0,4,2,6,02
Cherokee,State Senate,Jim Bynum,DEM,110023,5,35,83,123,3
Cherokee,State Senate,Wayne Shaw,REP,110023,3,18,59,80,3
Cherokee,President,Barack Obama,DEM,110025,8,73,196,277,
Cherokee,President,Mitt Romney,REP,110025,11,66,181,258,
Cherokee,U.S. House,Rob Wallace,DEM,110025,5,68,190,263,02
Cherokee,U.S. House,Markwayne Mullin,REP,110025,14,67,168,249,02
Cherokee,U.S. House,Michael Fulks,IND,110025,0,3,16,19,02
Choctaw,President,Barack Obama,DEM,120101,4,9,160,173,
Choctaw,President,Mitt Romney,REP,120101,7,20,395,422,
Choctaw,U.S. House,Rob Wallace,DEM,120101,4,10,228,242,02
Choctaw,U.S. House,Markwayne Mullin,REP,120101,7,18,299,324,02
Choctaw,U.S. House,Michael Fulks,IND,120101,0,1,19,20,02
Choctaw,State Senate,Jerry Ellis,DEM,120101,4,12,310,326,5
Choctaw,State Senate,Howard Houchen,REP,120101,7,17,238,262,5
Choctaw,President,Barack Obama,DEM,120104,3,11,118,132,
Choctaw,President,Mitt Romney,REP,120104,19,49,359,427,
Choctaw,U.S. House,Rob Wallace,DEM,120104,5,17,200,222,02
Choctaw,U.S. House,Markwayne Mullin,REP,120104,15,37,258,310,02
Choctaw,U.S. House,Michael Fulks,IND,120104,2,5,16,23,02
Choctaw,State Senate,Jerry Ellis,DEM,120104,10,26,274,310,5
Choctaw,State Senate,Howard Houchen,REP,120104,12,33,197,242,5
Choctaw,President,Barack Obama,DEM,120105,3,22,142,167,
Choctaw,President,Mitt Romney,REP,120105,1,10,37,48,
Choctaw,U.S. House,Rob Wallace,DEM,120105,2,21,142,165,02
Choctaw,U.S. House,Markwayne Mullin,REP,120105,2,9,29,40,02
Choctaw,U.S. House,Michael Fulks,IND,120105,0,2,6,8,02
Choctaw,State Senate,Jerry Ellis,DEM,120105,3,20,146,169,5
Choctaw,State Senate,Howard Houchen,REP,120105,1,12,30,43,5
Choctaw,President,Barack Obama,DEM,120106,2,14,51,67,
Choctaw,President,Mitt Romney,REP,120106,8,33,169,210,
Choctaw,U.S. House,Rob Wallace,DEM,120106,4,22,85,111,02
Choctaw,U.S. House,Markwayne Mullin,REP,120106,5,23,121,149,02
Choctaw,U.S. House,Michael Fulks,IND,120106,1,2,9,12,02
Choctaw,State Senate,Jerry Ellis,DEM,120106,3,30,103,136,5
Choctaw,State Senate,Howard Houchen,REP,120106,7,17,115,139,5
Choctaw,President,Barack Obama,DEM,120207,3,1,36,40,
Choctaw,President,Mitt Romney,REP,120207,1,7,47,55,
Choctaw,U.S. House,Rob Wallace,DEM,120207,3,4,41,48,02
Choctaw,U.S. House,Markwayne Mullin,REP,120207,1,4,41,46,02
Choctaw,U.S. House,Michael Fulks,IND,120207,0,0,1,1,02
Choctaw,State Senate,Jerry Ellis,DEM,120207,4,4,45,53,5
Choctaw,State Senate,Howard Houchen,REP,120207,0,4,38,42,5
Choctaw,President,Barack Obama,DEM,120208,3,15,71,89,
Choctaw,President,Mitt Romney,REP,120208,2,57,222,281,
Choctaw,U.S. House,Rob Wallace,DEM,120208,3,15,130,148,02
Choctaw,U.S. House,Markwayne Mullin,REP,120208,2,55,152,209,02
Choctaw,U.S. House,Michael Fulks,IND,120208,0,2,9,11,02
Choctaw,State Senate,Jerry Ellis,DEM,120208,3,31,148,182,5
Choctaw,State Senate,Howard Houchen,REP,120208,2,41,145,188,5
Choctaw,President,Barack Obama,DEM,120209,0,3,71,74,
Choctaw,President,Mitt Romney,REP,120209,1,9,65,75,
Choctaw,U.S. House,Rob Wallace,DEM,120209,0,5,88,93,02
Choctaw,U.S. House,Markwayne Mullin,REP,120209,1,7,44,52,02
Choctaw,U.S. House,Michael Fulks,IND,120209,0,0,5,5,02
Choctaw,State Senate,Jerry Ellis,DEM,120209,0,3,94,97,5
Choctaw,State Senate,Howard Houchen,REP,120209,1,7,43,51,5
Choctaw,President,Barack Obama,DEM,120210,0,8,74,82,
Choctaw,President,Mitt Romney,REP,120210,12,105,222,339,
Choctaw,U.S. House,Rob Wallace,DEM,120210,2,21,123,146,02
Choctaw,U.S. House,Markwayne Mullin,REP,120210,7,84,165,256,02
Choctaw,U.S. House,Michael Fulks,IND,120210,2,4,3,9,02
Choctaw,State Senate,Jerry Ellis,DEM,120210,1,43,154,198,5
Choctaw,State Senate,Howard Houchen,REP,120210,10,70,139,219,5
Choctaw,President,Barack Obama,DEM,120211,1,1,41,43,
Choctaw,President,Mitt Romney,REP,120211,1,4,44,49,
Choctaw,U.S. House,Rob Wallace,DEM,120211,1,1,45,47,02
Choctaw,U.S. House,Markwayne Mullin,REP,120211,1,4,30,35,02
Choctaw,U.S. House,Michael Fulks,IND,120211,0,0,7,7,02
Choctaw,State Senate,Jerry Ellis,DEM,120211,1,3,63,67,5
Choctaw,State Senate,Howard Houchen,REP,120211,1,2,20,23,5
Choctaw,President,Barack Obama,DEM,120214,1,15,131,147,
Choctaw,President,Mitt Romney,REP,120214,8,39,107,154,
Choctaw,U.S. House,Rob Wallace,DEM,120214,3,18,139,160,02
Choctaw,U.S. House,Markwayne Mullin,REP,120214,6,34,92,132,02
Choctaw,U.S. House,Michael Fulks,IND,120214,0,3,8,11,02
Choctaw,State Senate,Jerry Ellis,DEM,120214,1,27,153,181,5
Choctaw,State Senate,Howard Houchen,REP,120214,8,28,85,121,5
Choctaw,President,Barack Obama,DEM,120215,4,26,46,76,
Choctaw,President,Mitt Romney,REP,120215,4,47,95,146,
Choctaw,U.S. House,Rob Wallace,DEM,120215,4,31,59,94,02
Choctaw,U.S. House,Markwayne Mullin,REP,120215,4,38,70,112,02
Choctaw,U.S. House,Michael Fulks,IND,120215,0,3,9,12,02
Choctaw,State Senate,Jerry Ellis,DEM,120215,4,38,69,111,5
Choctaw,State Senate,Howard Houchen,REP,120215,4,36,72,112,5
Choctaw,President,Barack Obama,DEM,120316,5,41,113,159,
Choctaw,President,Mitt Romney,REP,120316,14,109,274,397,
Choctaw,U.S. House,Rob Wallace,DEM,120316,6,53,144,203,02
Choctaw,U.S. House,Markwayne Mullin,REP,120316,10,90,226,326,02
Choctaw,U.S. House,Michael Fulks,IND,120316,2,5,16,23,02
Choctaw,State Senate,Jerry Ellis,DEM,120316,8,73,190,271,5
Choctaw,State Senate,Howard Houchen,REP,120316,10,75,195,280,5
Choctaw,President,Barack Obama,DEM,120318,0,10,56,66,
Choctaw,President,Mitt Romney,REP,120318,3,44,203,250,
Choctaw,U.S. House,Rob Wallace,DEM,120318,0,15,88,103,02
Choctaw,U.S. House,Markwayne Mullin,REP,120318,1,36,159,196,02
Choctaw,U.S. House,Michael Fulks,IND,120318,0,2,8,10,02
Choctaw,State Senate,Jerry Ellis,DEM,120318,1,25,133,159,5
Choctaw,State Senate,Howard Houchen,REP,120318,1,29,126,156,5
Choctaw,President,Barack Obama,DEM,120319,1,9,52,62,
Choctaw,President,Mitt Romney,REP,120319,14,27,191,232,
Choctaw,U.S. House,Rob Wallace,DEM,120319,4,12,90,106,02
Choctaw,U.S. House,Markwayne Mullin,REP,120319,8,22,141,171,02
Choctaw,U.S. House,Michael Fulks,IND,120319,3,2,7,12,02
Choctaw,State Senate,Jerry Ellis,DEM,120319,9,17,164,190,5
Choctaw,State Senate,Howard Houchen,REP,120319,5,19,76,100,5
Choctaw,President,Barack Obama,DEM,120320,1,1,36,38,
Choctaw,President,Mitt Romney,REP,120320,0,8,88,96,
Choctaw,U.S. House,Rob Wallace,DEM,120320,1,4,43,48,02
Choctaw,U.S. House,Markwayne Mullin,REP,120320,0,5,68,73,02
Choctaw,U.S. House,Michael Fulks,IND,120320,0,0,9,9,02
Choctaw,State Senate,Jerry Ellis,DEM,120320,1,5,68,74,5
Choctaw,State Senate,Howard Houchen,REP,120320,0,4,50,54,5
Choctaw,President,Barack Obama,DEM,120321,4,0,52,56,
Choctaw,President,Mitt Romney,REP,120321,11,14,235,260,
Choctaw,U.S. House,Rob Wallace,DEM,120321,4,4,100,108,02
Choctaw,U.S. House,Markwayne Mullin,REP,120321,8,11,177,196,02
Choctaw,U.S. House,Michael Fulks,IND,120321,0,0,9,9,02
Choctaw,State Senate,Jerry Ellis,DEM,120321,4,7,180,191,5
Choctaw,State Senate,Howard Houchen,REP,120321,9,8,108,125,5
Choctaw,President,Barack Obama,DEM,120322,0,0,23,23,
Choctaw,President,Mitt Romney,REP,120322,0,7,124,131,
Choctaw,U.S. House,Rob Wallace,DEM,120322,0,0,51,51,02
Choctaw,U.S. House,Markwayne Mullin,REP,120322,0,7,86,93,02
Choctaw,U.S. House,Michael Fulks,IND,120322,0,0,7,7,02
Choctaw,State Senate,Jerry Ellis,DEM,120322,0,2,111,113,5
Choctaw,State Senate,Howard Houchen,REP,120322,0,5,38,43,5
Cimarron,President,Barack Obama,DEM,130002,4,1,25,30,
Cimarron,President,Mitt Romney,REP,130002,23,33,103,159,
Cimarron,U.S. House,Timothy Ray Murray,DEM,130002,4,1,14,19,03
Cimarron,U.S. House,Frank Lucas,REP,130002,23,33,106,162,03
Cimarron,U.S. House,William Sanders,IND,130002,0,0,8,8,03
Cimarron,State Senate,A. Bryce Marlatt,REP,130002,20,26,96,142,27
Cimarron,State Senate,Tommy Nicholson,IND,130002,6,7,24,37,27
Cimarron,President,Barack Obama,DEM,130003,0,2,10,12,
Cimarron,President,Mitt Romney,REP,130003,11,53,101,165,
Cimarron,U.S. House,Timothy Ray Murray,DEM,130003,1,2,4,7,03
Cimarron,U.S. House,Frank Lucas,REP,130003,9,49,97,155,03
Cimarron,U.S. House,William Sanders,IND,130003,1,3,15,19,03
Cimarron,State Senate,A. Bryce Marlatt,REP,130003,10,41,95,146,27
Cimarron,State Senate,Tommy Nicholson,IND,130003,1,13,20,34,27
Cimarron,President,Barack Obama,DEM,130004,1,4,14,19,
Cimarron,President,Mitt Romney,REP,130004,7,50,144,201,
Cimarron,U.S. House,Timothy Ray Murray,DEM,130004,0,1,15,16,03
Cimarron,U.S. House,Frank Lucas,REP,130004,8,50,138,196,03
Cimarron,U.S. House,William Sanders,IND,130004,0,2,2,4,03
Cimarron,State Senate,A. Bryce Marlatt,REP,130004,7,39,125,171,27
Cimarron,State Senate,Tommy Nicholson,IND,130004,1,12,26,39,27
Cimarron,President,Barack Obama,DEM,130005,1,8,14,23,
Cimarron,President,Mitt Romney,REP,130005,17,61,111,189,
Cimarron,U.S. House,Timothy Ray Murray,DEM,130005,2,8,10,20,03
Cimarron,U.S. House,Frank Lucas,REP,130005,15,58,98,171,03
Cimarron,U.S. House,William Sanders,IND,130005,0,1,13,14,03
Cimarron,State Senate,A. Bryce Marlatt,REP,130005,16,55,89,160,27
Cimarron,State Senate,Tommy Nicholson,IND,130005,0,9,22,31,27
Cimarron,President,Barack Obama,DEM,130006,0,7,15,22,
Cimarron,President,Mitt Romney,REP,130006,27,85,182,294,
Cimarron,U.S. House,Timothy Ray Murray,DEM,130006,0,4,19,23,03
Cimarron,U.S. House,Frank Lucas,REP,130006,26,82,174,282,03
Cimarron,U.S. House,William Sanders,IND,130006,1,3,3,7,03
Cimarron,State Senate,A. Bryce Marlatt,REP,130006,27,74,164,265,27
Cimarron,State Senate,Tommy Nicholson,IND,130006,0,14,24,38,27
Cimarron,President,Barack Obama,DEM,130007,0,4,5,9,
Cimarron,President,Mitt Romney,REP,130007,8,10,56,74,
Cimarron,U.S. House,Timothy Ray Murray,DEM,130007,0,2,5,7,03
Cimarron,U.S. House,Frank Lucas,REP,130007,7,12,56,75,03
Cimarron,U.S. House,William Sanders,IND,130007,0,0,1,1,03
Cimarron,State Senate,A. Bryce Marlatt,REP,130007,5,11,56,72,27
Cimarron,State Senate,Tommy Nicholson,IND,130007,1,3,5,9,27
Cleveland,President,Barack Obama,DEM,140002,11,20,296,327,
Cleveland,President,Mitt Romney,REP,140002,14,7,190,211,
Cleveland,U.S. House,Donna Marie Bebo,DEM,140002,11,19,247,277,04
Cleveland,U.S. House,Tom Cole,REP,140002,13,8,197,218,04
Cleveland,U.S. House,Rj Harris,IND,140002,1,0,44,45,04
Cleveland,President,Barack Obama,DEM,140003,11,42,313,366,
Cleveland,President,Mitt Romney,REP,140003,19,21,391,431,
Cleveland,U.S. House,Donna Marie Bebo,DEM,140003,12,36,261,309,04
Cleveland,U.S. House,Tom Cole,REP,140003,15,26,406,447,04
Cleveland,U.S. House,Rj Harris,IND,140003,3,1,34,38,04
Cleveland,State Senate,Claudia Griffith,DEM,140003,14,40,315,369,15
Cleveland,State Senate,Rob Standridge,REP,140003,15,21,380,416,15
Cleveland,State House,Paula Roberts,DEM,140003,15,45,340,400,45
Cleveland,State House,Aaron Stiles,REP,140003,15,17,364,396,45
Cleveland,President,Barack Obama,DEM,140004,30,15,353,398,
Cleveland,President,Mitt Romney,REP,140004,139,69,1384,1592,
Cleveland,U.S. House,Donna Marie Bebo,DEM,140004,30,13,274,317,04
Cleveland,U.S. House,Tom Cole,REP,140004,137,67,1373,1577,04
Cleveland,U.S. House,Rj Harris,IND,140004,1,3,71,75,04
Cleveland,President,Barack Obama,DEM,140005,28,37,498,563,
Cleveland,President,Mitt Romney,REP,140005,140,62,1314,1516,
Cleveland,U.S. House,Donna Marie Bebo,DEM,140005,25,35,376,436,04
Cleveland,U.S. House,Tom Cole,REP,140005,137,61,1339,1537,04
Cleveland,U.S. House,Rj Harris,IND,140005,4,2,89,95,04
Cleveland,President,Barack Obama,DEM,140006,29,59,564,652,
Cleveland,President,Mitt Romney,REP,140006,22,30,258,310,
Cleveland,U.S. House,Donna Marie Bebo,DEM,140006,23,56,495,574,04
Cleveland,U.S. House,Tom Cole,REP,140006,22,32,268,322,04
Cleveland,U.S. House,Rj Harris,IND,140006,3,1,54,58,04
Cleveland,President,Barack Obama,DEM,140007,6,4,139,149,
Cleveland,President,Mitt Romney,REP,140007,55,28,709,792,
Cleveland,U.S. House,Donna Marie Bebo,DEM,140007,8,4,116,128,04
Cleveland,U.S. House,Tom Cole,REP,140007,52,25,678,755,04
Cleveland,U.S. House,Rj Harris,IND,140007,2,1,43,46,04
Cleveland,President,Barack Obama,DEM,140008,21,51,610,682,
Cleveland,President,Mitt Romney,REP,140008,6,16,187,209,
Cleveland,U.S. House,Donna Marie Bebo,DEM,140008,20,51,528,599,04
Cleveland,U.S. House,Tom Cole,REP,140008,7,14,208,229,04
Cleveland,U.S. House,Rj Harris,IND,140008,1,0,56,57,04
Cleveland,President,Barack Obama,DEM,140009,20,22,374,416,
Cleveland,President,Mitt Romney,REP,140009,67,47,1190,1304,
Cleveland,U.S. House,Donna Marie Bebo,DEM,140009,18,18,276,312,04
Cleveland,U.S. House,Tom Cole,REP,140009,66,46,1193,1305,04
Cleveland,U.S. House,Rj Harris,IND,140009,2,4,81,87,04
Cleveland,President,Barack Obama,DEM,140010,14,23,243,280,
Cleveland,President,Mitt Romney,REP,140010,70,31,571,672,
Cleveland,U.S. House,Donna Marie Bebo,DEM,140010,15,24,212,251,04
Cleveland,U.S. House,Tom Cole,REP,140010,65,27,570,662,04
Cleveland,U.S. House,Rj Harris,IND,140010,0,3,22,25,04
Cleveland,President,Barack Obama,DEM,140011,27,48,531,606,
Cleveland,President,Mitt Romney,REP,140011,13,25,317,355,
Cleveland,U.S. House,Donna Marie Bebo,DEM,140011,25,40,448,513,04
Cleveland,U.S. House,Tom Cole,REP,140011,12,32,338,382,04
Cleveland,U.S. House,Rj Harris,IND,140011,0,1,60,61,04
Cleveland,President,Barack Obama,DEM,140012,26,58,470,554,
Cleveland,President,Mitt Romney,REP,140012,48,69,671,788,
Cleveland,U.S. House,Donna Marie Bebo,DEM,140012,27,52,391,470,04
Cleveland,U.S. House,Tom Cole,REP,140012,44,69,691,804,04
Cleveland,U.S. House,Rj Harris,IND,140012,0,6,58,64,04
Cleveland,State Senate,Claudia Griffith,DEM,140012,29,60,452,541,15
Cleveland,State Senate,Rob Standridge,REP,140012,40,64,679,783,15
Cleveland,State House,Paula Roberts,DEM,140012,35,61,519,615,45
Cleveland,State House,Aaron Stiles,REP,140012,35,66,619,720,45
Cleveland,President,Barack Obama,DEM,140013,19,29,387,435,
Cleveland,President,Mitt Romney,REP,140013,9,12,298,319,
Cleveland,U.S. House,Donna Marie Bebo,DEM,140013,14,28,306,348,04
Cleveland,U.S. House,Tom Cole,REP,140013,10,12,310,332,04
Cleveland,U.S. House,Rj Harris,IND,140013,0,1,60,61,04
Cleveland,State Senate,Claudia Griffith,DEM,140013,14,30,362,406,15
Cleveland,State Senate,Rob Standridge,REP,140013,8,11,291,310,15
Cleveland,President,Barack Obama,DEM,140014,28,70,561,659,
Cleveland,President,Mitt Romney,REP,140014,25,26,293,344,
Cleveland,U.S. House,Donna Marie Bebo,DEM,140014,24,60,447,531,04
Cleveland,U.S. House,Tom Cole,REP,140014,24,25,324,373,04
Cleveland,U.S. House,Rj Harris,IND,140014,5,8,81,94,04
Cleveland,President,Barack Obama,DEM,140015,36,61,584,681,
Cleveland,President,Mitt Romney,REP,140015,37,41,335,413,
Cleveland,U.S. House,Donna Marie Bebo,DEM,140015,34,56,514,604,04
Cleveland,U.S. House,Tom Cole,REP,140015,38,45,352,435,04
Cleveland,U.S. House,Rj Harris,IND,140015,2,2,50,54,04
Cleveland,President,Barack Obama,DEM,140016,23,19,311,353,
Cleveland,President,Mitt Romney,REP,140016,41,38,663,742,
Cleveland,U.S. House,Donna Marie Bebo,DEM,140016,25,15,255,295,04
Cleveland,U.S. House,Tom Cole,REP,140016,38,41,669,748,04
Cleveland,U.S. House,Rj Harris,IND,140016,1,2,49,52,04
Cleveland,President,Barack Obama,DEM,140017,2,8,88,98,
Cleveland,President,Mitt Romney,REP,140017,12,5,274,291,
Cleveland,U.S. House,Donna Marie Bebo,DEM,140017,2,7,75,84,04
Cleveland,U.S. House,Tom Cole,REP,140017,12,5,267,284,04
Cleveland,U.S. House,Rj Harris,IND,140017,0,1,20,21,04
Cleveland,State House,Randy Gilbert,DEM,140017,2,8,111,121,27
Cleveland,State House,Josh Cockroft,REP,140017,12,5,249,266,27
Cleveland,President,Barack Obama,DEM,140018,20,39,554,613,
Cleveland,President,Mitt Romney,REP,140018,22,24,334,380,
Cleveland,U.S. House,Donna Marie Bebo,DEM,140018,17,32,465,514,04
Cleveland,U.S. House,Tom Cole,REP,140018,24,25,359,408,04
Cleveland,U.S. House,Rj Harris,IND,140018,1,6,63,70,04
Cleveland,President,Barack Obama,DEM,140019,40,93,815,948,
Cleveland,President,Mitt Romney,REP,140019,47,69,774,890,
Cleveland,U.S. House,Donna Marie Bebo,DEM,140019,36,80,683,799,04
Cleveland,U.S. House,Tom Cole,REP,140019,48,68,818,934,04
Cleveland,U.S. House,Rj Harris,IND,140019,3,6,85,94,04
Cleveland,President,Barack Obama,DEM,140020,51,29,392,472,
Cleveland,President,Mitt Romney,REP,140020,137,92,1260,1489,
Cleveland,U.S. House,Donna Marie Bebo,DEM,140020,36,28,286,350,04
Cleveland,U.S. House,Tom Cole,REP,140020,145,88,1296,1529,04
Cleveland,U.S. House,Rj Harris,IND,140020,5,4,58,67,04
Cleveland,President,Barack Obama,DEM,140021,5,5,273,283,
Cleveland,President,Mitt Romney,REP,140021,25,16,524,565,
Cleveland,U.S. House,Donna Marie Bebo,DEM,140021,5,6,193,204,04
Cleveland,U.S. House,Tom Cole,REP,140021,24,15,546,585,04
Cleveland,U.S. House,Rj Harris,IND,140021,0,0,61,61,04
Cleveland,President,Barack Obama,DEM,140022,51,51,483,585,
Cleveland,President,Mitt Romney,REP,140022,107,77,1179,1363,
Cleveland,U.S. House,Donna Marie Bebo,DEM,140022,42,40,387,469,04
Cleveland,U.S. House,Tom Cole,REP,140022,107,75,1185,1367,04
Cleveland,U.S. House,Rj Harris,IND,140022,6,12,88,106,04
Cleveland,President,Barack Obama,DEM,140024,33,75,260,368,
Cleveland,President,Mitt Romney,REP,140024,97,113,690,900,
Cleveland,U.S. House,Donna Marie Bebo,DEM,140024,25,67,214,306,04
Cleveland,U.S. House,Tom Cole,REP,140024,100,116,685,901,04
Cleveland,U.S. House,Rj Harris,IND,140024,4,6,42,52,04
Cleveland,President,Barack Obama,DEM,140025,11,15,223,249,
Cleveland,President,Mitt Romney,REP,140025,17,17,454,488,
Cleveland,U.S. House,Donna Marie Bebo,DEM,140025,7,13,163,183,04
Cleveland,U.S. House,Tom Cole,REP,140025,19,16,471,506,04
Cleveland,U.S. House,Rj Harris,IND,140025,1,3,39,43,04
Cleveland,State Senate,Claudia Griffith,DEM,140025,10,15,212,237,15
Cleveland,State Senate,Rob Standridge,REP,140025,15,16,460,491,15
Cleveland,State House,Paula Roberts,DEM,140025,12,18,265,295,45
Cleveland,State House,Aaron Stiles,REP,140025,14,14,407,435,45
Cleveland,President,Barack Obama,DEM,140026,37,96,541,674,
Cleveland,President,Mitt Romney,REP,140026,47,65,616,728,
Cleveland,U.S. House,Donna Marie Bebo,DEM,140026,29,89,439,557,04
Cleveland,U.S. House,Tom Cole,REP,140026,47,64,652,763,04
Cleveland,U.S. House,Rj Harris,IND,140026,8,6,61,75,04
Cleveland,State Senate,Claudia Griffith,DEM,140026,29,91,529,649,15
Cleveland,State Senate,Rob Standridge,REP,140026,50,68,618,736,15
Cleveland,State House,Paula Roberts,DEM,140026,36,97,575,708,45
Cleveland,State House,Aaron Stiles,REP,140026,44,63,571,678,45
Cleveland,President,Barack Obama,DEM,140027,51,88,549,688,
Cleveland,President,Mitt Romney,REP,140027,118,110,1058,1286,
Cleveland,U.S. House,Donna Marie Bebo,DEM,140027,39,75,432,546,04
Cleveland,U.S. House,Tom Cole,REP,140027,117,119,1104,1340,04
Cleveland,U.S. House,Rj Harris,IND,140027,12,3,64,79,04
Cleveland,State Senate,Claudia Griffith,DEM,140027,53,84,526,663,15
Cleveland,State Senate,Rob Standridge,REP,140027,115,112,1058,1285,15
Cleveland,President,Barack Obama,DEM,140028,35,96,787,918,
Cleveland,President,Mitt Romney,REP,140028,22,55,641,718,
Cleveland,U.S. House,Donna Marie Bebo,DEM,140028,33,86,644,763,04
Cleveland,U.S. House,Tom Cole,REP,140028,23,57,661,741,04
Cleveland,U.S. House,Rj Harris,IND,140028,2,7,114,123,04
Cleveland,State House,Paula Roberts,DEM,140028,34,100,815,949,45
Cleveland,State House,Aaron Stiles,REP,140028,22,51,597,670,45
Cleveland,President,Barack Obama,DEM,140029,11,19,327,357,
Cleveland,President,Mitt Romney,REP,140029,38,37,815,890,
Cleveland,U.S. House,Donna Marie Bebo,DEM,140029,11,15,281,307,04
Cleveland,U.S. House,Tom Cole,REP,140029,35,36,818,889,04
Cleveland,U.S. House,Rj Harris,IND,140029,2,3,42,47,04
Cleveland,State House,Matt Branstetter,DEM,140029,14,23,475,512,20
Cleveland,State House,Bobby Cleveland,REP,140029,34,31,662,727,20
Cleveland,President,Barack Obama,DEM,140030,15,42,258,315,
Cleveland,President,Mitt Romney,REP,140030,34,32,439,505,
Cleveland,U.S. House,Donna Marie Bebo,DEM,140030,14,38,217,269,04
Cleveland,U.S. House,Tom Cole,REP,140030,31,34,443,508,04
Cleveland,U.S. House,Rj Harris,IND,140030,3,1,34,38,04
Cleveland,State House,Paula Roberts,DEM,140030,21,43,325,389,45
Cleveland,State House,Aaron Stiles,REP,140030,27,30,367,424,45
Cleveland,President,Barack Obama,DEM,140032,43,100,811,954,
Cleveland,President,Mitt Romney,REP,140032,24,29,501,554,
Cleveland,U.S. House,Donna Marie Bebo,DEM,140032,30,92,650,772,04
Cleveland,U.S. House,Tom Cole,REP,140032,26,28,560,614,04
Cleveland,U.S. House,Rj Harris,IND,140032,4,10,101,115,04
Cleveland,State House,Paula Roberts,DEM,140032,35,95,781,911,45
Cleveland,State House,Aaron Stiles,REP,140032,25,30,512,567,45
Cleveland,President,Barack Obama,DEM,140034,21,9,398,428,
Cleveland,President,Mitt Romney,REP,140034,59,34,1086,1179,
Cleveland,U.S. House,Donna Marie Bebo,DEM,140034,22,8,329,359,04
Cleveland,U.S. House,Tom Cole,REP,140034,56,32,1088,1176,04
Cleveland,U.S. House,Rj Harris,IND,140034,1,2,63,66,04
Cleveland,State House,Matt Branstetter,DEM,140034,30,13,503,546,20
Cleveland,State House,Bobby Cleveland,REP,140034,48,29,967,1044,20
Cleveland,President,Barack Obama,DEM,140035,21,31,340,392,
Cleveland,President,Mitt Romney,REP,140035,45,20,492,557,
Cleveland,U.S. House,Donna Marie Bebo,DEM,140035,19,27,278,324,04
Cleveland,U.S. House,Tom Cole,REP,140035,45,22,508,575,04
Cleveland,U.S. House,Rj Harris,IND,140035,2,1,38,41,04
Cleveland,State Senate,Claudia Griffith,DEM,140035,18,30,334,382,15
Cleveland,State Senate,Rob Standridge,REP,140035,45,21,489,555,15
Cleveland,President,Barack Obama,DEM,140036,13,31,182,226,
Cleveland,President,Mitt Romney,REP,140036,24,47,617,688,
Cleveland,U.S. House,Donna Marie Bebo,DEM,140036,10,27,151,188,04
Cleveland,U.S. House,Tom Cole,REP,140036,27,44,604,675,04
Cleveland,U.S. House,Rj Harris,IND,140036,1,8,48,57,04
Cleveland,State Senate,Claudia Griffith,DEM,140036,10,35,216,261,15
Cleveland,State Senate,Rob Standridge,REP,140036,27,44,585,656,15
Cleveland,State House,Randy Gilbert,DEM,140036,15,37,220,272,27
Cleveland,State House,Josh Cockroft,REP,140036,22,42,577,641,27
Cleveland,President,Barack Obama,DEM,140037,8,27,254,289,
Cleveland,President,Mitt Romney,REP,140037,25,21,567,613,
Cleveland,U.S. House,Donna Marie Bebo,DEM,140037,6,25,205,236,04
Cleveland,U.S. House,Tom Cole,REP,140037,25,22,555,602,04
Cleveland,U.S. House,Rj Harris,IND,140037,2,1,54,57,04
Cleveland,State Senate,Claudia Griffith,DEM,140037,7,28,276,311,15
Cleveland,State Senate,Rob Standridge,REP,140037,20,20,530,570,15
Cleveland,President,Barack Obama,DEM,140038,6,13,290,309,
Cleveland,President,Mitt Romney,REP,140038,37,11,570,618,
Cleveland,U.S. House,Donna Marie Bebo,DEM,140038,7,14,247,268,04
Cleveland,U.S. House,Tom Cole,REP,140038,31,9,561,601,04
Cleveland,U.S. House,Rj Harris,IND,140038,4,2,50,56,04
Cleveland,State Senate,Claudia Griffith,DEM,140038,9,14,298,321,15
Cleveland,State Senate,Rob Standridge,REP,140038,32,11,558,601,15
Cleveland,State House,Matt Branstetter,DEM,140038,14,14,322,350,20
Cleveland,State House,Bobby Cleveland,REP,140038,27,11,531,569,20
Cleveland,President,Barack Obama,DEM,140039,46,59,435,540,
Cleveland,President,Mitt Romney,REP,140039,48,54,523,625,
Cleveland,U.S. House,Donna Marie Bebo,DEM,140039,35,51,353,439,04
Cleveland,U.S. House,Tom Cole,REP,140039,54,55,543,652,04
Cleveland,U.S. House,Rj Harris,IND,140039,3,7,59,69,04
Cleveland,State Senate,Claudia Griffith,DEM,140039,42,59,412,513,15
Cleveland,State Senate,Rob Standridge,REP,140039,49,54,535,638,15
Cleveland,President,Barack Obama,DEM,140040,18,38,400,456,
Cleveland,President,Mitt Romney,REP,140040,46,34,859,939,
Cleveland,U.S. House,Donna Marie Bebo,DEM,140040,15,31,326,372,04
Cleveland,U.S. House,Tom Cole,REP,140040,46,36,869,951,04
Cleveland,U.S. House,Rj Harris,IND,140040,0,5,54,59,04
Cleveland,President,Barack Obama,DEM,140041,5,16,206,227,
Cleveland,President,Mitt Romney,REP,140041,18,7,371,396,
Cleveland,U.S. House,Donna Marie Bebo,DEM,140041,7,13,177,197,04
Cleveland,U.S. House,Tom Cole,REP,140041,16,8,359,383,04
Cleveland,U.S. House,Rj Harris,IND,140041,0,2,27,29,04
Cleveland,President,Barack Obama,DEM,140042,31,30,430,491,
Cleveland,President,Mitt Romney,REP,140042,21,27,297,345,
Cleveland,U.S. House,Donna Marie Bebo,DEM,140042,25,26,355,406,04
Cleveland,U.S. House,Tom Cole,REP,140042,22,28,334,384,04
Cleveland,U.S. House,Rj Harris,IND,140042,3,3,33,39,04
Cleveland,President,Barack Obama,DEM,140043,13,32,368,413,
Cleveland,President,Mitt Romney,REP,140043,37,52,889,978,
Cleveland,U.S. House,Donna Marie Bebo,DEM,140043,14,30,301,345,04
Cleveland,U.S. House,Tom Cole,REP,140043,32,52,885,969,04
Cleveland,U.S. House,Rj Harris,IND,140043,4,2,60,66,04
Cleveland,President,Barack Obama,DEM,140044,25,45,427,497,
Cleveland,President,Mitt Romney,REP,140044,57,71,934,1062,
Cleveland,U.S. House,Donna Marie Bebo,DEM,140044,22,40,337,399,04
Cleveland,U.S. House,Tom Cole,REP,140044,57,74,949,1080,04
Cleveland,U.S. House,Rj Harris,IND,140044,3,1,69,73,04
Cleveland,President,Barack Obama,DEM,140045,6,10,171,187,
Cleveland,President,Mitt Romney,REP,140045,15,8,329,352,
Cleveland,U.S. House,Donna Marie Bebo,DEM,140045,6,7,150,163,04
Cleveland,U.S. House,Tom Cole,REP,140045,14,9,323,346,04
Cleveland,U.S. House,Rj Harris,IND,140045,1,1,26,28,04
Cleveland,State Senate,Claudia Griffith,DEM,140045,5,9,177,191,15
Cleveland,State Senate,Rob Standridge,REP,140045,16,8,318,342,15
Cleveland,State House,Matt Branstetter,DEM,140045,6,10,192,208,20
Cleveland,State House,Bobby Cleveland,REP,140045,15,7,300,322,20
Cleveland,President,Barack Obama,DEM,140047,16,11,403,430,
Cleveland,President,Mitt Romney,REP,140047,40,24,807,871,
Cleveland,U.S. House,Donna Marie Bebo,DEM,140047,14,11,327,352,04
Cleveland,U.S. House,Tom Cole,REP,140047,41,22,797,860,04
Cleveland,U.S. House,Rj Harris,IND,140047,4,2,83,89,04
Cleveland,President,Barack Obama,DEM,140048,10,14,322,346,
Cleveland,President,Mitt Romney,REP,140048,26,26,680,732,
Cleveland,U.S. House,Donna Marie Bebo,DEM,140048,8,12,252,272,04
Cleveland,U.S. House,Tom Cole,REP,140048,27,26,690,743,04
Cleveland,U.S. House,Rj Harris,IND,140048,1,2,53,56,04
Cleveland,President,Barack Obama,DEM,140049,7,4,226,237,
Cleveland,President,Mitt Romney,REP,140049,14,5,384,403,
Cleveland,U.S. House,Donna Marie Bebo,DEM,140049,7,2,164,173,04
Cleveland,U.S. House,Tom Cole,REP,140049,14,5,409,428,04
Cleveland,U.S. House,Rj Harris,IND,140049,0,1,39,40,04
Cleveland,State Senate,Claudia Griffith,DEM,140049,7,4,241,252,15
Cleveland,State Senate,Rob Standridge,REP,140049,14,5,362,381,15
Cleveland,State House,Randy Gilbert,DEM,140049,7,4,262,273,27
Cleveland,State House,Josh Cockroft,REP,140049,14,4,338,356,27
Cleveland,President,Barack Obama,DEM,140050,38,30,488,556,
Cleveland,President,Mitt Romney,REP,140050,64,21,1091,1176,
Cleveland,U.S. House,Donna Marie Bebo,DEM,140050,31,23,396,450,04
Cleveland,U.S. House,Tom Cole,REP,140050,60,24,1100,1184,04
Cleveland,U.S. House,Rj Harris,IND,140050,11,1,75,87,04
Cleveland,President,Barack Obama,DEM,140051,19,37,371,427,
Cleveland,President,Mitt Romney,REP,140051,30,25,314,369,
Cleveland,U.S. House,Donna Marie Bebo,DEM,140051,16,33,321,370,04
Cleveland,U.S. House,Tom Cole,REP,140051,27,24,338,389,04
Cleveland,U.S. House,Rj Harris,IND,140051,5,4,22,31,04
Cleveland,President,Barack Obama,DEM,140053,83,106,770,959,
Cleveland,President,Mitt Romney,REP,140053,91,107,1098,1296,
Cleveland,U.S. House,Donna Marie Bebo,DEM,140053,67,92,611,770,04
Cleveland,U.S. House,Tom Cole,REP,140053,97,110,1157,1364,04
Cleveland,U.S. House,Rj Harris,IND,140053,7,11,84,102,04
Cleveland,State Senate,Claudia Griffith,DEM,140053,73,105,707,885,15
Cleveland,State Senate,Rob Standridge,REP,140053,95,107,1140,1342,15
Cleveland,President,Barack Obama,DEM,140054,3,9,278,290,
Cleveland,President,Mitt Romney,REP,140054,11,12,513,536,
Cleveland,U.S. House,Donna Marie Bebo,DEM,140054,3,5,196,204,04
Cleveland,U.S. House,Tom Cole,REP,140054,11,14,526,551,04
Cleveland,U.S. House,Rj Harris,IND,140054,0,2,66,68,04
Cleveland,President,Barack Obama,DEM,140055,47,119,740,906,
Cleveland,President,Mitt Romney,REP,140055,109,142,1146,1397,
Cleveland,U.S. House,Donna Marie Bebo,DEM,140055,38,109,598,745,04
Cleveland,U.S. House,Tom Cole,REP,140055,109,148,1182,1439,04
Cleveland,U.S. House,Rj Harris,IND,140055,5,1,94,100,04
Cleveland,State Senate,Claudia Griffith,DEM,140055,45,121,714,880,15
Cleveland,State Senate,Rob Standridge,REP,140055,102,137,1144,1383,15
Cleveland,State House,Paula Roberts,DEM,140055,53,127,796,976,45
Cleveland,State House,Aaron Stiles,REP,140055,96,125,1069,1290,45
Cleveland,President,Barack Obama,DEM,140056,43,84,614,741,
Cleveland,President,Mitt Romney,REP,140056,44,54,574,672,
Cleveland,U.S. House,Donna Marie Bebo,DEM,140056,33,70,538,641,04
Cleveland,U.S. House,Tom Cole,REP,140056,50,56,585,691,04
Cleveland,U.S. House,Rj Harris,IND,140056,3,9,63,75,04
Cleveland,President,Barack Obama,DEM,140057,14,26,507,547,
Cleveland,President,Mitt Romney,REP,140057,43,34,1038,1115,
Cleveland,U.S. House,Donna Marie Bebo,DEM,140057,13,22,385,420,04
Cleveland,U.S. House,Tom Cole,REP,140057,40,36,1063,1139,04
Cleveland,U.S. House,Rj Harris,IND,140057,4,2,88,94,04
Cleveland,President,Barack Obama,DEM,140058,16,15,347,378,
Cleveland,President,Mitt Romney,REP,140058,41,24,866,931,
Cleveland,U.S. House,Donna Marie Bebo,DEM,140058,13,13,264,290,04
Cleveland,U.S. House,Tom Cole,REP,140058,40,22,881,943,04
Cleveland,U.S. House,Rj Harris,IND,140058,5,3,73,81,04
Cleveland,President,Barack Obama,DEM,140059,17,11,194,222,
Cleveland,President,Mitt Romney,REP,140059,14,11,253,278,
Cleveland,U.S. House,Donna Marie Bebo,DEM,140059,14,7,167,188,04
Cleveland,U.S. House,Tom Cole,REP,140059,16,14,267,297,04
Cleveland,U.S. House,Rj Harris,IND,140059,1,1,10,12,04
Cleveland,President,Barack Obama,DEM,140060,18,32,515,565,
Cleveland,President,Mitt Romney,REP,140060,98,52,1388,1538,
Cleveland,U.S. House,Donna Marie Bebo,DEM,140060,18,30,404,452,04
Cleveland,U.S. House,Tom Cole,REP,140060,96,50,1411,1557,04
Cleveland,U.S. House,Rj Harris,IND,140060,1,5,75,81,04
Cleveland,President,Barack Obama,DEM,140061,44,35,325,404,
Cleveland,President,Mitt Romney,REP,140061,165,55,1019,1239,
Cleveland,U.S. House,Donna Marie Bebo,DEM,140061,31,29,262,322,04
Cleveland,U.S. House,Tom Cole,REP,140061,165,60,990,1215,04
Cleveland,U.S. House,Rj Harris,IND,140061,12,2,75,89,04
Cleveland,President,Barack Obama,DEM,140063,5,14,100,119,
Cleveland,President,Mitt Romney,REP,140063,18,33,379,430,
Cleveland,U.S. House,Donna Marie Bebo,DEM,140063,2,11,82,95,04
Cleveland,U.S. House,Tom Cole,REP,140063,18,34,372,424,04
Cleveland,U.S. House,Rj Harris,IND,140063,3,3,24,30,04
Cleveland,State Senate,Claudia Griffith,DEM,140063,4,19,106,129,15
Cleveland,State Senate,Rob Standridge,REP,140063,19,28,368,415,15
Cleveland,State House,Randy Gilbert,DEM,140063,3,17,127,147,27
Cleveland,State House,Josh Cockroft,REP,140063,20,30,348,398,27
Cleveland,President,Barack Obama,DEM,140064,31,1,279,311,
Cleveland,President,Mitt Romney,REP,140064,71,29,859,959,
Cleveland,U.S. House,Donna Marie Bebo,DEM,140064,25,0,225,250,04
Cleveland,U.S. House,Tom Cole,REP,140064,67,30,855,952,04
Cleveland,U.S. House,Rj Harris,IND,140064,6,0,54,60,04
Cleveland,State Senate,Claudia Griffith,DEM,140064,29,3,317,349,15
Cleveland,State Senate,Rob Standridge,REP,140064,66,26,805,897,15
Cleveland,State House,Randy Gilbert,DEM,140064,26,4,323,353,27
Cleveland,State House,Josh Cockroft,REP,140064,68,26,802,896,27
Cleveland,President,Barack Obama,DEM,140065,12,6,244,262,
Cleveland,President,Mitt Romney,REP,140065,21,9,439,469,
Cleveland,U.S. House,Donna Marie Bebo,DEM,140065,10,6,198,214,04
Cleveland,U.S. House,Tom Cole,REP,140065,20,9,438,467,04
Cleveland,U.S. House,Rj Harris,IND,140065,1,0,39,40,04
Cleveland,State Senate,Claudia Griffith,DEM,140065,15,6,256,277,15
Cleveland,State Senate,Rob Standridge,REP,140065,18,9,418,445,15
Cleveland,State House,Randy Gilbert,DEM,140065,12,7,279,298,27
Cleveland,State House,Josh Cockroft,REP,140065,18,8,398,424,27
Cleveland,President,Barack Obama,DEM,140067,14,30,294,338,
Cleveland,President,Mitt Romney,REP,140067,17,30,427,474,
Cleveland,U.S. House,Donna Marie Bebo,DEM,140067,12,25,239,276,04
Cleveland,U.S. House,Tom Cole,REP,140067,17,33,447,497,04
Cleveland,U.S. House,Rj Harris,IND,140067,1,3,30,34,04
Cleveland,President,Barack Obama,DEM,140068,17,31,331,379,
Cleveland,President,Mitt Romney,REP,140068,12,32,391,435,
Cleveland,U.S. House,Donna Marie Bebo,DEM,140068,12,27,267,306,04
Cleveland,U.S. House,Tom Cole,REP,140068,14,32,403,449,04
Cleveland,U.S. House,Rj Harris,IND,140068,2,3,43,48,04
Cleveland,President,Barack Obama,DEM,140069,17,30,529,576,
Cleveland,President,Mitt Romney,REP,140069,66,47,1164,1277,
Cleveland,U.S. House,Donna Marie Bebo,DEM,140069,15,27,442,484,04
Cleveland,U.S. House,Tom Cole,REP,140069,66,43,1154,1263,04
Cleveland,U.S. House,Rj Harris,IND,140069,0,7,78,85,04
Cleveland,President,Barack Obama,DEM,140070,10,31,385,426,
Cleveland,President,Mitt Romney,REP,140070,37,43,913,993,
Cleveland,U.S. House,Donna Marie Bebo,DEM,140070,11,29,301,341,04
Cleveland,U.S. House,Tom Cole,REP,140070,32,40,912,984,04
Cleveland,U.S. House,Rj Harris,IND,140070,4,4,77,85,04
Cleveland,President,Barack Obama,DEM,140071,38,33,263,334,
Cleveland,President,Mitt Romney,REP,140071,36,31,319,386,
Cleveland,U.S. House,Donna Marie Bebo,DEM,140071,29,33,212,274,04
Cleveland,U.S. House,Tom Cole,REP,140071,41,31,337,409,04
Cleveland,U.S. House,Rj Harris,IND,140071,2,0,27,29,04
Cleveland,State Senate,Claudia Griffith,DEM,140071,32,32,252,316,15
Cleveland,State Senate,Rob Standridge,REP,140071,38,32,323,393,15
Cleveland,President,Barack Obama,DEM,140072,20,38,337,395,
Cleveland,President,Mitt Romney,REP,140072,67,53,875,995,
Cleveland,U.S. House,Donna Marie Bebo,DEM,140072,13,36,280,329,04
Cleveland,U.S. House,Tom Cole,REP,140072,64,52,858,974,04
Cleveland,U.S. House,Rj Harris,IND,140072,7,3,63,73,04
Cleveland,President,Barack Obama,DEM,140073,53,86,638,777,
Cleveland,President,Mitt Romney,REP,140073,74,118,1254,1446,
Cleveland,U.S. House,Donna Marie Bebo,DEM,140073,49,79,519,647,04
Cleveland,U.S. House,Tom Cole,REP,140073,73,121,1308,1502,04
Cleveland,U.S. House,Rj Harris,IND,140073,4,5,60,69,04
Cleveland,State Senate,Claudia Griffith,DEM,140073,54,87,639,780,15
Cleveland,State Senate,Rob Standridge,REP,140073,69,114,1240,1423,15
Cleveland,President,Barack Obama,DEM,140074,16,24,293,333,
Cleveland,President,Mitt Romney,REP,140074,28,57,517,602,
Cleveland,U.S. House,Donna Marie Bebo,DEM,140074,15,17,246,278,04
Cleveland,U.S. House,Tom Cole,REP,140074,27,62,525,614,04
Cleveland,U.S. House,Rj Harris,IND,140074,1,3,40,44,04
Cleveland,State Senate,Claudia Griffith,DEM,140074,16,23,289,328,15
Cleveland,State Senate,Rob Standridge,REP,140074,24,59,520,603,15
Cleveland,President,Barack Obama,DEM,140076,16,37,383,436,
Cleveland,President,Mitt Romney,REP,140076,25,40,510,575,
Cleveland,U.S. House,Donna Marie Bebo,DEM,140076,14,32,314,360,04
Cleveland,U.S. House,Tom Cole,REP,140076,26,42,531,599,04
Cleveland,U.S. House,Rj Harris,IND,140076,0,4,47,51,04
Cleveland,State Senate,Claudia Griffith,DEM,140076,15,41,372,428,15
Cleveland,State Senate,Rob Standridge,REP,140076,22,36,514,572,15
Cleveland,President,Barack Obama,DEM,140077,8,10,131,149,
Cleveland,President,Mitt Romney,REP,140077,1,8,148,157,
Cleveland,U.S. House,Donna Marie Bebo,DEM,140077,6,9,119,134,04
Cleveland,U.S. House,Tom Cole,REP,140077,2,8,143,153,04
Cleveland,U.S. House,Rj Harris,IND,140077,0,1,17,18,04
Cleveland,State Senate,Claudia Griffith,DEM,140077,7,10,136,153,15
Cleveland,State Senate,Rob Standridge,REP,140077,1,8,143,152,15
Cleveland,President,Barack Obama,DEM,140078,13,8,185,206,
Cleveland,President,Mitt Romney,REP,140078,95,43,892,1030,
Cleveland,U.S. House,Donna Marie Bebo,DEM,140078,7,7,169,183,04
Cleveland,U.S. House,Tom Cole,REP,140078,94,42,852,988,04
Cleveland,U.S. House,Rj Harris,IND,140078,7,2,46,55,04
Cleveland,State Senate,Claudia Griffith,DEM,140078,15,13,224,252,15
Cleveland,State Senate,Rob Standridge,REP,140078,89,38,832,959,15
Cleveland,State House,Randy Gilbert,DEM,140078,14,14,248,276,27
Cleveland,State House,Josh Cockroft,REP,140078,89,37,806,932,27
Cleveland,President,Barack Obama,DEM,140080,6,2,66,74,
Cleveland,President,Mitt Romney,REP,140080,17,7,227,251,
Cleveland,U.S. House,Donna Marie Bebo,DEM,140080,4,2,56,62,04
Cleveland,U.S. House,Tom Cole,REP,140080,16,8,227,251,04
Cleveland,U.S. House,Rj Harris,IND,140080,3,0,10,13,04
Cleveland,President,Barack Obama,DEM,140081,57,78,604,739,
Cleveland,President,Mitt Romney,REP,140081,66,66,637,769,
Cleveland,U.S. House,Donna Marie Bebo,DEM,140081,50,68,488,606,04
Cleveland,U.S. House,Tom Cole,REP,140081,68,68,665,801,04
Cleveland,U.S. House,Rj Harris,IND,140081,4,8,71,83,04
Cleveland,State House,Paula Roberts,DEM,140081,66,80,596,742,45
Cleveland,State House,Aaron Stiles,REP,140081,56,61,624,741,45
Cleveland,President,Barack Obama,DEM,140082,33,71,515,619,
Cleveland,President,Mitt Romney,REP,140082,55,73,674,802,
Cleveland,U.S. House,Donna Marie Bebo,DEM,140082,25,63,424,512,04
Cleveland,U.S. House,Tom Cole,REP,140082,60,78,696,834,04
Cleveland,U.S. House,Rj Harris,IND,140082,0,2,56,58,04
Cleveland,State House,Paula Roberts,DEM,140082,33,69,553,655,45
Cleveland,State House,Aaron Stiles,REP,140082,49,74,620,743,45
Cleveland,President,Barack Obama,DEM,140083,6,6,133,145,
Cleveland,President,Mitt Romney,REP,140083,5,7,221,233,
Cleveland,U.S. House,Donna Marie Bebo,DEM,140083,6,6,107,119,04
Cleveland,U.S. House,Tom Cole,REP,140083,5,7,236,248,04
Cleveland,U.S. House,Rj Harris,IND,140083,0,0,10,10,04
Cleveland,State House,Matt Branstetter,DEM,140083,6,7,136,149,20
Cleveland,State House,Bobby Cleveland,REP,140083,5,6,216,227,20
Cleveland,President,Barack Obama,DEM,140086,19,22,369,410,
Cleveland,President,Mitt Romney,REP,140086,65,42,1031,1138,
Cleveland,U.S. House,Donna Marie Bebo,DEM,140086,14,17,285,316,04
Cleveland,U.S. House,Tom Cole,REP,140086,71,44,1044,1159,04
Cleveland,U.S. House,Rj Harris,IND,140086,0,3,65,68,04
Cleveland,President,Barack Obama,DEM,140087,10,6,119,135,
Cleveland,President,Mitt Romney,REP,140087,25,23,404,452,
Cleveland,U.S. House,Donna Marie Bebo,DEM,140087,7,6,105,118,04
Cleveland,U.S. House,Tom Cole,REP,140087,24,22,394,440,04
Cleveland,U.S. House,Rj Harris,IND,140087,4,2,27,33,04
Cleveland,State Senate,Claudia Griffith,DEM,140087,9,7,125,141,15
Cleveland,State Senate,Rob Standridge,REP,140087,26,22,396,444,15
Cleveland,State House,Randy Gilbert,DEM,140087,10,8,139,157,27
Cleveland,State House,Josh Cockroft,REP,140087,25,22,376,423,27
Cleveland,President,Barack Obama,DEM,140088,23,29,336,388,
Cleveland,President,Mitt Romney,REP,140088,58,48,1092,1198,
Cleveland,U.S. House,Donna Marie Bebo,DEM,140088,19,27,259,305,04
Cleveland,U.S. House,Tom Cole,REP,140088,60,48,1098,1206,04
Cleveland,U.S. House,Rj Harris,IND,140088,1,2,58,61,04
Cleveland,President,Barack Obama,DEM,140089,31,34,454,519,
Cleveland,President,Mitt Romney,REP,140089,80,76,1115,1271,
Cleveland,U.S. House,Donna Marie Bebo,DEM,140089,25,32,362,419,04
Cleveland,U.S. House,Tom Cole,REP,140089,79,75,1109,1263,04
Cleveland,U.S. House,Rj Harris,IND,140089,6,2,89,97,04
Cleveland,President,Barack Obama,DEM,140090,0,0,1,1,
Cleveland,President,Mitt Romney,REP,140090,0,0,0,0,
Cleveland,U.S. House,Donna Marie Bebo,DEM,140090,0,0,0,0,04
Cleveland,U.S. House,Tom Cole,REP,140090,0,0,1,1,04
Cleveland,U.S. House,Rj Harris,IND,140090,0,0,0,0,04
Cleveland,President,Barack Obama,DEM,140091,3,0,25,28,
Cleveland,President,Mitt Romney,REP,140091,6,5,96,107,
Cleveland,U.S. House,Donna Marie Bebo,DEM,140091,3,0,25,28,04
Cleveland,U.S. House,Tom Cole,REP,140091,6,5,94,105,04
Cleveland,U.S. House,Rj Harris,IND,140091,0,0,2,2,04
Cleveland,State Senate,Claudia Griffith,DEM,140091,3,0,32,35,15
Cleveland,State Senate,Rob Standridge,REP,140091,6,5,88,99,15
Cleveland,President,Barack Obama,DEM,140092,0,0,1,1,
Cleveland,President,Mitt Romney,REP,140092,0,0,3,3,
Cleveland,U.S. House,Donna Marie Bebo,DEM,140092,0,0,2,2,04
Cleveland,U.S. House,Tom Cole,REP,140092,0,0,2,2,04
Cleveland,U.S. House,Rj Harris,IND,140092,0,0,1,1,04
Cleveland,President,Barack Obama,DEM,140093,18,47,269,334,
Cleveland,President,Mitt Romney,REP,140093,15,29,192,236,
Cleveland,U.S. House,Donna Marie Bebo,DEM,140093,18,41,225,284,04
Cleveland,U.S. House,Tom Cole,REP,140093,15,32,209,256,04
Cleveland,U.S. House,Rj Harris,IND,140093,0,3,22,25,04
Cleveland,President,Barack Obama,DEM,140094,7,13,97,117,
Cleveland,President,Mitt Romney,REP,140094,12,27,135,174,
Cleveland,U.S. House,Donna Marie Bebo,DEM,140094,6,9,86,101,04
Cleveland,U.S. House,Tom Cole,REP,140094,13,28,140,181,04
Cleveland,U.S. House,Rj Harris,IND,140094,0,3,6,9,04
Cleveland,State Senate,Claudia Griffith,DEM,140094,7,16,104,127,15
Cleveland,State Senate,Rob Standridge,REP,140094,12,23,127,162,15
Cleveland,State House,Paula Roberts,DEM,140094,9,18,120,147,45
Cleveland,State House,Aaron Stiles,REP,140094,10,22,107,139,45
Cleveland,President,Barack Obama,DEM,140095,2,0,112,114,
Cleveland,President,Mitt Romney,REP,140095,8,7,289,304,
Cleveland,U.S. House,Donna Marie Bebo,DEM,140095,1,0,93,94,04
Cleveland,U.S. House,Tom Cole,REP,140095,9,7,288,304,04
Cleveland,U.S. House,Rj Harris,IND,140095,1,0,22,23,04
Cleveland,State Senate,Claudia Griffith,DEM,140095,1,1,124,126,15
Cleveland,State Senate,Rob Standridge,REP,140095,10,6,273,289,15
Cleveland,State House,Matt Branstetter,DEM,140095,1,2,152,155,20
Cleveland,State House,Bobby Cleveland,REP,140095,10,5,244,259,20
Coal,President,Barack Obama,DEM,150002,1,6,106,113,
Coal,President,Mitt Romney,REP,150002,4,11,244,259,
Coal,U.S. House,Rob Wallace,DEM,150002,1,7,169,177,02
Coal,U.S. House,Markwayne Mullin,REP,150002,3,11,168,182,02
Coal,U.S. House,Michael Fulks,IND,150002,1,0,9,10,02
Coal,President,Barack Obama,DEM,150003,2,10,32,44,
Coal,President,Mitt Romney,REP,150003,3,15,99,117,
Coal,U.S. House,Rob Wallace,DEM,150003,2,10,56,68,02
Coal,U.S. House,Markwayne Mullin,REP,150003,3,12,76,91,02
Coal,U.S. House,Michael Fulks,IND,150003,0,2,2,4,02
Coal,President,Barack Obama,DEM,150004,4,17,79,100,
Coal,President,Mitt Romney,REP,150004,13,62,187,262,
Coal,U.S. House,Rob Wallace,DEM,150004,4,32,126,162,02
Coal,U.S. House,Markwayne Mullin,REP,150004,12,45,127,184,02
Coal,U.S. House,Michael Fulks,IND,150004,1,2,10,13,02
Coal,President,Barack Obama,DEM,150005,5,21,83,109,
Coal,President,Mitt Romney,REP,150005,7,82,248,337,
Coal,U.S. House,Rob Wallace,DEM,150005,8,42,156,206,02
Coal,U.S. House,Markwayne Mullin,REP,150005,3,52,162,217,02
Coal,U.S. House,Michael Fulks,IND,150005,0,5,8,13,02
Coal,President,Barack Obama,DEM,150006,5,10,32,47,
Coal,President,Mitt Romney,REP,150006,6,29,84,119,
Coal,U.S. House,Rob Wallace,DEM,150006,5,14,42,61,02
Coal,U.S. House,Markwayne Mullin,REP,150006,5,21,66,92,02
Coal,U.S. House,Michael Fulks,IND,150006,0,3,8,11,02
Coal,President,Barack Obama,DEM,150007,2,14,64,80,
Coal,President,Mitt Romney,REP,150007,7,49,151,207,
Coal,U.S. House,Rob Wallace,DEM,150007,2,21,86,109,02
Coal,U.S. House,Markwayne Mullin,REP,150007,3,40,121,164,02
Coal,U.S. House,Michael Fulks,IND,150007,1,1,5,7,02
Coal,President,Barack Obama,DEM,150009,0,4,34,38,
Coal,President,Mitt Romney,REP,150009,4,7,68,79,
Coal,U.S. House,Rob Wallace,DEM,150009,0,6,44,50,02
Coal,U.S. House,Markwayne Mullin,REP,150009,4,6,52,62,02
Coal,U.S. House,Michael Fulks,IND,150009,0,0,6,6,02
Coal,President,Barack Obama,DEM,150010,0,5,17,22,
Coal,President,Mitt Romney,REP,150010,6,29,87,122,
Coal,U.S. House,Rob Wallace,DEM,150010,0,12,33,45,02
Coal,U.S. House,Markwayne Mullin,REP,150010,6,19,66,91,02
Coal,U.S. House,Michael Fulks,IND,150010,0,1,6,7,02
Coal,President,Barack Obama,DEM,150011,2,21,73,96,
Coal,President,Mitt Romney,REP,150011,2,28,178,208,
Coal,U.S. House,Rob Wallace,DEM,150011,4,21,128,153,02
Coal,U.S. House,Markwayne Mullin,REP,150011,0,29,107,136,02
Coal,U.S. House,Michael Fulks,IND,150011,0,0,10,10,02
Comanche,President,Barack Obama,DEM,160001,29,121,401,551,
Comanche,President,Mitt Romney,REP,160001,34,93,545,672,
Comanche,U.S. House,Donna Marie Bebo,DEM,160001,23,109,327,459,04
Comanche,U.S. House,Tom Cole,REP,160001,37,101,571,709,04
Comanche,U.S. House,Rj Harris,IND,160001,4,3,44,51,04
Comanche,President,Barack Obama,DEM,160002,28,110,406,544,
Comanche,President,Mitt Romney,REP,160002,36,75,434,545,
Comanche,U.S. House,Donna Marie Bebo,DEM,160002,27,99,366,492,04
Comanche,U.S. House,Tom Cole,REP,160002,36,80,443,559,04
Comanche,U.S. House,Rj Harris,IND,160002,1,4,31,36,04
Comanche,President,Barack Obama,DEM,160003,14,82,401,497,
Comanche,President,Mitt Romney,REP,160003,27,46,353,426,
Comanche,U.S. House,Donna Marie Bebo,DEM,160003,9,76,352,437,04
Comanche,U.S. House,Tom Cole,REP,160003,26,48,362,436,04
Comanche,U.S. House,Rj Harris,IND,160003,3,6,37,46,04
Comanche,President,Barack Obama,DEM,160007,23,96,362,481,
Comanche,President,Mitt Romney,REP,160007,26,64,396,486,
Comanche,U.S. House,Donna Marie Bebo,DEM,160007,22,85,292,399,04
Comanche,U.S. House,Tom Cole,REP,160007,24,67,427,518,04
Comanche,U.S. House,Rj Harris,IND,160007,2,5,40,47,04
Comanche,President,Barack Obama,DEM,160008,35,124,460,619,
Comanche,President,Mitt Romney,REP,160008,49,109,576,734,
Comanche,U.S. House,Donna Marie Bebo,DEM,160008,25,113,397,535,04
Comanche,U.S. House,Tom Cole,REP,160008,50,112,598,760,04
Comanche,U.S. House,Rj Harris,IND,160008,6,8,36,50,04
Comanche,President,Barack Obama,DEM,160009,17,131,507,655,
Comanche,President,Mitt Romney,REP,160009,28,76,462,566,
Comanche,U.S. House,Donna Marie Bebo,DEM,160009,14,118,437,569,04
Comanche,U.S. House,Tom Cole,REP,160009,28,88,501,617,04
Comanche,U.S. House,Rj Harris,IND,160009,2,1,31,34,04
Comanche,President,Barack Obama,DEM,160011,32,130,317,479,
Comanche,President,Mitt Romney,REP,160011,24,55,319,398,
Comanche,U.S. House,Donna Marie Bebo,DEM,160011,27,120,263,410,04
Comanche,U.S. House,Tom Cole,REP,160011,23,60,356,439,04
Comanche,U.S. House,Rj Harris,IND,160011,3,4,16,23,04
Comanche,State Senate,Tony Terrill,DEM,160011,24,123,289,436,31
Comanche,State Senate,Don Barrington,REP,160011,25,62,339,426,31
Comanche,President,Barack Obama,DEM,160013,26,74,521,621,
Comanche,President,Mitt Romney,REP,160013,23,42,499,564,
Comanche,U.S. House,Donna Marie Bebo,DEM,160013,20,70,442,532,04
Comanche,U.S. House,Tom Cole,REP,160013,25,38,514,577,04
Comanche,U.S. House,Rj Harris,IND,160013,2,6,59,67,04
Comanche,President,Barack Obama,DEM,160014,23,16,74,113,
Comanche,President,Mitt Romney,REP,160014,37,17,67,121,
Comanche,U.S. House,Donna Marie Bebo,DEM,160014,18,16,71,105,04
Comanche,U.S. House,Tom Cole,REP,160014,32,15,59,106,04
Comanche,U.S. House,Rj Harris,IND,160014,5,1,8,14,04
Comanche,President,Barack Obama,DEM,160015,23,83,372,478,
Comanche,President,Mitt Romney,REP,160015,25,85,440,550,
Comanche,U.S. House,Donna Marie Bebo,DEM,160015,16,72,313,401,04
Comanche,U.S. House,Tom Cole,REP,160015,30,87,457,574,04
Comanche,U.S. House,Rj Harris,IND,160015,2,8,39,49,04
Comanche,President,Barack Obama,DEM,160017,25,63,385,473,
Comanche,President,Mitt Romney,REP,160017,35,56,551,642,
Comanche,U.S. House,Donna Marie Bebo,DEM,160017,19,54,313,386,04
Comanche,U.S. House,Tom Cole,REP,160017,37,58,582,677,04
Comanche,U.S. House,Rj Harris,IND,160017,2,5,35,42,04
Comanche,President,Barack Obama,DEM,160019,8,19,238,265,
Comanche,President,Mitt Romney,REP,160019,15,26,403,444,
Comanche,U.S. House,Donna Marie Bebo,DEM,160019,6,19,200,225,04
Comanche,U.S. House,Tom Cole,REP,160019,16,26,416,458,04
Comanche,U.S. House,Rj Harris,IND,160019,1,0,22,23,04
Comanche,President,Barack Obama,DEM,160020,13,46,325,384,
Comanche,President,Mitt Romney,REP,160020,16,41,390,447,
Comanche,U.S. House,Donna Marie Bebo,DEM,160020,11,40,276,327,04
Comanche,U.S. House,Tom Cole,REP,160020,15,42,402,459,04
Comanche,U.S. House,Rj Harris,IND,160020,2,5,40,47,04
Comanche,President,Barack Obama,DEM,160021,8,58,220,286,
Comanche,President,Mitt Romney,REP,160021,7,27,267,301,
Comanche,U.S. House,Donna Marie Bebo,DEM,160021,7,52,180,239,04
Comanche,U.S. House,Tom Cole,REP,160021,3,31,278,312,04
Comanche,U.S. House,Rj Harris,IND,160021,4,2,32,38,04
Comanche,President,Barack Obama,DEM,160025,10,54,366,430,
Comanche,President,Mitt Romney,REP,160025,2,2,45,49,
Comanche,U.S. House,Donna Marie Bebo,DEM,160025,8,50,329,387,04
Comanche,U.S. House,Tom Cole,REP,160025,2,5,61,68,04
Comanche,U.S. House,Rj Harris,IND,160025,2,1,14,17,04
Comanche,State Senate,Tony Terrill,DEM,160025,8,52,339,399,31
Comanche,State Senate,Don Barrington,REP,160025,3,4,67,74,31
Comanche,President,Barack Obama,DEM,160026,3,14,168,185,
Comanche,President,Mitt Romney,REP,160026,7,9,210,226,
Comanche,U.S. House,Donna Marie Bebo,DEM,160026,2,13,142,157,04
Comanche,U.S. House,Tom Cole,REP,160026,7,8,210,225,04
Comanche,U.S. House,Rj Harris,IND,160026,1,2,28,31,04
Comanche,State Senate,Tony Terrill,DEM,160026,2,15,168,185,31
Comanche,State Senate,Don Barrington,REP,160026,6,8,211,225,31
Comanche,President,Barack Obama,DEM,160027,9,27,229,265,
Comanche,President,Mitt Romney,REP,160027,5,17,175,197,
Comanche,U.S. House,Donna Marie Bebo,DEM,160027,6,22,175,203,04
Comanche,U.S. House,Tom Cole,REP,160027,6,20,201,227,04
Comanche,U.S. House,Rj Harris,IND,160027,2,0,29,31,04
Comanche,State Senate,Tony Terrill,DEM,160027,9,22,203,234,31
Comanche,State Senate,Don Barrington,REP,160027,5,20,200,225,31
Comanche,President,Barack Obama,DEM,160029,8,22,235,265,
Comanche,President,Mitt Romney,REP,160029,4,6,45,55,
Comanche,U.S. House,Donna Marie Bebo,DEM,160029,6,20,224,250,04
Comanche,U.S. House,Tom Cole,REP,160029,6,5,50,61,04
Comanche,U.S. House,Rj Harris,IND,160029,0,1,8,9,04
Comanche,State Senate,Tony Terrill,DEM,160029,7,21,223,251,31
Comanche,State Senate,Don Barrington,REP,160029,4,5,58,67,31
Comanche,President,Barack Obama,DEM,160030,8,15,136,159,
Comanche,President,Mitt Romney,REP,160030,6,9,114,129,
Comanche,U.S. House,Donna Marie Bebo,DEM,160030,6,15,112,133,04
Comanche,U.S. House,Tom Cole,REP,160030,7,9,124,140,04
Comanche,U.S. House,Rj Harris,IND,160030,1,0,15,16,04
Comanche,State Senate,Tony Terrill,DEM,160030,7,13,133,153,31
Comanche,State Senate,Don Barrington,REP,160030,5,11,117,133,31
Comanche,President,Barack Obama,DEM,160031,50,218,441,709,
Comanche,President,Mitt Romney,REP,160031,83,273,863,1219,
Comanche,U.S. House,Donna Marie Bebo,DEM,160031,40,195,359,594,04
Comanche,U.S. House,Tom Cole,REP,160031,77,277,877,1231,04
Comanche,U.S. House,Rj Harris,IND,160031,9,14,48,71,04
Comanche,State Senate,Tony Terrill,DEM,160031,44,211,447,702,31
Comanche,State Senate,Don Barrington,REP,160031,78,276,831,1185,31
Comanche,President,Barack Obama,DEM,160032,4,3,86,93,
Comanche,President,Mitt Romney,REP,160032,3,0,8,11,
Comanche,U.S. House,Donna Marie Bebo,DEM,160032,4,2,84,90,04
Comanche,U.S. House,Tom Cole,REP,160032,3,0,7,10,04
Comanche,U.S. House,Rj Harris,IND,160032,0,0,1,1,04
Comanche,State Senate,Tony Terrill,DEM,160032,6,2,87,95,31
Comanche,State Senate,Don Barrington,REP,160032,1,0,6,7,31
Comanche,President,Barack Obama,DEM,160033,19,35,136,190,
Comanche,President,Mitt Romney,REP,160033,23,16,218,257,
Comanche,U.S. House,Donna Marie Bebo,DEM,160033,17,30,120,167,04
Comanche,U.S. House,Tom Cole,REP,160033,24,20,212,256,04
Comanche,U.S. House,Rj Harris,IND,160033,0,1,19,20,04
Comanche,State Senate,Tony Terrill,DEM,160033,17,33,147,197,31
Comanche,State Senate,Don Barrington,REP,160033,22,18,203,243,31
Comanche,President,Barack Obama,DEM,160034,31,158,446,635,
Comanche,President,Mitt Romney,REP,160034,43,111,578,732,
Comanche,U.S. House,Donna Marie Bebo,DEM,160034,23,138,384,545,04
Comanche,U.S. House,Tom Cole,REP,160034,41,120,596,757,04
Comanche,U.S. House,Rj Harris,IND,160034,4,6,42,52,04
Comanche,State Senate,Tony Terrill,DEM,160034,26,149,407,582,31
Comanche,State Senate,Don Barrington,REP,160034,36,114,613,763,31
Comanche,President,Barack Obama,DEM,160035,7,3,97,107,
Comanche,President,Mitt Romney,REP,160035,9,6,210,225,
Comanche,U.S. House,Donna Marie Bebo,DEM,160035,7,2,78,87,04
Comanche,U.S. House,Tom Cole,REP,160035,9,7,213,229,04
Comanche,U.S. House,Rj Harris,IND,160035,0,0,18,18,04
Comanche,President,Barack Obama,DEM,160036,3,6,77,86,
Comanche,President,Mitt Romney,REP,160036,10,7,179,196,
Comanche,U.S. House,Donna Marie Bebo,DEM,160036,3,4,66,73,04
Comanche,U.S. House,Tom Cole,REP,160036,9,9,178,196,04
Comanche,U.S. House,Rj Harris,IND,160036,1,0,11,12,04
Comanche,President,Barack Obama,DEM,160037,0,0,63,63,
Comanche,President,Mitt Romney,REP,160037,2,2,184,188,
Comanche,U.S. House,Donna Marie Bebo,DEM,160037,0,0,45,45,04
Comanche,U.S. House,Tom Cole,REP,160037,2,2,193,197,04
Comanche,U.S. House,Rj Harris,IND,160037,0,0,10,10,04
Comanche,President,Barack Obama,DEM,160038,17,43,293,353,
Comanche,President,Mitt Romney,REP,160038,51,86,986,1123,
Comanche,U.S. House,Donna Marie Bebo,DEM,160038,16,43,244,303,04
Comanche,U.S. House,Tom Cole,REP,160038,47,82,985,1114,04
Comanche,U.S. House,Rj Harris,IND,160038,3,3,47,53,04
Comanche,State Senate,Tony Terrill,DEM,160038,16,43,276,335,31
Comanche,State Senate,Don Barrington,REP,160038,49,84,990,1123,31
Comanche,President,Barack Obama,DEM,160039,13,2,186,201,
Comanche,President,Mitt Romney,REP,160039,27,12,532,571,
Comanche,U.S. House,Donna Marie Bebo,DEM,160039,11,4,151,166,04
Comanche,U.S. House,Tom Cole,REP,160039,27,9,537,573,04
Comanche,U.S. House,Rj Harris,IND,160039,1,1,26,28,04
Comanche,State Senate,Tony Terrill,DEM,160039,10,4,174,188,31
Comanche,State Senate,Don Barrington,REP,160039,27,10,538,575,31
Comanche,President,Barack Obama,DEM,160040,4,0,173,177,
Comanche,President,Mitt Romney,REP,160040,6,13,573,592,
Comanche,U.S. House,Donna Marie Bebo,DEM,160040,2,0,162,164,04
Comanche,U.S. House,Tom Cole,REP,160040,7,13,558,578,04
Comanche,U.S. House,Rj Harris,IND,160040,1,0,25,26,04
Comanche,State Senate,Tony Terrill,DEM,160040,3,0,185,188,31
Comanche,State Senate,Don Barrington,REP,160040,7,13,560,580,31
Comanche,President,Barack Obama,DEM,160041,0,8,144,152,
Comanche,President,Mitt Romney,REP,160041,6,10,329,345,
Comanche,U.S. House,Donna Marie Bebo,DEM,160041,0,9,115,124,04
Comanche,U.S. House,Tom Cole,REP,160041,6,9,332,347,04
Comanche,U.S. House,Rj Harris,IND,160041,0,0,20,20,04
Comanche,President,Barack Obama,DEM,160042,35,140,450,625,
Comanche,President,Mitt Romney,REP,160042,81,142,1048,1271,
Comanche,U.S. House,Donna Marie Bebo,DEM,160042,27,125,373,525,04
Comanche,U.S. House,Tom Cole,REP,160042,84,148,1077,1309,04
Comanche,U.S. House,Rj Harris,IND,160042,4,7,49,60,04
Comanche,President,Barack Obama,DEM,160043,3,4,66,73,
Comanche,President,Mitt Romney,REP,160043,9,14,214,237,
Comanche,U.S. House,Donna Marie Bebo,DEM,160043,2,3,47,52,04
Comanche,U.S. House,Tom Cole,REP,160043,9,14,224,247,04
Comanche,U.S. House,Rj Harris,IND,160043,1,1,9,11,04
Comanche,State Senate,Tony Terrill,DEM,160043,1,4,61,66,31
Comanche,State Senate,Don Barrington,REP,160043,11,14,219,244,31
Comanche,President,Barack Obama,DEM,160045,6,23,135,164,
Comanche,President,Mitt Romney,REP,160045,23,30,374,427,
Comanche,U.S. House,Donna Marie Bebo,DEM,160045,9,20,107,136,04
Comanche,U.S. House,Tom Cole,REP,160045,19,31,382,432,04
Comanche,U.S. House,Rj Harris,IND,160045,1,2,18,21,04
Comanche,State Senate,Tony Terrill,DEM,160045,5,24,131,160,31
Comanche,State Senate,Don Barrington,REP,160045,24,28,375,427,31
Comanche,President,Barack Obama,DEM,160046,4,4,69,77,
Comanche,President,Mitt Romney,REP,160046,3,9,208,220,
Comanche,U.S. House,Donna Marie Bebo,DEM,160046,4,2,53,59,04
Comanche,U.S. House,Tom Cole,REP,160046,3,11,217,231,04
Comanche,U.S. House,Rj Harris,IND,160046,0,0,7,7,04
Comanche,State Senate,Tony Terrill,DEM,160046,3,3,54,60,31
Comanche,State Senate,Don Barrington,REP,160046,4,10,218,232,31
Comanche,President,Barack Obama,DEM,160048,1,5,201,207,
Comanche,President,Mitt Romney,REP,160048,4,12,373,389,
Comanche,U.S. House,Donna Marie Bebo,DEM,160048,1,6,143,150,04
Comanche,U.S. House,Tom Cole,REP,160048,4,11,390,405,04
Comanche,U.S. House,Rj Harris,IND,160048,0,0,38,38,04
Comanche,State Senate,Tony Terrill,DEM,160048,1,5,167,173,31
Comanche,State Senate,Don Barrington,REP,160048,4,12,407,423,31
Comanche,President,Barack Obama,DEM,160049,3,8,125,136,
Comanche,President,Mitt Romney,REP,160049,15,14,402,431,
Comanche,U.S. House,Donna Marie Bebo,DEM,160049,3,8,114,125,04
Comanche,U.S. House,Tom Cole,REP,160049,12,14,398,424,04
Comanche,U.S. House,Rj Harris,IND,160049,2,1,12,15,04
Comanche,State Senate,Tony Terrill,DEM,160049,4,8,119,131,31
Comanche,State Senate,Don Barrington,REP,160049,13,15,402,430,31
Comanche,President,Barack Obama,DEM,160050,27,103,336,466,
Comanche,President,Mitt Romney,REP,160050,79,144,821,1044,
Comanche,U.S. House,Donna Marie Bebo,DEM,160050,23,95,263,381,04
Comanche,U.S. House,Tom Cole,REP,160050,79,147,847,1073,04
Comanche,U.S. House,Rj Harris,IND,160050,2,3,43,48,04
Comanche,President,Barack Obama,DEM,160051,6,21,230,257,
Comanche,President,Mitt Romney,REP,160051,32,52,550,634,
Comanche,U.S. House,Donna Marie Bebo,DEM,160051,4,21,188,213,04
Comanche,U.S. House,Tom Cole,REP,160051,31,50,563,644,04
Comanche,U.S. House,Rj Harris,IND,160051,3,2,29,34,04
Comanche,President,Barack Obama,DEM,160053,0,0,0,0,
Comanche,President,Mitt Romney,REP,160053,0,0,0,0,
Comanche,U.S. House,Donna Marie Bebo,DEM,160053,0,0,0,0,04
Comanche,U.S. House,Tom Cole,REP,160053,0,0,0,0,04
Comanche,U.S. House,Rj Harris,IND,160053,0,0,0,0,04
Cotton,President,Barack Obama,DEM,170001,0,7,26,33,
Cotton,President,Mitt Romney,REP,170001,4,8,44,56,
Cotton,U.S. House,Donna Marie Bebo,DEM,170001,0,3,24,27,04
Cotton,U.S. House,Tom Cole,REP,170001,4,10,44,58,04
Cotton,U.S. House,Rj Harris,IND,170001,0,1,3,4,04
Cotton,State Senate,Tony Terrill,DEM,170001,0,3,25,28,31
Cotton,State Senate,Don Barrington,REP,170001,3,11,44,58,31
Cotton,President,Barack Obama,DEM,170003,4,28,51,83,
Cotton,President,Mitt Romney,REP,170003,15,89,190,294,
Cotton,U.S. House,Donna Marie Bebo,DEM,170003,2,23,41,66,04
Cotton,U.S. House,Tom Cole,REP,170003,14,90,194,298,04
Cotton,U.S. House,Rj Harris,IND,170003,3,4,7,14,04
Cotton,State Senate,Tony Terrill,DEM,170003,3,25,41,69,31
Cotton,State Senate,Don Barrington,REP,170003,16,92,200,308,31
Cotton,President,Barack Obama,DEM,170004,1,14,87,102,
Cotton,President,Mitt Romney,REP,170004,7,49,178,234,
Cotton,U.S. House,Donna Marie Bebo,DEM,170004,0,9,67,76,04
Cotton,U.S. House,Tom Cole,REP,170004,7,54,182,243,04
Cotton,U.S. House,Rj Harris,IND,170004,0,0,16,16,04
Cotton,State Senate,Tony Terrill,DEM,170004,0,10,65,75,31
Cotton,State Senate,Don Barrington,REP,170004,7,53,202,262,31
Cotton,President,Barack Obama,DEM,170005,12,19,169,200,
Cotton,President,Mitt Romney,REP,170005,7,27,300,334,
Cotton,U.S. House,Donna Marie Bebo,DEM,170005,12,14,144,170,04
Cotton,U.S. House,Tom Cole,REP,170005,6,31,301,338,04
Cotton,U.S. House,Rj Harris,IND,170005,1,1,16,18,04
Cotton,State Senate,Tony Terrill,DEM,170005,11,12,146,169,31
Cotton,State Senate,Don Barrington,REP,170005,8,34,320,362,31
Cotton,President,Barack Obama,DEM,170007,4,11,73,88,
Cotton,President,Mitt Romney,REP,170007,5,53,188,246,
Cotton,U.S. House,Donna Marie Bebo,DEM,170007,2,12,65,79,04
Cotton,U.S. House,Tom Cole,REP,170007,6,47,181,234,04
Cotton,U.S. House,Rj Harris,IND,170007,1,3,16,20,04
Cotton,State Senate,Tony Terrill,DEM,170007,2,12,62,76,31
Cotton,State Senate,Don Barrington,REP,170007,7,50,203,260,31
Cotton,President,Barack Obama,DEM,170008,0,2,14,16,
Cotton,President,Mitt Romney,REP,170008,1,5,44,50,
Cotton,U.S. House,Donna Marie Bebo,DEM,170008,0,1,10,11,04
Cotton,U.S. House,Tom Cole,REP,170008,1,6,43,50,04
Cotton,U.S. House,Rj Harris,IND,170008,0,0,3,3,04
Cotton,State Senate,Tony Terrill,DEM,170008,0,0,12,12,31
Cotton,State Senate,Don Barrington,REP,170008,1,7,44,52,31
Cotton,President,Barack Obama,DEM,170009,2,12,55,69,
Cotton,President,Mitt Romney,REP,170009,16,38,200,254,
Cotton,U.S. House,Donna Marie Bebo,DEM,170009,2,11,39,52,04
Cotton,U.S. House,Tom Cole,REP,170009,15,36,202,253,04
Cotton,U.S. House,Rj Harris,IND,170009,0,2,16,18,04
Cotton,State Senate,Tony Terrill,DEM,170009,3,10,41,54,31
Cotton,State Senate,Don Barrington,REP,170009,15,39,212,266,31
Cotton,President,Barack Obama,DEM,170010,1,0,26,27,
Cotton,President,Mitt Romney,REP,170010,2,10,106,118,
Cotton,U.S. House,Donna Marie Bebo,DEM,170010,2,0,22,24,04
Cotton,U.S. House,Tom Cole,REP,170010,1,10,100,111,04
Cotton,U.S. House,Rj Harris,IND,170010,0,0,8,8,04
Cotton,State Senate,Tony Terrill,DEM,170010,1,0,23,24,31
Cotton,State Senate,Don Barrington,REP,170010,2,10,110,122,31
Cotton,President,Barack Obama,DEM,170011,1,1,37,39,
Cotton,President,Mitt Romney,REP,170011,6,11,193,210,
Cotton,U.S. House,Donna Marie Bebo,DEM,170011,1,1,41,43,04
Cotton,U.S. House,Tom Cole,REP,170011,6,11,160,177,04
Cotton,U.S. House,Rj Harris,IND,170011,0,0,18,18,04
Cotton,State Senate,Tony Terrill,DEM,170011,1,0,51,52,31
Cotton,State Senate,Don Barrington,REP,170011,6,12,171,189,31
Craig,President,Barack Obama,DEM,180140,2,1,162,165,
Craig,President,Mitt Romney,REP,180140,20,9,477,506,
Craig,U.S. House,Rob Wallace,DEM,180140,3,2,191,196,02
Craig,U.S. House,Markwayne Mullin,REP,180140,19,9,427,455,02
Craig,U.S. House,Michael Fulks,IND,180140,0,0,20,20,02
Craig,President,Barack Obama,DEM,180320,3,4,49,56,
Craig,President,Mitt Romney,REP,180320,9,16,79,104,
Craig,U.S. House,Rob Wallace,DEM,180320,2,2,49,53,02
Craig,U.S. House,Markwayne Mullin,REP,180320,9,17,72,98,02
Craig,U.S. House,Michael Fulks,IND,180320,0,1,6,7,02
Craig,President,Barack Obama,DEM,180410,2,2,102,106,
Craig,President,Mitt Romney,REP,180410,2,13,201,216,
Craig,U.S. House,Rob Wallace,DEM,180410,2,2,115,119,02
Craig,U.S. House,Markwayne Mullin,REP,180410,3,13,174,190,02
Craig,U.S. House,Michael Fulks,IND,180410,0,0,15,15,02
Craig,President,Barack Obama,DEM,180520,2,9,113,124,
Craig,President,Mitt Romney,REP,180520,9,17,215,241,
Craig,U.S. House,Rob Wallace,DEM,180520,2,10,121,133,02
Craig,U.S. House,Markwayne Mullin,REP,180520,6,16,196,218,02
Craig,U.S. House,Michael Fulks,IND,180520,2,0,12,14,02
Craig,President,Barack Obama,DEM,180611,3,17,142,162,
Craig,President,Mitt Romney,REP,180611,4,29,267,300,
Craig,U.S. House,Rob Wallace,DEM,180611,1,16,133,150,02
Craig,U.S. House,Markwayne Mullin,REP,180611,5,29,262,296,02
Craig,U.S. House,Michael Fulks,IND,180611,0,0,15,15,02
Craig,President,Barack Obama,DEM,180612,3,8,113,124,
Craig,President,Mitt Romney,REP,180612,5,5,174,184,
Craig,U.S. House,Rob Wallace,DEM,180612,3,6,112,121,02
Craig,U.S. House,Markwayne Mullin,REP,180612,4,3,163,170,02
Craig,U.S. House,Michael Fulks,IND,180612,0,4,14,18,02
Craig,President,Barack Obama,DEM,180621,13,29,262,304,
Craig,President,Mitt Romney,REP,180621,16,52,362,430,
Craig,U.S. House,Rob Wallace,DEM,180621,13,30,271,314,02
Craig,U.S. House,Markwayne Mullin,REP,180621,12,48,322,382,02
Craig,U.S. House,Michael Fulks,IND,180621,0,3,29,32,02
Craig,President,Barack Obama,DEM,180622,3,10,193,206,
Craig,President,Mitt Romney,REP,180622,19,11,231,261,
Craig,U.S. House,Rob Wallace,DEM,180622,3,8,198,209,02
Craig,U.S. House,Markwayne Mullin,REP,180622,17,12,203,232,02
Craig,U.S. House,Michael Fulks,IND,180622,1,1,23,25,02
Craig,President,Barack Obama,DEM,180710,5,7,65,77,
Craig,President,Mitt Romney,REP,180710,6,22,178,206,
Craig,U.S. House,Rob Wallace,DEM,180710,6,5,74,85,02
Craig,U.S. House,Markwayne Mullin,REP,180710,5,19,159,183,02
Craig,U.S. House,Michael Fulks,IND,180710,0,3,6,9,02
Craig,President,Barack Obama,DEM,180714,2,1,24,27,
Craig,President,Mitt Romney,REP,180714,1,7,57,65,
Craig,U.S. House,Rob Wallace,DEM,180714,2,2,25,29,02
Craig,U.S. House,Markwayne Mullin,REP,180714,1,6,54,61,02
Craig,U.S. House,Michael Fulks,IND,180714,0,0,2,2,02
Craig,President,Barack Obama,DEM,180810,4,8,112,124,
Craig,President,Mitt Romney,REP,180810,9,33,371,413,
Craig,U.S. House,Rob Wallace,DEM,180810,4,9,104,117,02
Craig,U.S. House,Markwayne Mullin,REP,180810,9,32,355,396,02
Craig,U.S. House,Michael Fulks,IND,180810,0,0,28,28,02
Craig,President,Barack Obama,DEM,180820,4,14,147,165,
Craig,President,Mitt Romney,REP,180820,19,34,338,391,
Craig,U.S. House,Rob Wallace,DEM,180820,6,15,153,174,02
Craig,U.S. House,Markwayne Mullin,REP,180820,17,33,308,358,02
Craig,U.S. House,Michael Fulks,IND,180820,0,0,21,21,02
Craig,President,Barack Obama,DEM,180910,6,7,94,107,
Craig,President,Mitt Romney,REP,180910,8,28,206,242,
Craig,U.S. House,Rob Wallace,DEM,180910,5,7,96,108,02
Craig,U.S. House,Markwayne Mullin,REP,180910,8,28,194,230,02
Craig,U.S. House,Michael Fulks,IND,180910,1,0,9,10,02
Creek,President,Barack Obama,DEM,190111,9,43,157,209,
Creek,President,Mitt Romney,REP,190111,18,106,473,597,
Creek,U.S. House,Timothy Ray Murray,DEM,190111,8,40,130,178,03
Creek,U.S. House,Frank Lucas,REP,190111,18,100,435,553,03
Creek,U.S. House,William Sanders,IND,190111,0,11,57,68,03
Creek,President,Barack Obama,DEM,190112,2,16,61,79,
Creek,President,Mitt Romney,REP,190112,5,31,171,207,
Creek,U.S. House,Timothy Ray Murray,DEM,190112,1,19,57,77,03
Creek,U.S. House,Frank Lucas,REP,190112,5,25,155,185,03
Creek,U.S. House,William Sanders,IND,190112,0,3,18,21,03
Creek,President,Barack Obama,DEM,190121,11,62,226,299,
Creek,President,Mitt Romney,REP,190121,30,166,651,847,
Creek,U.S. House,Timothy Ray Murray,DEM,190121,14,57,197,268,03
Creek,U.S. House,Frank Lucas,REP,190121,28,151,619,798,03
Creek,U.S. House,William Sanders,IND,190121,1,13,54,68,03
Creek,State House,David Narcomey,DEM,190121,14,59,231,304,29
Creek,State House,Skye Mcniel,REP,190121,29,160,632,821,29
Creek,President,Barack Obama,DEM,190122,1,29,190,220,
Creek,President,Mitt Romney,REP,190122,1,8,47,56,
Creek,U.S. House,Timothy Ray Murray,DEM,190122,1,28,179,208,03
Creek,U.S. House,Frank Lucas,REP,190122,1,9,52,62,03
Creek,U.S. House,William Sanders,IND,190122,0,0,6,6,03
Creek,President,Barack Obama,DEM,190131,4,44,138,186,
Creek,President,Mitt Romney,REP,190131,12,59,268,339,
Creek,U.S. House,Timothy Ray Murray,DEM,190131,1,43,110,154,03
Creek,U.S. House,Frank Lucas,REP,190131,14,54,264,332,03
Creek,U.S. House,William Sanders,IND,190131,1,5,27,33,03
Creek,President,Barack Obama,DEM,190132,9,68,143,220,
Creek,President,Mitt Romney,REP,190132,15,102,457,574,
Creek,U.S. House,Timothy Ray Murray,DEM,190132,8,55,117,180,03
Creek,U.S. House,Frank Lucas,REP,190132,14,110,427,551,03
Creek,U.S. House,William Sanders,IND,190132,0,4,49,53,03
Creek,President,Barack Obama,DEM,190142,25,159,409,593,
Creek,President,Mitt Romney,REP,190142,40,371,905,1316,
Creek,U.S. House,Timothy Ray Murray,DEM,190142,16,131,318,465,03
Creek,U.S. House,Frank Lucas,REP,190142,45,364,893,1302,03
Creek,U.S. House,William Sanders,IND,190142,2,26,83,111,03
Creek,President,Barack Obama,DEM,190143,18,66,216,300,
Creek,President,Mitt Romney,REP,190143,22,139,410,571,
Creek,U.S. House,Timothy Ray Murray,DEM,190143,17,51,180,248,03
Creek,U.S. House,Frank Lucas,REP,190143,18,143,401,562,03
Creek,U.S. House,William Sanders,IND,190143,3,6,40,49,03
Creek,President,Barack Obama,DEM,190211,3,2,138,143,
Creek,President,Mitt Romney,REP,190211,5,14,236,255,
Creek,U.S. House,Timothy Ray Murray,DEM,190211,3,2,108,113,03
Creek,U.S. House,Frank Lucas,REP,190211,5,14,236,255,03
Creek,U.S. House,William Sanders,IND,190211,0,0,25,25,03
Creek,State House,David Narcomey,DEM,190211,2,0,78,80,29
Creek,State House,Skye Mcniel,REP,190211,6,16,295,317,29
Creek,President,Barack Obama,DEM,190221,10,3,186,199,
Creek,President,Mitt Romney,REP,190221,5,3,219,227,
Creek,U.S. House,Timothy Ray Murray,DEM,190221,7,2,169,178,03
Creek,U.S. House,Frank Lucas,REP,190221,4,3,216,223,03
Creek,U.S. House,William Sanders,IND,190221,1,0,19,20,03
Creek,State House,David Narcomey,DEM,190221,8,1,134,143,29
Creek,State House,Skye Mcniel,REP,190221,7,5,271,283,29
Creek,President,Barack Obama,DEM,190231,5,2,154,161,
Creek,President,Mitt Romney,REP,190231,4,7,236,247,
Creek,U.S. House,Timothy Ray Murray,DEM,190231,4,2,126,132,03
Creek,U.S. House,Frank Lucas,REP,190231,4,6,244,254,03
Creek,U.S. House,William Sanders,IND,190231,0,0,10,10,03
Creek,State House,David Narcomey,DEM,190231,4,1,109,114,29
Creek,State House,Skye Mcniel,REP,190231,4,8,276,288,29
Creek,President,Barack Obama,DEM,190241,4,4,96,104,
Creek,President,Mitt Romney,REP,190241,3,8,192,203,
Creek,U.S. House,Timothy Ray Murray,DEM,190241,4,3,74,81,03
Creek,U.S. House,Frank Lucas,REP,190241,3,9,191,203,03
Creek,U.S. House,William Sanders,IND,190241,0,0,20,20,03
Creek,State House,David Narcomey,DEM,190241,4,1,69,74,29
Creek,State House,Skye Mcniel,REP,190241,3,11,218,232,29
Creek,President,Barack Obama,DEM,190311,14,5,230,249,
Creek,President,Mitt Romney,REP,190311,20,13,603,636,
Creek,U.S. House,Timothy Ray Murray,DEM,190311,13,4,199,216,03
Creek,U.S. House,Frank Lucas,REP,190311,16,14,579,609,03
Creek,U.S. House,William Sanders,IND,190311,1,0,52,53,03
Creek,President,Barack Obama,DEM,190401,5,23,147,175,
Creek,President,Mitt Romney,REP,190401,20,75,473,568,
Creek,U.S. House,Timothy Ray Murray,DEM,190401,5,17,124,146,03
Creek,U.S. House,Frank Lucas,REP,190401,19,73,447,539,03
Creek,U.S. House,William Sanders,IND,190401,1,6,46,53,03
Creek,State House,David Narcomey,DEM,190401,4,26,149,179,29
Creek,State House,Skye Mcniel,REP,190401,21,70,467,558,29
Creek,President,Barack Obama,DEM,190402,3,58,162,223,
Creek,President,Mitt Romney,REP,190402,20,146,467,633,
Creek,U.S. House,Timothy Ray Murray,DEM,190402,4,41,139,184,03
Creek,U.S. House,Frank Lucas,REP,190402,18,146,437,601,03
Creek,U.S. House,William Sanders,IND,190402,1,11,42,54,03
Creek,State House,David Narcomey,DEM,190402,4,55,159,218,29
Creek,State House,Skye Mcniel,REP,190402,18,143,454,615,29
Creek,President,Barack Obama,DEM,190403,9,22,167,198,
Creek,President,Mitt Romney,REP,190403,18,49,535,602,
Creek,U.S. House,Timothy Ray Murray,DEM,190403,6,17,150,173,03
Creek,U.S. House,Frank Lucas,REP,190403,19,45,498,562,03
Creek,U.S. House,William Sanders,IND,190403,1,9,45,55,03
Creek,State House,David Narcomey,DEM,190403,6,18,155,179,29
Creek,State House,Skye Mcniel,REP,190403,19,50,537,606,29
Creek,President,Barack Obama,DEM,190404,16,40,353,409,
Creek,President,Mitt Romney,REP,190404,46,66,1119,1231,
Creek,U.S. House,Timothy Ray Murray,DEM,190404,13,31,273,317,03
Creek,U.S. House,Frank Lucas,REP,190404,47,70,1088,1205,03
Creek,U.S. House,William Sanders,IND,190404,3,3,92,98,03
Creek,State House,David Narcomey,DEM,190404,13,34,306,353,29
Creek,State House,Skye Mcniel,REP,190404,50,70,1142,1262,29
Creek,President,Barack Obama,DEM,190405,8,9,180,197,
Creek,President,Mitt Romney,REP,190405,35,48,605,688,
Creek,U.S. House,Timothy Ray Murray,DEM,190405,7,5,168,180,03
Creek,U.S. House,Frank Lucas,REP,190405,34,48,561,643,03
Creek,U.S. House,William Sanders,IND,190405,2,4,55,61,03
Creek,President,Barack Obama,DEM,190406,2,3,124,129,
Creek,President,Mitt Romney,REP,190406,8,4,410,422,
Creek,U.S. House,Timothy Ray Murray,DEM,190406,2,3,125,130,03
Creek,U.S. House,Frank Lucas,REP,190406,8,4,373,385,03
Creek,U.S. House,William Sanders,IND,190406,1,0,28,29,03
Creek,President,Barack Obama,DEM,190407,2,0,92,94,
Creek,President,Mitt Romney,REP,190407,2,11,185,198,
Creek,U.S. House,Timothy Ray Murray,DEM,190407,2,0,71,73,03
Creek,U.S. House,Frank Lucas,REP,190407,2,9,186,197,03
Creek,U.S. House,William Sanders,IND,190407,0,1,19,20,03
Creek,President,Barack Obama,DEM,190408,2,2,72,76,
Creek,President,Mitt Romney,REP,190408,7,12,229,248,
Creek,U.S. House,Timothy Ray Murray,DEM,190408,2,2,65,69,03
Creek,U.S. House,Frank Lucas,REP,190408,6,11,224,241,03
Creek,U.S. House,William Sanders,IND,190408,1,1,11,13,03
Creek,State House,David Narcomey,DEM,190408,2,1,66,69,29
Creek,State House,Skye Mcniel,REP,190408,7,12,235,254,29
Creek,President,Barack Obama,DEM,190409,7,11,217,235,
Creek,President,Mitt Romney,REP,190409,4,20,522,546,
Creek,U.S. House,Timothy Ray Murray,DEM,190409,4,7,178,189,03
Creek,U.S. House,Frank Lucas,REP,190409,7,23,525,555,03
Creek,U.S. House,William Sanders,IND,190409,0,1,31,32,03
Creek,State House,David Narcomey,DEM,190409,2,7,135,144,29
Creek,State House,Skye Mcniel,REP,190409,8,24,606,638,29
Creek,President,Barack Obama,DEM,190410,3,2,44,49,
Creek,President,Mitt Romney,REP,190410,2,0,146,148,
Creek,U.S. House,Timothy Ray Murray,DEM,190410,3,2,43,48,03
Creek,U.S. House,Frank Lucas,REP,190410,2,0,137,139,03
Creek,U.S. House,William Sanders,IND,190410,0,0,7,7,03
Creek,State House,David Narcomey,DEM,190410,3,2,38,43,29
Creek,State House,Skye Mcniel,REP,190410,2,0,149,151,29
Creek,President,Barack Obama,DEM,190411,3,0,156,159,
Creek,President,Mitt Romney,REP,190411,8,5,310,323,
Creek,U.S. House,Timothy Ray Murray,DEM,190411,3,0,134,137,03
Creek,U.S. House,Frank Lucas,REP,190411,6,5,295,306,03
Creek,U.S. House,William Sanders,IND,190411,2,0,32,34,03
Creek,State House,David Narcomey,DEM,190411,2,1,120,123,29
Creek,State House,Skye Mcniel,REP,190411,9,4,348,361,29
Creek,President,Barack Obama,DEM,190412,5,10,114,129,
Creek,President,Mitt Romney,REP,190412,7,10,327,344,
Creek,U.S. House,Timothy Ray Murray,DEM,190412,4,11,99,114,03
Creek,U.S. House,Frank Lucas,REP,190412,7,9,319,335,03
Creek,U.S. House,William Sanders,IND,190412,1,0,16,17,03
Creek,State House,David Narcomey,DEM,190412,6,11,98,115,29
Creek,State House,Skye Mcniel,REP,190412,5,8,346,359,29
Creek,President,Barack Obama,DEM,190413,2,8,192,202,
Creek,President,Mitt Romney,REP,190413,14,16,523,553,
Creek,U.S. House,Timothy Ray Murray,DEM,190413,5,9,172,186,03
Creek,U.S. House,Frank Lucas,REP,190413,11,14,514,539,03
Creek,U.S. House,William Sanders,IND,190413,0,0,29,29,03
Creek,State House,David Narcomey,DEM,190413,3,10,139,152,29
Creek,State House,Skye Mcniel,REP,190413,12,13,575,600,29
Creek,President,Barack Obama,DEM,190414,11,48,292,351,
Creek,President,Mitt Romney,REP,190414,26,177,960,1163,
Creek,U.S. House,Timothy Ray Murray,DEM,190414,9,41,246,296,03
Creek,U.S. House,Frank Lucas,REP,190414,22,175,933,1130,03
Creek,U.S. House,William Sanders,IND,190414,6,11,74,91,03
Creek,State House,David Narcomey,DEM,190414,12,50,246,308,29
Creek,State House,Skye Mcniel,REP,190414,25,177,1005,1207,29
Creek,President,Barack Obama,DEM,190415,1,2,90,93,
Creek,President,Mitt Romney,REP,190415,14,32,274,320,
Creek,U.S. House,John Olson,DEM,190415,1,4,89,94,01
Creek,U.S. House,Jim Bridenstine,REP,190415,14,26,245,285,01
Creek,U.S. House,Craig Allen,IND,190415,0,2,22,24,01
Creek,State House,David Narcomey,DEM,190415,1,1,87,89,29
Creek,State House,Skye Mcniel,REP,190415,13,32,267,312,29
Creek,President,Barack Obama,DEM,190416,1,11,162,174,
Creek,President,Mitt Romney,REP,190416,11,37,541,589,
Creek,U.S. House,John Olson,DEM,190416,0,10,159,169,01
Creek,U.S. House,Jim Bridenstine,REP,190416,12,36,493,541,01
Creek,U.S. House,Craig Allen,IND,190416,0,2,42,44,01
Creek,President,Barack Obama,DEM,190417,7,41,277,325,
Creek,President,Mitt Romney,REP,190417,26,179,965,1170,
Creek,U.S. House,John Olson,DEM,190417,7,44,272,323,01
Creek,U.S. House,Jim Bridenstine,REP,190417,22,168,908,1098,01
Creek,U.S. House,Craig Allen,IND,190417,3,5,52,60,01
Creek,President,Barack Obama,DEM,190418,8,35,186,229,
Creek,President,Mitt Romney,REP,190418,34,129,703,866,
Creek,U.S. House,Timothy Ray Murray,DEM,190418,9,20,166,195,03
Creek,U.S. House,Frank Lucas,REP,190418,29,133,692,854,03
Creek,U.S. House,William Sanders,IND,190418,2,10,23,35,03
Creek,President,Barack Obama,DEM,190419,6,44,177,227,
Creek,President,Mitt Romney,REP,190419,40,83,604,727,
Creek,U.S. House,Timothy Ray Murray,DEM,190419,5,32,131,168,03
Creek,U.S. House,Frank Lucas,REP,190419,39,90,589,718,03
Creek,U.S. House,William Sanders,IND,190419,1,4,51,56,03
Creek,President,Barack Obama,DEM,190420,2,10,116,128,
Creek,President,Mitt Romney,REP,190420,13,44,399,456,
Creek,U.S. House,Timothy Ray Murray,DEM,190420,1,8,90,99,03
Creek,U.S. House,Frank Lucas,REP,190420,13,42,399,454,03
Creek,U.S. House,William Sanders,IND,190420,0,2,22,24,03
Creek,President,Barack Obama,DEM,190421,18,22,205,245,
Creek,President,Mitt Romney,REP,190421,67,35,639,741,
Creek,U.S. House,Timothy Ray Murray,DEM,190421,15,22,175,212,03
Creek,U.S. House,Frank Lucas,REP,190421,62,33,606,701,03
Creek,U.S. House,William Sanders,IND,190421,4,2,50,56,03
Creek,President,Barack Obama,DEM,190422,0,6,113,119,
Creek,President,Mitt Romney,REP,190422,28,24,323,375,
Creek,U.S. House,Timothy Ray Murray,DEM,190422,0,6,86,92,03
Creek,U.S. House,Frank Lucas,REP,190422,25,22,317,364,03
Creek,U.S. House,William Sanders,IND,190422,2,1,30,33,03
Creek,State House,David Narcomey,DEM,190422,1,3,101,105,29
Creek,State House,Skye Mcniel,REP,190422,27,26,332,385,29
Custer,President,Barack Obama,DEM,200001,5,49,174,228,
Custer,President,Mitt Romney,REP,200001,11,71,331,413,
Custer,U.S. House,Timothy Ray Murray,DEM,200001,4,37,121,162,03
Custer,U.S. House,Frank Lucas,REP,200001,10,78,365,453,03
Custer,U.S. House,William Sanders,IND,200001,1,4,19,24,03
Custer,President,Barack Obama,DEM,200003,4,38,200,242,
Custer,President,Mitt Romney,REP,200003,11,110,532,653,
Custer,U.S. House,Timothy Ray Murray,DEM,200003,2,28,105,135,03
Custer,U.S. House,Frank Lucas,REP,200003,11,113,605,729,03
Custer,U.S. House,William Sanders,IND,200003,1,5,22,28,03
Custer,President,Barack Obama,DEM,200005,10,31,146,187,
Custer,President,Mitt Romney,REP,200005,30,111,508,649,
Custer,U.S. House,Timothy Ray Murray,DEM,200005,6,20,89,115,03
Custer,U.S. House,Frank Lucas,REP,200005,32,116,545,693,03
Custer,U.S. House,William Sanders,IND,200005,1,5,23,29,03
Custer,President,Barack Obama,DEM,200007,9,64,137,210,
Custer,President,Mitt Romney,REP,200007,13,73,225,311,
Custer,U.S. House,Timothy Ray Murray,DEM,200007,9,52,88,149,03
Custer,U.S. House,Frank Lucas,REP,200007,13,78,255,346,03
Custer,U.S. House,William Sanders,IND,200007,0,8,18,26,03
Custer,President,Barack Obama,DEM,200012,5,14,66,85,
Custer,President,Mitt Romney,REP,200012,18,57,397,472,
Custer,U.S. House,Timothy Ray Murray,DEM,200012,2,7,40,49,03
Custer,U.S. House,Frank Lucas,REP,200012,19,61,410,490,03
Custer,U.S. House,William Sanders,IND,200012,1,2,13,16,03
Custer,President,Barack Obama,DEM,200013,3,5,49,57,
Custer,President,Mitt Romney,REP,200013,17,18,194,229,
Custer,U.S. House,Timothy Ray Murray,DEM,200013,3,4,29,36,03
Custer,U.S. House,Frank Lucas,REP,200013,17,19,205,241,03
Custer,U.S. House,William Sanders,IND,200013,0,0,9,9,03
Custer,President,Barack Obama,DEM,200018,10,15,234,259,
Custer,President,Mitt Romney,REP,200018,47,102,763,912,
Custer,U.S. House,Timothy Ray Murray,DEM,200018,9,15,144,168,03
Custer,U.S. House,Frank Lucas,REP,200018,44,102,821,967,03
Custer,U.S. House,William Sanders,IND,200018,3,0,33,36,03
Custer,President,Barack Obama,DEM,200019,14,15,226,255,
Custer,President,Mitt Romney,REP,200019,40,72,736,848,
Custer,U.S. House,Timothy Ray Murray,DEM,200019,11,10,139,160,03
Custer,U.S. House,Frank Lucas,REP,200019,43,74,783,900,03
Custer,U.S. House,William Sanders,IND,200019,0,4,42,46,03
Custer,President,Barack Obama,DEM,200020,10,13,188,211,
Custer,President,Mitt Romney,REP,200020,25,63,749,837,
Custer,U.S. House,Timothy Ray Murray,DEM,200020,5,9,127,141,03
Custer,U.S. House,Frank Lucas,REP,200020,28,67,785,880,03
Custer,U.S. House,William Sanders,IND,200020,0,0,22,22,03
Custer,President,Barack Obama,DEM,200021,12,15,388,415,
Custer,President,Mitt Romney,REP,200021,25,42,819,886,
Custer,U.S. House,Timothy Ray Murray,DEM,200021,10,11,285,306,03
Custer,U.S. House,Frank Lucas,REP,200021,26,44,841,911,03
Custer,U.S. House,William Sanders,IND,200021,1,2,77,80,03
Custer,President,Barack Obama,DEM,200022,2,2,28,32,
Custer,President,Mitt Romney,REP,200022,12,17,193,222,
Custer,U.S. House,Timothy Ray Murray,DEM,200022,2,0,19,21,03
Custer,U.S. House,Frank Lucas,REP,200022,12,18,195,225,03
Custer,U.S. House,William Sanders,IND,200022,0,1,7,8,03
Custer,President,Barack Obama,DEM,200023,3,3,113,119,
Custer,President,Mitt Romney,REP,200023,23,16,565,604,
Custer,U.S. House,Timothy Ray Murray,DEM,200023,4,3,61,68,03
Custer,U.S. House,Frank Lucas,REP,200023,21,16,602,639,03
Custer,U.S. House,William Sanders,IND,200023,0,0,16,16,03
Custer,President,Barack Obama,DEM,200026,3,6,50,59,
Custer,President,Mitt Romney,REP,200026,19,38,353,410,
Custer,U.S. House,Timothy Ray Murray,DEM,200026,3,4,24,31,03
Custer,U.S. House,Frank Lucas,REP,200026,18,36,372,426,03
Custer,U.S. House,William Sanders,IND,200026,1,4,6,11,03
Delaware,President,Barack Obama,DEM,210001,10,2,199,211,
Delaware,President,Mitt Romney,REP,210001,54,16,598,668,
Delaware,U.S. House,Rob Wallace,DEM,210001,13,1,200,214,02
Delaware,U.S. House,Markwayne Mullin,REP,210001,51,16,564,631,02
Delaware,U.S. House,Michael Fulks,IND,210001,0,1,28,29,02
Delaware,President,Barack Obama,DEM,210002,4,3,131,138,
Delaware,President,Mitt Romney,REP,210002,15,11,249,275,
Delaware,U.S. House,Rob Wallace,DEM,210002,4,4,141,149,02
Delaware,U.S. House,Markwayne Mullin,REP,210002,13,8,221,242,02
Delaware,U.S. House,Michael Fulks,IND,210002,1,2,10,13,02
Delaware,President,Barack Obama,DEM,210003,12,8,248,268,
Delaware,President,Mitt Romney,REP,210003,48,21,502,571,
Delaware,U.S. House,Rob Wallace,DEM,210003,14,9,232,255,02
Delaware,U.S. House,Markwayne Mullin,REP,210003,45,19,481,545,02
Delaware,U.S. House,Michael Fulks,IND,210003,1,1,33,35,02
Delaware,President,Barack Obama,DEM,210004,8,3,151,162,
Delaware,President,Mitt Romney,REP,210004,17,18,295,330,
Delaware,U.S. House,Rob Wallace,DEM,210004,9,4,153,166,02
Delaware,U.S. House,Markwayne Mullin,REP,210004,14,17,266,297,02
Delaware,U.S. House,Michael Fulks,IND,210004,2,0,20,22,02
Delaware,President,Barack Obama,DEM,210005,18,26,184,228,
Delaware,President,Mitt Romney,REP,210005,42,48,598,688,
Delaware,U.S. House,Rob Wallace,DEM,210005,16,26,189,231,02
Delaware,U.S. House,Markwayne Mullin,REP,210005,40,44,552,636,02
Delaware,U.S. House,Michael Fulks,IND,210005,4,4,29,37,02
Delaware,State Senate,Jim Bynum,DEM,210005,20,28,226,274,3
Delaware,State Senate,Wayne Shaw,REP,210005,39,47,549,635,3
Delaware,President,Barack Obama,DEM,210006,8,14,165,187,
Delaware,President,Mitt Romney,REP,210006,38,31,422,491,
Delaware,U.S. House,Rob Wallace,DEM,210006,7,15,168,190,02
Delaware,U.S. House,Markwayne Mullin,REP,210006,38,30,387,455,02
Delaware,U.S. House,Michael Fulks,IND,210006,2,0,25,27,02
Delaware,State Senate,Jim Bynum,DEM,210006,17,17,209,243,3
Delaware,State Senate,Wayne Shaw,REP,210006,30,28,366,424,3
Delaware,President,Barack Obama,DEM,210007,38,40,327,405,
Delaware,President,Mitt Romney,REP,210007,106,93,932,1131,
Delaware,U.S. House,Rob Wallace,DEM,210007,37,41,327,405,02
Delaware,U.S. House,Markwayne Mullin,REP,210007,98,88,875,1061,02
Delaware,U.S. House,Michael Fulks,IND,210007,7,4,46,57,02
Delaware,State Senate,Jim Bynum,DEM,210007,54,46,414,514,3
Delaware,State Senate,Wayne Shaw,REP,210007,87,83,827,997,3
Delaware,President,Barack Obama,DEM,210008,0,7,85,92,
Delaware,President,Mitt Romney,REP,210008,10,14,226,250,
Delaware,U.S. House,Rob Wallace,DEM,210008,0,9,99,108,02
Delaware,U.S. House,Markwayne Mullin,REP,210008,10,11,198,219,02
Delaware,U.S. House,Michael Fulks,IND,210008,0,1,16,17,02
Delaware,State Senate,Jim Bynum,DEM,210008,0,10,112,122,3
Delaware,State Senate,Wayne Shaw,REP,210008,10,10,198,218,3
Delaware,President,Barack Obama,DEM,210009,22,26,261,309,
Delaware,President,Mitt Romney,REP,210009,77,108,937,1122,
Delaware,U.S. House,Rob Wallace,DEM,210009,24,29,295,348,02
Delaware,U.S. House,Markwayne Mullin,REP,210009,70,102,847,1019,02
Delaware,U.S. House,Michael Fulks,IND,210009,4,2,42,48,02
Delaware,State Senate,Jim Bynum,DEM,210009,31,42,376,449,3
Delaware,State Senate,Wayne Shaw,REP,210009,67,90,808,965,3
Delaware,President,Barack Obama,DEM,210010,0,3,3,6,
Delaware,President,Mitt Romney,REP,210010,2,8,18,28,
Delaware,U.S. House,Rob Wallace,DEM,210010,0,4,6,10,02
Delaware,U.S. House,Markwayne Mullin,REP,210010,2,7,15,24,02
Delaware,U.S. House,Michael Fulks,IND,210010,0,0,0,0,02
Delaware,State House,Will Fourkiller,DEM,210010,2,4,6,12,86
Delaware,State House,Russell Don Turner,REP,210010,0,6,12,18,86
Delaware,President,Barack Obama,DEM,210011,15,18,167,200,
Delaware,President,Mitt Romney,REP,210011,34,40,476,550,
Delaware,U.S. House,Rob Wallace,DEM,210011,15,19,177,211,02
Delaware,U.S. House,Markwayne Mullin,REP,210011,34,39,445,518,02
Delaware,U.S. House,Michael Fulks,IND,210011,0,0,22,22,02
Delaware,State Senate,Jim Bynum,DEM,210011,17,20,221,258,3
Delaware,State Senate,Wayne Shaw,REP,210011,32,38,416,486,3
Delaware,President,Barack Obama,DEM,210012,7,5,148,160,
Delaware,President,Mitt Romney,REP,210012,40,37,291,368,
Delaware,U.S. House,Rob Wallace,DEM,210012,8,7,153,168,02
Delaware,U.S. House,Markwayne Mullin,REP,210012,38,34,257,329,02
Delaware,U.S. House,Michael Fulks,IND,210012,0,1,27,28,02
Delaware,President,Barack Obama,DEM,210014,9,37,175,221,
Delaware,President,Mitt Romney,REP,210014,16,63,274,353,
Delaware,U.S. House,Rob Wallace,DEM,210014,9,37,205,251,02
Delaware,U.S. House,Markwayne Mullin,REP,210014,15,60,222,297,02
Delaware,U.S. House,Michael Fulks,IND,210014,1,1,15,17,02
Delaware,President,Barack Obama,DEM,210015,10,37,191,238,
Delaware,President,Mitt Romney,REP,210015,30,56,383,469,
Delaware,U.S. House,Rob Wallace,DEM,210015,12,38,184,234,02
Delaware,U.S. House,Markwayne Mullin,REP,210015,27,54,364,445,02
Delaware,U.S. House,Michael Fulks,IND,210015,1,1,23,25,02
Delaware,President,Barack Obama,DEM,210016,8,41,161,210,
Delaware,President,Mitt Romney,REP,210016,9,72,207,288,
Delaware,U.S. House,Rob Wallace,DEM,210016,7,44,172,223,02
Delaware,U.S. House,Markwayne Mullin,REP,210016,6,64,177,247,02
Delaware,U.S. House,Michael Fulks,IND,210016,4,4,16,24,02
Delaware,President,Barack Obama,DEM,210017,6,24,92,122,
Delaware,President,Mitt Romney,REP,210017,7,43,129,179,
Delaware,U.S. House,Rob Wallace,DEM,210017,5,26,99,130,02
Delaware,U.S. House,Markwayne Mullin,REP,210017,6,39,109,154,02
Delaware,U.S. House,Michael Fulks,IND,210017,2,2,11,15,02
Delaware,President,Barack Obama,DEM,210018,5,21,96,122,
Delaware,President,Mitt Romney,REP,210018,2,61,225,288,
Delaware,U.S. House,Rob Wallace,DEM,210018,3,27,115,145,02
Delaware,U.S. House,Markwayne Mullin,REP,210018,2,51,195,248,02
Delaware,U.S. House,Michael Fulks,IND,210018,2,2,9,13,02
Delaware,State Senate,Jim Bynum,DEM,210018,5,32,138,175,3
Delaware,State Senate,Wayne Shaw,REP,210018,2,47,180,229,3
Delaware,President,Barack Obama,DEM,210019,20,14,251,285,
Delaware,President,Mitt Romney,REP,210019,32,25,507,564,
Delaware,U.S. House,Rob Wallace,DEM,210019,21,12,306,339,02
Delaware,U.S. House,Markwayne Mullin,REP,210019,30,24,417,471,02
Delaware,U.S. House,Michael Fulks,IND,210019,2,2,29,33,02
Delaware,State Senate,Jim Bynum,DEM,210019,30,18,400,448,3
Delaware,State Senate,Wayne Shaw,REP,210019,23,21,349,393,3
Delaware,State House,Will Fourkiller,DEM,210019,34,29,516,579,86
Delaware,State House,Russell Don Turner,REP,210019,18,8,234,260,86
Delaware,President,Barack Obama,DEM,210020,0,6,107,113,
Delaware,President,Mitt Romney,REP,210020,2,6,92,100,
Delaware,U.S. House,Rob Wallace,DEM,210020,0,6,101,107,02
Delaware,U.S. House,Markwayne Mullin,REP,210020,2,5,93,100,02
Delaware,U.S. House,Michael Fulks,IND,210020,0,0,5,5,02
Delaware,President,Barack Obama,DEM,210021,2,0,42,44,
Delaware,President,Mitt Romney,REP,210021,0,9,99,108,
Delaware,U.S. House,Rob Wallace,DEM,210021,2,0,47,49,02
Delaware,U.S. House,Markwayne Mullin,REP,210021,0,8,83,91,02
Delaware,U.S. House,Michael Fulks,IND,210021,0,1,10,11,02
Delaware,State Senate,Jim Bynum,DEM,210021,2,1,73,76,3
Delaware,State Senate,Wayne Shaw,REP,210021,0,8,66,74,3
Delaware,President,Barack Obama,DEM,210022,13,10,299,322,
Delaware,President,Mitt Romney,REP,210022,30,19,697,746,
Delaware,U.S. House,Rob Wallace,DEM,210022,12,12,370,394,02
Delaware,U.S. House,Markwayne Mullin,REP,210022,30,17,566,613,02
Delaware,U.S. House,Michael Fulks,IND,210022,2,0,53,55,02
Delaware,State Senate,Jim Bynum,DEM,210022,16,10,511,537,3
Delaware,State Senate,Wayne Shaw,REP,210022,26,19,477,522,3
Delaware,State House,Will Fourkiller,DEM,210022,20,12,630,662,86
Delaware,State House,Russell Don Turner,REP,210022,22,17,359,398,86
Delaware,President,Barack Obama,DEM,210023,10,1,142,153,
Delaware,President,Mitt Romney,REP,210023,39,15,459,513,
Delaware,U.S. House,Rob Wallace,DEM,210023,8,1,153,162,02
Delaware,U.S. House,Markwayne Mullin,REP,210023,33,15,419,467,02
Delaware,U.S. House,Michael Fulks,IND,210023,7,1,26,34,02
Delaware,State Senate,Jim Bynum,DEM,210023,19,2,210,231,3
Delaware,State Senate,Wayne Shaw,REP,210023,30,15,384,429,3
Delaware,State House,Will Fourkiller,DEM,210023,20,4,300,324,86
Delaware,State House,Russell Don Turner,REP,210023,29,13,290,332,86
Dewey,President,Barack Obama,DEM,220001,3,6,26,35,
Dewey,President,Mitt Romney,REP,220001,4,33,132,169,
Dewey,U.S. House,Timothy Ray Murray,DEM,220001,1,5,19,25,03
Dewey,U.S. House,Frank Lucas,REP,220001,6,32,130,168,03
Dewey,U.S. House,William Sanders,IND,220001,0,2,8,10,03
Dewey,State Senate,A. Bryce Marlatt,REP,220001,2,31,114,147,27
Dewey,State Senate,Tommy Nicholson,IND,220001,5,8,38,51,27
Dewey,President,Barack Obama,DEM,220002,0,0,8,8,
Dewey,President,Mitt Romney,REP,220002,11,2,73,86,
Dewey,U.S. House,Timothy Ray Murray,DEM,220002,0,0,2,2,03
Dewey,U.S. House,Frank Lucas,REP,220002,11,2,77,90,03
Dewey,U.S. House,William Sanders,IND,220002,0,0,2,2,03
Dewey,State Senate,A. Bryce Marlatt,REP,220002,7,2,56,65,27
Dewey,State Senate,Tommy Nicholson,IND,220002,4,0,21,25,27
Dewey,President,Barack Obama,DEM,220003,2,2,48,52,
Dewey,President,Mitt Romney,REP,220003,13,4,232,249,
Dewey,U.S. House,Timothy Ray Murray,DEM,220003,1,2,24,27,03
Dewey,U.S. House,Frank Lucas,REP,220003,13,4,245,262,03
Dewey,U.S. House,William Sanders,IND,220003,1,0,10,11,03
Dewey,State Senate,A. Bryce Marlatt,REP,220003,13,6,220,239,27
Dewey,State Senate,Tommy Nicholson,IND,220003,2,0,42,44,27
Dewey,President,Barack Obama,DEM,220004,0,0,19,19,
Dewey,President,Mitt Romney,REP,220004,3,2,100,105,
Dewey,U.S. House,Timothy Ray Murray,DEM,220004,0,0,14,14,03
Dewey,U.S. House,Frank Lucas,REP,220004,3,1,96,100,03
Dewey,U.S. House,William Sanders,IND,220004,0,1,9,10,03
Dewey,State Senate,A. Bryce Marlatt,REP,220004,3,2,97,102,27
Dewey,State Senate,Tommy Nicholson,IND,220004,0,0,20,20,27
Dewey,President,Barack Obama,DEM,220005,5,1,68,74,
Dewey,President,Mitt Romney,REP,220005,22,48,408,478,
Dewey,U.S. House,Timothy Ray Murray,DEM,220005,3,1,37,41,03
Dewey,U.S. House,Frank Lucas,REP,220005,23,46,416,485,03
Dewey,U.S. House,William Sanders,IND,220005,1,3,22,26,03
Dewey,State Senate,A. Bryce Marlatt,REP,220005,22,41,388,451,27
Dewey,State Senate,Tommy Nicholson,IND,220005,6,9,72,87,27
Dewey,President,Barack Obama,DEM,220006,0,0,5,5,
Dewey,President,Mitt Romney,REP,220006,3,5,42,50,
Dewey,U.S. House,Timothy Ray Murray,DEM,220006,0,0,2,2,03
Dewey,U.S. House,Frank Lucas,REP,220006,3,5,45,53,03
Dewey,U.S. House,William Sanders,IND,220006,0,0,0,0,03
Dewey,State Senate,A. Bryce Marlatt,REP,220006,3,5,37,45,27
Dewey,State Senate,Tommy Nicholson,IND,220006,0,0,10,10,27
Dewey,President,Barack Obama,DEM,220007,0,2,11,13,
Dewey,President,Mitt Romney,REP,220007,8,1,58,67,
Dewey,U.S. House,Timothy Ray Murray,DEM,220007,0,0,9,9,03
Dewey,U.S. House,Frank Lucas,REP,220007,8,3,58,69,03
Dewey,U.S. House,William Sanders,IND,220007,0,0,2,2,03
Dewey,State Senate,A. Bryce Marlatt,REP,220007,7,2,55,64,27
Dewey,State Senate,Tommy Nicholson,IND,220007,1,1,13,15,27
Dewey,President,Barack Obama,DEM,220008,3,0,61,64,
Dewey,President,Mitt Romney,REP,220008,28,37,358,423,
Dewey,U.S. House,Timothy Ray Murray,DEM,220008,2,0,35,37,03
Dewey,U.S. House,Frank Lucas,REP,220008,28,36,359,423,03
Dewey,U.S. House,William Sanders,IND,220008,1,1,22,24,03
Dewey,State Senate,A. Bryce Marlatt,REP,220008,21,33,323,377,27
Dewey,State Senate,Tommy Nicholson,IND,220008,5,3,78,86,27
Dewey,President,Barack Obama,DEM,220009,2,0,19,21,
Dewey,President,Mitt Romney,REP,220009,9,4,113,126,
Dewey,U.S. House,Timothy Ray Murray,DEM,220009,0,1,14,15,03
Dewey,U.S. House,Frank Lucas,REP,220009,11,3,112,126,03
Dewey,U.S. House,William Sanders,IND,220009,0,0,7,7,03
Dewey,State Senate,A. Bryce Marlatt,REP,220009,7,4,103,114,27
Dewey,State Senate,Tommy Nicholson,IND,220009,4,0,24,28,27
Dewey,President,Barack Obama,DEM,220010,1,1,8,10,
Dewey,President,Mitt Romney,REP,220010,4,1,34,39,
Dewey,U.S. House,Timothy Ray Murray,DEM,220010,0,0,4,4,03
Dewey,U.S. House,Frank Lucas,REP,220010,5,2,36,43,03
Dewey,U.S. House,William Sanders,IND,220010,0,0,1,1,03
Dewey,State Senate,A. Bryce Marlatt,REP,220010,3,1,27,31,27
Dewey,State Senate,Tommy Nicholson,IND,220010,1,1,11,13,27
Ellis,President,Barack Obama,DEM,230001,3,15,43,61,
Ellis,President,Mitt Romney,REP,230001,19,110,222,351,
Ellis,U.S. House,Timothy Ray Murray,DEM,230001,2,14,32,48,03
Ellis,U.S. House,Frank Lucas,REP,230001,18,104,224,346,03
Ellis,U.S. House,William Sanders,IND,230001,2,8,12,22,03
Ellis,State Senate,A. Bryce Marlatt,REP,230001,19,109,206,334,27
Ellis,State Senate,Tommy Nicholson,IND,230001,3,14,52,69,27
Ellis,President,Barack Obama,DEM,230003,4,4,67,75,
Ellis,President,Mitt Romney,REP,230003,25,28,503,556,
Ellis,U.S. House,Timothy Ray Murray,DEM,230003,5,4,42,51,03
Ellis,U.S. House,Frank Lucas,REP,230003,23,29,499,551,03
Ellis,U.S. House,William Sanders,IND,230003,1,0,30,31,03
Ellis,State Senate,A. Bryce Marlatt,REP,230003,22,31,486,539,27
Ellis,State Senate,Tommy Nicholson,IND,230003,6,2,76,84,27
Ellis,President,Barack Obama,DEM,230004,0,2,7,9,
Ellis,President,Mitt Romney,REP,230004,0,3,82,85,
Ellis,U.S. House,Timothy Ray Murray,DEM,230004,0,1,1,2,03
Ellis,U.S. House,Frank Lucas,REP,230004,0,4,83,87,03
Ellis,U.S. House,William Sanders,IND,230004,0,0,5,5,03
Ellis,State Senate,A. Bryce Marlatt,REP,230004,0,3,75,78,27
Ellis,State Senate,Tommy Nicholson,IND,230004,0,1,13,14,27
Ellis,President,Barack Obama,DEM,230006,4,0,4,8,
Ellis,President,Mitt Romney,REP,230006,3,7,37,47,
Ellis,U.S. House,Timothy Ray Murray,DEM,230006,4,0,2,6,03
Ellis,U.S. House,Frank Lucas,REP,230006,3,7,39,49,03
Ellis,U.S. House,William Sanders,IND,230006,0,0,1,1,03
Ellis,State Senate,A. Bryce Marlatt,REP,230006,5,7,41,53,27
Ellis,State Senate,Tommy Nicholson,IND,230006,2,0,1,3,27
Ellis,President,Barack Obama,DEM,230007,1,1,27,29,
Ellis,President,Mitt Romney,REP,230007,10,22,211,243,
Ellis,U.S. House,Timothy Ray Murray,DEM,230007,0,0,14,14,03
Ellis,U.S. House,Frank Lucas,REP,230007,11,22,218,251,03
Ellis,U.S. House,William Sanders,IND,230007,0,1,7,8,03
Ellis,State Senate,A. Bryce Marlatt,REP,230007,10,20,206,236,27
Ellis,State Senate,Tommy Nicholson,IND,230007,1,3,27,31,27
Ellis,President,Barack Obama,DEM,230008,1,1,25,27,
Ellis,President,Mitt Romney,REP,230008,9,5,205,219,
Ellis,U.S. House,Timothy Ray Murray,DEM,230008,0,2,17,19,03
Ellis,U.S. House,Frank Lucas,REP,230008,10,4,207,221,03
Ellis,U.S. House,William Sanders,IND,230008,0,1,6,7,03
Ellis,State Senate,A. Bryce Marlatt,REP,230008,10,5,189,204,27
Ellis,State Senate,Tommy Nicholson,IND,230008,0,2,37,39,27
Ellis,President,Barack Obama,DEM,230009,1,1,15,17,
Ellis,President,Mitt Romney,REP,230009,0,9,65,74,
Ellis,U.S. House,Timothy Ray Murray,DEM,230009,1,0,7,8,03
Ellis,U.S. House,Frank Lucas,REP,230009,0,9,68,77,03
Ellis,U.S. House,William Sanders,IND,230009,0,1,3,4,03
Ellis,State Senate,A. Bryce Marlatt,REP,230009,0,10,64,74,27
Ellis,State Senate,Tommy Nicholson,IND,230009,1,0,12,13,27
Garfield,President,Barack Obama,DEM,240101,15,24,161,200,
Garfield,President,Mitt Romney,REP,240101,17,28,174,219,
Garfield,U.S. House,Timothy Ray Murray,DEM,240101,10,20,129,159,03
Garfield,U.S. House,Frank Lucas,REP,240101,22,29,189,240,03
Garfield,U.S. House,William Sanders,IND,240101,0,2,12,14,03
Garfield,President,Barack Obama,DEM,240102,3,24,211,238,
Garfield,President,Mitt Romney,REP,240102,7,24,296,327,
Garfield,U.S. House,Timothy Ray Murray,DEM,240102,3,15,155,173,03
Garfield,U.S. House,Frank Lucas,REP,240102,7,30,320,357,03
Garfield,U.S. House,William Sanders,IND,240102,0,3,32,35,03
Garfield,President,Barack Obama,DEM,240103,9,34,223,266,
Garfield,President,Mitt Romney,REP,240103,20,39,388,447,
Garfield,U.S. House,Timothy Ray Murray,DEM,240103,7,29,168,204,03
Garfield,U.S. House,Frank Lucas,REP,240103,18,37,401,456,03
Garfield,U.S. House,William Sanders,IND,240103,3,7,43,53,03
Garfield,President,Barack Obama,DEM,240104,11,37,221,269,
Garfield,President,Mitt Romney,REP,240104,15,51,362,428,
Garfield,U.S. House,Timothy Ray Murray,DEM,240104,9,29,165,203,03
Garfield,U.S. House,Frank Lucas,REP,240104,17,59,381,457,03
Garfield,U.S. House,William Sanders,IND,240104,0,1,32,33,03
Garfield,President,Barack Obama,DEM,240105,3,26,127,156,
Garfield,President,Mitt Romney,REP,240105,10,46,291,347,
Garfield,U.S. House,Timothy Ray Murray,DEM,240105,2,18,88,108,03
Garfield,U.S. House,Frank Lucas,REP,240105,11,50,308,369,03
Garfield,U.S. House,William Sanders,IND,240105,0,4,22,26,03
Garfield,President,Barack Obama,DEM,240106,3,6,61,70,
Garfield,President,Mitt Romney,REP,240106,8,8,294,310,
Garfield,U.S. House,Timothy Ray Murray,DEM,240106,2,3,36,41,03
Garfield,U.S. House,Frank Lucas,REP,240106,9,11,304,324,03
Garfield,U.S. House,William Sanders,IND,240106,0,0,14,14,03
Garfield,President,Barack Obama,DEM,240107,0,0,15,15,
Garfield,President,Mitt Romney,REP,240107,3,4,60,67,
Garfield,U.S. House,Timothy Ray Murray,DEM,240107,0,0,7,7,03
Garfield,U.S. House,Frank Lucas,REP,240107,3,4,66,73,03
Garfield,U.S. House,William Sanders,IND,240107,0,0,3,3,03
Garfield,President,Barack Obama,DEM,240108,0,5,19,24,
Garfield,President,Mitt Romney,REP,240108,2,13,85,100,
Garfield,U.S. House,Timothy Ray Murray,DEM,240108,1,3,11,15,03
Garfield,U.S. House,Frank Lucas,REP,240108,1,14,92,107,03
Garfield,U.S. House,William Sanders,IND,240108,0,1,1,2,03
Garfield,President,Barack Obama,DEM,240109,0,2,39,41,
Garfield,President,Mitt Romney,REP,240109,7,13,200,220,
Garfield,U.S. House,Timothy Ray Murray,DEM,240109,0,2,33,35,03
Garfield,U.S. House,Frank Lucas,REP,240109,7,13,199,219,03
Garfield,U.S. House,William Sanders,IND,240109,0,0,5,5,03
Garfield,President,Barack Obama,DEM,240110,11,36,134,181,
Garfield,President,Mitt Romney,REP,240110,30,84,383,497,
Garfield,U.S. House,Timothy Ray Murray,DEM,240110,6,23,79,108,03
Garfield,U.S. House,Frank Lucas,REP,240110,26,86,412,524,03
Garfield,U.S. House,William Sanders,IND,240110,6,11,21,38,03
Garfield,President,Barack Obama,DEM,240201,16,65,313,394,
Garfield,President,Mitt Romney,REP,240201,54,147,715,916,
Garfield,U.S. House,Timothy Ray Murray,DEM,240201,12,45,224,281,03
Garfield,U.S. House,Frank Lucas,REP,240201,56,158,755,969,03
Garfield,U.S. House,William Sanders,IND,240201,0,8,49,57,03
Garfield,President,Barack Obama,DEM,240202,18,45,251,314,
Garfield,President,Mitt Romney,REP,240202,75,134,717,926,
Garfield,U.S. House,Timothy Ray Murray,DEM,240202,15,33,167,215,03
Garfield,U.S. House,Frank Lucas,REP,240202,73,137,762,972,03
Garfield,U.S. House,William Sanders,IND,240202,1,5,38,44,03
Garfield,President,Barack Obama,DEM,240203,8,40,115,163,
Garfield,President,Mitt Romney,REP,240203,9,48,292,349,
Garfield,U.S. House,Timothy Ray Murray,DEM,240203,6,25,87,118,03
Garfield,U.S. House,Frank Lucas,REP,240203,11,58,298,367,03
Garfield,U.S. House,William Sanders,IND,240203,0,5,23,28,03
Garfield,President,Barack Obama,DEM,240204,7,52,248,307,
Garfield,President,Mitt Romney,REP,240204,54,179,862,1095,
Garfield,U.S. House,Timothy Ray Murray,DEM,240204,3,37,157,197,03
Garfield,U.S. House,Frank Lucas,REP,240204,52,179,897,1128,03
Garfield,U.S. House,William Sanders,IND,240204,4,9,48,61,03
Garfield,President,Barack Obama,DEM,240206,4,18,176,198,
Garfield,President,Mitt Romney,REP,240206,5,38,430,473,
Garfield,U.S. House,Timothy Ray Murray,DEM,240206,2,12,111,125,03
Garfield,U.S. House,Frank Lucas,REP,240206,6,43,449,498,03
Garfield,U.S. House,William Sanders,IND,240206,1,2,44,47,03
Garfield,President,Barack Obama,DEM,240207,3,5,92,100,
Garfield,President,Mitt Romney,REP,240207,11,30,449,490,
Garfield,U.S. House,Timothy Ray Murray,DEM,240207,2,2,81,85,03
Garfield,U.S. House,Frank Lucas,REP,240207,12,31,448,491,03
Garfield,U.S. House,William Sanders,IND,240207,0,2,14,16,03
Garfield,President,Barack Obama,DEM,240208,0,0,11,11,
Garfield,President,Mitt Romney,REP,240208,4,6,105,115,
Garfield,U.S. House,Timothy Ray Murray,DEM,240208,0,0,13,13,03
Garfield,U.S. House,Frank Lucas,REP,240208,4,6,102,112,03
Garfield,U.S. House,William Sanders,IND,240208,0,0,2,2,03
Garfield,President,Barack Obama,DEM,240210,0,1,98,99,
Garfield,President,Mitt Romney,REP,240210,9,3,291,303,
Garfield,U.S. House,Timothy Ray Murray,DEM,240210,0,0,61,61,03
Garfield,U.S. House,Frank Lucas,REP,240210,9,4,310,323,03
Garfield,U.S. House,William Sanders,IND,240210,0,0,16,16,03
Garfield,President,Barack Obama,DEM,240211,3,8,69,80,
Garfield,President,Mitt Romney,REP,240211,18,15,409,442,
Garfield,U.S. House,Timothy Ray Murray,DEM,240211,3,4,47,54,03
Garfield,U.S. House,Frank Lucas,REP,240211,18,18,414,450,03
Garfield,U.S. House,William Sanders,IND,240211,0,1,14,15,03
Garfield,President,Barack Obama,DEM,240212,3,3,59,65,
Garfield,President,Mitt Romney,REP,240212,12,7,287,306,
Garfield,U.S. House,Timothy Ray Murray,DEM,240212,3,2,30,35,03
Garfield,U.S. House,Frank Lucas,REP,240212,11,7,302,320,03
Garfield,U.S. House,William Sanders,IND,240212,1,0,12,13,03
Garfield,President,Barack Obama,DEM,240301,2,25,110,137,
Garfield,President,Mitt Romney,REP,240301,25,85,379,489,
Garfield,U.S. House,Timothy Ray Murray,DEM,240301,2,20,79,101,03
Garfield,U.S. House,Frank Lucas,REP,240301,25,86,385,496,03
Garfield,U.S. House,William Sanders,IND,240301,0,4,22,26,03
Garfield,President,Barack Obama,DEM,240302,18,68,272,358,
Garfield,President,Mitt Romney,REP,240302,78,216,962,1256,
Garfield,U.S. House,Timothy Ray Murray,DEM,240302,14,54,178,246,03
Garfield,U.S. House,Frank Lucas,REP,240302,71,216,998,1285,03
Garfield,U.S. House,William Sanders,IND,240302,6,14,49,69,03
Garfield,President,Barack Obama,DEM,240304,17,50,176,243,
Garfield,President,Mitt Romney,REP,240304,63,221,838,1122,
Garfield,U.S. House,Timothy Ray Murray,DEM,240304,17,33,109,159,03
Garfield,U.S. House,Frank Lucas,REP,240304,56,227,860,1143,03
Garfield,U.S. House,William Sanders,IND,240304,4,11,42,57,03
Garfield,President,Barack Obama,DEM,240305,12,63,138,213,
Garfield,President,Mitt Romney,REP,240305,83,230,727,1040,
Garfield,U.S. House,Timothy Ray Murray,DEM,240305,11,40,91,142,03
Garfield,U.S. House,Frank Lucas,REP,240305,81,242,729,1052,03
Garfield,U.S. House,William Sanders,IND,240305,3,10,46,59,03
Garfield,President,Barack Obama,DEM,240306,5,17,113,135,
Garfield,President,Mitt Romney,REP,240306,16,79,416,511,
Garfield,U.S. House,Timothy Ray Murray,DEM,240306,3,15,86,104,03
Garfield,U.S. House,Frank Lucas,REP,240306,14,78,415,507,03
Garfield,U.S. House,William Sanders,IND,240306,1,2,26,29,03
Garfield,President,Barack Obama,DEM,240307,13,6,27,46,
Garfield,President,Mitt Romney,REP,240307,45,16,196,257,
Garfield,U.S. House,Timothy Ray Murray,DEM,240307,7,3,16,26,03
Garfield,U.S. House,Frank Lucas,REP,240307,48,18,195,261,03
Garfield,U.S. House,William Sanders,IND,240307,2,1,12,15,03
Garfield,President,Barack Obama,DEM,240308,7,16,45,68,
Garfield,President,Mitt Romney,REP,240308,38,88,382,508,
Garfield,U.S. House,Timothy Ray Murray,DEM,240308,5,11,26,42,03
Garfield,U.S. House,Frank Lucas,REP,240308,39,87,381,507,03
Garfield,U.S. House,William Sanders,IND,240308,0,5,15,20,03
Garfield,President,Barack Obama,DEM,240309,1,3,62,66,
Garfield,President,Mitt Romney,REP,240309,16,28,375,419,
Garfield,U.S. House,Timothy Ray Murray,DEM,240309,1,2,41,44,03
Garfield,U.S. House,Frank Lucas,REP,240309,16,27,376,419,03
Garfield,U.S. House,William Sanders,IND,240309,0,2,21,23,03
Garfield,President,Barack Obama,DEM,240310,6,7,80,93,
Garfield,President,Mitt Romney,REP,240310,16,49,396,461,
Garfield,U.S. House,Timothy Ray Murray,DEM,240310,3,5,62,70,03
Garfield,U.S. House,Frank Lucas,REP,240310,16,50,397,463,03
Garfield,U.S. House,William Sanders,IND,240310,2,1,16,19,03
Garfield,President,Barack Obama,DEM,240311,2,30,151,183,
Garfield,President,Mitt Romney,REP,240311,28,81,628,737,
Garfield,U.S. House,Timothy Ray Murray,DEM,240311,2,21,107,130,03
Garfield,U.S. House,Frank Lucas,REP,240311,29,83,639,751,03
Garfield,U.S. House,William Sanders,IND,240311,0,7,27,34,03
Garvin,President,Barack Obama,DEM,250001,3,0,96,99,
Garvin,President,Mitt Romney,REP,250001,11,5,316,332,
Garvin,U.S. House,Donna Marie Bebo,DEM,250001,1,0,87,88,04
Garvin,U.S. House,Tom Cole,REP,250001,13,5,303,321,04
Garvin,U.S. House,Rj Harris,IND,250001,0,0,19,19,04
Garvin,State Senate,Mike Fullerton,DEM,250001,3,0,117,120,43
Garvin,State Senate,Corey Brooks,REP,250001,11,5,287,303,43
Garvin,State House,Steven Vines,DEM,250001,0,0,77,77,42
Garvin,State House,Lisa Billy,REP,250001,14,5,332,351,42
Garvin,President,Barack Obama,DEM,250002,5,2,96,103,
Garvin,President,Mitt Romney,REP,250002,13,9,404,426,
Garvin,U.S. House,Donna Marie Bebo,DEM,250002,3,1,79,83,04
Garvin,U.S. House,Tom Cole,REP,250002,14,10,395,419,04
Garvin,U.S. House,Rj Harris,IND,250002,1,0,23,24,04
Garvin,State Senate,Mike Fullerton,DEM,250002,3,4,125,132,43
Garvin,State Senate,Corey Brooks,REP,250002,14,7,364,385,43
Garvin,State House,Steven Vines,DEM,250002,1,1,79,81,42
Garvin,State House,Lisa Billy,REP,250002,16,10,413,439,42
Garvin,President,Barack Obama,DEM,250003,2,2,114,118,
Garvin,President,Mitt Romney,REP,250003,13,17,418,448,
Garvin,U.S. House,Donna Marie Bebo,DEM,250003,1,2,95,98,04
Garvin,U.S. House,Tom Cole,REP,250003,14,17,408,439,04
Garvin,U.S. House,Rj Harris,IND,250003,0,0,27,27,04
Garvin,State Senate,Mike Fullerton,DEM,250003,3,3,165,171,43
Garvin,State Senate,Corey Brooks,REP,250003,11,16,356,383,43
Garvin,State House,Steven Vines,DEM,250003,1,1,97,99,42
Garvin,State House,Lisa Billy,REP,250003,13,18,429,460,42
Garvin,President,Barack Obama,DEM,250005,3,17,105,125,
Garvin,President,Mitt Romney,REP,250005,13,48,593,654,
Garvin,U.S. House,Donna Marie Bebo,DEM,250005,5,18,91,114,04
Garvin,U.S. House,Tom Cole,REP,250005,10,47,580,637,04
Garvin,U.S. House,Rj Harris,IND,250005,1,1,27,29,04
Garvin,State Senate,Susan Paddack,DEM,250005,11,44,468,523,13
Garvin,State Senate,Fred Smith,REP,250005,5,22,233,260,13
Garvin,State House,Steven Vines,DEM,250005,5,12,102,119,42
Garvin,State House,Lisa Billy,REP,250005,11,52,599,662,42
Garvin,President,Barack Obama,DEM,250006,0,3,116,119,
Garvin,President,Mitt Romney,REP,250006,5,14,206,225,
Garvin,U.S. House,Donna Marie Bebo,DEM,250006,0,3,105,108,04
Garvin,U.S. House,Tom Cole,REP,250006,3,13,195,211,04
Garvin,U.S. House,Rj Harris,IND,250006,2,1,20,23,04
Garvin,State Senate,Susan Paddack,DEM,250006,0,8,246,254,13
Garvin,State Senate,Fred Smith,REP,250006,5,9,72,86,13
Garvin,State House,Steven Vines,DEM,250006,0,4,107,111,42
Garvin,State House,Lisa Billy,REP,250006,5,13,213,231,42
Garvin,President,Barack Obama,DEM,250007,7,26,89,122,
Garvin,President,Mitt Romney,REP,250007,8,79,227,314,
Garvin,U.S. House,Donna Marie Bebo,DEM,250007,6,24,83,113,04
Garvin,U.S. House,Tom Cole,REP,250007,9,75,229,313,04
Garvin,U.S. House,Rj Harris,IND,250007,0,5,5,10,04
Garvin,State Senate,Susan Paddack,DEM,250007,9,74,235,318,13
Garvin,State Senate,Fred Smith,REP,250007,6,29,80,115,13
Garvin,State House,Steven Vines,DEM,250007,8,26,67,101,42
Garvin,State House,Lisa Billy,REP,250007,7,78,248,333,42
Garvin,President,Barack Obama,DEM,250008,2,17,121,140,
Garvin,President,Mitt Romney,REP,250008,14,62,264,340,
Garvin,U.S. House,Donna Marie Bebo,DEM,250008,2,15,96,113,04
Garvin,U.S. House,Tom Cole,REP,250008,14,63,268,345,04
Garvin,U.S. House,Rj Harris,IND,250008,0,1,22,23,04
Garvin,State Senate,Susan Paddack,DEM,250008,10,47,280,337,13
Garvin,State Senate,Fred Smith,REP,250008,6,30,102,138,13
Garvin,State House,Steven Vines,DEM,250008,2,15,93,110,42
Garvin,State House,Lisa Billy,REP,250008,14,64,293,371,42
Garvin,President,Barack Obama,DEM,250009,7,21,185,213,
Garvin,President,Mitt Romney,REP,250009,8,43,497,548,
Garvin,U.S. House,Donna Marie Bebo,DEM,250009,6,21,167,194,04
Garvin,U.S. House,Tom Cole,REP,250009,9,42,484,535,04
Garvin,U.S. House,Rj Harris,IND,250009,0,1,31,32,04
Garvin,State Senate,Susan Paddack,DEM,250009,12,48,505,565,13
Garvin,State Senate,Fred Smith,REP,250009,3,16,174,193,13
Garvin,State House,Steven Vines,DEM,250009,6,10,127,143,42
Garvin,State House,Lisa Billy,REP,250009,9,54,556,619,42
Garvin,President,Barack Obama,DEM,250013,2,3,65,70,
Garvin,President,Mitt Romney,REP,250013,9,17,195,221,
Garvin,U.S. House,Donna Marie Bebo,DEM,250013,5,3,66,74,04
Garvin,U.S. House,Tom Cole,REP,250013,6,17,187,210,04
Garvin,U.S. House,Rj Harris,IND,250013,0,0,7,7,04
Garvin,State Senate,Susan Paddack,DEM,250013,9,10,172,191,13
Garvin,State Senate,Fred Smith,REP,250013,2,10,88,100,13
Garvin,State House,Brian Spencer,DEM,250013,4,3,104,111,48
Garvin,State House,Patrick Ownbey,REP,250013,5,17,152,174,48
Garvin,President,Barack Obama,DEM,250015,3,30,138,171,
Garvin,President,Mitt Romney,REP,250015,19,87,351,457,
Garvin,U.S. House,Donna Marie Bebo,DEM,250015,5,28,108,141,04
Garvin,U.S. House,Tom Cole,REP,250015,17,88,356,461,04
Garvin,U.S. House,Rj Harris,IND,250015,0,3,17,20,04
Garvin,State Senate,Susan Paddack,DEM,250015,11,79,374,464,13
Garvin,State Senate,Fred Smith,REP,250015,10,40,105,155,13
Garvin,State House,Steven Vines,DEM,250015,3,22,112,137,42
Garvin,State House,Lisa Billy,REP,250015,18,97,371,486,42
Garvin,President,Barack Obama,DEM,250016,2,13,109,124,
Garvin,President,Mitt Romney,REP,250016,17,71,330,418,
Garvin,U.S. House,Donna Marie Bebo,DEM,250016,3,12,111,126,04
Garvin,U.S. House,Tom Cole,REP,250016,16,67,314,397,04
Garvin,U.S. House,Rj Harris,IND,250016,0,3,9,12,04
Garvin,State Senate,Susan Paddack,DEM,250016,11,56,300,367,13
Garvin,State Senate,Fred Smith,REP,250016,7,27,133,167,13
Garvin,State House,Steven Vines,DEM,250016,3,20,123,146,42
Garvin,State House,Lisa Billy,REP,250016,15,62,308,385,42
Garvin,President,Barack Obama,DEM,250017,12,49,169,230,
Garvin,President,Mitt Romney,REP,250017,11,52,240,303,
Garvin,U.S. House,Donna Marie Bebo,DEM,250017,9,47,145,201,04
Garvin,U.S. House,Tom Cole,REP,250017,10,49,250,309,04
Garvin,U.S. House,Rj Harris,IND,250017,1,4,14,19,04
Garvin,State Senate,Susan Paddack,DEM,250017,15,78,342,435,13
Garvin,State Senate,Fred Smith,REP,250017,4,22,68,94,13
Garvin,State House,Steven Vines,DEM,250017,9,38,131,178,42
Garvin,State House,Lisa Billy,REP,250017,10,62,277,349,42
Garvin,President,Barack Obama,DEM,250018,20,53,236,309,
Garvin,President,Mitt Romney,REP,250018,37,178,526,741,
Garvin,U.S. House,Donna Marie Bebo,DEM,250018,16,52,230,298,04
Garvin,U.S. House,Tom Cole,REP,250018,36,174,498,708,04
Garvin,U.S. House,Rj Harris,IND,250018,2,5,35,42,04
Garvin,State Senate,Susan Paddack,DEM,250018,37,161,561,759,13
Garvin,State Senate,Fred Smith,REP,250018,17,68,195,280,13
Garvin,State House,Matt Branstetter,DEM,250018,21,84,324,429,20
Garvin,State House,Bobby Cleveland,REP,250018,33,143,427,603,20
Garvin,President,Barack Obama,DEM,250020,7,19,292,318,
Garvin,President,Mitt Romney,REP,250020,8,46,526,580,
Garvin,U.S. House,Donna Marie Bebo,DEM,250020,7,16,247,270,04
Garvin,U.S. House,Tom Cole,REP,250020,8,48,544,600,04
Garvin,U.S. House,Rj Harris,IND,250020,0,0,22,22,04
Garvin,State Senate,Susan Paddack,DEM,250020,10,35,583,628,13
Garvin,State Senate,Fred Smith,REP,250020,5,29,227,261,13
Garvin,State House,Doris Anne Row,DEM,250020,8,24,423,455,22
Garvin,State House,Charles Mccall,REP,250020,7,40,398,445,22
Garvin,President,Barack Obama,DEM,250021,0,0,9,9,
Garvin,President,Mitt Romney,REP,250021,0,1,8,9,
Garvin,U.S. House,Donna Marie Bebo,DEM,250021,0,0,9,9,04
Garvin,U.S. House,Tom Cole,REP,250021,0,1,7,8,04
Garvin,U.S. House,Rj Harris,IND,250021,0,0,1,1,04
Garvin,State Senate,Susan Paddack,DEM,250021,0,0,9,9,13
Garvin,State Senate,Fred Smith,REP,250021,0,1,6,7,13
Garvin,State House,Matt Branstetter,DEM,250021,0,0,9,9,20
Garvin,State House,Bobby Cleveland,REP,250021,0,1,7,8,20
Garvin,President,Barack Obama,DEM,250024,7,7,163,177,
Garvin,President,Mitt Romney,REP,250024,21,25,490,536,
Garvin,U.S. House,Donna Marie Bebo,DEM,250024,7,7,143,157,04
Garvin,U.S. House,Tom Cole,REP,250024,19,22,488,529,04
Garvin,U.S. House,Rj Harris,IND,250024,1,1,21,23,04
Garvin,State Senate,Susan Paddack,DEM,250024,17,17,486,520,13
Garvin,State Senate,Fred Smith,REP,250024,10,13,162,185,13
Garvin,State House,Doris Anne Row,DEM,250024,10,9,336,355,22
Garvin,State House,Charles Mccall,REP,250024,17,20,310,347,22
Garvin,President,Barack Obama,DEM,250025,9,14,89,112,
Garvin,President,Mitt Romney,REP,250025,28,33,312,373,
Garvin,U.S. House,Donna Marie Bebo,DEM,250025,7,11,82,100,04
Garvin,U.S. House,Tom Cole,REP,250025,29,32,310,371,04
Garvin,U.S. House,Rj Harris,IND,250025,5,3,14,22,04
Garvin,State Senate,Susan Paddack,DEM,250025,29,34,275,338,13
Garvin,State Senate,Fred Smith,REP,250025,9,13,124,146,13
Garvin,State House,Matt Branstetter,DEM,250025,10,19,147,176,20
Garvin,State House,Bobby Cleveland,REP,250025,30,27,246,303,20
Grady,President,Barack Obama,DEM,260001,17,35,154,206,
Grady,President,Mitt Romney,REP,260001,31,64,415,510,
Grady,U.S. House,Donna Marie Bebo,DEM,260001,16,29,128,173,04
Grady,U.S. House,Tom Cole,REP,260001,29,67,415,511,04
Grady,U.S. House,Rj Harris,IND,260001,3,3,19,25,04
Grady,State House,David Perryman,DEM,260001,24,46,269,339,56
Grady,State House,Chuck Utsler,REP,260001,23,53,292,368,56
Grady,President,Barack Obama,DEM,260002,15,37,167,219,
Grady,President,Mitt Romney,REP,260002,23,83,557,663,
Grady,U.S. House,Donna Marie Bebo,DEM,260002,12,33,133,178,04
Grady,U.S. House,Tom Cole,REP,260002,24,84,569,677,04
Grady,U.S. House,Rj Harris,IND,260002,1,4,16,21,04
Grady,State House,David Perryman,DEM,260002,21,60,321,402,56
Grady,State House,Chuck Utsler,REP,260002,17,60,396,473,56
Grady,President,Barack Obama,DEM,260003,9,30,234,273,
Grady,President,Mitt Romney,REP,260003,15,77,423,515,
Grady,U.S. House,Donna Marie Bebo,DEM,260003,6,28,184,218,04
Grady,U.S. House,Tom Cole,REP,260003,13,82,444,539,04
Grady,U.S. House,Rj Harris,IND,260003,5,0,29,34,04
Grady,State House,Stewart Meyer,DEM,260003,11,64,398,473,51
Grady,State House,Scott Biggs,REP,260003,13,46,260,319,51
Grady,President,Barack Obama,DEM,260005,13,52,195,260,
Grady,President,Mitt Romney,REP,260005,14,47,197,258,
Grady,U.S. House,Donna Marie Bebo,DEM,260005,12,45,173,230,04
Grady,U.S. House,Tom Cole,REP,260005,14,48,201,263,04
Grady,U.S. House,Rj Harris,IND,260005,0,5,17,22,04
Grady,State House,David Perryman,DEM,260005,13,66,257,336,56
Grady,State House,Chuck Utsler,REP,260005,13,33,136,182,56
Grady,President,Barack Obama,DEM,260006,14,40,203,257,
Grady,President,Mitt Romney,REP,260006,21,61,346,428,
Grady,U.S. House,Donna Marie Bebo,DEM,260006,11,27,186,224,04
Grady,U.S. House,Tom Cole,REP,260006,24,66,334,424,04
Grady,U.S. House,Rj Harris,IND,260006,0,7,24,31,04
Grady,State House,David Perryman,DEM,260006,16,51,301,368,56
Grady,State House,Chuck Utsler,REP,260006,19,49,247,315,56
Grady,President,Barack Obama,DEM,260008,9,39,192,240,
Grady,President,Mitt Romney,REP,260008,18,36,308,362,
Grady,U.S. House,Donna Marie Bebo,DEM,260008,11,35,157,203,04
Grady,U.S. House,Tom Cole,REP,260008,15,38,309,362,04
Grady,U.S. House,Rj Harris,IND,260008,0,4,34,38,04
Grady,State House,David Perryman,DEM,260008,12,47,259,318,56
Grady,State House,Chuck Utsler,REP,260008,15,28,236,279,56
Grady,President,Barack Obama,DEM,260009,12,70,239,321,
Grady,President,Mitt Romney,REP,260009,31,90,442,563,
Grady,U.S. House,Donna Marie Bebo,DEM,260009,13,61,204,278,04
Grady,U.S. House,Tom Cole,REP,260009,29,92,446,567,04
Grady,U.S. House,Rj Harris,IND,260009,2,5,27,34,04
Grady,State House,David Perryman,DEM,260009,17,77,354,448,56
Grady,State House,Chuck Utsler,REP,260009,27,81,326,434,56
Grady,President,Barack Obama,DEM,260011,3,20,67,90,
Grady,President,Mitt Romney,REP,260011,12,69,228,309,
Grady,U.S. House,Donna Marie Bebo,DEM,260011,2,18,70,90,04
Grady,U.S. House,Tom Cole,REP,260011,11,67,210,288,04
Grady,U.S. House,Rj Harris,IND,260011,1,4,15,20,04
Grady,State House,Stewart Meyer,DEM,260011,6,53,152,211,51
Grady,State House,Scott Biggs,REP,260011,7,36,144,187,51
Grady,President,Barack Obama,DEM,260016,2,2,28,32,
Grady,President,Mitt Romney,REP,260016,4,2,121,127,
Grady,U.S. House,Donna Marie Bebo,DEM,260016,1,0,28,29,04
Grady,U.S. House,Tom Cole,REP,260016,4,4,116,124,04
Grady,U.S. House,Rj Harris,IND,260016,1,0,3,4,04
Grady,State Senate,Mike Fullerton,DEM,260016,2,2,39,43,43
Grady,State Senate,Corey Brooks,REP,260016,4,2,106,112,43
Grady,State House,Stewart Meyer,DEM,260016,2,2,84,88,51
Grady,State House,Scott Biggs,REP,260016,4,2,63,69,51
Grady,President,Barack Obama,DEM,260017,0,3,49,52,
Grady,President,Mitt Romney,REP,260017,4,13,191,208,
Grady,U.S. House,Donna Marie Bebo,DEM,260017,0,3,37,40,04
Grady,U.S. House,Tom Cole,REP,260017,4,10,193,207,04
Grady,U.S. House,Rj Harris,IND,260017,0,2,6,8,04
Grady,State House,David Perryman,DEM,260017,2,5,111,118,56
Grady,State House,Chuck Utsler,REP,260017,2,9,122,133,56
Grady,President,Barack Obama,DEM,260020,7,18,67,92,
Grady,President,Mitt Romney,REP,260020,13,22,211,246,
Grady,U.S. House,Donna Marie Bebo,DEM,260020,6,15,62,83,04
Grady,U.S. House,Tom Cole,REP,260020,12,25,204,241,04
Grady,U.S. House,Rj Harris,IND,260020,2,0,11,13,04
Grady,State House,Stewart Meyer,DEM,260020,12,21,176,209,51
Grady,State House,Scott Biggs,REP,260020,6,20,101,127,51
Grady,President,Barack Obama,DEM,260021,2,3,66,71,
Grady,President,Mitt Romney,REP,260021,6,12,193,211,
Grady,U.S. House,Donna Marie Bebo,DEM,260021,2,4,59,65,04
Grady,U.S. House,Tom Cole,REP,260021,6,12,188,206,04
Grady,U.S. House,Rj Harris,IND,260021,0,0,10,10,04
Grady,State House,David Perryman,DEM,260021,1,9,83,93,56
Grady,State House,Chuck Utsler,REP,260021,6,7,175,188,56
Grady,President,Barack Obama,DEM,260023,1,4,31,36,
Grady,President,Mitt Romney,REP,260023,8,6,86,100,
Grady,U.S. House,Donna Marie Bebo,DEM,260023,1,4,25,30,04
Grady,U.S. House,Tom Cole,REP,260023,8,6,88,102,04
Grady,U.S. House,Rj Harris,IND,260023,0,0,4,4,04
Grady,State Senate,Mike Fullerton,DEM,260023,1,5,37,43,43
Grady,State Senate,Corey Brooks,REP,260023,8,5,79,92,43
Grady,State House,Stewart Meyer,DEM,260023,4,8,63,75,51
Grady,State House,Scott Biggs,REP,260023,5,2,54,61,51
Grady,President,Barack Obama,DEM,260025,1,14,99,114,
Grady,President,Mitt Romney,REP,260025,13,28,287,328,
Grady,U.S. House,Donna Marie Bebo,DEM,260025,0,10,86,96,04
Grady,U.S. House,Tom Cole,REP,260025,13,30,293,336,04
Grady,U.S. House,Rj Harris,IND,260025,1,2,6,9,04
Grady,State House,Stewart Meyer,DEM,260025,1,19,177,197,51
Grady,State House,Scott Biggs,REP,260025,13,23,209,245,51
Grady,President,Barack Obama,DEM,260026,2,1,39,42,
Grady,President,Mitt Romney,REP,260026,12,5,119,136,
Grady,U.S. House,Donna Marie Bebo,DEM,260026,2,0,35,37,04
Grady,U.S. House,Tom Cole,REP,260026,11,6,120,137,04
Grady,U.S. House,Rj Harris,IND,260026,1,0,4,5,04
Grady,State Senate,Mike Fullerton,DEM,260026,2,3,58,63,43
Grady,State Senate,Corey Brooks,REP,260026,12,3,100,115,43
Grady,State House,Stewart Meyer,DEM,260026,4,2,67,73,51
Grady,State House,Scott Biggs,REP,260026,10,4,91,105,51
Grady,President,Barack Obama,DEM,260027,5,16,67,88,
Grady,President,Mitt Romney,REP,260027,8,46,212,266,
Grady,U.S. House,Donna Marie Bebo,DEM,260027,5,17,53,75,04
Grady,U.S. House,Tom Cole,REP,260027,7,44,214,265,04
Grady,U.S. House,Rj Harris,IND,260027,0,1,13,14,04
Grady,State House,David Perryman,DEM,260027,7,26,112,145,56
Grady,State House,Chuck Utsler,REP,260027,4,36,170,210,56
Grady,President,Barack Obama,DEM,260028,6,8,161,175,
Grady,President,Mitt Romney,REP,260028,21,42,506,569,
Grady,U.S. House,Donna Marie Bebo,DEM,260028,4,10,122,136,04
Grady,U.S. House,Tom Cole,REP,260028,20,40,505,565,04
Grady,U.S. House,Rj Harris,IND,260028,1,0,38,39,04
Grady,State House,Stewart Meyer,DEM,260028,6,15,215,236,51
Grady,State House,Scott Biggs,REP,260028,20,35,445,500,51
Grady,President,Barack Obama,DEM,260029,7,12,219,238,
Grady,President,Mitt Romney,REP,260029,26,33,816,875,
Grady,U.S. House,Donna Marie Bebo,DEM,260029,5,11,176,192,04
Grady,U.S. House,Tom Cole,REP,260029,28,34,820,882,04
Grady,U.S. House,Rj Harris,IND,260029,1,0,36,37,04
Grady,State House,David Perryman,DEM,260029,10,16,252,278,56
Grady,State House,Chuck Utsler,REP,260029,24,29,777,830,56
Grady,President,Barack Obama,DEM,260031,2,5,96,103,
Grady,President,Mitt Romney,REP,260031,14,25,304,343,
Grady,U.S. House,Donna Marie Bebo,DEM,260031,2,2,82,86,04
Grady,U.S. House,Tom Cole,REP,260031,12,23,299,334,04
Grady,U.S. House,Rj Harris,IND,260031,1,4,16,21,04
Grady,State House,Stewart Meyer,DEM,260031,5,8,140,153,51
Grady,State House,Scott Biggs,REP,260031,10,21,255,286,51
Grady,President,Barack Obama,DEM,260032,10,17,179,206,
Grady,President,Mitt Romney,REP,260032,26,84,504,614,
Grady,U.S. House,Donna Marie Bebo,DEM,260032,8,19,144,171,04
Grady,U.S. House,Tom Cole,REP,260032,27,82,510,619,04
Grady,U.S. House,Rj Harris,IND,260032,1,1,24,26,04
Grady,State House,Stewart Meyer,DEM,260032,19,36,402,457,51
Grady,State House,Scott Biggs,REP,260032,18,66,276,360,51
Grady,President,Barack Obama,DEM,260033,1,4,47,52,
Grady,President,Mitt Romney,REP,260033,5,9,163,177,
Grady,U.S. House,Donna Marie Bebo,DEM,260033,3,1,50,54,04
Grady,U.S. House,Tom Cole,REP,260033,3,10,150,163,04
Grady,U.S. House,Rj Harris,IND,260033,0,2,10,12,04
Grady,State House,David Perryman,DEM,260033,5,6,96,107,56
Grady,State House,Chuck Utsler,REP,260033,1,7,110,118,56
Grady,President,Barack Obama,DEM,260035,0,0,31,31,
Grady,President,Mitt Romney,REP,260035,5,10,115,130,
Grady,U.S. House,Donna Marie Bebo,DEM,260035,0,1,27,28,04
Grady,U.S. House,Tom Cole,REP,260035,5,10,107,122,04
Grady,U.S. House,Rj Harris,IND,260035,0,0,7,7,04
Grady,State House,David Perryman,DEM,260035,0,3,44,47,56
Grady,State House,Chuck Utsler,REP,260035,5,8,101,114,56
Grady,President,Barack Obama,DEM,260036,6,6,274,286,
Grady,President,Mitt Romney,REP,260036,33,37,735,805,
Grady,U.S. House,Donna Marie Bebo,DEM,260036,6,7,229,242,04
Grady,U.S. House,Tom Cole,REP,260036,33,35,721,789,04
Grady,U.S. House,Rj Harris,IND,260036,0,1,47,48,04
Grady,State Senate,Mike Fullerton,DEM,260036,9,12,371,392,43
Grady,State Senate,Corey Brooks,REP,260036,30,31,620,681,43
Grady,President,Barack Obama,DEM,260037,22,14,293,329,
Grady,President,Mitt Romney,REP,260037,138,120,1350,1608,
Grady,U.S. House,Donna Marie Bebo,DEM,260037,13,17,254,284,04
Grady,U.S. House,Tom Cole,REP,260037,140,109,1324,1573,04
Grady,U.S. House,Rj Harris,IND,260037,6,6,65,77,04
Grady,State House,Stewart Meyer,DEM,260037,23,19,407,449,51
Grady,State House,Scott Biggs,REP,260037,135,108,1218,1461,51
Grady,President,Barack Obama,DEM,260038,20,7,256,283,
Grady,President,Mitt Romney,REP,260038,52,58,1112,1222,
Grady,U.S. House,Donna Marie Bebo,DEM,260038,18,6,212,236,04
Grady,U.S. House,Tom Cole,REP,260038,52,56,1075,1183,04
Grady,U.S. House,Rj Harris,IND,260038,2,2,82,86,04
Grady,State House,Stewart Meyer,DEM,260038,27,6,356,389,51
Grady,State House,Scott Biggs,REP,260038,45,57,1004,1106,51
Grady,President,Barack Obama,DEM,260039,9,5,172,186,
Grady,President,Mitt Romney,REP,260039,28,41,751,820,
Grady,U.S. House,Donna Marie Bebo,DEM,260039,6,6,137,149,04
Grady,U.S. House,Tom Cole,REP,260039,25,39,731,795,04
Grady,U.S. House,Rj Harris,IND,260039,2,1,49,52,04
Grady,State House,Stewart Meyer,DEM,260039,7,8,259,274,51
Grady,State House,Scott Biggs,REP,260039,26,38,649,713,51
Grady,President,Barack Obama,DEM,260040,21,16,237,274,
Grady,President,Mitt Romney,REP,260040,84,77,1109,1270,
Grady,U.S. House,Donna Marie Bebo,DEM,260040,17,18,199,234,04
Grady,U.S. House,Tom Cole,REP,260040,84,73,1097,1254,04
Grady,U.S. House,Rj Harris,IND,260040,4,1,43,48,04
Grady,State House,Leon Pivinski,DEM,260040,26,24,303,353,47
Grady,State House,Leslie Kathryn Osborn,REP,260040,78,68,1033,1179,47
Grady,President,Barack Obama,DEM,260041,8,11,211,230,
Grady,President,Mitt Romney,REP,260041,57,40,1073,1170,
Grady,U.S. House,Donna Marie Bebo,DEM,260041,5,11,163,179,04
Grady,U.S. House,Tom Cole,REP,260041,58,40,1059,1157,04
Grady,U.S. House,Rj Harris,IND,260041,2,0,53,55,04
Grady,State House,Leon Pivinski,DEM,260041,5,13,223,241,47
Grady,State House,Leslie Kathryn Osborn,REP,260041,59,37,1038,1134,47
Grant,President,Barack Obama,DEM,270011,2,1,31,34,
Grant,President,Mitt Romney,REP,270011,0,4,86,90,
Grant,U.S. House,Timothy Ray Murray,DEM,270011,1,0,16,17,03
Grant,U.S. House,Frank Lucas,REP,270011,1,4,97,102,03
Grant,U.S. House,William Sanders,IND,270011,0,1,7,8,03
Grant,President,Barack Obama,DEM,270017,4,0,29,33,
Grant,President,Mitt Romney,REP,270017,20,6,211,237,
Grant,U.S. House,Timothy Ray Murray,DEM,270017,3,0,24,27,03
Grant,U.S. House,Frank Lucas,REP,270017,20,6,215,241,03
Grant,U.S. House,William Sanders,IND,270017,1,0,3,4,03
Grant,President,Barack Obama,DEM,270023,3,2,93,98,
Grant,President,Mitt Romney,REP,270023,12,18,372,402,
Grant,U.S. House,Timothy Ray Murray,DEM,270023,2,0,58,60,03
Grant,U.S. House,Frank Lucas,REP,270023,12,19,390,421,03
Grant,U.S. House,William Sanders,IND,270023,1,1,13,15,03
Grant,President,Barack Obama,DEM,270025,4,0,54,58,
Grant,President,Mitt Romney,REP,270025,18,9,199,226,
Grant,U.S. House,Timothy Ray Murray,DEM,270025,2,0,31,33,03
Grant,U.S. House,Frank Lucas,REP,270025,15,9,217,241,03
Grant,U.S. House,William Sanders,IND,270025,6,0,5,11,03
Grant,President,Barack Obama,DEM,270026,3,0,54,57,
Grant,President,Mitt Romney,REP,270026,6,7,211,224,
Grant,U.S. House,Timothy Ray Murray,DEM,270026,2,0,41,43,03
Grant,U.S. House,Frank Lucas,REP,270026,6,7,213,226,03
Grant,U.S. House,William Sanders,IND,270026,1,0,10,11,03
Grant,President,Barack Obama,DEM,270029,1,4,34,39,
Grant,President,Mitt Romney,REP,270029,5,24,139,168,
Grant,U.S. House,Timothy Ray Murray,DEM,270029,0,5,16,21,03
Grant,U.S. House,Frank Lucas,REP,270029,6,22,150,178,03
Grant,U.S. House,William Sanders,IND,270029,0,2,6,8,03
Grant,President,Barack Obama,DEM,270030,3,19,52,74,
Grant,President,Mitt Romney,REP,270030,23,49,256,328,
Grant,U.S. House,Timothy Ray Murray,DEM,270030,2,13,34,49,03
Grant,U.S. House,Frank Lucas,REP,270030,22,50,263,335,03
Grant,U.S. House,William Sanders,IND,270030,2,4,10,16,03
Greer,President,Barack Obama,DEM,280101,6,25,106,137,
Greer,President,Mitt Romney,REP,280101,16,70,247,333,
Greer,U.S. House,Timothy Ray Murray,DEM,280101,5,20,81,106,03
Greer,U.S. House,Frank Lucas,REP,280101,18,70,260,348,03
Greer,U.S. House,William Sanders,IND,280101,0,4,16,20,03
Greer,President,Barack Obama,DEM,280102,3,23,133,159,
Greer,President,Mitt Romney,REP,280102,18,49,310,377,
Greer,U.S. House,Timothy Ray Murray,DEM,280102,3,18,101,122,03
Greer,U.S. House,Frank Lucas,REP,280102,17,51,327,395,03
Greer,U.S. House,William Sanders,IND,280102,0,2,14,16,03
Greer,President,Barack Obama,DEM,280103,1,0,5,6,
Greer,President,Mitt Romney,REP,280103,2,7,14,23,
Greer,U.S. House,Timothy Ray Murray,DEM,280103,1,1,1,3,03
Greer,U.S. House,Frank Lucas,REP,280103,2,6,18,26,03
Greer,U.S. House,William Sanders,IND,280103,0,0,0,0,03
Greer,President,Barack Obama,DEM,280105,0,2,21,23,
Greer,President,Mitt Romney,REP,280105,2,5,58,65,
Greer,U.S. House,Timothy Ray Murray,DEM,280105,0,1,16,17,03
Greer,U.S. House,Frank Lucas,REP,280105,2,6,60,68,03
Greer,U.S. House,William Sanders,IND,280105,0,0,1,1,03
Greer,President,Barack Obama,DEM,280106,0,0,8,8,
Greer,President,Mitt Romney,REP,280106,1,13,57,71,
Greer,U.S. House,Timothy Ray Murray,DEM,280106,0,0,4,4,03
Greer,U.S. House,Frank Lucas,REP,280106,1,12,58,71,03
Greer,U.S. House,William Sanders,IND,280106,0,1,3,4,03
Greer,President,Barack Obama,DEM,280202,0,5,88,93,
Greer,President,Mitt Romney,REP,280202,9,22,272,303,
Greer,U.S. House,Timothy Ray Murray,DEM,280202,0,5,60,65,03
Greer,U.S. House,Frank Lucas,REP,280202,9,22,286,317,03
Greer,U.S. House,William Sanders,IND,280202,0,0,11,11,03
Greer,President,Barack Obama,DEM,280203,1,1,45,47,
Greer,President,Mitt Romney,REP,280203,7,14,110,131,
Greer,U.S. House,Timothy Ray Murray,DEM,280203,1,2,30,33,03
Greer,U.S. House,Frank Lucas,REP,280203,7,10,119,136,03
Greer,U.S. House,William Sanders,IND,280203,0,2,4,6,03
Greer,President,Barack Obama,DEM,280302,2,2,11,15,
Greer,President,Mitt Romney,REP,280302,2,8,31,41,
Greer,U.S. House,Timothy Ray Murray,DEM,280302,0,0,10,10,03
Greer,U.S. House,Frank Lucas,REP,280302,5,10,30,45,03
Greer,U.S. House,William Sanders,IND,280302,0,0,3,3,03
Harmon,President,Barack Obama,DEM,290101,0,0,15,15,
Harmon,President,Mitt Romney,REP,290101,2,1,32,35,
Harmon,U.S. House,Timothy Ray Murray,DEM,290101,0,0,12,12,03
Harmon,U.S. House,Frank Lucas,REP,290101,2,1,33,36,03
Harmon,U.S. House,William Sanders,IND,290101,0,0,1,1,03
Harmon,President,Barack Obama,DEM,290102,3,14,65,82,
Harmon,President,Mitt Romney,REP,290102,13,38,188,239,
Harmon,U.S. House,Timothy Ray Murray,DEM,290102,2,14,47,63,03
Harmon,U.S. House,Frank Lucas,REP,290102,12,36,201,249,03
Harmon,U.S. House,William Sanders,IND,290102,2,1,3,6,03
Harmon,President,Barack Obama,DEM,290201,0,14,64,78,
Harmon,President,Mitt Romney,REP,290201,5,31,96,132,
Harmon,U.S. House,Timothy Ray Murray,DEM,290201,0,10,38,48,03
Harmon,U.S. House,Frank Lucas,REP,290201,5,32,117,154,03
Harmon,U.S. House,William Sanders,IND,290201,0,1,3,4,03
Harmon,President,Barack Obama,DEM,290203,1,5,4,10,
Harmon,President,Mitt Romney,REP,290203,0,7,14,21,
Harmon,U.S. House,Timothy Ray Murray,DEM,290203,1,2,3,6,03
Harmon,U.S. House,Frank Lucas,REP,290203,0,9,14,23,03
Harmon,U.S. House,William Sanders,IND,290203,0,1,1,2,03
Harmon,President,Barack Obama,DEM,290204,0,1,6,7,
Harmon,President,Mitt Romney,REP,290204,1,5,13,19,
Harmon,U.S. House,Timothy Ray Murray,DEM,290204,0,0,2,2,03
Harmon,U.S. House,Frank Lucas,REP,290204,1,6,17,24,03
Harmon,U.S. House,William Sanders,IND,290204,0,0,0,0,03
Harmon,President,Barack Obama,DEM,290301,0,2,48,50,
Harmon,President,Mitt Romney,REP,290301,12,11,76,99,
Harmon,U.S. House,Timothy Ray Murray,DEM,290301,0,2,42,44,03
Harmon,U.S. House,Frank Lucas,REP,290301,11,11,80,102,03
Harmon,U.S. House,William Sanders,IND,290301,1,0,2,3,03
Harmon,President,Barack Obama,DEM,290302,1,0,21,22,
Harmon,President,Mitt Romney,REP,290302,2,6,106,114,
Harmon,U.S. House,Timothy Ray Murray,DEM,290302,2,0,18,20,03
Harmon,U.S. House,Frank Lucas,REP,290302,1,5,104,110,03
Harmon,U.S. House,William Sanders,IND,290302,0,1,2,3,03
Harper,President,Barack Obama,DEM,300201,1,1,49,51,
Harper,President,Mitt Romney,REP,300201,17,24,452,493,
Harper,U.S. House,Timothy Ray Murray,DEM,300201,1,1,32,34,03
Harper,U.S. House,Frank Lucas,REP,300201,16,22,460,498,03
Harper,U.S. House,William Sanders,IND,300201,0,2,9,11,03
Harper,State Senate,A. Bryce Marlatt,REP,300201,17,19,443,479,27
Harper,State Senate,Tommy Nicholson,IND,300201,0,5,49,54,27
Harper,President,Barack Obama,DEM,300203,2,0,18,20,
Harper,President,Mitt Romney,REP,300203,4,2,96,102,
Harper,U.S. House,Timothy Ray Murray,DEM,300203,2,1,10,13,03
Harper,U.S. House,Frank Lucas,REP,300203,4,1,102,107,03
Harper,U.S. House,William Sanders,IND,300203,0,0,2,2,03
Harper,State Senate,A. Bryce Marlatt,REP,300203,6,1,96,103,27
Harper,State Senate,Tommy Nicholson,IND,300203,0,1,16,17,27
Harper,President,Barack Obama,DEM,300301,1,4,40,45,
Harper,President,Mitt Romney,REP,300301,9,27,205,241,
Harper,U.S. House,Timothy Ray Murray,DEM,300301,1,2,25,28,03
Harper,U.S. House,Frank Lucas,REP,300301,9,29,209,247,03
Harper,U.S. House,William Sanders,IND,300301,0,0,9,9,03
Harper,State Senate,A. Bryce Marlatt,REP,300301,9,29,194,232,27
Harper,State Senate,Tommy Nicholson,IND,300301,1,2,42,45,27
Harper,President,Barack Obama,DEM,300302,0,1,3,4,
Harper,President,Mitt Romney,REP,300302,1,6,44,51,
Harper,U.S. House,Timothy Ray Murray,DEM,300302,0,1,1,2,03
Harper,U.S. House,Frank Lucas,REP,300302,1,6,46,53,03
Harper,U.S. House,William Sanders,IND,300302,0,0,0,0,03
Harper,State Senate,A. Bryce Marlatt,REP,300302,1,6,46,53,27
Harper,State Senate,Tommy Nicholson,IND,300302,0,1,1,2,27
Harper,President,Barack Obama,DEM,300303,0,0,2,2,
Harper,President,Mitt Romney,REP,300303,3,14,90,107,
Harper,U.S. House,Timothy Ray Murray,DEM,300303,0,1,0,1,03
Harper,U.S. House,Frank Lucas,REP,300303,3,12,88,103,03
Harper,U.S. House,William Sanders,IND,300303,0,1,3,4,03
Harper,State Senate,A. Bryce Marlatt,REP,300303,3,11,83,97,27
Harper,State Senate,Tommy Nicholson,IND,300303,0,3,9,12,27
Harper,President,Barack Obama,DEM,300402,7,11,33,51,
Harper,President,Mitt Romney,REP,300402,9,35,223,267,
Harper,U.S. House,Timothy Ray Murray,DEM,300402,3,6,20,29,03
Harper,U.S. House,Frank Lucas,REP,300402,10,38,226,274,03
Harper,U.S. House,William Sanders,IND,300402,1,2,7,10,03
Harper,State Senate,A. Bryce Marlatt,REP,300402,10,30,197,237,27
Harper,State Senate,Tommy Nicholson,IND,300402,4,14,47,65,27
Haskell,President,Barack Obama,DEM,310007,1,0,58,59,
Haskell,President,Mitt Romney,REP,310007,4,7,175,186,
Haskell,U.S. House,Rob Wallace,DEM,310007,1,0,93,94,02
Haskell,U.S. House,Markwayne Mullin,REP,310007,3,7,129,139,02
Haskell,U.S. House,Michael Fulks,IND,310007,0,0,11,11,02
Haskell,State Senate,J. Paul Lane,DEM,310007,1,0,104,105,7
Haskell,State Senate,Larry Boggs,REP,310007,4,7,129,140,7
Haskell,President,Barack Obama,DEM,310009,1,0,28,29,
Haskell,President,Mitt Romney,REP,310009,2,2,67,71,
Haskell,U.S. House,Rob Wallace,DEM,310009,1,2,35,38,02
Haskell,U.S. House,Markwayne Mullin,REP,310009,1,0,58,59,02
Haskell,U.S. House,Michael Fulks,IND,310009,0,0,1,1,02
Haskell,State Senate,J. Paul Lane,DEM,310009,1,1,29,31,7
Haskell,State Senate,Larry Boggs,REP,310009,1,1,64,66,7
Haskell,President,Barack Obama,DEM,310011,4,8,27,39,
Haskell,President,Mitt Romney,REP,310011,2,19,89,110,
Haskell,U.S. House,Rob Wallace,DEM,310011,4,11,45,60,02
Haskell,U.S. House,Markwayne Mullin,REP,310011,2,17,68,87,02
Haskell,U.S. House,Michael Fulks,IND,310011,0,0,3,3,02
Haskell,State Senate,J. Paul Lane,DEM,310011,3,13,43,59,7
Haskell,State Senate,Larry Boggs,REP,310011,3,12,72,87,7
Haskell,President,Barack Obama,DEM,310015,11,14,61,86,
Haskell,President,Mitt Romney,REP,310015,4,29,181,214,
Haskell,U.S. House,Rob Wallace,DEM,310015,12,18,77,107,02
Haskell,U.S. House,Markwayne Mullin,REP,310015,3,25,151,179,02
Haskell,U.S. House,Michael Fulks,IND,310015,0,1,11,12,02
Haskell,State Senate,J. Paul Lane,DEM,310015,12,19,82,113,7
Haskell,State Senate,Larry Boggs,REP,310015,3,26,156,185,7
Haskell,President,Barack Obama,DEM,310016,7,22,76,105,
Haskell,President,Mitt Romney,REP,310016,19,46,207,272,
Haskell,U.S. House,Rob Wallace,DEM,310016,10,28,113,151,02
Haskell,U.S. House,Markwayne Mullin,REP,310016,17,36,157,210,02
Haskell,U.S. House,Michael Fulks,IND,310016,0,1,13,14,02
Haskell,State Senate,J. Paul Lane,DEM,310016,10,26,115,151,7
Haskell,State Senate,Larry Boggs,REP,310016,17,39,168,224,7
Haskell,President,Barack Obama,DEM,310019,6,9,119,134,
Haskell,President,Mitt Romney,REP,310019,7,21,267,295,
Haskell,U.S. House,Rob Wallace,DEM,310019,7,8,162,177,02
Haskell,U.S. House,Markwayne Mullin,REP,310019,7,21,209,237,02
Haskell,U.S. House,Michael Fulks,IND,310019,0,1,14,15,02
Haskell,State Senate,J. Paul Lane,DEM,310019,6,6,149,161,7
Haskell,State Senate,Larry Boggs,REP,310019,8,23,233,264,7
Haskell,President,Barack Obama,DEM,310023,1,14,161,176,
Haskell,President,Mitt Romney,REP,310023,19,28,312,359,
Haskell,U.S. House,Rob Wallace,DEM,310023,3,16,220,239,02
Haskell,U.S. House,Markwayne Mullin,REP,310023,16,23,244,283,02
Haskell,U.S. House,Michael Fulks,IND,310023,0,2,13,15,02
Haskell,State Senate,J. Paul Lane,DEM,310023,6,18,216,240,7
Haskell,State Senate,Larry Boggs,REP,310023,13,24,260,297,7
Haskell,President,Barack Obama,DEM,310027,10,27,109,146,
Haskell,President,Mitt Romney,REP,310027,17,81,382,480,
Haskell,U.S. House,Rob Wallace,DEM,310027,8,41,175,224,02
Haskell,U.S. House,Markwayne Mullin,REP,310027,18,62,302,382,02
Haskell,U.S. House,Michael Fulks,IND,310027,1,3,9,13,02
Haskell,State Senate,J. Paul Lane,DEM,310027,11,43,177,231,7
Haskell,State Senate,Larry Boggs,REP,310027,16,64,308,388,7
Haskell,President,Barack Obama,DEM,310030,3,14,85,102,
Haskell,President,Mitt Romney,REP,310030,16,53,245,314,
Haskell,U.S. House,Rob Wallace,DEM,310030,4,15,121,140,02
Haskell,U.S. House,Markwayne Mullin,REP,310030,14,44,198,256,02
Haskell,U.S. House,Michael Fulks,IND,310030,1,5,14,20,02
Haskell,State Senate,J. Paul Lane,DEM,310030,3,17,115,135,7
Haskell,State Senate,Larry Boggs,REP,310030,16,48,213,277,7
Haskell,President,Barack Obama,DEM,310031,11,21,169,201,
Haskell,President,Mitt Romney,REP,310031,19,37,405,461,
Haskell,U.S. House,Rob Wallace,DEM,310031,12,27,223,262,02
Haskell,U.S. House,Markwayne Mullin,REP,310031,18,31,331,380,02
Haskell,U.S. House,Michael Fulks,IND,310031,0,0,19,19,02
Haskell,State Senate,J. Paul Lane,DEM,310031,16,26,235,277,7
Haskell,State Senate,Larry Boggs,REP,310031,18,32,337,387,7
Haskell,President,Barack Obama,DEM,310032,8,9,81,98,
Haskell,President,Mitt Romney,REP,310032,2,30,275,307,
Haskell,U.S. House,Rob Wallace,DEM,310032,7,11,121,139,02
Haskell,U.S. House,Markwayne Mullin,REP,310032,3,28,223,254,02
Haskell,U.S. House,Michael Fulks,IND,310032,0,0,10,10,02
Haskell,State Senate,J. Paul Lane,DEM,310032,8,17,119,144,7
Haskell,State Senate,Larry Boggs,REP,310032,2,22,235,259,7
Hughes,President,Barack Obama,DEM,320010,0,0,0,0,
Hughes,President,Mitt Romney,REP,320010,0,0,0,0,
Hughes,U.S. House,Rob Wallace,DEM,320010,0,0,0,0,02
Hughes,U.S. House,Markwayne Mullin,REP,320010,0,0,0,0,02
Hughes,U.S. House,Michael Fulks,IND,320010,0,0,0,0,02
Hughes,State Senate,J. Paul Lane,DEM,320010,0,0,0,0,7
Hughes,State Senate,Larry Boggs,REP,320010,0,0,0,0,7
Hughes,President,Barack Obama,DEM,320011,8,25,129,162,
Hughes,President,Mitt Romney,REP,320011,19,61,278,358,
Hughes,U.S. House,Rob Wallace,DEM,320011,9,41,174,224,02
Hughes,U.S. House,Markwayne Mullin,REP,320011,12,40,213,265,02
Hughes,U.S. House,Michael Fulks,IND,320011,5,2,11,18,02
Hughes,State Senate,Susan Paddack,DEM,320011,12,67,302,381,13
Hughes,State Senate,Fred Smith,REP,320011,15,17,96,128,13
Hughes,President,Barack Obama,DEM,320012,7,21,83,111,
Hughes,President,Mitt Romney,REP,320012,18,29,176,223,
Hughes,U.S. House,Rob Wallace,DEM,320012,12,25,114,151,02
Hughes,U.S. House,Markwayne Mullin,REP,320012,13,22,130,165,02
Hughes,U.S. House,Michael Fulks,IND,320012,0,3,11,14,02
Hughes,State Senate,Susan Paddack,DEM,320012,20,37,188,245,13
Hughes,State Senate,Fred Smith,REP,320012,6,14,69,89,13
Hughes,President,Barack Obama,DEM,320016,0,8,35,43,
Hughes,President,Mitt Romney,REP,320016,0,15,77,92,
Hughes,U.S. House,Rob Wallace,DEM,320016,0,10,42,52,02
Hughes,U.S. House,Markwayne Mullin,REP,320016,0,12,60,72,02
Hughes,U.S. House,Michael Fulks,IND,320016,0,0,8,8,02
Hughes,State Senate,J. Paul Lane,DEM,320016,0,8,33,41,7
Hughes,State Senate,Larry Boggs,REP,320016,0,14,75,89,7
Hughes,President,Barack Obama,DEM,320018,1,5,39,45,
Hughes,President,Mitt Romney,REP,320018,7,12,150,169,
Hughes,U.S. House,Rob Wallace,DEM,320018,2,7,71,80,02
Hughes,U.S. House,Markwayne Mullin,REP,320018,5,9,115,129,02
Hughes,U.S. House,Michael Fulks,IND,320018,1,1,3,5,02
Hughes,State Senate,J. Paul Lane,DEM,320018,2,6,80,88,7
Hughes,State Senate,Larry Boggs,REP,320018,6,11,108,125,7
Hughes,President,Barack Obama,DEM,320019,0,0,20,20,
Hughes,President,Mitt Romney,REP,320019,3,4,59,66,
Hughes,U.S. House,Rob Wallace,DEM,320019,0,1,29,30,02
Hughes,U.S. House,Markwayne Mullin,REP,320019,3,3,41,47,02
Hughes,U.S. House,Michael Fulks,IND,320019,0,0,7,7,02
Hughes,State Senate,Susan Paddack,DEM,320019,2,3,63,68,13
Hughes,State Senate,Fred Smith,REP,320019,1,1,14,16,13
Hughes,President,Barack Obama,DEM,320020,4,9,229,242,
Hughes,President,Mitt Romney,REP,320020,18,25,355,398,
Hughes,U.S. House,Rob Wallace,DEM,320020,3,14,289,306,02
Hughes,U.S. House,Markwayne Mullin,REP,320020,18,20,271,309,02
Hughes,U.S. House,Michael Fulks,IND,320020,1,0,18,19,02
Hughes,State Senate,J. Paul Lane,DEM,320020,4,13,280,297,7
Hughes,State Senate,Larry Boggs,REP,320020,18,21,299,338,7
Hughes,President,Barack Obama,DEM,320021,6,8,94,108,
Hughes,President,Mitt Romney,REP,320021,6,19,124,149,
Hughes,U.S. House,Rob Wallace,DEM,320021,7,12,116,135,02
Hughes,U.S. House,Markwayne Mullin,REP,320021,4,13,87,104,02
Hughes,U.S. House,Michael Fulks,IND,320021,1,0,9,10,02
Hughes,State Senate,Susan Paddack,DEM,320021,8,19,169,196,13
Hughes,State Senate,Fred Smith,REP,320021,4,6,48,58,13
Hughes,President,Barack Obama,DEM,320022,3,2,99,104,
Hughes,President,Mitt Romney,REP,320022,7,6,134,147,
Hughes,U.S. House,Rob Wallace,DEM,320022,5,3,117,125,02
Hughes,U.S. House,Markwayne Mullin,REP,320022,5,5,102,112,02
Hughes,U.S. House,Michael Fulks,IND,320022,0,0,12,12,02
Hughes,State Senate,J. Paul Lane,DEM,320022,5,0,115,120,7
Hughes,State Senate,Larry Boggs,REP,320022,5,6,116,127,7
Hughes,President,Barack Obama,DEM,320023,0,4,39,43,
Hughes,President,Mitt Romney,REP,320023,7,5,66,78,
Hughes,U.S. House,Rob Wallace,DEM,320023,2,5,43,50,02
Hughes,U.S. House,Markwayne Mullin,REP,320023,5,4,54,63,02
Hughes,U.S. House,Michael Fulks,IND,320023,0,0,5,5,02
Hughes,State Senate,J. Paul Lane,DEM,320023,3,4,50,57,7
Hughes,State Senate,Larry Boggs,REP,320023,4,5,52,61,7
Hughes,President,Barack Obama,DEM,320030,0,1,54,55,
Hughes,President,Mitt Romney,REP,320030,3,4,100,107,
Hughes,U.S. House,Rob Wallace,DEM,320030,0,4,66,70,02
Hughes,U.S. House,Markwayne Mullin,REP,320030,3,1,78,82,02
Hughes,U.S. House,Michael Fulks,IND,320030,0,0,8,8,02
Hughes,State Senate,Susan Paddack,DEM,320030,2,4,122,128,13
Hughes,State Senate,Fred Smith,REP,320030,1,1,32,34,13
Hughes,President,Barack Obama,DEM,320031,2,1,59,62,
Hughes,President,Mitt Romney,REP,320031,6,5,166,177,
Hughes,U.S. House,Rob Wallace,DEM,320031,2,2,91,95,02
Hughes,U.S. House,Markwayne Mullin,REP,320031,4,3,120,127,02
Hughes,U.S. House,Michael Fulks,IND,320031,1,0,9,10,02
Hughes,State Senate,J. Paul Lane,DEM,320031,3,2,78,83,7
Hughes,State Senate,Larry Boggs,REP,320031,4,3,146,153,7
Hughes,President,Barack Obama,DEM,320032,0,3,81,84,
Hughes,President,Mitt Romney,REP,320032,8,8,129,145,
Hughes,U.S. House,Rob Wallace,DEM,320032,0,3,115,118,02
Hughes,U.S. House,Markwayne Mullin,REP,320032,5,8,88,101,02
Hughes,U.S. House,Michael Fulks,IND,320032,3,0,8,11,02
Hughes,State Senate,J. Paul Lane,DEM,320032,0,7,121,128,7
Hughes,State Senate,Larry Boggs,REP,320032,8,4,94,106,7
Hughes,President,Barack Obama,DEM,320033,2,0,27,29,
Hughes,President,Mitt Romney,REP,320033,2,9,190,201,
Hughes,U.S. House,Rob Wallace,DEM,320033,2,1,71,74,02
Hughes,U.S. House,Markwayne Mullin,REP,320033,2,8,134,144,02
Hughes,U.S. House,Michael Fulks,IND,320033,0,0,12,12,02
Hughes,State Senate,J. Paul Lane,DEM,320033,2,0,67,69,7
Hughes,State Senate,Larry Boggs,REP,320033,2,9,150,161,7
Hughes,President,Barack Obama,DEM,320034,3,3,41,47,
Hughes,President,Mitt Romney,REP,320034,0,2,115,117,
Hughes,U.S. House,Rob Wallace,DEM,320034,2,3,61,66,02
Hughes,U.S. House,Markwayne Mullin,REP,320034,0,2,87,89,02
Hughes,U.S. House,Michael Fulks,IND,320034,1,0,4,5,02
Hughes,State Senate,J. Paul Lane,DEM,320034,2,2,65,69,7
Hughes,State Senate,Larry Boggs,REP,320034,1,3,89,93,7
Hughes,President,Barack Obama,DEM,320035,2,21,192,215,
Hughes,President,Mitt Romney,REP,320035,14,42,355,411,
Hughes,U.S. House,Rob Wallace,DEM,320035,6,29,242,277,02
Hughes,U.S. House,Markwayne Mullin,REP,320035,8,29,278,315,02
Hughes,U.S. House,Michael Fulks,IND,320035,1,4,20,25,02
Hughes,State Senate,Susan Paddack,DEM,320035,8,47,418,473,13
Hughes,State Senate,Fred Smith,REP,320035,8,15,124,147,13
Jackson,President,Barack Obama,DEM,330001,15,56,163,234,
Jackson,President,Mitt Romney,REP,330001,60,247,748,1055,
Jackson,U.S. House,Timothy Ray Murray,DEM,330001,14,51,125,190,03
Jackson,U.S. House,Frank Lucas,REP,330001,59,245,737,1041,03
Jackson,U.S. House,William Sanders,IND,330001,0,8,35,43,03
Jackson,President,Barack Obama,DEM,330002,7,23,46,76,
Jackson,President,Mitt Romney,REP,330002,37,142,228,407,
Jackson,U.S. House,Timothy Ray Murray,DEM,330002,4,13,37,54,03
Jackson,U.S. House,Frank Lucas,REP,330002,39,150,230,419,03
Jackson,U.S. House,William Sanders,IND,330002,0,2,5,7,03
Jackson,President,Barack Obama,DEM,330003,5,36,227,268,
Jackson,President,Mitt Romney,REP,330003,9,64,274,347,
Jackson,U.S. House,Timothy Ray Murray,DEM,330003,5,31,197,233,03
Jackson,U.S. House,Frank Lucas,REP,330003,9,64,278,351,03
Jackson,U.S. House,William Sanders,IND,330003,0,5,20,25,03
Jackson,President,Barack Obama,DEM,330006,11,53,198,262,
Jackson,President,Mitt Romney,REP,330006,33,186,627,846,
Jackson,U.S. House,Timothy Ray Murray,DEM,330006,10,43,146,199,03
Jackson,U.S. House,Frank Lucas,REP,330006,33,185,647,865,03
Jackson,U.S. House,William Sanders,IND,330006,1,8,26,35,03
Jackson,President,Barack Obama,DEM,330007,9,33,193,235,
Jackson,President,Mitt Romney,REP,330007,13,57,334,404,
Jackson,U.S. House,Timothy Ray Murray,DEM,330007,7,25,166,198,03
Jackson,U.S. House,Frank Lucas,REP,330007,13,61,338,412,03
Jackson,U.S. House,William Sanders,IND,330007,0,2,22,24,03
Jackson,President,Barack Obama,DEM,330010,4,29,171,204,
Jackson,President,Mitt Romney,REP,330010,17,67,215,299,
Jackson,U.S. House,Timothy Ray Murray,DEM,330010,4,21,151,176,03
Jackson,U.S. House,Frank Lucas,REP,330010,16,70,213,299,03
Jackson,U.S. House,William Sanders,IND,330010,0,4,20,24,03
Jackson,President,Barack Obama,DEM,330014,34,43,226,303,
Jackson,President,Mitt Romney,REP,330014,44,106,558,708,
Jackson,U.S. House,Timothy Ray Murray,DEM,330014,24,43,175,242,03
Jackson,U.S. House,Frank Lucas,REP,330014,42,105,568,715,03
Jackson,U.S. House,William Sanders,IND,330014,9,1,38,48,03
Jackson,President,Barack Obama,DEM,330016,2,6,74,82,
Jackson,President,Mitt Romney,REP,330016,5,20,323,348,
Jackson,U.S. House,Timothy Ray Murray,DEM,330016,2,4,64,70,03
Jackson,U.S. House,Frank Lucas,REP,330016,5,21,314,340,03
Jackson,U.S. House,William Sanders,IND,330016,0,1,15,16,03
Jackson,President,Barack Obama,DEM,330017,1,1,35,37,
Jackson,President,Mitt Romney,REP,330017,4,16,200,220,
Jackson,U.S. House,Timothy Ray Murray,DEM,330017,1,2,31,34,03
Jackson,U.S. House,Frank Lucas,REP,330017,4,15,199,218,03
Jackson,U.S. House,William Sanders,IND,330017,0,0,4,4,03
Jackson,President,Barack Obama,DEM,330018,1,1,38,40,
Jackson,President,Mitt Romney,REP,330018,3,7,157,167,
Jackson,U.S. House,Timothy Ray Murray,DEM,330018,1,0,25,26,03
Jackson,U.S. House,Frank Lucas,REP,330018,3,8,159,170,03
Jackson,U.S. House,William Sanders,IND,330018,0,0,7,7,03
Jackson,President,Barack Obama,DEM,330019,0,3,22,25,
Jackson,President,Mitt Romney,REP,330019,2,10,100,112,
Jackson,U.S. House,Timothy Ray Murray,DEM,330019,0,3,19,22,03
Jackson,U.S. House,Frank Lucas,REP,330019,2,9,94,105,03
Jackson,U.S. House,William Sanders,IND,330019,0,1,5,6,03
Jackson,President,Barack Obama,DEM,330020,1,18,53,72,
Jackson,President,Mitt Romney,REP,330020,19,84,400,503,
Jackson,U.S. House,Timothy Ray Murray,DEM,330020,1,15,38,54,03
Jackson,U.S. House,Frank Lucas,REP,330020,19,84,396,499,03
Jackson,U.S. House,William Sanders,IND,330020,0,3,19,22,03
Jackson,President,Barack Obama,DEM,330021,0,0,21,21,
Jackson,President,Mitt Romney,REP,330021,6,12,71,89,
Jackson,U.S. House,Timothy Ray Murray,DEM,330021,0,1,16,17,03
Jackson,U.S. House,Frank Lucas,REP,330021,4,11,73,88,03
Jackson,U.S. House,William Sanders,IND,330021,2,0,3,5,03
Jackson,President,Barack Obama,DEM,330023,4,16,40,60,
Jackson,President,Mitt Romney,REP,330023,9,45,229,283,
Jackson,U.S. House,Timothy Ray Murray,DEM,330023,4,14,28,46,03
Jackson,U.S. House,Frank Lucas,REP,330023,9,46,233,288,03
Jackson,U.S. House,William Sanders,IND,330023,0,1,7,8,03
Jackson,President,Barack Obama,DEM,330024,1,2,32,35,
Jackson,President,Mitt Romney,REP,330024,5,8,164,177,
Jackson,U.S. House,Timothy Ray Murray,DEM,330024,1,1,26,28,03
Jackson,U.S. House,Frank Lucas,REP,330024,5,7,161,173,03
Jackson,U.S. House,William Sanders,IND,330024,0,2,7,9,03
Jefferson,President,Barack Obama,DEM,340001,11,35,73,119,
Jefferson,President,Mitt Romney,REP,340001,11,66,188,265,
Jefferson,U.S. House,Donna Marie Bebo,DEM,340001,8,26,62,96,04
Jefferson,U.S. House,Tom Cole,REP,340001,11,67,182,260,04
Jefferson,U.S. House,Rj Harris,IND,340001,3,4,14,21,04
Jefferson,State Senate,Tony Terrill,DEM,340001,7,26,62,95,31
Jefferson,State Senate,Don Barrington,REP,340001,14,73,199,286,31
Jefferson,President,Barack Obama,DEM,340002,2,16,42,60,
Jefferson,President,Mitt Romney,REP,340002,10,55,141,206,
Jefferson,U.S. House,Donna Marie Bebo,DEM,340002,0,18,32,50,04
Jefferson,U.S. House,Tom Cole,REP,340002,12,51,142,205,04
Jefferson,U.S. House,Rj Harris,IND,340002,0,5,8,13,04
Jefferson,State Senate,Tony Terrill,DEM,340002,0,13,38,51,31
Jefferson,State Senate,Don Barrington,REP,340002,12,62,145,219,31
Jefferson,President,Barack Obama,DEM,340003,0,5,17,22,
Jefferson,President,Mitt Romney,REP,340003,6,20,55,81,
Jefferson,U.S. House,Donna Marie Bebo,DEM,340003,0,7,14,21,04
Jefferson,U.S. House,Tom Cole,REP,340003,6,17,55,78,04
Jefferson,U.S. House,Rj Harris,IND,340003,0,0,1,1,04
Jefferson,State Senate,Tony Terrill,DEM,340003,0,2,13,15,31
Jefferson,State Senate,Don Barrington,REP,340003,6,23,59,88,31
Jefferson,President,Barack Obama,DEM,340004,0,1,29,30,
Jefferson,President,Mitt Romney,REP,340004,2,12,59,73,
Jefferson,U.S. House,Donna Marie Bebo,DEM,340004,0,2,29,31,04
Jefferson,U.S. House,Tom Cole,REP,340004,2,12,54,68,04
Jefferson,U.S. House,Rj Harris,IND,340004,0,0,3,3,04
Jefferson,State Senate,Tony Terrill,DEM,340004,0,2,33,35,31
Jefferson,State Senate,Don Barrington,REP,340004,2,12,53,67,31
Jefferson,President,Barack Obama,DEM,340005,0,6,17,23,
Jefferson,President,Mitt Romney,REP,340005,2,8,47,57,
Jefferson,U.S. House,Donna Marie Bebo,DEM,340005,0,4,12,16,04
Jefferson,U.S. House,Tom Cole,REP,340005,1,7,51,59,04
Jefferson,U.S. House,Rj Harris,IND,340005,1,3,2,6,04
Jefferson,State Senate,Tony Terrill,DEM,340005,1,4,17,22,31
Jefferson,State Senate,Don Barrington,REP,340005,1,9,48,58,31
Jefferson,President,Barack Obama,DEM,340006,6,4,105,115,
Jefferson,President,Mitt Romney,REP,340006,9,25,232,266,
Jefferson,U.S. House,Donna Marie Bebo,DEM,340006,6,4,103,113,04
Jefferson,U.S. House,Tom Cole,REP,340006,9,25,209,243,04
Jefferson,U.S. House,Rj Harris,IND,340006,0,0,12,12,04
Jefferson,State Senate,Tony Terrill,DEM,340006,5,5,139,149,31
Jefferson,State Senate,Don Barrington,REP,340006,10,24,191,225,31
Jefferson,President,Barack Obama,DEM,340007,0,12,60,72,
Jefferson,President,Mitt Romney,REP,340007,2,8,96,106,
Jefferson,U.S. House,Donna Marie Bebo,DEM,340007,0,10,73,83,04
Jefferson,U.S. House,Tom Cole,REP,340007,2,10,67,79,04
Jefferson,U.S. House,Rj Harris,IND,340007,0,0,9,9,04
Jefferson,State Senate,Tony Terrill,DEM,340007,0,7,71,78,31
Jefferson,State Senate,Don Barrington,REP,340007,2,13,84,99,31
Jefferson,President,Barack Obama,DEM,340008,1,4,3,8,
Jefferson,President,Mitt Romney,REP,340008,2,13,29,44,
Jefferson,U.S. House,Donna Marie Bebo,DEM,340008,1,2,9,12,04
Jefferson,U.S. House,Tom Cole,REP,340008,2,14,23,39,04
Jefferson,U.S. House,Rj Harris,IND,340008,0,0,0,0,04
Jefferson,State Senate,Tony Terrill,DEM,340008,1,3,6,10,31
Jefferson,State Senate,Don Barrington,REP,340008,2,13,26,41,31
Jefferson,President,Barack Obama,DEM,340009,5,5,133,143,
Jefferson,President,Mitt Romney,REP,340009,14,19,466,499,
Jefferson,U.S. House,Donna Marie Bebo,DEM,340009,1,2,129,132,04
Jefferson,U.S. House,Tom Cole,REP,340009,18,20,453,491,04
Jefferson,U.S. House,Rj Harris,IND,340009,0,1,9,10,04
Jefferson,State Senate,Tony Terrill,DEM,340009,1,4,136,141,31
Jefferson,State Senate,Don Barrington,REP,340009,18,20,455,493,31
Jefferson,President,Barack Obama,DEM,340010,0,1,12,13,
Jefferson,President,Mitt Romney,REP,340010,1,1,35,37,
Jefferson,U.S. House,Donna Marie Bebo,DEM,340010,0,0,7,7,04
Jefferson,U.S. House,Tom Cole,REP,340010,1,1,35,37,04
Jefferson,U.S. House,Rj Harris,IND,340010,0,0,2,2,04
Jefferson,State Senate,Tony Terrill,DEM,340010,0,0,10,10,31
Jefferson,State Senate,Don Barrington,REP,340010,1,1,35,37,31
Johnston,President,Barack Obama,DEM,350001,2,23,52,77,
Johnston,President,Mitt Romney,REP,350001,5,64,162,231,
Johnston,U.S. House,Rob Wallace,DEM,350001,1,34,80,115,02
Johnston,U.S. House,Markwayne Mullin,REP,350001,6,51,124,181,02
Johnston,U.S. House,Michael Fulks,IND,350001,0,1,9,10,02
Johnston,State House,Doris Anne Row,DEM,350001,3,48,89,140,22
Johnston,State House,Charles Mccall,REP,350001,4,38,123,165,22
Johnston,President,Barack Obama,DEM,350002,0,17,66,83,
Johnston,President,Mitt Romney,REP,350002,8,28,112,148,
Johnston,U.S. House,Rob Wallace,DEM,350002,2,22,85,109,02
Johnston,U.S. House,Markwayne Mullin,REP,350002,6,23,87,116,02
Johnston,U.S. House,Michael Fulks,IND,350002,0,0,3,3,02
Johnston,State House,Doris Anne Row,DEM,350002,5,24,97,126,22
Johnston,State House,Charles Mccall,REP,350002,3,23,79,105,22
Johnston,President,Barack Obama,DEM,350003,2,23,56,81,
Johnston,President,Mitt Romney,REP,350003,5,43,116,164,
Johnston,U.S. House,Rob Wallace,DEM,350003,2,28,77,107,02
Johnston,U.S. House,Markwayne Mullin,REP,350003,4,34,79,117,02
Johnston,U.S. House,Michael Fulks,IND,350003,0,3,14,17,02
Johnston,State House,Doris Anne Row,DEM,350003,1,29,72,102,22
Johnston,State House,Charles Mccall,REP,350003,6,36,101,143,22
Johnston,President,Barack Obama,DEM,350004,5,33,168,206,
Johnston,President,Mitt Romney,REP,350004,21,128,292,441,
Johnston,U.S. House,Rob Wallace,DEM,350004,7,53,230,290,02
Johnston,U.S. House,Markwayne Mullin,REP,350004,16,100,207,323,02
Johnston,U.S. House,Michael Fulks,IND,350004,1,7,19,27,02
Johnston,State House,Doris Anne Row,DEM,350004,10,79,261,350,22
Johnston,State House,Charles Mccall,REP,350004,16,82,200,298,22
Johnston,President,Barack Obama,DEM,350005,4,4,93,101,
Johnston,President,Mitt Romney,REP,350005,5,8,291,304,
Johnston,U.S. House,Rob Wallace,DEM,350005,3,4,167,174,02
Johnston,U.S. House,Markwayne Mullin,REP,350005,6,8,188,202,02
Johnston,U.S. House,Michael Fulks,IND,350005,0,0,19,19,02
Johnston,State House,Doris Anne Row,DEM,350005,3,5,187,195,22
Johnston,State House,Charles Mccall,REP,350005,6,7,191,204,22
Johnston,President,Barack Obama,DEM,350006,1,10,92,103,
Johnston,President,Mitt Romney,REP,350006,3,24,178,205,
Johnston,U.S. House,Rob Wallace,DEM,350006,2,12,138,152,02
Johnston,U.S. House,Markwayne Mullin,REP,350006,2,21,116,139,02
Johnston,U.S. House,Michael Fulks,IND,350006,0,1,12,13,02
Johnston,State House,Doris Anne Row,DEM,350006,1,19,164,184,22
Johnston,State House,Charles Mccall,REP,350006,2,14,106,122,22
Johnston,President,Barack Obama,DEM,350007,0,0,3,3,
Johnston,President,Mitt Romney,REP,350007,1,2,3,6,
Johnston,U.S. House,Rob Wallace,DEM,350007,0,0,3,3,02
Johnston,U.S. House,Markwayne Mullin,REP,350007,1,2,3,6,02
Johnston,U.S. House,Michael Fulks,IND,350007,0,0,0,0,02
Johnston,State House,Doris Anne Row,DEM,350007,1,0,4,5,22
Johnston,State House,Charles Mccall,REP,350007,0,2,2,4,22
Johnston,President,Barack Obama,DEM,350008,0,5,51,56,
Johnston,President,Mitt Romney,REP,350008,1,11,173,185,
Johnston,U.S. House,Rob Wallace,DEM,350008,0,11,101,112,02
Johnston,U.S. House,Markwayne Mullin,REP,350008,1,3,110,114,02
Johnston,U.S. House,Michael Fulks,IND,350008,0,2,7,9,02
Johnston,State House,Doris Anne Row,DEM,350008,0,10,108,118,22
Johnston,State House,Charles Mccall,REP,350008,1,6,114,121,22
Johnston,President,Barack Obama,DEM,350009,1,3,51,55,
Johnston,President,Mitt Romney,REP,350009,3,12,87,102,
Johnston,U.S. House,Rob Wallace,DEM,350009,0,5,78,83,02
Johnston,U.S. House,Markwayne Mullin,REP,350009,4,9,52,65,02
Johnston,U.S. House,Michael Fulks,IND,350009,0,1,9,10,02
Johnston,State House,Doris Anne Row,DEM,350009,1,7,69,77,22
Johnston,State House,Charles Mccall,REP,350009,3,8,69,80,22
Johnston,President,Barack Obama,DEM,350010,2,0,35,37,
Johnston,President,Mitt Romney,REP,350010,2,7,50,59,
Johnston,U.S. House,Rob Wallace,DEM,350010,1,0,41,42,02
Johnston,U.S. House,Markwayne Mullin,REP,350010,3,7,41,51,02
Johnston,U.S. House,Michael Fulks,IND,350010,0,0,3,3,02
Johnston,State House,Doris Anne Row,DEM,350010,2,1,34,37,22
Johnston,State House,Charles Mccall,REP,350010,2,6,52,60,22
Johnston,President,Barack Obama,DEM,350011,2,0,61,63,
Johnston,President,Mitt Romney,REP,350011,6,4,119,129,
Johnston,U.S. House,Rob Wallace,DEM,350011,4,0,90,94,02
Johnston,U.S. House,Markwayne Mullin,REP,350011,5,4,83,92,02
Johnston,U.S. House,Michael Fulks,IND,350011,0,0,6,6,02
Johnston,State House,Doris Anne Row,DEM,350011,2,0,84,86,22
Johnston,State House,Charles Mccall,REP,350011,7,4,98,109,22
Johnston,President,Barack Obama,DEM,350012,0,6,99,105,
Johnston,President,Mitt Romney,REP,350012,8,13,260,281,
Johnston,U.S. House,Rob Wallace,DEM,350012,1,12,137,150,02
Johnston,U.S. House,Markwayne Mullin,REP,350012,7,8,200,215,02
Johnston,U.S. House,Michael Fulks,IND,350012,0,1,15,16,02
Johnston,State House,Doris Anne Row,DEM,350012,0,11,151,162,22
Johnston,State House,Charles Mccall,REP,350012,8,10,210,228,22
Johnston,President,Barack Obama,DEM,350013,2,17,128,147,
Johnston,President,Mitt Romney,REP,350013,10,39,284,333,
Johnston,U.S. House,Rob Wallace,DEM,350013,4,21,183,208,02
Johnston,U.S. House,Markwayne Mullin,REP,350013,8,31,202,241,02
Johnston,U.S. House,Michael Fulks,IND,350013,0,4,19,23,02
Johnston,State House,Doris Anne Row,DEM,350013,2,25,177,204,22
Johnston,State House,Charles Mccall,REP,350013,10,31,237,278,22
Johnston,President,Barack Obama,DEM,350014,0,5,15,20,
Johnston,President,Mitt Romney,REP,350014,0,6,55,61,
Johnston,U.S. House,Rob Wallace,DEM,350014,0,3,31,34,02
Johnston,U.S. House,Markwayne Mullin,REP,350014,0,7,32,39,02
Johnston,U.S. House,Michael Fulks,IND,350014,0,1,7,8,02
Johnston,State House,Doris Anne Row,DEM,350014,0,2,27,29,22
Johnston,State House,Charles Mccall,REP,350014,0,9,44,53,22
Kay,President,Barack Obama,DEM,360001,3,36,190,229,
Kay,President,Mitt Romney,REP,360001,18,131,465,614,
Kay,U.S. House,Timothy Ray Murray,DEM,360001,3,31,138,172,03
Kay,U.S. House,Frank Lucas,REP,360001,13,128,480,621,03
Kay,U.S. House,William Sanders,IND,360001,4,6,32,42,03
Kay,President,Barack Obama,DEM,360101,1,5,205,211,
Kay,President,Mitt Romney,REP,360101,9,6,438,453,
Kay,U.S. House,Timothy Ray Murray,DEM,360101,1,3,153,157,03
Kay,U.S. House,Frank Lucas,REP,360101,9,8,453,470,03
Kay,U.S. House,William Sanders,IND,360101,0,0,43,43,03
Kay,President,Barack Obama,DEM,360103,4,4,148,156,
Kay,President,Mitt Romney,REP,360103,21,11,418,450,
Kay,U.S. House,Timothy Ray Murray,DEM,360103,2,3,95,100,03
Kay,U.S. House,Frank Lucas,REP,360103,22,11,425,458,03
Kay,U.S. House,William Sanders,IND,360103,1,1,34,36,03
Kay,President,Barack Obama,DEM,360202,5,3,192,200,
Kay,President,Mitt Romney,REP,360202,22,20,491,533,
Kay,U.S. House,Timothy Ray Murray,DEM,360202,3,2,131,136,03
Kay,U.S. House,Frank Lucas,REP,360202,22,20,505,547,03
Kay,U.S. House,William Sanders,IND,360202,1,0,41,42,03
Kay,President,Barack Obama,DEM,360205,5,7,210,222,
Kay,President,Mitt Romney,REP,360205,10,15,484,509,
Kay,U.S. House,Timothy Ray Murray,DEM,360205,3,5,160,168,03
Kay,U.S. House,Frank Lucas,REP,360205,12,15,487,514,03
Kay,U.S. House,William Sanders,IND,360205,1,2,47,50,03
Kay,President,Barack Obama,DEM,360206,6,10,210,226,
Kay,President,Mitt Romney,REP,360206,29,26,780,835,
Kay,U.S. House,Timothy Ray Murray,DEM,360206,6,8,161,175,03
Kay,U.S. House,Frank Lucas,REP,360206,31,26,782,839,03
Kay,U.S. House,William Sanders,IND,360206,0,2,40,42,03
Kay,President,Barack Obama,DEM,360400,0,1,19,20,
Kay,President,Mitt Romney,REP,360400,6,6,78,90,
Kay,U.S. House,Timothy Ray Murray,DEM,360400,0,0,12,12,03
Kay,U.S. House,Frank Lucas,REP,360400,4,7,79,90,03
Kay,U.S. House,William Sanders,IND,360400,2,0,5,7,03
Kay,State House,Nancy Niemann,DEM,360400,0,1,21,22,37
Kay,State House,Steven Vaughan,REP,360400,6,6,76,88,37
Kay,President,Barack Obama,DEM,360401,1,2,6,9,
Kay,President,Mitt Romney,REP,360401,7,11,39,57,
Kay,U.S. House,Timothy Ray Murray,DEM,360401,2,0,7,9,03
Kay,U.S. House,Frank Lucas,REP,360401,8,11,37,56,03
Kay,U.S. House,William Sanders,IND,360401,0,2,1,3,03
Kay,State House,Nancy Niemann,DEM,360401,2,2,9,13,37
Kay,State House,Steven Vaughan,REP,360401,8,11,36,55,37
Kay,President,Barack Obama,DEM,360403,4,17,84,105,
Kay,President,Mitt Romney,REP,360403,13,45,264,322,
Kay,U.S. House,Timothy Ray Murray,DEM,360403,2,13,66,81,03
Kay,U.S. House,Frank Lucas,REP,360403,14,48,265,327,03
Kay,U.S. House,William Sanders,IND,360403,1,1,14,16,03
Kay,President,Barack Obama,DEM,360404,0,1,29,30,
Kay,President,Mitt Romney,REP,360404,2,8,102,112,
Kay,U.S. House,Timothy Ray Murray,DEM,360404,0,1,21,22,03
Kay,U.S. House,Frank Lucas,REP,360404,2,7,99,108,03
Kay,U.S. House,William Sanders,IND,360404,0,1,10,11,03
Kay,President,Barack Obama,DEM,360406,0,3,44,47,
Kay,President,Mitt Romney,REP,360406,7,12,173,192,
Kay,U.S. House,Timothy Ray Murray,DEM,360406,0,0,28,28,03
Kay,U.S. House,Frank Lucas,REP,360406,7,14,178,199,03
Kay,U.S. House,William Sanders,IND,360406,0,1,7,8,03
Kay,President,Barack Obama,DEM,360407,0,0,0,0,
Kay,President,Mitt Romney,REP,360407,1,3,30,34,
Kay,U.S. House,Timothy Ray Murray,DEM,360407,0,0,0,0,03
Kay,U.S. House,Frank Lucas,REP,360407,1,3,29,33,03
Kay,U.S. House,William Sanders,IND,360407,0,0,1,1,03
Kay,President,Barack Obama,DEM,360409,2,0,9,11,
Kay,President,Mitt Romney,REP,360409,10,2,48,60,
Kay,U.S. House,Timothy Ray Murray,DEM,360409,0,0,3,3,03
Kay,U.S. House,Frank Lucas,REP,360409,12,2,47,61,03
Kay,U.S. House,William Sanders,IND,360409,0,0,8,8,03
Kay,President,Barack Obama,DEM,360411,2,0,35,37,
Kay,President,Mitt Romney,REP,360411,4,3,112,119,
Kay,U.S. House,Timothy Ray Murray,DEM,360411,1,0,31,32,03
Kay,U.S. House,Frank Lucas,REP,360411,4,2,109,115,03
Kay,U.S. House,William Sanders,IND,360411,1,1,6,8,03
Kay,State House,Nancy Niemann,DEM,360411,2,1,57,60,37
Kay,State House,Steven Vaughan,REP,360411,3,2,88,93,37
Kay,President,Barack Obama,DEM,360412,4,4,68,76,
Kay,President,Mitt Romney,REP,360412,6,5,154,165,
Kay,U.S. House,Timothy Ray Murray,DEM,360412,2,4,62,68,03
Kay,U.S. House,Frank Lucas,REP,360412,4,5,144,153,03
Kay,U.S. House,William Sanders,IND,360412,3,0,11,14,03
Kay,State House,Nancy Niemann,DEM,360412,5,4,87,96,37
Kay,State House,Steven Vaughan,REP,360412,3,4,133,140,37
Kay,President,Barack Obama,DEM,360413,19,28,179,226,
Kay,President,Mitt Romney,REP,360413,40,64,581,685,
Kay,U.S. House,Timothy Ray Murray,DEM,360413,8,23,144,175,03
Kay,U.S. House,Frank Lucas,REP,360413,44,67,591,702,03
Kay,U.S. House,William Sanders,IND,360413,6,1,25,32,03
Kay,State House,Nancy Niemann,DEM,360413,19,32,246,297,37
Kay,State House,Steven Vaughan,REP,360413,40,60,509,609,37
Kay,President,Barack Obama,DEM,360419,17,3,166,186,
Kay,President,Mitt Romney,REP,360419,16,14,293,323,
Kay,U.S. House,Timothy Ray Murray,DEM,360419,14,3,125,142,03
Kay,U.S. House,Frank Lucas,REP,360419,15,14,307,336,03
Kay,U.S. House,William Sanders,IND,360419,1,0,26,27,03
Kay,State House,Nancy Niemann,DEM,360419,17,5,197,219,37
Kay,State House,Steven Vaughan,REP,360419,13,12,260,285,37
Kay,President,Barack Obama,DEM,360420,0,1,74,75,
Kay,President,Mitt Romney,REP,360420,6,9,185,200,
Kay,U.S. House,Timothy Ray Murray,DEM,360420,0,1,46,47,03
Kay,U.S. House,Frank Lucas,REP,360420,6,9,199,214,03
Kay,U.S. House,William Sanders,IND,360420,0,0,12,12,03
Kay,President,Barack Obama,DEM,360503,10,31,307,348,
Kay,President,Mitt Romney,REP,360503,43,38,596,677,
Kay,U.S. House,Timothy Ray Murray,DEM,360503,8,30,256,294,03
Kay,U.S. House,Frank Lucas,REP,360503,44,37,597,678,03
Kay,U.S. House,William Sanders,IND,360503,1,0,47,48,03
Kay,State House,Nancy Niemann,DEM,360503,8,37,391,436,37
Kay,State House,Steven Vaughan,REP,360503,42,30,511,583,37
Kay,President,Barack Obama,DEM,360507,6,11,183,200,
Kay,President,Mitt Romney,REP,360507,11,21,354,386,
Kay,U.S. House,Timothy Ray Murray,DEM,360507,6,9,146,161,03
Kay,U.S. House,Frank Lucas,REP,360507,11,22,346,379,03
Kay,U.S. House,William Sanders,IND,360507,0,1,38,39,03
Kay,State House,Nancy Niemann,DEM,360507,7,15,228,250,37
Kay,State House,Steven Vaughan,REP,360507,10,16,302,328,37
Kay,President,Barack Obama,DEM,360516,1,9,243,253,
Kay,President,Mitt Romney,REP,360516,8,11,294,313,
Kay,U.S. House,Timothy Ray Murray,DEM,360516,1,9,209,219,03
Kay,U.S. House,Frank Lucas,REP,360516,7,10,284,301,03
Kay,U.S. House,William Sanders,IND,360516,1,1,41,43,03
Kay,State House,Nancy Niemann,DEM,360516,1,9,288,298,37
Kay,State House,Steven Vaughan,REP,360516,8,11,248,267,37
Kay,President,Barack Obama,DEM,360517,15,15,251,281,
Kay,President,Mitt Romney,REP,360517,5,18,318,341,
Kay,U.S. House,Timothy Ray Murray,DEM,360517,11,11,200,222,03
Kay,U.S. House,Frank Lucas,REP,360517,7,19,328,354,03
Kay,U.S. House,William Sanders,IND,360517,1,2,39,42,03
Kay,State House,Nancy Niemann,DEM,360517,14,18,283,315,37
Kay,State House,Steven Vaughan,REP,360517,5,15,288,308,37
Kay,President,Barack Obama,DEM,360527,10,17,260,287,
Kay,President,Mitt Romney,REP,360527,23,52,588,663,
Kay,U.S. House,Timothy Ray Murray,DEM,360527,9,12,181,202,03
Kay,U.S. House,Frank Lucas,REP,360527,24,52,611,687,03
Kay,U.S. House,William Sanders,IND,360527,0,5,46,51,03
Kay,State House,Nancy Niemann,DEM,360527,7,18,316,341,37
Kay,State House,Steven Vaughan,REP,360527,25,50,529,604,37
Kay,President,Barack Obama,DEM,360530,4,6,235,245,
Kay,President,Mitt Romney,REP,360530,19,45,491,555,
Kay,U.S. House,Timothy Ray Murray,DEM,360530,2,6,177,185,03
Kay,U.S. House,Frank Lucas,REP,360530,21,44,504,569,03
Kay,U.S. House,William Sanders,IND,360530,0,1,44,45,03
Kay,State House,Nancy Niemann,DEM,360530,4,14,296,314,37
Kay,State House,Steven Vaughan,REP,360530,19,37,434,490,37
Kay,President,Barack Obama,DEM,360532,4,12,183,199,
Kay,President,Mitt Romney,REP,360532,28,50,552,630,
Kay,U.S. House,Timothy Ray Murray,DEM,360532,2,11,141,154,03
Kay,U.S. House,Frank Lucas,REP,360532,28,49,545,622,03
Kay,U.S. House,William Sanders,IND,360532,2,1,41,44,03
Kay,State House,Nancy Niemann,DEM,360532,5,27,296,328,37
Kay,State House,Steven Vaughan,REP,360532,26,35,438,499,37
Kay,President,Barack Obama,DEM,360533,7,8,204,219,
Kay,President,Mitt Romney,REP,360533,36,41,506,583,
Kay,U.S. House,Timothy Ray Murray,DEM,360533,6,5,143,154,03
Kay,U.S. House,Frank Lucas,REP,360533,36,41,534,611,03
Kay,U.S. House,William Sanders,IND,360533,1,3,27,31,03
Kay,State House,Nancy Niemann,DEM,360533,7,10,254,271,37
Kay,State House,Steven Vaughan,REP,360533,36,39,455,530,37
Kay,President,Barack Obama,DEM,360534,19,17,251,287,
Kay,President,Mitt Romney,REP,360534,43,71,693,807,
Kay,U.S. House,Timothy Ray Murray,DEM,360534,13,14,183,210,03
Kay,U.S. House,Frank Lucas,REP,360534,42,72,714,828,03
Kay,U.S. House,William Sanders,IND,360534,4,2,35,41,03
Kay,State House,Nancy Niemann,DEM,360534,25,30,358,413,37
Kay,State House,Steven Vaughan,REP,360534,35,58,577,670,37
Kay,President,Barack Obama,DEM,360535,18,14,210,242,
Kay,President,Mitt Romney,REP,360535,60,80,651,791,
Kay,U.S. House,Timothy Ray Murray,DEM,360535,11,8,161,180,03
Kay,U.S. House,Frank Lucas,REP,360535,65,85,651,801,03
Kay,U.S. House,William Sanders,IND,360535,2,1,41,44,03
Kay,State House,Nancy Niemann,DEM,360535,28,21,333,382,37
Kay,State House,Steven Vaughan,REP,360535,50,73,524,647,37
Kingfisher,President,Barack Obama,DEM,370101,10,32,144,186,
Kingfisher,President,Mitt Romney,REP,370101,30,179,667,876,
Kingfisher,U.S. House,Timothy Ray Murray,DEM,370101,7,25,82,114,03
Kingfisher,U.S. House,Frank Lucas,REP,370101,31,178,688,897,03
Kingfisher,U.S. House,William Sanders,IND,370101,2,7,39,48,03
Kingfisher,President,Barack Obama,DEM,370102,1,0,12,13,
Kingfisher,President,Mitt Romney,REP,370102,3,24,169,196,
Kingfisher,U.S. House,Timothy Ray Murray,DEM,370102,1,1,8,10,03
Kingfisher,U.S. House,Frank Lucas,REP,370102,3,22,170,195,03
Kingfisher,U.S. House,William Sanders,IND,370102,0,1,3,4,03
Kingfisher,President,Barack Obama,DEM,370103,0,8,21,29,
Kingfisher,President,Mitt Romney,REP,370103,15,76,203,294,
Kingfisher,U.S. House,Timothy Ray Murray,DEM,370103,0,6,15,21,03
Kingfisher,U.S. House,Frank Lucas,REP,370103,13,77,199,289,03
Kingfisher,U.S. House,William Sanders,IND,370103,2,2,11,15,03
Kingfisher,President,Barack Obama,DEM,370105,2,3,110,115,
Kingfisher,President,Mitt Romney,REP,370105,10,37,403,450,
Kingfisher,U.S. House,Timothy Ray Murray,DEM,370105,2,1,74,77,03
Kingfisher,U.S. House,Frank Lucas,REP,370105,9,36,421,466,03
Kingfisher,U.S. House,William Sanders,IND,370105,1,1,18,20,03
Kingfisher,President,Barack Obama,DEM,370106,0,1,3,4,
Kingfisher,President,Mitt Romney,REP,370106,3,8,68,79,
Kingfisher,U.S. House,Timothy Ray Murray,DEM,370106,0,0,2,2,03
Kingfisher,U.S. House,Frank Lucas,REP,370106,3,8,66,77,03
Kingfisher,U.S. House,William Sanders,IND,370106,0,0,3,3,03
Kingfisher,President,Barack Obama,DEM,370201,4,8,161,173,
Kingfisher,President,Mitt Romney,REP,370201,40,47,825,912,
Kingfisher,U.S. House,Timothy Ray Murray,DEM,370201,6,5,96,107,03
Kingfisher,U.S. House,Frank Lucas,REP,370201,35,49,817,901,03
Kingfisher,U.S. House,William Sanders,IND,370201,2,0,66,68,03
Kingfisher,President,Barack Obama,DEM,370203,3,1,21,25,
Kingfisher,President,Mitt Romney,REP,370203,17,10,120,147,
Kingfisher,U.S. House,Timothy Ray Murray,DEM,370203,1,1,9,11,03
Kingfisher,U.S. House,Frank Lucas,REP,370203,17,11,127,155,03
Kingfisher,U.S. House,William Sanders,IND,370203,2,0,5,7,03
Kingfisher,President,Barack Obama,DEM,370204,2,6,40,48,
Kingfisher,President,Mitt Romney,REP,370204,4,19,235,258,
Kingfisher,U.S. House,Timothy Ray Murray,DEM,370204,1,4,19,24,03
Kingfisher,U.S. House,Frank Lucas,REP,370204,5,20,236,261,03
Kingfisher,U.S. House,William Sanders,IND,370204,0,2,20,22,03
Kingfisher,President,Barack Obama,DEM,370301,2,36,150,188,
Kingfisher,President,Mitt Romney,REP,370301,28,167,638,833,
Kingfisher,U.S. House,Timothy Ray Murray,DEM,370301,2,21,96,119,03
Kingfisher,U.S. House,Frank Lucas,REP,370301,27,171,646,844,03
Kingfisher,U.S. House,William Sanders,IND,370301,1,11,43,55,03
Kingfisher,President,Barack Obama,DEM,370302,0,3,69,72,
Kingfisher,President,Mitt Romney,REP,370302,10,14,385,409,
Kingfisher,U.S. House,Timothy Ray Murray,DEM,370302,0,1,38,39,03
Kingfisher,U.S. House,Frank Lucas,REP,370302,10,16,394,420,03
Kingfisher,U.S. House,William Sanders,IND,370302,0,0,17,17,03
Kingfisher,President,Barack Obama,DEM,370303,0,0,5,5,
Kingfisher,President,Mitt Romney,REP,370303,0,26,84,110,
Kingfisher,U.S. House,Timothy Ray Murray,DEM,370303,0,1,2,3,03
Kingfisher,U.S. House,Frank Lucas,REP,370303,0,24,80,104,03
Kingfisher,U.S. House,William Sanders,IND,370303,0,1,7,8,03
Kingfisher,President,Barack Obama,DEM,370304,0,1,20,21,
Kingfisher,President,Mitt Romney,REP,370304,4,18,111,133,
Kingfisher,U.S. House,Timothy Ray Murray,DEM,370304,0,1,7,8,03
Kingfisher,U.S. House,Frank Lucas,REP,370304,4,17,117,138,03
Kingfisher,U.S. House,William Sanders,IND,370304,0,1,7,8,03
Kingfisher,President,Barack Obama,DEM,370305,6,2,10,18,
Kingfisher,President,Mitt Romney,REP,370305,6,25,128,159,
Kingfisher,U.S. House,Timothy Ray Murray,DEM,370305,2,0,2,4,03
Kingfisher,U.S. House,Frank Lucas,REP,370305,9,27,131,167,03
Kingfisher,U.S. House,William Sanders,IND,370305,1,1,6,8,03
Kingfisher,President,Barack Obama,DEM,370306,0,0,1,1,
Kingfisher,President,Mitt Romney,REP,370306,0,0,14,14,
Kingfisher,U.S. House,Timothy Ray Murray,DEM,370306,0,0,2,2,03
Kingfisher,U.S. House,Frank Lucas,REP,370306,0,0,13,13,03
Kingfisher,U.S. House,William Sanders,IND,370306,0,0,0,0,03
Kiowa,President,Barack Obama,DEM,380001,14,44,147,205,
Kiowa,President,Mitt Romney,REP,380001,27,92,398,517,
Kiowa,U.S. House,Timothy Ray Murray,DEM,380001,11,23,74,108,03
Kiowa,U.S. House,Frank Lucas,REP,380001,29,109,465,603,03
Kiowa,U.S. House,William Sanders,IND,380001,2,3,8,13,03
Kiowa,President,Barack Obama,DEM,380002,0,4,21,25,
Kiowa,President,Mitt Romney,REP,380002,4,16,97,117,
Kiowa,U.S. House,Timothy Ray Murray,DEM,380002,0,3,10,13,03
Kiowa,U.S. House,Frank Lucas,REP,380002,3,18,107,128,03
Kiowa,U.S. House,William Sanders,IND,380002,1,0,1,2,03
Kiowa,President,Barack Obama,DEM,380004,5,35,104,144,
Kiowa,President,Mitt Romney,REP,380004,6,69,230,305,
Kiowa,U.S. House,Timothy Ray Murray,DEM,380004,2,18,44,64,03
Kiowa,U.S. House,Frank Lucas,REP,380004,9,85,277,371,03
Kiowa,U.S. House,William Sanders,IND,380004,0,1,10,11,03
Kiowa,President,Barack Obama,DEM,380005,0,12,18,30,
Kiowa,President,Mitt Romney,REP,380005,1,9,19,29,
Kiowa,U.S. House,Timothy Ray Murray,DEM,380005,0,10,12,22,03
Kiowa,U.S. House,Frank Lucas,REP,380005,1,11,25,37,03
Kiowa,U.S. House,William Sanders,IND,380005,0,0,1,1,03
Kiowa,President,Barack Obama,DEM,380006,2,4,45,51,
Kiowa,President,Mitt Romney,REP,380006,6,11,82,99,
Kiowa,U.S. House,Timothy Ray Murray,DEM,380006,2,2,32,36,03
Kiowa,U.S. House,Frank Lucas,REP,380006,6,13,92,111,03
Kiowa,U.S. House,William Sanders,IND,380006,0,0,3,3,03
Kiowa,State House,David Perryman,DEM,380006,2,8,81,91,56
Kiowa,State House,Chuck Utsler,REP,380006,6,7,45,58,56
Kiowa,President,Barack Obama,DEM,380007,0,0,1,1,
Kiowa,President,Mitt Romney,REP,380007,0,2,1,3,
Kiowa,U.S. House,Timothy Ray Murray,DEM,380007,0,0,0,0,03
Kiowa,U.S. House,Frank Lucas,REP,380007,0,2,2,4,03
Kiowa,U.S. House,William Sanders,IND,380007,0,0,0,0,03
Kiowa,State House,David Perryman,DEM,380007,0,2,1,3,56
Kiowa,State House,Chuck Utsler,REP,380007,0,0,1,1,56
Kiowa,President,Barack Obama,DEM,380008,0,5,48,53,
Kiowa,President,Mitt Romney,REP,380008,9,8,147,164,
Kiowa,U.S. House,Timothy Ray Murray,DEM,380008,0,2,27,29,03
Kiowa,U.S. House,Frank Lucas,REP,380008,7,11,163,181,03
Kiowa,U.S. House,William Sanders,IND,380008,2,0,6,8,03
Kiowa,President,Barack Obama,DEM,380009,0,2,19,21,
Kiowa,President,Mitt Romney,REP,380009,0,1,31,32,
Kiowa,U.S. House,Timothy Ray Murray,DEM,380009,0,1,9,10,03
Kiowa,U.S. House,Frank Lucas,REP,380009,0,2,41,43,03
Kiowa,U.S. House,William Sanders,IND,380009,0,0,0,0,03
Kiowa,State House,David Perryman,DEM,380009,0,2,27,29,56
Kiowa,State House,Chuck Utsler,REP,380009,0,1,21,22,56
Kiowa,President,Barack Obama,DEM,380010,4,3,147,154,
Kiowa,President,Mitt Romney,REP,380010,10,6,305,321,
Kiowa,U.S. House,Timothy Ray Murray,DEM,380010,4,2,107,113,03
Kiowa,U.S. House,Frank Lucas,REP,380010,10,7,328,345,03
Kiowa,U.S. House,William Sanders,IND,380010,0,0,17,17,03
Kiowa,State House,David Perryman,DEM,380010,7,3,255,265,56
Kiowa,State House,Chuck Utsler,REP,380010,7,6,197,210,56
Kiowa,President,Barack Obama,DEM,380011,0,4,17,21,
Kiowa,President,Mitt Romney,REP,380011,2,7,72,81,
Kiowa,U.S. House,Timothy Ray Murray,DEM,380011,0,2,14,16,03
Kiowa,U.S. House,Frank Lucas,REP,380011,2,8,72,82,03
Kiowa,U.S. House,William Sanders,IND,380011,0,0,1,1,03
Kiowa,President,Barack Obama,DEM,380014,4,4,238,246,
Kiowa,President,Mitt Romney,REP,380014,12,8,322,342,
Kiowa,U.S. House,Timothy Ray Murray,DEM,380014,4,3,180,187,03
Kiowa,U.S. House,Frank Lucas,REP,380014,11,8,366,385,03
Kiowa,U.S. House,William Sanders,IND,380014,1,1,13,15,03
Kiowa,President,Barack Obama,DEM,380015,2,3,51,56,
Kiowa,President,Mitt Romney,REP,380015,7,14,98,119,
Kiowa,U.S. House,Timothy Ray Murray,DEM,380015,3,4,22,29,03
Kiowa,U.S. House,Frank Lucas,REP,380015,6,13,114,133,03
Kiowa,U.S. House,William Sanders,IND,380015,0,0,9,9,03
Kiowa,State House,David Perryman,DEM,380015,7,8,64,79,56
Kiowa,State House,Chuck Utsler,REP,380015,1,9,78,88,56
Kiowa,President,Barack Obama,DEM,380016,4,2,22,28,
Kiowa,President,Mitt Romney,REP,380016,4,3,56,63,
Kiowa,U.S. House,Timothy Ray Murray,DEM,380016,2,2,13,17,03
Kiowa,U.S. House,Frank Lucas,REP,380016,5,3,64,72,03
Kiowa,U.S. House,William Sanders,IND,380016,0,0,1,1,03
Kiowa,President,Barack Obama,DEM,380022,1,0,70,71,
Kiowa,President,Mitt Romney,REP,380022,8,4,112,124,
Kiowa,U.S. House,Timothy Ray Murray,DEM,380022,1,1,57,59,03
Kiowa,U.S. House,Frank Lucas,REP,380022,8,3,118,129,03
Kiowa,U.S. House,William Sanders,IND,380022,0,0,5,5,03
Latimer,President,Barack Obama,DEM,390001,4,29,127,160,
Latimer,President,Mitt Romney,REP,390001,15,36,234,285,
Latimer,U.S. House,Rob Wallace,DEM,390001,5,37,192,234,02
Latimer,U.S. House,Markwayne Mullin,REP,390001,14,26,150,190,02
Latimer,U.S. House,Michael Fulks,IND,390001,0,2,17,19,02
Latimer,State Senate,J. Paul Lane,DEM,390001,7,39,161,207,7
Latimer,State Senate,Larry Boggs,REP,390001,12,25,199,236,7
Latimer,President,Barack Obama,DEM,390002,9,36,124,169,
Latimer,President,Mitt Romney,REP,390002,10,44,259,313,
Latimer,U.S. House,Rob Wallace,DEM,390002,11,34,189,234,02
Latimer,U.S. House,Markwayne Mullin,REP,390002,7,45,176,228,02
Latimer,U.S. House,Michael Fulks,IND,390002,0,1,18,19,02
Latimer,State Senate,J. Paul Lane,DEM,390002,10,45,184,239,7
Latimer,State Senate,Larry Boggs,REP,390002,9,36,198,243,7
Latimer,President,Barack Obama,DEM,390003,0,22,38,60,
Latimer,President,Mitt Romney,REP,390003,9,48,131,188,
Latimer,U.S. House,Rob Wallace,DEM,390003,2,43,61,106,02
Latimer,U.S. House,Markwayne Mullin,REP,390003,6,21,98,125,02
Latimer,U.S. House,Michael Fulks,IND,390003,0,3,10,13,02
Latimer,State Senate,J. Paul Lane,DEM,390003,2,30,61,93,7
Latimer,State Senate,Larry Boggs,REP,390003,6,40,108,154,7
Latimer,President,Barack Obama,DEM,390004,0,15,63,78,
Latimer,President,Mitt Romney,REP,390004,7,28,125,160,
Latimer,U.S. House,Rob Wallace,DEM,390004,1,15,90,106,02
Latimer,U.S. House,Markwayne Mullin,REP,390004,6,24,88,118,02
Latimer,U.S. House,Michael Fulks,IND,390004,0,3,10,13,02
Latimer,State Senate,J. Paul Lane,DEM,390004,0,24,91,115,7
Latimer,State Senate,Larry Boggs,REP,390004,7,18,99,124,7
Latimer,President,Barack Obama,DEM,390005,1,27,94,122,
Latimer,President,Mitt Romney,REP,390005,6,46,240,292,
Latimer,U.S. House,Rob Wallace,DEM,390005,1,41,143,185,02
Latimer,U.S. House,Markwayne Mullin,REP,390005,6,31,180,217,02
Latimer,U.S. House,Michael Fulks,IND,390005,0,1,12,13,02
Latimer,State Senate,J. Paul Lane,DEM,390005,4,34,167,205,7
Latimer,State Senate,Larry Boggs,REP,390005,1,39,167,207,7
Latimer,President,Barack Obama,DEM,390006,1,1,32,34,
Latimer,President,Mitt Romney,REP,390006,2,5,84,91,
Latimer,U.S. House,Rob Wallace,DEM,390006,1,2,51,54,02
Latimer,U.S. House,Markwayne Mullin,REP,390006,1,4,63,68,02
Latimer,U.S. House,Michael Fulks,IND,390006,0,0,4,4,02
Latimer,State Senate,J. Paul Lane,DEM,390006,0,1,54,55,7
Latimer,State Senate,Larry Boggs,REP,390006,3,5,64,72,7
Latimer,President,Barack Obama,DEM,390007,2,6,43,51,
Latimer,President,Mitt Romney,REP,390007,3,11,113,127,
Latimer,U.S. House,Rob Wallace,DEM,390007,3,6,55,64,02
Latimer,U.S. House,Markwayne Mullin,REP,390007,2,11,88,101,02
Latimer,U.S. House,Michael Fulks,IND,390007,0,0,14,14,02
Latimer,State Senate,J. Paul Lane,DEM,390007,3,7,58,68,7
Latimer,State Senate,Larry Boggs,REP,390007,2,10,98,110,7
Latimer,President,Barack Obama,DEM,390008,3,8,65,76,
Latimer,President,Mitt Romney,REP,390008,17,9,250,276,
Latimer,U.S. House,Rob Wallace,DEM,390008,3,9,151,163,02
Latimer,U.S. House,Markwayne Mullin,REP,390008,11,7,155,173,02
Latimer,U.S. House,Michael Fulks,IND,390008,2,1,7,10,02
Latimer,State Senate,J. Paul Lane,DEM,390008,5,8,139,152,7
Latimer,State Senate,Larry Boggs,REP,390008,11,9,175,195,7
Latimer,President,Barack Obama,DEM,390009,9,5,73,87,
Latimer,President,Mitt Romney,REP,390009,8,12,173,193,
Latimer,U.S. House,Rob Wallace,DEM,390009,12,6,100,118,02
Latimer,U.S. House,Markwayne Mullin,REP,390009,5,11,130,146,02
Latimer,U.S. House,Michael Fulks,IND,390009,0,0,18,18,02
Latimer,State Senate,J. Paul Lane,DEM,390009,10,6,111,127,7
Latimer,State Senate,Larry Boggs,REP,390009,7,11,136,154,7
Latimer,President,Barack Obama,DEM,390010,1,9,75,85,
Latimer,President,Mitt Romney,REP,390010,6,8,168,182,
Latimer,U.S. House,Rob Wallace,DEM,390010,2,10,100,112,02
Latimer,U.S. House,Markwayne Mullin,REP,390010,5,6,132,143,02
Latimer,U.S. House,Michael Fulks,IND,390010,0,1,11,12,02
Latimer,State Senate,J. Paul Lane,DEM,390010,2,9,109,120,7
Latimer,State Senate,Larry Boggs,REP,390010,5,8,135,148,7
Latimer,President,Barack Obama,DEM,390011,14,10,163,187,
Latimer,President,Mitt Romney,REP,390011,18,20,340,378,
Latimer,U.S. House,Rob Wallace,DEM,390011,19,16,238,273,02
Latimer,U.S. House,Markwayne Mullin,REP,390011,12,16,237,265,02
Latimer,U.S. House,Michael Fulks,IND,390011,1,0,28,29,02
Latimer,State Senate,J. Paul Lane,DEM,390011,16,17,231,264,7
Latimer,State Senate,Larry Boggs,REP,390011,16,15,272,303,7
Latimer,President,Barack Obama,DEM,390012,4,5,52,61,
Latimer,President,Mitt Romney,REP,390012,6,8,129,143,
Latimer,U.S. House,Rob Wallace,DEM,390012,7,7,80,94,02
Latimer,U.S. House,Markwayne Mullin,REP,390012,4,5,90,99,02
Latimer,U.S. House,Michael Fulks,IND,390012,0,1,12,13,02
Latimer,State Senate,J. Paul Lane,DEM,390012,5,5,73,83,7
Latimer,State Senate,Larry Boggs,REP,390012,6,8,110,124,7
Leflore,President,Barack Obama,DEM,400101,3,8,68,79,
Leflore,President,Mitt Romney,REP,400101,3,13,233,249,
Leflore,U.S. House,Rob Wallace,DEM,400101,3,9,110,122,02
Leflore,U.S. House,Markwayne Mullin,REP,400101,3,13,169,185,02
Leflore,U.S. House,Michael Fulks,IND,400101,0,0,21,21,02
Leflore,President,Barack Obama,DEM,400102,3,6,112,121,
Leflore,President,Mitt Romney,REP,400102,6,20,309,335,
Leflore,U.S. House,Rob Wallace,DEM,400102,7,10,172,189,02
Leflore,U.S. House,Markwayne Mullin,REP,400102,2,14,230,246,02
Leflore,U.S. House,Michael Fulks,IND,400102,0,1,19,20,02
Leflore,State House,James Lockhart,DEM,400102,9,13,243,265,3
Leflore,State House,Roger Mattox,REP,400102,0,12,182,194,3
Leflore,President,Barack Obama,DEM,400103,4,10,157,171,
Leflore,President,Mitt Romney,REP,400103,13,30,394,437,
Leflore,U.S. House,Rob Wallace,DEM,400103,7,14,242,263,02
Leflore,U.S. House,Markwayne Mullin,REP,400103,9,26,286,321,02
Leflore,U.S. House,Michael Fulks,IND,400103,0,0,15,15,02
Leflore,State House,James Lockhart,DEM,400103,7,24,331,362,3
Leflore,State House,Roger Mattox,REP,400103,8,16,216,240,3
Leflore,President,Barack Obama,DEM,400104,14,7,139,160,
Leflore,President,Mitt Romney,REP,400104,0,3,36,39,
Leflore,U.S. House,Rob Wallace,DEM,400104,13,7,145,165,02
Leflore,U.S. House,Markwayne Mullin,REP,400104,1,3,24,28,02
Leflore,U.S. House,Michael Fulks,IND,400104,0,0,5,5,02
Leflore,State House,James Lockhart,DEM,400104,14,8,153,175,3
Leflore,State House,Roger Mattox,REP,400104,0,2,21,23,3
Leflore,President,Barack Obama,DEM,400105,3,7,178,188,
Leflore,President,Mitt Romney,REP,400105,13,21,460,494,
Leflore,U.S. House,Rob Wallace,DEM,400105,8,15,243,266,02
Leflore,U.S. House,Markwayne Mullin,REP,400105,8,11,363,382,02
Leflore,U.S. House,Michael Fulks,IND,400105,0,1,24,25,02
Leflore,State House,James Lockhart,DEM,400105,6,18,333,357,3
Leflore,State House,Roger Mattox,REP,400105,10,10,297,317,3
Leflore,President,Barack Obama,DEM,400106,5,14,170,189,
Leflore,President,Mitt Romney,REP,400106,6,25,400,431,
Leflore,U.S. House,Rob Wallace,DEM,400106,6,16,207,229,02
Leflore,U.S. House,Markwayne Mullin,REP,400106,3,20,302,325,02
Leflore,U.S. House,Michael Fulks,IND,400106,2,3,47,52,02
Leflore,State House,James Lockhart,DEM,400106,7,19,308,334,3
Leflore,State House,Roger Mattox,REP,400106,4,19,259,282,3
Leflore,President,Barack Obama,DEM,400107,9,7,173,189,
Leflore,President,Mitt Romney,REP,400107,16,46,580,642,
Leflore,U.S. House,Rob Wallace,DEM,400107,10,13,297,320,02
Leflore,U.S. House,Markwayne Mullin,REP,400107,13,38,416,467,02
Leflore,U.S. House,Michael Fulks,IND,400107,2,2,33,37,02
Leflore,State House,James Lockhart,DEM,400107,11,16,419,446,3
Leflore,State House,Roger Mattox,REP,400107,14,37,330,381,3
Leflore,President,Barack Obama,DEM,400108,3,2,134,139,
Leflore,President,Mitt Romney,REP,400108,12,11,299,322,
Leflore,U.S. House,Rob Wallace,DEM,400108,4,3,181,188,02
Leflore,U.S. House,Markwayne Mullin,REP,400108,11,9,227,247,02
Leflore,U.S. House,Michael Fulks,IND,400108,0,1,19,20,02
Leflore,State House,James Lockhart,DEM,400108,4,6,225,235,3
Leflore,State House,Roger Mattox,REP,400108,11,7,204,222,3
Leflore,President,Barack Obama,DEM,400109,3,26,189,218,
Leflore,President,Mitt Romney,REP,400109,10,58,418,486,
Leflore,U.S. House,Rob Wallace,DEM,400109,4,33,262,299,02
Leflore,U.S. House,Markwayne Mullin,REP,400109,7,45,301,353,02
Leflore,U.S. House,Michael Fulks,IND,400109,1,8,37,46,02
Leflore,State House,James Lockhart,DEM,400109,3,45,385,433,3
Leflore,State House,Roger Mattox,REP,400109,8,39,218,265,3
Leflore,President,Barack Obama,DEM,400110,3,11,167,181,
Leflore,President,Mitt Romney,REP,400110,5,19,347,371,
Leflore,U.S. House,Rob Wallace,DEM,400110,4,18,266,288,02
Leflore,U.S. House,Markwayne Mullin,REP,400110,4,10,228,242,02
Leflore,U.S. House,Michael Fulks,IND,400110,0,2,17,19,02
Leflore,President,Barack Obama,DEM,400111,2,15,166,183,
Leflore,President,Mitt Romney,REP,400111,13,70,422,505,
Leflore,U.S. House,Rob Wallace,DEM,400111,3,28,273,304,02
Leflore,U.S. House,Markwayne Mullin,REP,400111,10,52,275,337,02
Leflore,U.S. House,Michael Fulks,IND,400111,1,3,35,39,02
Leflore,President,Barack Obama,DEM,400112,0,2,55,57,
Leflore,President,Mitt Romney,REP,400112,3,0,89,92,
Leflore,U.S. House,Rob Wallace,DEM,400112,0,2,75,77,02
Leflore,U.S. House,Markwayne Mullin,REP,400112,2,0,59,61,02
Leflore,U.S. House,Michael Fulks,IND,400112,1,0,8,9,02
Leflore,President,Barack Obama,DEM,400113,2,6,75,83,
Leflore,President,Mitt Romney,REP,400113,6,12,197,215,
Leflore,U.S. House,Rob Wallace,DEM,400113,2,6,119,127,02
Leflore,U.S. House,Markwayne Mullin,REP,400113,5,11,145,161,02
Leflore,U.S. House,Michael Fulks,IND,400113,1,1,9,11,02
Leflore,President,Barack Obama,DEM,400114,1,2,67,70,
Leflore,President,Mitt Romney,REP,400114,1,8,80,89,
Leflore,U.S. House,Rob Wallace,DEM,400114,1,2,72,75,02
Leflore,U.S. House,Markwayne Mullin,REP,400114,1,6,60,67,02
Leflore,U.S. House,Michael Fulks,IND,400114,0,2,14,16,02
Leflore,President,Barack Obama,DEM,400201,3,1,28,32,
Leflore,President,Mitt Romney,REP,400201,3,13,57,73,
Leflore,U.S. House,Rob Wallace,DEM,400201,3,4,30,37,02
Leflore,U.S. House,Markwayne Mullin,REP,400201,3,9,49,61,02
Leflore,U.S. House,Michael Fulks,IND,400201,0,0,5,5,02
Leflore,President,Barack Obama,DEM,400202,2,4,43,49,
Leflore,President,Mitt Romney,REP,400202,2,2,96,100,
Leflore,U.S. House,Rob Wallace,DEM,400202,3,3,64,70,02
Leflore,U.S. House,Markwayne Mullin,REP,400202,0,2,68,70,02
Leflore,U.S. House,Michael Fulks,IND,400202,1,0,8,9,02
Leflore,State Senate,Jerry Ellis,DEM,400202,3,3,73,79,5
Leflore,State Senate,Howard Houchen,REP,400202,1,2,62,65,5
Leflore,State House,James Lockhart,DEM,400202,3,4,94,101,3
Leflore,State House,Roger Mattox,REP,400202,1,2,47,50,3
Leflore,President,Barack Obama,DEM,400203,8,88,277,373,
Leflore,President,Mitt Romney,REP,400203,37,234,578,849,
Leflore,U.S. House,Rob Wallace,DEM,400203,17,133,402,552,02
Leflore,U.S. House,Markwayne Mullin,REP,400203,29,171,409,609,02
Leflore,U.S. House,Michael Fulks,IND,400203,0,14,45,59,02
Leflore,State House,James Lockhart,DEM,400203,21,183,500,704,3
Leflore,State House,Roger Mattox,REP,400203,25,137,349,511,3
Leflore,President,Barack Obama,DEM,400204,5,38,217,260,
Leflore,President,Mitt Romney,REP,400204,10,87,442,539,
Leflore,U.S. House,Rob Wallace,DEM,400204,6,54,338,398,02
Leflore,U.S. House,Markwayne Mullin,REP,400204,7,67,287,361,02
Leflore,U.S. House,Michael Fulks,IND,400204,1,2,31,34,02
Leflore,State House,James Lockhart,DEM,400204,8,65,405,478,3
Leflore,State House,Roger Mattox,REP,400204,7,59,251,317,3
Leflore,President,Barack Obama,DEM,400205,5,28,62,95,
Leflore,President,Mitt Romney,REP,400205,9,69,152,230,
Leflore,U.S. House,Rob Wallace,DEM,400205,8,57,100,165,02
Leflore,U.S. House,Markwayne Mullin,REP,400205,6,36,94,136,02
Leflore,U.S. House,Michael Fulks,IND,400205,0,5,23,28,02
Leflore,State House,James Lockhart,DEM,400205,8,52,120,180,3
Leflore,State House,Roger Mattox,REP,400205,6,46,94,146,3
Leflore,President,Barack Obama,DEM,400207,4,18,148,170,
Leflore,President,Mitt Romney,REP,400207,14,90,332,436,
Leflore,U.S. House,Rob Wallace,DEM,400207,8,35,227,270,02
Leflore,U.S. House,Markwayne Mullin,REP,400207,10,71,223,304,02
Leflore,U.S. House,Michael Fulks,IND,400207,0,1,31,32,02
Leflore,State House,James Lockhart,DEM,400207,10,47,284,341,3
Leflore,State House,Roger Mattox,REP,400207,8,60,200,268,3
Leflore,President,Barack Obama,DEM,400208,9,19,200,228,
Leflore,President,Mitt Romney,REP,400208,13,76,336,425,
Leflore,U.S. House,Rob Wallace,DEM,400208,13,31,255,299,02
Leflore,U.S. House,Markwayne Mullin,REP,400208,8,59,241,308,02
Leflore,U.S. House,Michael Fulks,IND,400208,0,5,34,39,02
Leflore,State House,James Lockhart,DEM,400208,15,52,317,384,3
Leflore,State House,Roger Mattox,REP,400208,8,42,217,267,3
Leflore,President,Barack Obama,DEM,400210,4,24,125,153,
Leflore,President,Mitt Romney,REP,400210,30,74,384,488,
Leflore,U.S. House,Rob Wallace,DEM,400210,8,49,206,263,02
Leflore,U.S. House,Markwayne Mullin,REP,400210,24,45,285,354,02
Leflore,U.S. House,Michael Fulks,IND,400210,0,4,16,20,02
Leflore,State House,James Lockhart,DEM,400210,16,56,299,371,3
Leflore,State House,Roger Mattox,REP,400210,17,42,208,267,3
Leflore,President,Barack Obama,DEM,400211,1,10,146,157,
Leflore,President,Mitt Romney,REP,400211,6,45,355,406,
Leflore,U.S. House,Rob Wallace,DEM,400211,3,19,243,265,02
Leflore,U.S. House,Markwayne Mullin,REP,400211,3,30,234,267,02
Leflore,U.S. House,Michael Fulks,IND,400211,1,4,24,29,02
Leflore,State Senate,Jerry Ellis,DEM,400211,2,24,268,294,5
Leflore,State Senate,Howard Houchen,REP,400211,4,28,225,257,5
Leflore,State House,James Lockhart,DEM,400211,5,27,306,338,3
Leflore,State House,Roger Mattox,REP,400211,2,28,203,233,3
Leflore,President,Barack Obama,DEM,400212,10,19,178,207,
Leflore,President,Mitt Romney,REP,400212,36,115,480,631,
Leflore,U.S. House,Rob Wallace,DEM,400212,14,51,317,382,02
Leflore,U.S. House,Markwayne Mullin,REP,400212,28,78,312,418,02
Leflore,U.S. House,Michael Fulks,IND,400212,4,3,31,38,02
Leflore,State House,James Lockhart,DEM,400212,28,56,418,502,3
Leflore,State House,Roger Mattox,REP,400212,16,76,241,333,3
Leflore,President,Barack Obama,DEM,400213,2,0,20,22,
Leflore,President,Mitt Romney,REP,400213,0,2,65,67,
Leflore,U.S. House,Rob Wallace,DEM,400213,0,0,44,44,02
Leflore,U.S. House,Markwayne Mullin,REP,400213,0,2,40,42,02
Leflore,U.S. House,Michael Fulks,IND,400213,0,0,2,2,02
Leflore,State Senate,Jerry Ellis,DEM,400213,1,1,47,49,5
Leflore,State Senate,Howard Houchen,REP,400213,0,1,37,38,5
Leflore,President,Barack Obama,DEM,400214,1,3,34,38,
Leflore,President,Mitt Romney,REP,400214,3,4,78,85,
Leflore,U.S. House,Rob Wallace,DEM,400214,3,3,63,69,02
Leflore,U.S. House,Markwayne Mullin,REP,400214,1,4,46,51,02
Leflore,U.S. House,Michael Fulks,IND,400214,0,0,4,4,02
Leflore,State Senate,Jerry Ellis,DEM,400214,3,3,72,78,5
Leflore,State Senate,Howard Houchen,REP,400214,1,3,41,45,5
Leflore,President,Barack Obama,DEM,400215,3,3,65,71,
Leflore,President,Mitt Romney,REP,400215,10,14,153,177,
Leflore,U.S. House,Rob Wallace,DEM,400215,5,7,100,112,02
Leflore,U.S. House,Markwayne Mullin,REP,400215,8,8,105,121,02
Leflore,U.S. House,Michael Fulks,IND,400215,0,2,9,11,02
Leflore,State Senate,Jerry Ellis,DEM,400215,6,11,141,158,5
Leflore,State Senate,Howard Houchen,REP,400215,7,6,70,83,5
Leflore,President,Barack Obama,DEM,400301,6,1,101,108,
Leflore,President,Mitt Romney,REP,400301,10,9,179,198,
Leflore,U.S. House,Rob Wallace,DEM,400301,6,3,146,155,02
Leflore,U.S. House,Markwayne Mullin,REP,400301,9,2,121,132,02
Leflore,U.S. House,Michael Fulks,IND,400301,1,4,14,19,02
Leflore,State Senate,Jerry Ellis,DEM,400301,9,5,175,189,5
Leflore,State Senate,Howard Houchen,REP,400301,9,4,99,112,5
Leflore,President,Barack Obama,DEM,400302,5,1,117,123,
Leflore,President,Mitt Romney,REP,400302,12,7,274,293,
Leflore,U.S. House,Rob Wallace,DEM,400302,7,5,203,215,02
Leflore,U.S. House,Markwayne Mullin,REP,400302,7,2,177,186,02
Leflore,U.S. House,Michael Fulks,IND,400302,2,1,17,20,02
Leflore,State Senate,Jerry Ellis,DEM,400302,8,5,253,266,5
Leflore,State Senate,Howard Houchen,REP,400302,7,3,136,146,5
Leflore,President,Barack Obama,DEM,400303,1,1,35,37,
Leflore,President,Mitt Romney,REP,400303,4,4,113,121,
Leflore,U.S. House,Rob Wallace,DEM,400303,2,2,63,67,02
Leflore,U.S. House,Markwayne Mullin,REP,400303,3,3,75,81,02
Leflore,U.S. House,Michael Fulks,IND,400303,0,0,9,9,02
Leflore,State Senate,Jerry Ellis,DEM,400303,3,1,72,76,5
Leflore,State Senate,Howard Houchen,REP,400303,2,3,70,75,5
Leflore,President,Barack Obama,DEM,400304,2,0,28,30,
Leflore,President,Mitt Romney,REP,400304,9,8,139,156,
Leflore,U.S. House,Rob Wallace,DEM,400304,2,0,58,60,02
Leflore,U.S. House,Markwayne Mullin,REP,400304,9,5,95,109,02
Leflore,U.S. House,Michael Fulks,IND,400304,0,1,8,9,02
Leflore,State Senate,Jerry Ellis,DEM,400304,10,2,77,89,5
Leflore,State Senate,Howard Houchen,REP,400304,1,4,82,87,5
Leflore,President,Barack Obama,DEM,400305,2,5,47,54,
Leflore,President,Mitt Romney,REP,400305,3,5,103,111,
Leflore,U.S. House,Rob Wallace,DEM,400305,2,6,56,64,02
Leflore,U.S. House,Markwayne Mullin,REP,400305,3,4,77,84,02
Leflore,U.S. House,Michael Fulks,IND,400305,0,0,19,19,02
Leflore,State Senate,Jerry Ellis,DEM,400305,2,8,73,83,5
Leflore,State Senate,Howard Houchen,REP,400305,3,1,71,75,5
Leflore,President,Barack Obama,DEM,400306,0,5,10,15,
Leflore,President,Mitt Romney,REP,400306,6,11,67,84,
Leflore,U.S. House,Rob Wallace,DEM,400306,0,3,26,29,02
Leflore,U.S. House,Markwayne Mullin,REP,400306,6,13,50,69,02
Leflore,U.S. House,Michael Fulks,IND,400306,0,0,2,2,02
Leflore,State Senate,Jerry Ellis,DEM,400306,1,5,37,43,5
Leflore,State Senate,Howard Houchen,REP,400306,5,10,34,49,5
Leflore,President,Barack Obama,DEM,400309,1,0,20,21,
Leflore,President,Mitt Romney,REP,400309,1,2,46,49,
Leflore,U.S. House,Rob Wallace,DEM,400309,1,0,38,39,02
Leflore,U.S. House,Markwayne Mullin,REP,400309,1,1,26,28,02
Leflore,U.S. House,Michael Fulks,IND,400309,0,0,3,3,02
Leflore,State Senate,Jerry Ellis,DEM,400309,1,0,40,41,5
Leflore,State Senate,Howard Houchen,REP,400309,1,1,25,27,5
Leflore,State House,James Lockhart,DEM,400309,2,0,54,56,3
Leflore,State House,Roger Mattox,REP,400309,0,1,13,14,3
Leflore,President,Barack Obama,DEM,400310,8,26,140,174,
Leflore,President,Mitt Romney,REP,400310,9,32,381,422,
Leflore,U.S. House,Rob Wallace,DEM,400310,10,33,255,298,02
Leflore,U.S. House,Markwayne Mullin,REP,400310,7,23,229,259,02
Leflore,U.S. House,Michael Fulks,IND,400310,0,2,32,34,02
Leflore,State Senate,Jerry Ellis,DEM,400310,8,25,306,339,5
Leflore,State Senate,Howard Houchen,REP,400310,8,30,193,231,5
Leflore,State House,James Lockhart,DEM,400310,12,39,370,421,3
Leflore,State House,Roger Mattox,REP,400310,5,19,151,175,3
Leflore,President,Barack Obama,DEM,400311,8,4,99,111,
Leflore,President,Mitt Romney,REP,400311,16,27,286,329,
Leflore,U.S. House,Rob Wallace,DEM,400311,8,10,192,210,02
Leflore,U.S. House,Markwayne Mullin,REP,400311,14,20,179,213,02
Leflore,U.S. House,Michael Fulks,IND,400311,1,1,18,20,02
Leflore,State Senate,Jerry Ellis,DEM,400311,7,13,214,234,5
Leflore,State Senate,Howard Houchen,REP,400311,16,17,159,192,5
Leflore,State House,James Lockhart,DEM,400311,12,16,269,297,3
Leflore,State House,Roger Mattox,REP,400311,11,14,116,141,3
Leflore,President,Barack Obama,DEM,400312,6,6,94,106,
Leflore,President,Mitt Romney,REP,400312,3,9,189,201,
Leflore,U.S. House,Rob Wallace,DEM,400312,9,10,143,162,02
Leflore,U.S. House,Markwayne Mullin,REP,400312,0,4,121,125,02
Leflore,U.S. House,Michael Fulks,IND,400312,0,1,15,16,02
Leflore,State Senate,Jerry Ellis,DEM,400312,8,10,185,203,5
Leflore,State Senate,Howard Houchen,REP,400312,0,5,87,92,5
Leflore,State House,James Lockhart,DEM,400312,9,10,217,236,3
Leflore,State House,Roger Mattox,REP,400312,0,5,66,71,3
Lincoln,President,Barack Obama,DEM,410001,9,9,153,171,
Lincoln,President,Mitt Romney,REP,410001,20,28,373,421,
Lincoln,U.S. House,Timothy Ray Murray,DEM,410001,8,6,130,144,03
Lincoln,U.S. House,Frank Lucas,REP,410001,20,29,364,413,03
Lincoln,U.S. House,William Sanders,IND,410001,1,2,25,28,03
Lincoln,State House,Keith Kinnamon,DEM,410001,9,14,209,232,32
Lincoln,State House,Jason Smalley,REP,410001,20,23,319,362,32
Lincoln,President,Barack Obama,DEM,410002,6,9,146,161,
Lincoln,President,Mitt Romney,REP,410002,16,24,526,566,
Lincoln,U.S. House,Timothy Ray Murray,DEM,410002,5,7,127,139,03
Lincoln,U.S. House,Frank Lucas,REP,410002,13,26,505,544,03
Lincoln,U.S. House,William Sanders,IND,410002,1,0,34,35,03
Lincoln,State House,Keith Kinnamon,DEM,410002,10,15,238,263,32
Lincoln,State House,Jason Smalley,REP,410002,10,18,433,461,32
Lincoln,President,Barack Obama,DEM,410003,6,34,154,194,
Lincoln,President,Mitt Romney,REP,410003,14,76,540,630,
Lincoln,U.S. House,Timothy Ray Murray,DEM,410003,3,24,129,156,03
Lincoln,U.S. House,Frank Lucas,REP,410003,16,80,533,629,03
Lincoln,U.S. House,William Sanders,IND,410003,0,5,26,31,03
Lincoln,State House,Keith Kinnamon,DEM,410003,9,50,315,374,32
Lincoln,State House,Jason Smalley,REP,410003,9,59,380,448,32
Lincoln,President,Barack Obama,DEM,410004,3,3,67,73,
Lincoln,President,Mitt Romney,REP,410004,10,9,307,326,
Lincoln,U.S. House,Timothy Ray Murray,DEM,410004,2,2,60,64,03
Lincoln,U.S. House,Frank Lucas,REP,410004,11,9,294,314,03
Lincoln,U.S. House,William Sanders,IND,410004,0,1,18,19,03
Lincoln,State House,Keith Kinnamon,DEM,410004,3,3,105,111,32
Lincoln,State House,Jason Smalley,REP,410004,10,9,265,284,32
Lincoln,President,Barack Obama,DEM,410005,4,9,117,130,
Lincoln,President,Mitt Romney,REP,410005,12,47,376,435,
Lincoln,U.S. House,Timothy Ray Murray,DEM,410005,4,8,84,96,03
Lincoln,U.S. House,Frank Lucas,REP,410005,8,47,372,427,03
Lincoln,U.S. House,William Sanders,IND,410005,2,1,28,31,03
Lincoln,State House,Keith Kinnamon,DEM,410005,7,21,196,224,32
Lincoln,State House,Jason Smalley,REP,410005,7,34,293,334,32
Lincoln,President,Barack Obama,DEM,410006,0,0,89,89,
Lincoln,President,Mitt Romney,REP,410006,5,9,177,191,
Lincoln,U.S. House,Timothy Ray Murray,DEM,410006,0,0,71,71,03
Lincoln,U.S. House,Frank Lucas,REP,410006,5,9,178,192,03
Lincoln,U.S. House,William Sanders,IND,410006,0,0,12,12,03
Lincoln,State House,Keith Kinnamon,DEM,410006,1,1,126,128,32
Lincoln,State House,Jason Smalley,REP,410006,4,8,137,149,32
Lincoln,President,Barack Obama,DEM,410007,3,4,127,134,
Lincoln,President,Mitt Romney,REP,410007,9,27,199,235,
Lincoln,U.S. House,Timothy Ray Murray,DEM,410007,2,4,100,106,03
Lincoln,U.S. House,Frank Lucas,REP,410007,9,25,205,239,03
Lincoln,U.S. House,William Sanders,IND,410007,0,1,17,18,03
Lincoln,State House,Keith Kinnamon,DEM,410007,7,8,179,194,32
Lincoln,State House,Jason Smalley,REP,410007,5,23,151,179,32
Lincoln,President,Barack Obama,DEM,410008,10,13,230,253,
Lincoln,President,Mitt Romney,REP,410008,22,32,666,720,
Lincoln,U.S. House,Timothy Ray Murray,DEM,410008,8,7,177,192,03
Lincoln,U.S. House,Frank Lucas,REP,410008,21,35,675,731,03
Lincoln,U.S. House,William Sanders,IND,410008,3,1,40,44,03
Lincoln,State House,Keith Kinnamon,DEM,410008,14,19,393,426,32
Lincoln,State House,Jason Smalley,REP,410008,18,24,495,537,32
Lincoln,President,Barack Obama,DEM,410009,3,17,101,121,
Lincoln,President,Mitt Romney,REP,410009,14,56,372,442,
Lincoln,U.S. House,Timothy Ray Murray,DEM,410009,1,9,73,83,03
Lincoln,U.S. House,Frank Lucas,REP,410009,16,61,378,455,03
Lincoln,U.S. House,William Sanders,IND,410009,1,1,19,21,03
Lincoln,State House,Keith Kinnamon,DEM,410009,6,27,174,207,32
Lincoln,State House,Jason Smalley,REP,410009,12,46,299,357,32
Lincoln,President,Barack Obama,DEM,410010,7,31,146,184,
Lincoln,President,Mitt Romney,REP,410010,21,173,466,660,
Lincoln,U.S. House,Timothy Ray Murray,DEM,410010,7,21,101,129,03
Lincoln,U.S. House,Frank Lucas,REP,410010,20,180,475,675,03
Lincoln,U.S. House,William Sanders,IND,410010,0,3,28,31,03
Lincoln,State House,Keith Kinnamon,DEM,410010,10,88,266,364,32
Lincoln,State House,Jason Smalley,REP,410010,17,117,347,481,32
Lincoln,President,Barack Obama,DEM,410011,8,59,126,193,
Lincoln,President,Mitt Romney,REP,410011,21,124,371,516,
Lincoln,U.S. House,Timothy Ray Murray,DEM,410011,7,47,99,153,03
Lincoln,U.S. House,Frank Lucas,REP,410011,21,125,364,510,03
Lincoln,U.S. House,William Sanders,IND,410011,0,13,36,49,03
Lincoln,State House,Keith Kinnamon,DEM,410011,12,92,238,342,32
Lincoln,State House,Jason Smalley,REP,410011,17,93,261,371,32
Lincoln,President,Barack Obama,DEM,410012,5,44,177,226,
Lincoln,President,Mitt Romney,REP,410012,23,126,311,460,
Lincoln,U.S. House,Timothy Ray Murray,DEM,410012,7,30,132,169,03
Lincoln,U.S. House,Frank Lucas,REP,410012,20,132,336,488,03
Lincoln,U.S. House,William Sanders,IND,410012,1,7,13,21,03
Lincoln,State House,Keith Kinnamon,DEM,410012,15,82,264,361,32
Lincoln,State House,Jason Smalley,REP,410012,13,87,224,324,32
Lincoln,President,Barack Obama,DEM,410013,0,1,41,42,
Lincoln,President,Mitt Romney,REP,410013,6,8,164,178,
Lincoln,U.S. House,Timothy Ray Murray,DEM,410013,0,0,44,44,03
Lincoln,U.S. House,Frank Lucas,REP,410013,3,7,151,161,03
Lincoln,U.S. House,William Sanders,IND,410013,3,2,9,14,03
Lincoln,State House,Keith Kinnamon,DEM,410013,0,1,71,72,32
Lincoln,State House,Jason Smalley,REP,410013,6,8,133,147,32
Lincoln,President,Barack Obama,DEM,410015,4,9,227,240,
Lincoln,President,Mitt Romney,REP,410015,19,28,631,678,
Lincoln,U.S. House,Timothy Ray Murray,DEM,410015,5,5,180,190,03
Lincoln,U.S. House,Frank Lucas,REP,410015,17,31,618,666,03
Lincoln,U.S. House,William Sanders,IND,410015,1,3,60,64,03
Lincoln,State House,Keith Kinnamon,DEM,410015,10,11,281,302,32
Lincoln,State House,Jason Smalley,REP,410015,13,27,578,618,32
Lincoln,President,Barack Obama,DEM,410016,4,8,132,144,
Lincoln,President,Mitt Romney,REP,410016,22,19,468,509,
Lincoln,U.S. House,Timothy Ray Murray,DEM,410016,2,4,97,103,03
Lincoln,U.S. House,Frank Lucas,REP,410016,22,20,466,508,03
Lincoln,U.S. House,William Sanders,IND,410016,1,3,36,40,03
Lincoln,State House,Keith Kinnamon,DEM,410016,6,11,197,214,32
Lincoln,State House,Jason Smalley,REP,410016,20,16,400,436,32
Lincoln,President,Barack Obama,DEM,410017,2,20,56,78,
Lincoln,President,Mitt Romney,REP,410017,5,21,123,149,
Lincoln,U.S. House,Timothy Ray Murray,DEM,410017,2,10,40,52,03
Lincoln,U.S. House,Frank Lucas,REP,410017,5,29,126,160,03
Lincoln,U.S. House,William Sanders,IND,410017,0,0,9,9,03
Lincoln,State House,Keith Kinnamon,DEM,410017,5,24,89,118,32
Lincoln,State House,Jason Smalley,REP,410017,2,16,89,107,32
Lincoln,President,Barack Obama,DEM,410018,6,9,123,138,
Lincoln,President,Mitt Romney,REP,410018,14,18,274,306,
Lincoln,U.S. House,Timothy Ray Murray,DEM,410018,4,6,100,110,03
Lincoln,U.S. House,Frank Lucas,REP,410018,13,20,279,312,03
Lincoln,U.S. House,William Sanders,IND,410018,2,1,18,21,03
Lincoln,State House,Keith Kinnamon,DEM,410018,7,12,171,190,32
Lincoln,State House,Jason Smalley,REP,410018,13,15,227,255,32
Lincoln,President,Barack Obama,DEM,410019,5,1,129,135,
Lincoln,President,Mitt Romney,REP,410019,27,13,475,515,
Lincoln,U.S. House,Timothy Ray Murray,DEM,410019,5,0,110,115,03
Lincoln,U.S. House,Frank Lucas,REP,410019,26,13,463,502,03
Lincoln,U.S. House,William Sanders,IND,410019,1,1,33,35,03
Lincoln,State House,Keith Kinnamon,DEM,410019,11,2,232,245,32
Lincoln,State House,Jason Smalley,REP,410019,21,12,373,406,32
Lincoln,President,Barack Obama,DEM,410020,2,6,134,142,
Lincoln,President,Mitt Romney,REP,410020,11,10,319,340,
Lincoln,U.S. House,Timothy Ray Murray,DEM,410020,3,6,117,126,03
Lincoln,U.S. House,Frank Lucas,REP,410020,10,7,301,318,03
Lincoln,U.S. House,William Sanders,IND,410020,0,4,33,37,03
Lincoln,State House,Keith Kinnamon,DEM,410020,3,7,169,179,32
Lincoln,State House,Jason Smalley,REP,410020,10,10,284,304,32
Lincoln,President,Barack Obama,DEM,410021,3,4,197,204,
Lincoln,President,Mitt Romney,REP,410021,23,27,599,649,
Lincoln,U.S. House,Timothy Ray Murray,DEM,410021,3,1,166,170,03
Lincoln,U.S. House,Frank Lucas,REP,410021,20,29,578,627,03
Lincoln,U.S. House,William Sanders,IND,410021,3,2,47,52,03
Lincoln,State House,Keith Kinnamon,DEM,410021,9,11,287,307,32
Lincoln,State House,Jason Smalley,REP,410021,17,21,501,539,32
Lincoln,President,Barack Obama,DEM,410022,9,10,202,221,
Lincoln,President,Mitt Romney,REP,410022,22,9,596,627,
Lincoln,U.S. House,Timothy Ray Murray,DEM,410022,6,8,162,176,03
Lincoln,U.S. House,Frank Lucas,REP,410022,25,10,594,629,03
Lincoln,U.S. House,William Sanders,IND,410022,1,0,37,38,03
Lincoln,State House,Keith Kinnamon,DEM,410022,17,10,308,335,32
Lincoln,State House,Jason Smalley,REP,410022,15,9,483,507,32
Logan,President,Barack Obama,DEM,420101,6,6,59,71,
Logan,President,Mitt Romney,REP,420101,29,38,380,447,
Logan,U.S. House,Timothy Ray Murray,DEM,420101,5,5,41,51,03
Logan,U.S. House,Frank Lucas,REP,420101,30,39,375,444,03
Logan,U.S. House,William Sanders,IND,420101,0,0,17,17,03
Logan,President,Barack Obama,DEM,420102,11,43,177,231,
Logan,President,Mitt Romney,REP,420102,35,109,428,572,
Logan,U.S. House,Timothy Ray Murray,DEM,420102,8,37,134,179,03
Logan,U.S. House,Frank Lucas,REP,420102,36,101,429,566,03
Logan,U.S. House,William Sanders,IND,420102,1,10,33,44,03
Logan,President,Barack Obama,DEM,420103,34,47,278,359,
Logan,President,Mitt Romney,REP,420103,110,158,1172,1440,
Logan,U.S. House,Timothy Ray Murray,DEM,420103,27,43,211,281,03
Logan,U.S. House,Frank Lucas,REP,420103,104,156,1168,1428,03
Logan,U.S. House,William Sanders,IND,420103,8,6,61,75,03
Logan,President,Barack Obama,DEM,420104,16,29,156,201,
Logan,President,Mitt Romney,REP,420104,55,135,780,970,
Logan,U.S. House,Timothy Ray Murray,DEM,420104,14,25,114,153,03
Logan,U.S. House,Frank Lucas,REP,420104,52,129,767,948,03
Logan,U.S. House,William Sanders,IND,420104,5,6,47,58,03
Logan,President,Barack Obama,DEM,420105,9,33,126,168,
Logan,President,Mitt Romney,REP,420105,29,97,423,549,
Logan,U.S. House,Timothy Ray Murray,DEM,420105,7,28,100,135,03
Logan,U.S. House,Frank Lucas,REP,420105,29,100,430,559,03
Logan,U.S. House,William Sanders,IND,420105,3,3,20,26,03
Logan,President,Barack Obama,DEM,420106,20,34,159,213,
Logan,President,Mitt Romney,REP,420106,69,113,850,1032,
Logan,U.S. House,Timothy Ray Murray,DEM,420106,14,30,128,172,03
Logan,U.S. House,Frank Lucas,REP,420106,68,112,821,1001,03
Logan,U.S. House,William Sanders,IND,420106,6,5,44,55,03
Logan,President,Barack Obama,DEM,420201,0,4,54,58,
Logan,President,Mitt Romney,REP,420201,2,3,93,98,
Logan,U.S. House,Timothy Ray Murray,DEM,420201,0,2,38,40,03
Logan,U.S. House,Frank Lucas,REP,420201,2,4,99,105,03
Logan,U.S. House,William Sanders,IND,420201,0,1,8,9,03
Logan,President,Barack Obama,DEM,420203,4,9,95,108,
Logan,President,Mitt Romney,REP,420203,22,18,182,222,
Logan,U.S. House,Timothy Ray Murray,DEM,420203,6,8,73,87,03
Logan,U.S. House,Frank Lucas,REP,420203,20,19,187,226,03
Logan,U.S. House,William Sanders,IND,420203,0,0,15,15,03
Logan,State House,Keith Kinnamon,DEM,420203,7,10,105,122,32
Logan,State House,Jason Smalley,REP,420203,18,17,162,197,32
Logan,President,Barack Obama,DEM,420204,17,93,249,359,
Logan,President,Mitt Romney,REP,420204,39,161,578,778,
Logan,U.S. House,Timothy Ray Murray,DEM,420204,13,79,218,310,03
Logan,U.S. House,Frank Lucas,REP,420204,36,156,567,759,03
Logan,U.S. House,William Sanders,IND,420204,4,16,36,56,03
Logan,President,Barack Obama,DEM,420205,20,73,230,323,
Logan,President,Mitt Romney,REP,420205,29,177,907,1113,
Logan,U.S. House,Timothy Ray Murray,DEM,420205,11,65,182,258,03
Logan,U.S. House,Frank Lucas,REP,420205,35,182,881,1098,03
Logan,U.S. House,William Sanders,IND,420205,3,3,74,80,03
Logan,President,Barack Obama,DEM,420206,12,37,270,319,
Logan,President,Mitt Romney,REP,420206,32,121,679,832,
Logan,U.S. House,Timothy Ray Murray,DEM,420206,10,27,210,247,03
Logan,U.S. House,Frank Lucas,REP,420206,32,126,672,830,03
Logan,U.S. House,William Sanders,IND,420206,1,5,60,66,03
Logan,President,Barack Obama,DEM,420207,24,34,246,304,
Logan,President,Mitt Romney,REP,420207,31,101,793,925,
Logan,U.S. House,Timothy Ray Murray,DEM,420207,15,24,192,231,03
Logan,U.S. House,Frank Lucas,REP,420207,36,101,781,918,03
Logan,U.S. House,William Sanders,IND,420207,3,8,59,70,03
Logan,President,Barack Obama,DEM,420301,0,0,7,7,
Logan,President,Mitt Romney,REP,420301,3,9,155,167,
Logan,U.S. House,Timothy Ray Murray,DEM,420301,0,0,10,10,03
Logan,U.S. House,Frank Lucas,REP,420301,3,7,147,157,03
Logan,U.S. House,William Sanders,IND,420301,0,2,4,6,03
Logan,President,Barack Obama,DEM,420302,0,1,25,26,
Logan,President,Mitt Romney,REP,420302,2,1,95,98,
Logan,U.S. House,Timothy Ray Murray,DEM,420302,0,1,9,10,03
Logan,U.S. House,Frank Lucas,REP,420302,2,1,108,111,03
Logan,U.S. House,William Sanders,IND,420302,0,0,4,4,03
Logan,President,Barack Obama,DEM,420303,9,13,212,234,
Logan,President,Mitt Romney,REP,420303,22,35,898,955,
Logan,U.S. House,Timothy Ray Murray,DEM,420303,8,9,168,185,03
Logan,U.S. House,Frank Lucas,REP,420303,22,39,904,965,03
Logan,U.S. House,William Sanders,IND,420303,0,0,31,31,03
Logan,President,Barack Obama,DEM,420304,1,1,35,37,
Logan,President,Mitt Romney,REP,420304,5,17,221,243,
Logan,U.S. House,Timothy Ray Murray,DEM,420304,0,0,25,25,03
Logan,U.S. House,Frank Lucas,REP,420304,5,18,227,250,03
Logan,U.S. House,William Sanders,IND,420304,0,0,5,5,03
Logan,President,Barack Obama,DEM,420305,7,50,150,207,
Logan,President,Mitt Romney,REP,420305,32,82,428,542,
Logan,U.S. House,Timothy Ray Murray,DEM,420305,8,46,113,167,03
Logan,U.S. House,Frank Lucas,REP,420305,29,80,431,540,03
Logan,U.S. House,William Sanders,IND,420305,2,6,31,39,03
Logan,President,Barack Obama,DEM,420306,8,11,73,92,
Logan,President,Mitt Romney,REP,420306,5,20,193,218,
Logan,U.S. House,Timothy Ray Murray,DEM,420306,6,9,57,72,03
Logan,U.S. House,Frank Lucas,REP,420306,6,21,199,226,03
Logan,U.S. House,William Sanders,IND,420306,0,0,11,11,03
Logan,President,Barack Obama,DEM,420307,32,58,246,336,
Logan,President,Mitt Romney,REP,420307,40,108,482,630,
Logan,U.S. House,Timothy Ray Murray,DEM,420307,26,51,188,265,03
Logan,U.S. House,Frank Lucas,REP,420307,43,104,484,631,03
Logan,U.S. House,William Sanders,IND,420307,2,4,48,54,03
Logan,President,Barack Obama,DEM,420308,12,115,308,435,
Logan,President,Mitt Romney,REP,420308,17,76,368,461,
Logan,U.S. House,Timothy Ray Murray,DEM,420308,11,98,276,385,03
Logan,U.S. House,Frank Lucas,REP,420308,18,83,367,468,03
Logan,U.S. House,William Sanders,IND,420308,1,7,33,41,03
Logan,President,Barack Obama,DEM,420309,2,8,20,30,
Logan,President,Mitt Romney,REP,420309,0,6,13,19,
Logan,U.S. House,Timothy Ray Murray,DEM,420309,1,7,15,23,03
Logan,U.S. House,Frank Lucas,REP,420309,1,7,16,24,03
Logan,U.S. House,William Sanders,IND,420309,0,0,2,2,03
Logan,President,Barack Obama,DEM,420310,5,37,564,606,
Logan,President,Mitt Romney,REP,420310,0,1,2,3,
Logan,U.S. House,Timothy Ray Murray,DEM,420310,5,34,521,560,03
Logan,U.S. House,Frank Lucas,REP,420310,0,1,20,21,03
Logan,U.S. House,William Sanders,IND,420310,0,3,21,24,03
Logan,State House,Keith Kinnamon,DEM,420310,5,37,544,586,32
Logan,State House,Jason Smalley,REP,420310,0,1,20,21,32
Love,President,Barack Obama,DEM,430101,2,14,100,116,
Love,President,Mitt Romney,REP,430101,6,42,207,255,
Love,U.S. House,Donna Marie Bebo,DEM,430101,2,13,78,93,04
Love,U.S. House,Tom Cole,REP,430101,6,40,218,264,04
Love,U.S. House,Rj Harris,IND,430101,0,3,9,12,04
Love,President,Barack Obama,DEM,430102,1,8,60,69,
Love,President,Mitt Romney,REP,430102,9,45,215,269,
Love,U.S. House,Donna Marie Bebo,DEM,430102,1,10,58,69,04
Love,U.S. House,Tom Cole,REP,430102,9,42,209,260,04
Love,U.S. House,Rj Harris,IND,430102,0,1,7,8,04
Love,President,Barack Obama,DEM,430103,3,8,127,138,
Love,President,Mitt Romney,REP,430103,1,34,355,390,
Love,U.S. House,Donna Marie Bebo,DEM,430103,3,4,138,145,04
Love,U.S. House,Tom Cole,REP,430103,1,37,318,356,04
Love,U.S. House,Rj Harris,IND,430103,0,0,22,22,04
Love,President,Barack Obama,DEM,430204,6,27,104,137,
Love,President,Mitt Romney,REP,430204,6,29,140,175,
Love,U.S. House,Donna Marie Bebo,DEM,430204,5,22,79,106,04
Love,U.S. House,Tom Cole,REP,430204,4,30,150,184,04
Love,U.S. House,Rj Harris,IND,430204,4,1,11,16,04
Love,President,Barack Obama,DEM,430205,1,10,85,96,
Love,President,Mitt Romney,REP,430205,3,60,279,342,
Love,U.S. House,Donna Marie Bebo,DEM,430205,1,13,85,99,04
Love,U.S. House,Tom Cole,REP,430205,3,56,261,320,04
Love,U.S. House,Rj Harris,IND,430205,0,1,20,21,04
Love,President,Barack Obama,DEM,430206,2,7,63,72,
Love,President,Mitt Romney,REP,430206,5,17,100,122,
Love,U.S. House,Donna Marie Bebo,DEM,430206,2,7,56,65,04
Love,U.S. House,Tom Cole,REP,430206,5,16,103,124,04
Love,U.S. House,Rj Harris,IND,430206,0,1,6,7,04
Love,President,Barack Obama,DEM,430207,1,3,28,32,
Love,President,Mitt Romney,REP,430207,0,6,44,50,
Love,U.S. House,Donna Marie Bebo,DEM,430207,1,2,28,31,04
Love,U.S. House,Tom Cole,REP,430207,0,7,40,47,04
Love,U.S. House,Rj Harris,IND,430207,0,0,1,1,04
Love,President,Barack Obama,DEM,430208,0,0,18,18,
Love,President,Mitt Romney,REP,430208,1,3,31,35,
Love,U.S. House,Donna Marie Bebo,DEM,430208,0,0,20,20,04
Love,U.S. House,Tom Cole,REP,430208,1,2,27,30,04
Love,U.S. House,Rj Harris,IND,430208,0,1,2,3,04
Love,President,Barack Obama,DEM,430310,2,12,122,136,
Love,President,Mitt Romney,REP,430310,6,29,183,218,
Love,U.S. House,Donna Marie Bebo,DEM,430310,4,9,97,110,04
Love,U.S. House,Tom Cole,REP,430310,4,30,198,232,04
Love,U.S. House,Rj Harris,IND,430310,0,2,8,10,04
Love,President,Barack Obama,DEM,430311,2,8,78,88,
Love,President,Mitt Romney,REP,430311,17,25,234,276,
Love,U.S. House,Donna Marie Bebo,DEM,430311,2,8,75,85,04
Love,U.S. House,Tom Cole,REP,430311,16,24,222,262,04
Love,U.S. House,Rj Harris,IND,430311,1,1,12,14,04
Love,President,Barack Obama,DEM,430312,3,6,72,81,
Love,President,Mitt Romney,REP,430312,1,19,178,198,
Love,U.S. House,Donna Marie Bebo,DEM,430312,3,5,60,68,04
Love,U.S. House,Tom Cole,REP,430312,1,19,179,199,04
Love,U.S. House,Rj Harris,IND,430312,0,0,12,12,04
Love,President,Barack Obama,DEM,430313,5,3,43,51,
Love,President,Mitt Romney,REP,430313,4,8,94,106,
Love,U.S. House,Donna Marie Bebo,DEM,430313,5,2,39,46,04
Love,U.S. House,Tom Cole,REP,430313,4,8,91,103,04
Love,U.S. House,Rj Harris,IND,430313,0,1,7,8,04
Mcclain,President,Barack Obama,DEM,440001,0,1,48,49,
Mcclain,President,Mitt Romney,REP,440001,8,5,178,191,
Mcclain,U.S. House,Donna Marie Bebo,DEM,440001,0,1,36,37,04
Mcclain,U.S. House,Tom Cole,REP,440001,8,5,179,192,04
Mcclain,U.S. House,Rj Harris,IND,440001,0,0,10,10,04
Mcclain,State Senate,Mike Fullerton,DEM,440001,0,1,65,66,43
Mcclain,State Senate,Corey Brooks,REP,440001,8,5,151,164,43
Mcclain,State House,Matt Branstetter,DEM,440001,0,3,70,73,20
Mcclain,State House,Bobby Cleveland,REP,440001,8,3,145,156,20
Mcclain,President,Barack Obama,DEM,440002,3,0,44,47,
Mcclain,President,Mitt Romney,REP,440002,6,7,145,158,
Mcclain,U.S. House,Donna Marie Bebo,DEM,440002,3,0,43,46,04
Mcclain,U.S. House,Tom Cole,REP,440002,6,7,140,153,04
Mcclain,U.S. House,Rj Harris,IND,440002,0,0,6,6,04
Mcclain,State Senate,Mike Fullerton,DEM,440002,3,0,60,63,43
Mcclain,State Senate,Corey Brooks,REP,440002,6,7,129,142,43
Mcclain,State House,Matt Branstetter,DEM,440002,4,1,59,64,20
Mcclain,State House,Bobby Cleveland,REP,440002,5,6,128,139,20
Mcclain,President,Barack Obama,DEM,440003,2,6,46,54,
Mcclain,President,Mitt Romney,REP,440003,6,21,105,132,
Mcclain,U.S. House,Donna Marie Bebo,DEM,440003,1,6,40,47,04
Mcclain,U.S. House,Tom Cole,REP,440003,2,23,102,127,04
Mcclain,U.S. House,Rj Harris,IND,440003,5,0,9,14,04
Mcclain,State Senate,Mike Fullerton,DEM,440003,4,8,61,73,43
Mcclain,State Senate,Corey Brooks,REP,440003,4,21,89,114,43
Mcclain,State House,Matt Branstetter,DEM,440003,5,10,74,89,20
Mcclain,State House,Bobby Cleveland,REP,440003,3,19,75,97,20
Mcclain,President,Barack Obama,DEM,440004,6,11,80,97,
Mcclain,President,Mitt Romney,REP,440004,7,20,200,227,
Mcclain,U.S. House,Donna Marie Bebo,DEM,440004,5,10,65,80,04
Mcclain,U.S. House,Tom Cole,REP,440004,8,20,199,227,04
Mcclain,U.S. House,Rj Harris,IND,440004,0,1,18,19,04
Mcclain,State Senate,Mike Fullerton,DEM,440004,6,10,99,115,43
Mcclain,State Senate,Corey Brooks,REP,440004,7,20,182,209,43
Mcclain,State House,Steven Vines,DEM,440004,4,6,56,66,42
Mcclain,State House,Lisa Billy,REP,440004,9,25,229,263,42
Mcclain,President,Barack Obama,DEM,440005,7,4,96,107,
Mcclain,President,Mitt Romney,REP,440005,23,31,401,455,
Mcclain,U.S. House,Donna Marie Bebo,DEM,440005,8,3,84,95,04
Mcclain,U.S. House,Tom Cole,REP,440005,22,28,386,436,04
Mcclain,U.S. House,Rj Harris,IND,440005,0,3,22,25,04
Mcclain,State Senate,Mike Fullerton,DEM,440005,11,7,126,144,43
Mcclain,State Senate,Corey Brooks,REP,440005,19,27,361,407,43
Mcclain,State House,Steven Vines,DEM,440005,10,5,92,107,42
Mcclain,State House,Lisa Billy,REP,440005,20,30,401,451,42
Mcclain,President,Barack Obama,DEM,440006,6,47,114,167,
Mcclain,President,Mitt Romney,REP,440006,36,162,468,666,
Mcclain,U.S. House,Donna Marie Bebo,DEM,440006,6,36,89,131,04
Mcclain,U.S. House,Tom Cole,REP,440006,31,168,462,661,04
Mcclain,U.S. House,Rj Harris,IND,440006,2,2,28,32,04
Mcclain,State Senate,Mike Fullerton,DEM,440006,9,51,136,196,43
Mcclain,State Senate,Corey Brooks,REP,440006,28,151,432,611,43
Mcclain,State House,Steven Vines,DEM,440006,8,32,78,118,42
Mcclain,State House,Lisa Billy,REP,440006,33,176,499,708,42
Mcclain,President,Barack Obama,DEM,440007,0,11,63,74,
Mcclain,President,Mitt Romney,REP,440007,17,23,198,238,
Mcclain,U.S. House,Donna Marie Bebo,DEM,440007,0,8,54,62,04
Mcclain,U.S. House,Tom Cole,REP,440007,17,26,201,244,04
Mcclain,U.S. House,Rj Harris,IND,440007,0,0,7,7,04
Mcclain,State Senate,Mike Fullerton,DEM,440007,2,10,83,95,43
Mcclain,State Senate,Corey Brooks,REP,440007,15,24,177,216,43
Mcclain,State House,Steven Vines,DEM,440007,0,6,49,55,42
Mcclain,State House,Lisa Billy,REP,440007,17,28,210,255,42
Mcclain,President,Barack Obama,DEM,440008,3,7,112,122,
Mcclain,President,Mitt Romney,REP,440008,23,35,534,592,
Mcclain,U.S. House,Donna Marie Bebo,DEM,440008,5,8,91,104,04
Mcclain,U.S. House,Tom Cole,REP,440008,21,34,529,584,04
Mcclain,U.S. House,Rj Harris,IND,440008,0,0,31,31,04
Mcclain,State Senate,Mike Fullerton,DEM,440008,3,6,117,126,43
Mcclain,State Senate,Corey Brooks,REP,440008,23,36,527,586,43
Mcclain,State House,Steven Vines,DEM,440008,3,7,99,109,42
Mcclain,State House,Lisa Billy,REP,440008,23,35,550,608,42
Mcclain,President,Barack Obama,DEM,440009,7,10,162,179,
Mcclain,President,Mitt Romney,REP,440009,34,25,420,479,
Mcclain,U.S. House,Donna Marie Bebo,DEM,440009,9,9,126,144,04
Mcclain,U.S. House,Tom Cole,REP,440009,30,25,429,484,04
Mcclain,U.S. House,Rj Harris,IND,440009,2,0,22,24,04
Mcclain,State Senate,Mike Fullerton,DEM,440009,9,10,155,174,43
Mcclain,State Senate,Corey Brooks,REP,440009,31,24,419,474,43
Mcclain,State House,Matt Branstetter,DEM,440009,13,11,185,209,20
Mcclain,State House,Bobby Cleveland,REP,440009,28,23,389,440,20
Mcclain,President,Barack Obama,DEM,440010,4,0,35,39,
Mcclain,President,Mitt Romney,REP,440010,7,12,151,170,
Mcclain,U.S. House,Donna Marie Bebo,DEM,440010,4,0,35,39,04
Mcclain,U.S. House,Tom Cole,REP,440010,7,12,139,158,04
Mcclain,U.S. House,Rj Harris,IND,440010,0,0,8,8,04
Mcclain,State Senate,Mike Fullerton,DEM,440010,4,1,45,50,43
Mcclain,State Senate,Corey Brooks,REP,440010,7,11,136,154,43
Mcclain,State House,Steven Vines,DEM,440010,5,0,38,43,42
Mcclain,State House,Lisa Billy,REP,440010,6,12,146,164,42
Mcclain,President,Barack Obama,DEM,440011,2,5,87,94,
Mcclain,President,Mitt Romney,REP,440011,3,16,240,259,
Mcclain,U.S. House,Donna Marie Bebo,DEM,440011,2,4,70,76,04
Mcclain,U.S. House,Tom Cole,REP,440011,3,14,234,251,04
Mcclain,U.S. House,Rj Harris,IND,440011,0,3,22,25,04
Mcclain,State Senate,Mike Fullerton,DEM,440011,2,6,109,117,43
Mcclain,State Senate,Corey Brooks,REP,440011,3,15,212,230,43
Mcclain,State House,Steven Vines,DEM,440011,2,4,72,78,42
Mcclain,State House,Lisa Billy,REP,440011,3,17,250,270,42
Mcclain,President,Barack Obama,DEM,440012,11,4,227,242,
Mcclain,President,Mitt Romney,REP,440012,44,38,734,816,
Mcclain,U.S. House,Donna Marie Bebo,DEM,440012,8,5,185,198,04
Mcclain,U.S. House,Tom Cole,REP,440012,47,34,723,804,04
Mcclain,U.S. House,Rj Harris,IND,440012,4,3,52,59,04
Mcclain,State Senate,Mike Fullerton,DEM,440012,10,6,257,273,43
Mcclain,State Senate,Corey Brooks,REP,440012,47,36,689,772,43
Mcclain,State House,Steven Vines,DEM,440012,10,4,189,203,42
Mcclain,State House,Lisa Billy,REP,440012,48,38,760,846,42
Mcclain,President,Barack Obama,DEM,440013,17,7,334,358,
Mcclain,President,Mitt Romney,REP,440013,84,44,1118,1246,
Mcclain,U.S. House,Donna Marie Bebo,DEM,440013,16,7,265,288,04
Mcclain,U.S. House,Tom Cole,REP,440013,76,42,1114,1232,04
Mcclain,U.S. House,Rj Harris,IND,440013,5,2,65,72,04
Mcclain,State Senate,Mike Fullerton,DEM,440013,18,8,409,435,43
Mcclain,State Senate,Corey Brooks,REP,440013,79,43,1026,1148,43
Mcclain,State House,Matt Branstetter,DEM,440013,20,9,395,424,20
Mcclain,State House,Bobby Cleveland,REP,440013,75,40,1033,1148,20
Mcclain,President,Barack Obama,DEM,440014,2,0,82,84,
Mcclain,President,Mitt Romney,REP,440014,23,15,375,413,
Mcclain,U.S. House,Donna Marie Bebo,DEM,440014,1,0,70,71,04
Mcclain,U.S. House,Tom Cole,REP,440014,23,15,369,407,04
Mcclain,U.S. House,Rj Harris,IND,440014,1,0,16,17,04
Mcclain,State Senate,Mike Fullerton,DEM,440014,4,1,115,120,43
Mcclain,State Senate,Corey Brooks,REP,440014,21,14,338,373,43
Mcclain,State House,Matt Branstetter,DEM,440014,4,0,98,102,20
Mcclain,State House,Bobby Cleveland,REP,440014,21,15,353,389,20
Mcclain,President,Barack Obama,DEM,440015,5,7,142,154,
Mcclain,President,Mitt Romney,REP,440015,40,38,602,680,
Mcclain,U.S. House,Donna Marie Bebo,DEM,440015,5,7,122,134,04
Mcclain,U.S. House,Tom Cole,REP,440015,39,35,577,651,04
Mcclain,U.S. House,Rj Harris,IND,440015,1,3,40,44,04
Mcclain,State Senate,Mike Fullerton,DEM,440015,7,7,197,211,43
Mcclain,State Senate,Corey Brooks,REP,440015,37,38,538,613,43
Mcclain,State House,Stewart Meyer,DEM,440015,8,15,191,214,51
Mcclain,State House,Scott Biggs,REP,440015,36,30,543,609,51
Mcclain,President,Barack Obama,DEM,440016,19,1,173,193,
Mcclain,President,Mitt Romney,REP,440016,45,33,665,743,
Mcclain,U.S. House,Donna Marie Bebo,DEM,440016,15,1,155,171,04
Mcclain,U.S. House,Tom Cole,REP,440016,49,33,651,733,04
Mcclain,U.S. House,Rj Harris,IND,440016,1,0,30,31,04
Mcclain,State Senate,Mike Fullerton,DEM,440016,19,5,198,222,43
Mcclain,State Senate,Corey Brooks,REP,440016,46,29,632,707,43
Mcclain,State House,Steven Vines,DEM,440016,20,4,156,180,42
Mcclain,State House,Lisa Billy,REP,440016,45,29,674,748,42
Mcclain,President,Barack Obama,DEM,440017,1,4,23,28,
Mcclain,President,Mitt Romney,REP,440017,9,12,131,152,
Mcclain,U.S. House,Donna Marie Bebo,DEM,440017,2,4,17,23,04
Mcclain,U.S. House,Tom Cole,REP,440017,8,12,127,147,04
Mcclain,U.S. House,Rj Harris,IND,440017,0,0,10,10,04
Mcclain,State Senate,Mike Fullerton,DEM,440017,1,4,44,49,43
Mcclain,State Senate,Corey Brooks,REP,440017,9,12,110,131,43
Mcclain,State House,Matt Branstetter,DEM,440017,1,5,38,44,20
Mcclain,State House,Bobby Cleveland,REP,440017,8,11,115,134,20
Mcclain,President,Barack Obama,DEM,440018,4,2,84,90,
Mcclain,President,Mitt Romney,REP,440018,23,22,329,374,
Mcclain,U.S. House,Donna Marie Bebo,DEM,440018,4,1,70,75,04
Mcclain,U.S. House,Tom Cole,REP,440018,22,21,327,370,04
Mcclain,U.S. House,Rj Harris,IND,440018,0,2,12,14,04
Mcclain,State Senate,Mike Fullerton,DEM,440018,3,2,91,96,43
Mcclain,State Senate,Corey Brooks,REP,440018,23,21,318,362,43
Mcclain,State House,Matt Branstetter,DEM,440018,7,4,106,117,20
Mcclain,State House,Bobby Cleveland,REP,440018,20,20,297,337,20
Mcclain,President,Barack Obama,DEM,440019,10,7,149,166,
Mcclain,President,Mitt Romney,REP,440019,34,18,458,510,
Mcclain,U.S. House,Donna Marie Bebo,DEM,440019,4,6,118,128,04
Mcclain,U.S. House,Tom Cole,REP,440019,38,19,450,507,04
Mcclain,U.S. House,Rj Harris,IND,440019,2,0,34,36,04
Mcclain,State Senate,Mike Fullerton,DEM,440019,7,11,165,183,43
Mcclain,State Senate,Corey Brooks,REP,440019,37,14,427,478,43
Mcclain,State House,Steven Vines,DEM,440019,3,4,135,142,42
Mcclain,State House,Lisa Billy,REP,440019,41,21,461,523,42
Mcclain,President,Barack Obama,DEM,440020,7,7,80,94,
Mcclain,President,Mitt Romney,REP,440020,16,26,380,422,
Mcclain,U.S. House,Donna Marie Bebo,DEM,440020,5,6,60,71,04
Mcclain,U.S. House,Tom Cole,REP,440020,15,27,373,415,04
Mcclain,U.S. House,Rj Harris,IND,440020,3,0,25,28,04
Mcclain,State Senate,Mike Fullerton,DEM,440020,5,8,82,95,43
Mcclain,State Senate,Corey Brooks,REP,440020,18,25,371,414,43
Mcclain,State House,Matt Branstetter,DEM,440020,7,9,120,136,20
Mcclain,State House,Bobby Cleveland,REP,440020,15,24,332,371,20
Mcclain,President,Barack Obama,DEM,440021,8,50,149,207,
Mcclain,President,Mitt Romney,REP,440021,10,64,270,344,
Mcclain,U.S. House,Donna Marie Bebo,DEM,440021,8,44,125,177,04
Mcclain,U.S. House,Tom Cole,REP,440021,10,67,271,348,04
Mcclain,U.S. House,Rj Harris,IND,440021,0,3,23,26,04
Mcclain,State Senate,Mike Fullerton,DEM,440021,8,53,191,252,43
Mcclain,State Senate,Corey Brooks,REP,440021,9,60,225,294,43
Mcclain,State House,Steven Vines,DEM,440021,9,29,106,144,42
Mcclain,State House,Lisa Billy,REP,440021,8,83,310,401,42
Mcclain,President,Barack Obama,DEM,440023,6,31,105,142,
Mcclain,President,Mitt Romney,REP,440023,24,97,387,508,
Mcclain,U.S. House,Donna Marie Bebo,DEM,440023,3,27,85,115,04
Mcclain,U.S. House,Tom Cole,REP,440023,26,98,393,517,04
Mcclain,U.S. House,Rj Harris,IND,440023,0,2,15,17,04
Mcclain,State Senate,Mike Fullerton,DEM,440023,7,36,135,178,43
Mcclain,State Senate,Corey Brooks,REP,440023,22,89,352,463,43
Mcclain,State House,Matt Branstetter,DEM,440023,5,41,132,178,20
Mcclain,State House,Bobby Cleveland,REP,440023,23,82,354,459,20
Mcclain,President,Barack Obama,DEM,440024,17,40,168,225,
Mcclain,President,Mitt Romney,REP,440024,27,80,423,530,
Mcclain,U.S. House,Donna Marie Bebo,DEM,440024,16,35,133,184,04
Mcclain,U.S. House,Tom Cole,REP,440024,25,80,434,539,04
Mcclain,U.S. House,Rj Harris,IND,440024,1,4,20,25,04
Mcclain,State Senate,Mike Fullerton,DEM,440024,17,41,191,249,43
Mcclain,State Senate,Corey Brooks,REP,440024,23,78,384,485,43
Mcclain,State House,Steven Vines,DEM,440024,11,31,109,151,42
Mcclain,State House,Lisa Billy,REP,440024,30,87,478,595,42
Mcclain,President,Barack Obama,DEM,440026,0,4,24,28,
Mcclain,President,Mitt Romney,REP,440026,2,41,139,182,
Mcclain,U.S. House,Donna Marie Bebo,DEM,440026,0,4,26,30,04
Mcclain,U.S. House,Tom Cole,REP,440026,2,40,133,175,04
Mcclain,U.S. House,Rj Harris,IND,440026,0,0,3,3,04
Mcclain,State Senate,Mike Fullerton,DEM,440026,0,5,36,41,43
Mcclain,State Senate,Corey Brooks,REP,440026,2,38,124,164,43
Mcclain,State House,Steven Vines,DEM,440026,0,1,18,19,42
Mcclain,State House,Lisa Billy,REP,440026,2,44,145,191,42
Mcclain,President,Barack Obama,DEM,440027,1,2,51,54,
Mcclain,President,Mitt Romney,REP,440027,19,4,258,281,
Mcclain,U.S. House,Donna Marie Bebo,DEM,440027,2,3,36,41,04
Mcclain,U.S. House,Tom Cole,REP,440027,17,3,249,269,04
Mcclain,U.S. House,Rj Harris,IND,440027,1,0,25,26,04
Mcclain,State Senate,Mike Fullerton,DEM,440027,1,3,74,78,43
Mcclain,State Senate,Corey Brooks,REP,440027,19,3,232,254,43
Mcclain,State House,Matt Branstetter,DEM,440027,0,3,67,70,20
Mcclain,State House,Bobby Cleveland,REP,440027,20,3,239,262,20
Mcclain,President,Barack Obama,DEM,440028,7,5,88,100,
Mcclain,President,Mitt Romney,REP,440028,18,34,292,344,
Mcclain,U.S. House,Donna Marie Bebo,DEM,440028,3,4,73,80,04
Mcclain,U.S. House,Tom Cole,REP,440028,19,34,292,345,04
Mcclain,U.S. House,Rj Harris,IND,440028,2,2,15,19,04
Mcclain,State Senate,Mike Fullerton,DEM,440028,7,5,94,106,43
Mcclain,State Senate,Corey Brooks,REP,440028,17,34,285,336,43
Mcclain,State House,Matt Branstetter,DEM,440028,7,9,104,120,20
Mcclain,State House,Bobby Cleveland,REP,440028,17,30,269,316,20
Mccurtain,President,Barack Obama,DEM,450002,1,8,110,119,
Mccurtain,President,Mitt Romney,REP,450002,3,11,99,113,
Mccurtain,U.S. House,Rob Wallace,DEM,450002,2,9,123,134,02
Mccurtain,U.S. House,Markwayne Mullin,REP,450002,2,9,72,83,02
Mccurtain,U.S. House,Michael Fulks,IND,450002,0,1,9,10,02
Mccurtain,State Senate,Jerry Ellis,DEM,450002,3,17,170,190,5
Mccurtain,State Senate,Howard Houchen,REP,450002,1,2,37,40,5
Mccurtain,President,Barack Obama,DEM,450004,5,41,119,165,
Mccurtain,President,Mitt Romney,REP,450004,12,93,307,412,
Mccurtain,U.S. House,Rob Wallace,DEM,450004,2,53,160,215,02
Mccurtain,U.S. House,Markwayne Mullin,REP,450004,12,76,246,334,02
Mccurtain,U.S. House,Michael Fulks,IND,450004,2,2,16,20,02
Mccurtain,State Senate,Jerry Ellis,DEM,450004,10,97,300,407,5
Mccurtain,State Senate,Howard Houchen,REP,450004,7,31,123,161,5
Mccurtain,President,Barack Obama,DEM,450005,2,16,202,220,
Mccurtain,President,Mitt Romney,REP,450005,0,8,29,37,
Mccurtain,U.S. House,Rob Wallace,DEM,450005,2,17,202,221,02
Mccurtain,U.S. House,Markwayne Mullin,REP,450005,0,6,23,29,02
Mccurtain,U.S. House,Michael Fulks,IND,450005,0,0,3,3,02
Mccurtain,State Senate,Jerry Ellis,DEM,450005,2,19,216,237,5
Mccurtain,State Senate,Howard Houchen,REP,450005,0,4,15,19,5
Mccurtain,President,Barack Obama,DEM,450006,12,30,120,162,
Mccurtain,President,Mitt Romney,REP,450006,8,70,308,386,
Mccurtain,U.S. House,Rob Wallace,DEM,450006,14,43,188,245,02
Mccurtain,U.S. House,Markwayne Mullin,REP,450006,6,54,230,290,02
Mccurtain,U.S. House,Michael Fulks,IND,450006,1,2,12,15,02
Mccurtain,State Senate,Jerry Ellis,DEM,450006,15,65,315,395,5
Mccurtain,State Senate,Howard Houchen,REP,450006,5,36,115,156,5
Mccurtain,President,Barack Obama,DEM,450008,5,16,83,104,
Mccurtain,President,Mitt Romney,REP,450008,20,61,324,405,
Mccurtain,U.S. House,Rob Wallace,DEM,450008,4,26,129,159,02
Mccurtain,U.S. House,Markwayne Mullin,REP,450008,17,50,269,336,02
Mccurtain,U.S. House,Michael Fulks,IND,450008,4,0,6,10,02
Mccurtain,State Senate,Jerry Ellis,DEM,450008,16,49,291,356,5
Mccurtain,State Senate,Howard Houchen,REP,450008,10,26,115,151,5
Mccurtain,President,Barack Obama,DEM,450009,2,17,139,158,
Mccurtain,President,Mitt Romney,REP,450009,13,32,296,341,
Mccurtain,U.S. House,Rob Wallace,DEM,450009,4,22,182,208,02
Mccurtain,U.S. House,Markwayne Mullin,REP,450009,11,25,238,274,02
Mccurtain,U.S. House,Michael Fulks,IND,450009,0,1,9,10,02
Mccurtain,State Senate,Jerry Ellis,DEM,450009,9,37,304,350,5
Mccurtain,State Senate,Howard Houchen,REP,450009,7,12,128,147,5
Mccurtain,President,Barack Obama,DEM,450011,3,4,45,52,
Mccurtain,President,Mitt Romney,REP,450011,5,17,104,126,
Mccurtain,U.S. House,Rob Wallace,DEM,450011,3,11,68,82,02
Mccurtain,U.S. House,Markwayne Mullin,REP,450011,4,9,75,88,02
Mccurtain,U.S. House,Michael Fulks,IND,450011,1,1,2,4,02
Mccurtain,State Senate,Jerry Ellis,DEM,450011,4,18,116,138,5
Mccurtain,State Senate,Howard Houchen,REP,450011,4,3,32,39,5
Mccurtain,President,Barack Obama,DEM,450012,0,1,72,73,
Mccurtain,President,Mitt Romney,REP,450012,2,3,66,71,
Mccurtain,U.S. House,Rob Wallace,DEM,450012,0,1,97,98,02
Mccurtain,U.S. House,Markwayne Mullin,REP,450012,2,3,34,39,02
Mccurtain,U.S. House,Michael Fulks,IND,450012,0,0,3,3,02
Mccurtain,State Senate,Jerry Ellis,DEM,450012,0,3,122,125,5
Mccurtain,State Senate,Howard Houchen,REP,450012,2,1,16,19,5
Mccurtain,President,Barack Obama,DEM,450013,3,5,51,59,
Mccurtain,President,Mitt Romney,REP,450013,6,29,225,260,
Mccurtain,U.S. House,Rob Wallace,DEM,450013,3,11,96,110,02
Mccurtain,U.S. House,Markwayne Mullin,REP,450013,6,20,162,188,02
Mccurtain,U.S. House,Michael Fulks,IND,450013,0,1,10,11,02
Mccurtain,State Senate,Jerry Ellis,DEM,450013,6,25,202,233,5
Mccurtain,State Senate,Howard Houchen,REP,450013,3,8,72,83,5
Mccurtain,President,Barack Obama,DEM,450014,0,3,32,35,
Mccurtain,President,Mitt Romney,REP,450014,5,5,121,131,
Mccurtain,U.S. House,Rob Wallace,DEM,450014,0,4,54,58,02
Mccurtain,U.S. House,Markwayne Mullin,REP,450014,4,4,87,95,02
Mccurtain,U.S. House,Michael Fulks,IND,450014,0,0,5,5,02
Mccurtain,State Senate,Jerry Ellis,DEM,450014,2,8,115,125,5
Mccurtain,State Senate,Howard Houchen,REP,450014,2,0,36,38,5
Mccurtain,President,Barack Obama,DEM,450015,0,0,19,19,
Mccurtain,President,Mitt Romney,REP,450015,2,12,130,144,
Mccurtain,U.S. House,Rob Wallace,DEM,450015,1,3,38,42,02
Mccurtain,U.S. House,Markwayne Mullin,REP,450015,0,9,107,116,02
Mccurtain,U.S. House,Michael Fulks,IND,450015,1,0,2,3,02
Mccurtain,State Senate,Jerry Ellis,DEM,450015,2,8,117,127,5
Mccurtain,State Senate,Howard Houchen,REP,450015,0,4,32,36,5
Mccurtain,President,Barack Obama,DEM,450017,0,9,129,138,
Mccurtain,President,Mitt Romney,REP,450017,3,16,248,267,
Mccurtain,U.S. House,Rob Wallace,DEM,450017,0,10,158,168,02
Mccurtain,U.S. House,Markwayne Mullin,REP,450017,3,11,211,225,02
Mccurtain,U.S. House,Michael Fulks,IND,450017,0,1,5,6,02
Mccurtain,State Senate,Jerry Ellis,DEM,450017,0,17,281,298,5
Mccurtain,State Senate,Howard Houchen,REP,450017,3,5,93,101,5
Mccurtain,President,Barack Obama,DEM,450018,8,10,134,152,
Mccurtain,President,Mitt Romney,REP,450018,16,17,473,506,
Mccurtain,U.S. House,Rob Wallace,DEM,450018,13,13,231,257,02
Mccurtain,U.S. House,Markwayne Mullin,REP,450018,8,11,348,367,02
Mccurtain,U.S. House,Michael Fulks,IND,450018,0,3,22,25,02
Mccurtain,State Senate,Jerry Ellis,DEM,450018,15,17,424,456,5
Mccurtain,State Senate,Howard Houchen,REP,450018,8,10,179,197,5
Mccurtain,President,Barack Obama,DEM,450019,7,4,66,77,
Mccurtain,President,Mitt Romney,REP,450019,10,15,366,391,
Mccurtain,U.S. House,Rob Wallace,DEM,450019,9,6,109,124,02
Mccurtain,U.S. House,Markwayne Mullin,REP,450019,7,13,297,317,02
Mccurtain,U.S. House,Michael Fulks,IND,450019,0,0,17,17,02
Mccurtain,State Senate,Jerry Ellis,DEM,450019,12,8,295,315,5
Mccurtain,State Senate,Howard Houchen,REP,450019,4,11,128,143,5
Mccurtain,President,Barack Obama,DEM,450020,3,4,60,67,
Mccurtain,President,Mitt Romney,REP,450020,11,29,299,339,
Mccurtain,U.S. House,Rob Wallace,DEM,450020,3,9,93,105,02
Mccurtain,U.S. House,Markwayne Mullin,REP,450020,10,24,246,280,02
Mccurtain,U.S. House,Michael Fulks,IND,450020,1,0,14,15,02
Mccurtain,State Senate,Jerry Ellis,DEM,450020,9,19,223,251,5
Mccurtain,State Senate,Howard Houchen,REP,450020,5,14,132,151,5
Mccurtain,President,Barack Obama,DEM,450022,0,1,38,39,
Mccurtain,President,Mitt Romney,REP,450022,8,16,264,288,
Mccurtain,U.S. House,Rob Wallace,DEM,450022,2,2,86,90,02
Mccurtain,U.S. House,Markwayne Mullin,REP,450022,5,14,195,214,02
Mccurtain,U.S. House,Michael Fulks,IND,450022,1,0,12,13,02
Mccurtain,State Senate,Jerry Ellis,DEM,450022,3,13,218,234,5
Mccurtain,State Senate,Howard Houchen,REP,450022,5,4,81,90,5
Mccurtain,President,Barack Obama,DEM,450023,1,4,80,85,
Mccurtain,President,Mitt Romney,REP,450023,2,7,190,199,
Mccurtain,U.S. House,Rob Wallace,DEM,450023,2,5,127,134,02
Mccurtain,U.S. House,Markwayne Mullin,REP,450023,0,6,130,136,02
Mccurtain,U.S. House,Michael Fulks,IND,450023,1,0,6,7,02
Mccurtain,State Senate,Jerry Ellis,DEM,450023,2,7,223,232,5
Mccurtain,State Senate,Howard Houchen,REP,450023,1,4,42,47,5
Mccurtain,President,Barack Obama,DEM,450024,3,1,30,34,
Mccurtain,President,Mitt Romney,REP,450024,7,1,119,127,
Mccurtain,U.S. House,Rob Wallace,DEM,450024,6,1,61,68,02
Mccurtain,U.S. House,Markwayne Mullin,REP,450024,4,0,82,86,02
Mccurtain,U.S. House,Michael Fulks,IND,450024,0,1,5,6,02
Mccurtain,State Senate,Jerry Ellis,DEM,450024,7,1,119,127,5
Mccurtain,State Senate,Howard Houchen,REP,450024,3,1,33,37,5
Mccurtain,President,Barack Obama,DEM,450025,1,1,25,27,
Mccurtain,President,Mitt Romney,REP,450025,6,1,182,189,
Mccurtain,U.S. House,Rob Wallace,DEM,450025,1,1,72,74,02
Mccurtain,U.S. House,Markwayne Mullin,REP,450025,6,1,120,127,02
Mccurtain,U.S. House,Michael Fulks,IND,450025,0,0,12,12,02
Mccurtain,State Senate,Jerry Ellis,DEM,450025,1,1,117,119,5
Mccurtain,State Senate,Howard Houchen,REP,450025,6,1,88,95,5
Mccurtain,President,Barack Obama,DEM,450026,2,0,22,24,
Mccurtain,President,Mitt Romney,REP,450026,12,8,139,159,
Mccurtain,U.S. House,Rob Wallace,DEM,450026,6,4,35,45,02
Mccurtain,U.S. House,Markwayne Mullin,REP,450026,8,3,112,123,02
Mccurtain,U.S. House,Michael Fulks,IND,450026,0,1,6,7,02
Mccurtain,State Senate,Jerry Ellis,DEM,450026,6,4,82,92,5
Mccurtain,State Senate,Howard Houchen,REP,450026,8,4,74,86,5
Mccurtain,President,Barack Obama,DEM,450027,1,0,16,17,
Mccurtain,President,Mitt Romney,REP,450027,4,3,89,96,
Mccurtain,U.S. House,Rob Wallace,DEM,450027,1,0,43,44,02
Mccurtain,U.S. House,Markwayne Mullin,REP,450027,4,3,58,65,02
Mccurtain,U.S. House,Michael Fulks,IND,450027,0,0,3,3,02
Mccurtain,State Senate,Jerry Ellis,DEM,450027,4,2,92,98,5
Mccurtain,State Senate,Howard Houchen,REP,450027,1,1,13,15,5
Mccurtain,President,Barack Obama,DEM,450028,2,1,8,11,
Mccurtain,President,Mitt Romney,REP,450028,0,2,76,78,
Mccurtain,U.S. House,Rob Wallace,DEM,450028,2,1,28,31,02
Mccurtain,U.S. House,Markwayne Mullin,REP,450028,0,2,47,49,02
Mccurtain,U.S. House,Michael Fulks,IND,450028,0,0,4,4,02
Mccurtain,State Senate,Jerry Ellis,DEM,450028,2,3,65,70,5
Mccurtain,State Senate,Howard Houchen,REP,450028,0,0,18,18,5
Mccurtain,President,Barack Obama,DEM,450029,1,3,34,38,
Mccurtain,President,Mitt Romney,REP,450029,10,13,226,249,
Mccurtain,U.S. House,Rob Wallace,DEM,450029,2,6,84,92,02
Mccurtain,U.S. House,Markwayne Mullin,REP,450029,8,9,159,176,02
Mccurtain,U.S. House,Michael Fulks,IND,450029,0,0,10,10,02
Mccurtain,State Senate,Jerry Ellis,DEM,450029,6,15,195,216,5
Mccurtain,State Senate,Howard Houchen,REP,450029,4,1,66,71,5
Mccurtain,President,Barack Obama,DEM,450031,1,10,74,85,
Mccurtain,President,Mitt Romney,REP,450031,17,69,383,469,
Mccurtain,U.S. House,Rob Wallace,DEM,450031,2,23,135,160,02
Mccurtain,U.S. House,Markwayne Mullin,REP,450031,16,55,302,373,02
Mccurtain,U.S. House,Michael Fulks,IND,450031,0,1,12,13,02
Mccurtain,State Senate,Jerry Ellis,DEM,450031,10,49,329,388,5
Mccurtain,State Senate,Howard Houchen,REP,450031,7,29,130,166,5
Mccurtain,President,Barack Obama,DEM,450032,0,4,22,26,
Mccurtain,President,Mitt Romney,REP,450032,3,19,110,132,
Mccurtain,U.S. House,Rob Wallace,DEM,450032,0,13,49,62,02
Mccurtain,U.S. House,Markwayne Mullin,REP,450032,3,11,80,94,02
Mccurtain,U.S. House,Michael Fulks,IND,450032,0,0,4,4,02
Mccurtain,State Senate,Jerry Ellis,DEM,450032,3,22,105,130,5
Mccurtain,State Senate,Howard Houchen,REP,450032,0,2,28,30,5
Mccurtain,President,Barack Obama,DEM,450033,3,5,26,34,
Mccurtain,President,Mitt Romney,REP,450033,2,2,114,118,
Mccurtain,U.S. House,Rob Wallace,DEM,450033,4,5,56,65,02
Mccurtain,U.S. House,Markwayne Mullin,REP,450033,1,2,76,79,02
Mccurtain,U.S. House,Michael Fulks,IND,450033,0,0,7,7,02
Mccurtain,State Senate,Jerry Ellis,DEM,450033,3,7,115,125,5
Mccurtain,State Senate,Howard Houchen,REP,450033,2,0,25,27,5
Mccurtain,President,Barack Obama,DEM,450034,4,2,49,55,
Mccurtain,President,Mitt Romney,REP,450034,10,22,255,287,
Mccurtain,U.S. House,Rob Wallace,DEM,450034,7,10,104,121,02
Mccurtain,U.S. House,Markwayne Mullin,REP,450034,7,13,190,210,02
Mccurtain,U.S. House,Michael Fulks,IND,450034,0,1,7,8,02
Mccurtain,State Senate,Jerry Ellis,DEM,450034,11,19,239,269,5
Mccurtain,State Senate,Howard Houchen,REP,450034,2,5,64,71,5
Mccurtain,President,Barack Obama,DEM,450035,2,3,142,147,
Mccurtain,President,Mitt Romney,REP,450035,12,22,434,468,
Mccurtain,U.S. House,Rob Wallace,DEM,450035,2,6,230,238,02
Mccurtain,U.S. House,Markwayne Mullin,REP,450035,10,19,318,347,02
Mccurtain,U.S. House,Michael Fulks,IND,450035,1,0,12,13,02
Mccurtain,State Senate,Jerry Ellis,DEM,450035,9,18,503,530,5
Mccurtain,State Senate,Howard Houchen,REP,450035,4,7,70,81,5
Mccurtain,President,Barack Obama,DEM,450036,1,3,63,67,
Mccurtain,President,Mitt Romney,REP,450036,9,13,346,368,
Mccurtain,U.S. House,Rob Wallace,DEM,450036,2,7,144,153,02
Mccurtain,U.S. House,Markwayne Mullin,REP,450036,8,8,247,263,02
Mccurtain,U.S. House,Michael Fulks,IND,450036,0,0,8,8,02
Mccurtain,State Senate,Jerry Ellis,DEM,450036,6,15,353,374,5
Mccurtain,State Senate,Howard Houchen,REP,450036,4,1,54,59,5
Mccurtain,President,Barack Obama,DEM,450037,1,0,32,33,
Mccurtain,President,Mitt Romney,REP,450037,2,3,77,82,
Mccurtain,U.S. House,Rob Wallace,DEM,450037,1,1,41,43,02
Mccurtain,U.S. House,Markwayne Mullin,REP,450037,2,2,63,67,02
Mccurtain,U.S. House,Michael Fulks,IND,450037,0,0,5,5,02
Mccurtain,State Senate,Jerry Ellis,DEM,450037,2,1,83,86,5
Mccurtain,State Senate,Howard Houchen,REP,450037,1,2,25,28,5
Mccurtain,President,Barack Obama,DEM,450038,4,4,110,118,
Mccurtain,President,Mitt Romney,REP,450038,8,13,376,397,
Mccurtain,U.S. House,Rob Wallace,DEM,450038,6,7,223,236,02
Mccurtain,U.S. House,Markwayne Mullin,REP,450038,6,9,245,260,02
Mccurtain,U.S. House,Michael Fulks,IND,450038,0,0,12,12,02
Mccurtain,State Senate,Jerry Ellis,DEM,450038,8,15,419,442,5
Mccurtain,State Senate,Howard Houchen,REP,450038,4,2,66,72,5
Mcintosh,President,Barack Obama,DEM,460102,5,8,275,288,
Mcintosh,President,Mitt Romney,REP,460102,11,9,370,390,
Mcintosh,U.S. House,Rob Wallace,DEM,460102,5,9,327,341,02
Mcintosh,U.S. House,Markwayne Mullin,REP,460102,11,8,290,309,02
Mcintosh,U.S. House,Michael Fulks,IND,460102,1,0,31,32,02
Mcintosh,President,Barack Obama,DEM,460103,14,20,388,422,
Mcintosh,President,Mitt Romney,REP,460103,21,34,659,714,
Mcintosh,U.S. House,Rob Wallace,DEM,460103,19,24,479,522,02
Mcintosh,U.S. House,Markwayne Mullin,REP,460103,15,30,522,567,02
Mcintosh,U.S. House,Michael Fulks,IND,460103,0,0,40,40,02
Mcintosh,President,Barack Obama,DEM,460104,2,8,193,203,
Mcintosh,President,Mitt Romney,REP,460104,11,22,293,326,
Mcintosh,U.S. House,Rob Wallace,DEM,460104,3,13,212,228,02
Mcintosh,U.S. House,Markwayne Mullin,REP,460104,10,17,259,286,02
Mcintosh,U.S. House,Michael Fulks,IND,460104,0,0,18,18,02
Mcintosh,President,Barack Obama,DEM,460201,23,54,336,413,
Mcintosh,President,Mitt Romney,REP,460201,24,83,465,572,
Mcintosh,U.S. House,Rob Wallace,DEM,460201,20,51,370,441,02
Mcintosh,U.S. House,Markwayne Mullin,REP,460201,22,79,394,495,02
Mcintosh,U.S. House,Michael Fulks,IND,460201,4,7,36,47,02
Mcintosh,President,Barack Obama,DEM,460203,13,32,163,208,
Mcintosh,President,Mitt Romney,REP,460203,8,40,180,228,
Mcintosh,U.S. House,Rob Wallace,DEM,460203,12,34,167,213,02
Mcintosh,U.S. House,Markwayne Mullin,REP,460203,8,33,158,199,02
Mcintosh,U.S. House,Michael Fulks,IND,460203,1,5,14,20,02
Mcintosh,President,Barack Obama,DEM,460205,23,52,281,356,
Mcintosh,President,Mitt Romney,REP,460205,46,82,622,750,
Mcintosh,U.S. House,Rob Wallace,DEM,460205,28,51,307,386,02
Mcintosh,U.S. House,Markwayne Mullin,REP,460205,38,79,541,658,02
Mcintosh,U.S. House,Michael Fulks,IND,460205,1,5,52,58,02
Mcintosh,President,Barack Obama,DEM,460307,1,11,159,171,
Mcintosh,President,Mitt Romney,REP,460307,12,19,242,273,
Mcintosh,U.S. House,Rob Wallace,DEM,460307,2,11,175,188,02
Mcintosh,U.S. House,Markwayne Mullin,REP,460307,9,19,206,234,02
Mcintosh,U.S. House,Michael Fulks,IND,460307,1,0,18,19,02
Mcintosh,President,Barack Obama,DEM,460310,2,0,71,73,
Mcintosh,President,Mitt Romney,REP,460310,3,4,100,107,
Mcintosh,U.S. House,Rob Wallace,DEM,460310,3,1,85,89,02
Mcintosh,U.S. House,Markwayne Mullin,REP,460310,2,3,79,84,02
Mcintosh,U.S. House,Michael Fulks,IND,460310,0,0,6,6,02
Mcintosh,President,Barack Obama,DEM,460311,3,8,98,109,
Mcintosh,President,Mitt Romney,REP,460311,3,6,136,145,
Mcintosh,U.S. House,Rob Wallace,DEM,460311,4,10,106,120,02
Mcintosh,U.S. House,Markwayne Mullin,REP,460311,4,4,122,130,02
Mcintosh,U.S. House,Michael Fulks,IND,460311,0,0,7,7,02
Mcintosh,President,Barack Obama,DEM,460312,0,0,40,40,
Mcintosh,President,Mitt Romney,REP,460312,0,0,59,59,
Mcintosh,U.S. House,Rob Wallace,DEM,460312,0,0,38,38,02
Mcintosh,U.S. House,Markwayne Mullin,REP,460312,0,0,59,59,02
Mcintosh,U.S. House,Michael Fulks,IND,460312,0,0,3,3,02
Mcintosh,President,Barack Obama,DEM,460313,0,0,40,40,
Mcintosh,President,Mitt Romney,REP,460313,1,2,58,61,
Mcintosh,U.S. House,Rob Wallace,DEM,460313,0,0,44,44,02
Mcintosh,U.S. House,Markwayne Mullin,REP,460313,0,2,53,55,02
Mcintosh,U.S. House,Michael Fulks,IND,460313,0,0,1,1,02
Mcintosh,President,Barack Obama,DEM,460314,7,22,237,266,
Mcintosh,President,Mitt Romney,REP,460314,17,38,387,442,
Mcintosh,U.S. House,Rob Wallace,DEM,460314,7,22,260,289,02
Mcintosh,U.S. House,Markwayne Mullin,REP,460314,15,37,329,381,02
Mcintosh,U.S. House,Michael Fulks,IND,460314,1,0,30,31,02
Mcintosh,President,Barack Obama,DEM,460315,6,0,77,83,
Mcintosh,President,Mitt Romney,REP,460315,4,0,162,166,
Mcintosh,U.S. House,Rob Wallace,DEM,460315,6,0,106,112,02
Mcintosh,U.S. House,Markwayne Mullin,REP,460315,4,0,130,134,02
Mcintosh,U.S. House,Michael Fulks,IND,460315,0,0,6,6,02
Mcintosh,President,Barack Obama,DEM,460316,1,1,105,107,
Mcintosh,President,Mitt Romney,REP,460316,4,9,263,276,
Mcintosh,U.S. House,Rob Wallace,DEM,460316,1,1,130,132,02
Mcintosh,U.S. House,Markwayne Mullin,REP,460316,3,9,227,239,02
Mcintosh,U.S. House,Michael Fulks,IND,460316,1,0,11,12,02
Major,President,Barack Obama,DEM,470002,2,5,81,88,
Major,President,Mitt Romney,REP,470002,26,67,586,679,
Major,U.S. House,Timothy Ray Murray,DEM,470002,1,4,52,57,03
Major,U.S. House,Frank Lucas,REP,470002,25,67,587,679,03
Major,U.S. House,William Sanders,IND,470002,2,1,27,30,03
Major,State Senate,A. Bryce Marlatt,REP,470002,25,67,556,648,27
Major,State Senate,Tommy Nicholson,IND,470002,3,4,98,105,27
Major,President,Barack Obama,DEM,470004,2,4,17,23,
Major,President,Mitt Romney,REP,470004,7,5,138,150,
Major,U.S. House,Timothy Ray Murray,DEM,470004,1,0,11,12,03
Major,U.S. House,Frank Lucas,REP,470004,8,8,140,156,03
Major,U.S. House,William Sanders,IND,470004,0,1,4,5,03
Major,State Senate,A. Bryce Marlatt,REP,470004,7,5,133,145,27
Major,State Senate,Tommy Nicholson,IND,470004,2,4,21,27,27
Major,President,Barack Obama,DEM,470009,0,0,4,4,
Major,President,Mitt Romney,REP,470009,4,2,40,46,
Major,U.S. House,Timothy Ray Murray,DEM,470009,0,0,2,2,03
Major,U.S. House,Frank Lucas,REP,470009,4,2,39,45,03
Major,U.S. House,William Sanders,IND,470009,0,0,3,3,03
Major,State Senate,A. Bryce Marlatt,REP,470009,4,2,38,44,27
Major,State Senate,Tommy Nicholson,IND,470009,0,0,6,6,27
Major,President,Barack Obama,DEM,470010,2,2,14,18,
Major,President,Mitt Romney,REP,470010,12,13,154,179,
Major,U.S. House,Timothy Ray Murray,DEM,470010,2,0,10,12,03
Major,U.S. House,Frank Lucas,REP,470010,12,14,147,173,03
Major,U.S. House,William Sanders,IND,470010,0,1,9,10,03
Major,State Senate,A. Bryce Marlatt,REP,470010,11,14,136,161,27
Major,State Senate,Tommy Nicholson,IND,470010,1,1,26,28,27
Major,President,Barack Obama,DEM,470015,1,0,18,19,
Major,President,Mitt Romney,REP,470015,3,5,177,185,
Major,U.S. House,Timothy Ray Murray,DEM,470015,0,0,16,16,03
Major,U.S. House,Frank Lucas,REP,470015,4,5,177,186,03
Major,U.S. House,William Sanders,IND,470015,0,0,6,6,03
Major,State Senate,A. Bryce Marlatt,REP,470015,3,5,167,175,27
Major,State Senate,Tommy Nicholson,IND,470015,1,0,28,29,27
Major,President,Barack Obama,DEM,470016,2,0,12,14,
Major,President,Mitt Romney,REP,470016,0,2,66,68,
Major,U.S. House,Timothy Ray Murray,DEM,470016,1,0,7,8,03
Major,U.S. House,Frank Lucas,REP,470016,0,2,67,69,03
Major,U.S. House,William Sanders,IND,470016,0,0,4,4,03
Major,State Senate,A. Bryce Marlatt,REP,470016,0,2,68,70,27
Major,State Senate,Tommy Nicholson,IND,470016,0,0,8,8,27
Major,President,Barack Obama,DEM,470020,18,32,96,146,
Major,President,Mitt Romney,REP,470020,49,136,579,764,
Major,U.S. House,Timothy Ray Murray,DEM,470020,9,23,72,104,03
Major,U.S. House,Frank Lucas,REP,470020,54,132,579,765,03
Major,U.S. House,William Sanders,IND,470020,3,13,28,44,03
Major,State Senate,A. Bryce Marlatt,REP,470020,50,137,587,774,27
Major,State Senate,Tommy Nicholson,IND,470020,13,29,75,117,27
Major,President,Barack Obama,DEM,470022,7,39,88,134,
Major,President,Mitt Romney,REP,470022,26,139,464,629,
Major,U.S. House,Timothy Ray Murray,DEM,470022,3,17,38,58,03
Major,U.S. House,Frank Lucas,REP,470022,26,149,482,657,03
Major,U.S. House,William Sanders,IND,470022,3,11,31,45,03
Major,State Senate,A. Bryce Marlatt,REP,470022,26,150,473,649,27
Major,State Senate,Tommy Nicholson,IND,470022,4,25,68,97,27
Marshall,President,Barack Obama,DEM,480101,3,33,139,175,
Marshall,President,Mitt Romney,REP,480101,14,92,394,500,
Marshall,U.S. House,Rob Wallace,DEM,480101,3,46,197,246,02
Marshall,U.S. House,Markwayne Mullin,REP,480101,13,73,316,402,02
Marshall,U.S. House,Michael Fulks,IND,480101,0,5,12,17,02
Marshall,President,Barack Obama,DEM,480102,2,24,103,129,
Marshall,President,Mitt Romney,REP,480102,11,68,185,264,
Marshall,U.S. House,Rob Wallace,DEM,480102,3,38,127,168,02
Marshall,U.S. House,Markwayne Mullin,REP,480102,10,49,129,188,02
Marshall,U.S. House,Michael Fulks,IND,480102,0,3,11,14,02
Marshall,President,Barack Obama,DEM,480105,3,14,78,95,
Marshall,President,Mitt Romney,REP,480105,22,36,183,241,
Marshall,U.S. House,Rob Wallace,DEM,480105,1,14,93,108,02
Marshall,U.S. House,Markwayne Mullin,REP,480105,22,30,160,212,02
Marshall,U.S. House,Michael Fulks,IND,480105,1,6,11,18,02
Marshall,President,Barack Obama,DEM,480106,3,5,64,72,
Marshall,President,Mitt Romney,REP,480106,6,17,138,161,
Marshall,U.S. House,Rob Wallace,DEM,480106,4,5,90,99,02
Marshall,U.S. House,Markwayne Mullin,REP,480106,4,17,97,118,02
Marshall,U.S. House,Michael Fulks,IND,480106,0,0,12,12,02
Marshall,President,Barack Obama,DEM,480201,1,7,73,81,
Marshall,President,Mitt Romney,REP,480201,10,45,179,234,
Marshall,U.S. House,Rob Wallace,DEM,480201,2,12,92,106,02
Marshall,U.S. House,Markwayne Mullin,REP,480201,9,40,148,197,02
Marshall,U.S. House,Michael Fulks,IND,480201,0,1,13,14,02
Marshall,President,Barack Obama,DEM,480202,8,21,100,129,
Marshall,President,Mitt Romney,REP,480202,9,48,160,217,
Marshall,U.S. House,Rob Wallace,DEM,480202,8,31,126,165,02
Marshall,U.S. House,Markwayne Mullin,REP,480202,8,37,112,157,02
Marshall,U.S. House,Michael Fulks,IND,480202,0,2,19,21,02
Marshall,President,Barack Obama,DEM,480204,5,13,115,133,
Marshall,President,Mitt Romney,REP,480204,12,80,287,379,
Marshall,U.S. House,Rob Wallace,DEM,480204,3,22,140,165,02
Marshall,U.S. House,Markwayne Mullin,REP,480204,13,68,232,313,02
Marshall,U.S. House,Michael Fulks,IND,480204,0,1,26,27,02
Marshall,President,Barack Obama,DEM,480206,4,15,72,91,
Marshall,President,Mitt Romney,REP,480206,21,28,226,275,
Marshall,U.S. House,Rob Wallace,DEM,480206,5,20,112,137,02
Marshall,U.S. House,Markwayne Mullin,REP,480206,16,21,171,208,02
Marshall,U.S. House,Michael Fulks,IND,480206,4,2,13,19,02
Marshall,President,Barack Obama,DEM,480302,5,15,80,100,
Marshall,President,Mitt Romney,REP,480302,22,43,232,297,
Marshall,U.S. House,Rob Wallace,DEM,480302,5,18,100,123,02
Marshall,U.S. House,Markwayne Mullin,REP,480302,20,39,195,254,02
Marshall,U.S. House,Michael Fulks,IND,480302,2,1,17,20,02
Marshall,President,Barack Obama,DEM,480303,3,18,133,154,
Marshall,President,Mitt Romney,REP,480303,43,97,391,531,
Marshall,U.S. House,Rob Wallace,DEM,480303,0,26,177,203,02
Marshall,U.S. House,Markwayne Mullin,REP,480303,40,88,323,451,02
Marshall,U.S. House,Michael Fulks,IND,480303,5,1,19,25,02
Marshall,President,Barack Obama,DEM,480304,6,20,211,237,
Marshall,President,Mitt Romney,REP,480304,50,86,509,645,
Marshall,U.S. House,Rob Wallace,DEM,480304,3,25,231,259,02
Marshall,U.S. House,Markwayne Mullin,REP,480304,49,73,440,562,02
Marshall,U.S. House,Michael Fulks,IND,480304,3,8,42,53,02
Mayes,President,Barack Obama,DEM,490011,3,7,168,178,
Mayes,President,Mitt Romney,REP,490011,16,28,344,388,
Mayes,U.S. House,Rob Wallace,DEM,490011,3,7,148,158,02
Mayes,U.S. House,Markwayne Mullin,REP,490011,14,28,335,377,02
Mayes,U.S. House,Michael Fulks,IND,490011,3,0,29,32,02
Mayes,President,Barack Obama,DEM,490012,3,9,161,173,
Mayes,President,Mitt Romney,REP,490012,14,37,385,436,
Mayes,U.S. House,Rob Wallace,DEM,490012,3,8,176,187,02
Mayes,U.S. House,Markwayne Mullin,REP,490012,14,37,351,402,02
Mayes,U.S. House,Michael Fulks,IND,490012,0,1,17,18,02
Mayes,President,Barack Obama,DEM,490014,0,7,65,72,
Mayes,President,Mitt Romney,REP,490014,2,5,95,102,
Mayes,U.S. House,Rob Wallace,DEM,490014,1,3,64,68,02
Mayes,U.S. House,Markwayne Mullin,REP,490014,1,7,89,97,02
Mayes,U.S. House,Michael Fulks,IND,490014,0,1,6,7,02
Mayes,President,Barack Obama,DEM,490015,7,24,132,163,
Mayes,President,Mitt Romney,REP,490015,7,41,258,306,
Mayes,U.S. House,Rob Wallace,DEM,490015,5,27,128,160,02
Mayes,U.S. House,Markwayne Mullin,REP,490015,8,37,249,294,02
Mayes,U.S. House,Michael Fulks,IND,490015,1,1,13,15,02
Mayes,President,Barack Obama,DEM,490016,5,24,92,121,
Mayes,President,Mitt Romney,REP,490016,12,49,205,266,
Mayes,U.S. House,Rob Wallace,DEM,490016,3,26,92,121,02
Mayes,U.S. House,Markwayne Mullin,REP,490016,14,47,192,253,02
Mayes,U.S. House,Michael Fulks,IND,490016,0,1,13,14,02
Mayes,President,Barack Obama,DEM,490020,3,34,208,245,
Mayes,President,Mitt Romney,REP,490020,12,83,476,571,
Mayes,U.S. House,Rob Wallace,DEM,490020,1,33,200,234,02
Mayes,U.S. House,Markwayne Mullin,REP,490020,12,81,458,551,02
Mayes,U.S. House,Michael Fulks,IND,490020,2,4,26,32,02
Mayes,President,Barack Obama,DEM,490021,4,20,85,109,
Mayes,President,Mitt Romney,REP,490021,8,39,188,235,
Mayes,U.S. House,Rob Wallace,DEM,490021,4,19,83,106,02
Mayes,U.S. House,Markwayne Mullin,REP,490021,6,39,179,224,02
Mayes,U.S. House,Michael Fulks,IND,490021,0,1,12,13,02
Mayes,President,Barack Obama,DEM,490022,4,10,112,126,
Mayes,President,Mitt Romney,REP,490022,13,33,386,432,
Mayes,U.S. House,Rob Wallace,DEM,490022,4,10,128,142,02
Mayes,U.S. House,Markwayne Mullin,REP,490022,13,31,348,392,02
Mayes,U.S. House,Michael Fulks,IND,490022,0,2,23,25,02
Mayes,State Senate,Jim Bynum,DEM,490022,5,10,189,204,3
Mayes,State Senate,Wayne Shaw,REP,490022,12,32,306,350,3
Mayes,President,Barack Obama,DEM,490023,6,16,228,250,
Mayes,President,Mitt Romney,REP,490023,12,51,509,572,
Mayes,U.S. House,Rob Wallace,DEM,490023,4,21,231,256,02
Mayes,U.S. House,Markwayne Mullin,REP,490023,13,45,468,526,02
Mayes,U.S. House,Michael Fulks,IND,490023,1,1,36,38,02
Mayes,State Senate,Jim Bynum,DEM,490023,5,26,305,336,3
Mayes,State Senate,Wayne Shaw,REP,490023,12,41,424,477,3
Mayes,President,Barack Obama,DEM,490024,6,3,102,111,
Mayes,President,Mitt Romney,REP,490024,8,20,306,334,
Mayes,U.S. House,Rob Wallace,DEM,490024,6,2,98,106,02
Mayes,U.S. House,Markwayne Mullin,REP,490024,8,21,285,314,02
Mayes,U.S. House,Michael Fulks,IND,490024,0,1,23,24,02
Mayes,State Senate,Jim Bynum,DEM,490024,6,3,154,163,3
Mayes,State Senate,Wayne Shaw,REP,490024,8,20,249,277,3
Mayes,President,Barack Obama,DEM,490025,7,2,117,126,
Mayes,President,Mitt Romney,REP,490025,8,12,231,251,
Mayes,U.S. House,Rob Wallace,DEM,490025,6,3,127,136,02
Mayes,U.S. House,Markwayne Mullin,REP,490025,9,11,200,220,02
Mayes,U.S. House,Michael Fulks,IND,490025,0,0,17,17,02
Mayes,President,Barack Obama,DEM,490026,1,0,9,10,
Mayes,President,Mitt Romney,REP,490026,4,0,50,54,
Mayes,U.S. House,Rob Wallace,DEM,490026,0,0,12,12,02
Mayes,U.S. House,Markwayne Mullin,REP,490026,4,0,46,50,02
Mayes,U.S. House,Michael Fulks,IND,490026,1,0,1,2,02
Mayes,State Senate,Jim Bynum,DEM,490026,1,0,22,23,3
Mayes,State Senate,Wayne Shaw,REP,490026,4,0,37,41,3
Mayes,President,Barack Obama,DEM,490027,0,0,19,19,
Mayes,President,Mitt Romney,REP,490027,0,1,32,33,
Mayes,U.S. House,Rob Wallace,DEM,490027,0,0,19,19,02
Mayes,U.S. House,Markwayne Mullin,REP,490027,0,1,27,28,02
Mayes,U.S. House,Michael Fulks,IND,490027,0,0,4,4,02
Mayes,President,Barack Obama,DEM,490031,12,10,220,242,
Mayes,President,Mitt Romney,REP,490031,21,25,434,480,
Mayes,U.S. House,Rob Wallace,DEM,490031,10,12,218,240,02
Mayes,U.S. House,Markwayne Mullin,REP,490031,21,22,413,456,02
Mayes,U.S. House,Michael Fulks,IND,490031,2,1,22,25,02
Mayes,President,Barack Obama,DEM,490034,14,8,149,171,
Mayes,President,Mitt Romney,REP,490034,12,8,208,228,
Mayes,U.S. House,Rob Wallace,DEM,490034,13,6,151,170,02
Mayes,U.S. House,Markwayne Mullin,REP,490034,13,10,195,218,02
Mayes,U.S. House,Michael Fulks,IND,490034,0,0,12,12,02
Mayes,President,Barack Obama,DEM,490036,8,26,479,513,
Mayes,President,Mitt Romney,REP,490036,24,46,676,746,
Mayes,U.S. House,Rob Wallace,DEM,490036,6,25,493,524,02
Mayes,U.S. House,Markwayne Mullin,REP,490036,24,46,623,693,02
Mayes,U.S. House,Michael Fulks,IND,490036,2,1,38,41,02
Mayes,President,Barack Obama,DEM,490037,2,3,187,192,
Mayes,President,Mitt Romney,REP,490037,13,20,461,494,
Mayes,U.S. House,Rob Wallace,DEM,490037,2,4,206,212,02
Mayes,U.S. House,Markwayne Mullin,REP,490037,13,19,421,453,02
Mayes,U.S. House,Michael Fulks,IND,490037,0,1,23,24,02
Mayes,State Senate,Jim Bynum,DEM,490037,3,5,285,293,3
Mayes,State Senate,Wayne Shaw,REP,490037,11,19,363,393,3
Mayes,President,Barack Obama,DEM,490038,2,5,77,84,
Mayes,President,Mitt Romney,REP,490038,6,17,152,175,
Mayes,U.S. House,Rob Wallace,DEM,490038,3,6,91,100,02
Mayes,U.S. House,Markwayne Mullin,REP,490038,5,16,132,153,02
Mayes,U.S. House,Michael Fulks,IND,490038,0,0,6,6,02
Mayes,President,Barack Obama,DEM,490039,3,7,275,285,
Mayes,President,Mitt Romney,REP,490039,12,27,384,423,
Mayes,U.S. House,Rob Wallace,DEM,490039,5,9,287,301,02
Mayes,U.S. House,Markwayne Mullin,REP,490039,11,25,349,385,02
Mayes,U.S. House,Michael Fulks,IND,490039,0,0,26,26,02
Mayes,State Senate,Jim Bynum,DEM,490039,5,10,363,378,3
Mayes,State Senate,Wayne Shaw,REP,490039,11,23,297,331,3
Mayes,President,Barack Obama,DEM,490101,6,29,153,188,
Mayes,President,Mitt Romney,REP,490101,8,34,238,280,
Mayes,U.S. House,Rob Wallace,DEM,490101,4,30,143,177,02
Mayes,U.S. House,Markwayne Mullin,REP,490101,9,30,238,277,02
Mayes,U.S. House,Michael Fulks,IND,490101,1,3,13,17,02
Mayes,President,Barack Obama,DEM,490121,10,40,209,259,
Mayes,President,Mitt Romney,REP,490121,16,59,450,525,
Mayes,U.S. House,Rob Wallace,DEM,490121,7,40,215,262,02
Mayes,U.S. House,Markwayne Mullin,REP,490121,16,54,412,482,02
Mayes,U.S. House,Michael Fulks,IND,490121,3,4,32,39,02
Mayes,President,Barack Obama,DEM,490122,2,2,30,34,
Mayes,President,Mitt Romney,REP,490122,4,10,46,60,
Mayes,U.S. House,Rob Wallace,DEM,490122,2,2,24,28,02
Mayes,U.S. House,Markwayne Mullin,REP,490122,4,10,51,65,02
Mayes,U.S. House,Michael Fulks,IND,490122,0,0,1,1,02
Mayes,President,Barack Obama,DEM,490130,5,9,150,164,
Mayes,President,Mitt Romney,REP,490130,14,26,281,321,
Mayes,U.S. House,Rob Wallace,DEM,490130,6,10,152,168,02
Mayes,U.S. House,Markwayne Mullin,REP,490130,10,24,250,284,02
Mayes,U.S. House,Michael Fulks,IND,490130,2,0,29,31,02
Mayes,President,Barack Obama,DEM,490132,10,53,220,283,
Mayes,President,Mitt Romney,REP,490132,9,58,327,394,
Mayes,U.S. House,Rob Wallace,DEM,490132,10,46,211,267,02
Mayes,U.S. House,Markwayne Mullin,REP,490132,9,62,320,391,02
Mayes,U.S. House,Michael Fulks,IND,490132,0,3,19,22,02
Mayes,President,Barack Obama,DEM,490241,15,81,302,398,
Mayes,President,Mitt Romney,REP,490241,24,167,684,875,
Mayes,U.S. House,Rob Wallace,DEM,490241,15,76,287,378,02
Mayes,U.S. House,Markwayne Mullin,REP,490241,24,167,644,835,02
Mayes,U.S. House,Michael Fulks,IND,490241,0,8,46,54,02
Mayes,President,Barack Obama,DEM,490242,6,33,156,195,
Mayes,President,Mitt Romney,REP,490242,5,67,347,419,
Mayes,U.S. House,Rob Wallace,DEM,490242,5,35,154,194,02
Mayes,U.S. House,Markwayne Mullin,REP,490242,5,62,329,396,02
Mayes,U.S. House,Michael Fulks,IND,490242,1,2,18,21,02
Mayes,President,Barack Obama,DEM,490311,2,5,105,112,
Mayes,President,Mitt Romney,REP,490311,3,11,223,237,
Mayes,U.S. House,Rob Wallace,DEM,490311,2,3,123,128,02
Mayes,U.S. House,Markwayne Mullin,REP,490311,3,11,191,205,02
Mayes,U.S. House,Michael Fulks,IND,490311,0,2,13,15,02
Murray,President,Barack Obama,DEM,500004,2,27,137,166,
Murray,President,Mitt Romney,REP,500004,16,80,364,460,
Murray,U.S. House,Donna Marie Bebo,DEM,500004,1,19,118,138,04
Murray,U.S. House,Tom Cole,REP,500004,16,83,364,463,04
Murray,U.S. House,Rj Harris,IND,500004,1,5,19,25,04
Murray,State House,Doris Anne Row,DEM,500004,10,58,269,337,22
Murray,State House,Charles Mccall,REP,500004,8,48,231,287,22
Murray,President,Barack Obama,DEM,500005,7,10,346,363,
Murray,President,Mitt Romney,REP,500005,11,48,725,784,
Murray,U.S. House,Donna Marie Bebo,DEM,500005,5,10,290,305,04
Murray,U.S. House,Tom Cole,REP,500005,13,47,725,785,04
Murray,U.S. House,Rj Harris,IND,500005,0,1,50,51,04
Murray,State House,Doris Anne Row,DEM,500005,8,31,631,670,22
Murray,State House,Charles Mccall,REP,500005,9,27,441,477,22
Murray,President,Barack Obama,DEM,500007,6,11,77,94,
Murray,President,Mitt Romney,REP,500007,1,26,193,220,
Murray,U.S. House,Donna Marie Bebo,DEM,500007,4,10,73,87,04
Murray,U.S. House,Tom Cole,REP,500007,0,26,181,207,04
Murray,U.S. House,Rj Harris,IND,500007,2,1,14,17,04
Murray,State House,Brian Spencer,DEM,500007,5,12,104,121,48
Murray,State House,Patrick Ownbey,REP,500007,0,25,160,185,48
Murray,President,Barack Obama,DEM,500009,2,15,91,108,
Murray,President,Mitt Romney,REP,500009,17,29,208,254,
Murray,U.S. House,Donna Marie Bebo,DEM,500009,2,10,62,74,04
Murray,U.S. House,Tom Cole,REP,500009,16,34,227,277,04
Murray,U.S. House,Rj Harris,IND,500009,0,0,9,9,04
Murray,State House,Doris Anne Row,DEM,500009,13,32,189,234,22
Murray,State House,Charles Mccall,REP,500009,6,12,108,126,22
Murray,President,Barack Obama,DEM,500012,3,3,67,73,
Murray,President,Mitt Romney,REP,500012,6,9,185,200,
Murray,U.S. House,Donna Marie Bebo,DEM,500012,3,4,53,60,04
Murray,U.S. House,Tom Cole,REP,500012,5,8,193,206,04
Murray,U.S. House,Rj Harris,IND,500012,1,0,5,6,04
Murray,State House,Doris Anne Row,DEM,500012,8,5,120,133,22
Murray,State House,Charles Mccall,REP,500012,1,7,134,142,22
Murray,President,Barack Obama,DEM,500014,4,3,72,79,
Murray,President,Mitt Romney,REP,500014,3,13,89,105,
Murray,U.S. House,Donna Marie Bebo,DEM,500014,3,3,58,64,04
Murray,U.S. House,Tom Cole,REP,500014,3,13,100,116,04
Murray,U.S. House,Rj Harris,IND,500014,1,0,1,2,04
Murray,State House,Doris Anne Row,DEM,500014,5,6,101,112,22
Murray,State House,Charles Mccall,REP,500014,2,11,60,73,22
Murray,President,Barack Obama,DEM,500015,29,69,158,256,
Murray,President,Mitt Romney,REP,500015,33,122,462,617,
Murray,U.S. House,Donna Marie Bebo,DEM,500015,21,58,141,220,04
Murray,U.S. House,Tom Cole,REP,500015,35,129,456,620,04
Murray,U.S. House,Rj Harris,IND,500015,2,3,20,25,04
Murray,State House,Doris Anne Row,DEM,500015,38,121,396,555,22
Murray,State House,Charles Mccall,REP,500015,21,70,224,315,22
Murray,President,Barack Obama,DEM,500017,0,0,17,17,
Murray,President,Mitt Romney,REP,500017,1,8,63,72,
Murray,U.S. House,Donna Marie Bebo,DEM,500017,0,2,13,15,04
Murray,U.S. House,Tom Cole,REP,500017,1,6,66,73,04
Murray,U.S. House,Rj Harris,IND,500017,0,0,1,1,04
Murray,State House,Doris Anne Row,DEM,500017,1,5,37,43,22
Murray,State House,Charles Mccall,REP,500017,0,3,43,46,22
Murray,President,Barack Obama,DEM,500018,1,22,116,139,
Murray,President,Mitt Romney,REP,500018,13,43,281,337,
Murray,U.S. House,Donna Marie Bebo,DEM,500018,2,14,90,106,04
Murray,U.S. House,Tom Cole,REP,500018,12,48,289,349,04
Murray,U.S. House,Rj Harris,IND,500018,0,3,15,18,04
Murray,State House,Doris Anne Row,DEM,500018,13,47,256,316,22
Murray,State House,Charles Mccall,REP,500018,1,18,142,161,22
Murray,President,Barack Obama,DEM,500020,9,67,169,245,
Murray,President,Mitt Romney,REP,500020,16,93,448,557,
Murray,U.S. House,Donna Marie Bebo,DEM,500020,7,53,140,200,04
Murray,U.S. House,Tom Cole,REP,500020,17,100,455,572,04
Murray,U.S. House,Rj Harris,IND,500020,0,6,17,23,04
Murray,State House,Doris Anne Row,DEM,500020,14,120,402,536,22
Murray,State House,Charles Mccall,REP,500020,10,39,218,267,22
Muskogee,President,Barack Obama,DEM,510005,30,105,523,658,
Muskogee,President,Mitt Romney,REP,510005,23,92,566,681,
Muskogee,U.S. House,Rob Wallace,DEM,510005,27,103,542,672,02
Muskogee,U.S. House,Markwayne Mullin,REP,510005,21,84,480,585,02
Muskogee,U.S. House,Michael Fulks,IND,510005,2,9,66,77,02
Muskogee,State Senate,Earl Garrison,DEM,510005,35,148,784,967,9
Muskogee,State Senate,Barney Taylor,REP,510005,13,46,298,357,9
Muskogee,State House,Jerry Rains,DEM,510005,27,119,612,758,14
Muskogee,State House,Arthur Hulbert,REP,510005,21,78,471,570,14
Muskogee,President,Barack Obama,DEM,510007,26,129,429,584,
Muskogee,President,Mitt Romney,REP,510007,29,169,698,896,
Muskogee,U.S. House,Rob Wallace,DEM,510007,27,139,441,607,02
Muskogee,U.S. House,Markwayne Mullin,REP,510007,23,147,632,802,02
Muskogee,U.S. House,Michael Fulks,IND,510007,5,11,50,66,02
Muskogee,State Senate,Earl Garrison,DEM,510007,37,228,796,1061,9
Muskogee,State Senate,Barney Taylor,REP,510007,17,69,317,403,9
Muskogee,State House,Jerry Rains,DEM,510007,29,139,500,668,14
Muskogee,State House,Arthur Hulbert,REP,510007,25,159,620,804,14
Muskogee,President,Barack Obama,DEM,510009,14,134,449,597,
Muskogee,President,Mitt Romney,REP,510009,32,238,802,1072,
Muskogee,U.S. House,Rob Wallace,DEM,510009,14,152,500,666,02
Muskogee,U.S. House,Markwayne Mullin,REP,510009,30,209,689,928,02
Muskogee,U.S. House,Michael Fulks,IND,510009,1,9,59,69,02
Muskogee,State Senate,Earl Garrison,DEM,510009,32,254,875,1161,9
Muskogee,State Senate,Barney Taylor,REP,510009,14,113,362,489,9
Muskogee,State House,Jerry Rains,DEM,510009,19,141,547,707,14
Muskogee,State House,Arthur Hulbert,REP,510009,27,229,705,961,14
Muskogee,President,Barack Obama,DEM,510011,5,38,247,290,
Muskogee,President,Mitt Romney,REP,510011,10,44,289,343,
Muskogee,U.S. House,Rob Wallace,DEM,510011,5,41,270,316,02
Muskogee,U.S. House,Markwayne Mullin,REP,510011,9,39,236,284,02
Muskogee,U.S. House,Michael Fulks,IND,510011,1,2,29,32,02
Muskogee,State Senate,Earl Garrison,DEM,510011,6,57,389,452,9
Muskogee,State Senate,Barney Taylor,REP,510011,8,24,142,174,9
Muskogee,State House,Jerry Rains,DEM,510011,6,40,306,352,14
Muskogee,State House,Arthur Hulbert,REP,510011,9,41,227,277,14
Muskogee,President,Barack Obama,DEM,510013,7,53,303,363,
Muskogee,President,Mitt Romney,REP,510013,20,82,407,509,
Muskogee,U.S. House,Rob Wallace,DEM,510013,10,67,331,408,02
Muskogee,U.S. House,Markwayne Mullin,REP,510013,17,60,338,415,02
Muskogee,U.S. House,Michael Fulks,IND,510013,0,9,36,45,02
Muskogee,State Senate,Earl Garrison,DEM,510013,18,93,501,612,9
Muskogee,State Senate,Barney Taylor,REP,510013,9,41,199,249,9
Muskogee,State House,Jerry Rains,DEM,510013,11,65,372,448,14
Muskogee,State House,Arthur Hulbert,REP,510013,16,70,333,419,14
Muskogee,President,Barack Obama,DEM,510017,13,47,261,321,
Muskogee,President,Mitt Romney,REP,510017,2,12,70,84,
Muskogee,U.S. House,Rob Wallace,DEM,510017,13,46,256,315,02
Muskogee,U.S. House,Markwayne Mullin,REP,510017,2,12,60,74,02
Muskogee,U.S. House,Michael Fulks,IND,510017,0,2,14,16,02
Muskogee,State Senate,Earl Garrison,DEM,510017,13,49,294,356,9
Muskogee,State Senate,Barney Taylor,REP,510017,2,11,34,47,9
Muskogee,President,Barack Obama,DEM,510021,8,127,468,603,
Muskogee,President,Mitt Romney,REP,510021,3,43,232,278,
Muskogee,U.S. House,Rob Wallace,DEM,510021,8,131,462,601,02
Muskogee,U.S. House,Markwayne Mullin,REP,510021,3,34,205,242,02
Muskogee,U.S. House,Michael Fulks,IND,510021,0,7,29,36,02
Muskogee,State Senate,Earl Garrison,DEM,510021,9,154,551,714,9
Muskogee,State Senate,Barney Taylor,REP,510021,1,17,136,154,9
Muskogee,President,Barack Obama,DEM,510022,21,93,363,477,
Muskogee,President,Mitt Romney,REP,510022,32,85,435,552,
Muskogee,U.S. House,Rob Wallace,DEM,510022,22,99,346,467,02
Muskogee,U.S. House,Markwayne Mullin,REP,510022,28,71,397,496,02
Muskogee,U.S. House,Michael Fulks,IND,510022,1,7,50,58,02
Muskogee,State Senate,Earl Garrison,DEM,510022,32,136,566,734,9
Muskogee,State Senate,Barney Taylor,REP,510022,17,40,220,277,9
Muskogee,President,Barack Obama,DEM,510023,28,223,534,785,
Muskogee,President,Mitt Romney,REP,510023,6,45,128,179,
Muskogee,U.S. House,Rob Wallace,DEM,510023,26,219,526,771,02
Muskogee,U.S. House,Markwayne Mullin,REP,510023,4,37,118,159,02
Muskogee,U.S. House,Michael Fulks,IND,510023,3,12,17,32,02
Muskogee,State Senate,Earl Garrison,DEM,510023,28,236,587,851,9
Muskogee,State Senate,Barney Taylor,REP,510023,5,31,72,108,9
Muskogee,President,Barack Obama,DEM,510028,13,47,248,308,
Muskogee,President,Mitt Romney,REP,510028,7,19,141,167,
Muskogee,U.S. House,Rob Wallace,DEM,510028,13,44,239,296,02
Muskogee,U.S. House,Markwayne Mullin,REP,510028,6,17,134,157,02
Muskogee,U.S. House,Michael Fulks,IND,510028,1,5,14,20,02
Muskogee,State Senate,Earl Garrison,DEM,510028,19,52,319,390,9
Muskogee,State Senate,Barney Taylor,REP,510028,0,14,67,81,9
Muskogee,President,Barack Obama,DEM,510033,13,19,280,312,
Muskogee,President,Mitt Romney,REP,510033,22,29,657,708,
Muskogee,U.S. House,Rob Wallace,DEM,510033,8,20,321,349,02
Muskogee,U.S. House,Markwayne Mullin,REP,510033,25,27,582,634,02
Muskogee,U.S. House,Michael Fulks,IND,510033,2,1,39,42,02
Muskogee,State House,Jerry Shoemake,DEM,510033,17,30,541,588,16
Muskogee,State House,James Delso,REP,510033,18,17,395,430,16
Muskogee,President,Barack Obama,DEM,510036,4,18,141,163,
Muskogee,President,Mitt Romney,REP,510036,7,6,40,53,
Muskogee,U.S. House,Rob Wallace,DEM,510036,6,17,130,153,02
Muskogee,U.S. House,Markwayne Mullin,REP,510036,5,6,42,53,02
Muskogee,U.S. House,Michael Fulks,IND,510036,0,1,6,7,02
Muskogee,State Senate,Earl Garrison,DEM,510036,8,20,150,178,9
Muskogee,State Senate,Barney Taylor,REP,510036,3,4,28,35,9
Muskogee,President,Barack Obama,DEM,510037,5,33,231,269,
Muskogee,President,Mitt Romney,REP,510037,11,44,379,434,
Muskogee,U.S. House,Rob Wallace,DEM,510037,5,31,242,278,02
Muskogee,U.S. House,Markwayne Mullin,REP,510037,8,41,337,386,02
Muskogee,U.S. House,Michael Fulks,IND,510037,3,4,30,37,02
Muskogee,State Senate,Earl Garrison,DEM,510037,11,55,428,494,9
Muskogee,State Senate,Barney Taylor,REP,510037,5,20,179,204,9
Muskogee,President,Barack Obama,DEM,510038,18,92,278,388,
Muskogee,President,Mitt Romney,REP,510038,45,143,487,675,
Muskogee,U.S. House,Rob Wallace,DEM,510038,21,95,297,413,02
Muskogee,U.S. House,Markwayne Mullin,REP,510038,36,130,437,603,02
Muskogee,U.S. House,Michael Fulks,IND,510038,4,10,26,40,02
Muskogee,State Senate,Earl Garrison,DEM,510038,43,165,560,768,9
Muskogee,State Senate,Barney Taylor,REP,510038,20,69,197,286,9
Muskogee,State House,Jerry Rains,DEM,510038,28,100,326,454,14
Muskogee,State House,Arthur Hulbert,REP,510038,35,133,433,601,14
Muskogee,President,Barack Obama,DEM,510040,4,11,69,84,
Muskogee,President,Mitt Romney,REP,510040,8,23,215,246,
Muskogee,U.S. House,Rob Wallace,DEM,510040,2,16,78,96,02
Muskogee,U.S. House,Markwayne Mullin,REP,510040,9,17,189,215,02
Muskogee,U.S. House,Michael Fulks,IND,510040,1,1,16,18,02
Muskogee,State Senate,Earl Garrison,DEM,510040,5,24,181,210,9
Muskogee,State Senate,Barney Taylor,REP,510040,7,10,100,117,9
Muskogee,State House,Jerry Rains,DEM,510040,4,7,74,85,14
Muskogee,State House,Arthur Hulbert,REP,510040,8,27,208,243,14
Muskogee,President,Barack Obama,DEM,510041,17,76,542,635,
Muskogee,President,Mitt Romney,REP,510041,54,144,1156,1354,
Muskogee,U.S. House,Rob Wallace,DEM,510041,18,97,722,837,02
Muskogee,U.S. House,Markwayne Mullin,REP,510041,49,113,888,1050,02
Muskogee,U.S. House,Michael Fulks,IND,510041,2,9,76,87,02
Muskogee,State House,Jerry Rains,DEM,510041,16,83,595,694,14
Muskogee,State House,Arthur Hulbert,REP,510041,53,134,1094,1281,14
Muskogee,President,Barack Obama,DEM,510044,3,3,160,166,
Muskogee,President,Mitt Romney,REP,510044,4,7,252,263,
Muskogee,U.S. House,Rob Wallace,DEM,510044,5,5,177,187,02
Muskogee,U.S. House,Markwayne Mullin,REP,510044,2,6,201,209,02
Muskogee,U.S. House,Michael Fulks,IND,510044,0,0,32,32,02
Muskogee,State Senate,Earl Garrison,DEM,510044,6,8,275,289,9
Muskogee,State Senate,Barney Taylor,REP,510044,1,3,136,140,9
Muskogee,State House,Jerry Rains,DEM,510044,5,4,198,207,14
Muskogee,State House,Arthur Hulbert,REP,510044,2,7,214,223,14
Muskogee,President,Barack Obama,DEM,510045,10,10,187,207,
Muskogee,President,Mitt Romney,REP,510045,4,36,292,332,
Muskogee,U.S. House,Rob Wallace,DEM,510045,10,17,213,240,02
Muskogee,U.S. House,Markwayne Mullin,REP,510045,3,28,242,273,02
Muskogee,U.S. House,Michael Fulks,IND,510045,1,1,22,24,02
Muskogee,State Senate,Earl Garrison,DEM,510045,12,31,331,374,9
Muskogee,State Senate,Barney Taylor,REP,510045,2,14,145,161,9
Muskogee,State House,Jerry Rains,DEM,510045,10,20,211,241,14
Muskogee,State House,Arthur Hulbert,REP,510045,4,25,268,297,14
Muskogee,President,Barack Obama,DEM,510046,7,37,279,323,
Muskogee,President,Mitt Romney,REP,510046,14,80,625,719,
Muskogee,U.S. House,Rob Wallace,DEM,510046,11,40,316,367,02
Muskogee,U.S. House,Markwayne Mullin,REP,510046,14,72,532,618,02
Muskogee,U.S. House,Michael Fulks,IND,510046,0,4,52,56,02
Muskogee,State Senate,Earl Garrison,DEM,510046,15,81,632,728,9
Muskogee,State Senate,Barney Taylor,REP,510046,10,33,263,306,9
Muskogee,President,Barack Obama,DEM,510047,12,69,266,347,
Muskogee,President,Mitt Romney,REP,510047,12,42,310,364,
Muskogee,U.S. House,Rob Wallace,DEM,510047,12,66,282,360,02
Muskogee,U.S. House,Markwayne Mullin,REP,510047,12,39,270,321,02
Muskogee,U.S. House,Michael Fulks,IND,510047,0,6,30,36,02
Muskogee,State Senate,Earl Garrison,DEM,510047,13,94,451,558,9
Muskogee,State Senate,Barney Taylor,REP,510047,10,17,124,151,9
Muskogee,President,Barack Obama,DEM,510049,1,18,78,97,
Muskogee,President,Mitt Romney,REP,510049,4,30,123,157,
Muskogee,U.S. House,Rob Wallace,DEM,510049,1,19,92,112,02
Muskogee,U.S. House,Markwayne Mullin,REP,510049,4,26,98,128,02
Muskogee,U.S. House,Michael Fulks,IND,510049,0,3,12,15,02
Muskogee,State Senate,Earl Garrison,DEM,510049,2,30,148,180,9
Muskogee,State Senate,Barney Taylor,REP,510049,3,18,51,72,9
Muskogee,State House,Jerry Rains,DEM,510049,1,24,102,127,14
Muskogee,State House,Arthur Hulbert,REP,510049,4,24,99,127,14
Muskogee,President,Barack Obama,DEM,510050,7,9,121,137,
Muskogee,President,Mitt Romney,REP,510050,5,6,93,104,
Muskogee,U.S. House,Rob Wallace,DEM,510050,7,7,121,135,02
Muskogee,U.S. House,Markwayne Mullin,REP,510050,5,6,86,97,02
Muskogee,U.S. House,Michael Fulks,IND,510050,0,1,7,8,02
Muskogee,State House,Jerry Shoemake,DEM,510050,10,12,169,191,16
Muskogee,State House,James Delso,REP,510050,2,1,46,49,16
Muskogee,President,Barack Obama,DEM,510051,0,0,34,34,
Muskogee,President,Mitt Romney,REP,510051,4,1,61,66,
Muskogee,U.S. House,Rob Wallace,DEM,510051,0,0,42,42,02
Muskogee,U.S. House,Markwayne Mullin,REP,510051,4,1,52,57,02
Muskogee,U.S. House,Michael Fulks,IND,510051,0,0,3,3,02
Muskogee,State House,Jerry Shoemake,DEM,510051,1,0,63,64,16
Muskogee,State House,James Delso,REP,510051,3,1,32,36,16
Muskogee,President,Barack Obama,DEM,510052,5,7,75,87,
Muskogee,President,Mitt Romney,REP,510052,6,19,137,162,
Muskogee,U.S. House,Rob Wallace,DEM,510052,5,8,93,106,02
Muskogee,U.S. House,Markwayne Mullin,REP,510052,6,18,105,129,02
Muskogee,U.S. House,Michael Fulks,IND,510052,0,0,10,10,02
Muskogee,President,Barack Obama,DEM,510053,3,14,147,164,
Muskogee,President,Mitt Romney,REP,510053,14,15,314,343,
Muskogee,U.S. House,Rob Wallace,DEM,510053,1,17,166,184,02
Muskogee,U.S. House,Markwayne Mullin,REP,510053,14,14,271,299,02
Muskogee,U.S. House,Michael Fulks,IND,510053,2,0,23,25,02
Muskogee,State Senate,Earl Garrison,DEM,510053,8,24,321,353,9
Muskogee,State Senate,Barney Taylor,REP,510053,9,7,133,149,9
Muskogee,President,Barack Obama,DEM,510055,7,83,407,497,
Muskogee,President,Mitt Romney,REP,510055,32,160,952,1144,
Muskogee,U.S. House,Rob Wallace,DEM,510055,8,92,468,568,02
Muskogee,U.S. House,Markwayne Mullin,REP,510055,30,138,830,998,02
Muskogee,U.S. House,Michael Fulks,IND,510055,0,12,66,78,02
Muskogee,State Senate,Earl Garrison,DEM,510055,22,176,951,1149,9
Muskogee,State Senate,Barney Taylor,REP,510055,14,63,398,475,9
Muskogee,President,Barack Obama,DEM,510056,0,7,48,55,
Muskogee,President,Mitt Romney,REP,510056,2,8,78,88,
Muskogee,U.S. House,Rob Wallace,DEM,510056,0,3,49,52,02
Muskogee,U.S. House,Markwayne Mullin,REP,510056,2,8,77,87,02
Muskogee,U.S. House,Michael Fulks,IND,510056,0,4,8,12,02
Muskogee,State Senate,Earl Garrison,DEM,510056,1,10,103,114,9
Muskogee,State Senate,Barney Taylor,REP,510056,1,5,31,37,9
Muskogee,President,Barack Obama,DEM,510057,0,1,7,8,
Muskogee,President,Mitt Romney,REP,510057,1,2,17,20,
Muskogee,U.S. House,Rob Wallace,DEM,510057,0,1,5,6,02
Muskogee,U.S. House,Markwayne Mullin,REP,510057,1,1,16,18,02
Muskogee,U.S. House,Michael Fulks,IND,510057,0,1,3,4,02
Muskogee,State Senate,Earl Garrison,DEM,510057,0,2,13,15,9
Muskogee,State Senate,Barney Taylor,REP,510057,1,1,11,13,9
Muskogee,State House,Jerry Rains,DEM,510057,0,1,12,13,14
Muskogee,State House,Arthur Hulbert,REP,510057,1,2,12,15,14
Muskogee,President,Barack Obama,DEM,510058,4,4,176,184,
Muskogee,President,Mitt Romney,REP,510058,7,10,255,272,
Muskogee,U.S. House,Rob Wallace,DEM,510058,5,6,172,183,02
Muskogee,U.S. House,Markwayne Mullin,REP,510058,6,9,230,245,02
Muskogee,U.S. House,Michael Fulks,IND,510058,0,0,27,27,02
Muskogee,State House,Jerry Rains,DEM,510058,8,8,227,243,14
Muskogee,State House,Arthur Hulbert,REP,510058,3,7,199,209,14
Muskogee,President,Barack Obama,DEM,510059,5,19,253,277,
Muskogee,President,Mitt Romney,REP,510059,11,24,392,427,
Muskogee,U.S. House,Rob Wallace,DEM,510059,5,18,266,289,02
Muskogee,U.S. House,Markwayne Mullin,REP,510059,9,23,336,368,02
Muskogee,U.S. House,Michael Fulks,IND,510059,0,2,39,41,02
Muskogee,President,Barack Obama,DEM,510060,4,2,88,94,
Muskogee,President,Mitt Romney,REP,510060,4,6,96,106,
Muskogee,U.S. House,Rob Wallace,DEM,510060,6,4,96,106,02
Muskogee,U.S. House,Markwayne Mullin,REP,510060,2,4,80,86,02
Muskogee,U.S. House,Michael Fulks,IND,510060,0,0,4,4,02
Muskogee,President,Barack Obama,DEM,510061,3,5,146,154,
Muskogee,President,Mitt Romney,REP,510061,3,17,167,187,
Muskogee,U.S. House,Rob Wallace,DEM,510061,2,6,162,170,02
Muskogee,U.S. House,Markwayne Mullin,REP,510061,3,16,144,163,02
Muskogee,U.S. House,Michael Fulks,IND,510061,1,0,10,11,02
Muskogee,State Senate,Earl Garrison,DEM,510061,3,12,252,267,9
Muskogee,State Senate,Barney Taylor,REP,510061,3,10,63,76,9
Muskogee,President,Barack Obama,DEM,510064,4,10,270,284,
Muskogee,President,Mitt Romney,REP,510064,14,16,389,419,
Muskogee,U.S. House,Rob Wallace,DEM,510064,7,9,307,323,02
Muskogee,U.S. House,Markwayne Mullin,REP,510064,10,16,326,352,02
Muskogee,U.S. House,Michael Fulks,IND,510064,2,1,25,28,02
Noble,President,Barack Obama,DEM,520101,4,34,94,132,
Noble,President,Mitt Romney,REP,520101,28,140,368,536,
Noble,U.S. House,Timothy Ray Murray,DEM,520101,3,27,63,93,03
Noble,U.S. House,Frank Lucas,REP,520101,28,141,381,550,03
Noble,U.S. House,William Sanders,IND,520101,0,5,16,21,03
Noble,President,Barack Obama,DEM,520102,0,6,30,36,
Noble,President,Mitt Romney,REP,520102,7,22,100,129,
Noble,U.S. House,Timothy Ray Murray,DEM,520102,0,5,14,19,03
Noble,U.S. House,Frank Lucas,REP,520102,7,23,111,141,03
Noble,U.S. House,William Sanders,IND,520102,0,0,5,5,03
Noble,President,Barack Obama,DEM,520103,8,0,49,57,
Noble,President,Mitt Romney,REP,520103,9,0,130,139,
Noble,U.S. House,Timothy Ray Murray,DEM,520103,7,0,34,41,03
Noble,U.S. House,Frank Lucas,REP,520103,7,0,133,140,03
Noble,U.S. House,William Sanders,IND,520103,3,0,12,15,03
Noble,President,Barack Obama,DEM,520104,0,3,57,60,
Noble,President,Mitt Romney,REP,520104,5,12,157,174,
Noble,U.S. House,Timothy Ray Murray,DEM,520104,0,1,46,47,03
Noble,U.S. House,Frank Lucas,REP,520104,5,13,157,175,03
Noble,U.S. House,William Sanders,IND,520104,0,1,12,13,03
Noble,President,Barack Obama,DEM,520105,2,3,105,110,
Noble,President,Mitt Romney,REP,520105,0,3,100,103,
Noble,U.S. House,Timothy Ray Murray,DEM,520105,2,2,77,81,03
Noble,U.S. House,Frank Lucas,REP,520105,0,4,105,109,03
Noble,U.S. House,William Sanders,IND,520105,0,0,21,21,03
Noble,President,Barack Obama,DEM,520106,0,3,14,17,
Noble,President,Mitt Romney,REP,520106,0,9,70,79,
Noble,U.S. House,Timothy Ray Murray,DEM,520106,0,0,10,10,03
Noble,U.S. House,Frank Lucas,REP,520106,0,11,63,74,03
Noble,U.S. House,William Sanders,IND,520106,0,0,11,11,03
Noble,President,Barack Obama,DEM,520201,4,42,97,143,
Noble,President,Mitt Romney,REP,520201,25,150,280,455,
Noble,U.S. House,Timothy Ray Murray,DEM,520201,3,29,67,99,03
Noble,U.S. House,Frank Lucas,REP,520201,25,154,291,470,03
Noble,U.S. House,William Sanders,IND,520201,0,5,19,24,03
Noble,President,Barack Obama,DEM,520202,2,27,50,79,
Noble,President,Mitt Romney,REP,520202,10,68,180,258,
Noble,U.S. House,Timothy Ray Murray,DEM,520202,1,23,34,58,03
Noble,U.S. House,Frank Lucas,REP,520202,10,70,184,264,03
Noble,U.S. House,William Sanders,IND,520202,0,2,12,14,03
Noble,President,Barack Obama,DEM,520203,3,17,94,114,
Noble,President,Mitt Romney,REP,520203,6,45,195,246,
Noble,U.S. House,Timothy Ray Murray,DEM,520203,2,10,64,76,03
Noble,U.S. House,Frank Lucas,REP,520203,8,46,207,261,03
Noble,U.S. House,William Sanders,IND,520203,0,6,19,25,03
Noble,President,Barack Obama,DEM,520301,1,24,61,86,
Noble,President,Mitt Romney,REP,520301,16,99,206,321,
Noble,U.S. House,Timothy Ray Murray,DEM,520301,1,15,33,49,03
Noble,U.S. House,Frank Lucas,REP,520301,16,105,216,337,03
Noble,U.S. House,William Sanders,IND,520301,0,2,17,19,03
Noble,President,Barack Obama,DEM,520305,3,3,176,182,
Noble,President,Mitt Romney,REP,520305,17,33,516,566,
Noble,U.S. House,Timothy Ray Murray,DEM,520305,3,2,111,116,03
Noble,U.S. House,Frank Lucas,REP,520305,16,33,539,588,03
Noble,U.S. House,William Sanders,IND,520305,1,0,39,40,03
Noble,President,Barack Obama,DEM,520307,6,38,83,127,
Noble,President,Mitt Romney,REP,520307,23,142,317,482,
Noble,U.S. House,Timothy Ray Murray,DEM,520307,2,21,55,78,03
Noble,U.S. House,Frank Lucas,REP,520307,26,156,325,507,03
Noble,U.S. House,William Sanders,IND,520307,1,2,18,21,03
Nowata,President,Barack Obama,DEM,530101,7,30,149,186,
Nowata,President,Mitt Romney,REP,530101,19,54,226,299,
Nowata,U.S. House,Rob Wallace,DEM,530101,5,28,133,166,02
Nowata,U.S. House,Markwayne Mullin,REP,530101,19,54,231,304,02
Nowata,U.S. House,Michael Fulks,IND,530101,2,1,11,14,02
Nowata,President,Barack Obama,DEM,530102,4,23,153,180,
Nowata,President,Mitt Romney,REP,530102,18,72,357,447,
Nowata,U.S. House,Rob Wallace,DEM,530102,3,24,148,175,02
Nowata,U.S. House,Markwayne Mullin,REP,530102,18,67,335,420,02
Nowata,U.S. House,Michael Fulks,IND,530102,1,3,24,28,02
Nowata,President,Barack Obama,DEM,530103,1,2,65,68,
Nowata,President,Mitt Romney,REP,530103,5,13,163,181,
Nowata,U.S. House,Rob Wallace,DEM,530103,1,3,74,78,02
Nowata,U.S. House,Markwayne Mullin,REP,530103,5,11,148,164,02
Nowata,U.S. House,Michael Fulks,IND,530103,0,0,6,6,02
Nowata,President,Barack Obama,DEM,530201,1,2,80,83,
Nowata,President,Mitt Romney,REP,530201,10,3,205,218,
Nowata,U.S. House,Rob Wallace,DEM,530201,1,2,89,92,02
Nowata,U.S. House,Markwayne Mullin,REP,530201,10,3,186,199,02
Nowata,U.S. House,Michael Fulks,IND,530201,0,0,9,9,02
Nowata,President,Barack Obama,DEM,530202,6,6,36,48,
Nowata,President,Mitt Romney,REP,530202,11,43,215,269,
Nowata,U.S. House,Rob Wallace,DEM,530202,5,9,48,62,02
Nowata,U.S. House,Markwayne Mullin,REP,530202,12,40,198,250,02
Nowata,U.S. House,Michael Fulks,IND,530202,0,1,2,3,02
Nowata,President,Barack Obama,DEM,530203,4,51,139,194,
Nowata,President,Mitt Romney,REP,530203,9,70,301,380,
Nowata,U.S. House,Rob Wallace,DEM,530203,6,41,135,182,02
Nowata,U.S. House,Markwayne Mullin,REP,530203,7,75,276,358,02
Nowata,U.S. House,Michael Fulks,IND,530203,0,5,24,29,02
Nowata,President,Barack Obama,DEM,530204,1,2,51,54,
Nowata,President,Mitt Romney,REP,530204,3,8,166,177,
Nowata,U.S. House,Rob Wallace,DEM,530204,1,0,67,68,02
Nowata,U.S. House,Markwayne Mullin,REP,530204,3,10,146,159,02
Nowata,U.S. House,Michael Fulks,IND,530204,0,0,2,2,02
Nowata,President,Barack Obama,DEM,530301,5,0,187,192,
Nowata,President,Mitt Romney,REP,530301,15,9,376,400,
Nowata,U.S. House,Rob Wallace,DEM,530301,5,2,208,215,02
Nowata,U.S. House,Markwayne Mullin,REP,530301,15,7,327,349,02
Nowata,U.S. House,Michael Fulks,IND,530301,0,0,25,25,02
Nowata,President,Barack Obama,DEM,530302,4,29,93,126,
Nowata,President,Mitt Romney,REP,530302,11,36,162,209,
Nowata,U.S. House,Rob Wallace,DEM,530302,2,28,106,136,02
Nowata,U.S. House,Markwayne Mullin,REP,530302,12,35,144,191,02
Nowata,U.S. House,Michael Fulks,IND,530302,0,1,8,9,02
Nowata,President,Barack Obama,DEM,530303,2,5,71,78,
Nowata,President,Mitt Romney,REP,530303,1,13,157,171,
Nowata,U.S. House,Rob Wallace,DEM,530303,1,8,76,85,02
Nowata,U.S. House,Markwayne Mullin,REP,530303,1,10,142,153,02
Nowata,U.S. House,Michael Fulks,IND,530303,1,0,8,9,02
Nowata,President,Barack Obama,DEM,530304,2,6,27,35,
Nowata,President,Mitt Romney,REP,530304,10,10,61,81,
Nowata,U.S. House,Rob Wallace,DEM,530304,4,4,31,39,02
Nowata,U.S. House,Markwayne Mullin,REP,530304,8,11,54,73,02
Nowata,U.S. House,Michael Fulks,IND,530304,0,1,3,4,02
Okfuskee,President,Barack Obama,DEM,540101,0,6,113,119,
Okfuskee,President,Mitt Romney,REP,540101,4,14,499,517,
Okfuskee,U.S. House,Rob Wallace,DEM,540101,0,6,174,180,02
Okfuskee,U.S. House,Markwayne Mullin,REP,540101,4,15,391,410,02
Okfuskee,U.S. House,Michael Fulks,IND,540101,0,0,34,34,02
Okfuskee,President,Barack Obama,DEM,540102,7,9,164,180,
Okfuskee,President,Mitt Romney,REP,540102,3,4,19,26,
Okfuskee,U.S. House,Rob Wallace,DEM,540102,7,9,162,178,02
Okfuskee,U.S. House,Markwayne Mullin,REP,540102,3,4,15,22,02
Okfuskee,U.S. House,Michael Fulks,IND,540102,0,0,1,1,02
Okfuskee,President,Barack Obama,DEM,540103,0,2,34,36,
Okfuskee,President,Mitt Romney,REP,540103,0,3,87,90,
Okfuskee,U.S. House,Rob Wallace,DEM,540103,0,2,45,47,02
Okfuskee,U.S. House,Markwayne Mullin,REP,540103,0,3,72,75,02
Okfuskee,U.S. House,Michael Fulks,IND,540103,0,0,4,4,02
Okfuskee,President,Barack Obama,DEM,540105,0,9,65,74,
Okfuskee,President,Mitt Romney,REP,540105,4,12,91,107,
Okfuskee,U.S. House,Rob Wallace,DEM,540105,0,10,71,81,02
Okfuskee,U.S. House,Markwayne Mullin,REP,540105,4,11,78,93,02
Okfuskee,U.S. House,Michael Fulks,IND,540105,0,1,6,7,02
Okfuskee,President,Barack Obama,DEM,540206,3,8,73,84,
Okfuskee,President,Mitt Romney,REP,540206,19,30,201,250,
Okfuskee,U.S. House,Rob Wallace,DEM,540206,5,7,89,101,02
Okfuskee,U.S. House,Markwayne Mullin,REP,540206,16,30,179,225,02
Okfuskee,U.S. House,Michael Fulks,IND,540206,2,1,5,8,02
Okfuskee,President,Barack Obama,DEM,540207,1,7,34,42,
Okfuskee,President,Mitt Romney,REP,540207,1,12,67,80,
Okfuskee,U.S. House,Rob Wallace,DEM,540207,2,7,42,51,02
Okfuskee,U.S. House,Markwayne Mullin,REP,540207,0,11,55,66,02
Okfuskee,U.S. House,Michael Fulks,IND,540207,0,1,3,4,02
Okfuskee,President,Barack Obama,DEM,540208,3,12,59,74,
Okfuskee,President,Mitt Romney,REP,540208,11,35,160,206,
Okfuskee,U.S. House,Rob Wallace,DEM,540208,4,12,79,95,02
Okfuskee,U.S. House,Markwayne Mullin,REP,540208,10,32,125,167,02
Okfuskee,U.S. House,Michael Fulks,IND,540208,0,3,16,19,02
Okfuskee,President,Barack Obama,DEM,540209,7,18,140,165,
Okfuskee,President,Mitt Romney,REP,540209,13,66,264,343,
Okfuskee,U.S. House,Rob Wallace,DEM,540209,8,25,165,198,02
Okfuskee,U.S. House,Markwayne Mullin,REP,540209,12,60,219,291,02
Okfuskee,U.S. House,Michael Fulks,IND,540209,0,2,11,13,02
Okfuskee,President,Barack Obama,DEM,540210,2,5,32,39,
Okfuskee,President,Mitt Romney,REP,540210,6,29,88,123,
Okfuskee,U.S. House,Rob Wallace,DEM,540210,4,9,49,62,02
Okfuskee,U.S. House,Markwayne Mullin,REP,540210,4,24,62,90,02
Okfuskee,U.S. House,Michael Fulks,IND,540210,0,1,6,7,02
Okfuskee,State Senate,J. Paul Lane,DEM,540210,4,9,44,57,7
Okfuskee,State Senate,Larry Boggs,REP,540210,4,24,72,100,7
Okfuskee,President,Barack Obama,DEM,540311,12,4,85,101,
Okfuskee,President,Mitt Romney,REP,540311,10,14,137,161,
Okfuskee,U.S. House,Rob Wallace,DEM,540311,12,9,91,112,02
Okfuskee,U.S. House,Markwayne Mullin,REP,540311,9,9,123,141,02
Okfuskee,U.S. House,Michael Fulks,IND,540311,1,1,12,14,02
Okfuskee,President,Barack Obama,DEM,540312,13,10,155,178,
Okfuskee,President,Mitt Romney,REP,540312,8,28,192,228,
Okfuskee,U.S. House,Rob Wallace,DEM,540312,13,10,163,186,02
Okfuskee,U.S. House,Markwayne Mullin,REP,540312,8,26,173,207,02
Okfuskee,U.S. House,Michael Fulks,IND,540312,0,1,11,12,02
Okfuskee,State Senate,J. Paul Lane,DEM,540312,11,10,170,191,7
Okfuskee,State Senate,Larry Boggs,REP,540312,9,27,176,212,7
Okfuskee,President,Barack Obama,DEM,540313,1,1,44,46,
Okfuskee,President,Mitt Romney,REP,540313,2,2,58,62,
Okfuskee,U.S. House,Rob Wallace,DEM,540313,1,0,40,41,02
Okfuskee,U.S. House,Markwayne Mullin,REP,540313,2,2,57,61,02
Okfuskee,U.S. House,Michael Fulks,IND,540313,0,1,4,5,02
Okfuskee,President,Barack Obama,DEM,540314,3,12,103,118,
Okfuskee,President,Mitt Romney,REP,540314,2,26,114,142,
Okfuskee,U.S. House,Rob Wallace,DEM,540314,2,18,108,128,02
Okfuskee,U.S. House,Markwayne Mullin,REP,540314,3,20,95,118,02
Okfuskee,U.S. House,Michael Fulks,IND,540314,0,0,13,13,02
Oklahoma,President,Barack Obama,DEM,550001,0,0,369,369,
Oklahoma,President,Mitt Romney,REP,550001,0,0,428,428,
Oklahoma,U.S. House,Tom Guild,DEM,550001,0,0,343,343,05
Oklahoma,U.S. House,James Lankford,REP,550001,0,0,423,423,05
Oklahoma,U.S. House,Pat Martin,IND,550001,0,0,19,19,05
Oklahoma,U.S. House,Robert Murphy,IND,550001,0,0,13,13,05
Oklahoma,President,Barack Obama,DEM,550002,0,0,201,201,
Oklahoma,President,Mitt Romney,REP,550002,0,0,481,481,
Oklahoma,U.S. House,Tom Guild,DEM,550002,0,0,167,167,05
Oklahoma,U.S. House,James Lankford,REP,550002,0,0,482,482,05
Oklahoma,U.S. House,Pat Martin,IND,550002,0,0,14,14,05
Oklahoma,U.S. House,Robert Murphy,IND,550002,0,0,11,11,05
Oklahoma,President,Barack Obama,DEM,550003,0,0,253,253,
Oklahoma,President,Mitt Romney,REP,550003,0,0,680,680,
Oklahoma,U.S. House,Tom Guild,DEM,550003,0,0,229,229,05
Oklahoma,U.S. House,James Lankford,REP,550003,0,0,667,667,05
Oklahoma,U.S. House,Pat Martin,IND,550003,0,0,21,21,05
Oklahoma,U.S. House,Robert Murphy,IND,550003,0,0,14,14,05
Oklahoma,President,Barack Obama,DEM,550004,0,0,293,293,
Oklahoma,President,Mitt Romney,REP,550004,0,0,783,783,
Oklahoma,U.S. House,Tom Guild,DEM,550004,0,0,252,252,05
Oklahoma,U.S. House,James Lankford,REP,550004,0,0,772,772,05
Oklahoma,U.S. House,Pat Martin,IND,550004,0,0,28,28,05
Oklahoma,U.S. House,Robert Murphy,IND,550004,0,0,16,16,05
Oklahoma,President,Barack Obama,DEM,550005,0,0,243,243,
Oklahoma,President,Mitt Romney,REP,550005,0,0,642,642,
Oklahoma,U.S. House,Tom Guild,DEM,550005,0,0,227,227,05
Oklahoma,U.S. House,James Lankford,REP,550005,0,0,625,625,05
Oklahoma,U.S. House,Pat Martin,IND,550005,0,0,18,18,05
Oklahoma,U.S. House,Robert Murphy,IND,550005,0,0,12,12,05
Oklahoma,President,Barack Obama,DEM,550006,0,0,249,249,
Oklahoma,President,Mitt Romney,REP,550006,0,0,452,452,
Oklahoma,U.S. House,Tom Guild,DEM,550006,0,0,223,223,05
Oklahoma,U.S. House,James Lankford,REP,550006,0,0,448,448,05
Oklahoma,U.S. House,Pat Martin,IND,550006,0,0,11,11,05
Oklahoma,U.S. House,Robert Murphy,IND,550006,0,0,18,18,05
Oklahoma,President,Barack Obama,DEM,550007,0,0,230,230,
Oklahoma,President,Mitt Romney,REP,550007,0,0,817,817,
Oklahoma,U.S. House,Tom Guild,DEM,550007,0,0,213,213,05
Oklahoma,U.S. House,James Lankford,REP,550007,0,0,791,791,05
Oklahoma,U.S. House,Pat Martin,IND,550007,0,0,17,17,05
Oklahoma,U.S. House,Robert Murphy,IND,550007,0,0,14,14,05
Oklahoma,President,Barack Obama,DEM,550008,0,0,80,80,
Oklahoma,President,Mitt Romney,REP,550008,0,0,370,370,
Oklahoma,U.S. House,Tom Guild,DEM,550008,0,0,68,68,05
Oklahoma,U.S. House,James Lankford,REP,550008,0,0,354,354,05
Oklahoma,U.S. House,Pat Martin,IND,550008,0,0,12,12,05
Oklahoma,U.S. House,Robert Murphy,IND,550008,0,0,9,9,05
Oklahoma,President,Barack Obama,DEM,550009,0,0,147,147,
Oklahoma,President,Mitt Romney,REP,550009,0,0,508,508,
Oklahoma,U.S. House,Tom Guild,DEM,550009,0,0,130,130,05
Oklahoma,U.S. House,James Lankford,REP,550009,0,0,493,493,05
Oklahoma,U.S. House,Pat Martin,IND,550009,0,0,17,17,05
Oklahoma,U.S. House,Robert Murphy,IND,550009,0,0,13,13,05
Oklahoma,President,Barack Obama,DEM,550010,0,0,132,132,
Oklahoma,President,Mitt Romney,REP,550010,0,0,355,355,
Oklahoma,U.S. House,Tom Guild,DEM,550010,0,0,99,99,05
Oklahoma,U.S. House,James Lankford,REP,550010,0,0,370,370,05
Oklahoma,U.S. House,Pat Martin,IND,550010,0,0,9,9,05
Oklahoma,U.S. House,Robert Murphy,IND,550010,0,0,10,10,05
Oklahoma,President,Barack Obama,DEM,550011,0,0,298,298,
Oklahoma,President,Mitt Romney,REP,550011,0,0,479,479,
Oklahoma,U.S. House,Tom Guild,DEM,550011,0,0,248,248,05
Oklahoma,U.S. House,James Lankford,REP,550011,0,0,489,489,05
Oklahoma,U.S. House,Pat Martin,IND,550011,0,0,17,17,05
Oklahoma,U.S. House,Robert Murphy,IND,550011,0,0,21,21,05
Oklahoma,President,Barack Obama,DEM,550012,0,0,525,525,
Oklahoma,President,Mitt Romney,REP,550012,0,0,817,817,
Oklahoma,U.S. House,Tom Guild,DEM,550012,0,0,454,454,05
Oklahoma,U.S. House,James Lankford,REP,550012,0,0,821,821,05
Oklahoma,U.S. House,Pat Martin,IND,550012,0,0,24,24,05
Oklahoma,U.S. House,Robert Murphy,IND,550012,0,0,35,35,05
Oklahoma,State House,Nick Singer,DEM,550012,0,0,512,512,87
Oklahoma,State House,Jason Nelson,REP,550012,0,0,786,786,87
Oklahoma,President,Barack Obama,DEM,550013,0,0,303,303,
Oklahoma,President,Mitt Romney,REP,550013,0,0,587,587,
Oklahoma,U.S. House,Tom Guild,DEM,550013,0,0,267,267,05
Oklahoma,U.S. House,James Lankford,REP,550013,0,0,568,568,05
Oklahoma,U.S. House,Pat Martin,IND,550013,0,0,24,24,05
Oklahoma,U.S. House,Robert Murphy,IND,550013,0,0,28,28,05
Oklahoma,President,Barack Obama,DEM,550014,0,0,292,292,
Oklahoma,President,Mitt Romney,REP,550014,0,0,546,546,
Oklahoma,U.S. House,Tom Guild,DEM,550014,0,0,268,268,05
Oklahoma,U.S. House,James Lankford,REP,550014,0,0,520,520,05
Oklahoma,U.S. House,Pat Martin,IND,550014,0,0,18,18,05
Oklahoma,U.S. House,Robert Murphy,IND,550014,0,0,16,16,05
Oklahoma,State House,Nick Singer,DEM,550014,0,0,301,301,87
Oklahoma,State House,Jason Nelson,REP,550014,0,0,507,507,87
Oklahoma,President,Barack Obama,DEM,550015,0,0,315,315,
Oklahoma,President,Mitt Romney,REP,550015,0,0,554,554,
Oklahoma,U.S. House,Tom Guild,DEM,550015,0,0,290,290,05
Oklahoma,U.S. House,James Lankford,REP,550015,0,0,538,538,05
Oklahoma,U.S. House,Pat Martin,IND,550015,0,0,16,16,05
Oklahoma,U.S. House,Robert Murphy,IND,550015,0,0,19,19,05
Oklahoma,State House,Nick Singer,DEM,550015,0,0,323,323,87
Oklahoma,State House,Jason Nelson,REP,550015,0,0,525,525,87
Oklahoma,President,Barack Obama,DEM,550016,0,0,59,59,
Oklahoma,President,Mitt Romney,REP,550016,0,0,158,158,
Oklahoma,U.S. House,Tom Guild,DEM,550016,0,0,45,45,05
Oklahoma,U.S. House,James Lankford,REP,550016,0,0,160,160,05
Oklahoma,U.S. House,Pat Martin,IND,550016,0,0,3,3,05
Oklahoma,U.S. House,Robert Murphy,IND,550016,0,0,7,7,05
Oklahoma,President,Barack Obama,DEM,550017,0,0,0,0,
Oklahoma,President,Mitt Romney,REP,550017,0,0,0,0,
Oklahoma,U.S. House,Tom Guild,DEM,550017,0,0,0,0,05
Oklahoma,U.S. House,James Lankford,REP,550017,0,0,0,0,05
Oklahoma,U.S. House,Pat Martin,IND,550017,0,0,0,0,05
Oklahoma,U.S. House,Robert Murphy,IND,550017,0,0,0,0,05
Oklahoma,President,Barack Obama,DEM,550018,0,0,81,81,
Oklahoma,President,Mitt Romney,REP,550018,0,0,228,228,
Oklahoma,U.S. House,Tom Guild,DEM,550018,0,0,71,71,05
Oklahoma,U.S. House,James Lankford,REP,550018,0,0,229,229,05
Oklahoma,U.S. House,Pat Martin,IND,550018,0,0,4,4,05
Oklahoma,U.S. House,Robert Murphy,IND,550018,0,0,4,4,05
Oklahoma,President,Barack Obama,DEM,550019,0,0,243,243,
Oklahoma,President,Mitt Romney,REP,550019,0,0,778,778,
Oklahoma,U.S. House,Tom Guild,DEM,550019,0,0,216,216,05
Oklahoma,U.S. House,James Lankford,REP,550019,0,0,739,739,05
Oklahoma,U.S. House,Pat Martin,IND,550019,0,0,34,34,05
Oklahoma,U.S. House,Robert Murphy,IND,550019,0,0,20,20,05
Oklahoma,President,Barack Obama,DEM,550020,0,0,264,264,
Oklahoma,President,Mitt Romney,REP,550020,0,0,1043,1043,
Oklahoma,U.S. House,Tom Guild,DEM,550020,0,0,228,228,05
Oklahoma,U.S. House,James Lankford,REP,550020,0,0,1013,1013,05
Oklahoma,U.S. House,Pat Martin,IND,550020,0,0,31,31,05
Oklahoma,U.S. House,Robert Murphy,IND,550020,0,0,24,24,05
Oklahoma,President,Barack Obama,DEM,550021,0,0,351,351,
Oklahoma,President,Mitt Romney,REP,550021,0,0,1037,1037,
Oklahoma,U.S. House,Tom Guild,DEM,550021,0,0,310,310,05
Oklahoma,U.S. House,James Lankford,REP,550021,0,0,1003,1003,05
Oklahoma,U.S. House,Pat Martin,IND,550021,0,0,31,31,05
Oklahoma,U.S. House,Robert Murphy,IND,550021,0,0,30,30,05
Oklahoma,State House,Stephen Covert,DEM,550021,0,0,342,342,10
Oklahoma,State House,Gary Banz,REP,550021,0,0,1004,1004,10
Oklahoma,President,Barack Obama,DEM,550022,0,0,187,187,
Oklahoma,President,Mitt Romney,REP,550022,0,0,593,593,
Oklahoma,U.S. House,Donna Marie Bebo,DEM,550022,0,0,138,138,04
Oklahoma,U.S. House,Tom Cole,REP,550022,0,0,593,593,04
Oklahoma,U.S. House,Rj Harris,IND,550022,0,0,40,40,04
Oklahoma,State House,Stephen Covert,DEM,550022,0,0,201,201,10
Oklahoma,State House,Gary Banz,REP,550022,0,0,554,554,10
Oklahoma,President,Barack Obama,DEM,550023,0,0,266,266,
Oklahoma,President,Mitt Romney,REP,550023,0,0,809,809,
Oklahoma,U.S. House,Donna Marie Bebo,DEM,550023,0,0,202,202,04
Oklahoma,U.S. House,Tom Cole,REP,550023,0,0,803,803,04
Oklahoma,U.S. House,Rj Harris,IND,550023,0,0,53,53,04
Oklahoma,State House,Stephen Covert,DEM,550023,0,0,246,246,10
Oklahoma,State House,Gary Banz,REP,550023,0,0,812,812,10
Oklahoma,President,Barack Obama,DEM,550024,0,0,19,19,
Oklahoma,President,Mitt Romney,REP,550024,0,0,64,64,
Oklahoma,U.S. House,Tom Guild,DEM,550024,0,0,11,11,05
Oklahoma,U.S. House,James Lankford,REP,550024,0,0,65,65,05
Oklahoma,U.S. House,Pat Martin,IND,550024,0,0,4,4,05
Oklahoma,U.S. House,Robert Murphy,IND,550024,0,0,0,0,05
Oklahoma,President,Barack Obama,DEM,550025,0,0,157,157,
Oklahoma,President,Mitt Romney,REP,550025,0,0,212,212,
Oklahoma,U.S. House,Tom Guild,DEM,550025,0,0,152,152,05
Oklahoma,U.S. House,James Lankford,REP,550025,0,0,197,197,05
Oklahoma,U.S. House,Pat Martin,IND,550025,0,0,9,9,05
Oklahoma,U.S. House,Robert Murphy,IND,550025,0,0,6,6,05
Oklahoma,President,Barack Obama,DEM,550026,0,0,158,158,
Oklahoma,President,Mitt Romney,REP,550026,0,0,554,554,
Oklahoma,U.S. House,Donna Marie Bebo,DEM,550026,0,0,136,136,04
Oklahoma,U.S. House,Tom Cole,REP,550026,0,0,528,528,04
Oklahoma,U.S. House,Rj Harris,IND,550026,0,0,39,39,04
Oklahoma,State House,Stephen Covert,DEM,550026,0,0,179,179,10
Oklahoma,State House,Gary Banz,REP,550026,0,0,519,519,10
Oklahoma,President,Barack Obama,DEM,550027,0,0,56,56,
Oklahoma,President,Mitt Romney,REP,550027,0,0,107,107,
Oklahoma,U.S. House,Donna Marie Bebo,DEM,550027,0,0,46,46,04
Oklahoma,U.S. House,Tom Cole,REP,550027,0,0,109,109,04
Oklahoma,U.S. House,Rj Harris,IND,550027,0,0,7,7,04
Oklahoma,State House,Stephen Covert,DEM,550027,0,0,60,60,10
Oklahoma,State House,Gary Banz,REP,550027,0,0,101,101,10
Oklahoma,President,Barack Obama,DEM,550028,0,0,560,560,
Oklahoma,President,Mitt Romney,REP,550028,0,0,424,424,
Oklahoma,U.S. House,Tom Guild,DEM,550028,0,0,544,544,05
Oklahoma,U.S. House,James Lankford,REP,550028,0,0,400,400,05
Oklahoma,U.S. House,Pat Martin,IND,550028,0,0,14,14,05
Oklahoma,U.S. House,Robert Murphy,IND,550028,0,0,17,17,05
Oklahoma,President,Barack Obama,DEM,550029,0,0,492,492,
Oklahoma,President,Mitt Romney,REP,550029,0,0,735,735,
Oklahoma,U.S. House,Tom Guild,DEM,550029,0,0,468,468,05
Oklahoma,U.S. House,James Lankford,REP,550029,0,0,669,669,05
Oklahoma,U.S. House,Pat Martin,IND,550029,0,0,43,43,05
Oklahoma,U.S. House,Robert Murphy,IND,550029,0,0,38,38,05
Oklahoma,President,Barack Obama,DEM,550030,0,0,481,481,
Oklahoma,President,Mitt Romney,REP,550030,0,0,509,509,
Oklahoma,U.S. House,Tom Guild,DEM,550030,0,0,442,442,05
Oklahoma,U.S. House,James Lankford,REP,550030,0,0,493,493,05
Oklahoma,U.S. House,Pat Martin,IND,550030,0,0,21,21,05
Oklahoma,U.S. House,Robert Murphy,IND,550030,0,0,27,27,05
Oklahoma,President,Barack Obama,DEM,550031,0,0,481,481,
Oklahoma,President,Mitt Romney,REP,550031,0,0,689,689,
Oklahoma,U.S. House,Tom Guild,DEM,550031,0,0,448,448,05
Oklahoma,U.S. House,James Lankford,REP,550031,0,0,663,663,05
Oklahoma,U.S. House,Pat Martin,IND,550031,0,0,31,31,05
Oklahoma,U.S. House,Robert Murphy,IND,550031,0,0,20,20,05
Oklahoma,President,Barack Obama,DEM,550032,0,0,231,231,
Oklahoma,President,Mitt Romney,REP,550032,0,0,559,559,
Oklahoma,U.S. House,Tom Guild,DEM,550032,0,0,231,231,05
Oklahoma,U.S. House,James Lankford,REP,550032,0,0,510,510,05
Oklahoma,U.S. House,Pat Martin,IND,550032,0,0,22,22,05
Oklahoma,U.S. House,Robert Murphy,IND,550032,0,0,21,21,05
Oklahoma,President,Barack Obama,DEM,550033,0,0,601,601,
Oklahoma,President,Mitt Romney,REP,550033,0,0,1063,1063,
Oklahoma,U.S. House,Tom Guild,DEM,550033,0,0,551,551,05
Oklahoma,U.S. House,James Lankford,REP,550033,0,0,1023,1023,05
Oklahoma,U.S. House,Pat Martin,IND,550033,0,0,33,33,05
Oklahoma,U.S. House,Robert Murphy,IND,550033,0,0,44,44,05
Oklahoma,President,Barack Obama,DEM,550034,0,0,146,146,
Oklahoma,President,Mitt Romney,REP,550034,0,0,698,698,
Oklahoma,U.S. House,Tom Guild,DEM,550034,0,0,100,100,05
Oklahoma,U.S. House,James Lankford,REP,550034,0,0,714,714,05
Oklahoma,U.S. House,Pat Martin,IND,550034,0,0,8,8,05
Oklahoma,U.S. House,Robert Murphy,IND,550034,0,0,17,17,05
Oklahoma,President,Barack Obama,DEM,550035,0,0,402,402,
Oklahoma,President,Mitt Romney,REP,550035,0,0,1184,1184,
Oklahoma,U.S. House,Tom Guild,DEM,550035,0,0,336,336,05
Oklahoma,U.S. House,James Lankford,REP,550035,0,0,1186,1186,05
Oklahoma,U.S. House,Pat Martin,IND,550035,0,0,32,32,05
Oklahoma,U.S. House,Robert Murphy,IND,550035,0,0,22,22,05
Oklahoma,President,Barack Obama,DEM,550036,0,0,201,201,
Oklahoma,President,Mitt Romney,REP,550036,0,0,756,756,
Oklahoma,U.S. House,Tom Guild,DEM,550036,0,0,177,177,05
Oklahoma,U.S. House,James Lankford,REP,550036,0,0,732,732,05
Oklahoma,U.S. House,Pat Martin,IND,550036,0,0,22,22,05
Oklahoma,U.S. House,Robert Murphy,IND,550036,0,0,17,17,05
Oklahoma,President,Barack Obama,DEM,550037,0,0,266,266,
Oklahoma,President,Mitt Romney,REP,550037,0,0,831,831,
Oklahoma,U.S. House,Tom Guild,DEM,550037,0,0,228,228,05
Oklahoma,U.S. House,James Lankford,REP,550037,0,0,827,827,05
Oklahoma,U.S. House,Pat Martin,IND,550037,0,0,20,20,05
Oklahoma,U.S. House,Robert Murphy,IND,550037,0,0,14,14,05
Oklahoma,President,Barack Obama,DEM,550038,0,0,356,356,
Oklahoma,President,Mitt Romney,REP,550038,0,0,728,728,
Oklahoma,U.S. House,Tom Guild,DEM,550038,0,0,295,295,05
Oklahoma,U.S. House,James Lankford,REP,550038,0,0,740,740,05
Oklahoma,U.S. House,Pat Martin,IND,550038,0,0,20,20,05
Oklahoma,U.S. House,Robert Murphy,IND,550038,0,0,22,22,05
Oklahoma,President,Barack Obama,DEM,550039,0,0,316,316,
Oklahoma,President,Mitt Romney,REP,550039,0,0,824,824,
Oklahoma,U.S. House,Tom Guild,DEM,550039,0,0,282,282,05
Oklahoma,U.S. House,James Lankford,REP,550039,0,0,812,812,05
Oklahoma,U.S. House,Pat Martin,IND,550039,0,0,21,21,05
Oklahoma,U.S. House,Robert Murphy,IND,550039,0,0,16,16,05
Oklahoma,State House,Ed Holzberger,DEM,550039,0,0,284,284,83
Oklahoma,State House,Randy Mcdaniel,REP,550039,0,0,819,819,83
Oklahoma,President,Barack Obama,DEM,550040,0,0,533,533,
Oklahoma,President,Mitt Romney,REP,550040,0,0,1197,1197,
Oklahoma,U.S. House,Tom Guild,DEM,550040,0,0,455,455,05
Oklahoma,U.S. House,James Lankford,REP,550040,0,0,1203,1203,05
Oklahoma,U.S. House,Pat Martin,IND,550040,0,0,34,34,05
Oklahoma,U.S. House,Robert Murphy,IND,550040,0,0,25,25,05
Oklahoma,President,Barack Obama,DEM,550041,0,0,399,399,
Oklahoma,President,Mitt Romney,REP,550041,0,0,830,830,
Oklahoma,U.S. House,Tom Guild,DEM,550041,0,0,345,345,05
Oklahoma,U.S. House,James Lankford,REP,550041,0,0,830,830,05
Oklahoma,U.S. House,Pat Martin,IND,550041,0,0,19,19,05
Oklahoma,U.S. House,Robert Murphy,IND,550041,0,0,21,21,05
Oklahoma,President,Barack Obama,DEM,550042,0,0,366,366,
Oklahoma,President,Mitt Romney,REP,550042,0,0,1103,1103,
Oklahoma,U.S. House,Tom Guild,DEM,550042,0,0,313,313,05
Oklahoma,U.S. House,James Lankford,REP,550042,0,0,1087,1087,05
Oklahoma,U.S. House,Pat Martin,IND,550042,0,0,34,34,05
Oklahoma,U.S. House,Robert Murphy,IND,550042,0,0,27,27,05
Oklahoma,State Senate,Clark Jolley,REP,550042,0,0,1123,1123,41
Oklahoma,State Senate,Richard Prawdzienski,IND,550042,0,0,261,261,41
Oklahoma,President,Barack Obama,DEM,550043,0,0,265,265,
Oklahoma,President,Mitt Romney,REP,550043,0,0,1642,1642,
Oklahoma,U.S. House,Tom Guild,DEM,550043,0,0,236,236,05
Oklahoma,U.S. House,James Lankford,REP,550043,0,0,1598,1598,05
Oklahoma,U.S. House,Pat Martin,IND,550043,0,0,27,27,05
Oklahoma,U.S. House,Robert Murphy,IND,550043,0,0,26,26,05
Oklahoma,State Senate,Clark Jolley,REP,550043,0,0,1605,1605,41
Oklahoma,State Senate,Richard Prawdzienski,IND,550043,0,0,214,214,41
Oklahoma,President,Barack Obama,DEM,550044,0,0,486,486,
Oklahoma,President,Mitt Romney,REP,550044,0,0,1347,1347,
Oklahoma,U.S. House,Tom Guild,DEM,550044,0,0,431,431,05
Oklahoma,U.S. House,James Lankford,REP,550044,0,0,1326,1326,05
Oklahoma,U.S. House,Pat Martin,IND,550044,0,0,23,23,05
Oklahoma,U.S. House,Robert Murphy,IND,550044,0,0,39,39,05
Oklahoma,State Senate,Clark Jolley,REP,550044,0,0,1361,1361,41
Oklahoma,State Senate,Richard Prawdzienski,IND,550044,0,0,347,347,41
Oklahoma,President,Barack Obama,DEM,550045,0,0,385,385,
Oklahoma,President,Mitt Romney,REP,550045,0,0,1437,1437,
Oklahoma,U.S. House,Tom Guild,DEM,550045,0,0,340,340,05
Oklahoma,U.S. House,James Lankford,REP,550045,0,0,1401,1401,05
Oklahoma,U.S. House,Pat Martin,IND,550045,0,0,36,36,05
Oklahoma,U.S. House,Robert Murphy,IND,550045,0,0,25,25,05
Oklahoma,State Senate,Clark Jolley,REP,550045,0,0,1441,1441,41
Oklahoma,State Senate,Richard Prawdzienski,IND,550045,0,0,283,283,41
Oklahoma,President,Barack Obama,DEM,550046,0,0,373,373,
Oklahoma,President,Mitt Romney,REP,550046,0,0,469,469,
Oklahoma,U.S. House,Tom Guild,DEM,550046,0,0,301,301,05
Oklahoma,U.S. House,James Lankford,REP,550046,0,0,479,479,05
Oklahoma,U.S. House,Pat Martin,IND,550046,0,0,22,22,05
Oklahoma,U.S. House,Robert Murphy,IND,550046,0,0,31,31,05
Oklahoma,State Senate,Clark Jolley,REP,550046,0,0,507,507,41
Oklahoma,State Senate,Richard Prawdzienski,IND,550046,0,0,278,278,41
Oklahoma,President,Barack Obama,DEM,550047,0,0,306,306,
Oklahoma,President,Mitt Romney,REP,550047,0,0,345,345,
Oklahoma,U.S. House,Tom Guild,DEM,550047,0,0,278,278,05
Oklahoma,U.S. House,James Lankford,REP,550047,0,0,339,339,05
Oklahoma,U.S. House,Pat Martin,IND,550047,0,0,14,14,05
Oklahoma,U.S. House,Robert Murphy,IND,550047,0,0,18,18,05
Oklahoma,State Senate,Clark Jolley,REP,550047,0,0,362,362,41
Oklahoma,State Senate,Richard Prawdzienski,IND,550047,0,0,219,219,41
Oklahoma,President,Barack Obama,DEM,550048,0,0,344,344,
Oklahoma,President,Mitt Romney,REP,550048,0,0,648,648,
Oklahoma,U.S. House,Tom Guild,DEM,550048,0,0,291,291,05
Oklahoma,U.S. House,James Lankford,REP,550048,0,0,642,642,05
Oklahoma,U.S. House,Pat Martin,IND,550048,0,0,28,28,05
Oklahoma,U.S. House,Robert Murphy,IND,550048,0,0,27,27,05
Oklahoma,State Senate,Clark Jolley,REP,550048,0,0,656,656,41
Oklahoma,State Senate,Richard Prawdzienski,IND,550048,0,0,262,262,41
Oklahoma,President,Barack Obama,DEM,550049,0,0,308,308,
Oklahoma,President,Mitt Romney,REP,550049,0,0,436,436,
Oklahoma,U.S. House,Tom Guild,DEM,550049,0,0,274,274,05
Oklahoma,U.S. House,James Lankford,REP,550049,0,0,428,428,05
Oklahoma,U.S. House,Pat Martin,IND,550049,0,0,19,19,05
Oklahoma,U.S. House,Robert Murphy,IND,550049,0,0,22,22,05
Oklahoma,State Senate,Clark Jolley,REP,550049,0,0,442,442,41
Oklahoma,State Senate,Richard Prawdzienski,IND,550049,0,0,235,235,41
Oklahoma,President,Barack Obama,DEM,550050,0,0,23,23,
Oklahoma,President,Mitt Romney,REP,550050,0,0,31,31,
Oklahoma,U.S. House,Tom Guild,DEM,550050,0,0,22,22,05
Oklahoma,U.S. House,James Lankford,REP,550050,0,0,31,31,05
Oklahoma,U.S. House,Pat Martin,IND,550050,0,0,0,0,05
Oklahoma,U.S. House,Robert Murphy,IND,550050,0,0,0,0,05
Oklahoma,State Senate,Clark Jolley,REP,550050,0,0,30,30,41
Oklahoma,State Senate,Richard Prawdzienski,IND,550050,0,0,15,15,41
Oklahoma,State House,Ed Holzberger,DEM,550050,0,0,23,23,83
Oklahoma,State House,Randy Mcdaniel,REP,550050,0,0,28,28,83
Oklahoma,President,Barack Obama,DEM,550051,0,0,368,368,
Oklahoma,President,Mitt Romney,REP,550051,0,0,602,602,
Oklahoma,U.S. House,Tom Guild,DEM,550051,0,0,325,325,05
Oklahoma,U.S. House,James Lankford,REP,550051,0,0,587,587,05
Oklahoma,U.S. House,Pat Martin,IND,550051,0,0,22,22,05
Oklahoma,U.S. House,Robert Murphy,IND,550051,0,0,24,24,05
Oklahoma,State Senate,Clark Jolley,REP,550051,0,0,620,620,41
Oklahoma,State Senate,Richard Prawdzienski,IND,550051,0,0,281,281,41
Oklahoma,President,Barack Obama,DEM,550052,0,0,278,278,
Oklahoma,President,Mitt Romney,REP,550052,0,0,929,929,
Oklahoma,U.S. House,Tom Guild,DEM,550052,0,0,227,227,05
Oklahoma,U.S. House,James Lankford,REP,550052,0,0,938,938,05
Oklahoma,U.S. House,Pat Martin,IND,550052,0,0,19,19,05
Oklahoma,U.S. House,Robert Murphy,IND,550052,0,0,13,13,05
Oklahoma,State Senate,Clark Jolley,REP,550052,0,0,942,942,41
Oklahoma,State Senate,Richard Prawdzienski,IND,550052,0,0,200,200,41
Oklahoma,President,Barack Obama,DEM,550053,0,0,387,387,
Oklahoma,President,Mitt Romney,REP,550053,0,0,843,843,
Oklahoma,U.S. House,Tom Guild,DEM,550053,0,0,324,324,05
Oklahoma,U.S. House,James Lankford,REP,550053,0,0,826,826,05
Oklahoma,U.S. House,Pat Martin,IND,550053,0,0,39,39,05
Oklahoma,U.S. House,Robert Murphy,IND,550053,0,0,35,35,05
Oklahoma,State Senate,Clark Jolley,REP,550053,0,0,863,863,41
Oklahoma,State Senate,Richard Prawdzienski,IND,550053,0,0,289,289,41
Oklahoma,President,Barack Obama,DEM,550054,0,0,313,313,
Oklahoma,President,Mitt Romney,REP,550054,0,0,898,898,
Oklahoma,U.S. House,Tom Guild,DEM,550054,0,0,268,268,05
Oklahoma,U.S. House,James Lankford,REP,550054,0,0,885,885,05
Oklahoma,U.S. House,Pat Martin,IND,550054,0,0,18,18,05
Oklahoma,U.S. House,Robert Murphy,IND,550054,0,0,34,34,05
Oklahoma,State Senate,Clark Jolley,REP,550054,0,0,877,877,41
Oklahoma,State Senate,Richard Prawdzienski,IND,550054,0,0,254,254,41
Oklahoma,President,Barack Obama,DEM,550055,0,0,363,363,
Oklahoma,President,Mitt Romney,REP,550055,0,0,775,775,
Oklahoma,U.S. House,Tom Guild,DEM,550055,0,0,316,316,05
Oklahoma,U.S. House,James Lankford,REP,550055,0,0,766,766,05
Oklahoma,U.S. House,Pat Martin,IND,550055,0,0,25,25,05
Oklahoma,U.S. House,Robert Murphy,IND,550055,0,0,23,23,05
Oklahoma,State Senate,Clark Jolley,REP,550055,0,0,788,788,41
Oklahoma,State Senate,Richard Prawdzienski,IND,550055,0,0,266,266,41
Oklahoma,President,Barack Obama,DEM,550056,0,0,343,343,
Oklahoma,President,Mitt Romney,REP,550056,0,0,795,795,
Oklahoma,U.S. House,Tom Guild,DEM,550056,0,0,291,291,05
Oklahoma,U.S. House,James Lankford,REP,550056,0,0,797,797,05
Oklahoma,U.S. House,Pat Martin,IND,550056,0,0,27,27,05
Oklahoma,U.S. House,Robert Murphy,IND,550056,0,0,23,23,05
Oklahoma,State Senate,Clark Jolley,REP,550056,0,0,831,831,41
Oklahoma,State Senate,Richard Prawdzienski,IND,550056,0,0,237,237,41
Oklahoma,President,Barack Obama,DEM,550057,0,0,325,325,
Oklahoma,President,Mitt Romney,REP,550057,0,0,650,650,
Oklahoma,U.S. House,Tom Guild,DEM,550057,0,0,274,274,05
Oklahoma,U.S. House,James Lankford,REP,550057,0,0,653,653,05
Oklahoma,U.S. House,Pat Martin,IND,550057,0,0,20,20,05
Oklahoma,U.S. House,Robert Murphy,IND,550057,0,0,21,21,05
Oklahoma,State Senate,Clark Jolley,REP,550057,0,0,667,667,41
Oklahoma,State Senate,Richard Prawdzienski,IND,550057,0,0,238,238,41
Oklahoma,President,Barack Obama,DEM,550058,0,0,405,405,
Oklahoma,President,Mitt Romney,REP,550058,0,0,1567,1567,
Oklahoma,U.S. House,Tom Guild,DEM,550058,0,0,338,338,05
Oklahoma,U.S. House,James Lankford,REP,550058,0,0,1564,1564,05
Oklahoma,U.S. House,Pat Martin,IND,550058,0,0,37,37,05
Oklahoma,U.S. House,Robert Murphy,IND,550058,0,0,16,16,05
Oklahoma,State Senate,Clark Jolley,REP,550058,0,0,1613,1613,41
Oklahoma,State Senate,Richard Prawdzienski,IND,550058,0,0,265,265,41
Oklahoma,President,Barack Obama,DEM,550059,0,0,224,224,
Oklahoma,President,Mitt Romney,REP,550059,0,0,1148,1148,
Oklahoma,U.S. House,Tom Guild,DEM,550059,0,0,203,203,05
Oklahoma,U.S. House,James Lankford,REP,550059,0,0,1127,1127,05
Oklahoma,U.S. House,Pat Martin,IND,550059,0,0,15,15,05
Oklahoma,U.S. House,Robert Murphy,IND,550059,0,0,14,14,05
Oklahoma,State Senate,Clark Jolley,REP,550059,0,0,1140,1140,41
Oklahoma,State Senate,Richard Prawdzienski,IND,550059,0,0,167,167,41
Oklahoma,President,Barack Obama,DEM,550060,0,0,395,395,
Oklahoma,President,Mitt Romney,REP,550060,0,0,1380,1380,
Oklahoma,U.S. House,Tom Guild,DEM,550060,0,0,350,350,05
Oklahoma,U.S. House,James Lankford,REP,550060,0,0,1352,1352,05
Oklahoma,U.S. House,Pat Martin,IND,550060,0,0,36,36,05
Oklahoma,U.S. House,Robert Murphy,IND,550060,0,0,27,27,05
Oklahoma,State Senate,Clark Jolley,REP,550060,0,0,1374,1374,41
Oklahoma,State Senate,Richard Prawdzienski,IND,550060,0,0,314,314,41
Oklahoma,President,Barack Obama,DEM,550061,0,0,371,371,
Oklahoma,President,Mitt Romney,REP,550061,0,0,1306,1306,
Oklahoma,U.S. House,Tom Guild,DEM,550061,0,0,317,317,05
Oklahoma,U.S. House,James Lankford,REP,550061,0,0,1293,1293,05
Oklahoma,U.S. House,Pat Martin,IND,550061,0,0,25,25,05
Oklahoma,U.S. House,Robert Murphy,IND,550061,0,0,29,29,05
Oklahoma,State Senate,Clark Jolley,REP,550061,0,0,1312,1312,41
Oklahoma,State Senate,Richard Prawdzienski,IND,550061,0,0,273,273,41
Oklahoma,President,Barack Obama,DEM,550062,0,0,450,450,
Oklahoma,President,Mitt Romney,REP,550062,0,0,1417,1417,
Oklahoma,U.S. House,Tom Guild,DEM,550062,0,0,363,363,05
Oklahoma,U.S. House,James Lankford,REP,550062,0,0,1408,1408,05
Oklahoma,U.S. House,Pat Martin,IND,550062,0,0,38,38,05
Oklahoma,U.S. House,Robert Murphy,IND,550062,0,0,40,40,05
Oklahoma,State Senate,Clark Jolley,REP,550062,0,0,1430,1430,41
Oklahoma,State Senate,Richard Prawdzienski,IND,550062,0,0,324,324,41
Oklahoma,President,Barack Obama,DEM,550063,0,0,147,147,
Oklahoma,President,Mitt Romney,REP,550063,0,0,584,584,
Oklahoma,U.S. House,Tom Guild,DEM,550063,0,0,124,124,05
Oklahoma,U.S. House,James Lankford,REP,550063,0,0,596,596,05
Oklahoma,U.S. House,Pat Martin,IND,550063,0,0,5,5,05
Oklahoma,U.S. House,Robert Murphy,IND,550063,0,0,8,8,05
Oklahoma,State Senate,Clark Jolley,REP,550063,0,0,593,593,41
Oklahoma,State Senate,Richard Prawdzienski,IND,550063,0,0,111,111,41
Oklahoma,President,Barack Obama,DEM,550064,0,0,268,268,
Oklahoma,President,Mitt Romney,REP,550064,0,0,1131,1131,
Oklahoma,U.S. House,Tom Guild,DEM,550064,0,0,239,239,05
Oklahoma,U.S. House,James Lankford,REP,550064,0,0,1118,1118,05
Oklahoma,U.S. House,Pat Martin,IND,550064,0,0,12,12,05
Oklahoma,U.S. House,Robert Murphy,IND,550064,0,0,18,18,05
Oklahoma,State Senate,Clark Jolley,REP,550064,0,0,1135,1135,41
Oklahoma,State Senate,Richard Prawdzienski,IND,550064,0,0,201,201,41
Oklahoma,President,Barack Obama,DEM,550065,0,0,270,270,
Oklahoma,President,Mitt Romney,REP,550065,0,0,548,548,
Oklahoma,U.S. House,Tom Guild,DEM,550065,0,0,234,234,05
Oklahoma,U.S. House,James Lankford,REP,550065,0,0,549,549,05
Oklahoma,U.S. House,Pat Martin,IND,550065,0,0,12,12,05
Oklahoma,U.S. House,Robert Murphy,IND,550065,0,0,15,15,05
Oklahoma,State Senate,Clark Jolley,REP,550065,0,0,551,551,41
Oklahoma,State Senate,Richard Prawdzienski,IND,550065,0,0,202,202,41
Oklahoma,President,Barack Obama,DEM,550066,0,0,758,758,
Oklahoma,President,Mitt Romney,REP,550066,0,0,206,206,
Oklahoma,U.S. House,Tom Guild,DEM,550066,0,0,723,723,05
Oklahoma,U.S. House,James Lankford,REP,550066,0,0,209,209,05
Oklahoma,U.S. House,Pat Martin,IND,550066,0,0,9,9,05
Oklahoma,U.S. House,Robert Murphy,IND,550066,0,0,13,13,05
Oklahoma,President,Barack Obama,DEM,550067,0,0,240,240,
Oklahoma,President,Mitt Romney,REP,550067,0,0,868,868,
Oklahoma,U.S. House,Tom Guild,DEM,550067,0,0,246,246,05
Oklahoma,U.S. House,James Lankford,REP,550067,0,0,822,822,05
Oklahoma,U.S. House,Pat Martin,IND,550067,0,0,20,20,05
Oklahoma,U.S. House,Robert Murphy,IND,550067,0,0,18,18,05
Oklahoma,State House,Stephen Covert,DEM,550067,0,0,308,308,10
Oklahoma,State House,Gary Banz,REP,550067,0,0,778,778,10
Oklahoma,President,Barack Obama,DEM,550068,0,0,134,134,
Oklahoma,President,Mitt Romney,REP,550068,0,0,534,534,
Oklahoma,U.S. House,Tom Guild,DEM,550068,0,0,119,119,05
Oklahoma,U.S. House,James Lankford,REP,550068,0,0,534,534,05
Oklahoma,U.S. House,Pat Martin,IND,550068,0,0,8,8,05
Oklahoma,U.S. House,Robert Murphy,IND,550068,0,0,7,7,05
Oklahoma,President,Barack Obama,DEM,550069,0,0,229,229,
Oklahoma,President,Mitt Romney,REP,550069,0,0,738,738,
Oklahoma,U.S. House,Tom Guild,DEM,550069,0,0,199,199,05
Oklahoma,U.S. House,James Lankford,REP,550069,0,0,724,724,05
Oklahoma,U.S. House,Pat Martin,IND,550069,0,0,24,24,05
Oklahoma,U.S. House,Robert Murphy,IND,550069,0,0,18,18,05
Oklahoma,President,Barack Obama,DEM,550070,0,0,177,177,
Oklahoma,President,Mitt Romney,REP,550070,0,0,662,662,
Oklahoma,U.S. House,Tom Guild,DEM,550070,0,0,171,171,05
Oklahoma,U.S. House,James Lankford,REP,550070,0,0,626,626,05
Oklahoma,U.S. House,Pat Martin,IND,550070,0,0,15,15,05
Oklahoma,U.S. House,Robert Murphy,IND,550070,0,0,17,17,05
Oklahoma,President,Barack Obama,DEM,550071,0,0,254,254,
Oklahoma,President,Mitt Romney,REP,550071,0,0,878,878,
Oklahoma,U.S. House,Tom Guild,DEM,550071,0,0,235,235,05
Oklahoma,U.S. House,James Lankford,REP,550071,0,0,853,853,05
Oklahoma,U.S. House,Pat Martin,IND,550071,0,0,20,20,05
Oklahoma,U.S. House,Robert Murphy,IND,550071,0,0,25,25,05
Oklahoma,President,Barack Obama,DEM,550072,0,0,216,216,
Oklahoma,President,Mitt Romney,REP,550072,0,0,562,562,
Oklahoma,U.S. House,Tom Guild,DEM,550072,0,0,192,192,05
Oklahoma,U.S. House,James Lankford,REP,550072,0,0,536,536,05
Oklahoma,U.S. House,Pat Martin,IND,550072,0,0,21,21,05
Oklahoma,U.S. House,Robert Murphy,IND,550072,0,0,19,19,05
Oklahoma,President,Barack Obama,DEM,550073,0,0,72,72,
Oklahoma,President,Mitt Romney,REP,550073,0,0,177,177,
Oklahoma,U.S. House,Tom Guild,DEM,550073,0,0,63,63,05
Oklahoma,U.S. House,James Lankford,REP,550073,0,0,180,180,05
Oklahoma,U.S. House,Pat Martin,IND,550073,0,0,2,2,05
Oklahoma,U.S. House,Robert Murphy,IND,550073,0,0,4,4,05
Oklahoma,President,Barack Obama,DEM,550074,0,0,245,245,
Oklahoma,President,Mitt Romney,REP,550074,0,0,44,44,
Oklahoma,U.S. House,Tom Guild,DEM,550074,0,0,232,232,05
Oklahoma,U.S. House,James Lankford,REP,550074,0,0,42,42,05
Oklahoma,U.S. House,Pat Martin,IND,550074,0,0,10,10,05
Oklahoma,U.S. House,Robert Murphy,IND,550074,0,0,4,4,05
Oklahoma,President,Barack Obama,DEM,550075,0,0,833,833,
Oklahoma,President,Mitt Romney,REP,550075,0,0,178,178,
Oklahoma,U.S. House,Tom Guild,DEM,550075,0,0,776,776,05
Oklahoma,U.S. House,James Lankford,REP,550075,0,0,198,198,05
Oklahoma,U.S. House,Pat Martin,IND,550075,0,0,12,12,05
Oklahoma,U.S. House,Robert Murphy,IND,550075,0,0,18,18,05
Oklahoma,President,Barack Obama,DEM,550076,0,0,262,262,
Oklahoma,President,Mitt Romney,REP,550076,0,0,596,596,
Oklahoma,U.S. House,Tom Guild,DEM,550076,0,0,232,232,05
Oklahoma,U.S. House,James Lankford,REP,550076,0,0,573,573,05
Oklahoma,U.S. House,Pat Martin,IND,550076,0,0,27,27,05
Oklahoma,U.S. House,Robert Murphy,IND,550076,0,0,19,19,05
Oklahoma,President,Barack Obama,DEM,550077,0,0,709,709,
Oklahoma,President,Mitt Romney,REP,550077,0,0,260,260,
Oklahoma,U.S. House,Tom Guild,DEM,550077,0,0,667,667,05
Oklahoma,U.S. House,James Lankford,REP,550077,0,0,258,258,05
Oklahoma,U.S. House,Pat Martin,IND,550077,0,0,21,21,05
Oklahoma,U.S. House,Robert Murphy,IND,550077,0,0,15,15,05
Oklahoma,President,Barack Obama,DEM,550078,0,0,595,595,
Oklahoma,President,Mitt Romney,REP,550078,0,0,159,159,
Oklahoma,U.S. House,Tom Guild,DEM,550078,0,0,559,559,05
Oklahoma,U.S. House,James Lankford,REP,550078,0,0,154,154,05
Oklahoma,U.S. House,Pat Martin,IND,550078,0,0,15,15,05
Oklahoma,U.S. House,Robert Murphy,IND,550078,0,0,17,17,05
Oklahoma,President,Barack Obama,DEM,550079,0,0,933,933,
Oklahoma,President,Mitt Romney,REP,550079,0,0,226,226,
Oklahoma,U.S. House,Tom Guild,DEM,550079,0,0,873,873,05
Oklahoma,U.S. House,James Lankford,REP,550079,0,0,231,231,05
Oklahoma,U.S. House,Pat Martin,IND,550079,0,0,22,22,05
Oklahoma,U.S. House,Robert Murphy,IND,550079,0,0,24,24,05
Oklahoma,President,Barack Obama,DEM,550080,0,0,686,686,
Oklahoma,President,Mitt Romney,REP,550080,0,0,985,985,
Oklahoma,U.S. House,Donna Marie Bebo,DEM,550080,0,0,555,555,04
Oklahoma,U.S. House,Tom Cole,REP,550080,0,0,1031,1031,04
Oklahoma,U.S. House,Rj Harris,IND,550080,0,0,69,69,04
Oklahoma,President,Barack Obama,DEM,550081,0,0,353,353,
Oklahoma,President,Mitt Romney,REP,550081,0,0,551,551,
Oklahoma,U.S. House,Donna Marie Bebo,DEM,550081,0,0,285,285,04
Oklahoma,U.S. House,Tom Cole,REP,550081,0,0,562,562,04
Oklahoma,U.S. House,Rj Harris,IND,550081,0,0,50,50,04
Oklahoma,President,Barack Obama,DEM,550082,0,0,223,223,
Oklahoma,President,Mitt Romney,REP,550082,0,0,239,239,
Oklahoma,U.S. House,Donna Marie Bebo,DEM,550082,0,0,171,171,04
Oklahoma,U.S. House,Tom Cole,REP,550082,0,0,256,256,04
Oklahoma,U.S. House,Rj Harris,IND,550082,0,0,25,25,04
Oklahoma,President,Barack Obama,DEM,550083,0,0,448,448,
Oklahoma,President,Mitt Romney,REP,550083,0,0,653,653,
Oklahoma,U.S. House,Donna Marie Bebo,DEM,550083,0,0,370,370,04
Oklahoma,U.S. House,Tom Cole,REP,550083,0,0,634,634,04
Oklahoma,U.S. House,Rj Harris,IND,550083,0,0,95,95,04
Oklahoma,President,Barack Obama,DEM,550084,0,0,368,368,
Oklahoma,President,Mitt Romney,REP,550084,0,0,421,421,
Oklahoma,U.S. House,Donna Marie Bebo,DEM,550084,0,0,290,290,04
Oklahoma,U.S. House,Tom Cole,REP,550084,0,0,426,426,04
Oklahoma,U.S. House,Rj Harris,IND,550084,0,0,64,64,04
Oklahoma,President,Barack Obama,DEM,550085,0,0,470,470,
Oklahoma,President,Mitt Romney,REP,550085,0,0,705,705,
Oklahoma,U.S. House,Donna Marie Bebo,DEM,550085,0,0,361,361,04
Oklahoma,U.S. House,Tom Cole,REP,550085,0,0,725,725,04
Oklahoma,U.S. House,Rj Harris,IND,550085,0,0,71,71,04
Oklahoma,President,Barack Obama,DEM,550086,0,0,490,490,
Oklahoma,President,Mitt Romney,REP,550086,0,0,835,835,
Oklahoma,U.S. House,Donna Marie Bebo,DEM,550086,0,0,409,409,04
Oklahoma,U.S. House,Tom Cole,REP,550086,0,0,845,845,04
Oklahoma,U.S. House,Rj Harris,IND,550086,0,0,69,69,04
Oklahoma,President,Barack Obama,DEM,550087,0,0,369,369,
Oklahoma,President,Mitt Romney,REP,550087,0,0,249,249,
Oklahoma,U.S. House,Donna Marie Bebo,DEM,550087,0,0,317,317,04
Oklahoma,U.S. House,Tom Cole,REP,550087,0,0,257,257,04
Oklahoma,U.S. House,Rj Harris,IND,550087,0,0,40,40,04
Oklahoma,President,Barack Obama,DEM,550088,0,0,273,273,
Oklahoma,President,Mitt Romney,REP,550088,0,0,128,128,
Oklahoma,U.S. House,Donna Marie Bebo,DEM,550088,0,0,246,246,04
Oklahoma,U.S. House,Tom Cole,REP,550088,0,0,132,132,04
Oklahoma,U.S. House,Rj Harris,IND,550088,0,0,19,19,04
Oklahoma,State House,Stephen Covert,DEM,550088,0,0,261,261,10
Oklahoma,State House,Gary Banz,REP,550088,0,0,133,133,10
Oklahoma,President,Barack Obama,DEM,550089,0,0,557,557,
Oklahoma,President,Mitt Romney,REP,550089,0,0,184,184,
Oklahoma,U.S. House,Tom Guild,DEM,550089,0,0,522,522,05
Oklahoma,U.S. House,James Lankford,REP,550089,0,0,181,181,05
Oklahoma,U.S. House,Pat Martin,IND,550089,0,0,22,22,05
Oklahoma,U.S. House,Robert Murphy,IND,550089,0,0,10,10,05
Oklahoma,President,Barack Obama,DEM,550090,0,0,118,118,
Oklahoma,President,Mitt Romney,REP,550090,0,0,44,44,
Oklahoma,U.S. House,Tom Guild,DEM,550090,0,0,114,114,05
Oklahoma,U.S. House,James Lankford,REP,550090,0,0,41,41,05
Oklahoma,U.S. House,Pat Martin,IND,550090,0,0,7,7,05
Oklahoma,U.S. House,Robert Murphy,IND,550090,0,0,3,3,05
Oklahoma,State House,Stephen Covert,DEM,550090,0,0,121,121,10
Oklahoma,State House,Gary Banz,REP,550090,0,0,43,43,10
Oklahoma,President,Barack Obama,DEM,550091,0,0,118,118,
Oklahoma,President,Mitt Romney,REP,550091,0,0,95,95,
Oklahoma,U.S. House,Donna Marie Bebo,DEM,550091,0,0,106,106,04
Oklahoma,U.S. House,Tom Cole,REP,550091,0,0,89,89,04
Oklahoma,U.S. House,Rj Harris,IND,550091,0,0,15,15,04
Oklahoma,State House,Stephen Covert,DEM,550091,0,0,123,123,10
Oklahoma,State House,Gary Banz,REP,550091,0,0,85,85,10
Oklahoma,President,Barack Obama,DEM,550092,0,0,735,735,
Oklahoma,President,Mitt Romney,REP,550092,0,0,725,725,
Oklahoma,U.S. House,Donna Marie Bebo,DEM,550092,0,0,643,643,04
Oklahoma,U.S. House,Tom Cole,REP,550092,0,0,744,744,04
Oklahoma,U.S. House,Rj Harris,IND,550092,0,0,65,65,04
Oklahoma,State House,Stephen Covert,DEM,550092,0,0,720,720,10
Oklahoma,State House,Gary Banz,REP,550092,0,0,714,714,10
Oklahoma,President,Barack Obama,DEM,550093,0,0,179,179,
Oklahoma,President,Mitt Romney,REP,550093,0,0,472,472,
Oklahoma,U.S. House,Donna Marie Bebo,DEM,550093,0,0,148,148,04
Oklahoma,U.S. House,Tom Cole,REP,550093,0,0,478,478,04
Oklahoma,U.S. House,Rj Harris,IND,550093,0,0,20,20,04
Oklahoma,State House,Stephen Covert,DEM,550093,0,0,165,165,10
Oklahoma,State House,Gary Banz,REP,550093,0,0,472,472,10
Oklahoma,President,Barack Obama,DEM,550094,0,0,344,344,
Oklahoma,President,Mitt Romney,REP,550094,0,0,711,711,
Oklahoma,U.S. House,Donna Marie Bebo,DEM,550094,0,0,266,266,04
Oklahoma,U.S. House,Tom Cole,REP,550094,0,0,724,724,04
Oklahoma,U.S. House,Rj Harris,IND,550094,0,0,58,58,04
Oklahoma,State House,Stephen Covert,DEM,550094,0,0,324,324,10
Oklahoma,State House,Gary Banz,REP,550094,0,0,716,716,10
Oklahoma,President,Barack Obama,DEM,550095,0,0,248,248,
Oklahoma,President,Mitt Romney,REP,550095,0,0,547,547,
Oklahoma,U.S. House,Donna Marie Bebo,DEM,550095,0,0,199,199,04
Oklahoma,U.S. House,Tom Cole,REP,550095,0,0,552,552,04
Oklahoma,U.S. House,Rj Harris,IND,550095,0,0,33,33,04
Oklahoma,State House,Stephen Covert,DEM,550095,0,0,221,221,10
Oklahoma,State House,Gary Banz,REP,550095,0,0,555,555,10
Oklahoma,President,Barack Obama,DEM,550096,0,0,432,432,
Oklahoma,President,Mitt Romney,REP,550096,0,0,702,702,
Oklahoma,U.S. House,Donna Marie Bebo,DEM,550096,0,0,350,350,04
Oklahoma,U.S. House,Tom Cole,REP,550096,0,0,727,727,04
Oklahoma,U.S. House,Rj Harris,IND,550096,0,0,48,48,04
Oklahoma,State House,Stephen Covert,DEM,550096,0,0,419,419,10
Oklahoma,State House,Gary Banz,REP,550096,0,0,698,698,10
Oklahoma,President,Barack Obama,DEM,550097,0,0,246,246,
Oklahoma,President,Mitt Romney,REP,550097,0,0,488,488,
Oklahoma,U.S. House,Donna Marie Bebo,DEM,550097,0,0,183,183,04
Oklahoma,U.S. House,Tom Cole,REP,550097,0,0,509,509,04
Oklahoma,U.S. House,Rj Harris,IND,550097,0,0,35,35,04
Oklahoma,State House,Stephen Covert,DEM,550097,0,0,207,207,10
Oklahoma,State House,Gary Banz,REP,550097,0,0,517,517,10
Oklahoma,President,Barack Obama,DEM,550098,0,0,340,340,
Oklahoma,President,Mitt Romney,REP,550098,0,0,993,993,
Oklahoma,U.S. House,Donna Marie Bebo,DEM,550098,0,0,275,275,04
Oklahoma,U.S. House,Tom Cole,REP,550098,0,0,984,984,04
Oklahoma,U.S. House,Rj Harris,IND,550098,0,0,62,62,04
Oklahoma,State House,Stephen Covert,DEM,550098,0,0,307,307,10
Oklahoma,State House,Gary Banz,REP,550098,0,0,1004,1004,10
Oklahoma,President,Barack Obama,DEM,550099,0,0,321,321,
Oklahoma,President,Mitt Romney,REP,550099,0,0,687,687,
Oklahoma,U.S. House,Tom Guild,DEM,550099,0,0,284,284,05
Oklahoma,U.S. House,James Lankford,REP,550099,0,0,694,694,05
Oklahoma,U.S. House,Pat Martin,IND,550099,0,0,17,17,05
Oklahoma,U.S. House,Robert Murphy,IND,550099,0,0,13,13,05
Oklahoma,President,Barack Obama,DEM,550100,0,0,310,310,
Oklahoma,President,Mitt Romney,REP,550100,0,0,945,945,
Oklahoma,U.S. House,Tom Guild,DEM,550100,0,0,278,278,05
Oklahoma,U.S. House,James Lankford,REP,550100,0,0,915,915,05
Oklahoma,U.S. House,Pat Martin,IND,550100,0,0,19,19,05
Oklahoma,U.S. House,Robert Murphy,IND,550100,0,0,15,15,05
Oklahoma,State House,Ed Holzberger,DEM,550100,0,0,220,220,83
Oklahoma,State House,Randy Mcdaniel,REP,550100,0,0,1008,1008,83
Oklahoma,President,Barack Obama,DEM,550101,0,0,102,102,
Oklahoma,President,Mitt Romney,REP,550101,0,0,386,386,
Oklahoma,U.S. House,Tom Guild,DEM,550101,0,0,99,99,05
Oklahoma,U.S. House,James Lankford,REP,550101,0,0,372,372,05
Oklahoma,U.S. House,Pat Martin,IND,550101,0,0,7,7,05
Oklahoma,U.S. House,Robert Murphy,IND,550101,0,0,6,6,05
Oklahoma,State House,Ed Holzberger,DEM,550101,0,0,91,91,83
Oklahoma,State House,Randy Mcdaniel,REP,550101,0,0,391,391,83
Oklahoma,President,Barack Obama,DEM,550102,0,0,422,422,
Oklahoma,President,Mitt Romney,REP,550102,0,0,995,995,
Oklahoma,U.S. House,Tom Guild,DEM,550102,0,0,367,367,05
Oklahoma,U.S. House,James Lankford,REP,550102,0,0,981,981,05
Oklahoma,U.S. House,Pat Martin,IND,550102,0,0,20,20,05
Oklahoma,U.S. House,Robert Murphy,IND,550102,0,0,30,30,05
Oklahoma,President,Barack Obama,DEM,550103,0,0,349,349,
Oklahoma,President,Mitt Romney,REP,550103,0,0,492,492,
Oklahoma,U.S. House,Tom Guild,DEM,550103,0,0,314,314,05
Oklahoma,U.S. House,James Lankford,REP,550103,0,0,468,468,05
Oklahoma,U.S. House,Pat Martin,IND,550103,0,0,28,28,05
Oklahoma,U.S. House,Robert Murphy,IND,550103,0,0,26,26,05
Oklahoma,State House,Ed Holzberger,DEM,550103,0,0,313,313,83
Oklahoma,State House,Randy Mcdaniel,REP,550103,0,0,504,504,83
Oklahoma,President,Barack Obama,DEM,550104,0,0,332,332,
Oklahoma,President,Mitt Romney,REP,550104,0,0,370,370,
Oklahoma,U.S. House,Tom Guild,DEM,550104,0,0,283,283,05
Oklahoma,U.S. House,James Lankford,REP,550104,0,0,372,372,05
Oklahoma,U.S. House,Pat Martin,IND,550104,0,0,20,20,05
Oklahoma,U.S. House,Robert Murphy,IND,550104,0,0,17,17,05
Oklahoma,State House,Ed Holzberger,DEM,550104,0,0,300,300,83
Oklahoma,State House,Randy Mcdaniel,REP,550104,0,0,376,376,83
Oklahoma,President,Barack Obama,DEM,550105,0,0,304,304,
Oklahoma,President,Mitt Romney,REP,550105,0,0,591,591,
Oklahoma,U.S. House,Tom Guild,DEM,550105,0,0,279,279,05
Oklahoma,U.S. House,James Lankford,REP,550105,0,0,578,578,05
Oklahoma,U.S. House,Pat Martin,IND,550105,0,0,16,16,05
Oklahoma,U.S. House,Robert Murphy,IND,550105,0,0,19,19,05
Oklahoma,State House,Ed Holzberger,DEM,550105,0,0,273,273,83
Oklahoma,State House,Randy Mcdaniel,REP,550105,0,0,592,592,83
Oklahoma,President,Barack Obama,DEM,550106,0,0,368,368,
Oklahoma,President,Mitt Romney,REP,550106,0,0,734,734,
Oklahoma,U.S. House,Tom Guild,DEM,550106,0,0,331,331,05
Oklahoma,U.S. House,James Lankford,REP,550106,0,0,726,726,05
Oklahoma,U.S. House,Pat Martin,IND,550106,0,0,13,13,05
Oklahoma,U.S. House,Robert Murphy,IND,550106,0,0,15,15,05
Oklahoma,President,Barack Obama,DEM,550107,0,0,124,124,
Oklahoma,President,Mitt Romney,REP,550107,0,0,277,277,
Oklahoma,U.S. House,Tom Guild,DEM,550107,0,0,116,116,05
Oklahoma,U.S. House,James Lankford,REP,550107,0,0,258,258,05
Oklahoma,U.S. House,Pat Martin,IND,550107,0,0,9,9,05
Oklahoma,U.S. House,Robert Murphy,IND,550107,0,0,16,16,05
Oklahoma,State Senate,Clark Jolley,REP,550107,0,0,276,276,41
Oklahoma,State Senate,Richard Prawdzienski,IND,550107,0,0,97,97,41
Oklahoma,President,Barack Obama,DEM,550108,0,0,93,93,
Oklahoma,President,Mitt Romney,REP,550108,0,0,195,195,
Oklahoma,U.S. House,Tom Guild,DEM,550108,0,0,81,81,05
Oklahoma,U.S. House,James Lankford,REP,550108,0,0,197,197,05
Oklahoma,U.S. House,Pat Martin,IND,550108,0,0,1,1,05
Oklahoma,U.S. House,Robert Murphy,IND,550108,0,0,7,7,05
Oklahoma,State Senate,Clark Jolley,REP,550108,0,0,199,199,41
Oklahoma,State Senate,Richard Prawdzienski,IND,550108,0,0,62,62,41
Oklahoma,President,Barack Obama,DEM,550109,0,0,340,340,
Oklahoma,President,Mitt Romney,REP,550109,0,0,999,999,
Oklahoma,U.S. House,Tom Guild,DEM,550109,0,0,300,300,05
Oklahoma,U.S. House,James Lankford,REP,550109,0,0,1001,1001,05
Oklahoma,U.S. House,Pat Martin,IND,550109,0,0,12,12,05
Oklahoma,U.S. House,Robert Murphy,IND,550109,0,0,19,19,05
Oklahoma,President,Barack Obama,DEM,550110,0,0,78,78,
Oklahoma,President,Mitt Romney,REP,550110,0,0,219,219,
Oklahoma,U.S. House,Tom Guild,DEM,550110,0,0,65,65,05
Oklahoma,U.S. House,James Lankford,REP,550110,0,0,214,214,05
Oklahoma,U.S. House,Pat Martin,IND,550110,0,0,7,7,05
Oklahoma,U.S. House,Robert Murphy,IND,550110,0,0,9,9,05
Oklahoma,State Senate,Clark Jolley,REP,550110,0,0,225,225,41
Oklahoma,State Senate,Richard Prawdzienski,IND,550110,0,0,56,56,41
Oklahoma,President,Barack Obama,DEM,550111,0,0,426,426,
Oklahoma,President,Mitt Romney,REP,550111,0,0,1125,1125,
Oklahoma,U.S. House,Tom Guild,DEM,550111,0,0,364,364,05
Oklahoma,U.S. House,James Lankford,REP,550111,0,0,1131,1131,05
Oklahoma,U.S. House,Pat Martin,IND,550111,0,0,24,24,05
Oklahoma,U.S. House,Robert Murphy,IND,550111,0,0,23,23,05
Oklahoma,State Senate,Clark Jolley,REP,550111,0,0,1133,1133,41
Oklahoma,State Senate,Richard Prawdzienski,IND,550111,0,0,320,320,41
Oklahoma,President,Barack Obama,DEM,550112,0,0,55,55,
Oklahoma,President,Mitt Romney,REP,550112,0,0,103,103,
Oklahoma,U.S. House,Tom Guild,DEM,550112,0,0,51,51,05
Oklahoma,U.S. House,James Lankford,REP,550112,0,0,98,98,05
Oklahoma,U.S. House,Pat Martin,IND,550112,0,0,4,4,05
Oklahoma,U.S. House,Robert Murphy,IND,550112,0,0,5,5,05
Oklahoma,President,Barack Obama,DEM,550113,0,0,123,123,
Oklahoma,President,Mitt Romney,REP,550113,0,0,241,241,
Oklahoma,U.S. House,Tom Guild,DEM,550113,0,0,118,118,05
Oklahoma,U.S. House,James Lankford,REP,550113,0,0,230,230,05
Oklahoma,U.S. House,Pat Martin,IND,550113,0,0,7,7,05
Oklahoma,U.S. House,Robert Murphy,IND,550113,0,0,7,7,05
Oklahoma,President,Barack Obama,DEM,550114,0,0,688,688,
Oklahoma,President,Mitt Romney,REP,550114,0,0,74,74,
Oklahoma,U.S. House,Tom Guild,DEM,550114,0,0,643,643,05
Oklahoma,U.S. House,James Lankford,REP,550114,0,0,86,86,05
Oklahoma,U.S. House,Pat Martin,IND,550114,0,0,6,6,05
Oklahoma,U.S. House,Robert Murphy,IND,550114,0,0,17,17,05
Oklahoma,President,Barack Obama,DEM,550115,0,0,987,987,
Oklahoma,President,Mitt Romney,REP,550115,0,0,34,34,
Oklahoma,U.S. House,Tom Guild,DEM,550115,0,0,919,919,05
Oklahoma,U.S. House,James Lankford,REP,550115,0,0,64,64,05
Oklahoma,U.S. House,Pat Martin,IND,550115,0,0,15,15,05
Oklahoma,U.S. House,Robert Murphy,IND,550115,0,0,14,14,05
Oklahoma,President,Barack Obama,DEM,550116,0,0,241,241,
Oklahoma,President,Mitt Romney,REP,550116,0,0,226,226,
Oklahoma,U.S. House,Tom Guild,DEM,550116,0,0,196,196,05
Oklahoma,U.S. House,James Lankford,REP,550116,0,0,230,230,05
Oklahoma,U.S. House,Pat Martin,IND,550116,0,0,17,17,05
Oklahoma,U.S. House,Robert Murphy,IND,550116,0,0,11,11,05
Oklahoma,State House,Anastasia Pittman,DEM,550116,0,0,259,259,99
Oklahoma,State House,Willard Linzy,REP,550116,0,0,186,186,99
Oklahoma,President,Barack Obama,DEM,550117,0,0,1021,1021,
Oklahoma,President,Mitt Romney,REP,550117,0,0,142,142,
Oklahoma,U.S. House,Tom Guild,DEM,550117,0,0,975,975,05
Oklahoma,U.S. House,James Lankford,REP,550117,0,0,159,159,05
Oklahoma,U.S. House,Pat Martin,IND,550117,0,0,16,16,05
Oklahoma,U.S. House,Robert Murphy,IND,550117,0,0,13,13,05
Oklahoma,President,Barack Obama,DEM,550118,0,0,1015,1015,
Oklahoma,President,Mitt Romney,REP,550118,0,0,266,266,
Oklahoma,U.S. House,Tom Guild,DEM,550118,0,0,944,944,05
Oklahoma,U.S. House,James Lankford,REP,550118,0,0,258,258,05
Oklahoma,U.S. House,Pat Martin,IND,550118,0,0,40,40,05
Oklahoma,U.S. House,Robert Murphy,IND,550118,0,0,34,34,05
Oklahoma,State House,Anastasia Pittman,DEM,550118,0,0,1022,1022,99
Oklahoma,State House,Willard Linzy,REP,550118,0,0,244,244,99
Oklahoma,President,Barack Obama,DEM,550119,0,0,73,73,
Oklahoma,President,Mitt Romney,REP,550119,0,0,96,96,
Oklahoma,U.S. House,Tom Guild,DEM,550119,0,0,75,75,05
Oklahoma,U.S. House,James Lankford,REP,550119,0,0,88,88,05
Oklahoma,U.S. House,Pat Martin,IND,550119,0,0,5,5,05
Oklahoma,U.S. House,Robert Murphy,IND,550119,0,0,3,3,05
Oklahoma,State House,Ed Holzberger,DEM,550119,0,0,63,63,83
Oklahoma,State House,Randy Mcdaniel,REP,550119,0,0,106,106,83
Oklahoma,President,Barack Obama,DEM,550120,0,0,777,777,
Oklahoma,President,Mitt Romney,REP,550120,0,0,225,225,
Oklahoma,U.S. House,Tom Guild,DEM,550120,0,0,713,713,05
Oklahoma,U.S. House,James Lankford,REP,550120,0,0,229,229,05
Oklahoma,U.S. House,Pat Martin,IND,550120,0,0,29,29,05
Oklahoma,U.S. House,Robert Murphy,IND,550120,0,0,27,27,05
Oklahoma,State House,Anastasia Pittman,DEM,550120,0,0,813,813,99
Oklahoma,State House,Willard Linzy,REP,550120,0,0,178,178,99
Oklahoma,President,Barack Obama,DEM,550121,0,0,1017,1017,
Oklahoma,President,Mitt Romney,REP,550121,0,0,243,243,
Oklahoma,U.S. House,Tom Guild,DEM,550121,0,0,936,936,05
Oklahoma,U.S. House,James Lankford,REP,550121,0,0,251,251,05
Oklahoma,U.S. House,Pat Martin,IND,550121,0,0,40,40,05
Oklahoma,U.S. House,Robert Murphy,IND,550121,0,0,25,25,05
Oklahoma,State House,Anastasia Pittman,DEM,550121,0,0,1019,1019,99
Oklahoma,State House,Willard Linzy,REP,550121,0,0,228,228,99
Oklahoma,President,Barack Obama,DEM,550122,0,0,595,595,
Oklahoma,President,Mitt Romney,REP,550122,0,0,195,195,
Oklahoma,U.S. House,Tom Guild,DEM,550122,0,0,544,544,05
Oklahoma,U.S. House,James Lankford,REP,550122,0,0,195,195,05
Oklahoma,U.S. House,Pat Martin,IND,550122,0,0,18,18,05
Oklahoma,U.S. House,Robert Murphy,IND,550122,0,0,17,17,05
Oklahoma,State House,Anastasia Pittman,DEM,550122,0,0,589,589,99
Oklahoma,State House,Willard Linzy,REP,550122,0,0,176,176,99
Oklahoma,President,Barack Obama,DEM,550123,0,0,667,667,
Oklahoma,President,Mitt Romney,REP,550123,0,0,351,351,
Oklahoma,U.S. House,Tom Guild,DEM,550123,0,0,622,622,05
Oklahoma,U.S. House,James Lankford,REP,550123,0,0,344,344,05
Oklahoma,U.S. House,Pat Martin,IND,550123,0,0,22,22,05
Oklahoma,U.S. House,Robert Murphy,IND,550123,0,0,21,21,05
Oklahoma,State House,Anastasia Pittman,DEM,550123,0,0,682,682,99
Oklahoma,State House,Willard Linzy,REP,550123,0,0,318,318,99
Oklahoma,President,Barack Obama,DEM,550124,0,0,508,508,
Oklahoma,President,Mitt Romney,REP,550124,0,0,435,435,
Oklahoma,U.S. House,Tom Guild,DEM,550124,0,0,472,472,05
Oklahoma,U.S. House,James Lankford,REP,550124,0,0,430,430,05
Oklahoma,U.S. House,Pat Martin,IND,550124,0,0,23,23,05
Oklahoma,U.S. House,Robert Murphy,IND,550124,0,0,18,18,05
Oklahoma,State House,Ed Holzberger,DEM,550124,0,0,477,477,83
Oklahoma,State House,Randy Mcdaniel,REP,550124,0,0,446,446,83
Oklahoma,President,Barack Obama,DEM,550125,0,0,504,504,
Oklahoma,President,Mitt Romney,REP,550125,0,0,222,222,
Oklahoma,U.S. House,Tom Guild,DEM,550125,0,0,454,454,05
Oklahoma,U.S. House,James Lankford,REP,550125,0,0,230,230,05
Oklahoma,U.S. House,Pat Martin,IND,550125,0,0,19,19,05
Oklahoma,U.S. House,Robert Murphy,IND,550125,0,0,16,16,05
Oklahoma,State House,Anastasia Pittman,DEM,550125,0,0,502,502,99
Oklahoma,State House,Willard Linzy,REP,550125,0,0,205,205,99
Oklahoma,President,Barack Obama,DEM,550126,0,0,735,735,
Oklahoma,President,Mitt Romney,REP,550126,0,0,349,349,
Oklahoma,U.S. House,Tom Guild,DEM,550126,0,0,671,671,05
Oklahoma,U.S. House,James Lankford,REP,550126,0,0,349,349,05
Oklahoma,U.S. House,Pat Martin,IND,550126,0,0,36,36,05
Oklahoma,U.S. House,Robert Murphy,IND,550126,0,0,18,18,05
Oklahoma,State House,Ed Holzberger,DEM,550126,0,0,690,690,83
Oklahoma,State House,Randy Mcdaniel,REP,550126,0,0,366,366,83
Oklahoma,President,Barack Obama,DEM,550127,0,0,402,402,
Oklahoma,President,Mitt Romney,REP,550127,0,0,803,803,
Oklahoma,U.S. House,Tom Guild,DEM,550127,0,0,359,359,05
Oklahoma,U.S. House,James Lankford,REP,550127,0,0,797,797,05
Oklahoma,U.S. House,Pat Martin,IND,550127,0,0,20,20,05
Oklahoma,U.S. House,Robert Murphy,IND,550127,0,0,19,19,05
Oklahoma,State House,Ed Holzberger,DEM,550127,0,0,375,375,83
Oklahoma,State House,Randy Mcdaniel,REP,550127,0,0,800,800,83
Oklahoma,President,Barack Obama,DEM,550128,0,0,513,513,
Oklahoma,President,Mitt Romney,REP,550128,0,0,827,827,
Oklahoma,U.S. House,Tom Guild,DEM,550128,0,0,438,438,05
Oklahoma,U.S. House,James Lankford,REP,550128,0,0,816,816,05
Oklahoma,U.S. House,Pat Martin,IND,550128,0,0,34,34,05
Oklahoma,U.S. House,Robert Murphy,IND,550128,0,0,37,37,05
Oklahoma,State House,Ed Holzberger,DEM,550128,0,0,467,467,83
Oklahoma,State House,Randy Mcdaniel,REP,550128,0,0,827,827,83
Oklahoma,President,Barack Obama,DEM,550129,0,0,231,231,
Oklahoma,President,Mitt Romney,REP,550129,0,0,352,352,
Oklahoma,U.S. House,Tom Guild,DEM,550129,0,0,208,208,05
Oklahoma,U.S. House,James Lankford,REP,550129,0,0,334,334,05
Oklahoma,U.S. House,Pat Martin,IND,550129,0,0,9,9,05
Oklahoma,U.S. House,Robert Murphy,IND,550129,0,0,13,13,05
Oklahoma,State House,Ed Holzberger,DEM,550129,0,0,209,209,83
Oklahoma,State House,Randy Mcdaniel,REP,550129,0,0,333,333,83
Oklahoma,President,Barack Obama,DEM,550130,0,0,531,531,
Oklahoma,President,Mitt Romney,REP,550130,0,0,1028,1028,
Oklahoma,U.S. House,Tom Guild,DEM,550130,0,0,467,467,05
Oklahoma,U.S. House,James Lankford,REP,550130,0,0,1016,1016,05
Oklahoma,U.S. House,Pat Martin,IND,550130,0,0,45,45,05
Oklahoma,U.S. House,Robert Murphy,IND,550130,0,0,27,27,05
Oklahoma,State House,Ed Holzberger,DEM,550130,0,0,487,487,83
Oklahoma,State House,Randy Mcdaniel,REP,550130,0,0,1037,1037,83
Oklahoma,President,Barack Obama,DEM,550131,0,0,210,210,
Oklahoma,President,Mitt Romney,REP,550131,0,0,540,540,
Oklahoma,U.S. House,Tom Guild,DEM,550131,0,0,187,187,05
Oklahoma,U.S. House,James Lankford,REP,550131,0,0,540,540,05
Oklahoma,U.S. House,Pat Martin,IND,550131,0,0,8,8,05
Oklahoma,U.S. House,Robert Murphy,IND,550131,0,0,10,10,05
Oklahoma,State House,Ed Holzberger,DEM,550131,0,0,173,173,83
Oklahoma,State House,Randy Mcdaniel,REP,550131,0,0,550,550,83
Oklahoma,President,Barack Obama,DEM,550132,0,0,244,244,
Oklahoma,President,Mitt Romney,REP,550132,0,0,551,551,
Oklahoma,U.S. House,Tom Guild,DEM,550132,0,0,208,208,05
Oklahoma,U.S. House,James Lankford,REP,550132,0,0,559,559,05
Oklahoma,U.S. House,Pat Martin,IND,550132,0,0,8,8,05
Oklahoma,U.S. House,Robert Murphy,IND,550132,0,0,11,11,05
Oklahoma,State House,Ed Holzberger,DEM,550132,0,0,226,226,83
Oklahoma,State House,Randy Mcdaniel,REP,550132,0,0,540,540,83
Oklahoma,President,Barack Obama,DEM,550133,0,0,297,297,
Oklahoma,President,Mitt Romney,REP,550133,0,0,634,634,
Oklahoma,U.S. House,Tom Guild,DEM,550133,0,0,263,263,05
Oklahoma,U.S. House,James Lankford,REP,550133,0,0,628,628,05
Oklahoma,U.S. House,Pat Martin,IND,550133,0,0,19,19,05
Oklahoma,U.S. House,Robert Murphy,IND,550133,0,0,17,17,05
Oklahoma,President,Barack Obama,DEM,550134,0,0,454,454,
Oklahoma,President,Mitt Romney,REP,550134,0,0,1284,1284,
Oklahoma,U.S. House,Tom Guild,DEM,550134,0,0,392,392,05
Oklahoma,U.S. House,James Lankford,REP,550134,0,0,1293,1293,05
Oklahoma,U.S. House,Pat Martin,IND,550134,0,0,24,24,05
Oklahoma,U.S. House,Robert Murphy,IND,550134,0,0,18,18,05
Oklahoma,President,Barack Obama,DEM,550135,0,0,134,134,
Oklahoma,President,Mitt Romney,REP,550135,0,0,342,342,
Oklahoma,U.S. House,Tom Guild,DEM,550135,0,0,115,115,05
Oklahoma,U.S. House,James Lankford,REP,550135,0,0,337,337,05
Oklahoma,U.S. House,Pat Martin,IND,550135,0,0,6,6,05
Oklahoma,U.S. House,Robert Murphy,IND,550135,0,0,9,9,05
Oklahoma,President,Barack Obama,DEM,550136,0,0,524,524,
Oklahoma,President,Mitt Romney,REP,550136,0,0,1263,1263,
Oklahoma,U.S. House,Tom Guild,DEM,550136,0,0,426,426,05
Oklahoma,U.S. House,James Lankford,REP,550136,0,0,1272,1272,05
Oklahoma,U.S. House,Pat Martin,IND,550136,0,0,31,31,05
Oklahoma,U.S. House,Robert Murphy,IND,550136,0,0,34,34,05
Oklahoma,President,Barack Obama,DEM,550137,0,0,180,180,
Oklahoma,President,Mitt Romney,REP,550137,0,0,827,827,
Oklahoma,U.S. House,Tom Guild,DEM,550137,0,0,140,140,05
Oklahoma,U.S. House,James Lankford,REP,550137,0,0,831,831,05
Oklahoma,U.S. House,Pat Martin,IND,550137,0,0,19,19,05
Oklahoma,U.S. House,Robert Murphy,IND,550137,0,0,13,13,05
Oklahoma,President,Barack Obama,DEM,550138,0,0,69,69,
Oklahoma,President,Mitt Romney,REP,550138,0,0,385,385,
Oklahoma,U.S. House,Tom Guild,DEM,550138,0,0,64,64,05
Oklahoma,U.S. House,James Lankford,REP,550138,0,0,371,371,05
Oklahoma,U.S. House,Pat Martin,IND,550138,0,0,9,9,05
Oklahoma,U.S. House,Robert Murphy,IND,550138,0,0,7,7,05
Oklahoma,President,Barack Obama,DEM,550139,0,0,351,351,
Oklahoma,President,Mitt Romney,REP,550139,0,0,1143,1143,
Oklahoma,U.S. House,Tom Guild,DEM,550139,0,0,280,280,05
Oklahoma,U.S. House,James Lankford,REP,550139,0,0,1153,1153,05
Oklahoma,U.S. House,Pat Martin,IND,550139,0,0,27,27,05
Oklahoma,U.S. House,Robert Murphy,IND,550139,0,0,19,19,05
Oklahoma,President,Barack Obama,DEM,550140,0,0,180,180,
Oklahoma,President,Mitt Romney,REP,550140,0,0,668,668,
Oklahoma,U.S. House,Tom Guild,DEM,550140,0,0,161,161,05
Oklahoma,U.S. House,James Lankford,REP,550140,0,0,657,657,05
Oklahoma,U.S. House,Pat Martin,IND,550140,0,0,9,9,05
Oklahoma,U.S. House,Robert Murphy,IND,550140,0,0,12,12,05
Oklahoma,President,Barack Obama,DEM,550141,0,0,406,406,
Oklahoma,President,Mitt Romney,REP,550141,0,0,913,913,
Oklahoma,U.S. House,Tom Guild,DEM,550141,0,0,342,342,05
Oklahoma,U.S. House,James Lankford,REP,550141,0,0,913,913,05
Oklahoma,U.S. House,Pat Martin,IND,550141,0,0,34,34,05
Oklahoma,U.S. House,Robert Murphy,IND,550141,0,0,14,14,05
Oklahoma,President,Barack Obama,DEM,550142,0,0,676,676,
Oklahoma,President,Mitt Romney,REP,550142,0,0,1162,1162,
Oklahoma,U.S. House,Tom Guild,DEM,550142,0,0,587,587,05
Oklahoma,U.S. House,James Lankford,REP,550142,0,0,1167,1167,05
Oklahoma,U.S. House,Pat Martin,IND,550142,0,0,32,32,05
Oklahoma,U.S. House,Robert Murphy,IND,550142,0,0,36,36,05
Oklahoma,President,Barack Obama,DEM,550143,0,0,299,299,
Oklahoma,President,Mitt Romney,REP,550143,0,0,757,757,
Oklahoma,U.S. House,Tom Guild,DEM,550143,0,0,249,249,05
Oklahoma,U.S. House,James Lankford,REP,550143,0,0,767,767,05
Oklahoma,U.S. House,Pat Martin,IND,550143,0,0,19,19,05
Oklahoma,U.S. House,Robert Murphy,IND,550143,0,0,11,11,05
Oklahoma,President,Barack Obama,DEM,550144,0,0,378,378,
Oklahoma,President,Mitt Romney,REP,550144,0,0,793,793,
Oklahoma,U.S. House,Tom Guild,DEM,550144,0,0,346,346,05
Oklahoma,U.S. House,James Lankford,REP,550144,0,0,768,768,05
Oklahoma,U.S. House,Pat Martin,IND,550144,0,0,24,24,05
Oklahoma,U.S. House,Robert Murphy,IND,550144,0,0,18,18,05
Oklahoma,President,Barack Obama,DEM,550145,0,0,236,236,
Oklahoma,President,Mitt Romney,REP,550145,0,0,774,774,
Oklahoma,U.S. House,Tom Guild,DEM,550145,0,0,226,226,05
Oklahoma,U.S. House,James Lankford,REP,550145,0,0,755,755,05
Oklahoma,U.S. House,Pat Martin,IND,550145,0,0,14,14,05
Oklahoma,U.S. House,Robert Murphy,IND,550145,0,0,13,13,05
Oklahoma,State House,Ed Holzberger,DEM,550145,0,0,213,213,83
Oklahoma,State House,Randy Mcdaniel,REP,550145,0,0,777,777,83
Oklahoma,President,Barack Obama,DEM,550146,0,0,380,380,
Oklahoma,President,Mitt Romney,REP,550146,0,0,992,992,
Oklahoma,U.S. House,Tom Guild,DEM,550146,0,0,333,333,05
Oklahoma,U.S. House,James Lankford,REP,550146,0,0,983,983,05
Oklahoma,U.S. House,Pat Martin,IND,550146,0,0,23,23,05
Oklahoma,U.S. House,Robert Murphy,IND,550146,0,0,21,21,05
Oklahoma,President,Barack Obama,DEM,550147,0,0,148,148,
Oklahoma,President,Mitt Romney,REP,550147,0,0,331,331,
Oklahoma,U.S. House,Tom Guild,DEM,550147,0,0,128,128,05
Oklahoma,U.S. House,James Lankford,REP,550147,0,0,332,332,05
Oklahoma,U.S. House,Pat Martin,IND,550147,0,0,9,9,05
Oklahoma,U.S. House,Robert Murphy,IND,550147,0,0,6,6,05
Oklahoma,President,Barack Obama,DEM,550148,0,0,508,508,
Oklahoma,President,Mitt Romney,REP,550148,0,0,935,935,
Oklahoma,U.S. House,Tom Guild,DEM,550148,0,0,454,454,05
Oklahoma,U.S. House,James Lankford,REP,550148,0,0,939,939,05
Oklahoma,U.S. House,Pat Martin,IND,550148,0,0,22,22,05
Oklahoma,U.S. House,Robert Murphy,IND,550148,0,0,18,18,05
Oklahoma,President,Barack Obama,DEM,550149,0,0,380,380,
Oklahoma,President,Mitt Romney,REP,550149,0,0,1267,1267,
Oklahoma,U.S. House,Tom Guild,DEM,550149,0,0,336,336,05
Oklahoma,U.S. House,James Lankford,REP,550149,0,0,1248,1248,05
Oklahoma,U.S. House,Pat Martin,IND,550149,0,0,25,25,05
Oklahoma,U.S. House,Robert Murphy,IND,550149,0,0,22,22,05
Oklahoma,President,Barack Obama,DEM,550150,0,0,553,553,
Oklahoma,President,Mitt Romney,REP,550150,0,0,1115,1115,
Oklahoma,U.S. House,Tom Guild,DEM,550150,0,0,498,498,05
Oklahoma,U.S. House,James Lankford,REP,550150,0,0,1102,1102,05
Oklahoma,U.S. House,Pat Martin,IND,550150,0,0,27,27,05
Oklahoma,U.S. House,Robert Murphy,IND,550150,0,0,25,25,05
Oklahoma,President,Barack Obama,DEM,550151,0,0,579,579,
Oklahoma,President,Mitt Romney,REP,550151,0,0,1024,1024,
Oklahoma,U.S. House,Tom Guild,DEM,550151,0,0,487,487,05
Oklahoma,U.S. House,James Lankford,REP,550151,0,0,1043,1043,05
Oklahoma,U.S. House,Pat Martin,IND,550151,0,0,39,39,05
Oklahoma,U.S. House,Robert Murphy,IND,550151,0,0,22,22,05
Oklahoma,President,Barack Obama,DEM,550152,0,0,509,509,
Oklahoma,President,Mitt Romney,REP,550152,0,0,981,981,
Oklahoma,U.S. House,Tom Guild,DEM,550152,0,0,445,445,05
Oklahoma,U.S. House,James Lankford,REP,550152,0,0,986,986,05
Oklahoma,U.S. House,Pat Martin,IND,550152,0,0,29,29,05
Oklahoma,U.S. House,Robert Murphy,IND,550152,0,0,21,21,05
Oklahoma,President,Barack Obama,DEM,550153,0,0,534,534,
Oklahoma,President,Mitt Romney,REP,550153,0,0,1194,1194,
Oklahoma,U.S. House,Tom Guild,DEM,550153,0,0,482,482,05
Oklahoma,U.S. House,James Lankford,REP,550153,0,0,1164,1164,05
Oklahoma,U.S. House,Pat Martin,IND,550153,0,0,32,32,05
Oklahoma,U.S. House,Robert Murphy,IND,550153,0,0,27,27,05
Oklahoma,President,Barack Obama,DEM,550154,0,0,625,625,
Oklahoma,President,Mitt Romney,REP,550154,0,0,1159,1159,
Oklahoma,U.S. House,Tom Guild,DEM,550154,0,0,560,560,05
Oklahoma,U.S. House,James Lankford,REP,550154,0,0,1147,1147,05
Oklahoma,U.S. House,Pat Martin,IND,550154,0,0,37,37,05
Oklahoma,U.S. House,Robert Murphy,IND,550154,0,0,25,25,05
Oklahoma,President,Barack Obama,DEM,550155,0,0,203,203,
Oklahoma,President,Mitt Romney,REP,550155,0,0,395,395,
Oklahoma,U.S. House,Tom Guild,DEM,550155,0,0,182,182,05
Oklahoma,U.S. House,James Lankford,REP,550155,0,0,384,384,05
Oklahoma,U.S. House,Pat Martin,IND,550155,0,0,14,14,05
Oklahoma,U.S. House,Robert Murphy,IND,550155,0,0,15,15,05
Oklahoma,President,Barack Obama,DEM,550156,0,0,716,716,
Oklahoma,President,Mitt Romney,REP,550156,0,0,851,851,
Oklahoma,U.S. House,Tom Guild,DEM,550156,0,0,635,635,05
Oklahoma,U.S. House,James Lankford,REP,550156,0,0,856,856,05
Oklahoma,U.S. House,Pat Martin,IND,550156,0,0,36,36,05
Oklahoma,U.S. House,Robert Murphy,IND,550156,0,0,24,24,05
Oklahoma,President,Barack Obama,DEM,550157,0,0,37,37,
Oklahoma,President,Mitt Romney,REP,550157,0,0,27,27,
Oklahoma,U.S. House,Tom Guild,DEM,550157,0,0,31,31,05
Oklahoma,U.S. House,James Lankford,REP,550157,0,0,28,28,05
Oklahoma,U.S. House,Pat Martin,IND,550157,0,0,1,1,05
Oklahoma,U.S. House,Robert Murphy,IND,550157,0,0,4,4,05
Oklahoma,President,Barack Obama,DEM,550158,0,0,508,508,
Oklahoma,President,Mitt Romney,REP,550158,0,0,697,697,
Oklahoma,U.S. House,Tom Guild,DEM,550158,0,0,442,442,05
Oklahoma,U.S. House,James Lankford,REP,550158,0,0,691,691,05
Oklahoma,U.S. House,Pat Martin,IND,550158,0,0,35,35,05
Oklahoma,U.S. House,Robert Murphy,IND,550158,0,0,24,24,05
Oklahoma,President,Barack Obama,DEM,550159,0,0,600,600,
Oklahoma,President,Mitt Romney,REP,550159,0,0,905,905,
Oklahoma,U.S. House,Tom Guild,DEM,550159,0,0,534,534,05
Oklahoma,U.S. House,James Lankford,REP,550159,0,0,906,906,05
Oklahoma,U.S. House,Pat Martin,IND,550159,0,0,24,24,05
Oklahoma,U.S. House,Robert Murphy,IND,550159,0,0,31,31,05
Oklahoma,President,Barack Obama,DEM,550160,0,0,252,252,
Oklahoma,President,Mitt Romney,REP,550160,0,0,855,855,
Oklahoma,U.S. House,Tom Guild,DEM,550160,0,0,230,230,05
Oklahoma,U.S. House,James Lankford,REP,550160,0,0,853,853,05
Oklahoma,U.S. House,Pat Martin,IND,550160,0,0,7,7,05
Oklahoma,U.S. House,Robert Murphy,IND,550160,0,0,8,8,05
Oklahoma,President,Barack Obama,DEM,550161,0,0,558,558,
Oklahoma,President,Mitt Romney,REP,550161,0,0,398,398,
Oklahoma,U.S. House,Tom Guild,DEM,550161,0,0,504,504,05
Oklahoma,U.S. House,James Lankford,REP,550161,0,0,388,388,05
Oklahoma,U.S. House,Pat Martin,IND,550161,0,0,25,25,05
Oklahoma,U.S. House,Robert Murphy,IND,550161,0,0,33,33,05
Oklahoma,President,Barack Obama,DEM,550162,0,0,276,276,
Oklahoma,President,Mitt Romney,REP,550162,0,0,602,602,
Oklahoma,U.S. House,Tom Guild,DEM,550162,0,0,239,239,05
Oklahoma,U.S. House,James Lankford,REP,550162,0,0,592,592,05
Oklahoma,U.S. House,Pat Martin,IND,550162,0,0,23,23,05
Oklahoma,U.S. House,Robert Murphy,IND,550162,0,0,19,19,05
Oklahoma,President,Barack Obama,DEM,550163,0,0,549,549,
Oklahoma,President,Mitt Romney,REP,550163,0,0,599,599,
Oklahoma,U.S. House,Tom Guild,DEM,550163,0,0,493,493,05
Oklahoma,U.S. House,James Lankford,REP,550163,0,0,587,587,05
Oklahoma,U.S. House,Pat Martin,IND,550163,0,0,24,24,05
Oklahoma,U.S. House,Robert Murphy,IND,550163,0,0,28,28,05
Oklahoma,President,Barack Obama,DEM,550164,0,0,268,268,
Oklahoma,President,Mitt Romney,REP,550164,0,0,420,420,
Oklahoma,U.S. House,Tom Guild,DEM,550164,0,0,223,223,05
Oklahoma,U.S. House,James Lankford,REP,550164,0,0,422,422,05
Oklahoma,U.S. House,Pat Martin,IND,550164,0,0,25,25,05
Oklahoma,U.S. House,Robert Murphy,IND,550164,0,0,14,14,05
Oklahoma,President,Barack Obama,DEM,550165,0,0,176,176,
Oklahoma,President,Mitt Romney,REP,550165,0,0,663,663,
Oklahoma,U.S. House,Tom Guild,DEM,550165,0,0,181,181,05
Oklahoma,U.S. House,James Lankford,REP,550165,0,0,617,617,05
Oklahoma,U.S. House,Pat Martin,IND,550165,0,0,16,16,05
Oklahoma,U.S. House,Robert Murphy,IND,550165,0,0,19,19,05
Oklahoma,President,Barack Obama,DEM,550166,0,0,90,90,
Oklahoma,President,Mitt Romney,REP,550166,0,0,175,175,
Oklahoma,U.S. House,Tom Guild,DEM,550166,0,0,82,82,05
Oklahoma,U.S. House,James Lankford,REP,550166,0,0,172,172,05
Oklahoma,U.S. House,Pat Martin,IND,550166,0,0,1,1,05
Oklahoma,U.S. House,Robert Murphy,IND,550166,0,0,11,11,05
Oklahoma,President,Barack Obama,DEM,550167,0,0,188,188,
Oklahoma,President,Mitt Romney,REP,550167,0,0,225,225,
Oklahoma,U.S. House,Tom Guild,DEM,550167,0,0,173,173,05
Oklahoma,U.S. House,James Lankford,REP,550167,0,0,216,216,05
Oklahoma,U.S. House,Pat Martin,IND,550167,0,0,11,11,05
Oklahoma,U.S. House,Robert Murphy,IND,550167,0,0,13,13,05
Oklahoma,President,Barack Obama,DEM,550168,0,0,105,105,
Oklahoma,President,Mitt Romney,REP,550168,0,0,175,175,
Oklahoma,U.S. House,Tom Guild,DEM,550168,0,0,91,91,05
Oklahoma,U.S. House,James Lankford,REP,550168,0,0,165,165,05
Oklahoma,U.S. House,Pat Martin,IND,550168,0,0,8,8,05
Oklahoma,U.S. House,Robert Murphy,IND,550168,0,0,14,14,05
Oklahoma,President,Barack Obama,DEM,550169,0,0,474,474,
Oklahoma,President,Mitt Romney,REP,550169,0,0,467,467,
Oklahoma,U.S. House,Tom Guild,DEM,550169,0,0,435,435,05
Oklahoma,U.S. House,James Lankford,REP,550169,0,0,442,442,05
Oklahoma,U.S. House,Pat Martin,IND,550169,0,0,26,26,05
Oklahoma,U.S. House,Robert Murphy,IND,550169,0,0,24,24,05
Oklahoma,President,Barack Obama,DEM,550170,0,0,381,381,
Oklahoma,President,Mitt Romney,REP,550170,0,0,417,417,
Oklahoma,U.S. House,Tom Guild,DEM,550170,0,0,342,342,05
Oklahoma,U.S. House,James Lankford,REP,550170,0,0,399,399,05
Oklahoma,U.S. House,Pat Martin,IND,550170,0,0,27,27,05
Oklahoma,U.S. House,Robert Murphy,IND,550170,0,0,24,24,05
Oklahoma,President,Barack Obama,DEM,550171,0,0,481,481,
Oklahoma,President,Mitt Romney,REP,550171,0,0,515,515,
Oklahoma,U.S. House,Tom Guild,DEM,550171,0,0,426,426,05
Oklahoma,U.S. House,James Lankford,REP,550171,0,0,510,510,05
Oklahoma,U.S. House,Pat Martin,IND,550171,0,0,22,22,05
Oklahoma,U.S. House,Robert Murphy,IND,550171,0,0,32,32,05
Oklahoma,State House,Nick Singer,DEM,550171,0,0,472,472,87
Oklahoma,State House,Jason Nelson,REP,550171,0,0,495,495,87
Oklahoma,President,Barack Obama,DEM,550172,0,0,503,503,
Oklahoma,President,Mitt Romney,REP,550172,0,0,576,576,
Oklahoma,U.S. House,Tom Guild,DEM,550172,0,0,460,460,05
Oklahoma,U.S. House,James Lankford,REP,550172,0,0,557,557,05
Oklahoma,U.S. House,Pat Martin,IND,550172,0,0,29,29,05
Oklahoma,U.S. House,Robert Murphy,IND,550172,0,0,25,25,05
Oklahoma,State House,Nick Singer,DEM,550172,0,0,512,512,87
Oklahoma,State House,Jason Nelson,REP,550172,0,0,545,545,87
Oklahoma,President,Barack Obama,DEM,550173,0,0,529,529,
Oklahoma,President,Mitt Romney,REP,550173,0,0,734,734,
Oklahoma,U.S. House,Tom Guild,DEM,550173,0,0,479,479,05
Oklahoma,U.S. House,James Lankford,REP,550173,0,0,726,726,05
Oklahoma,U.S. House,Pat Martin,IND,550173,0,0,24,24,05
Oklahoma,U.S. House,Robert Murphy,IND,550173,0,0,24,24,05
Oklahoma,President,Barack Obama,DEM,550174,0,0,258,258,
Oklahoma,President,Mitt Romney,REP,550174,0,0,427,427,
Oklahoma,U.S. House,Tom Guild,DEM,550174,0,0,226,226,05
Oklahoma,U.S. House,James Lankford,REP,550174,0,0,427,427,05
Oklahoma,U.S. House,Pat Martin,IND,550174,0,0,15,15,05
Oklahoma,U.S. House,Robert Murphy,IND,550174,0,0,18,18,05
Oklahoma,President,Barack Obama,DEM,550175,0,0,155,155,
Oklahoma,President,Mitt Romney,REP,550175,0,0,200,200,
Oklahoma,U.S. House,Tom Guild,DEM,550175,0,0,126,126,05
Oklahoma,U.S. House,James Lankford,REP,550175,0,0,195,195,05
Oklahoma,U.S. House,Pat Martin,IND,550175,0,0,17,17,05
Oklahoma,U.S. House,Robert Murphy,IND,550175,0,0,17,17,05
Oklahoma,President,Barack Obama,DEM,550176,0,0,326,326,
Oklahoma,President,Mitt Romney,REP,550176,0,0,588,588,
Oklahoma,U.S. House,Tom Guild,DEM,550176,0,0,299,299,05
Oklahoma,U.S. House,James Lankford,REP,550176,0,0,570,570,05
Oklahoma,U.S. House,Pat Martin,IND,550176,0,0,15,15,05
Oklahoma,U.S. House,Robert Murphy,IND,550176,0,0,20,20,05
Oklahoma,State House,Nick Singer,DEM,550176,0,0,329,329,87
Oklahoma,State House,Jason Nelson,REP,550176,0,0,563,563,87
Oklahoma,President,Barack Obama,DEM,550177,0,0,422,422,
Oklahoma,President,Mitt Romney,REP,550177,0,0,706,706,
Oklahoma,U.S. House,Tom Guild,DEM,550177,0,0,382,382,05
Oklahoma,U.S. House,James Lankford,REP,550177,0,0,687,687,05
Oklahoma,U.S. House,Pat Martin,IND,550177,0,0,31,31,05
Oklahoma,U.S. House,Robert Murphy,IND,550177,0,0,17,17,05
Oklahoma,State House,Nick Singer,DEM,550177,0,0,406,406,87
Oklahoma,State House,Jason Nelson,REP,550177,0,0,695,695,87
Oklahoma,President,Barack Obama,DEM,550178,0,0,327,327,
Oklahoma,President,Mitt Romney,REP,550178,0,0,489,489,
Oklahoma,U.S. House,Tom Guild,DEM,550178,0,0,286,286,05
Oklahoma,U.S. House,James Lankford,REP,550178,0,0,480,480,05
Oklahoma,U.S. House,Pat Martin,IND,550178,0,0,28,28,05
Oklahoma,U.S. House,Robert Murphy,IND,550178,0,0,14,14,05
Oklahoma,State House,Nick Singer,DEM,550178,0,0,302,302,87
Oklahoma,State House,Jason Nelson,REP,550178,0,0,491,491,87
Oklahoma,President,Barack Obama,DEM,550179,0,0,426,426,
Oklahoma,President,Mitt Romney,REP,550179,0,0,659,659,
Oklahoma,U.S. House,Tom Guild,DEM,550179,0,0,387,387,05
Oklahoma,U.S. House,James Lankford,REP,550179,0,0,654,654,05
Oklahoma,U.S. House,Pat Martin,IND,550179,0,0,22,22,05
Oklahoma,U.S. House,Robert Murphy,IND,550179,0,0,16,16,05
Oklahoma,President,Barack Obama,DEM,550180,0,0,296,296,
Oklahoma,President,Mitt Romney,REP,550180,0,0,416,416,
Oklahoma,U.S. House,Tom Guild,DEM,550180,0,0,255,255,05
Oklahoma,U.S. House,James Lankford,REP,550180,0,0,407,407,05
Oklahoma,U.S. House,Pat Martin,IND,550180,0,0,23,23,05
Oklahoma,U.S. House,Robert Murphy,IND,550180,0,0,24,24,05
Oklahoma,President,Barack Obama,DEM,550181,0,0,240,240,
Oklahoma,President,Mitt Romney,REP,550181,0,0,311,311,
Oklahoma,U.S. House,Tom Guild,DEM,550181,0,0,203,203,05
Oklahoma,U.S. House,James Lankford,REP,550181,0,0,314,314,05
Oklahoma,U.S. House,Pat Martin,IND,550181,0,0,11,11,05
Oklahoma,U.S. House,Robert Murphy,IND,550181,0,0,19,19,05
Oklahoma,President,Barack Obama,DEM,550182,0,0,307,307,
Oklahoma,President,Mitt Romney,REP,550182,0,0,213,213,
Oklahoma,U.S. House,Tom Guild,DEM,550182,0,0,279,279,05
Oklahoma,U.S. House,James Lankford,REP,550182,0,0,206,206,05
Oklahoma,U.S. House,Pat Martin,IND,550182,0,0,15,15,05
Oklahoma,U.S. House,Robert Murphy,IND,550182,0,0,17,17,05
Oklahoma,State House,Nick Singer,DEM,550182,0,0,305,305,87
Oklahoma,State House,Jason Nelson,REP,550182,0,0,207,207,87
Oklahoma,President,Barack Obama,DEM,550183,0,0,420,420,
Oklahoma,President,Mitt Romney,REP,550183,0,0,520,520,
Oklahoma,U.S. House,Tom Guild,DEM,550183,0,0,372,372,05
Oklahoma,U.S. House,James Lankford,REP,550183,0,0,500,500,05
Oklahoma,U.S. House,Pat Martin,IND,550183,0,0,23,23,05
Oklahoma,U.S. House,Robert Murphy,IND,550183,0,0,32,32,05
Oklahoma,State House,Nick Singer,DEM,550183,0,0,430,430,87
Oklahoma,State House,Jason Nelson,REP,550183,0,0,480,480,87
Oklahoma,President,Barack Obama,DEM,550184,0,0,548,548,
Oklahoma,President,Mitt Romney,REP,550184,0,0,473,473,
Oklahoma,U.S. House,Tom Guild,DEM,550184,0,0,493,493,05
Oklahoma,U.S. House,James Lankford,REP,550184,0,0,461,461,05
Oklahoma,U.S. House,Pat Martin,IND,550184,0,0,37,37,05
Oklahoma,U.S. House,Robert Murphy,IND,550184,0,0,25,25,05
Oklahoma,State House,Nick Singer,DEM,550184,0,0,537,537,87
Oklahoma,State House,Jason Nelson,REP,550184,0,0,465,465,87
Oklahoma,President,Barack Obama,DEM,550185,0,0,200,200,
Oklahoma,President,Mitt Romney,REP,550185,0,0,176,176,
Oklahoma,U.S. House,Tom Guild,DEM,550185,0,0,186,186,05
Oklahoma,U.S. House,James Lankford,REP,550185,0,0,167,167,05
Oklahoma,U.S. House,Pat Martin,IND,550185,0,0,8,8,05
Oklahoma,U.S. House,Robert Murphy,IND,550185,0,0,11,11,05
Oklahoma,State House,Kay Floyd,DEM,550185,0,0,220,220,88
Oklahoma,State House,Aaron Kaspereit,REP,550185,0,0,145,145,88
Oklahoma,President,Barack Obama,DEM,550186,0,0,301,301,
Oklahoma,President,Mitt Romney,REP,550186,0,0,279,279,
Oklahoma,U.S. House,Tom Guild,DEM,550186,0,0,272,272,05
Oklahoma,U.S. House,James Lankford,REP,550186,0,0,272,272,05
Oklahoma,U.S. House,Pat Martin,IND,550186,0,0,19,19,05
Oklahoma,U.S. House,Robert Murphy,IND,550186,0,0,12,12,05
Oklahoma,State House,Kay Floyd,DEM,550186,0,0,339,339,88
Oklahoma,State House,Aaron Kaspereit,REP,550186,0,0,228,228,88
Oklahoma,President,Barack Obama,DEM,550187,0,0,67,67,
Oklahoma,President,Mitt Romney,REP,550187,0,0,59,59,
Oklahoma,U.S. House,Tom Guild,DEM,550187,0,0,53,53,05
Oklahoma,U.S. House,James Lankford,REP,550187,0,0,58,58,05
Oklahoma,U.S. House,Pat Martin,IND,550187,0,0,5,5,05
Oklahoma,U.S. House,Robert Murphy,IND,550187,0,0,6,6,05
Oklahoma,President,Barack Obama,DEM,550188,0,0,3,3,
Oklahoma,President,Mitt Romney,REP,550188,0,0,0,0,
Oklahoma,U.S. House,Tom Guild,DEM,550188,0,0,3,3,05
Oklahoma,U.S. House,James Lankford,REP,550188,0,0,0,0,05
Oklahoma,U.S. House,Pat Martin,IND,550188,0,0,0,0,05
Oklahoma,U.S. House,Robert Murphy,IND,550188,0,0,0,0,05
Oklahoma,President,Barack Obama,DEM,550189,0,0,100,100,
Oklahoma,President,Mitt Romney,REP,550189,0,0,68,68,
Oklahoma,U.S. House,Tom Guild,DEM,550189,0,0,77,77,05
Oklahoma,U.S. House,James Lankford,REP,550189,0,0,71,71,05
Oklahoma,U.S. House,Pat Martin,IND,550189,0,0,9,9,05
Oklahoma,U.S. House,Robert Murphy,IND,550189,0,0,8,8,05
Oklahoma,President,Barack Obama,DEM,550190,0,0,283,283,
Oklahoma,President,Mitt Romney,REP,550190,0,0,99,99,
Oklahoma,U.S. House,Tom Guild,DEM,550190,0,0,255,255,05
Oklahoma,U.S. House,James Lankford,REP,550190,0,0,96,96,05
Oklahoma,U.S. House,Pat Martin,IND,550190,0,0,11,11,05
Oklahoma,U.S. House,Robert Murphy,IND,550190,0,0,15,15,05
Oklahoma,President,Barack Obama,DEM,550191,0,0,395,395,
Oklahoma,President,Mitt Romney,REP,550191,0,0,227,227,
Oklahoma,U.S. House,Tom Guild,DEM,550191,0,0,363,363,05
Oklahoma,U.S. House,James Lankford,REP,550191,0,0,209,209,05
Oklahoma,U.S. House,Pat Martin,IND,550191,0,0,18,18,05
Oklahoma,U.S. House,Robert Murphy,IND,550191,0,0,30,30,05
Oklahoma,State House,Kay Floyd,DEM,550191,0,0,442,442,88
Oklahoma,State House,Aaron Kaspereit,REP,550191,0,0,172,172,88
Oklahoma,President,Barack Obama,DEM,550192,0,0,684,684,
Oklahoma,President,Mitt Romney,REP,550192,0,0,504,504,
Oklahoma,U.S. House,Tom Guild,DEM,550192,0,0,626,626,05
Oklahoma,U.S. House,James Lankford,REP,550192,0,0,499,499,05
Oklahoma,U.S. House,Pat Martin,IND,550192,0,0,28,28,05
Oklahoma,U.S. House,Robert Murphy,IND,550192,0,0,30,30,05
Oklahoma,State House,Kay Floyd,DEM,550192,0,0,755,755,88
Oklahoma,State House,Aaron Kaspereit,REP,550192,0,0,404,404,88
Oklahoma,President,Barack Obama,DEM,550193,0,0,507,507,
Oklahoma,President,Mitt Romney,REP,550193,0,0,329,329,
Oklahoma,U.S. House,Tom Guild,DEM,550193,0,0,455,455,05
Oklahoma,U.S. House,James Lankford,REP,550193,0,0,323,323,05
Oklahoma,U.S. House,Pat Martin,IND,550193,0,0,26,26,05
Oklahoma,U.S. House,Robert Murphy,IND,550193,0,0,25,25,05
Oklahoma,State House,Kay Floyd,DEM,550193,0,0,568,568,88
Oklahoma,State House,Aaron Kaspereit,REP,550193,0,0,248,248,88
Oklahoma,President,Barack Obama,DEM,550194,0,0,449,449,
Oklahoma,President,Mitt Romney,REP,550194,0,0,272,272,
Oklahoma,U.S. House,Tom Guild,DEM,550194,0,0,415,415,05
Oklahoma,U.S. House,James Lankford,REP,550194,0,0,267,267,05
Oklahoma,U.S. House,Pat Martin,IND,550194,0,0,18,18,05
Oklahoma,U.S. House,Robert Murphy,IND,550194,0,0,16,16,05
Oklahoma,State House,Kay Floyd,DEM,550194,0,0,492,492,88
Oklahoma,State House,Aaron Kaspereit,REP,550194,0,0,216,216,88
Oklahoma,President,Barack Obama,DEM,550195,0,0,673,673,
Oklahoma,President,Mitt Romney,REP,550195,0,0,693,693,
Oklahoma,U.S. House,Tom Guild,DEM,550195,0,0,587,587,05
Oklahoma,U.S. House,James Lankford,REP,550195,0,0,665,665,05
Oklahoma,U.S. House,Pat Martin,IND,550195,0,0,45,45,05
Oklahoma,U.S. House,Robert Murphy,IND,550195,0,0,47,47,05
Oklahoma,State House,Nick Singer,DEM,550195,0,0,663,663,87
Oklahoma,State House,Jason Nelson,REP,550195,0,0,658,658,87
Oklahoma,President,Barack Obama,DEM,550196,0,0,631,631,
Oklahoma,President,Mitt Romney,REP,550196,0,0,999,999,
Oklahoma,U.S. House,Tom Guild,DEM,550196,0,0,581,581,05
Oklahoma,U.S. House,James Lankford,REP,550196,0,0,977,977,05
Oklahoma,U.S. House,Pat Martin,IND,550196,0,0,34,34,05
Oklahoma,U.S. House,Robert Murphy,IND,550196,0,0,20,20,05
Oklahoma,President,Barack Obama,DEM,550197,0,0,538,538,
Oklahoma,President,Mitt Romney,REP,550197,0,0,331,331,
Oklahoma,U.S. House,Tom Guild,DEM,550197,0,0,483,483,05
Oklahoma,U.S. House,James Lankford,REP,550197,0,0,316,316,05
Oklahoma,U.S. House,Pat Martin,IND,550197,0,0,26,26,05
Oklahoma,U.S. House,Robert Murphy,IND,550197,0,0,33,33,05
Oklahoma,State House,Kay Floyd,DEM,550197,0,0,592,592,88
Oklahoma,State House,Aaron Kaspereit,REP,550197,0,0,246,246,88
Oklahoma,President,Barack Obama,DEM,550198,0,0,469,469,
Oklahoma,President,Mitt Romney,REP,550198,0,0,322,322,
Oklahoma,U.S. House,Tom Guild,DEM,550198,0,0,430,430,05
Oklahoma,U.S. House,James Lankford,REP,550198,0,0,311,311,05
Oklahoma,U.S. House,Pat Martin,IND,550198,0,0,20,20,05
Oklahoma,U.S. House,Robert Murphy,IND,550198,0,0,27,27,05
Oklahoma,President,Barack Obama,DEM,550199,0,0,396,396,
Oklahoma,President,Mitt Romney,REP,550199,0,0,356,356,
Oklahoma,U.S. House,Tom Guild,DEM,550199,0,0,364,364,05
Oklahoma,U.S. House,James Lankford,REP,550199,0,0,349,349,05
Oklahoma,U.S. House,Pat Martin,IND,550199,0,0,16,16,05
Oklahoma,U.S. House,Robert Murphy,IND,550199,0,0,13,13,05
Oklahoma,President,Barack Obama,DEM,550200,0,0,946,946,
Oklahoma,President,Mitt Romney,REP,550200,0,0,447,447,
Oklahoma,U.S. House,Tom Guild,DEM,550200,0,0,837,837,05
Oklahoma,U.S. House,James Lankford,REP,550200,0,0,448,448,05
Oklahoma,U.S. House,Pat Martin,IND,550200,0,0,47,47,05
Oklahoma,U.S. House,Robert Murphy,IND,550200,0,0,55,55,05
Oklahoma,State House,Kay Floyd,DEM,550200,0,0,1007,1007,88
Oklahoma,State House,Aaron Kaspereit,REP,550200,0,0,356,356,88
Oklahoma,President,Barack Obama,DEM,550201,0,0,508,508,
Oklahoma,President,Mitt Romney,REP,550201,0,0,252,252,
Oklahoma,U.S. House,Tom Guild,DEM,550201,0,0,450,450,05
Oklahoma,U.S. House,James Lankford,REP,550201,0,0,244,244,05
Oklahoma,U.S. House,Pat Martin,IND,550201,0,0,38,38,05
Oklahoma,U.S. House,Robert Murphy,IND,550201,0,0,23,23,05
Oklahoma,State House,Kay Floyd,DEM,550201,0,0,548,548,88
Oklahoma,State House,Aaron Kaspereit,REP,550201,0,0,205,205,88
Oklahoma,President,Barack Obama,DEM,550202,0,0,341,341,
Oklahoma,President,Mitt Romney,REP,550202,0,0,251,251,
Oklahoma,U.S. House,Tom Guild,DEM,550202,0,0,320,320,05
Oklahoma,U.S. House,James Lankford,REP,550202,0,0,243,243,05
Oklahoma,U.S. House,Pat Martin,IND,550202,0,0,11,11,05
Oklahoma,U.S. House,Robert Murphy,IND,550202,0,0,16,16,05
Oklahoma,State House,Kay Floyd,DEM,550202,0,0,381,381,88
Oklahoma,State House,Aaron Kaspereit,REP,550202,0,0,198,198,88
Oklahoma,President,Barack Obama,DEM,550203,0,0,441,441,
Oklahoma,President,Mitt Romney,REP,550203,0,0,234,234,
Oklahoma,U.S. House,Tom Guild,DEM,550203,0,0,397,397,05
Oklahoma,U.S. House,James Lankford,REP,550203,0,0,229,229,05
Oklahoma,U.S. House,Pat Martin,IND,550203,0,0,21,21,05
Oklahoma,U.S. House,Robert Murphy,IND,550203,0,0,20,20,05
Oklahoma,State House,Kay Floyd,DEM,550203,0,0,469,469,88
Oklahoma,State House,Aaron Kaspereit,REP,550203,0,0,186,186,88
Oklahoma,President,Barack Obama,DEM,550204,0,0,833,833,
Oklahoma,President,Mitt Romney,REP,550204,0,0,620,620,
Oklahoma,U.S. House,Tom Guild,DEM,550204,0,0,748,748,05
Oklahoma,U.S. House,James Lankford,REP,550204,0,0,629,629,05
Oklahoma,U.S. House,Pat Martin,IND,550204,0,0,30,30,05
Oklahoma,U.S. House,Robert Murphy,IND,550204,0,0,31,31,05
Oklahoma,State House,Kay Floyd,DEM,550204,0,0,973,973,88
Oklahoma,State House,Aaron Kaspereit,REP,550204,0,0,440,440,88
Oklahoma,President,Barack Obama,DEM,550205,0,0,279,279,
Oklahoma,President,Mitt Romney,REP,550205,0,0,259,259,
Oklahoma,U.S. House,Tom Guild,DEM,550205,0,0,245,245,05
Oklahoma,U.S. House,James Lankford,REP,550205,0,0,238,238,05
Oklahoma,U.S. House,Pat Martin,IND,550205,0,0,28,28,05
Oklahoma,U.S. House,Robert Murphy,IND,550205,0,0,20,20,05
Oklahoma,President,Barack Obama,DEM,550206,0,0,188,188,
Oklahoma,President,Mitt Romney,REP,550206,0,0,81,81,
Oklahoma,U.S. House,Tom Guild,DEM,550206,0,0,161,161,05
Oklahoma,U.S. House,James Lankford,REP,550206,0,0,75,75,05
Oklahoma,U.S. House,Pat Martin,IND,550206,0,0,13,13,05
Oklahoma,U.S. House,Robert Murphy,IND,550206,0,0,13,13,05
Oklahoma,President,Barack Obama,DEM,550207,0,0,490,490,
Oklahoma,President,Mitt Romney,REP,550207,0,0,322,322,
Oklahoma,U.S. House,Tom Guild,DEM,550207,0,0,428,428,05
Oklahoma,U.S. House,James Lankford,REP,550207,0,0,321,321,05
Oklahoma,U.S. House,Pat Martin,IND,550207,0,0,21,21,05
Oklahoma,U.S. House,Robert Murphy,IND,550207,0,0,28,28,05
Oklahoma,President,Barack Obama,DEM,550208,0,0,8,8,
Oklahoma,President,Mitt Romney,REP,550208,0,0,8,8,
Oklahoma,U.S. House,Tom Guild,DEM,550208,0,0,8,8,05
Oklahoma,U.S. House,James Lankford,REP,550208,0,0,6,6,05
Oklahoma,U.S. House,Pat Martin,IND,550208,0,0,3,3,05
Oklahoma,U.S. House,Robert Murphy,IND,550208,0,0,0,0,05
Oklahoma,President,Barack Obama,DEM,550209,0,0,410,410,
Oklahoma,President,Mitt Romney,REP,550209,0,0,272,272,
Oklahoma,U.S. House,Tom Guild,DEM,550209,0,0,385,385,05
Oklahoma,U.S. House,James Lankford,REP,550209,0,0,242,242,05
Oklahoma,U.S. House,Pat Martin,IND,550209,0,0,16,16,05
Oklahoma,U.S. House,Robert Murphy,IND,550209,0,0,30,30,05
Oklahoma,President,Barack Obama,DEM,550210,0,0,332,332,
Oklahoma,President,Mitt Romney,REP,550210,0,0,289,289,
Oklahoma,U.S. House,Tom Guild,DEM,550210,0,0,299,299,05
Oklahoma,U.S. House,James Lankford,REP,550210,0,0,275,275,05
Oklahoma,U.S. House,Pat Martin,IND,550210,0,0,16,16,05
Oklahoma,U.S. House,Robert Murphy,IND,550210,0,0,24,24,05
Oklahoma,President,Barack Obama,DEM,550211,0,0,301,301,
Oklahoma,President,Mitt Romney,REP,550211,0,0,207,207,
Oklahoma,U.S. House,Tom Guild,DEM,550211,0,0,291,291,05
Oklahoma,U.S. House,James Lankford,REP,550211,0,0,176,176,05
Oklahoma,U.S. House,Pat Martin,IND,550211,0,0,18,18,05
Oklahoma,U.S. House,Robert Murphy,IND,550211,0,0,18,18,05
Oklahoma,President,Barack Obama,DEM,550212,0,0,272,272,
Oklahoma,President,Mitt Romney,REP,550212,0,0,209,209,
Oklahoma,U.S. House,Tom Guild,DEM,550212,0,0,250,250,05
Oklahoma,U.S. House,James Lankford,REP,550212,0,0,202,202,05
Oklahoma,U.S. House,Pat Martin,IND,550212,0,0,12,12,05
Oklahoma,U.S. House,Robert Murphy,IND,550212,0,0,12,12,05
Oklahoma,President,Barack Obama,DEM,550213,0,0,156,156,
Oklahoma,President,Mitt Romney,REP,550213,0,0,112,112,
Oklahoma,U.S. House,Tom Guild,DEM,550213,0,0,141,141,05
Oklahoma,U.S. House,James Lankford,REP,550213,0,0,108,108,05
Oklahoma,U.S. House,Pat Martin,IND,550213,0,0,8,8,05
Oklahoma,U.S. House,Robert Murphy,IND,550213,0,0,11,11,05
Oklahoma,President,Barack Obama,DEM,550214,0,0,156,156,
Oklahoma,President,Mitt Romney,REP,550214,0,0,235,235,
Oklahoma,U.S. House,Tom Guild,DEM,550214,0,0,149,149,05
Oklahoma,U.S. House,James Lankford,REP,550214,0,0,221,221,05
Oklahoma,U.S. House,Pat Martin,IND,550214,0,0,14,14,05
Oklahoma,U.S. House,Robert Murphy,IND,550214,0,0,8,8,05
Oklahoma,President,Barack Obama,DEM,550215,0,0,329,329,
Oklahoma,President,Mitt Romney,REP,550215,0,0,287,287,
Oklahoma,U.S. House,Tom Guild,DEM,550215,0,0,299,299,05
Oklahoma,U.S. House,James Lankford,REP,550215,0,0,268,268,05
Oklahoma,U.S. House,Pat Martin,IND,550215,0,0,19,19,05
Oklahoma,U.S. House,Robert Murphy,IND,550215,0,0,22,22,05
Oklahoma,President,Barack Obama,DEM,550216,0,0,11,11,
Oklahoma,President,Mitt Romney,REP,550216,0,0,4,4,
Oklahoma,U.S. House,Tom Guild,DEM,550216,0,0,9,9,05
Oklahoma,U.S. House,James Lankford,REP,550216,0,0,5,5,05
Oklahoma,U.S. House,Pat Martin,IND,550216,0,0,0,0,05
Oklahoma,U.S. House,Robert Murphy,IND,550216,0,0,0,0,05
Oklahoma,President,Barack Obama,DEM,550217,0,0,322,322,
Oklahoma,President,Mitt Romney,REP,550217,0,0,388,388,
Oklahoma,U.S. House,Tom Guild,DEM,550217,0,0,293,293,05
Oklahoma,U.S. House,James Lankford,REP,550217,0,0,355,355,05
Oklahoma,U.S. House,Pat Martin,IND,550217,0,0,35,35,05
Oklahoma,U.S. House,Robert Murphy,IND,550217,0,0,26,26,05
Oklahoma,President,Barack Obama,DEM,550218,0,0,416,416,
Oklahoma,President,Mitt Romney,REP,550218,0,0,598,598,
Oklahoma,U.S. House,Tom Guild,DEM,550218,0,0,377,377,05
Oklahoma,U.S. House,James Lankford,REP,550218,0,0,576,576,05
Oklahoma,U.S. House,Pat Martin,IND,550218,0,0,29,29,05
Oklahoma,U.S. House,Robert Murphy,IND,550218,0,0,25,25,05
Oklahoma,President,Barack Obama,DEM,550219,0,0,237,237,
Oklahoma,President,Mitt Romney,REP,550219,0,0,276,276,
Oklahoma,U.S. House,Tom Guild,DEM,550219,0,0,234,234,05
Oklahoma,U.S. House,James Lankford,REP,550219,0,0,244,244,05
Oklahoma,U.S. House,Pat Martin,IND,550219,0,0,12,12,05
Oklahoma,U.S. House,Robert Murphy,IND,550219,0,0,16,16,05
Oklahoma,President,Barack Obama,DEM,550220,0,0,425,425,
Oklahoma,President,Mitt Romney,REP,550220,0,0,547,547,
Oklahoma,U.S. House,Tom Guild,DEM,550220,0,0,386,386,05
Oklahoma,U.S. House,James Lankford,REP,550220,0,0,529,529,05
Oklahoma,U.S. House,Pat Martin,IND,550220,0,0,22,22,05
Oklahoma,U.S. House,Robert Murphy,IND,550220,0,0,30,30,05
Oklahoma,President,Barack Obama,DEM,550221,0,0,406,406,
Oklahoma,President,Mitt Romney,REP,550221,0,0,589,589,
Oklahoma,U.S. House,Tom Guild,DEM,550221,0,0,388,388,05
Oklahoma,U.S. House,James Lankford,REP,550221,0,0,554,554,05
Oklahoma,U.S. House,Pat Martin,IND,550221,0,0,22,22,05
Oklahoma,U.S. House,Robert Murphy,IND,550221,0,0,19,19,05
Oklahoma,President,Barack Obama,DEM,550222,0,0,289,289,
Oklahoma,President,Mitt Romney,REP,550222,0,0,364,364,
Oklahoma,U.S. House,Tom Guild,DEM,550222,0,0,247,247,05
Oklahoma,U.S. House,James Lankford,REP,550222,0,0,355,355,05
Oklahoma,U.S. House,Pat Martin,IND,550222,0,0,18,18,05
Oklahoma,U.S. House,Robert Murphy,IND,550222,0,0,26,26,05
Oklahoma,President,Barack Obama,DEM,550223,0,0,314,314,
Oklahoma,President,Mitt Romney,REP,550223,0,0,250,250,
Oklahoma,U.S. House,Tom Guild,DEM,550223,0,0,275,275,05
Oklahoma,U.S. House,James Lankford,REP,550223,0,0,247,247,05
Oklahoma,U.S. House,Pat Martin,IND,550223,0,0,16,16,05
Oklahoma,U.S. House,Robert Murphy,IND,550223,0,0,17,17,05
Oklahoma,President,Barack Obama,DEM,550224,0,0,309,309,
Oklahoma,President,Mitt Romney,REP,550224,0,0,363,363,
Oklahoma,U.S. House,Tom Guild,DEM,550224,0,0,278,278,05
Oklahoma,U.S. House,James Lankford,REP,550224,0,0,335,335,05
Oklahoma,U.S. House,Pat Martin,IND,550224,0,0,27,27,05
Oklahoma,U.S. House,Robert Murphy,IND,550224,0,0,28,28,05
Oklahoma,President,Barack Obama,DEM,550225,0,0,73,73,
Oklahoma,President,Mitt Romney,REP,550225,0,0,62,62,
Oklahoma,U.S. House,Tom Guild,DEM,550225,0,0,71,71,05
Oklahoma,U.S. House,James Lankford,REP,550225,0,0,54,54,05
Oklahoma,U.S. House,Pat Martin,IND,550225,0,0,3,3,05
Oklahoma,U.S. House,Robert Murphy,IND,550225,0,0,2,2,05
Oklahoma,President,Barack Obama,DEM,550226,0,0,332,332,
Oklahoma,President,Mitt Romney,REP,550226,0,0,365,365,
Oklahoma,U.S. House,Tom Guild,DEM,550226,0,0,310,310,05
Oklahoma,U.S. House,James Lankford,REP,550226,0,0,332,332,05
Oklahoma,U.S. House,Pat Martin,IND,550226,0,0,23,23,05
Oklahoma,U.S. House,Robert Murphy,IND,550226,0,0,22,22,05
Oklahoma,President,Barack Obama,DEM,550227,0,0,242,242,
Oklahoma,President,Mitt Romney,REP,550227,0,0,298,298,
Oklahoma,U.S. House,Tom Guild,DEM,550227,0,0,212,212,05
Oklahoma,U.S. House,James Lankford,REP,550227,0,0,285,285,05
Oklahoma,U.S. House,Pat Martin,IND,550227,0,0,12,12,05
Oklahoma,U.S. House,Robert Murphy,IND,550227,0,0,23,23,05
Oklahoma,President,Barack Obama,DEM,550228,0,0,291,291,
Oklahoma,President,Mitt Romney,REP,550228,0,0,362,362,
Oklahoma,U.S. House,Tom Guild,DEM,550228,0,0,262,262,05
Oklahoma,U.S. House,James Lankford,REP,550228,0,0,333,333,05
Oklahoma,U.S. House,Pat Martin,IND,550228,0,0,20,20,05
Oklahoma,U.S. House,Robert Murphy,IND,550228,0,0,24,24,05
Oklahoma,President,Barack Obama,DEM,550229,0,0,337,337,
Oklahoma,President,Mitt Romney,REP,550229,0,0,586,586,
Oklahoma,U.S. House,Tom Guild,DEM,550229,0,0,307,307,05
Oklahoma,U.S. House,James Lankford,REP,550229,0,0,573,573,05
Oklahoma,U.S. House,Pat Martin,IND,550229,0,0,19,19,05
Oklahoma,U.S. House,Robert Murphy,IND,550229,0,0,21,21,05
Oklahoma,President,Barack Obama,DEM,550230,0,0,319,319,
Oklahoma,President,Mitt Romney,REP,550230,0,0,629,629,
Oklahoma,U.S. House,Tom Guild,DEM,550230,0,0,299,299,05
Oklahoma,U.S. House,James Lankford,REP,550230,0,0,588,588,05
Oklahoma,U.S. House,Pat Martin,IND,550230,0,0,27,27,05
Oklahoma,U.S. House,Robert Murphy,IND,550230,0,0,17,17,05
Oklahoma,President,Barack Obama,DEM,550231,0,0,286,286,
Oklahoma,President,Mitt Romney,REP,550231,0,0,402,402,
Oklahoma,U.S. House,Tom Guild,DEM,550231,0,0,251,251,05
Oklahoma,U.S. House,James Lankford,REP,550231,0,0,394,394,05
Oklahoma,U.S. House,Pat Martin,IND,550231,0,0,15,15,05
Oklahoma,U.S. House,Robert Murphy,IND,550231,0,0,22,22,05
Oklahoma,President,Barack Obama,DEM,550232,0,0,292,292,
Oklahoma,President,Mitt Romney,REP,550232,0,0,527,527,
Oklahoma,U.S. House,Tom Guild,DEM,550232,0,0,270,270,05
Oklahoma,U.S. House,James Lankford,REP,550232,0,0,505,505,05
Oklahoma,U.S. House,Pat Martin,IND,550232,0,0,18,18,05
Oklahoma,U.S. House,Robert Murphy,IND,550232,0,0,15,15,05
Oklahoma,President,Barack Obama,DEM,550233,0,0,125,125,
Oklahoma,President,Mitt Romney,REP,550233,0,0,164,164,
Oklahoma,U.S. House,Tom Guild,DEM,550233,0,0,119,119,05
Oklahoma,U.S. House,James Lankford,REP,550233,0,0,145,145,05
Oklahoma,U.S. House,Pat Martin,IND,550233,0,0,9,9,05
Oklahoma,U.S. House,Robert Murphy,IND,550233,0,0,15,15,05
Oklahoma,President,Barack Obama,DEM,550234,0,0,347,347,
Oklahoma,President,Mitt Romney,REP,550234,0,0,350,350,
Oklahoma,U.S. House,Tom Guild,DEM,550234,0,0,316,316,05
Oklahoma,U.S. House,James Lankford,REP,550234,0,0,321,321,05
Oklahoma,U.S. House,Pat Martin,IND,550234,0,0,29,29,05
Oklahoma,U.S. House,Robert Murphy,IND,550234,0,0,23,23,05
Oklahoma,President,Barack Obama,DEM,550235,0,0,351,351,
Oklahoma,President,Mitt Romney,REP,550235,0,0,196,196,
Oklahoma,U.S. House,Tom Guild,DEM,550235,0,0,331,331,05
Oklahoma,U.S. House,James Lankford,REP,550235,0,0,181,181,05
Oklahoma,U.S. House,Pat Martin,IND,550235,0,0,14,14,05
Oklahoma,U.S. House,Robert Murphy,IND,550235,0,0,20,20,05
Oklahoma,President,Barack Obama,DEM,550236,0,0,0,0,
Oklahoma,President,Mitt Romney,REP,550236,0,0,0,0,
Oklahoma,U.S. House,Tom Guild,DEM,550236,0,0,0,0,05
Oklahoma,U.S. House,James Lankford,REP,550236,0,0,0,0,05
Oklahoma,U.S. House,Pat Martin,IND,550236,0,0,0,0,05
Oklahoma,U.S. House,Robert Murphy,IND,550236,0,0,0,0,05
Oklahoma,State House,Anastasia Pittman,DEM,550236,0,0,0,0,99
Oklahoma,State House,Willard Linzy,REP,550236,0,0,0,0,99
Oklahoma,President,Barack Obama,DEM,550237,0,0,4,4,
Oklahoma,President,Mitt Romney,REP,550237,0,0,0,0,
Oklahoma,U.S. House,Tom Guild,DEM,550237,0,0,4,4,05
Oklahoma,U.S. House,James Lankford,REP,550237,0,0,0,0,05
Oklahoma,U.S. House,Pat Martin,IND,550237,0,0,0,0,05
Oklahoma,U.S. House,Robert Murphy,IND,550237,0,0,0,0,05
Oklahoma,State House,Anastasia Pittman,DEM,550237,0,0,4,4,99
Oklahoma,State House,Willard Linzy,REP,550237,0,0,0,0,99
Oklahoma,President,Barack Obama,DEM,550238,0,0,0,0,
Oklahoma,President,Mitt Romney,REP,550238,0,0,0,0,
Oklahoma,U.S. House,Tom Guild,DEM,550238,0,0,0,0,05
Oklahoma,U.S. House,James Lankford,REP,550238,0,0,0,0,05
Oklahoma,U.S. House,Pat Martin,IND,550238,0,0,0,0,05
Oklahoma,U.S. House,Robert Murphy,IND,550238,0,0,0,0,05
Oklahoma,State House,Anastasia Pittman,DEM,550238,0,0,0,0,99
Oklahoma,State House,Willard Linzy,REP,550238,0,0,0,0,99
Oklahoma,President,Barack Obama,DEM,550239,0,0,496,496,
Oklahoma,President,Mitt Romney,REP,550239,0,0,133,133,
Oklahoma,U.S. House,Tom Guild,DEM,550239,0,0,459,459,05
Oklahoma,U.S. House,James Lankford,REP,550239,0,0,133,133,05
Oklahoma,U.S. House,Pat Martin,IND,550239,0,0,18,18,05
Oklahoma,U.S. House,Robert Murphy,IND,550239,0,0,13,13,05
Oklahoma,State House,Anastasia Pittman,DEM,550239,0,0,485,485,99
Oklahoma,State House,Willard Linzy,REP,550239,0,0,135,135,99
Oklahoma,President,Barack Obama,DEM,550240,0,0,829,829,
Oklahoma,President,Mitt Romney,REP,550240,0,0,26,26,
Oklahoma,U.S. House,Tom Guild,DEM,550240,0,0,779,779,05
Oklahoma,U.S. House,James Lankford,REP,550240,0,0,40,40,05
Oklahoma,U.S. House,Pat Martin,IND,550240,0,0,13,13,05
Oklahoma,U.S. House,Robert Murphy,IND,550240,0,0,10,10,05
Oklahoma,State House,Anastasia Pittman,DEM,550240,0,0,818,818,99
Oklahoma,State House,Willard Linzy,REP,550240,0,0,35,35,99
Oklahoma,President,Barack Obama,DEM,550241,0,0,522,522,
Oklahoma,President,Mitt Romney,REP,550241,0,0,86,86,
Oklahoma,U.S. House,Tom Guild,DEM,550241,0,0,487,487,05
Oklahoma,U.S. House,James Lankford,REP,550241,0,0,93,93,05
Oklahoma,U.S. House,Pat Martin,IND,550241,0,0,9,9,05
Oklahoma,U.S. House,Robert Murphy,IND,550241,0,0,8,8,05
Oklahoma,State House,Anastasia Pittman,DEM,550241,0,0,544,544,99
Oklahoma,State House,Willard Linzy,REP,550241,0,0,61,61,99
Oklahoma,President,Barack Obama,DEM,550242,0,0,542,542,
Oklahoma,President,Mitt Romney,REP,550242,0,0,11,11,
Oklahoma,U.S. House,Tom Guild,DEM,550242,0,0,509,509,05
Oklahoma,U.S. House,James Lankford,REP,550242,0,0,27,27,05
Oklahoma,U.S. House,Pat Martin,IND,550242,0,0,5,5,05
Oklahoma,U.S. House,Robert Murphy,IND,550242,0,0,4,4,05
Oklahoma,President,Barack Obama,DEM,550243,0,0,864,864,
Oklahoma,President,Mitt Romney,REP,550243,0,0,19,19,
Oklahoma,U.S. House,Tom Guild,DEM,550243,0,0,807,807,05
Oklahoma,U.S. House,James Lankford,REP,550243,0,0,39,39,05
Oklahoma,U.S. House,Pat Martin,IND,550243,0,0,14,14,05
Oklahoma,U.S. House,Robert Murphy,IND,550243,0,0,16,16,05
Oklahoma,President,Barack Obama,DEM,550244,0,0,807,807,
Oklahoma,President,Mitt Romney,REP,550244,0,0,13,13,
Oklahoma,U.S. House,Tom Guild,DEM,550244,0,0,765,765,05
Oklahoma,U.S. House,James Lankford,REP,550244,0,0,30,30,05
Oklahoma,U.S. House,Pat Martin,IND,550244,0,0,14,14,05
Oklahoma,U.S. House,Robert Murphy,IND,550244,0,0,4,4,05
Oklahoma,State House,Anastasia Pittman,DEM,550244,0,0,788,788,99
Oklahoma,State House,Willard Linzy,REP,550244,0,0,31,31,99
Oklahoma,President,Barack Obama,DEM,550245,0,0,895,895,
Oklahoma,President,Mitt Romney,REP,550245,0,0,4,4,
Oklahoma,U.S. House,Tom Guild,DEM,550245,0,0,833,833,05
Oklahoma,U.S. House,James Lankford,REP,550245,0,0,25,25,05
Oklahoma,U.S. House,Pat Martin,IND,550245,0,0,13,13,05
Oklahoma,U.S. House,Robert Murphy,IND,550245,0,0,17,17,05
Oklahoma,State House,Anastasia Pittman,DEM,550245,0,0,867,867,99
Oklahoma,State House,Willard Linzy,REP,550245,0,0,27,27,99
Oklahoma,President,Barack Obama,DEM,550246,0,0,110,110,
Oklahoma,President,Mitt Romney,REP,550246,0,0,124,124,
Oklahoma,U.S. House,Tom Guild,DEM,550246,0,0,97,97,05
Oklahoma,U.S. House,James Lankford,REP,550246,0,0,122,122,05
Oklahoma,U.S. House,Pat Martin,IND,550246,0,0,5,5,05
Oklahoma,U.S. House,Robert Murphy,IND,550246,0,0,8,8,05
Oklahoma,President,Barack Obama,DEM,550247,0,0,458,458,
Oklahoma,President,Mitt Romney,REP,550247,0,0,218,218,
Oklahoma,U.S. House,Tom Guild,DEM,550247,0,0,425,425,05
Oklahoma,U.S. House,James Lankford,REP,550247,0,0,196,196,05
Oklahoma,U.S. House,Pat Martin,IND,550247,0,0,20,20,05
Oklahoma,U.S. House,Robert Murphy,IND,550247,0,0,25,25,05
Oklahoma,President,Barack Obama,DEM,550248,0,0,1022,1022,
Oklahoma,President,Mitt Romney,REP,550248,0,0,488,488,
Oklahoma,U.S. House,Tom Guild,DEM,550248,0,0,960,960,05
Oklahoma,U.S. House,James Lankford,REP,550248,0,0,483,483,05
Oklahoma,U.S. House,Pat Martin,IND,550248,0,0,30,30,05
Oklahoma,U.S. House,Robert Murphy,IND,550248,0,0,29,29,05
Oklahoma,President,Barack Obama,DEM,550249,0,0,785,785,
Oklahoma,President,Mitt Romney,REP,550249,0,0,772,772,
Oklahoma,U.S. House,Tom Guild,DEM,550249,0,0,735,735,05
Oklahoma,U.S. House,James Lankford,REP,550249,0,0,771,771,05
Oklahoma,U.S. House,Pat Martin,IND,550249,0,0,20,20,05
Oklahoma,U.S. House,Robert Murphy,IND,550249,0,0,20,20,05
Oklahoma,State Senate,Claudia Griffith,DEM,550249,0,0,780,780,15
Oklahoma,State Senate,Rob Standridge,REP,550249,0,0,753,753,15
Oklahoma,President,Barack Obama,DEM,550250,0,0,435,435,
Oklahoma,President,Mitt Romney,REP,550250,0,0,585,585,
Oklahoma,U.S. House,Tom Guild,DEM,550250,0,0,402,402,05
Oklahoma,U.S. House,James Lankford,REP,550250,0,0,563,563,05
Oklahoma,U.S. House,Pat Martin,IND,550250,0,0,21,21,05
Oklahoma,U.S. House,Robert Murphy,IND,550250,0,0,32,32,05
Oklahoma,State Senate,Claudia Griffith,DEM,550250,0,0,439,439,15
Oklahoma,State Senate,Rob Standridge,REP,550250,0,0,572,572,15
Oklahoma,President,Barack Obama,DEM,550251,0,0,702,702,
Oklahoma,President,Mitt Romney,REP,550251,0,0,763,763,
Oklahoma,U.S. House,Donna Marie Bebo,DEM,550251,0,0,605,605,04
Oklahoma,U.S. House,Tom Cole,REP,550251,0,0,787,787,04
Oklahoma,U.S. House,Rj Harris,IND,550251,0,0,60,60,04
Oklahoma,President,Barack Obama,DEM,550252,0,0,351,351,
Oklahoma,President,Mitt Romney,REP,550252,0,0,1083,1083,
Oklahoma,U.S. House,Donna Marie Bebo,DEM,550252,0,0,281,281,04
Oklahoma,U.S. House,Tom Cole,REP,550252,0,0,1085,1085,04
Oklahoma,U.S. House,Rj Harris,IND,550252,0,0,57,57,04
Oklahoma,President,Barack Obama,DEM,550253,0,0,98,98,
Oklahoma,President,Mitt Romney,REP,550253,0,0,364,364,
Oklahoma,U.S. House,Tom Guild,DEM,550253,0,0,83,83,05
Oklahoma,U.S. House,James Lankford,REP,550253,0,0,353,353,05
Oklahoma,U.S. House,Pat Martin,IND,550253,0,0,9,9,05
Oklahoma,U.S. House,Robert Murphy,IND,550253,0,0,11,11,05
Oklahoma,State House,Stephen Covert,DEM,550253,0,0,100,100,10
Oklahoma,State House,Gary Banz,REP,550253,0,0,352,352,10
Oklahoma,President,Barack Obama,DEM,550254,0,0,266,266,
Oklahoma,President,Mitt Romney,REP,550254,0,0,923,923,
Oklahoma,U.S. House,Tom Guild,DEM,550254,0,0,233,233,05
Oklahoma,U.S. House,James Lankford,REP,550254,0,0,877,877,05
Oklahoma,U.S. House,Pat Martin,IND,550254,0,0,28,28,05
Oklahoma,U.S. House,Robert Murphy,IND,550254,0,0,38,38,05
Oklahoma,State House,Stephen Covert,DEM,550254,0,0,289,289,10
Oklahoma,State House,Gary Banz,REP,550254,0,0,864,864,10
Oklahoma,President,Barack Obama,DEM,550255,0,0,0,0,
Oklahoma,President,Mitt Romney,REP,550255,0,0,0,0,
Oklahoma,U.S. House,Donna Marie Bebo,DEM,550255,0,0,0,0,04
Oklahoma,U.S. House,Tom Cole,REP,550255,0,0,0,0,04
Oklahoma,U.S. House,Rj Harris,IND,550255,0,0,0,0,04
Oklahoma,President,Barack Obama,DEM,550256,0,0,0,0,
Oklahoma,President,Mitt Romney,REP,550256,0,0,0,0,
Oklahoma,U.S. House,Tom Guild,DEM,550256,0,0,0,0,05
Oklahoma,U.S. House,James Lankford,REP,550256,0,0,0,0,05
Oklahoma,U.S. House,Pat Martin,IND,550256,0,0,0,0,05
Oklahoma,U.S. House,Robert Murphy,IND,550256,0,0,0,0,05
Oklahoma,President,Barack Obama,DEM,559999,5297,9711,0,15008,
Oklahoma,President,Mitt Romney,REP,559999,10930,4153,0,15083,
Oklahoma,U.S. House,Donna Marie Bebo,DEM,559999,388,595,0,983,04
Oklahoma,U.S. House,Tom Cole,REP,559999,844,297,0,1141,04
Oklahoma,U.S. House,Rj Harris,IND,559999,46,32,0,78,04
Oklahoma,U.S. House,Tom Guild,DEM,559999,4289,8569,0,12858,05
Oklahoma,U.S. House,James Lankford,REP,559999,9963,3966,0,13929,05
Oklahoma,U.S. House,Pat Martin,IND,559999,175,178,0,353,05
Oklahoma,U.S. House,Robert Murphy,IND,559999,200,142,0,342,05
Oklahoma,State Senate,Claudia Griffith,DEM,559999,54,166,0,220,15
Oklahoma,State Senate,Rob Standridge,REP,559999,92,30,0,122,15
Oklahoma,State Senate,Clark Jolley,REP,559999,2295,1026,0,3321,41
Oklahoma,State Senate,Richard Prawdzienski,IND,559999,437,404,0,841,41
Oklahoma,State House,Ed Holzberger,DEM,559999,360,661,0,1021,83
Oklahoma,State House,Randy Mcdaniel,REP,559999,1085,409,0,1494,83
Oklahoma,State House,Nick Singer,DEM,559999,243,357,0,600,87
Oklahoma,State House,Jason Nelson,REP,559999,461,174,0,635,87
Oklahoma,State House,Kay Floyd,DEM,559999,266,419,0,685,88
Oklahoma,State House,Aaron Kaspereit,REP,559999,181,112,0,293,88
Oklahoma,State House,Anastasia Pittman,DEM,559999,408,1841,0,2249,99
Oklahoma,State House,Willard Linzy,REP,559999,123,157,0,280,99
Oklahoma,State House,Stephen Covert,DEM,559999,242,287,0,529,10
Oklahoma,State House,Gary Banz,REP,559999,575,181,0,756,10
Okmulgee,President,Barack Obama,DEM,560001,2,58,165,225,
Okmulgee,President,Mitt Romney,REP,560001,7,14,39,60,
Okmulgee,U.S. House,Rob Wallace,DEM,560001,2,54,160,216,02
Okmulgee,U.S. House,Markwayne Mullin,REP,560001,7,15,37,59,02
Okmulgee,U.S. House,Michael Fulks,IND,560001,0,1,8,9,02
Okmulgee,State House,Jerry Shoemake,DEM,560001,3,58,170,231,16
Okmulgee,State House,James Delso,REP,560001,6,12,34,52,16
Okmulgee,President,Barack Obama,DEM,560002,14,93,371,478,
Okmulgee,President,Mitt Romney,REP,560002,1,7,38,46,
Okmulgee,U.S. House,Rob Wallace,DEM,560002,12,90,365,467,02
Okmulgee,U.S. House,Markwayne Mullin,REP,560002,1,7,37,45,02
Okmulgee,U.S. House,Michael Fulks,IND,560002,0,3,6,9,02
Okmulgee,State House,Jerry Shoemake,DEM,560002,12,95,376,483,16
Okmulgee,State House,James Delso,REP,560002,1,5,32,38,16
Okmulgee,President,Barack Obama,DEM,560004,2,9,61,72,
Okmulgee,President,Mitt Romney,REP,560004,1,5,39,45,
Okmulgee,U.S. House,Rob Wallace,DEM,560004,1,10,59,70,02
Okmulgee,U.S. House,Markwayne Mullin,REP,560004,1,2,37,40,02
Okmulgee,U.S. House,Michael Fulks,IND,560004,1,1,4,6,02
Okmulgee,State House,Jerry Shoemake,DEM,560004,3,11,79,93,16
Okmulgee,State House,James Delso,REP,560004,0,3,20,23,16
Okmulgee,President,Barack Obama,DEM,560005,0,20,183,203,
Okmulgee,President,Mitt Romney,REP,560005,3,29,201,233,
Okmulgee,U.S. House,Rob Wallace,DEM,560005,0,28,190,218,02
Okmulgee,U.S. House,Markwayne Mullin,REP,560005,3,19,181,203,02
Okmulgee,U.S. House,Michael Fulks,IND,560005,0,1,15,16,02
Okmulgee,State House,Jerry Shoemake,DEM,560005,1,30,285,316,16
Okmulgee,State House,James Delso,REP,560005,2,17,98,117,16
Okmulgee,President,Barack Obama,DEM,560006,0,16,78,94,
Okmulgee,President,Mitt Romney,REP,560006,2,13,93,108,
Okmulgee,U.S. House,Rob Wallace,DEM,560006,0,19,69,88,02
Okmulgee,U.S. House,Markwayne Mullin,REP,560006,2,9,89,100,02
Okmulgee,U.S. House,Michael Fulks,IND,560006,0,1,12,13,02
Okmulgee,State House,Jerry Shoemake,DEM,560006,0,22,110,132,16
Okmulgee,State House,James Delso,REP,560006,2,7,58,67,16
Okmulgee,President,Barack Obama,DEM,560007,9,46,172,227,
Okmulgee,President,Mitt Romney,REP,560007,3,49,221,273,
Okmulgee,U.S. House,Rob Wallace,DEM,560007,8,45,167,220,02
Okmulgee,U.S. House,Markwayne Mullin,REP,560007,4,44,207,255,02
Okmulgee,U.S. House,Michael Fulks,IND,560007,0,5,20,25,02
Okmulgee,State House,Jerry Shoemake,DEM,560007,10,60,260,330,16
Okmulgee,State House,James Delso,REP,560007,3,32,132,167,16
Okmulgee,President,Barack Obama,DEM,560008,2,12,110,124,
Okmulgee,President,Mitt Romney,REP,560008,5,17,126,148,
Okmulgee,U.S. House,Rob Wallace,DEM,560008,3,11,110,124,02
Okmulgee,U.S. House,Markwayne Mullin,REP,560008,4,18,113,135,02
Okmulgee,U.S. House,Michael Fulks,IND,560008,0,0,10,10,02
Okmulgee,State House,Jerry Shoemake,DEM,560008,4,15,162,181,16
Okmulgee,State House,James Delso,REP,560008,2,14,74,90,16
Okmulgee,President,Barack Obama,DEM,560009,12,38,125,175,
Okmulgee,President,Mitt Romney,REP,560009,9,17,116,142,
Okmulgee,U.S. House,Rob Wallace,DEM,560009,10,38,118,166,02
Okmulgee,U.S. House,Markwayne Mullin,REP,560009,8,16,111,135,02
Okmulgee,U.S. House,Michael Fulks,IND,560009,0,1,13,14,02
Okmulgee,State House,Jerry Shoemake,DEM,560009,9,44,154,207,16
Okmulgee,State House,James Delso,REP,560009,9,10,84,103,16
Okmulgee,President,Barack Obama,DEM,560010,2,9,57,68,
Okmulgee,President,Mitt Romney,REP,560010,1,16,119,136,
Okmulgee,U.S. House,Rob Wallace,DEM,560010,1,10,51,62,02
Okmulgee,U.S. House,Markwayne Mullin,REP,560010,1,14,118,133,02
Okmulgee,U.S. House,Michael Fulks,IND,560010,1,0,6,7,02
Okmulgee,President,Barack Obama,DEM,560011,5,18,140,163,
Okmulgee,President,Mitt Romney,REP,560011,11,18,182,211,
Okmulgee,U.S. House,Rob Wallace,DEM,560011,8,15,139,162,02
Okmulgee,U.S. House,Markwayne Mullin,REP,560011,7,20,168,195,02
Okmulgee,U.S. House,Michael Fulks,IND,560011,0,1,14,15,02
Okmulgee,State House,Jerry Shoemake,DEM,560011,13,24,220,257,16
Okmulgee,State House,James Delso,REP,560011,4,12,99,115,16
Okmulgee,President,Barack Obama,DEM,560012,6,57,244,307,
Okmulgee,President,Mitt Romney,REP,560012,24,71,420,515,
Okmulgee,U.S. House,Rob Wallace,DEM,560012,5,52,246,303,02
Okmulgee,U.S. House,Markwayne Mullin,REP,560012,23,67,384,474,02
Okmulgee,U.S. House,Michael Fulks,IND,560012,2,9,26,37,02
Okmulgee,State House,Jerry Shoemake,DEM,560012,10,85,447,542,16
Okmulgee,State House,James Delso,REP,560012,19,43,209,271,16
Okmulgee,President,Barack Obama,DEM,560013,1,5,159,165,
Okmulgee,President,Mitt Romney,REP,560013,1,6,166,173,
Okmulgee,U.S. House,Rob Wallace,DEM,560013,1,5,179,185,02
Okmulgee,U.S. House,Markwayne Mullin,REP,560013,1,6,136,143,02
Okmulgee,U.S. House,Michael Fulks,IND,560013,0,0,11,11,02
Okmulgee,State House,Jerry Shoemake,DEM,560013,1,5,227,233,16
Okmulgee,State House,James Delso,REP,560013,1,6,96,103,16
Okmulgee,President,Barack Obama,DEM,560014,2,0,106,108,
Okmulgee,President,Mitt Romney,REP,560014,2,5,123,130,
Okmulgee,U.S. House,Rob Wallace,DEM,560014,3,1,114,118,02
Okmulgee,U.S. House,Markwayne Mullin,REP,560014,0,3,108,111,02
Okmulgee,U.S. House,Michael Fulks,IND,560014,1,1,7,9,02
Okmulgee,State House,Jerry Shoemake,DEM,560014,3,4,140,147,16
Okmulgee,State House,James Delso,REP,560014,1,1,87,89,16
Okmulgee,President,Barack Obama,DEM,560015,6,14,282,302,
Okmulgee,President,Mitt Romney,REP,560015,25,21,349,395,
Okmulgee,U.S. House,Rob Wallace,DEM,560015,7,15,291,313,02
Okmulgee,U.S. House,Markwayne Mullin,REP,560015,20,19,315,354,02
Okmulgee,U.S. House,Michael Fulks,IND,560015,3,1,24,28,02
Okmulgee,State House,Jerry Shoemake,DEM,560015,11,20,397,428,16
Okmulgee,State House,James Delso,REP,560015,20,15,224,259,16
Okmulgee,President,Barack Obama,DEM,560016,8,7,156,171,
Okmulgee,President,Mitt Romney,REP,560016,12,6,266,284,
Okmulgee,U.S. House,Rob Wallace,DEM,560016,7,7,181,195,02
Okmulgee,U.S. House,Markwayne Mullin,REP,560016,9,7,223,239,02
Okmulgee,U.S. House,Michael Fulks,IND,560016,3,0,13,16,02
Okmulgee,President,Barack Obama,DEM,560018,7,6,175,188,
Okmulgee,President,Mitt Romney,REP,560018,5,4,222,231,
Okmulgee,U.S. House,Rob Wallace,DEM,560018,7,7,193,207,02
Okmulgee,U.S. House,Markwayne Mullin,REP,560018,5,3,193,201,02
Okmulgee,U.S. House,Michael Fulks,IND,560018,0,0,12,12,02
Okmulgee,State House,Jerry Shoemake,DEM,560018,9,8,264,281,16
Okmulgee,State House,James Delso,REP,560018,3,2,131,136,16
Okmulgee,President,Barack Obama,DEM,560019,4,4,132,140,
Okmulgee,President,Mitt Romney,REP,560019,12,12,185,209,
Okmulgee,U.S. House,Rob Wallace,DEM,560019,4,5,143,152,02
Okmulgee,U.S. House,Markwayne Mullin,REP,560019,9,11,163,183,02
Okmulgee,U.S. House,Michael Fulks,IND,560019,2,0,12,14,02
Okmulgee,President,Barack Obama,DEM,560020,8,14,446,468,
Okmulgee,President,Mitt Romney,REP,560020,22,48,748,818,
Okmulgee,U.S. House,Rob Wallace,DEM,560020,7,14,477,498,02
Okmulgee,U.S. House,Markwayne Mullin,REP,560020,22,46,673,741,02
Okmulgee,U.S. House,Michael Fulks,IND,560020,1,1,35,37,02
Okmulgee,President,Barack Obama,DEM,560021,2,15,148,165,
Okmulgee,President,Mitt Romney,REP,560021,4,9,109,122,
Okmulgee,U.S. House,Rob Wallace,DEM,560021,2,18,151,171,02
Okmulgee,U.S. House,Markwayne Mullin,REP,560021,4,6,98,108,02
Okmulgee,U.S. House,Michael Fulks,IND,560021,0,0,8,8,02
Okmulgee,State House,Jerry Shoemake,DEM,560021,2,19,204,225,16
Okmulgee,State House,James Delso,REP,560021,4,5,51,60,16
Okmulgee,President,Barack Obama,DEM,560026,7,9,211,227,
Okmulgee,President,Mitt Romney,REP,560026,6,24,484,514,
Okmulgee,U.S. House,Rob Wallace,DEM,560026,7,11,214,232,02
Okmulgee,U.S. House,Markwayne Mullin,REP,560026,6,21,454,481,02
Okmulgee,U.S. House,Michael Fulks,IND,560026,0,1,28,29,02
Okmulgee,State House,Jerry Shoemake,DEM,560026,8,23,496,527,16
Okmulgee,State House,James Delso,REP,560026,5,10,199,214,16
Okmulgee,President,Barack Obama,DEM,560027,4,8,142,154,
Okmulgee,President,Mitt Romney,REP,560027,11,15,307,333,
Okmulgee,U.S. House,Rob Wallace,DEM,560027,4,8,152,164,02
Okmulgee,U.S. House,Markwayne Mullin,REP,560027,11,14,276,301,02
Okmulgee,U.S. House,Michael Fulks,IND,560027,0,1,18,19,02
Okmulgee,State House,Jerry Shoemake,DEM,560027,4,15,264,283,16
Okmulgee,State House,James Delso,REP,560027,11,7,181,199,16
Okmulgee,President,Barack Obama,DEM,560029,6,24,288,318,
Okmulgee,President,Mitt Romney,REP,560029,34,64,849,947,
Okmulgee,U.S. House,Rob Wallace,DEM,560029,7,21,284,312,02
Okmulgee,U.S. House,Markwayne Mullin,REP,560029,33,64,808,905,02
Okmulgee,U.S. House,Michael Fulks,IND,560029,0,3,46,49,02
Okmulgee,President,Barack Obama,DEM,560031,2,1,52,55,
Okmulgee,President,Mitt Romney,REP,560031,1,11,158,170,
Okmulgee,U.S. House,Rob Wallace,DEM,560031,0,3,66,69,02
Okmulgee,U.S. House,Markwayne Mullin,REP,560031,1,9,138,148,02
Okmulgee,U.S. House,Michael Fulks,IND,560031,1,0,6,7,02
Okmulgee,President,Barack Obama,DEM,560032,1,23,132,156,
Okmulgee,President,Mitt Romney,REP,560032,3,28,190,221,
Okmulgee,U.S. House,Rob Wallace,DEM,560032,1,22,140,163,02
Okmulgee,U.S. House,Markwayne Mullin,REP,560032,3,29,173,205,02
Okmulgee,U.S. House,Michael Fulks,IND,560032,0,1,9,10,02
Okmulgee,President,Barack Obama,DEM,560033,8,12,125,145,
Okmulgee,President,Mitt Romney,REP,560033,4,23,191,218,
Okmulgee,U.S. House,Rob Wallace,DEM,560033,6,13,120,139,02
Okmulgee,U.S. House,Markwayne Mullin,REP,560033,4,21,188,213,02
Okmulgee,U.S. House,Michael Fulks,IND,560033,2,1,11,14,02
Okmulgee,President,Barack Obama,DEM,560034,0,5,80,85,
Okmulgee,President,Mitt Romney,REP,560034,6,16,213,235,
Okmulgee,U.S. House,Rob Wallace,DEM,560034,2,4,88,94,02
Okmulgee,U.S. House,Markwayne Mullin,REP,560034,4,16,196,216,02
Okmulgee,U.S. House,Michael Fulks,IND,560034,0,1,10,11,02
Okmulgee,State House,Jerry Shoemake,DEM,560034,3,11,206,220,16
Okmulgee,State House,James Delso,REP,560034,2,10,88,100,16
Okmulgee,President,Barack Obama,DEM,560035,2,0,119,121,
Okmulgee,President,Mitt Romney,REP,560035,5,16,168,189,
Okmulgee,U.S. House,Rob Wallace,DEM,560035,4,1,140,145,02
Okmulgee,U.S. House,Markwayne Mullin,REP,560035,2,15,132,149,02
Okmulgee,U.S. House,Michael Fulks,IND,560035,0,0,13,13,02
Okmulgee,State House,Jerry Shoemake,DEM,560035,5,6,183,194,16
Okmulgee,State House,James Delso,REP,560035,2,10,100,112,16
Okmulgee,President,Barack Obama,DEM,560036,7,27,195,229,
Okmulgee,President,Mitt Romney,REP,560036,7,50,396,453,
Okmulgee,U.S. House,Rob Wallace,DEM,560036,8,28,208,244,02
Okmulgee,U.S. House,Markwayne Mullin,REP,560036,6,47,362,415,02
Okmulgee,U.S. House,Michael Fulks,IND,560036,0,1,23,24,02
Okmulgee,State House,Jerry Shoemake,DEM,560036,11,52,405,468,16
Okmulgee,State House,James Delso,REP,560036,2,25,188,215,16
Okmulgee,President,Barack Obama,DEM,560038,4,8,87,99,
Okmulgee,President,Mitt Romney,REP,560038,3,7,162,172,
Okmulgee,U.S. House,Rob Wallace,DEM,560038,4,8,95,107,02
Okmulgee,U.S. House,Markwayne Mullin,REP,560038,3,7,144,154,02
Okmulgee,U.S. House,Michael Fulks,IND,560038,0,0,11,11,02
Osage,President,Barack Obama,DEM,570101,3,1,38,42,
Osage,President,Mitt Romney,REP,570101,10,4,107,121,
Osage,U.S. House,Timothy Ray Murray,DEM,570101,2,1,36,39,03
Osage,U.S. House,Frank Lucas,REP,570101,9,3,99,111,03
Osage,U.S. House,William Sanders,IND,570101,0,1,8,9,03
Osage,President,Barack Obama,DEM,570102,5,6,33,44,
Osage,President,Mitt Romney,REP,570102,8,14,108,130,
Osage,U.S. House,Timothy Ray Murray,DEM,570102,7,5,28,40,03
Osage,U.S. House,Frank Lucas,REP,570102,6,13,101,120,03
Osage,U.S. House,William Sanders,IND,570102,0,2,12,14,03
Osage,State House,Jim Massey,DEM,570102,7,6,41,54,36
Osage,State House,Sean Roberts,REP,570102,6,14,98,118,36
Osage,President,Barack Obama,DEM,570103,3,2,56,61,
Osage,President,Mitt Romney,REP,570103,5,4,196,205,
Osage,U.S. House,Timothy Ray Murray,DEM,570103,0,1,52,53,03
Osage,U.S. House,Frank Lucas,REP,570103,6,5,184,195,03
Osage,U.S. House,William Sanders,IND,570103,2,0,17,19,03
Osage,State House,Nancy Niemann,DEM,570103,3,3,101,107,37
Osage,State House,Steven Vaughan,REP,570103,4,3,152,159,37
Osage,President,Barack Obama,DEM,570105,13,5,229,247,
Osage,President,Mitt Romney,REP,570105,39,4,534,577,
Osage,U.S. House,Timothy Ray Murray,DEM,570105,11,4,201,216,03
Osage,U.S. House,Frank Lucas,REP,570105,41,4,513,558,03
Osage,U.S. House,William Sanders,IND,570105,2,1,36,39,03
Osage,State House,Nancy Niemann,DEM,570105,22,5,310,337,37
Osage,State House,Steven Vaughan,REP,570105,32,4,448,484,37
Osage,President,Barack Obama,DEM,570106,0,1,18,19,
Osage,President,Mitt Romney,REP,570106,1,0,52,53,
Osage,U.S. House,Timothy Ray Murray,DEM,570106,0,0,20,20,03
Osage,U.S. House,Frank Lucas,REP,570106,0,1,42,43,03
Osage,U.S. House,William Sanders,IND,570106,1,0,4,5,03
Osage,State House,Nancy Niemann,DEM,570106,0,1,31,32,37
Osage,State House,Steven Vaughan,REP,570106,1,0,35,36,37
Osage,President,Barack Obama,DEM,570107,16,75,310,401,
Osage,President,Mitt Romney,REP,570107,43,149,495,687,
Osage,U.S. House,Timothy Ray Murray,DEM,570107,13,61,270,344,03
Osage,U.S. House,Frank Lucas,REP,570107,39,150,486,675,03
Osage,U.S. House,William Sanders,IND,570107,5,7,48,60,03
Osage,State House,Nancy Niemann,DEM,570107,26,98,410,534,37
Osage,State House,Steven Vaughan,REP,570107,32,121,394,547,37
Osage,President,Barack Obama,DEM,570108,16,53,189,258,
Osage,President,Mitt Romney,REP,570108,16,67,265,348,
Osage,U.S. House,Timothy Ray Murray,DEM,570108,11,44,166,221,03
Osage,U.S. House,Frank Lucas,REP,570108,17,71,246,334,03
Osage,U.S. House,William Sanders,IND,570108,2,3,31,36,03
Osage,State House,Jim Massey,DEM,570108,13,60,233,306,36
Osage,State House,Sean Roberts,REP,570108,19,58,209,286,36
Osage,President,Barack Obama,DEM,570109,12,6,171,189,
Osage,President,Mitt Romney,REP,570109,25,22,556,603,
Osage,U.S. House,Timothy Ray Murray,DEM,570109,8,4,138,150,03
Osage,U.S. House,Frank Lucas,REP,570109,29,20,540,589,03
Osage,U.S. House,William Sanders,IND,570109,1,4,40,45,03
Osage,President,Barack Obama,DEM,570110,15,4,148,167,
Osage,President,Mitt Romney,REP,570110,14,23,530,567,
Osage,U.S. House,Timothy Ray Murray,DEM,570110,13,2,148,163,03
Osage,U.S. House,Frank Lucas,REP,570110,15,23,503,541,03
Osage,U.S. House,William Sanders,IND,570110,0,1,28,29,03
Osage,State House,Jim Massey,DEM,570110,14,4,213,231,36
Osage,State House,Sean Roberts,REP,570110,15,22,458,495,36
Osage,President,Barack Obama,DEM,570111,0,1,62,63,
Osage,President,Mitt Romney,REP,570111,2,12,165,179,
Osage,U.S. House,Timothy Ray Murray,DEM,570111,0,3,49,52,03
Osage,U.S. House,Frank Lucas,REP,570111,2,10,165,177,03
Osage,U.S. House,William Sanders,IND,570111,0,0,11,11,03
Osage,State House,Jim Massey,DEM,570111,0,6,67,73,36
Osage,State House,Sean Roberts,REP,570111,1,7,158,166,36
Osage,President,Barack Obama,DEM,570112,7,2,143,152,
Osage,President,Mitt Romney,REP,570112,25,6,297,328,
Osage,U.S. House,Timothy Ray Murray,DEM,570112,7,0,122,129,03
Osage,U.S. House,Frank Lucas,REP,570112,20,5,263,288,03
Osage,U.S. House,William Sanders,IND,570112,5,1,43,49,03
Osage,State House,Jim Massey,DEM,570112,8,3,181,192,36
Osage,State House,Sean Roberts,REP,570112,24,5,245,274,36
Osage,President,Barack Obama,DEM,570113,1,1,19,21,
Osage,President,Mitt Romney,REP,570113,3,1,39,43,
Osage,U.S. House,Timothy Ray Murray,DEM,570113,1,2,20,23,03
Osage,U.S. House,Frank Lucas,REP,570113,3,0,37,40,03
Osage,U.S. House,William Sanders,IND,570113,0,0,1,1,03
Osage,State House,Nancy Niemann,DEM,570113,1,2,27,30,37
Osage,State House,Steven Vaughan,REP,570113,3,0,29,32,37
Osage,President,Barack Obama,DEM,570201,17,7,387,411,
Osage,President,Mitt Romney,REP,570201,71,16,1345,1432,
Osage,U.S. House,Timothy Ray Murray,DEM,570201,17,3,347,367,03
Osage,U.S. House,Frank Lucas,REP,570201,65,17,1240,1322,03
Osage,U.S. House,William Sanders,IND,570201,6,2,108,116,03
Osage,State House,Jim Massey,DEM,570201,24,8,560,592,36
Osage,State House,Sean Roberts,REP,570201,62,14,1141,1217,36
Osage,President,Barack Obama,DEM,570202,108,76,1288,1472,
Osage,President,Mitt Romney,REP,570202,17,3,163,183,
Osage,U.S. House,Timothy Ray Murray,DEM,570202,107,65,1193,1365,03
Osage,U.S. House,Frank Lucas,REP,570202,14,7,196,217,03
Osage,U.S. House,William Sanders,IND,570202,4,6,53,63,03
Osage,State Senate,Jabar Shumate,DEM,570202,106,77,1268,1451,11
Osage,State Senate,Dave Bell,REP,570202,14,3,128,145,11
Osage,State Senate,Curtis Mullins,IND,570202,4,1,51,56,11
Osage,President,Barack Obama,DEM,570203,29,17,401,447,
Osage,President,Mitt Romney,REP,570203,76,41,1527,1644,
Osage,U.S. House,Timothy Ray Murray,DEM,570203,29,15,374,418,03
Osage,U.S. House,Frank Lucas,REP,570203,68,40,1426,1534,03
Osage,U.S. House,William Sanders,IND,570203,5,3,98,106,03
Osage,State House,Jim Massey,DEM,570203,39,23,652,714,36
Osage,State House,Sean Roberts,REP,570203,65,35,1236,1336,36
Osage,President,Barack Obama,DEM,570204,9,2,159,170,
Osage,President,Mitt Romney,REP,570204,22,3,446,471,
Osage,U.S. House,Timothy Ray Murray,DEM,570204,9,2,154,165,03
Osage,U.S. House,Frank Lucas,REP,570204,15,3,409,427,03
Osage,U.S. House,William Sanders,IND,570204,3,0,33,36,03
Osage,State House,Jim Massey,DEM,570204,6,3,263,272,36
Osage,State House,Sean Roberts,REP,570204,18,2,333,353,36
Osage,President,Barack Obama,DEM,570205,4,0,82,86,
Osage,President,Mitt Romney,REP,570205,6,1,110,117,
Osage,U.S. House,Timothy Ray Murray,DEM,570205,4,0,78,82,03
Osage,U.S. House,Frank Lucas,REP,570205,6,1,101,108,03
Osage,U.S. House,William Sanders,IND,570205,0,0,11,11,03
Osage,State Senate,Jabar Shumate,DEM,570205,4,0,75,79,11
Osage,State Senate,Dave Bell,REP,570205,6,1,96,103,11
Osage,State Senate,Curtis Mullins,IND,570205,0,0,17,17,11
Osage,State House,Jim Massey,DEM,570205,5,0,96,101,36
Osage,State House,Sean Roberts,REP,570205,5,1,90,96,36
Osage,President,Barack Obama,DEM,570301,23,7,197,227,
Osage,President,Mitt Romney,REP,570301,15,9,375,399,
Osage,U.S. House,Timothy Ray Murray,DEM,570301,18,6,164,188,03
Osage,U.S. House,Frank Lucas,REP,570301,17,9,374,400,03
Osage,U.S. House,William Sanders,IND,570301,2,1,32,35,03
Osage,State House,Jim Massey,DEM,570301,22,8,227,257,36
Osage,State House,Sean Roberts,REP,570301,15,8,339,362,36
Osage,President,Barack Obama,DEM,570302,0,1,43,44,
Osage,President,Mitt Romney,REP,570302,7,2,68,77,
Osage,U.S. House,Timothy Ray Murray,DEM,570302,0,1,34,35,03
Osage,U.S. House,Frank Lucas,REP,570302,5,2,74,81,03
Osage,U.S. House,William Sanders,IND,570302,2,0,2,4,03
Osage,State House,Nancy Niemann,DEM,570302,2,1,55,58,37
Osage,State House,Steven Vaughan,REP,570302,5,2,55,62,37
Osage,President,Barack Obama,DEM,570303,3,2,96,101,
Osage,President,Mitt Romney,REP,570303,14,16,236,266,
Osage,U.S. House,Timothy Ray Murray,DEM,570303,4,3,89,96,03
Osage,U.S. House,Frank Lucas,REP,570303,13,15,224,252,03
Osage,U.S. House,William Sanders,IND,570303,0,0,16,16,03
Osage,State House,Nancy Niemann,DEM,570303,6,2,164,172,37
Osage,State House,Steven Vaughan,REP,570303,11,16,167,194,37
Osage,President,Barack Obama,DEM,570305,9,0,116,125,
Osage,President,Mitt Romney,REP,570305,11,2,255,268,
Osage,U.S. House,Timothy Ray Murray,DEM,570305,5,0,110,115,03
Osage,U.S. House,Frank Lucas,REP,570305,12,2,233,247,03
Osage,U.S. House,William Sanders,IND,570305,4,0,24,28,03
Osage,President,Barack Obama,DEM,570306,2,1,134,137,
Osage,President,Mitt Romney,REP,570306,8,6,313,327,
Osage,U.S. House,Timothy Ray Murray,DEM,570306,2,1,101,104,03
Osage,U.S. House,Frank Lucas,REP,570306,8,6,327,341,03
Osage,U.S. House,William Sanders,IND,570306,0,0,16,16,03
Osage,State House,Jim Massey,DEM,570306,4,0,125,129,36
Osage,State House,Sean Roberts,REP,570306,6,7,325,338,36
Osage,President,Barack Obama,DEM,570307,9,2,275,286,
Osage,President,Mitt Romney,REP,570307,17,6,349,372,
Osage,U.S. House,Timothy Ray Murray,DEM,570307,9,3,220,232,03
Osage,U.S. House,Frank Lucas,REP,570307,16,5,359,380,03
Osage,U.S. House,William Sanders,IND,570307,1,0,40,41,03
Osage,State House,Jim Massey,DEM,570307,9,4,217,230,36
Osage,State House,Sean Roberts,REP,570307,17,4,405,426,36
Osage,President,Barack Obama,DEM,570308,12,3,314,329,
Osage,President,Mitt Romney,REP,570308,30,4,719,753,
Osage,U.S. House,Timothy Ray Murray,DEM,570308,12,1,256,269,03
Osage,U.S. House,Frank Lucas,REP,570308,27,5,699,731,03
Osage,U.S. House,William Sanders,IND,570308,5,1,66,72,03
Osage,State House,Jim Massey,DEM,570308,15,3,355,373,36
Osage,State House,Sean Roberts,REP,570308,29,4,666,699,36
Osage,President,Barack Obama,DEM,570309,4,1,114,119,
Osage,President,Mitt Romney,REP,570309,31,10,469,510,
Osage,U.S. House,Timothy Ray Murray,DEM,570309,3,0,100,103,03
Osage,U.S. House,Frank Lucas,REP,570309,30,9,434,473,03
Osage,U.S. House,William Sanders,IND,570309,0,0,43,43,03
Osage,State House,Jim Massey,DEM,570309,7,1,162,170,36
Osage,State House,Sean Roberts,REP,570309,27,8,408,443,36
Osage,President,Barack Obama,DEM,570310,50,24,843,917,
Osage,President,Mitt Romney,REP,570310,10,3,85,98,
Osage,U.S. House,Timothy Ray Murray,DEM,570310,49,21,781,851,03
Osage,U.S. House,Frank Lucas,REP,570310,10,3,89,102,03
Osage,U.S. House,William Sanders,IND,570310,1,3,44,48,03
Osage,State Senate,Jabar Shumate,DEM,570310,51,21,829,901,11
Osage,State Senate,Dave Bell,REP,570310,5,3,67,75,11
Osage,State Senate,Curtis Mullins,IND,570310,4,3,24,31,11
Osage,President,Barack Obama,DEM,570311,6,2,32,40,
Osage,President,Mitt Romney,REP,570311,10,0,48,58,
Osage,U.S. House,Timothy Ray Murray,DEM,570311,3,2,25,30,03
Osage,U.S. House,Frank Lucas,REP,570311,11,0,50,61,03
Osage,U.S. House,William Sanders,IND,570311,2,0,4,6,03
Osage,State Senate,Jabar Shumate,DEM,570311,4,2,30,36,11
Osage,State Senate,Dave Bell,REP,570311,10,0,43,53,11
Osage,State Senate,Curtis Mullins,IND,570311,2,0,6,8,11
Osage,State House,David Iii,DEM,570311,5,2,29,36,66
Osage,State House,Jadine Nollan,REP,570311,11,0,51,62,66
Osage,President,Barack Obama,DEM,570312,11,0,118,129,
Osage,President,Mitt Romney,REP,570312,29,7,390,426,
Osage,U.S. House,Timothy Ray Murray,DEM,570312,8,0,103,111,03
Osage,U.S. House,Frank Lucas,REP,570312,26,7,374,407,03
Osage,U.S. House,William Sanders,IND,570312,2,0,28,30,03
Osage,State House,David Iii,DEM,570312,13,0,100,113,66
Osage,State House,Jadine Nollan,REP,570312,26,7,409,442,66
Ottawa,President,Barack Obama,DEM,580002,11,32,124,167,
Ottawa,President,Mitt Romney,REP,580002,14,41,283,338,
Ottawa,U.S. House,Rob Wallace,DEM,580002,16,32,144,192,02
Ottawa,U.S. House,Markwayne Mullin,REP,580002,9,39,242,290,02
Ottawa,U.S. House,Michael Fulks,IND,580002,0,1,13,14,02
Ottawa,President,Barack Obama,DEM,580003,5,28,241,274,
Ottawa,President,Mitt Romney,REP,580003,20,43,398,461,
Ottawa,U.S. House,Rob Wallace,DEM,580003,6,31,264,301,02
Ottawa,U.S. House,Markwayne Mullin,REP,580003,17,37,339,393,02
Ottawa,U.S. House,Michael Fulks,IND,580003,2,3,29,34,02
Ottawa,President,Barack Obama,DEM,580004,6,23,94,123,
Ottawa,President,Mitt Romney,REP,580004,10,30,178,218,
Ottawa,U.S. House,Rob Wallace,DEM,580004,7,21,116,144,02
Ottawa,U.S. House,Markwayne Mullin,REP,580004,9,30,142,181,02
Ottawa,U.S. House,Michael Fulks,IND,580004,0,2,11,13,02
Ottawa,President,Barack Obama,DEM,580005,4,18,165,187,
Ottawa,President,Mitt Romney,REP,580005,7,32,206,245,
Ottawa,U.S. House,Rob Wallace,DEM,580005,5,18,167,190,02
Ottawa,U.S. House,Markwayne Mullin,REP,580005,4,29,169,202,02
Ottawa,U.S. House,Michael Fulks,IND,580005,2,4,27,33,02
Ottawa,President,Barack Obama,DEM,580007,8,31,243,282,
Ottawa,President,Mitt Romney,REP,580007,16,68,557,641,
Ottawa,U.S. House,Rob Wallace,DEM,580007,8,37,287,332,02
Ottawa,U.S. House,Markwayne Mullin,REP,580007,15,59,464,538,02
Ottawa,U.S. House,Michael Fulks,IND,580007,1,3,40,44,02
Ottawa,President,Barack Obama,DEM,580008,1,12,95,108,
Ottawa,President,Mitt Romney,REP,580008,6,14,137,157,
Ottawa,U.S. House,Rob Wallace,DEM,580008,2,13,104,119,02
Ottawa,U.S. House,Markwayne Mullin,REP,580008,4,12,109,125,02
Ottawa,U.S. House,Michael Fulks,IND,580008,1,0,16,17,02
Ottawa,President,Barack Obama,DEM,580009,3,9,121,133,
Ottawa,President,Mitt Romney,REP,580009,5,19,176,200,
Ottawa,U.S. House,Rob Wallace,DEM,580009,1,11,139,151,02
Ottawa,U.S. House,Markwayne Mullin,REP,580009,5,16,149,170,02
Ottawa,U.S. House,Michael Fulks,IND,580009,1,0,2,3,02
Ottawa,President,Barack Obama,DEM,580011,10,26,226,262,
Ottawa,President,Mitt Romney,REP,580011,15,49,263,327,
Ottawa,U.S. House,Rob Wallace,DEM,580011,13,28,217,258,02
Ottawa,U.S. House,Markwayne Mullin,REP,580011,11,45,232,288,02
Ottawa,U.S. House,Michael Fulks,IND,580011,0,2,31,33,02
Ottawa,President,Barack Obama,DEM,580012,5,9,133,147,
Ottawa,President,Mitt Romney,REP,580012,12,17,250,279,
Ottawa,U.S. House,Rob Wallace,DEM,580012,5,11,167,183,02
Ottawa,U.S. House,Markwayne Mullin,REP,580012,11,13,188,212,02
Ottawa,U.S. House,Michael Fulks,IND,580012,0,2,21,23,02
Ottawa,President,Barack Obama,DEM,580014,6,17,312,335,
Ottawa,President,Mitt Romney,REP,580014,11,27,466,504,
Ottawa,U.S. House,Rob Wallace,DEM,580014,5,24,353,382,02
Ottawa,U.S. House,Markwayne Mullin,REP,580014,6,16,379,401,02
Ottawa,U.S. House,Michael Fulks,IND,580014,1,2,41,44,02
Ottawa,President,Barack Obama,DEM,580023,3,4,247,254,
Ottawa,President,Mitt Romney,REP,580023,6,28,315,349,
Ottawa,U.S. House,Rob Wallace,DEM,580023,2,8,290,300,02
Ottawa,U.S. House,Markwayne Mullin,REP,580023,5,20,239,264,02
Ottawa,U.S. House,Michael Fulks,IND,580023,2,3,28,33,02
Ottawa,President,Barack Obama,DEM,580024,0,4,90,94,
Ottawa,President,Mitt Romney,REP,580024,10,5,164,179,
Ottawa,U.S. House,Rob Wallace,DEM,580024,0,4,95,99,02
Ottawa,U.S. House,Markwayne Mullin,REP,580024,9,5,150,164,02
Ottawa,U.S. House,Michael Fulks,IND,580024,0,0,8,8,02
Ottawa,President,Barack Obama,DEM,580025,0,8,147,155,
Ottawa,President,Mitt Romney,REP,580025,20,19,369,408,
Ottawa,U.S. House,Rob Wallace,DEM,580025,3,10,168,181,02
Ottawa,U.S. House,Markwayne Mullin,REP,580025,16,14,313,343,02
Ottawa,U.S. House,Michael Fulks,IND,580025,1,3,25,29,02
Ottawa,President,Barack Obama,DEM,580026,8,4,197,209,
Ottawa,President,Mitt Romney,REP,580026,20,17,453,490,
Ottawa,U.S. House,Rob Wallace,DEM,580026,8,7,207,222,02
Ottawa,U.S. House,Markwayne Mullin,REP,580026,19,12,396,427,02
Ottawa,U.S. House,Michael Fulks,IND,580026,0,2,39,41,02
Ottawa,President,Barack Obama,DEM,580028,12,22,294,328,
Ottawa,President,Mitt Romney,REP,580028,21,42,690,753,
Ottawa,U.S. House,Rob Wallace,DEM,580028,13,22,363,398,02
Ottawa,U.S. House,Markwayne Mullin,REP,580028,19,40,568,627,02
Ottawa,U.S. House,Michael Fulks,IND,580028,2,3,45,50,02
Ottawa,President,Barack Obama,DEM,580031,17,28,255,300,
Ottawa,President,Mitt Romney,REP,580031,38,44,487,569,
Ottawa,U.S. House,Rob Wallace,DEM,580031,11,33,270,314,02
Ottawa,U.S. House,Markwayne Mullin,REP,580031,35,37,432,504,02
Ottawa,U.S. House,Michael Fulks,IND,580031,5,2,28,35,02
Ottawa,President,Barack Obama,DEM,580034,6,13,132,151,
Ottawa,President,Mitt Romney,REP,580034,7,33,308,348,
Ottawa,U.S. House,Rob Wallace,DEM,580034,6,12,134,152,02
Ottawa,U.S. House,Markwayne Mullin,REP,580034,6,34,275,315,02
Ottawa,U.S. House,Michael Fulks,IND,580034,1,0,28,29,02
Pawnee,President,Barack Obama,DEM,590104,8,31,122,161,
Pawnee,President,Mitt Romney,REP,590104,14,90,335,439,
Pawnee,U.S. House,Timothy Ray Murray,DEM,590104,7,22,103,132,03
Pawnee,U.S. House,Frank Lucas,REP,590104,15,93,332,440,03
Pawnee,U.S. House,William Sanders,IND,590104,0,5,17,22,03
Pawnee,President,Barack Obama,DEM,590111,0,5,98,103,
Pawnee,President,Mitt Romney,REP,590111,8,9,193,210,
Pawnee,U.S. House,Timothy Ray Murray,DEM,590111,0,5,85,90,03
Pawnee,U.S. House,Frank Lucas,REP,590111,8,9,188,205,03
Pawnee,U.S. House,William Sanders,IND,590111,0,0,14,14,03
Pawnee,President,Barack Obama,DEM,590112,2,1,72,75,
Pawnee,President,Mitt Romney,REP,590112,4,0,170,174,
Pawnee,U.S. House,Timothy Ray Murray,DEM,590112,2,1,67,70,03
Pawnee,U.S. House,Frank Lucas,REP,590112,3,0,156,159,03
Pawnee,U.S. House,William Sanders,IND,590112,1,0,15,16,03
Pawnee,President,Barack Obama,DEM,590118,9,7,236,252,
Pawnee,President,Mitt Romney,REP,590118,20,20,576,616,
Pawnee,U.S. House,Timothy Ray Murray,DEM,590118,9,6,199,214,03
Pawnee,U.S. House,Frank Lucas,REP,590118,18,21,571,610,03
Pawnee,U.S. House,William Sanders,IND,590118,2,0,35,37,03
Pawnee,President,Barack Obama,DEM,590202,25,100,310,435,
Pawnee,President,Mitt Romney,REP,590202,43,153,570,766,
Pawnee,U.S. House,Timothy Ray Murray,DEM,590202,20,70,239,329,03
Pawnee,U.S. House,Frank Lucas,REP,590202,40,170,597,807,03
Pawnee,U.S. House,William Sanders,IND,590202,5,10,45,60,03
Pawnee,President,Barack Obama,DEM,590215,0,4,58,62,
Pawnee,President,Mitt Romney,REP,590215,0,4,87,91,
Pawnee,U.S. House,Timothy Ray Murray,DEM,590215,0,4,46,50,03
Pawnee,U.S. House,Frank Lucas,REP,590215,0,5,88,93,03
Pawnee,U.S. House,William Sanders,IND,590215,0,0,9,9,03
Pawnee,President,Barack Obama,DEM,590217,18,8,156,182,
Pawnee,President,Mitt Romney,REP,590217,12,21,451,484,
Pawnee,U.S. House,Timothy Ray Murray,DEM,590217,14,8,130,152,03
Pawnee,U.S. House,Frank Lucas,REP,590217,14,19,456,489,03
Pawnee,U.S. House,William Sanders,IND,590217,2,2,23,27,03
Pawnee,President,Barack Obama,DEM,590307,16,12,248,276,
Pawnee,President,Mitt Romney,REP,590307,34,24,733,791,
Pawnee,U.S. House,Timothy Ray Murray,DEM,590307,12,11,221,244,03
Pawnee,U.S. House,Frank Lucas,REP,590307,32,24,694,750,03
Pawnee,U.S. House,William Sanders,IND,590307,6,1,57,64,03
Pawnee,President,Barack Obama,DEM,590309,1,0,62,63,
Pawnee,President,Mitt Romney,REP,590309,9,2,183,194,
Pawnee,U.S. House,Timothy Ray Murray,DEM,590309,0,0,42,42,03
Pawnee,U.S. House,Frank Lucas,REP,590309,10,2,179,191,03
Pawnee,U.S. House,William Sanders,IND,590309,0,0,22,22,03
Pawnee,President,Barack Obama,DEM,590314,5,4,195,204,
Pawnee,President,Mitt Romney,REP,590314,13,2,452,467,
Pawnee,U.S. House,Timothy Ray Murray,DEM,590314,6,0,148,154,03
Pawnee,U.S. House,Frank Lucas,REP,590314,11,6,444,461,03
Pawnee,U.S. House,William Sanders,IND,590314,0,0,59,59,03
Payne,President,Barack Obama,DEM,600001,6,29,143,178,
Payne,President,Mitt Romney,REP,600001,6,25,138,169,
Payne,U.S. House,Timothy Ray Murray,DEM,600001,5,27,99,131,03
Payne,U.S. House,Frank Lucas,REP,600001,6,26,164,196,03
Payne,U.S. House,William Sanders,IND,600001,1,1,19,21,03
Payne,President,Barack Obama,DEM,600002,8,49,310,367,
Payne,President,Mitt Romney,REP,600002,23,58,420,501,
Payne,U.S. House,Timothy Ray Murray,DEM,600002,6,33,219,258,03
Payne,U.S. House,Frank Lucas,REP,600002,23,64,447,534,03
Payne,U.S. House,William Sanders,IND,600002,1,9,63,73,03
Payne,President,Barack Obama,DEM,600003,7,23,185,215,
Payne,President,Mitt Romney,REP,600003,7,36,182,225,
Payne,U.S. House,Timothy Ray Murray,DEM,600003,3,18,132,153,03
Payne,U.S. House,Frank Lucas,REP,600003,9,38,201,248,03
Payne,U.S. House,William Sanders,IND,600003,1,3,30,34,03
Payne,President,Barack Obama,DEM,600004,15,106,340,461,
Payne,President,Mitt Romney,REP,600004,29,118,552,699,
Payne,U.S. House,Timothy Ray Murray,DEM,600004,11,87,242,340,03
Payne,U.S. House,Frank Lucas,REP,600004,30,124,590,744,03
Payne,U.S. House,William Sanders,IND,600004,5,13,60,78,03
Payne,President,Barack Obama,DEM,600005,0,15,53,68,
Payne,President,Mitt Romney,REP,600005,2,30,112,144,
Payne,U.S. House,Timothy Ray Murray,DEM,600005,0,11,39,50,03
Payne,U.S. House,Frank Lucas,REP,600005,2,31,117,150,03
Payne,U.S. House,William Sanders,IND,600005,0,3,10,13,03
Payne,President,Barack Obama,DEM,600006,15,158,410,583,
Payne,President,Mitt Romney,REP,600006,24,166,582,772,
Payne,U.S. House,Timothy Ray Murray,DEM,600006,15,129,306,450,03
Payne,U.S. House,Frank Lucas,REP,600006,23,175,613,811,03
Payne,U.S. House,William Sanders,IND,600006,1,18,61,80,03
Payne,President,Barack Obama,DEM,600007,15,38,243,296,
Payne,President,Mitt Romney,REP,600007,11,24,239,274,
Payne,U.S. House,Timothy Ray Murray,DEM,600007,11,26,175,212,03
Payne,U.S. House,Frank Lucas,REP,600007,15,28,241,284,03
Payne,U.S. House,William Sanders,IND,600007,1,5,62,68,03
Payne,President,Barack Obama,DEM,600008,27,71,301,399,
Payne,President,Mitt Romney,REP,600008,23,64,262,349,
Payne,U.S. House,Timothy Ray Murray,DEM,600008,18,50,234,302,03
Payne,U.S. House,Frank Lucas,REP,600008,22,77,275,374,03
Payne,U.S. House,William Sanders,IND,600008,5,7,48,60,03
Payne,President,Barack Obama,DEM,600009,25,112,311,448,
Payne,President,Mitt Romney,REP,600009,42,160,574,776,
Payne,U.S. House,Timothy Ray Murray,DEM,600009,16,99,229,344,03
Payne,U.S. House,Frank Lucas,REP,600009,47,162,608,817,03
Payne,U.S. House,William Sanders,IND,600009,1,7,45,53,03
Payne,President,Barack Obama,DEM,600010,17,52,301,370,
Payne,President,Mitt Romney,REP,600010,18,33,328,379,
Payne,U.S. House,Timothy Ray Murray,DEM,600010,9,46,218,273,03
Payne,U.S. House,Frank Lucas,REP,600010,19,32,340,391,03
Payne,U.S. House,William Sanders,IND,600010,2,3,61,66,03
Payne,President,Barack Obama,DEM,600011,9,41,136,186,
Payne,President,Mitt Romney,REP,600011,9,47,246,302,
Payne,U.S. House,Timothy Ray Murray,DEM,600011,8,28,105,141,03
Payne,U.S. House,Frank Lucas,REP,600011,9,56,247,312,03
Payne,U.S. House,William Sanders,IND,600011,1,2,27,30,03
Payne,President,Barack Obama,DEM,600012,16,46,271,333,
Payne,President,Mitt Romney,REP,600012,6,25,301,332,
Payne,U.S. House,Timothy Ray Murray,DEM,600012,16,37,195,248,03
Payne,U.S. House,Frank Lucas,REP,600012,6,28,310,344,03
Payne,U.S. House,William Sanders,IND,600012,0,4,61,65,03
Payne,President,Barack Obama,DEM,600013,15,133,407,555,
Payne,President,Mitt Romney,REP,600013,48,136,638,822,
Payne,U.S. House,Timothy Ray Murray,DEM,600013,12,102,309,423,03
Payne,U.S. House,Frank Lucas,REP,600013,44,149,648,841,03
Payne,U.S. House,William Sanders,IND,600013,4,15,73,92,03
Payne,President,Barack Obama,DEM,600014,0,7,36,43,
Payne,President,Mitt Romney,REP,600014,2,3,22,27,
Payne,U.S. House,Timothy Ray Murray,DEM,600014,0,5,27,32,03
Payne,U.S. House,Frank Lucas,REP,600014,2,4,20,26,03
Payne,U.S. House,William Sanders,IND,600014,0,1,9,10,03
Payne,President,Barack Obama,DEM,600015,15,68,320,403,
Payne,President,Mitt Romney,REP,600015,14,54,307,375,
Payne,U.S. House,Timothy Ray Murray,DEM,600015,13,56,242,311,03
Payne,U.S. House,Frank Lucas,REP,600015,12,61,329,402,03
Payne,U.S. House,William Sanders,IND,600015,2,4,49,55,03
Payne,President,Barack Obama,DEM,600016,41,215,452,708,
Payne,President,Mitt Romney,REP,600016,66,389,799,1254,
Payne,U.S. House,Timothy Ray Murray,DEM,600016,34,149,310,493,03
Payne,U.S. House,Frank Lucas,REP,600016,67,440,863,1370,03
Payne,U.S. House,William Sanders,IND,600016,5,12,61,78,03
Payne,President,Barack Obama,DEM,600101,11,11,244,266,
Payne,President,Mitt Romney,REP,600101,26,27,536,589,
Payne,U.S. House,Timothy Ray Murray,DEM,600101,12,8,201,221,03
Payne,U.S. House,Frank Lucas,REP,600101,20,29,532,581,03
Payne,U.S. House,William Sanders,IND,600101,4,1,43,48,03
Payne,President,Barack Obama,DEM,600102,13,9,206,228,
Payne,President,Mitt Romney,REP,600102,23,22,634,679,
Payne,U.S. House,Timothy Ray Murray,DEM,600102,12,9,169,190,03
Payne,U.S. House,Frank Lucas,REP,600102,24,23,622,669,03
Payne,U.S. House,William Sanders,IND,600102,0,0,42,42,03
Payne,President,Barack Obama,DEM,600103,9,4,203,216,
Payne,President,Mitt Romney,REP,600103,19,15,557,591,
Payne,U.S. House,Timothy Ray Murray,DEM,600103,8,4,157,169,03
Payne,U.S. House,Frank Lucas,REP,600103,18,13,568,599,03
Payne,U.S. House,William Sanders,IND,600103,0,2,29,31,03
Payne,President,Barack Obama,DEM,600104,7,4,158,169,
Payne,President,Mitt Romney,REP,600104,35,15,590,640,
Payne,U.S. House,Timothy Ray Murray,DEM,600104,5,4,141,150,03
Payne,U.S. House,Frank Lucas,REP,600104,36,15,581,632,03
Payne,U.S. House,William Sanders,IND,600104,0,0,21,21,03
Payne,President,Barack Obama,DEM,600201,3,5,253,261,
Payne,President,Mitt Romney,REP,600201,18,15,573,606,
Payne,U.S. House,Timothy Ray Murray,DEM,600201,4,5,217,226,03
Payne,U.S. House,Frank Lucas,REP,600201,14,15,568,597,03
Payne,U.S. House,William Sanders,IND,600201,0,0,35,35,03
Payne,President,Barack Obama,DEM,600301,10,55,404,469,
Payne,President,Mitt Romney,REP,600301,33,119,1080,1232,
Payne,U.S. House,Timothy Ray Murray,DEM,600301,6,48,290,344,03
Payne,U.S. House,Frank Lucas,REP,600301,36,122,1116,1274,03
Payne,U.S. House,William Sanders,IND,600301,0,3,77,80,03
Payne,President,Barack Obama,DEM,600401,33,144,415,592,
Payne,President,Mitt Romney,REP,600401,59,236,861,1156,
Payne,U.S. House,Timothy Ray Murray,DEM,600401,26,98,293,417,03
Payne,U.S. House,Frank Lucas,REP,600401,55,270,897,1222,03
Payne,U.S. House,William Sanders,IND,600401,9,6,68,83,03
Payne,President,Barack Obama,DEM,600402,12,40,175,227,
Payne,President,Mitt Romney,REP,600402,25,97,362,484,
Payne,U.S. House,Timothy Ray Murray,DEM,600402,10,32,134,176,03
Payne,U.S. House,Frank Lucas,REP,600402,25,97,380,502,03
Payne,U.S. House,William Sanders,IND,600402,1,7,21,29,03
Payne,President,Barack Obama,DEM,600403,4,30,115,149,
Payne,President,Mitt Romney,REP,600403,15,59,365,439,
Payne,U.S. House,Timothy Ray Murray,DEM,600403,4,25,78,107,03
Payne,U.S. House,Frank Lucas,REP,600403,13,61,375,449,03
Payne,U.S. House,William Sanders,IND,600403,0,2,25,27,03
Payne,President,Barack Obama,DEM,600404,0,18,31,49,
Payne,President,Mitt Romney,REP,600404,6,12,70,88,
Payne,U.S. House,Timothy Ray Murray,DEM,600404,0,10,18,28,03
Payne,U.S. House,Frank Lucas,REP,600404,6,17,77,100,03
Payne,U.S. House,William Sanders,IND,600404,0,4,5,9,03
Payne,President,Barack Obama,DEM,600405,15,38,205,258,
Payne,President,Mitt Romney,REP,600405,26,66,595,687,
Payne,U.S. House,Timothy Ray Murray,DEM,600405,7,31,141,179,03
Payne,U.S. House,Frank Lucas,REP,600405,31,65,614,710,03
Payne,U.S. House,William Sanders,IND,600405,1,7,40,48,03
Payne,President,Barack Obama,DEM,600406,7,16,152,175,
Payne,President,Mitt Romney,REP,600406,17,49,471,537,
Payne,U.S. House,Timothy Ray Murray,DEM,600406,7,13,116,136,03
Payne,U.S. House,Frank Lucas,REP,600406,15,48,473,536,03
Payne,U.S. House,William Sanders,IND,600406,2,4,25,31,03
Payne,President,Barack Obama,DEM,600407,13,32,204,249,
Payne,President,Mitt Romney,REP,600407,14,74,530,618,
Payne,U.S. House,Timothy Ray Murray,DEM,600407,9,18,146,173,03
Payne,U.S. House,Frank Lucas,REP,600407,17,84,547,648,03
Payne,U.S. House,William Sanders,IND,600407,1,5,36,42,03
Payne,President,Barack Obama,DEM,600408,4,10,77,91,
Payne,President,Mitt Romney,REP,600408,10,19,152,181,
Payne,U.S. House,Timothy Ray Murray,DEM,600408,1,7,51,59,03
Payne,U.S. House,Frank Lucas,REP,600408,10,20,164,194,03
Payne,U.S. House,William Sanders,IND,600408,2,2,13,17,03
Payne,President,Barack Obama,DEM,600409,9,25,152,186,
Payne,President,Mitt Romney,REP,600409,16,68,470,554,
Payne,U.S. House,Timothy Ray Murray,DEM,600409,5,17,108,130,03
Payne,U.S. House,Frank Lucas,REP,600409,17,73,462,552,03
Payne,U.S. House,William Sanders,IND,600409,1,3,48,52,03
Pittsburg,President,Barack Obama,DEM,610001,3,4,61,68,
Pittsburg,President,Mitt Romney,REP,610001,0,5,28,33,
Pittsburg,U.S. House,Rob Wallace,DEM,610001,3,5,61,69,02
Pittsburg,U.S. House,Markwayne Mullin,REP,610001,0,4,21,25,02
Pittsburg,U.S. House,Michael Fulks,IND,610001,0,0,7,7,02
Pittsburg,State Senate,J. Paul Lane,DEM,610001,3,5,65,73,7
Pittsburg,State Senate,Larry Boggs,REP,610001,0,4,24,28,7
Pittsburg,President,Barack Obama,DEM,610003,13,34,192,239,
Pittsburg,President,Mitt Romney,REP,610003,22,44,298,364,
Pittsburg,U.S. House,Rob Wallace,DEM,610003,14,39,240,293,02
Pittsburg,U.S. House,Markwayne Mullin,REP,610003,21,37,227,285,02
Pittsburg,U.S. House,Michael Fulks,IND,610003,1,2,20,23,02
Pittsburg,State Senate,J. Paul Lane,DEM,610003,18,39,270,327,7
Pittsburg,State Senate,Larry Boggs,REP,610003,18,35,218,271,7
Pittsburg,President,Barack Obama,DEM,610004,8,45,246,299,
Pittsburg,President,Mitt Romney,REP,610004,30,100,577,707,
Pittsburg,U.S. House,Rob Wallace,DEM,610004,11,64,310,385,02
Pittsburg,U.S. House,Markwayne Mullin,REP,610004,25,76,470,571,02
Pittsburg,U.S. House,Michael Fulks,IND,610004,1,7,35,43,02
Pittsburg,State Senate,J. Paul Lane,DEM,610004,12,79,423,514,7
Pittsburg,State Senate,Larry Boggs,REP,610004,23,67,402,492,7
Pittsburg,President,Barack Obama,DEM,610005,4,21,138,163,
Pittsburg,President,Mitt Romney,REP,610005,4,34,271,309,
Pittsburg,U.S. House,Rob Wallace,DEM,610005,4,22,186,212,02
Pittsburg,U.S. House,Markwayne Mullin,REP,610005,3,29,203,235,02
Pittsburg,U.S. House,Michael Fulks,IND,610005,1,4,15,20,02
Pittsburg,State Senate,J. Paul Lane,DEM,610005,5,33,213,251,7
Pittsburg,State Senate,Larry Boggs,REP,610005,3,22,193,218,7
Pittsburg,President,Barack Obama,DEM,610006,15,22,99,136,
Pittsburg,President,Mitt Romney,REP,610006,14,42,257,313,
Pittsburg,U.S. House,Rob Wallace,DEM,610006,16,26,130,172,02
Pittsburg,U.S. House,Markwayne Mullin,REP,610006,11,34,204,249,02
Pittsburg,U.S. House,Michael Fulks,IND,610006,2,4,16,22,02
Pittsburg,State Senate,J. Paul Lane,DEM,610006,17,40,195,252,7
Pittsburg,State Senate,Larry Boggs,REP,610006,11,25,157,193,7
Pittsburg,President,Barack Obama,DEM,610007,5,26,122,153,
Pittsburg,President,Mitt Romney,REP,610007,12,41,288,341,
Pittsburg,U.S. House,Rob Wallace,DEM,610007,7,30,153,190,02
Pittsburg,U.S. House,Markwayne Mullin,REP,610007,8,35,238,281,02
Pittsburg,U.S. House,Michael Fulks,IND,610007,0,1,15,16,02
Pittsburg,State Senate,J. Paul Lane,DEM,610007,5,42,214,261,7
Pittsburg,State Senate,Larry Boggs,REP,610007,10,24,195,229,7
Pittsburg,President,Barack Obama,DEM,610008,5,13,150,168,
Pittsburg,President,Mitt Romney,REP,610008,10,15,239,264,
Pittsburg,U.S. House,Rob Wallace,DEM,610008,5,16,193,214,02
Pittsburg,U.S. House,Markwayne Mullin,REP,610008,9,11,172,192,02
Pittsburg,U.S. House,Michael Fulks,IND,610008,1,1,20,22,02
Pittsburg,State Senate,J. Paul Lane,DEM,610008,10,17,223,250,7
Pittsburg,State Senate,Larry Boggs,REP,610008,5,11,162,178,7
Pittsburg,President,Barack Obama,DEM,610011,17,35,233,285,
Pittsburg,President,Mitt Romney,REP,610011,32,72,457,561,
Pittsburg,U.S. House,Rob Wallace,DEM,610011,21,53,322,396,02
Pittsburg,U.S. House,Markwayne Mullin,REP,610011,24,47,327,398,02
Pittsburg,U.S. House,Michael Fulks,IND,610011,2,7,38,47,02
Pittsburg,State Senate,J. Paul Lane,DEM,610011,22,66,374,462,7
Pittsburg,State Senate,Larry Boggs,REP,610011,24,39,317,380,7
Pittsburg,President,Barack Obama,DEM,610014,3,39,199,241,
Pittsburg,President,Mitt Romney,REP,610014,14,53,429,496,
Pittsburg,U.S. House,Rob Wallace,DEM,610014,3,44,287,334,02
Pittsburg,U.S. House,Markwayne Mullin,REP,610014,13,46,316,375,02
Pittsburg,U.S. House,Michael Fulks,IND,610014,1,2,24,27,02
Pittsburg,State Senate,J. Paul Lane,DEM,610014,7,53,320,380,7
Pittsburg,State Senate,Larry Boggs,REP,610014,8,39,307,354,7
Pittsburg,President,Barack Obama,DEM,610015,4,12,109,125,
Pittsburg,President,Mitt Romney,REP,610015,1,5,49,55,
Pittsburg,U.S. House,Rob Wallace,DEM,610015,3,12,106,121,02
Pittsburg,U.S. House,Markwayne Mullin,REP,610015,0,5,42,47,02
Pittsburg,U.S. House,Michael Fulks,IND,610015,1,0,8,9,02
Pittsburg,State Senate,J. Paul Lane,DEM,610015,2,13,117,132,7
Pittsburg,State Senate,Larry Boggs,REP,610015,1,4,39,44,7
Pittsburg,President,Barack Obama,DEM,610019,0,2,57,59,
Pittsburg,President,Mitt Romney,REP,610019,2,4,140,146,
Pittsburg,U.S. House,Rob Wallace,DEM,610019,0,2,90,92,02
Pittsburg,U.S. House,Markwayne Mullin,REP,610019,2,3,100,105,02
Pittsburg,U.S. House,Michael Fulks,IND,610019,0,0,8,8,02
Pittsburg,State Senate,J. Paul Lane,DEM,610019,0,2,91,93,7
Pittsburg,State Senate,Larry Boggs,REP,610019,2,3,105,110,7
Pittsburg,President,Barack Obama,DEM,610020,3,6,23,32,
Pittsburg,President,Mitt Romney,REP,610020,4,8,57,69,
Pittsburg,U.S. House,Rob Wallace,DEM,610020,3,6,29,38,02
Pittsburg,U.S. House,Markwayne Mullin,REP,610020,3,7,47,57,02
Pittsburg,U.S. House,Michael Fulks,IND,610020,1,0,4,5,02
Pittsburg,State Senate,J. Paul Lane,DEM,610020,5,7,37,49,7
Pittsburg,State Senate,Larry Boggs,REP,610020,2,7,42,51,7
Pittsburg,President,Barack Obama,DEM,610021,6,10,118,134,
Pittsburg,President,Mitt Romney,REP,610021,10,37,346,393,
Pittsburg,U.S. House,Rob Wallace,DEM,610021,6,18,203,227,02
Pittsburg,U.S. House,Markwayne Mullin,REP,610021,10,27,239,276,02
Pittsburg,U.S. House,Michael Fulks,IND,610021,0,2,18,20,02
Pittsburg,State Senate,J. Paul Lane,DEM,610021,8,20,213,241,7
Pittsburg,State Senate,Larry Boggs,REP,610021,6,26,253,285,7
Pittsburg,President,Barack Obama,DEM,610023,2,1,21,24,
Pittsburg,President,Mitt Romney,REP,610023,2,5,89,96,
Pittsburg,U.S. House,Rob Wallace,DEM,610023,3,4,47,54,02
Pittsburg,U.S. House,Markwayne Mullin,REP,610023,1,2,56,59,02
Pittsburg,U.S. House,Michael Fulks,IND,610023,0,0,4,4,02
Pittsburg,State Senate,J. Paul Lane,DEM,610023,2,3,47,52,7
Pittsburg,State Senate,Larry Boggs,REP,610023,2,3,61,66,7
Pittsburg,President,Barack Obama,DEM,610026,1,7,77,85,
Pittsburg,President,Mitt Romney,REP,610026,7,23,224,254,
Pittsburg,U.S. House,Rob Wallace,DEM,610026,1,10,100,111,02
Pittsburg,U.S. House,Markwayne Mullin,REP,610026,6,16,185,207,02
Pittsburg,U.S. House,Michael Fulks,IND,610026,1,4,18,23,02
Pittsburg,State Senate,J. Paul Lane,DEM,610026,0,16,122,138,7
Pittsburg,State Senate,Larry Boggs,REP,610026,6,14,180,200,7
Pittsburg,President,Barack Obama,DEM,610027,12,6,206,224,
Pittsburg,President,Mitt Romney,REP,610027,44,36,579,659,
Pittsburg,U.S. House,Rob Wallace,DEM,610027,12,11,252,275,02
Pittsburg,U.S. House,Markwayne Mullin,REP,610027,39,31,477,547,02
Pittsburg,U.S. House,Michael Fulks,IND,610027,5,0,50,55,02
Pittsburg,State Senate,J. Paul Lane,DEM,610027,16,6,282,304,7
Pittsburg,State Senate,Larry Boggs,REP,610027,40,34,495,569,7
Pittsburg,President,Barack Obama,DEM,610028,2,2,58,62,
Pittsburg,President,Mitt Romney,REP,610028,3,10,111,124,
Pittsburg,U.S. House,Rob Wallace,DEM,610028,1,4,72,77,02
Pittsburg,U.S. House,Markwayne Mullin,REP,610028,4,8,85,97,02
Pittsburg,U.S. House,Michael Fulks,IND,610028,1,0,13,14,02
Pittsburg,State Senate,J. Paul Lane,DEM,610028,4,7,95,106,7
Pittsburg,State Senate,Larry Boggs,REP,610028,2,5,75,82,7
Pittsburg,President,Barack Obama,DEM,610029,4,6,51,61,
Pittsburg,President,Mitt Romney,REP,610029,5,10,152,167,
Pittsburg,U.S. House,Rob Wallace,DEM,610029,6,8,84,98,02
Pittsburg,U.S. House,Markwayne Mullin,REP,610029,3,7,110,120,02
Pittsburg,U.S. House,Michael Fulks,IND,610029,0,1,9,10,02
Pittsburg,State Senate,J. Paul Lane,DEM,610029,6,8,74,88,7
Pittsburg,State Senate,Larry Boggs,REP,610029,3,8,126,137,7
Pittsburg,President,Barack Obama,DEM,610030,2,4,48,54,
Pittsburg,President,Mitt Romney,REP,610030,8,7,154,169,
Pittsburg,U.S. House,Rob Wallace,DEM,610030,1,4,74,79,02
Pittsburg,U.S. House,Markwayne Mullin,REP,610030,8,6,124,138,02
Pittsburg,U.S. House,Michael Fulks,IND,610030,1,1,9,11,02
Pittsburg,State Senate,J. Paul Lane,DEM,610030,1,8,88,97,7
Pittsburg,State Senate,Larry Boggs,REP,610030,8,3,116,127,7
Pittsburg,President,Barack Obama,DEM,610031,8,6,94,108,
Pittsburg,President,Mitt Romney,REP,610031,17,17,249,283,
Pittsburg,U.S. House,Rob Wallace,DEM,610031,10,7,107,124,02
Pittsburg,U.S. House,Markwayne Mullin,REP,610031,14,15,223,252,02
Pittsburg,U.S. House,Michael Fulks,IND,610031,1,1,11,13,02
Pittsburg,State Senate,J. Paul Lane,DEM,610031,10,9,124,143,7
Pittsburg,State Senate,Larry Boggs,REP,610031,15,15,218,248,7
Pittsburg,President,Barack Obama,DEM,610032,16,33,150,199,
Pittsburg,President,Mitt Romney,REP,610032,42,118,538,698,
Pittsburg,U.S. House,Rob Wallace,DEM,610032,20,43,218,281,02
Pittsburg,U.S. House,Markwayne Mullin,REP,610032,34,105,424,563,02
Pittsburg,U.S. House,Michael Fulks,IND,610032,2,3,38,43,02
Pittsburg,State Senate,J. Paul Lane,DEM,610032,29,73,314,416,7
Pittsburg,State Senate,Larry Boggs,REP,610032,28,78,373,479,7
Pittsburg,President,Barack Obama,DEM,610033,6,5,115,126,
Pittsburg,President,Mitt Romney,REP,610033,5,7,209,221,
Pittsburg,U.S. House,Rob Wallace,DEM,610033,6,5,146,157,02
Pittsburg,U.S. House,Markwayne Mullin,REP,610033,5,7,153,165,02
Pittsburg,U.S. House,Michael Fulks,IND,610033,0,0,18,18,02
Pittsburg,State Senate,J. Paul Lane,DEM,610033,9,4,177,190,7
Pittsburg,State Senate,Larry Boggs,REP,610033,2,8,145,155,7
Pittsburg,President,Barack Obama,DEM,610034,6,9,193,208,
Pittsburg,President,Mitt Romney,REP,610034,2,15,358,375,
Pittsburg,U.S. House,Rob Wallace,DEM,610034,6,10,275,291,02
Pittsburg,U.S. House,Markwayne Mullin,REP,610034,2,11,242,255,02
Pittsburg,U.S. House,Michael Fulks,IND,610034,0,3,34,37,02
Pittsburg,State Senate,J. Paul Lane,DEM,610034,6,13,282,301,7
Pittsburg,State Senate,Larry Boggs,REP,610034,2,11,270,283,7
Pittsburg,President,Barack Obama,DEM,610035,8,6,154,168,
Pittsburg,President,Mitt Romney,REP,610035,4,4,210,218,
Pittsburg,U.S. House,Rob Wallace,DEM,610035,7,6,205,218,02
Pittsburg,U.S. House,Markwayne Mullin,REP,610035,3,3,142,148,02
Pittsburg,U.S. House,Michael Fulks,IND,610035,0,1,16,17,02
Pittsburg,State Senate,J. Paul Lane,DEM,610035,8,8,194,210,7
Pittsburg,State Senate,Larry Boggs,REP,610035,3,2,168,173,7
Pittsburg,President,Barack Obama,DEM,610036,3,4,29,36,
Pittsburg,President,Mitt Romney,REP,610036,5,20,86,111,
Pittsburg,U.S. House,Rob Wallace,DEM,610036,4,11,33,48,02
Pittsburg,U.S. House,Markwayne Mullin,REP,610036,4,8,76,88,02
Pittsburg,U.S. House,Michael Fulks,IND,610036,0,5,6,11,02
Pittsburg,State Senate,J. Paul Lane,DEM,610036,4,8,43,55,7
Pittsburg,State Senate,Larry Boggs,REP,610036,4,16,73,93,7
Pittsburg,President,Barack Obama,DEM,610037,6,13,138,157,
Pittsburg,President,Mitt Romney,REP,610037,22,33,439,494,
Pittsburg,U.S. House,Rob Wallace,DEM,610037,7,19,217,243,02
Pittsburg,U.S. House,Markwayne Mullin,REP,610037,21,26,340,387,02
Pittsburg,U.S. House,Michael Fulks,IND,610037,0,1,18,19,02
Pittsburg,State Senate,J. Paul Lane,DEM,610037,8,21,219,248,7
Pittsburg,State Senate,Larry Boggs,REP,610037,17,25,357,399,7
Pittsburg,President,Barack Obama,DEM,610038,0,0,5,5,
Pittsburg,President,Mitt Romney,REP,610038,0,4,28,32,
Pittsburg,U.S. House,Rob Wallace,DEM,610038,0,0,10,10,02
Pittsburg,U.S. House,Markwayne Mullin,REP,610038,0,4,21,25,02
Pittsburg,U.S. House,Michael Fulks,IND,610038,0,0,1,1,02
Pittsburg,State Senate,J. Paul Lane,DEM,610038,0,0,11,11,7
Pittsburg,State Senate,Larry Boggs,REP,610038,0,3,21,24,7
Pittsburg,President,Barack Obama,DEM,610039,2,4,96,102,
Pittsburg,President,Mitt Romney,REP,610039,12,14,286,312,
Pittsburg,U.S. House,Rob Wallace,DEM,610039,2,6,162,170,02
Pittsburg,U.S. House,Markwayne Mullin,REP,610039,12,12,201,225,02
Pittsburg,U.S. House,Michael Fulks,IND,610039,0,0,17,17,02
Pittsburg,State Senate,J. Paul Lane,DEM,610039,2,6,173,181,7
Pittsburg,State Senate,Larry Boggs,REP,610039,12,12,209,233,7
Pittsburg,President,Barack Obama,DEM,610040,3,7,74,84,
Pittsburg,President,Mitt Romney,REP,610040,4,23,229,256,
Pittsburg,U.S. House,Rob Wallace,DEM,610040,3,12,110,125,02
Pittsburg,U.S. House,Markwayne Mullin,REP,610040,4,19,178,201,02
Pittsburg,U.S. House,Michael Fulks,IND,610040,0,0,12,12,02
Pittsburg,State Senate,J. Paul Lane,DEM,610040,2,9,150,161,7
Pittsburg,State Senate,Larry Boggs,REP,610040,5,22,150,177,7
Pittsburg,President,Barack Obama,DEM,610041,8,14,200,222,
Pittsburg,President,Mitt Romney,REP,610041,13,28,400,441,
Pittsburg,U.S. House,Rob Wallace,DEM,610041,10,15,265,290,02
Pittsburg,U.S. House,Markwayne Mullin,REP,610041,10,26,292,328,02
Pittsburg,U.S. House,Michael Fulks,IND,610041,1,1,41,43,02
Pittsburg,State Senate,J. Paul Lane,DEM,610041,12,20,307,339,7
Pittsburg,State Senate,Larry Boggs,REP,610041,9,22,298,329,7
Pittsburg,President,Barack Obama,DEM,610042,7,29,127,163,
Pittsburg,President,Mitt Romney,REP,610042,8,58,238,304,
Pittsburg,U.S. House,Rob Wallace,DEM,610042,8,33,156,197,02
Pittsburg,U.S. House,Markwayne Mullin,REP,610042,8,49,185,242,02
Pittsburg,U.S. House,Michael Fulks,IND,610042,0,4,25,29,02
Pittsburg,State Senate,J. Paul Lane,DEM,610042,8,40,191,239,7
Pittsburg,State Senate,Larry Boggs,REP,610042,8,46,174,228,7
Pittsburg,President,Barack Obama,DEM,610043,4,2,70,76,
Pittsburg,President,Mitt Romney,REP,610043,2,11,210,223,
Pittsburg,U.S. House,Rob Wallace,DEM,610043,3,8,125,136,02
Pittsburg,U.S. House,Markwayne Mullin,REP,610043,2,4,143,149,02
Pittsburg,U.S. House,Michael Fulks,IND,610043,1,0,10,11,02
Pittsburg,State Senate,J. Paul Lane,DEM,610043,5,6,134,145,7
Pittsburg,State Senate,Larry Boggs,REP,610043,1,7,148,156,7
Pittsburg,President,Barack Obama,DEM,610044,5,4,146,155,
Pittsburg,President,Mitt Romney,REP,610044,10,2,314,326,
Pittsburg,U.S. House,Rob Wallace,DEM,610044,6,5,200,211,02
Pittsburg,U.S. House,Markwayne Mullin,REP,610044,8,2,230,240,02
Pittsburg,U.S. House,Michael Fulks,IND,610044,1,0,26,27,02
Pittsburg,State Senate,J. Paul Lane,DEM,610044,7,5,208,220,7
Pittsburg,State Senate,Larry Boggs,REP,610044,8,2,248,258,7
Pittsburg,President,Barack Obama,DEM,610045,0,0,3,3,
Pittsburg,President,Mitt Romney,REP,610045,0,0,5,5,
Pittsburg,U.S. House,Rob Wallace,DEM,610045,0,0,3,3,02
Pittsburg,U.S. House,Markwayne Mullin,REP,610045,0,0,5,5,02
Pittsburg,U.S. House,Michael Fulks,IND,610045,0,0,0,0,02
Pittsburg,State Senate,J. Paul Lane,DEM,610045,0,0,4,4,7
Pittsburg,State Senate,Larry Boggs,REP,610045,0,0,4,4,7
Pittsburg,President,Barack Obama,DEM,610046,0,7,35,42,
Pittsburg,President,Mitt Romney,REP,610046,8,33,153,194,
Pittsburg,U.S. House,Rob Wallace,DEM,610046,0,12,53,65,02
Pittsburg,U.S. House,Markwayne Mullin,REP,610046,8,28,124,160,02
Pittsburg,U.S. House,Michael Fulks,IND,610046,0,0,9,9,02
Pittsburg,State Senate,J. Paul Lane,DEM,610046,1,12,71,84,7
Pittsburg,State Senate,Larry Boggs,REP,610046,7,27,117,151,7
Pittsburg,President,Barack Obama,DEM,610047,4,4,114,122,
Pittsburg,President,Mitt Romney,REP,610047,2,11,251,264,
Pittsburg,U.S. House,Rob Wallace,DEM,610047,4,6,173,183,02
Pittsburg,U.S. House,Markwayne Mullin,REP,610047,2,9,183,194,02
Pittsburg,U.S. House,Michael Fulks,IND,610047,0,0,8,8,02
Pittsburg,State Senate,J. Paul Lane,DEM,610047,3,8,198,209,7
Pittsburg,State Senate,Larry Boggs,REP,610047,3,6,165,174,7
Pittsburg,President,Barack Obama,DEM,610048,1,2,30,33,
Pittsburg,President,Mitt Romney,REP,610048,2,7,69,78,
Pittsburg,U.S. House,Rob Wallace,DEM,610048,1,3,41,45,02
Pittsburg,U.S. House,Markwayne Mullin,REP,610048,2,5,50,57,02
Pittsburg,U.S. House,Michael Fulks,IND,610048,0,1,3,4,02
Pittsburg,State Senate,J. Paul Lane,DEM,610048,1,3,48,52,7
Pittsburg,State Senate,Larry Boggs,REP,610048,2,6,49,57,7
Pittsburg,President,Barack Obama,DEM,610049,3,8,107,118,
Pittsburg,President,Mitt Romney,REP,610049,16,26,263,305,
Pittsburg,U.S. House,Rob Wallace,DEM,610049,2,13,159,174,02
Pittsburg,U.S. House,Markwayne Mullin,REP,610049,13,20,197,230,02
Pittsburg,U.S. House,Michael Fulks,IND,610049,4,3,14,21,02
Pittsburg,State Senate,J. Paul Lane,DEM,610049,6,18,166,190,7
Pittsburg,State Senate,Larry Boggs,REP,610049,11,19,202,232,7
Pittsburg,President,Barack Obama,DEM,610051,0,1,60,61,
Pittsburg,President,Mitt Romney,REP,610051,1,3,119,123,
Pittsburg,U.S. House,Rob Wallace,DEM,610051,0,1,80,81,02
Pittsburg,U.S. House,Markwayne Mullin,REP,610051,1,3,95,99,02
Pittsburg,U.S. House,Michael Fulks,IND,610051,0,0,4,4,02
Pittsburg,State Senate,J. Paul Lane,DEM,610051,1,0,89,90,7
Pittsburg,State Senate,Larry Boggs,REP,610051,0,4,88,92,7
Pittsburg,President,Barack Obama,DEM,610052,0,0,3,3,
Pittsburg,President,Mitt Romney,REP,610052,0,1,12,13,
Pittsburg,U.S. House,Rob Wallace,DEM,610052,0,1,2,3,02
Pittsburg,U.S. House,Markwayne Mullin,REP,610052,0,0,13,13,02
Pittsburg,U.S. House,Michael Fulks,IND,610052,0,0,0,0,02
Pittsburg,State Senate,J. Paul Lane,DEM,610052,0,0,3,3,7
Pittsburg,State Senate,Larry Boggs,REP,610052,0,1,11,12,7
Pittsburg,President,Barack Obama,DEM,610053,0,5,23,28,
Pittsburg,President,Mitt Romney,REP,610053,1,5,39,45,
Pittsburg,U.S. House,Rob Wallace,DEM,610053,0,5,34,39,02
Pittsburg,U.S. House,Markwayne Mullin,REP,610053,1,3,25,29,02
Pittsburg,U.S. House,Michael Fulks,IND,610053,0,2,1,3,02
Pittsburg,State Senate,J. Paul Lane,DEM,610053,0,9,33,42,7
Pittsburg,State Senate,Larry Boggs,REP,610053,1,1,28,30,7
Pontotoc,President,Barack Obama,DEM,620013,8,64,271,343,
Pontotoc,President,Mitt Romney,REP,620013,29,133,455,617,
Pontotoc,U.S. House,Donna Marie Bebo,DEM,620013,6,53,209,268,04
Pontotoc,U.S. House,Tom Cole,REP,620013,29,134,486,649,04
Pontotoc,U.S. House,Rj Harris,IND,620013,1,9,31,41,04
Pontotoc,State Senate,Susan Paddack,DEM,620013,25,154,619,798,13
Pontotoc,State Senate,Fred Smith,REP,620013,10,38,106,154,13
Pontotoc,President,Barack Obama,DEM,620016,21,67,298,386,
Pontotoc,President,Mitt Romney,REP,620016,34,191,664,889,
Pontotoc,U.S. House,Donna Marie Bebo,DEM,620016,18,55,231,304,04
Pontotoc,U.S. House,Tom Cole,REP,620016,35,199,691,925,04
Pontotoc,U.S. House,Rj Harris,IND,620016,1,4,33,38,04
Pontotoc,State Senate,Susan Paddack,DEM,620016,44,208,805,1057,13
Pontotoc,State Senate,Fred Smith,REP,620016,11,48,151,210,13
Pontotoc,President,Barack Obama,DEM,620022,10,56,245,311,
Pontotoc,President,Mitt Romney,REP,620022,16,73,401,490,
Pontotoc,U.S. House,Donna Marie Bebo,DEM,620022,10,44,188,242,04
Pontotoc,U.S. House,Tom Cole,REP,620022,15,83,426,524,04
Pontotoc,U.S. House,Rj Harris,IND,620022,0,5,30,35,04
Pontotoc,State Senate,Susan Paddack,DEM,620022,22,103,523,648,13
Pontotoc,State Senate,Fred Smith,REP,620022,3,28,122,153,13
Pontotoc,President,Barack Obama,DEM,620025,14,49,269,332,
Pontotoc,President,Mitt Romney,REP,620025,29,133,618,780,
Pontotoc,U.S. House,Donna Marie Bebo,DEM,620025,10,40,195,245,04
Pontotoc,U.S. House,Tom Cole,REP,620025,30,137,664,831,04
Pontotoc,U.S. House,Rj Harris,IND,620025,2,6,27,35,04
Pontotoc,State Senate,Susan Paddack,DEM,620025,34,158,737,929,13
Pontotoc,State Senate,Fred Smith,REP,620025,8,24,145,177,13
Pontotoc,President,Barack Obama,DEM,620031,26,81,367,474,
Pontotoc,President,Mitt Romney,REP,620031,24,87,477,588,
Pontotoc,U.S. House,Donna Marie Bebo,DEM,620031,26,68,289,383,04
Pontotoc,U.S. House,Tom Cole,REP,620031,22,95,500,617,04
Pontotoc,U.S. House,Rj Harris,IND,620031,1,5,53,59,04
Pontotoc,State Senate,Susan Paddack,DEM,620031,40,148,664,852,13
Pontotoc,State Senate,Fred Smith,REP,620031,9,18,178,205,13
Pontotoc,President,Barack Obama,DEM,620051,5,4,90,99,
Pontotoc,President,Mitt Romney,REP,620051,11,12,237,260,
Pontotoc,U.S. House,Donna Marie Bebo,DEM,620051,5,4,70,79,04
Pontotoc,U.S. House,Tom Cole,REP,620051,10,11,240,261,04
Pontotoc,U.S. House,Rj Harris,IND,620051,0,1,14,15,04
Pontotoc,State Senate,Susan Paddack,DEM,620051,7,15,266,288,13
Pontotoc,State Senate,Fred Smith,REP,620051,8,1,65,74,13
Pontotoc,President,Barack Obama,DEM,620052,3,21,163,187,
Pontotoc,President,Mitt Romney,REP,620052,10,44,260,314,
Pontotoc,U.S. House,Donna Marie Bebo,DEM,620052,2,18,141,161,04
Pontotoc,U.S. House,Tom Cole,REP,620052,11,43,268,322,04
Pontotoc,U.S. House,Rj Harris,IND,620052,0,3,20,23,04
Pontotoc,State Senate,Susan Paddack,DEM,620052,11,47,347,405,13
Pontotoc,State Senate,Fred Smith,REP,620052,1,16,80,97,13
Pontotoc,President,Barack Obama,DEM,620053,13,79,231,323,
Pontotoc,President,Mitt Romney,REP,620053,37,185,632,854,
Pontotoc,U.S. House,Donna Marie Bebo,DEM,620053,11,56,187,254,04
Pontotoc,U.S. House,Tom Cole,REP,620053,36,201,642,879,04
Pontotoc,U.S. House,Rj Harris,IND,620053,4,6,29,39,04
Pontotoc,State Senate,Susan Paddack,DEM,620053,35,230,713,978,13
Pontotoc,State Senate,Fred Smith,REP,620053,16,32,137,185,13
Pontotoc,President,Barack Obama,DEM,620054,1,1,35,37,
Pontotoc,President,Mitt Romney,REP,620054,3,6,120,129,
Pontotoc,U.S. House,Donna Marie Bebo,DEM,620054,1,0,23,24,04
Pontotoc,U.S. House,Tom Cole,REP,620054,3,6,121,130,04
Pontotoc,U.S. House,Rj Harris,IND,620054,0,1,9,10,04
Pontotoc,State Senate,Susan Paddack,DEM,620054,3,6,111,120,13
Pontotoc,State Senate,Fred Smith,REP,620054,1,1,41,43,13
Pontotoc,President,Barack Obama,DEM,620055,5,13,42,60,
Pontotoc,President,Mitt Romney,REP,620055,3,20,140,163,
Pontotoc,U.S. House,Donna Marie Bebo,DEM,620055,6,9,38,53,04
Pontotoc,U.S. House,Tom Cole,REP,620055,2,22,138,162,04
Pontotoc,U.S. House,Rj Harris,IND,620055,0,1,5,6,04
Pontotoc,State Senate,Susan Paddack,DEM,620055,6,28,161,195,13
Pontotoc,State Senate,Fred Smith,REP,620055,2,4,20,26,13
Pontotoc,President,Barack Obama,DEM,620056,0,1,91,92,
Pontotoc,President,Mitt Romney,REP,620056,2,8,162,172,
Pontotoc,U.S. House,Donna Marie Bebo,DEM,620056,0,2,70,72,04
Pontotoc,U.S. House,Tom Cole,REP,620056,2,8,171,181,04
Pontotoc,U.S. House,Rj Harris,IND,620056,0,0,9,9,04
Pontotoc,State Senate,Susan Paddack,DEM,620056,1,8,198,207,13
Pontotoc,State Senate,Fred Smith,REP,620056,1,2,54,57,13
Pontotoc,President,Barack Obama,DEM,620058,5,16,161,182,
Pontotoc,President,Mitt Romney,REP,620058,17,62,451,530,
Pontotoc,U.S. House,Donna Marie Bebo,DEM,620058,3,8,139,150,04
Pontotoc,U.S. House,Tom Cole,REP,620058,18,67,455,540,04
Pontotoc,U.S. House,Rj Harris,IND,620058,1,2,22,25,04
Pontotoc,State Senate,Susan Paddack,DEM,620058,19,65,510,594,13
Pontotoc,State Senate,Fred Smith,REP,620058,3,13,107,123,13
Pontotoc,President,Barack Obama,DEM,620059,0,7,134,141,
Pontotoc,President,Mitt Romney,REP,620059,13,32,357,402,
Pontotoc,U.S. House,Donna Marie Bebo,DEM,620059,0,6,104,110,04
Pontotoc,U.S. House,Tom Cole,REP,620059,11,31,365,407,04
Pontotoc,U.S. House,Rj Harris,IND,620059,2,2,18,22,04
Pontotoc,State Senate,Susan Paddack,DEM,620059,7,28,397,432,13
Pontotoc,State Senate,Fred Smith,REP,620059,6,11,96,113,13
Pontotoc,President,Barack Obama,DEM,620060,8,18,194,220,
Pontotoc,President,Mitt Romney,REP,620060,9,42,437,488,
Pontotoc,U.S. House,Donna Marie Bebo,DEM,620060,5,15,152,172,04
Pontotoc,U.S. House,Tom Cole,REP,620060,10,39,460,509,04
Pontotoc,U.S. House,Rj Harris,IND,620060,1,5,24,30,04
Pontotoc,State Senate,Susan Paddack,DEM,620060,13,54,538,605,13
Pontotoc,State Senate,Fred Smith,REP,620060,1,5,92,98,13
Pontotoc,President,Barack Obama,DEM,620061,1,5,50,56,
Pontotoc,President,Mitt Romney,REP,620061,0,25,153,178,
Pontotoc,U.S. House,Donna Marie Bebo,DEM,620061,1,4,36,41,04
Pontotoc,U.S. House,Tom Cole,REP,620061,0,24,149,173,04
Pontotoc,U.S. House,Rj Harris,IND,620061,0,1,15,16,04
Pontotoc,State Senate,Susan Paddack,DEM,620061,1,24,167,192,13
Pontotoc,State Senate,Fred Smith,REP,620061,0,6,36,42,13
Pontotoc,President,Barack Obama,DEM,620062,4,11,140,155,
Pontotoc,President,Mitt Romney,REP,620062,7,49,374,430,
Pontotoc,U.S. House,Donna Marie Bebo,DEM,620062,1,11,109,121,04
Pontotoc,U.S. House,Tom Cole,REP,620062,9,50,385,444,04
Pontotoc,U.S. House,Rj Harris,IND,620062,1,0,17,18,04
Pontotoc,State Senate,Susan Paddack,DEM,620062,7,50,424,481,13
Pontotoc,State Senate,Fred Smith,REP,620062,4,10,93,107,13
Pontotoc,President,Barack Obama,DEM,620063,2,4,110,116,
Pontotoc,President,Mitt Romney,REP,620063,4,15,236,255,
Pontotoc,U.S. House,Donna Marie Bebo,DEM,620063,2,2,100,104,04
Pontotoc,U.S. House,Tom Cole,REP,620063,4,16,230,250,04
Pontotoc,U.S. House,Rj Harris,IND,620063,0,1,16,17,04
Pontotoc,State Senate,Susan Paddack,DEM,620063,5,15,276,296,13
Pontotoc,State Senate,Fred Smith,REP,620063,1,4,66,71,13
Pontotoc,President,Barack Obama,DEM,620064,2,15,117,134,
Pontotoc,President,Mitt Romney,REP,620064,6,40,329,375,
Pontotoc,U.S. House,Donna Marie Bebo,DEM,620064,3,15,93,111,04
Pontotoc,U.S. House,Tom Cole,REP,620064,5,40,333,378,04
Pontotoc,U.S. House,Rj Harris,IND,620064,0,2,25,27,04
Pontotoc,State Senate,Susan Paddack,DEM,620064,6,43,361,410,13
Pontotoc,State Senate,Fred Smith,REP,620064,2,12,88,102,13
Pontotoc,President,Barack Obama,DEM,620065,3,3,97,103,
Pontotoc,President,Mitt Romney,REP,620065,13,32,343,388,
Pontotoc,U.S. House,Donna Marie Bebo,DEM,620065,3,5,89,97,04
Pontotoc,U.S. House,Tom Cole,REP,620065,11,30,344,385,04
Pontotoc,U.S. House,Rj Harris,IND,620065,2,0,11,13,04
Pontotoc,State Senate,Susan Paddack,DEM,620065,7,30,355,392,13
Pontotoc,State Senate,Fred Smith,REP,620065,7,5,88,100,13
Pontotoc,President,Barack Obama,DEM,620066,5,15,102,122,
Pontotoc,President,Mitt Romney,REP,620066,5,40,320,365,
Pontotoc,U.S. House,Donna Marie Bebo,DEM,620066,4,8,82,94,04
Pontotoc,U.S. House,Tom Cole,REP,620066,6,45,325,376,04
Pontotoc,U.S. House,Rj Harris,IND,620066,0,1,18,19,04
Pontotoc,State Senate,Susan Paddack,DEM,620066,9,36,346,391,13
Pontotoc,State Senate,Fred Smith,REP,620066,1,17,79,97,13
Pontotoc,President,Barack Obama,DEM,620067,0,12,62,74,
Pontotoc,President,Mitt Romney,REP,620067,6,22,250,278,
Pontotoc,U.S. House,Donna Marie Bebo,DEM,620067,0,8,52,60,04
Pontotoc,U.S. House,Tom Cole,REP,620067,6,25,246,277,04
Pontotoc,U.S. House,Rj Harris,IND,620067,0,1,17,18,04
Pontotoc,State Senate,Susan Paddack,DEM,620067,3,27,249,279,13
Pontotoc,State Senate,Fred Smith,REP,620067,3,6,65,74,13
Pottawatomie,President,Barack Obama,DEM,630001,8,10,97,115,
Pottawatomie,President,Mitt Romney,REP,630001,15,33,257,305,
Pottawatomie,U.S. House,Tom Guild,DEM,630001,8,11,98,117,05
Pottawatomie,U.S. House,James Lankford,REP,630001,14,32,250,296,05
Pottawatomie,U.S. House,Pat Martin,IND,630001,0,0,1,1,05
Pottawatomie,U.S. House,Robert Murphy,IND,630001,0,0,5,5,05
Pottawatomie,State House,Patty Sue Wagstaff,DEM,630001,15,14,135,164,26
Pottawatomie,State House,Justin Freeland Wood,REP,630001,7,28,219,254,26
Pottawatomie,President,Barack Obama,DEM,630002,14,29,176,219,
Pottawatomie,President,Mitt Romney,REP,630002,8,38,290,336,
Pottawatomie,U.S. House,Tom Guild,DEM,630002,14,30,158,202,05
Pottawatomie,U.S. House,James Lankford,REP,630002,5,31,278,314,05
Pottawatomie,U.S. House,Pat Martin,IND,630002,2,2,16,20,05
Pottawatomie,U.S. House,Robert Murphy,IND,630002,1,4,11,16,05
Pottawatomie,State House,Patty Sue Wagstaff,DEM,630002,16,31,180,227,26
Pottawatomie,State House,Justin Freeland Wood,REP,630002,6,37,284,327,26
Pottawatomie,President,Barack Obama,DEM,630003,28,58,381,467,
Pottawatomie,President,Mitt Romney,REP,630003,12,77,466,555,
Pottawatomie,U.S. House,Tom Guild,DEM,630003,21,53,348,422,05
Pottawatomie,U.S. House,James Lankford,REP,630003,13,73,452,538,05
Pottawatomie,U.S. House,Pat Martin,IND,630003,3,5,26,34,05
Pottawatomie,U.S. House,Robert Murphy,IND,630003,1,1,21,23,05
Pottawatomie,State House,Patty Sue Wagstaff,DEM,630003,24,64,386,474,26
Pottawatomie,State House,Justin Freeland Wood,REP,630003,15,69,464,548,26
Pottawatomie,President,Barack Obama,DEM,630006,9,29,245,283,
Pottawatomie,President,Mitt Romney,REP,630006,24,72,478,574,
Pottawatomie,U.S. House,Tom Guild,DEM,630006,8,28,219,255,05
Pottawatomie,U.S. House,James Lankford,REP,630006,23,69,472,564,05
Pottawatomie,U.S. House,Pat Martin,IND,630006,0,1,14,15,05
Pottawatomie,U.S. House,Robert Murphy,IND,630006,1,1,11,13,05
Pottawatomie,State House,Patty Sue Wagstaff,DEM,630006,11,36,261,308,26
Pottawatomie,State House,Justin Freeland Wood,REP,630006,20,62,449,531,26
Pottawatomie,President,Barack Obama,DEM,630007,20,54,264,338,
Pottawatomie,President,Mitt Romney,REP,630007,19,121,522,662,
Pottawatomie,U.S. House,Tom Guild,DEM,630007,18,49,231,298,05
Pottawatomie,U.S. House,James Lankford,REP,630007,17,121,515,653,05
Pottawatomie,U.S. House,Pat Martin,IND,630007,3,2,21,26,05
Pottawatomie,U.S. House,Robert Murphy,IND,630007,1,2,14,17,05
Pottawatomie,State House,Patty Sue Wagstaff,DEM,630007,24,68,295,387,26
Pottawatomie,State House,Justin Freeland Wood,REP,630007,12,107,482,601,26
Pottawatomie,President,Barack Obama,DEM,630009,12,49,229,290,
Pottawatomie,President,Mitt Romney,REP,630009,33,157,673,863,
Pottawatomie,U.S. House,Tom Guild,DEM,630009,10,50,208,268,05
Pottawatomie,U.S. House,James Lankford,REP,630009,32,150,652,834,05
Pottawatomie,U.S. House,Pat Martin,IND,630009,1,2,25,28,05
Pottawatomie,U.S. House,Robert Murphy,IND,630009,1,4,10,15,05
Pottawatomie,State House,Patty Sue Wagstaff,DEM,630009,12,77,295,384,26
Pottawatomie,State House,Justin Freeland Wood,REP,630009,33,127,599,759,26
Pottawatomie,President,Barack Obama,DEM,630011,17,78,347,442,
Pottawatomie,President,Mitt Romney,REP,630011,50,139,862,1051,
Pottawatomie,U.S. House,Tom Guild,DEM,630011,16,66,311,393,05
Pottawatomie,U.S. House,James Lankford,REP,630011,51,150,863,1064,05
Pottawatomie,U.S. House,Pat Martin,IND,630011,0,0,17,17,05
Pottawatomie,U.S. House,Robert Murphy,IND,630011,0,0,18,18,05
Pottawatomie,State House,Patty Sue Wagstaff,DEM,630011,21,79,427,527,26
Pottawatomie,State House,Justin Freeland Wood,REP,630011,45,136,782,963,26
Pottawatomie,President,Barack Obama,DEM,630012,15,52,269,336,
Pottawatomie,President,Mitt Romney,REP,630012,23,99,496,618,
Pottawatomie,U.S. House,Tom Guild,DEM,630012,13,51,238,302,05
Pottawatomie,U.S. House,James Lankford,REP,630012,23,100,491,614,05
Pottawatomie,U.S. House,Pat Martin,IND,630012,1,1,16,18,05
Pottawatomie,U.S. House,Robert Murphy,IND,630012,1,0,12,13,05
Pottawatomie,State House,Patty Sue Wagstaff,DEM,630012,19,63,329,411,26
Pottawatomie,State House,Justin Freeland Wood,REP,630012,18,90,428,536,26
Pottawatomie,President,Barack Obama,DEM,630013,18,69,304,391,
Pottawatomie,President,Mitt Romney,REP,630013,38,146,692,876,
Pottawatomie,U.S. House,Tom Guild,DEM,630013,13,62,273,348,05
Pottawatomie,U.S. House,James Lankford,REP,630013,36,144,700,880,05
Pottawatomie,U.S. House,Pat Martin,IND,630013,2,2,6,10,05
Pottawatomie,U.S. House,Robert Murphy,IND,630013,0,4,16,20,05
Pottawatomie,State House,Patty Sue Wagstaff,DEM,630013,19,87,424,530,26
Pottawatomie,State House,Justin Freeland Wood,REP,630013,30,127,570,727,26
Pottawatomie,President,Barack Obama,DEM,630015,15,48,418,481,
Pottawatomie,President,Mitt Romney,REP,630015,25,85,595,705,
Pottawatomie,U.S. House,Tom Guild,DEM,630015,12,46,356,414,05
Pottawatomie,U.S. House,James Lankford,REP,630015,28,86,608,722,05
Pottawatomie,U.S. House,Pat Martin,IND,630015,0,2,25,27,05
Pottawatomie,U.S. House,Robert Murphy,IND,630015,0,1,24,25,05
Pottawatomie,State House,Patty Sue Wagstaff,DEM,630015,17,49,449,515,26
Pottawatomie,State House,Justin Freeland Wood,REP,630015,22,84,563,669,26
Pottawatomie,President,Barack Obama,DEM,630018,10,54,353,417,
Pottawatomie,President,Mitt Romney,REP,630018,26,81,549,656,
Pottawatomie,U.S. House,Tom Guild,DEM,630018,11,52,314,377,05
Pottawatomie,U.S. House,James Lankford,REP,630018,24,81,534,639,05
Pottawatomie,U.S. House,Pat Martin,IND,630018,0,0,31,31,05
Pottawatomie,U.S. House,Robert Murphy,IND,630018,2,1,18,21,05
Pottawatomie,State House,Patty Sue Wagstaff,DEM,630018,13,64,409,486,26
Pottawatomie,State House,Justin Freeland Wood,REP,630018,23,69,491,583,26
Pottawatomie,President,Barack Obama,DEM,630021,2,21,147,170,
Pottawatomie,President,Mitt Romney,REP,630021,12,28,382,422,
Pottawatomie,U.S. House,Tom Guild,DEM,630021,2,20,131,153,05
Pottawatomie,U.S. House,James Lankford,REP,630021,12,26,375,413,05
Pottawatomie,U.S. House,Pat Martin,IND,630021,0,0,14,14,05
Pottawatomie,U.S. House,Robert Murphy,IND,630021,0,2,8,10,05
Pottawatomie,State House,Patty Sue Wagstaff,DEM,630021,3,25,173,201,26
Pottawatomie,State House,Justin Freeland Wood,REP,630021,11,23,352,386,26
Pottawatomie,President,Barack Obama,DEM,630022,13,54,258,325,
Pottawatomie,President,Mitt Romney,REP,630022,31,151,770,952,
Pottawatomie,U.S. House,Tom Guild,DEM,630022,13,49,229,291,05
Pottawatomie,U.S. House,James Lankford,REP,630022,28,155,749,932,05
Pottawatomie,U.S. House,Pat Martin,IND,630022,0,3,12,15,05
Pottawatomie,U.S. House,Robert Murphy,IND,630022,1,3,28,32,05
Pottawatomie,State House,Randy Gilbert,DEM,630022,17,72,363,452,27
Pottawatomie,State House,Josh Cockroft,REP,630022,26,138,659,823,27
Pottawatomie,President,Barack Obama,DEM,630024,7,26,230,263,
Pottawatomie,President,Mitt Romney,REP,630024,54,63,809,926,
Pottawatomie,U.S. House,Tom Guild,DEM,630024,6,22,222,250,05
Pottawatomie,U.S. House,James Lankford,REP,630024,51,66,762,879,05
Pottawatomie,U.S. House,Pat Martin,IND,630024,2,1,19,22,05
Pottawatomie,U.S. House,Robert Murphy,IND,630024,1,0,20,21,05
Pottawatomie,State House,Marilyn Rainwater,DEM,630024,10,24,259,293,28
Pottawatomie,State House,Tom Newell,REP,630024,50,65,759,874,28
Pottawatomie,President,Barack Obama,DEM,630025,4,11,169,184,
Pottawatomie,President,Mitt Romney,REP,630025,18,24,461,503,
Pottawatomie,U.S. House,Tom Guild,DEM,630025,4,12,158,174,05
Pottawatomie,U.S. House,James Lankford,REP,630025,18,21,448,487,05
Pottawatomie,U.S. House,Pat Martin,IND,630025,0,0,10,10,05
Pottawatomie,U.S. House,Robert Murphy,IND,630025,0,2,12,14,05
Pottawatomie,State House,Marilyn Rainwater,DEM,630025,4,13,197,214,28
Pottawatomie,State House,Tom Newell,REP,630025,16,22,423,461,28
Pottawatomie,President,Barack Obama,DEM,630026,17,30,134,181,
Pottawatomie,President,Mitt Romney,REP,630026,42,78,520,640,
Pottawatomie,U.S. House,Tom Guild,DEM,630026,13,27,150,190,05
Pottawatomie,U.S. House,James Lankford,REP,630026,42,78,491,611,05
Pottawatomie,U.S. House,Pat Martin,IND,630026,1,2,4,7,05
Pottawatomie,U.S. House,Robert Murphy,IND,630026,1,0,8,9,05
Pottawatomie,State House,Patty Sue Wagstaff,DEM,630026,16,36,186,238,26
Pottawatomie,State House,Justin Freeland Wood,REP,630026,42,68,463,573,26
Pottawatomie,President,Barack Obama,DEM,630027,5,17,204,226,
Pottawatomie,President,Mitt Romney,REP,630027,7,24,429,460,
Pottawatomie,U.S. House,Tom Guild,DEM,630027,4,14,196,214,05
Pottawatomie,U.S. House,James Lankford,REP,630027,7,26,393,426,05
Pottawatomie,U.S. House,Pat Martin,IND,630027,1,0,24,25,05
Pottawatomie,U.S. House,Robert Murphy,IND,630027,0,0,18,18,05
Pottawatomie,State House,Randy Gilbert,DEM,630027,4,23,267,294,27
Pottawatomie,State House,Josh Cockroft,REP,630027,7,18,368,393,27
Pottawatomie,President,Barack Obama,DEM,630029,6,41,342,389,
Pottawatomie,President,Mitt Romney,REP,630029,24,78,662,764,
Pottawatomie,U.S. House,Tom Guild,DEM,630029,6,33,312,351,05
Pottawatomie,U.S. House,James Lankford,REP,630029,22,81,631,734,05
Pottawatomie,U.S. House,Pat Martin,IND,630029,0,0,22,22,05
Pottawatomie,U.S. House,Robert Murphy,IND,630029,2,3,20,25,05
Pottawatomie,State House,Randy Gilbert,DEM,630029,9,47,516,572,27
Pottawatomie,State House,Josh Cockroft,REP,630029,21,71,488,580,27
Pottawatomie,President,Barack Obama,DEM,630030,19,29,462,510,
Pottawatomie,President,Mitt Romney,REP,630030,34,107,924,1065,
Pottawatomie,U.S. House,Tom Guild,DEM,630030,16,25,435,476,05
Pottawatomie,U.S. House,James Lankford,REP,630030,34,107,890,1031,05
Pottawatomie,U.S. House,Pat Martin,IND,630030,0,2,25,27,05
Pottawatomie,U.S. House,Robert Murphy,IND,630030,0,2,24,26,05
Pottawatomie,State House,Randy Gilbert,DEM,630030,19,49,696,764,27
Pottawatomie,State House,Josh Cockroft,REP,630030,31,87,686,804,27
Pottawatomie,President,Barack Obama,DEM,630031,13,46,458,517,
Pottawatomie,President,Mitt Romney,REP,630031,51,107,1385,1543,
Pottawatomie,U.S. House,Tom Guild,DEM,630031,8,45,444,497,05
Pottawatomie,U.S. House,James Lankford,REP,630031,50,109,1332,1491,05
Pottawatomie,U.S. House,Pat Martin,IND,630031,0,0,33,33,05
Pottawatomie,U.S. House,Robert Murphy,IND,630031,4,0,32,36,05
Pottawatomie,State House,Marilyn Rainwater,DEM,630031,13,51,543,607,28
Pottawatomie,State House,Tom Newell,REP,630031,47,102,1275,1424,28
Pottawatomie,President,Barack Obama,DEM,630033,6,3,150,159,
Pottawatomie,President,Mitt Romney,REP,630033,9,20,303,332,
Pottawatomie,U.S. House,Tom Guild,DEM,630033,6,3,141,150,05
Pottawatomie,U.S. House,James Lankford,REP,630033,9,19,288,316,05
Pottawatomie,U.S. House,Pat Martin,IND,630033,0,0,14,14,05
Pottawatomie,U.S. House,Robert Murphy,IND,630033,0,1,11,12,05
Pottawatomie,State House,Randy Gilbert,DEM,630033,6,8,239,253,27
Pottawatomie,State House,Josh Cockroft,REP,630033,9,15,211,235,27
Pottawatomie,President,Barack Obama,DEM,630037,6,5,109,120,
Pottawatomie,President,Mitt Romney,REP,630037,18,11,343,372,
Pottawatomie,U.S. House,Tom Guild,DEM,630037,6,5,104,115,05
Pottawatomie,U.S. House,James Lankford,REP,630037,16,11,327,354,05
Pottawatomie,U.S. House,Pat Martin,IND,630037,1,0,10,11,05
Pottawatomie,U.S. House,Robert Murphy,IND,630037,0,0,10,10,05
Pottawatomie,State Senate,Susan Paddack,DEM,630037,11,9,212,232,13
Pottawatomie,State Senate,Fred Smith,REP,630037,12,6,231,249,13
Pottawatomie,State House,Randy Gilbert,DEM,630037,8,7,174,189,27
Pottawatomie,State House,Josh Cockroft,REP,630037,15,9,278,302,27
Pottawatomie,President,Barack Obama,DEM,630038,5,7,76,88,
Pottawatomie,President,Mitt Romney,REP,630038,11,24,235,270,
Pottawatomie,U.S. House,Tom Guild,DEM,630038,5,8,86,99,05
Pottawatomie,U.S. House,James Lankford,REP,630038,11,22,210,243,05
Pottawatomie,U.S. House,Pat Martin,IND,630038,0,0,6,6,05
Pottawatomie,U.S. House,Robert Murphy,IND,630038,0,1,7,8,05
Pottawatomie,State Senate,Susan Paddack,DEM,630038,9,8,164,181,13
Pottawatomie,State Senate,Fred Smith,REP,630038,7,21,140,168,13
Pottawatomie,State House,Randy Gilbert,DEM,630038,6,8,139,153,27
Pottawatomie,State House,Josh Cockroft,REP,630038,10,22,169,201,27
Pottawatomie,President,Barack Obama,DEM,630040,9,0,96,105,
Pottawatomie,President,Mitt Romney,REP,630040,9,8,254,271,
Pottawatomie,U.S. House,Tom Guild,DEM,630040,9,1,105,115,05
Pottawatomie,U.S. House,James Lankford,REP,630040,9,7,234,250,05
Pottawatomie,U.S. House,Pat Martin,IND,630040,0,0,8,8,05
Pottawatomie,U.S. House,Robert Murphy,IND,630040,0,0,3,3,05
Pottawatomie,State Senate,Susan Paddack,DEM,630040,11,3,200,214,13
Pottawatomie,State Senate,Fred Smith,REP,630040,7,5,141,153,13
Pottawatomie,State House,Randy Gilbert,DEM,630040,11,4,172,187,27
Pottawatomie,State House,Josh Cockroft,REP,630040,7,4,178,189,27
Pottawatomie,President,Barack Obama,DEM,630041,1,2,100,103,
Pottawatomie,President,Mitt Romney,REP,630041,13,7,295,315,
Pottawatomie,U.S. House,Tom Guild,DEM,630041,0,2,102,104,05
Pottawatomie,U.S. House,James Lankford,REP,630041,13,6,279,298,05
Pottawatomie,U.S. House,Pat Martin,IND,630041,0,0,8,8,05
Pottawatomie,U.S. House,Robert Murphy,IND,630041,0,1,2,3,05
Pottawatomie,State Senate,Susan Paddack,DEM,630041,3,8,232,243,13
Pottawatomie,State Senate,Fred Smith,REP,630041,10,0,154,164,13
Pottawatomie,State House,Randy Gilbert,DEM,630041,5,3,197,205,27
Pottawatomie,State House,Josh Cockroft,REP,630041,8,6,195,209,27
Pottawatomie,President,Barack Obama,DEM,630042,1,1,67,69,
Pottawatomie,President,Mitt Romney,REP,630042,11,2,201,214,
Pottawatomie,U.S. House,Tom Guild,DEM,630042,1,1,73,75,05
Pottawatomie,U.S. House,James Lankford,REP,630042,11,2,186,199,05
Pottawatomie,U.S. House,Pat Martin,IND,630042,0,0,2,2,05
Pottawatomie,U.S. House,Robert Murphy,IND,630042,0,0,5,5,05
Pottawatomie,State Senate,Susan Paddack,DEM,630042,2,2,168,172,13
Pottawatomie,State Senate,Fred Smith,REP,630042,10,0,93,103,13
Pottawatomie,State House,Matt Branstetter,DEM,630042,3,1,111,115,20
Pottawatomie,State House,Bobby Cleveland,REP,630042,9,2,144,155,20
Pushmataha,President,Barack Obama,DEM,640001,3,11,61,75,
Pushmataha,President,Mitt Romney,REP,640001,5,38,189,232,
Pushmataha,U.S. House,Rob Wallace,DEM,640001,3,10,104,117,02
Pushmataha,U.S. House,Markwayne Mullin,REP,640001,4,38,133,175,02
Pushmataha,U.S. House,Michael Fulks,IND,640001,0,1,8,9,02
Pushmataha,State Senate,Jerry Ellis,DEM,640001,4,34,152,190,5
Pushmataha,State Senate,Howard Houchen,REP,640001,4,16,96,116,5
Pushmataha,President,Barack Obama,DEM,640002,7,52,124,183,
Pushmataha,President,Mitt Romney,REP,640002,10,115,392,517,
Pushmataha,U.S. House,Rob Wallace,DEM,640002,8,66,207,281,02
Pushmataha,U.S. House,Markwayne Mullin,REP,640002,10,88,277,375,02
Pushmataha,U.S. House,Michael Fulks,IND,640002,0,10,32,42,02
Pushmataha,State Senate,Jerry Ellis,DEM,640002,11,99,329,439,5
Pushmataha,State Senate,Howard Houchen,REP,640002,7,66,189,262,5
Pushmataha,President,Barack Obama,DEM,640003,4,15,80,99,
Pushmataha,President,Mitt Romney,REP,640003,14,44,191,249,
Pushmataha,U.S. House,Rob Wallace,DEM,640003,5,19,131,155,02
Pushmataha,U.S. House,Markwayne Mullin,REP,640003,13,35,125,173,02
Pushmataha,U.S. House,Michael Fulks,IND,640003,0,4,13,17,02
Pushmataha,State Senate,Jerry Ellis,DEM,640003,7,37,190,234,5
Pushmataha,State Senate,Howard Houchen,REP,640003,11,18,81,110,5
Pushmataha,President,Barack Obama,DEM,640004,3,17,77,97,
Pushmataha,President,Mitt Romney,REP,640004,15,55,301,371,
Pushmataha,U.S. House,Rob Wallace,DEM,640004,5,31,137,173,02
Pushmataha,U.S. House,Markwayne Mullin,REP,640004,9,40,225,274,02
Pushmataha,U.S. House,Michael Fulks,IND,640004,0,1,14,15,02
Pushmataha,State Senate,Jerry Ellis,DEM,640004,9,42,243,294,5
Pushmataha,State Senate,Howard Houchen,REP,640004,6,29,134,169,5
Pushmataha,President,Barack Obama,DEM,640005,1,0,13,14,
Pushmataha,President,Mitt Romney,REP,640005,1,8,65,74,
Pushmataha,U.S. House,Rob Wallace,DEM,640005,1,2,22,25,02
Pushmataha,U.S. House,Markwayne Mullin,REP,640005,1,6,54,61,02
Pushmataha,U.S. House,Michael Fulks,IND,640005,0,0,0,0,02
Pushmataha,State Senate,Jerry Ellis,DEM,640005,1,5,43,49,5
Pushmataha,State Senate,Howard Houchen,REP,640005,1,3,34,38,5
Pushmataha,President,Barack Obama,DEM,640007,0,8,53,61,
Pushmataha,President,Mitt Romney,REP,640007,1,12,90,103,
Pushmataha,U.S. House,Rob Wallace,DEM,640007,0,9,64,73,02
Pushmataha,U.S. House,Markwayne Mullin,REP,640007,0,11,73,84,02
Pushmataha,U.S. House,Michael Fulks,IND,640007,1,0,3,4,02
Pushmataha,State Senate,Jerry Ellis,DEM,640007,1,13,119,133,5
Pushmataha,State Senate,Howard Houchen,REP,640007,0,7,26,33,5
Pushmataha,President,Barack Obama,DEM,640008,0,0,41,41,
Pushmataha,President,Mitt Romney,REP,640008,1,9,95,105,
Pushmataha,U.S. House,Rob Wallace,DEM,640008,0,2,61,63,02
Pushmataha,U.S. House,Markwayne Mullin,REP,640008,1,6,71,78,02
Pushmataha,U.S. House,Michael Fulks,IND,640008,0,0,4,4,02
Pushmataha,State Senate,Jerry Ellis,DEM,640008,0,7,104,111,5
Pushmataha,State Senate,Howard Houchen,REP,640008,1,1,33,35,5
Pushmataha,President,Barack Obama,DEM,640009,0,0,71,71,
Pushmataha,President,Mitt Romney,REP,640009,2,6,126,134,
Pushmataha,U.S. House,Rob Wallace,DEM,640009,0,2,110,112,02
Pushmataha,U.S. House,Markwayne Mullin,REP,640009,0,3,80,83,02
Pushmataha,U.S. House,Michael Fulks,IND,640009,2,0,6,8,02
Pushmataha,State Senate,Jerry Ellis,DEM,640009,0,5,151,156,5
Pushmataha,State Senate,Howard Houchen,REP,640009,2,0,46,48,5
Pushmataha,President,Barack Obama,DEM,640010,1,3,12,16,
Pushmataha,President,Mitt Romney,REP,640010,4,3,67,74,
Pushmataha,U.S. House,Rob Wallace,DEM,640010,2,4,19,25,02
Pushmataha,U.S. House,Markwayne Mullin,REP,640010,3,2,57,62,02
Pushmataha,U.S. House,Michael Fulks,IND,640010,0,0,3,3,02
Pushmataha,State Senate,Jerry Ellis,DEM,640010,4,4,40,48,5
Pushmataha,State Senate,Howard Houchen,REP,640010,1,2,39,42,5
Pushmataha,President,Barack Obama,DEM,640011,9,11,109,129,
Pushmataha,President,Mitt Romney,REP,640011,8,25,395,428,
Pushmataha,U.S. House,Rob Wallace,DEM,640011,10,17,209,236,02
Pushmataha,U.S. House,Markwayne Mullin,REP,640011,6,18,262,286,02
Pushmataha,U.S. House,Michael Fulks,IND,640011,0,0,25,25,02
Pushmataha,State Senate,Jerry Ellis,DEM,640011,10,25,342,377,5
Pushmataha,State Senate,Howard Houchen,REP,640011,7,10,155,172,5
Pushmataha,President,Barack Obama,DEM,640012,0,0,17,17,
Pushmataha,President,Mitt Romney,REP,640012,1,4,64,69,
Pushmataha,U.S. House,Rob Wallace,DEM,640012,0,1,39,40,02
Pushmataha,U.S. House,Markwayne Mullin,REP,640012,1,3,37,41,02
Pushmataha,U.S. House,Michael Fulks,IND,640012,0,0,5,5,02
Pushmataha,State Senate,Jerry Ellis,DEM,640012,0,1,63,64,5
Pushmataha,State Senate,Howard Houchen,REP,640012,1,3,18,22,5
Pushmataha,President,Barack Obama,DEM,640013,0,0,9,9,
Pushmataha,President,Mitt Romney,REP,640013,1,0,39,40,
Pushmataha,U.S. House,Rob Wallace,DEM,640013,0,0,16,16,02
Pushmataha,U.S. House,Markwayne Mullin,REP,640013,1,0,31,32,02
Pushmataha,U.S. House,Michael Fulks,IND,640013,0,0,1,1,02
Pushmataha,State Senate,Jerry Ellis,DEM,640013,0,0,29,29,5
Pushmataha,State Senate,Howard Houchen,REP,640013,1,0,19,20,5
Pushmataha,President,Barack Obama,DEM,640014,1,0,11,12,
Pushmataha,President,Mitt Romney,REP,640014,4,4,89,97,
Pushmataha,U.S. House,Rob Wallace,DEM,640014,1,0,28,29,02
Pushmataha,U.S. House,Markwayne Mullin,REP,640014,4,3,65,72,02
Pushmataha,U.S. House,Michael Fulks,IND,640014,0,0,5,5,02
Pushmataha,State Senate,Jerry Ellis,DEM,640014,1,1,58,60,5
Pushmataha,State Senate,Howard Houchen,REP,640014,4,2,40,46,5
Pushmataha,President,Barack Obama,DEM,640015,3,4,103,110,
Pushmataha,President,Mitt Romney,REP,640015,15,13,334,362,
Pushmataha,U.S. House,Rob Wallace,DEM,640015,5,6,210,221,02
Pushmataha,U.S. House,Markwayne Mullin,REP,640015,11,11,206,228,02
Pushmataha,U.S. House,Michael Fulks,IND,640015,2,0,15,17,02
Pushmataha,State Senate,Jerry Ellis,DEM,640015,10,10,324,344,5
Pushmataha,State Senate,Howard Houchen,REP,640015,8,7,114,129,5
Pushmataha,President,Barack Obama,DEM,640016,4,0,34,38,
Pushmataha,President,Mitt Romney,REP,640016,3,0,94,97,
Pushmataha,U.S. House,Rob Wallace,DEM,640016,4,0,48,52,02
Pushmataha,U.S. House,Markwayne Mullin,REP,640016,1,0,73,74,02
Pushmataha,U.S. House,Michael Fulks,IND,640016,2,0,6,8,02
Pushmataha,State Senate,Jerry Ellis,DEM,640016,6,0,79,85,5
Pushmataha,State Senate,Howard Houchen,REP,640016,1,0,49,50,5
Pushmataha,President,Barack Obama,DEM,640017,0,2,69,71,
Pushmataha,President,Mitt Romney,REP,640017,6,1,128,135,
Pushmataha,U.S. House,Rob Wallace,DEM,640017,0,2,83,85,02
Pushmataha,U.S. House,Markwayne Mullin,REP,640017,4,1,100,105,02
Pushmataha,U.S. House,Michael Fulks,IND,640017,2,0,10,12,02
Pushmataha,State Senate,Jerry Ellis,DEM,640017,0,2,118,120,5
Pushmataha,State Senate,Howard Houchen,REP,640017,6,1,78,85,5
Roger Mills,President,Barack Obama,DEM,650101,1,6,14,21,
Roger Mills,President,Mitt Romney,REP,650101,5,23,109,137,
Roger Mills,U.S. House,Timothy Ray Murray,DEM,650101,0,3,6,9,03
Roger Mills,U.S. House,Frank Lucas,REP,650101,6,26,106,138,03
Roger Mills,U.S. House,William Sanders,IND,650101,0,0,9,9,03
Roger Mills,President,Barack Obama,DEM,650102,0,0,14,14,
Roger Mills,President,Mitt Romney,REP,650102,4,21,87,112,
Roger Mills,U.S. House,Timothy Ray Murray,DEM,650102,1,1,8,10,03
Roger Mills,U.S. House,Frank Lucas,REP,650102,3,19,92,114,03
Roger Mills,U.S. House,William Sanders,IND,650102,0,1,1,2,03
Roger Mills,President,Barack Obama,DEM,650103,3,5,34,42,
Roger Mills,President,Mitt Romney,REP,650103,7,30,168,205,
Roger Mills,U.S. House,Timothy Ray Murray,DEM,650103,3,2,21,26,03
Roger Mills,U.S. House,Frank Lucas,REP,650103,7,34,181,222,03
Roger Mills,U.S. House,William Sanders,IND,650103,0,0,2,2,03
Roger Mills,President,Barack Obama,DEM,650201,1,2,100,103,
Roger Mills,President,Mitt Romney,REP,650201,16,16,269,301,
Roger Mills,U.S. House,Timothy Ray Murray,DEM,650201,2,2,63,67,03
Roger Mills,U.S. House,Frank Lucas,REP,650201,16,16,296,328,03
Roger Mills,U.S. House,William Sanders,IND,650201,0,0,9,9,03
Roger Mills,President,Barack Obama,DEM,650202,1,2,4,7,
Roger Mills,President,Mitt Romney,REP,650202,8,20,74,102,
Roger Mills,U.S. House,Timothy Ray Murray,DEM,650202,0,2,2,4,03
Roger Mills,U.S. House,Frank Lucas,REP,650202,9,20,75,104,03
Roger Mills,U.S. House,William Sanders,IND,650202,0,0,1,1,03
Roger Mills,President,Barack Obama,DEM,650203,0,0,9,9,
Roger Mills,President,Mitt Romney,REP,650203,1,2,81,84,
Roger Mills,U.S. House,Timothy Ray Murray,DEM,650203,0,0,6,6,03
Roger Mills,U.S. House,Frank Lucas,REP,650203,1,1,80,82,03
Roger Mills,U.S. House,William Sanders,IND,650203,0,1,3,4,03
Roger Mills,President,Barack Obama,DEM,650301,1,0,17,18,
Roger Mills,President,Mitt Romney,REP,650301,6,17,119,142,
Roger Mills,U.S. House,Timothy Ray Murray,DEM,650301,1,0,14,15,03
Roger Mills,U.S. House,Frank Lucas,REP,650301,6,17,118,141,03
Roger Mills,U.S. House,William Sanders,IND,650301,0,0,5,5,03
Roger Mills,President,Barack Obama,DEM,650302,1,8,11,20,
Roger Mills,President,Mitt Romney,REP,650302,6,17,131,154,
Roger Mills,U.S. House,Timothy Ray Murray,DEM,650302,0,5,11,16,03
Roger Mills,U.S. House,Frank Lucas,REP,650302,6,19,124,149,03
Roger Mills,U.S. House,William Sanders,IND,650302,1,0,6,7,03
Roger Mills,President,Barack Obama,DEM,650303,1,10,27,38,
Roger Mills,President,Mitt Romney,REP,650303,10,32,123,165,
Roger Mills,U.S. House,Timothy Ray Murray,DEM,650303,0,6,14,20,03
Roger Mills,U.S. House,Frank Lucas,REP,650303,10,35,134,179,03
Roger Mills,U.S. House,William Sanders,IND,650303,1,1,3,5,03
Rogers,President,Barack Obama,DEM,660001,39,102,378,519,
Rogers,President,Mitt Romney,REP,660001,83,241,717,1041,
Rogers,U.S. House,Rob Wallace,DEM,660001,41,107,360,508,02
Rogers,U.S. House,Markwayne Mullin,REP,660001,72,225,680,977,02
Rogers,U.S. House,Michael Fulks,IND,660001,4,8,49,61,02
Rogers,President,Barack Obama,DEM,660002,10,49,228,287,
Rogers,President,Mitt Romney,REP,660002,17,112,354,483,
Rogers,U.S. House,Rob Wallace,DEM,660002,8,47,208,263,02
Rogers,U.S. House,Markwayne Mullin,REP,660002,20,105,328,453,02
Rogers,U.S. House,Michael Fulks,IND,660002,0,12,40,52,02
Rogers,President,Barack Obama,DEM,660003,11,48,198,257,
Rogers,President,Mitt Romney,REP,660003,23,176,484,683,
Rogers,U.S. House,Rob Wallace,DEM,660003,13,49,201,263,02
Rogers,U.S. House,Markwayne Mullin,REP,660003,20,164,441,625,02
Rogers,U.S. House,Michael Fulks,IND,660003,1,10,34,45,02
Rogers,President,Barack Obama,DEM,660004,16,93,342,451,
Rogers,President,Mitt Romney,REP,660004,32,210,819,1061,
Rogers,U.S. House,Rob Wallace,DEM,660004,16,96,312,424,02
Rogers,U.S. House,Markwayne Mullin,REP,660004,26,189,771,986,02
Rogers,U.S. House,Michael Fulks,IND,660004,3,13,76,92,02
Rogers,President,Barack Obama,DEM,660005,5,45,131,181,
Rogers,President,Mitt Romney,REP,660005,28,160,417,605,
Rogers,U.S. House,Rob Wallace,DEM,660005,7,48,135,190,02
Rogers,U.S. House,Markwayne Mullin,REP,660005,25,151,385,561,02
Rogers,U.S. House,Michael Fulks,IND,660005,1,5,26,32,02
Rogers,President,Barack Obama,DEM,660006,13,29,179,221,
Rogers,President,Mitt Romney,REP,660006,58,63,593,714,
Rogers,U.S. House,John Olson,DEM,660006,10,24,153,187,01
Rogers,U.S. House,Jim Bridenstine,REP,660006,60,64,579,703,01
Rogers,U.S. House,Craig Allen,IND,660006,2,3,38,43,01
Rogers,President,Barack Obama,DEM,660007,7,70,232,309,
Rogers,President,Mitt Romney,REP,660007,44,155,662,861,
Rogers,U.S. House,Rob Wallace,DEM,660007,9,68,239,316,02
Rogers,U.S. House,Markwayne Mullin,REP,660007,42,141,611,794,02
Rogers,U.S. House,Michael Fulks,IND,660007,1,17,37,55,02
Rogers,President,Barack Obama,DEM,660008,35,66,196,297,
Rogers,President,Mitt Romney,REP,660008,65,166,493,724,
Rogers,U.S. House,Rob Wallace,DEM,660008,37,66,199,302,02
Rogers,U.S. House,Markwayne Mullin,REP,660008,55,161,437,653,02
Rogers,U.S. House,Michael Fulks,IND,660008,4,5,55,64,02
Rogers,President,Barack Obama,DEM,660009,6,23,85,114,
Rogers,President,Mitt Romney,REP,660009,24,62,361,447,
Rogers,U.S. House,Rob Wallace,DEM,660009,4,21,90,115,02
Rogers,U.S. House,Markwayne Mullin,REP,660009,27,55,340,422,02
Rogers,U.S. House,Michael Fulks,IND,660009,0,9,16,25,02
Rogers,President,Barack Obama,DEM,660010,15,15,432,462,
Rogers,President,Mitt Romney,REP,660010,61,71,1243,1375,
Rogers,U.S. House,John Olson,DEM,660010,14,14,388,416,01
Rogers,U.S. House,Jim Bridenstine,REP,660010,56,69,1184,1309,01
Rogers,U.S. House,Craig Allen,IND,660010,6,1,94,101,01
Rogers,State House,Shawna Keller,DEM,660010,12,16,468,496,23
Rogers,State House,Terry O'Donnell,REP,660010,63,67,1197,1327,23
Rogers,President,Barack Obama,DEM,660011,16,37,368,421,
Rogers,President,Mitt Romney,REP,660011,29,122,844,995,
Rogers,U.S. House,Rob Wallace,DEM,660011,15,42,378,435,02
Rogers,U.S. House,Markwayne Mullin,REP,660011,27,108,782,917,02
Rogers,U.S. House,Michael Fulks,IND,660011,3,6,58,67,02
Rogers,President,Barack Obama,DEM,660012,1,5,79,85,
Rogers,President,Mitt Romney,REP,660012,7,8,237,252,
Rogers,U.S. House,Rob Wallace,DEM,660012,1,6,78,85,02
Rogers,U.S. House,Markwayne Mullin,REP,660012,7,7,224,238,02
Rogers,U.S. House,Michael Fulks,IND,660012,0,0,12,12,02
Rogers,President,Barack Obama,DEM,660013,7,37,189,233,
Rogers,President,Mitt Romney,REP,660013,7,106,508,621,
Rogers,U.S. House,Rob Wallace,DEM,660013,3,36,188,227,02
Rogers,U.S. House,Markwayne Mullin,REP,660013,11,101,477,589,02
Rogers,U.S. House,Michael Fulks,IND,660013,0,4,33,37,02
Rogers,President,Barack Obama,DEM,660014,8,40,150,198,
Rogers,President,Mitt Romney,REP,660014,30,115,474,619,
Rogers,U.S. House,Rob Wallace,DEM,660014,7,46,148,201,02
Rogers,U.S. House,Markwayne Mullin,REP,660014,29,99,442,570,02
Rogers,U.S. House,Michael Fulks,IND,660014,0,8,31,39,02
Rogers,President,Barack Obama,DEM,660015,11,15,309,335,
Rogers,President,Mitt Romney,REP,660015,25,30,833,888,
Rogers,U.S. House,Rob Wallace,DEM,660015,11,13,333,357,02
Rogers,U.S. House,Markwayne Mullin,REP,660015,21,28,765,814,02
Rogers,U.S. House,Michael Fulks,IND,660015,2,4,47,53,02
Rogers,President,Barack Obama,DEM,660017,5,15,152,172,
Rogers,President,Mitt Romney,REP,660017,10,70,414,494,
Rogers,U.S. House,Rob Wallace,DEM,660017,6,17,148,171,02
Rogers,U.S. House,Markwayne Mullin,REP,660017,10,66,394,470,02
Rogers,U.S. House,Michael Fulks,IND,660017,0,3,24,27,02
Rogers,President,Barack Obama,DEM,660018,6,67,197,270,
Rogers,President,Mitt Romney,REP,660018,41,169,784,994,
Rogers,U.S. House,Rob Wallace,DEM,660018,6,74,228,308,02
Rogers,U.S. House,Markwayne Mullin,REP,660018,37,157,718,912,02
Rogers,U.S. House,Michael Fulks,IND,660018,4,5,29,38,02
Rogers,President,Barack Obama,DEM,660019,4,22,131,157,
Rogers,President,Mitt Romney,REP,660019,22,75,479,576,
Rogers,U.S. House,Rob Wallace,DEM,660019,4,22,152,178,02
Rogers,U.S. House,Markwayne Mullin,REP,660019,18,74,434,526,02
Rogers,U.S. House,Michael Fulks,IND,660019,3,1,22,26,02
Rogers,President,Barack Obama,DEM,660020,13,71,309,393,
Rogers,President,Mitt Romney,REP,660020,48,181,938,1167,
Rogers,U.S. House,Rob Wallace,DEM,660020,11,67,308,386,02
Rogers,U.S. House,Markwayne Mullin,REP,660020,43,176,874,1093,02
Rogers,U.S. House,Michael Fulks,IND,660020,6,8,61,75,02
Rogers,President,Barack Obama,DEM,660021,1,2,30,33,
Rogers,President,Mitt Romney,REP,660021,12,6,94,112,
Rogers,U.S. House,John Olson,DEM,660021,2,1,27,30,01
Rogers,U.S. House,Jim Bridenstine,REP,660021,9,7,95,111,01
Rogers,U.S. House,Craig Allen,IND,660021,2,0,2,4,01
Rogers,President,Barack Obama,DEM,660022,3,34,206,243,
Rogers,President,Mitt Romney,REP,660022,35,121,721,877,
Rogers,U.S. House,Rob Wallace,DEM,660022,5,37,213,255,02
Rogers,U.S. House,Markwayne Mullin,REP,660022,31,110,675,816,02
Rogers,U.S. House,Michael Fulks,IND,660022,2,9,41,52,02
Rogers,President,Barack Obama,DEM,660023,8,15,435,458,
Rogers,President,Mitt Romney,REP,660023,42,69,1164,1275,
Rogers,U.S. House,Rob Wallace,DEM,660023,10,13,478,501,02
Rogers,U.S. House,Markwayne Mullin,REP,660023,36,67,1056,1159,02
Rogers,U.S. House,Michael Fulks,IND,660023,2,3,68,73,02
Rogers,President,Barack Obama,DEM,660024,1,13,95,109,
Rogers,President,Mitt Romney,REP,660024,12,10,402,424,
Rogers,U.S. House,Rob Wallace,DEM,660024,3,10,110,123,02
Rogers,U.S. House,Markwayne Mullin,REP,660024,9,9,353,371,02
Rogers,U.S. House,Michael Fulks,IND,660024,1,3,30,34,02
Rogers,President,Barack Obama,DEM,660025,3,1,81,85,
Rogers,President,Mitt Romney,REP,660025,1,3,202,206,
Rogers,U.S. House,John Olson,DEM,660025,3,1,77,81,01
Rogers,U.S. House,Jim Bridenstine,REP,660025,1,3,195,199,01
Rogers,U.S. House,Craig Allen,IND,660025,0,0,11,11,01
Rogers,President,Barack Obama,DEM,660026,16,21,326,363,
Rogers,President,Mitt Romney,REP,660026,53,90,1067,1210,
Rogers,U.S. House,Rob Wallace,DEM,660026,17,24,345,386,02
Rogers,U.S. House,Markwayne Mullin,REP,660026,47,83,999,1129,02
Rogers,U.S. House,Michael Fulks,IND,660026,2,4,51,57,02
Rogers,State Senate,Jim Bynum,DEM,660026,24,32,518,574,3
Rogers,State Senate,Wayne Shaw,REP,660026,43,78,863,984,3
Rogers,President,Barack Obama,DEM,660027,7,15,153,175,
Rogers,President,Mitt Romney,REP,660027,5,33,454,492,
Rogers,U.S. House,Rob Wallace,DEM,660027,5,14,176,195,02
Rogers,U.S. House,Markwayne Mullin,REP,660027,6,30,395,431,02
Rogers,U.S. House,Michael Fulks,IND,660027,1,2,30,33,02
Rogers,State Senate,Jim Bynum,DEM,660027,5,21,261,287,3
Rogers,State Senate,Wayne Shaw,REP,660027,7,26,339,372,3
Rogers,President,Barack Obama,DEM,660029,7,10,127,144,
Rogers,President,Mitt Romney,REP,660029,21,42,420,483,
Rogers,U.S. House,Rob Wallace,DEM,660029,8,12,124,144,02
Rogers,U.S. House,Markwayne Mullin,REP,660029,18,39,388,445,02
Rogers,U.S. House,Michael Fulks,IND,660029,2,0,34,36,02
Rogers,President,Barack Obama,DEM,660030,17,34,299,350,
Rogers,President,Mitt Romney,REP,660030,90,111,1409,1610,
Rogers,U.S. House,Rob Wallace,DEM,660030,14,36,308,358,02
Rogers,U.S. House,Markwayne Mullin,REP,660030,90,107,1325,1522,02
Rogers,U.S. House,Michael Fulks,IND,660030,1,1,62,64,02
Rogers,President,Barack Obama,DEM,660031,15,38,320,373,
Rogers,President,Mitt Romney,REP,660031,58,89,954,1101,
Rogers,U.S. House,John Olson,DEM,660031,13,31,297,341,01
Rogers,U.S. House,Jim Bridenstine,REP,660031,56,91,907,1054,01
Rogers,U.S. House,Craig Allen,IND,660031,4,4,69,77,01
Rogers,President,Barack Obama,DEM,660032,7,25,129,161,
Rogers,President,Mitt Romney,REP,660032,45,58,465,568,
Rogers,U.S. House,Rob Wallace,DEM,660032,6,23,132,161,02
Rogers,U.S. House,Markwayne Mullin,REP,660032,43,59,435,537,02
Rogers,U.S. House,Michael Fulks,IND,660032,2,0,23,25,02
Rogers,President,Barack Obama,DEM,660033,3,3,92,98,
Rogers,President,Mitt Romney,REP,660033,7,6,276,289,
Rogers,U.S. House,Rob Wallace,DEM,660033,3,3,82,88,02
Rogers,U.S. House,Markwayne Mullin,REP,660033,7,6,267,280,02
Rogers,U.S. House,Michael Fulks,IND,660033,0,0,22,22,02
Rogers,President,Barack Obama,DEM,660110,10,20,171,201,
Rogers,President,Mitt Romney,REP,660110,33,88,623,744,
Rogers,U.S. House,Rob Wallace,DEM,660110,13,25,178,216,02
Rogers,U.S. House,Markwayne Mullin,REP,660110,28,79,578,685,02
Rogers,U.S. House,Michael Fulks,IND,660110,2,3,44,49,02
Rogers,State House,Shawna Keller,DEM,660110,10,24,213,247,23
Rogers,State House,Terry O'Donnell,REP,660110,33,83,578,694,23
Rogers,President,Barack Obama,DEM,660116,4,4,166,174,
Rogers,President,Mitt Romney,REP,660116,23,29,521,573,
Rogers,U.S. House,Rob Wallace,DEM,660116,4,5,170,179,02
Rogers,U.S. House,Markwayne Mullin,REP,660116,21,27,466,514,02
Rogers,U.S. House,Michael Fulks,IND,660116,1,0,45,46,02
Rogers,President,Barack Obama,DEM,660120,0,22,140,162,
Rogers,President,Mitt Romney,REP,660120,28,81,588,697,
Rogers,U.S. House,Rob Wallace,DEM,660120,0,23,163,186,02
Rogers,U.S. House,Markwayne Mullin,REP,660120,27,75,532,634,02
Rogers,U.S. House,Michael Fulks,IND,660120,1,4,32,37,02
Rogers,President,Barack Obama,DEM,660128,1,4,164,169,
Rogers,President,Mitt Romney,REP,660128,14,23,511,548,
Rogers,U.S. House,Rob Wallace,DEM,660128,1,5,179,185,02
Rogers,U.S. House,Markwayne Mullin,REP,660128,13,22,465,500,02
Rogers,U.S. House,Michael Fulks,IND,660128,0,0,26,26,02
Rogers,State House,Shawna Keller,DEM,660128,1,3,200,204,23
Rogers,State House,Terry O'Donnell,REP,660128,14,24,460,498,23
Rogers,President,Barack Obama,DEM,660130,37,41,410,488,
Rogers,President,Mitt Romney,REP,660130,114,179,1451,1744,
Rogers,U.S. House,John Olson,DEM,660130,39,42,382,463,01
Rogers,U.S. House,Jim Bridenstine,REP,660130,104,174,1388,1666,01
Rogers,U.S. House,Craig Allen,IND,660130,5,4,80,89,01
Seminole,President,Barack Obama,DEM,670010,7,22,313,342,
Seminole,President,Mitt Romney,REP,670010,18,39,469,526,
Seminole,U.S. House,Tom Guild,DEM,670010,6,20,275,301,05
Seminole,U.S. House,James Lankford,REP,670010,18,38,474,530,05
Seminole,U.S. House,Pat Martin,IND,670010,0,2,14,16,05
Seminole,U.S. House,Robert Murphy,IND,670010,0,1,14,15,05
Seminole,State House,Marilyn Rainwater,DEM,670010,7,23,351,381,28
Seminole,State House,Tom Newell,REP,670010,17,38,429,484,28
Seminole,President,Barack Obama,DEM,670012,0,1,33,34,
Seminole,President,Mitt Romney,REP,670012,5,2,77,84,
Seminole,U.S. House,Tom Guild,DEM,670012,0,0,32,32,05
Seminole,U.S. House,James Lankford,REP,670012,5,3,76,84,05
Seminole,U.S. House,Pat Martin,IND,670012,0,0,0,0,05
Seminole,U.S. House,Robert Murphy,IND,670012,0,0,4,4,05
Seminole,State Senate,Susan Paddack,DEM,670012,2,2,73,77,13
Seminole,State Senate,Fred Smith,REP,670012,3,1,39,43,13
Seminole,State House,Marilyn Rainwater,DEM,670012,2,1,48,51,28
Seminole,State House,Tom Newell,REP,670012,3,2,64,69,28
Seminole,President,Barack Obama,DEM,670014,8,2,227,237,
Seminole,President,Mitt Romney,REP,670014,15,9,571,595,
Seminole,U.S. House,Tom Guild,DEM,670014,8,3,239,250,05
Seminole,U.S. House,James Lankford,REP,670014,14,8,526,548,05
Seminole,U.S. House,Pat Martin,IND,670014,0,0,21,21,05
Seminole,U.S. House,Robert Murphy,IND,670014,1,0,14,15,05
Seminole,State Senate,Susan Paddack,DEM,670014,10,8,527,545,13
Seminole,State Senate,Fred Smith,REP,670014,10,3,264,277,13
Seminole,State House,Marilyn Rainwater,DEM,670014,7,4,294,305,28
Seminole,State House,Tom Newell,REP,670014,13,7,496,516,28
Seminole,President,Barack Obama,DEM,670015,4,8,122,134,
Seminole,President,Mitt Romney,REP,670015,5,29,230,264,
Seminole,U.S. House,Tom Guild,DEM,670015,4,7,120,131,05
Seminole,U.S. House,James Lankford,REP,670015,5,29,213,247,05
Seminole,U.S. House,Pat Martin,IND,670015,0,0,14,14,05
Seminole,U.S. House,Robert Murphy,IND,670015,0,0,3,3,05
Seminole,State Senate,Susan Paddack,DEM,670015,7,19,259,285,13
Seminole,State Senate,Fred Smith,REP,670015,2,17,90,109,13
Seminole,State House,Marilyn Rainwater,DEM,670015,4,8,162,174,28
Seminole,State House,Tom Newell,REP,670015,5,27,187,219,28
Seminole,President,Barack Obama,DEM,670020,2,3,150,155,
Seminole,President,Mitt Romney,REP,670020,16,16,460,492,
Seminole,U.S. House,Tom Guild,DEM,670020,3,4,155,162,05
Seminole,U.S. House,James Lankford,REP,670020,14,13,439,466,05
Seminole,U.S. House,Pat Martin,IND,670020,0,0,10,10,05
Seminole,U.S. House,Robert Murphy,IND,670020,0,0,6,6,05
Seminole,State House,Marilyn Rainwater,DEM,670020,2,3,179,184,28
Seminole,State House,Tom Newell,REP,670020,16,16,431,463,28
Seminole,President,Barack Obama,DEM,670022,8,20,239,267,
Seminole,President,Mitt Romney,REP,670022,23,17,448,488,
Seminole,U.S. House,Tom Guild,DEM,670022,9,19,203,231,05
Seminole,U.S. House,James Lankford,REP,670022,21,14,458,493,05
Seminole,U.S. House,Pat Martin,IND,670022,1,2,8,11,05
Seminole,U.S. House,Robert Murphy,IND,670022,0,2,18,20,05
Seminole,State House,Marilyn Rainwater,DEM,670022,12,24,288,324,28
Seminole,State House,Tom Newell,REP,670022,19,13,399,431,28
Seminole,President,Barack Obama,DEM,670023,12,24,239,275,
Seminole,President,Mitt Romney,REP,670023,25,27,491,543,
Seminole,U.S. House,Tom Guild,DEM,670023,10,27,219,256,05
Seminole,U.S. House,James Lankford,REP,670023,21,23,479,523,05
Seminole,U.S. House,Pat Martin,IND,670023,0,0,16,16,05
Seminole,U.S. House,Robert Murphy,IND,670023,1,0,14,15,05
Seminole,State House,Marilyn Rainwater,DEM,670023,12,31,279,322,28
Seminole,State House,Tom Newell,REP,670023,20,19,450,489,28
Seminole,President,Barack Obama,DEM,670024,2,13,165,180,
Seminole,President,Mitt Romney,REP,670024,11,11,319,341,
Seminole,U.S. House,Tom Guild,DEM,670024,3,11,148,162,05
Seminole,U.S. House,James Lankford,REP,670024,10,12,316,338,05
Seminole,U.S. House,Pat Martin,IND,670024,0,0,9,9,05
Seminole,U.S. House,Robert Murphy,IND,670024,0,0,10,10,05
Seminole,State House,Marilyn Rainwater,DEM,670024,2,12,194,208,28
Seminole,State House,Tom Newell,REP,670024,11,12,288,311,28
Seminole,President,Barack Obama,DEM,670025,1,0,44,45,
Seminole,President,Mitt Romney,REP,670025,9,13,70,92,
Seminole,U.S. House,Tom Guild,DEM,670025,1,0,45,46,05
Seminole,U.S. House,James Lankford,REP,670025,9,13,66,88,05
Seminole,U.S. House,Pat Martin,IND,670025,0,0,1,1,05
Seminole,U.S. House,Robert Murphy,IND,670025,0,0,2,2,05
Seminole,State Senate,Susan Paddack,DEM,670025,6,5,75,86,13
Seminole,State Senate,Fred Smith,REP,670025,4,8,38,50,13
Seminole,State House,Marilyn Rainwater,DEM,670025,1,2,59,62,28
Seminole,State House,Tom Newell,REP,670025,9,11,55,75,28
Seminole,President,Barack Obama,DEM,670030,0,4,72,76,
Seminole,President,Mitt Romney,REP,670030,4,8,170,182,
Seminole,U.S. House,Tom Guild,DEM,670030,0,3,69,72,05
Seminole,U.S. House,James Lankford,REP,670030,2,9,161,172,05
Seminole,U.S. House,Pat Martin,IND,670030,2,0,7,9,05
Seminole,U.S. House,Robert Murphy,IND,670030,0,0,2,2,05
Seminole,State House,Marilyn Rainwater,DEM,670030,0,5,79,84,28
Seminole,State House,Tom Newell,REP,670030,4,7,158,169,28
Seminole,President,Barack Obama,DEM,670032,9,40,187,236,
Seminole,President,Mitt Romney,REP,670032,22,70,260,352,
Seminole,U.S. House,Tom Guild,DEM,670032,7,36,189,232,05
Seminole,U.S. House,James Lankford,REP,670032,23,69,251,343,05
Seminole,U.S. House,Pat Martin,IND,670032,0,1,2,3,05
Seminole,U.S. House,Robert Murphy,IND,670032,1,1,7,9,05
Seminole,State House,Marilyn Rainwater,DEM,670032,11,40,212,263,28
Seminole,State House,Tom Newell,REP,670032,20,67,241,328,28
Seminole,President,Barack Obama,DEM,670033,0,10,25,35,
Seminole,President,Mitt Romney,REP,670033,2,12,46,60,
Seminole,U.S. House,Tom Guild,DEM,670033,1,8,20,29,05
Seminole,U.S. House,James Lankford,REP,670033,1,14,47,62,05
Seminole,U.S. House,Pat Martin,IND,670033,0,0,3,3,05
Seminole,U.S. House,Robert Murphy,IND,670033,0,0,1,1,05
Seminole,State Senate,Susan Paddack,DEM,670033,1,12,46,59,13
Seminole,State Senate,Fred Smith,REP,670033,1,10,25,36,13
Seminole,State House,Marilyn Rainwater,DEM,670033,2,10,36,48,28
Seminole,State House,Tom Newell,REP,670033,0,12,35,47,28
Seminole,President,Barack Obama,DEM,670034,16,100,358,474,
Seminole,President,Mitt Romney,REP,670034,28,122,422,572,
Seminole,U.S. House,Tom Guild,DEM,670034,11,93,318,422,05
Seminole,U.S. House,James Lankford,REP,670034,27,120,438,585,05
Seminole,U.S. House,Pat Martin,IND,670034,0,5,10,15,05
Seminole,U.S. House,Robert Murphy,IND,670034,3,3,15,21,05
Seminole,State House,Marilyn Rainwater,DEM,670034,16,117,420,553,28
Seminole,State House,Tom Newell,REP,670034,26,103,364,493,28
Seminole,President,Barack Obama,DEM,670035,3,11,96,110,
Seminole,President,Mitt Romney,REP,670035,5,15,245,265,
Seminole,U.S. House,Tom Guild,DEM,670035,3,12,104,119,05
Seminole,U.S. House,James Lankford,REP,670035,5,14,227,246,05
Seminole,U.S. House,Pat Martin,IND,670035,0,0,7,7,05
Seminole,U.S. House,Robert Murphy,IND,670035,0,0,5,5,05
Seminole,State House,Marilyn Rainwater,DEM,670035,2,13,114,129,28
Seminole,State House,Tom Newell,REP,670035,4,13,227,244,28
Sequoyah,President,Barack Obama,DEM,680101,5,20,228,253,
Sequoyah,President,Mitt Romney,REP,680101,12,77,632,721,
Sequoyah,U.S. House,Rob Wallace,DEM,680101,8,26,319,353,02
Sequoyah,U.S. House,Markwayne Mullin,REP,680101,8,66,510,584,02
Sequoyah,U.S. House,Michael Fulks,IND,680101,3,5,15,23,02
Sequoyah,State House,Rick Agent,DEM,680101,10,29,383,422,2
Sequoyah,State House,John Bennett,REP,680101,9,69,480,558,2
Sequoyah,President,Barack Obama,DEM,680102,6,8,168,182,
Sequoyah,President,Mitt Romney,REP,680102,6,28,348,382,
Sequoyah,U.S. House,Rob Wallace,DEM,680102,7,10,212,229,02
Sequoyah,U.S. House,Markwayne Mullin,REP,680102,6,26,282,314,02
Sequoyah,U.S. House,Michael Fulks,IND,680102,0,0,9,9,02
Sequoyah,State House,Rick Agent,DEM,680102,6,12,253,271,2
Sequoyah,State House,John Bennett,REP,680102,7,24,264,295,2
Sequoyah,President,Barack Obama,DEM,680103,8,12,189,209,
Sequoyah,President,Mitt Romney,REP,680103,16,67,525,608,
Sequoyah,U.S. House,Rob Wallace,DEM,680103,10,18,277,305,02
Sequoyah,U.S. House,Markwayne Mullin,REP,680103,15,56,403,474,02
Sequoyah,U.S. House,Michael Fulks,IND,680103,1,4,27,32,02
Sequoyah,State House,Rick Agent,DEM,680103,15,36,366,417,2
Sequoyah,State House,John Bennett,REP,680103,11,43,353,407,2
Sequoyah,President,Barack Obama,DEM,680104,3,11,149,163,
Sequoyah,President,Mitt Romney,REP,680104,17,48,542,607,
Sequoyah,U.S. House,Rob Wallace,DEM,680104,3,12,203,218,02
Sequoyah,U.S. House,Markwayne Mullin,REP,680104,17,45,449,511,02
Sequoyah,U.S. House,Michael Fulks,IND,680104,0,1,33,34,02
Sequoyah,State House,Rick Agent,DEM,680104,5,15,252,272,2
Sequoyah,State House,John Bennett,REP,680104,15,45,440,500,2
Sequoyah,President,Barack Obama,DEM,680105,15,23,178,216,
Sequoyah,President,Mitt Romney,REP,680105,22,40,558,620,
Sequoyah,U.S. House,Rob Wallace,DEM,680105,16,27,227,270,02
Sequoyah,U.S. House,Markwayne Mullin,REP,680105,21,31,463,515,02
Sequoyah,U.S. House,Michael Fulks,IND,680105,0,4,26,30,02
Sequoyah,State House,Rick Agent,DEM,680105,11,29,268,308,2
Sequoyah,State House,John Bennett,REP,680105,26,33,456,515,2
Sequoyah,President,Barack Obama,DEM,680106,0,12,102,114,
Sequoyah,President,Mitt Romney,REP,680106,11,31,373,415,
Sequoyah,U.S. House,Rob Wallace,DEM,680106,2,15,144,161,02
Sequoyah,U.S. House,Markwayne Mullin,REP,680106,10,26,298,334,02
Sequoyah,U.S. House,Michael Fulks,IND,680106,0,1,27,28,02
Sequoyah,State House,Rick Agent,DEM,680106,2,17,193,212,2
Sequoyah,State House,John Bennett,REP,680106,10,26,282,318,2
Sequoyah,President,Barack Obama,DEM,680201,4,12,80,96,
Sequoyah,President,Mitt Romney,REP,680201,4,16,138,158,
Sequoyah,U.S. House,Rob Wallace,DEM,680201,5,12,97,114,02
Sequoyah,U.S. House,Markwayne Mullin,REP,680201,2,16,116,134,02
Sequoyah,U.S. House,Michael Fulks,IND,680201,1,0,9,10,02
Sequoyah,President,Barack Obama,DEM,680202,7,10,206,223,
Sequoyah,President,Mitt Romney,REP,680202,12,21,288,321,
Sequoyah,U.S. House,Rob Wallace,DEM,680202,6,13,225,244,02
Sequoyah,U.S. House,Markwayne Mullin,REP,680202,11,17,245,273,02
Sequoyah,U.S. House,Michael Fulks,IND,680202,1,1,18,20,02
Sequoyah,State House,Rick Agent,DEM,680202,5,6,227,238,2
Sequoyah,State House,John Bennett,REP,680202,14,25,266,305,2
Sequoyah,President,Barack Obama,DEM,680203,2,3,79,84,
Sequoyah,President,Mitt Romney,REP,680203,8,11,120,139,
Sequoyah,U.S. House,Rob Wallace,DEM,680203,5,2,95,102,02
Sequoyah,U.S. House,Markwayne Mullin,REP,680203,5,10,100,115,02
Sequoyah,U.S. House,Michael Fulks,IND,680203,0,1,6,7,02
Sequoyah,President,Barack Obama,DEM,680204,0,2,79,81,
Sequoyah,President,Mitt Romney,REP,680204,6,20,133,159,
Sequoyah,U.S. House,Rob Wallace,DEM,680204,0,2,77,79,02
Sequoyah,U.S. House,Markwayne Mullin,REP,680204,5,18,122,145,02
Sequoyah,U.S. House,Michael Fulks,IND,680204,1,0,5,6,02
Sequoyah,State House,Rick Agent,DEM,680204,3,6,98,107,2
Sequoyah,State House,John Bennett,REP,680204,3,16,118,137,2
Sequoyah,President,Barack Obama,DEM,680205,12,64,267,343,
Sequoyah,President,Mitt Romney,REP,680205,18,132,415,565,
Sequoyah,U.S. House,Rob Wallace,DEM,680205,18,85,302,405,02
Sequoyah,U.S. House,Markwayne Mullin,REP,680205,11,97,326,434,02
Sequoyah,U.S. House,Michael Fulks,IND,680205,2,10,40,52,02
Sequoyah,State House,Rick Agent,DEM,680205,20,96,368,484,2
Sequoyah,State House,John Bennett,REP,680205,10,100,315,425,2
Sequoyah,President,Barack Obama,DEM,680206,4,20,73,97,
Sequoyah,President,Mitt Romney,REP,680206,8,63,151,222,
Sequoyah,U.S. House,Rob Wallace,DEM,680206,4,32,99,135,02
Sequoyah,U.S. House,Markwayne Mullin,REP,680206,9,51,117,177,02
Sequoyah,U.S. House,Michael Fulks,IND,680206,0,0,7,7,02
Sequoyah,State House,Rick Agent,DEM,680206,6,39,120,165,2
Sequoyah,State House,John Bennett,REP,680206,7,45,107,159,2
Sequoyah,President,Barack Obama,DEM,680207,7,17,142,166,
Sequoyah,President,Mitt Romney,REP,680207,11,27,217,255,
Sequoyah,U.S. House,Rob Wallace,DEM,680207,6,17,139,162,02
Sequoyah,U.S. House,Markwayne Mullin,REP,680207,10,25,206,241,02
Sequoyah,U.S. House,Michael Fulks,IND,680207,2,2,16,20,02
Sequoyah,State House,Rick Agent,DEM,680207,9,18,157,184,2
Sequoyah,State House,John Bennett,REP,680207,9,26,208,243,2
Sequoyah,President,Barack Obama,DEM,680208,7,15,233,255,
Sequoyah,President,Mitt Romney,REP,680208,14,35,310,359,
Sequoyah,U.S. House,Rob Wallace,DEM,680208,10,19,248,277,02
Sequoyah,U.S. House,Markwayne Mullin,REP,680208,12,30,259,301,02
Sequoyah,U.S. House,Michael Fulks,IND,680208,1,1,32,34,02
Sequoyah,President,Barack Obama,DEM,680209,6,6,150,162,
Sequoyah,President,Mitt Romney,REP,680209,15,15,306,336,
Sequoyah,U.S. House,Rob Wallace,DEM,680209,9,12,180,201,02
Sequoyah,U.S. House,Markwayne Mullin,REP,680209,12,9,248,269,02
Sequoyah,U.S. House,Michael Fulks,IND,680209,0,0,21,21,02
Sequoyah,President,Barack Obama,DEM,680210,2,7,138,147,
Sequoyah,President,Mitt Romney,REP,680210,22,11,300,333,
Sequoyah,U.S. House,Rob Wallace,DEM,680210,2,7,179,188,02
Sequoyah,U.S. House,Markwayne Mullin,REP,680210,21,11,244,276,02
Sequoyah,U.S. House,Michael Fulks,IND,680210,0,0,13,13,02
Sequoyah,President,Barack Obama,DEM,680301,7,35,198,240,
Sequoyah,President,Mitt Romney,REP,680301,21,134,435,590,
Sequoyah,U.S. House,Rob Wallace,DEM,680301,7,57,242,306,02
Sequoyah,U.S. House,Markwayne Mullin,REP,680301,20,109,353,482,02
Sequoyah,U.S. House,Michael Fulks,IND,680301,0,3,22,25,02
Sequoyah,State House,Rick Agent,DEM,680301,14,85,337,436,2
Sequoyah,State House,John Bennett,REP,680301,14,85,296,395,2
Sequoyah,President,Barack Obama,DEM,680302,6,21,83,110,
Sequoyah,President,Mitt Romney,REP,680302,8,47,159,214,
Sequoyah,U.S. House,Rob Wallace,DEM,680302,8,32,102,142,02
Sequoyah,U.S. House,Markwayne Mullin,REP,680302,4,34,131,169,02
Sequoyah,U.S. House,Michael Fulks,IND,680302,0,1,8,9,02
Sequoyah,State House,Rick Agent,DEM,680302,8,37,111,156,2
Sequoyah,State House,John Bennett,REP,680302,6,30,130,166,2
Sequoyah,President,Barack Obama,DEM,680303,10,40,196,246,
Sequoyah,President,Mitt Romney,REP,680303,26,111,428,565,
Sequoyah,U.S. House,Rob Wallace,DEM,680303,12,65,247,324,02
Sequoyah,U.S. House,Markwayne Mullin,REP,680303,21,77,342,440,02
Sequoyah,U.S. House,Michael Fulks,IND,680303,2,10,28,40,02
Sequoyah,State House,Rick Agent,DEM,680303,21,88,311,420,2
Sequoyah,State House,John Bennett,REP,680303,15,64,316,395,2
Sequoyah,President,Barack Obama,DEM,680304,4,10,110,124,
Sequoyah,President,Mitt Romney,REP,680304,5,34,285,324,
Sequoyah,U.S. House,Rob Wallace,DEM,680304,4,12,149,165,02
Sequoyah,U.S. House,Markwayne Mullin,REP,680304,3,27,223,253,02
Sequoyah,U.S. House,Michael Fulks,IND,680304,1,4,18,23,02
Sequoyah,State House,Rick Agent,DEM,680304,7,16,165,188,2
Sequoyah,State House,John Bennett,REP,680304,2,28,232,262,2
Sequoyah,President,Barack Obama,DEM,680305,2,7,89,98,
Sequoyah,President,Mitt Romney,REP,680305,9,33,208,250,
Sequoyah,U.S. House,Rob Wallace,DEM,680305,5,7,112,124,02
Sequoyah,U.S. House,Markwayne Mullin,REP,680305,6,31,171,208,02
Sequoyah,U.S. House,Michael Fulks,IND,680305,1,3,13,17,02
Sequoyah,State House,Rick Agent,DEM,680305,2,16,165,183,2
Sequoyah,State House,John Bennett,REP,680305,11,25,137,173,2
Sequoyah,President,Barack Obama,DEM,680306,9,20,163,192,
Sequoyah,President,Mitt Romney,REP,680306,21,64,349,434,
Sequoyah,U.S. House,Rob Wallace,DEM,680306,12,33,200,245,02
Sequoyah,U.S. House,Markwayne Mullin,REP,680306,18,49,280,347,02
Sequoyah,U.S. House,Michael Fulks,IND,680306,0,2,21,23,02
Sequoyah,State House,Rick Agent,DEM,680306,13,45,251,309,2
Sequoyah,State House,John Bennett,REP,680306,17,39,261,317,2
Sequoyah,President,Barack Obama,DEM,680307,2,13,98,113,
Sequoyah,President,Mitt Romney,REP,680307,13,31,241,285,
Sequoyah,U.S. House,Rob Wallace,DEM,680307,3,21,129,153,02
Sequoyah,U.S. House,Markwayne Mullin,REP,680307,12,18,185,215,02
Sequoyah,U.S. House,Michael Fulks,IND,680307,0,5,13,18,02
Sequoyah,State House,Rick Agent,DEM,680307,6,18,152,176,2
Sequoyah,State House,John Bennett,REP,680307,9,27,190,226,2
Sequoyah,President,Barack Obama,DEM,680308,5,17,72,94,
Sequoyah,President,Mitt Romney,REP,680308,2,22,150,174,
Sequoyah,U.S. House,Rob Wallace,DEM,680308,5,21,91,117,02
Sequoyah,U.S. House,Markwayne Mullin,REP,680308,6,14,120,140,02
Sequoyah,U.S. House,Michael Fulks,IND,680308,0,2,10,12,02
Sequoyah,State House,Rick Agent,DEM,680308,4,20,108,132,2
Sequoyah,State House,John Bennett,REP,680308,7,19,119,145,2
Sequoyah,President,Barack Obama,DEM,680309,4,7,81,92,
Sequoyah,President,Mitt Romney,REP,680309,10,17,236,263,
Sequoyah,U.S. House,Rob Wallace,DEM,680309,10,9,125,144,02
Sequoyah,U.S. House,Markwayne Mullin,REP,680309,5,14,175,194,02
Sequoyah,U.S. House,Michael Fulks,IND,680309,2,1,11,14,02
Sequoyah,State House,Rick Agent,DEM,680309,8,9,156,173,2
Sequoyah,State House,John Bennett,REP,680309,9,15,161,185,2
Sequoyah,President,Barack Obama,DEM,680310,0,6,87,93,
Sequoyah,President,Mitt Romney,REP,680310,8,14,257,279,
Sequoyah,U.S. House,Rob Wallace,DEM,680310,2,13,122,137,02
Sequoyah,U.S. House,Markwayne Mullin,REP,680310,6,5,199,210,02
Sequoyah,U.S. House,Michael Fulks,IND,680310,0,0,19,19,02
Sequoyah,State House,Rick Agent,DEM,680310,3,13,168,184,2
Sequoyah,State House,John Bennett,REP,680310,6,6,178,190,2
Stephens,President,Barack Obama,DEM,690001,6,13,125,144,
Stephens,President,Mitt Romney,REP,690001,20,77,609,706,
Stephens,U.S. House,Donna Marie Bebo,DEM,690001,5,10,103,118,04
Stephens,U.S. House,Tom Cole,REP,690001,21,77,615,713,04
Stephens,U.S. House,Rj Harris,IND,690001,0,3,21,24,04
Stephens,State Senate,Mike Fullerton,DEM,690001,6,13,163,182,43
Stephens,State Senate,Corey Brooks,REP,690001,19,77,569,665,43
Stephens,President,Barack Obama,DEM,690003,15,19,134,168,
Stephens,President,Mitt Romney,REP,690003,22,68,551,641,
Stephens,U.S. House,Donna Marie Bebo,DEM,690003,11,15,105,131,04
Stephens,U.S. House,Tom Cole,REP,690003,24,70,561,655,04
Stephens,U.S. House,Rj Harris,IND,690003,1,2,13,16,04
Stephens,State Senate,Mike Fullerton,DEM,690003,12,23,165,200,43
Stephens,State Senate,Corey Brooks,REP,690003,23,64,509,596,43
Stephens,President,Barack Obama,DEM,690004,5,31,227,263,
Stephens,President,Mitt Romney,REP,690004,29,57,587,673,
Stephens,U.S. House,Donna Marie Bebo,DEM,690004,3,30,169,202,04
Stephens,U.S. House,Tom Cole,REP,690004,30,53,602,685,04
Stephens,U.S. House,Rj Harris,IND,690004,1,4,40,45,04
Stephens,State Senate,Mike Fullerton,DEM,690004,6,34,276,316,43
Stephens,State Senate,Corey Brooks,REP,690004,28,51,520,599,43
Stephens,President,Barack Obama,DEM,690008,6,34,321,361,
Stephens,President,Mitt Romney,REP,690008,9,23,375,407,
Stephens,U.S. House,Donna Marie Bebo,DEM,690008,6,33,267,306,04
Stephens,U.S. House,Tom Cole,REP,690008,8,22,380,410,04
Stephens,U.S. House,Rj Harris,IND,690008,1,3,43,47,04
Stephens,State Senate,Mike Fullerton,DEM,690008,8,37,356,401,43
Stephens,State Senate,Corey Brooks,REP,690008,6,21,329,356,43
Stephens,President,Barack Obama,DEM,690012,7,29,205,241,
Stephens,President,Mitt Romney,REP,690012,19,64,487,570,
Stephens,U.S. House,Donna Marie Bebo,DEM,690012,6,31,172,209,04
Stephens,U.S. House,Tom Cole,REP,690012,17,58,482,557,04
Stephens,U.S. House,Rj Harris,IND,690012,3,4,35,42,04
Stephens,State Senate,Mike Fullerton,DEM,690012,9,40,261,310,43
Stephens,State Senate,Corey Brooks,REP,690012,16,52,418,486,43
Stephens,President,Barack Obama,DEM,690013,20,12,100,132,
Stephens,President,Mitt Romney,REP,690013,5,6,131,142,
Stephens,U.S. House,Donna Marie Bebo,DEM,690013,18,12,88,118,04
Stephens,U.S. House,Tom Cole,REP,690013,6,6,131,143,04
Stephens,U.S. House,Rj Harris,IND,690013,0,0,8,8,04
Stephens,State Senate,Mike Fullerton,DEM,690013,19,12,114,145,43
Stephens,State Senate,Corey Brooks,REP,690013,4,6,113,123,43
Stephens,President,Barack Obama,DEM,690014,7,26,217,250,
Stephens,President,Mitt Romney,REP,690014,31,117,791,939,
Stephens,U.S. House,Donna Marie Bebo,DEM,690014,5,22,191,218,04
Stephens,U.S. House,Tom Cole,REP,690014,30,118,769,917,04
Stephens,U.S. House,Rj Harris,IND,690014,2,3,44,49,04
Stephens,State Senate,Tony Terrill,DEM,690014,5,29,250,284,31
Stephens,State Senate,Don Barrington,REP,690014,31,115,744,890,31
Stephens,President,Barack Obama,DEM,690015,0,7,46,53,
Stephens,President,Mitt Romney,REP,690015,5,13,143,161,
Stephens,U.S. House,Donna Marie Bebo,DEM,690015,0,5,44,49,04
Stephens,U.S. House,Tom Cole,REP,690015,5,15,140,160,04
Stephens,U.S. House,Rj Harris,IND,690015,0,0,7,7,04
Stephens,State Senate,Tony Terrill,DEM,690015,0,7,47,54,31
Stephens,State Senate,Don Barrington,REP,690015,5,12,143,160,31
Stephens,President,Barack Obama,DEM,690016,12,35,223,270,
Stephens,President,Mitt Romney,REP,690016,47,120,873,1040,
Stephens,U.S. House,Donna Marie Bebo,DEM,690016,8,35,184,227,04
Stephens,U.S. House,Tom Cole,REP,690016,47,114,873,1034,04
Stephens,U.S. House,Rj Harris,IND,690016,3,7,38,48,04
Stephens,State Senate,Tony Terrill,DEM,690016,10,41,243,294,31
Stephens,State Senate,Don Barrington,REP,690016,48,115,847,1010,31
Stephens,President,Barack Obama,DEM,690019,12,47,208,267,
Stephens,President,Mitt Romney,REP,690019,55,126,821,1002,
Stephens,U.S. House,Donna Marie Bebo,DEM,690019,10,37,175,222,04
Stephens,U.S. House,Tom Cole,REP,690019,55,136,821,1012,04
Stephens,U.S. House,Rj Harris,IND,690019,1,0,28,29,04
Stephens,State Senate,Mike Fullerton,DEM,690019,15,50,269,334,43
Stephens,State Senate,Corey Brooks,REP,690019,51,122,746,919,43
Stephens,President,Barack Obama,DEM,690032,4,10,222,236,
Stephens,President,Mitt Romney,REP,690032,16,23,658,697,
Stephens,U.S. House,Donna Marie Bebo,DEM,690032,2,13,170,185,04
Stephens,U.S. House,Tom Cole,REP,690032,17,21,671,709,04
Stephens,U.S. House,Rj Harris,IND,690032,1,1,34,36,04
Stephens,State Senate,Mike Fullerton,DEM,690032,6,16,283,305,43
Stephens,State Senate,Corey Brooks,REP,690032,12,19,584,615,43
Stephens,State House,Stewart Meyer,DEM,690032,7,16,345,368,51
Stephens,State House,Scott Biggs,REP,690032,11,19,525,555,51
Stephens,President,Barack Obama,DEM,690033,17,18,231,266,
Stephens,President,Mitt Romney,REP,690033,30,53,793,876,
Stephens,U.S. House,Donna Marie Bebo,DEM,690033,12,15,192,219,04
Stephens,U.S. House,Tom Cole,REP,690033,30,52,792,874,04
Stephens,U.S. House,Rj Harris,IND,690033,3,4,37,44,04
Stephens,State Senate,Mike Fullerton,DEM,690033,14,25,305,344,43
Stephens,State Senate,Corey Brooks,REP,690033,30,45,713,788,43
Stephens,State House,Stewart Meyer,DEM,690033,16,30,346,392,51
Stephens,State House,Scott Biggs,REP,690033,29,40,670,739,51
Stephens,President,Barack Obama,DEM,690041,2,5,157,164,
Stephens,President,Mitt Romney,REP,690041,13,29,518,560,
Stephens,U.S. House,Donna Marie Bebo,DEM,690041,2,5,136,143,04
Stephens,U.S. House,Tom Cole,REP,690041,12,29,515,556,04
Stephens,U.S. House,Rj Harris,IND,690041,0,0,28,28,04
Stephens,State Senate,Mike Fullerton,DEM,690041,2,6,232,240,43
Stephens,State Senate,Corey Brooks,REP,690041,11,28,442,481,43
Stephens,President,Barack Obama,DEM,690049,0,0,28,28,
Stephens,President,Mitt Romney,REP,690049,2,4,119,125,
Stephens,U.S. House,Donna Marie Bebo,DEM,690049,0,0,21,21,04
Stephens,U.S. House,Tom Cole,REP,690049,1,4,118,123,04
Stephens,U.S. House,Rj Harris,IND,690049,0,0,8,8,04
Stephens,State Senate,Tony Terrill,DEM,690049,0,0,31,31,31
Stephens,State Senate,Don Barrington,REP,690049,2,4,115,121,31
Stephens,State House,Stewart Meyer,DEM,690049,0,0,55,55,51
Stephens,State House,Scott Biggs,REP,690049,2,4,88,94,51
Stephens,President,Barack Obama,DEM,690050,6,26,179,211,
Stephens,President,Mitt Romney,REP,690050,30,94,839,963,
Stephens,U.S. House,Donna Marie Bebo,DEM,690050,5,23,155,183,04
Stephens,U.S. House,Tom Cole,REP,690050,29,96,825,950,04
Stephens,U.S. House,Rj Harris,IND,690050,2,1,38,41,04
Stephens,State Senate,Mike Fullerton,DEM,690050,5,31,256,292,43
Stephens,State Senate,Corey Brooks,REP,690050,30,88,756,874,43
Stephens,State House,Stewart Meyer,DEM,690050,9,40,283,332,51
Stephens,State House,Scott Biggs,REP,690050,27,78,726,831,51
Stephens,President,Barack Obama,DEM,690051,0,1,79,80,
Stephens,President,Mitt Romney,REP,690051,15,20,270,305,
Stephens,U.S. House,Donna Marie Bebo,DEM,690051,1,1,71,73,04
Stephens,U.S. House,Tom Cole,REP,690051,13,16,266,295,04
Stephens,U.S. House,Rj Harris,IND,690051,1,4,9,14,04
Stephens,State Senate,Tony Terrill,DEM,690051,3,2,82,87,31
Stephens,State Senate,Don Barrington,REP,690051,12,19,263,294,31
Stephens,President,Barack Obama,DEM,690052,0,4,32,36,
Stephens,President,Mitt Romney,REP,690052,9,16,91,116,
Stephens,U.S. House,Donna Marie Bebo,DEM,690052,0,4,23,27,04
Stephens,U.S. House,Tom Cole,REP,690052,10,16,91,117,04
Stephens,U.S. House,Rj Harris,IND,690052,0,0,7,7,04
Stephens,State Senate,Mike Fullerton,DEM,690052,1,6,32,39,43
Stephens,State Senate,Corey Brooks,REP,690052,9,13,87,109,43
Stephens,President,Barack Obama,DEM,690053,0,7,27,34,
Stephens,President,Mitt Romney,REP,690053,3,7,147,157,
Stephens,U.S. House,Donna Marie Bebo,DEM,690053,0,6,19,25,04
Stephens,U.S. House,Tom Cole,REP,690053,3,8,148,159,04
Stephens,U.S. House,Rj Harris,IND,690053,0,0,7,7,04
Stephens,State Senate,Mike Fullerton,DEM,690053,0,7,42,49,43
Stephens,State Senate,Corey Brooks,REP,690053,3,7,130,140,43
Stephens,State House,Stewart Meyer,DEM,690053,0,7,44,51,51
Stephens,State House,Scott Biggs,REP,690053,3,7,128,138,51
Stephens,President,Barack Obama,DEM,690054,3,0,47,50,
Stephens,President,Mitt Romney,REP,690054,5,11,184,200,
Stephens,U.S. House,Donna Marie Bebo,DEM,690054,3,1,51,55,04
Stephens,U.S. House,Tom Cole,REP,690054,5,10,168,183,04
Stephens,U.S. House,Rj Harris,IND,690054,0,0,17,17,04
Stephens,State Senate,Mike Fullerton,DEM,690054,3,2,92,97,43
Stephens,State Senate,Corey Brooks,REP,690054,5,9,143,157,43
Stephens,State House,Stewart Meyer,DEM,690054,2,2,94,98,51
Stephens,State House,Scott Biggs,REP,690054,4,9,141,154,51
Stephens,President,Barack Obama,DEM,690055,1,4,61,66,
Stephens,President,Mitt Romney,REP,690055,5,12,168,185,
Stephens,U.S. House,Donna Marie Bebo,DEM,690055,1,5,59,65,04
Stephens,U.S. House,Tom Cole,REP,690055,4,11,158,173,04
Stephens,U.S. House,Rj Harris,IND,690055,1,0,9,10,04
Stephens,State Senate,Mike Fullerton,DEM,690055,1,5,85,91,43
Stephens,State Senate,Corey Brooks,REP,690055,5,11,138,154,43
Stephens,State House,Stewart Meyer,DEM,690055,2,8,100,110,51
Stephens,State House,Scott Biggs,REP,690055,4,8,124,136,51
Stephens,President,Barack Obama,DEM,690056,2,2,48,52,
Stephens,President,Mitt Romney,REP,690056,7,9,248,264,
Stephens,U.S. House,Donna Marie Bebo,DEM,690056,2,2,52,56,04
Stephens,U.S. House,Tom Cole,REP,690056,7,9,237,253,04
Stephens,U.S. House,Rj Harris,IND,690056,0,0,4,4,04
Stephens,State Senate,Mike Fullerton,DEM,690056,3,1,69,73,43
Stephens,State Senate,Corey Brooks,REP,690056,6,9,222,237,43
Stephens,State House,Stewart Meyer,DEM,690056,3,2,90,95,51
Stephens,State House,Scott Biggs,REP,690056,6,7,202,215,51
Stephens,President,Barack Obama,DEM,690057,6,12,102,120,
Stephens,President,Mitt Romney,REP,690057,11,56,449,516,
Stephens,U.S. House,Donna Marie Bebo,DEM,690057,2,9,80,91,04
Stephens,U.S. House,Tom Cole,REP,690057,11,56,445,512,04
Stephens,U.S. House,Rj Harris,IND,690057,3,2,22,27,04
Stephens,State Senate,Mike Fullerton,DEM,690057,5,15,147,167,43
Stephens,State Senate,Corey Brooks,REP,690057,11,51,399,461,43
Stephens,President,Barack Obama,DEM,690058,0,0,66,66,
Stephens,President,Mitt Romney,REP,690058,2,13,274,289,
Stephens,U.S. House,Donna Marie Bebo,DEM,690058,0,1,60,61,04
Stephens,U.S. House,Tom Cole,REP,690058,2,12,259,273,04
Stephens,U.S. House,Rj Harris,IND,690058,0,0,16,16,04
Stephens,State Senate,Mike Fullerton,DEM,690058,0,1,91,92,43
Stephens,State Senate,Corey Brooks,REP,690058,2,12,244,258,43
Stephens,State House,Stewart Meyer,DEM,690058,0,1,120,121,51
Stephens,State House,Scott Biggs,REP,690058,2,11,209,222,51
Stephens,President,Barack Obama,DEM,690059,2,4,31,37,
Stephens,President,Mitt Romney,REP,690059,9,22,165,196,
Stephens,U.S. House,Donna Marie Bebo,DEM,690059,3,3,31,37,04
Stephens,U.S. House,Tom Cole,REP,690059,8,22,156,186,04
Stephens,U.S. House,Rj Harris,IND,690059,0,0,8,8,04
Stephens,State Senate,Mike Fullerton,DEM,690059,3,5,45,53,43
Stephens,State Senate,Corey Brooks,REP,690059,8,20,147,175,43
Stephens,President,Barack Obama,DEM,690060,0,2,6,8,
Stephens,President,Mitt Romney,REP,690060,1,3,14,18,
Stephens,U.S. House,Donna Marie Bebo,DEM,690060,0,2,4,6,04
Stephens,U.S. House,Tom Cole,REP,690060,1,3,15,19,04
Stephens,U.S. House,Rj Harris,IND,690060,0,0,1,1,04
Stephens,State Senate,Mike Fullerton,DEM,690060,0,2,10,12,43
Stephens,State Senate,Corey Brooks,REP,690060,1,3,10,14,43
Stephens,President,Barack Obama,DEM,690061,2,16,118,136,
Stephens,President,Mitt Romney,REP,690061,14,34,461,509,
Stephens,U.S. House,Donna Marie Bebo,DEM,690061,2,11,122,135,04
Stephens,U.S. House,Tom Cole,REP,690061,10,37,430,477,04
Stephens,U.S. House,Rj Harris,IND,690061,4,1,26,31,04
Stephens,State Senate,Mike Fullerton,DEM,690061,3,17,184,204,43
Stephens,State Senate,Corey Brooks,REP,690061,12,31,392,435,43
Stephens,President,Barack Obama,DEM,690062,3,8,117,128,
Stephens,President,Mitt Romney,REP,690062,10,17,357,384,
Stephens,U.S. House,Donna Marie Bebo,DEM,690062,1,7,111,119,04
Stephens,U.S. House,Tom Cole,REP,690062,10,14,343,367,04
Stephens,U.S. House,Rj Harris,IND,690062,1,3,24,28,04
Stephens,State Senate,Tony Terrill,DEM,690062,2,9,127,138,31
Stephens,State Senate,Don Barrington,REP,690062,10,15,347,372,31
Stephens,President,Barack Obama,DEM,690063,2,6,64,72,
Stephens,President,Mitt Romney,REP,690063,7,18,242,267,
Stephens,U.S. House,Donna Marie Bebo,DEM,690063,1,6,55,62,04
Stephens,U.S. House,Tom Cole,REP,690063,7,18,235,260,04
Stephens,U.S. House,Rj Harris,IND,690063,1,0,18,19,04
Stephens,State Senate,Tony Terrill,DEM,690063,1,8,70,79,31
Stephens,State Senate,Don Barrington,REP,690063,6,16,235,257,31
Texas,President,Barack Obama,DEM,700101,9,3,73,85,
Texas,President,Mitt Romney,REP,700101,42,30,653,725,
Texas,U.S. House,Timothy Ray Murray,DEM,700101,4,1,55,60,03
Texas,U.S. House,Frank Lucas,REP,700101,48,29,654,731,03
Texas,U.S. House,William Sanders,IND,700101,0,2,18,20,03
Texas,State Senate,A. Bryce Marlatt,REP,700101,46,27,631,704,27
Texas,State Senate,Tommy Nicholson,IND,700101,2,5,86,93,27
Texas,President,Barack Obama,DEM,700102,5,18,70,93,
Texas,President,Mitt Romney,REP,700102,9,56,195,260,
Texas,U.S. House,Timothy Ray Murray,DEM,700102,4,15,53,72,03
Texas,U.S. House,Frank Lucas,REP,700102,9,53,194,256,03
Texas,U.S. House,William Sanders,IND,700102,1,5,16,22,03
Texas,State Senate,A. Bryce Marlatt,REP,700102,9,51,186,246,27
Texas,State Senate,Tommy Nicholson,IND,700102,4,19,70,93,27
Texas,President,Barack Obama,DEM,700104,11,0,45,56,
Texas,President,Mitt Romney,REP,700104,29,4,321,354,
Texas,U.S. House,Timothy Ray Murray,DEM,700104,6,0,38,44,03
Texas,U.S. House,Frank Lucas,REP,700104,31,4,304,339,03
Texas,U.S. House,William Sanders,IND,700104,3,0,21,24,03
Texas,State Senate,A. Bryce Marlatt,REP,700104,25,4,297,326,27
Texas,State Senate,Tommy Nicholson,IND,700104,14,0,62,76,27
Texas,President,Barack Obama,DEM,700107,1,2,12,15,
Texas,President,Mitt Romney,REP,700107,8,9,139,156,
Texas,U.S. House,Timothy Ray Murray,DEM,700107,1,1,9,11,03
Texas,U.S. House,Frank Lucas,REP,700107,7,8,136,151,03
Texas,U.S. House,William Sanders,IND,700107,1,2,11,14,03
Texas,State Senate,A. Bryce Marlatt,REP,700107,6,7,130,143,27
Texas,State Senate,Tommy Nicholson,IND,700107,3,4,23,30,27
Texas,President,Barack Obama,DEM,700201,5,15,98,118,
Texas,President,Mitt Romney,REP,700201,43,129,633,805,
Texas,U.S. House,Timothy Ray Murray,DEM,700201,2,12,80,94,03
Texas,U.S. House,Frank Lucas,REP,700201,44,124,616,784,03
Texas,U.S. House,William Sanders,IND,700201,2,7,31,40,03
Texas,State Senate,A. Bryce Marlatt,REP,700201,45,120,597,762,27
Texas,State Senate,Tommy Nicholson,IND,700201,3,19,111,133,27
Texas,President,Barack Obama,DEM,700202,1,17,66,84,
Texas,President,Mitt Romney,REP,700202,14,87,218,319,
Texas,U.S. House,Timothy Ray Murray,DEM,700202,1,14,53,68,03
Texas,U.S. House,Frank Lucas,REP,700202,13,82,217,312,03
Texas,U.S. House,William Sanders,IND,700202,0,7,12,19,03
Texas,State Senate,A. Bryce Marlatt,REP,700202,13,80,210,303,27
Texas,State Senate,Tommy Nicholson,IND,700202,1,17,58,76,27
Texas,President,Barack Obama,DEM,700205,10,14,70,94,
Texas,President,Mitt Romney,REP,700205,25,162,481,668,
Texas,U.S. House,Timothy Ray Murray,DEM,700205,7,12,61,80,03
Texas,U.S. House,Frank Lucas,REP,700205,27,158,458,643,03
Texas,U.S. House,William Sanders,IND,700205,1,4,27,32,03
Texas,State Senate,A. Bryce Marlatt,REP,700205,25,149,447,621,27
Texas,State Senate,Tommy Nicholson,IND,700205,6,21,91,118,27
Texas,President,Barack Obama,DEM,700302,1,2,8,11,
Texas,President,Mitt Romney,REP,700302,14,10,117,141,
Texas,U.S. House,Timothy Ray Murray,DEM,700302,1,2,7,10,03
Texas,U.S. House,Frank Lucas,REP,700302,13,10,112,135,03
Texas,U.S. House,William Sanders,IND,700302,1,1,6,8,03
Texas,State Senate,A. Bryce Marlatt,REP,700302,11,9,106,126,27
Texas,State Senate,Tommy Nicholson,IND,700302,4,2,17,23,27
Texas,President,Barack Obama,DEM,700303,5,2,58,65,
Texas,President,Mitt Romney,REP,700303,18,22,326,366,
Texas,U.S. House,Timothy Ray Murray,DEM,700303,5,2,39,46,03
Texas,U.S. House,Frank Lucas,REP,700303,16,19,322,357,03
Texas,U.S. House,William Sanders,IND,700303,1,3,16,20,03
Texas,State Senate,A. Bryce Marlatt,REP,700303,12,23,307,342,27
Texas,State Senate,Tommy Nicholson,IND,700303,5,1,55,61,27
Texas,President,Barack Obama,DEM,700304,3,2,70,75,
Texas,President,Mitt Romney,REP,700304,17,21,274,312,
Texas,U.S. House,Timothy Ray Murray,DEM,700304,2,2,50,54,03
Texas,U.S. House,Frank Lucas,REP,700304,16,21,258,295,03
Texas,U.S. House,William Sanders,IND,700304,1,0,34,35,03
Texas,State Senate,A. Bryce Marlatt,REP,700304,14,17,254,285,27
Texas,State Senate,Tommy Nicholson,IND,700304,4,6,83,93,27
Texas,President,Barack Obama,DEM,700305,1,25,140,166,
Texas,President,Mitt Romney,REP,700305,40,153,631,824,
Texas,U.S. House,Timothy Ray Murray,DEM,700305,1,18,102,121,03
Texas,U.S. House,Frank Lucas,REP,700305,35,146,627,808,03
Texas,U.S. House,William Sanders,IND,700305,4,12,39,55,03
Texas,State Senate,A. Bryce Marlatt,REP,700305,33,140,618,791,27
Texas,State Senate,Tommy Nicholson,IND,700305,5,29,129,163,27
Tillman,President,Barack Obama,DEM,710001,8,32,107,147,
Tillman,President,Mitt Romney,REP,710001,6,124,280,410,
Tillman,U.S. House,Donna Marie Bebo,DEM,710001,5,30,73,108,04
Tillman,U.S. House,Tom Cole,REP,710001,8,120,300,428,04
Tillman,U.S. House,Rj Harris,IND,710001,0,3,8,11,04
Tillman,State Senate,Tony Terrill,DEM,710001,8,40,89,137,31
Tillman,State Senate,Don Barrington,REP,710001,6,111,292,409,31
Tillman,President,Barack Obama,DEM,710002,3,28,119,150,
Tillman,President,Mitt Romney,REP,710002,7,53,153,213,
Tillman,U.S. House,Donna Marie Bebo,DEM,710002,2,22,82,106,04
Tillman,U.S. House,Tom Cole,REP,710002,7,56,171,234,04
Tillman,U.S. House,Rj Harris,IND,710002,1,3,18,22,04
Tillman,State Senate,Tony Terrill,DEM,710002,2,21,104,127,31
Tillman,State Senate,Don Barrington,REP,710002,8,59,166,233,31
Tillman,President,Barack Obama,DEM,710003,1,11,74,86,
Tillman,President,Mitt Romney,REP,710003,4,20,74,98,
Tillman,U.S. House,Donna Marie Bebo,DEM,710003,2,9,58,69,04
Tillman,U.S. House,Tom Cole,REP,710003,3,21,86,110,04
Tillman,U.S. House,Rj Harris,IND,710003,0,1,2,3,04
Tillman,State Senate,Tony Terrill,DEM,710003,2,10,67,79,31
Tillman,State Senate,Don Barrington,REP,710003,2,21,77,100,31
Tillman,President,Barack Obama,DEM,710004,2,19,87,108,
Tillman,President,Mitt Romney,REP,710004,3,38,114,155,
Tillman,U.S. House,Donna Marie Bebo,DEM,710004,2,18,74,94,04
Tillman,U.S. House,Tom Cole,REP,710004,2,38,117,157,04
Tillman,U.S. House,Rj Harris,IND,710004,0,1,8,9,04
Tillman,State Senate,Tony Terrill,DEM,710004,2,18,75,95,31
Tillman,State Senate,Don Barrington,REP,710004,2,38,123,163,31
Tillman,President,Barack Obama,DEM,710006,3,3,29,35,
Tillman,President,Mitt Romney,REP,710006,2,6,97,105,
Tillman,U.S. House,Donna Marie Bebo,DEM,710006,2,2,19,23,04
Tillman,U.S. House,Tom Cole,REP,710006,2,6,104,112,04
Tillman,U.S. House,Rj Harris,IND,710006,2,1,3,6,04
Tillman,State Senate,Tony Terrill,DEM,710006,4,1,17,22,31
Tillman,State Senate,Don Barrington,REP,710006,2,8,107,117,31
Tillman,President,Barack Obama,DEM,710007,1,1,120,122,
Tillman,President,Mitt Romney,REP,710007,10,3,297,310,
Tillman,U.S. House,Donna Marie Bebo,DEM,710007,1,0,100,101,04
Tillman,U.S. House,Tom Cole,REP,710007,9,4,296,309,04
Tillman,U.S. House,Rj Harris,IND,710007,1,0,16,17,04
Tillman,State Senate,Tony Terrill,DEM,710007,1,0,123,124,31
Tillman,State Senate,Don Barrington,REP,710007,8,4,288,300,31
Tillman,President,Barack Obama,DEM,710009,1,7,69,77,
Tillman,President,Mitt Romney,REP,710009,0,20,93,113,
Tillman,U.S. House,Donna Marie Bebo,DEM,710009,1,6,57,64,04
Tillman,U.S. House,Tom Cole,REP,710009,0,20,101,121,04
Tillman,U.S. House,Rj Harris,IND,710009,0,0,3,3,04
Tillman,State Senate,Tony Terrill,DEM,710009,1,7,65,73,31
Tillman,State Senate,Don Barrington,REP,710009,0,19,93,112,31
Tillman,President,Barack Obama,DEM,710010,3,7,143,153,
Tillman,President,Mitt Romney,REP,710010,8,17,278,303,
Tillman,U.S. House,Donna Marie Bebo,DEM,710010,3,7,118,128,04
Tillman,U.S. House,Tom Cole,REP,710010,8,17,286,311,04
Tillman,U.S. House,Rj Harris,IND,710010,0,0,15,15,04
Tillman,State Senate,Tony Terrill,DEM,710010,2,8,135,145,31
Tillman,State Senate,Don Barrington,REP,710010,8,15,278,301,31
Tillman,President,Barack Obama,DEM,710012,1,1,26,28,
Tillman,President,Mitt Romney,REP,710012,1,10,97,108,
Tillman,U.S. House,Donna Marie Bebo,DEM,710012,2,0,25,27,04
Tillman,U.S. House,Tom Cole,REP,710012,0,9,92,101,04
Tillman,U.S. House,Rj Harris,IND,710012,0,2,5,7,04
Tillman,State Senate,Tony Terrill,DEM,710012,2,2,35,39,31
Tillman,State Senate,Don Barrington,REP,710012,0,9,83,92,31
Tulsa,President,Barack Obama,DEM,720001,0,0,877,877,
Tulsa,President,Mitt Romney,REP,720001,0,0,28,28,
Tulsa,U.S. House,John Olson,DEM,720001,0,0,837,837,01
Tulsa,U.S. House,Jim Bridenstine,REP,720001,0,0,33,33,01
Tulsa,U.S. House,Craig Allen,IND,720001,0,0,28,28,01
Tulsa,State Senate,Jabar Shumate,DEM,720001,0,0,843,843,11
Tulsa,State Senate,Dave Bell,REP,720001,0,0,25,25,11
Tulsa,State Senate,Curtis Mullins,IND,720001,0,0,33,33,11
Tulsa,President,Barack Obama,DEM,720002,0,0,750,750,
Tulsa,President,Mitt Romney,REP,720002,0,0,83,83,
Tulsa,U.S. House,John Olson,DEM,720002,0,0,723,723,01
Tulsa,U.S. House,Jim Bridenstine,REP,720002,0,0,74,74,01
Tulsa,U.S. House,Craig Allen,IND,720002,0,0,29,29,01
Tulsa,State Senate,Jabar Shumate,DEM,720002,0,0,708,708,11
Tulsa,State Senate,Dave Bell,REP,720002,0,0,72,72,11
Tulsa,State Senate,Curtis Mullins,IND,720002,0,0,45,45,11
Tulsa,State House,Seneca Scott,DEM,720002,0,0,779,779,72
Tulsa,State House,Randall Reese,REP,720002,0,0,47,47,72
Tulsa,President,Barack Obama,DEM,720003,0,0,188,188,
Tulsa,President,Mitt Romney,REP,720003,0,0,157,157,
Tulsa,U.S. House,John Olson,DEM,720003,0,0,179,179,01
Tulsa,U.S. House,Jim Bridenstine,REP,720003,0,0,146,146,01
Tulsa,U.S. House,Craig Allen,IND,720003,0,0,19,19,01
Tulsa,State Senate,Jabar Shumate,DEM,720003,0,0,174,174,11
Tulsa,State Senate,Dave Bell,REP,720003,0,0,120,120,11
Tulsa,State Senate,Curtis Mullins,IND,720003,0,0,47,47,11
Tulsa,State House,Seneca Scott,DEM,720003,0,0,251,251,72
Tulsa,State House,Randall Reese,REP,720003,0,0,84,84,72
Tulsa,President,Barack Obama,DEM,720004,0,0,910,910,
Tulsa,President,Mitt Romney,REP,720004,0,0,47,47,
Tulsa,U.S. House,John Olson,DEM,720004,0,0,883,883,01
Tulsa,U.S. House,Jim Bridenstine,REP,720004,0,0,47,47,01
Tulsa,U.S. House,Craig Allen,IND,720004,0,0,22,22,01
Tulsa,State Senate,Jabar Shumate,DEM,720004,0,0,880,880,11
Tulsa,State Senate,Dave Bell,REP,720004,0,0,53,53,11
Tulsa,State Senate,Curtis Mullins,IND,720004,0,0,21,21,11
Tulsa,President,Barack Obama,DEM,720005,0,0,450,450,
Tulsa,President,Mitt Romney,REP,720005,0,0,37,37,
Tulsa,U.S. House,John Olson,DEM,720005,0,0,435,435,01
Tulsa,U.S. House,Jim Bridenstine,REP,720005,0,0,34,34,01
Tulsa,U.S. House,Craig Allen,IND,720005,0,0,11,11,01
Tulsa,State Senate,Jabar Shumate,DEM,720005,0,0,430,430,11
Tulsa,State Senate,Dave Bell,REP,720005,0,0,35,35,11
Tulsa,State Senate,Curtis Mullins,IND,720005,0,0,20,20,11
Tulsa,State House,Seneca Scott,DEM,720005,0,0,446,446,72
Tulsa,State House,Randall Reese,REP,720005,0,0,31,31,72
Tulsa,President,Barack Obama,DEM,720006,0,0,956,956,
Tulsa,President,Mitt Romney,REP,720006,0,0,30,30,
Tulsa,U.S. House,John Olson,DEM,720006,0,0,915,915,01
Tulsa,U.S. House,Jim Bridenstine,REP,720006,0,0,42,42,01
Tulsa,U.S. House,Craig Allen,IND,720006,0,0,16,16,01
Tulsa,State Senate,Jabar Shumate,DEM,720006,0,0,915,915,11
Tulsa,State Senate,Dave Bell,REP,720006,0,0,35,35,11
Tulsa,State Senate,Curtis Mullins,IND,720006,0,0,31,31,11
Tulsa,President,Barack Obama,DEM,720007,0,0,454,454,
Tulsa,President,Mitt Romney,REP,720007,0,0,29,29,
Tulsa,U.S. House,John Olson,DEM,720007,0,0,446,446,01
Tulsa,U.S. House,Jim Bridenstine,REP,720007,0,0,27,27,01
Tulsa,U.S. House,Craig Allen,IND,720007,0,0,7,7,01
Tulsa,State Senate,Jabar Shumate,DEM,720007,0,0,431,431,11
Tulsa,State Senate,Dave Bell,REP,720007,0,0,26,26,11
Tulsa,State Senate,Curtis Mullins,IND,720007,0,0,23,23,11
Tulsa,President,Barack Obama,DEM,720008,0,0,492,492,
Tulsa,President,Mitt Romney,REP,720008,0,0,65,65,
Tulsa,U.S. House,John Olson,DEM,720008,0,0,469,469,01
Tulsa,U.S. House,Jim Bridenstine,REP,720008,0,0,62,62,01
Tulsa,U.S. House,Craig Allen,IND,720008,0,0,28,28,01
Tulsa,State Senate,Jabar Shumate,DEM,720008,0,0,473,473,11
Tulsa,State Senate,Dave Bell,REP,720008,0,0,45,45,11
Tulsa,State Senate,Curtis Mullins,IND,720008,0,0,42,42,11
Tulsa,State House,Seneca Scott,DEM,720008,0,0,504,504,72
Tulsa,State House,Randall Reese,REP,720008,0,0,49,49,72
Tulsa,President,Barack Obama,DEM,720009,0,0,212,212,
Tulsa,President,Mitt Romney,REP,720009,0,0,19,19,
Tulsa,U.S. House,John Olson,DEM,720009,0,0,201,201,01
Tulsa,U.S. House,Jim Bridenstine,REP,720009,0,0,20,20,01
Tulsa,U.S. House,Craig Allen,IND,720009,0,0,7,7,01
Tulsa,State Senate,Jabar Shumate,DEM,720009,0,0,198,198,11
Tulsa,State Senate,Dave Bell,REP,720009,0,0,21,21,11
Tulsa,State Senate,Curtis Mullins,IND,720009,0,0,11,11,11
Tulsa,State House,Seneca Scott,DEM,720009,0,0,209,209,72
Tulsa,State House,Randall Reese,REP,720009,0,0,20,20,72
Tulsa,President,Barack Obama,DEM,720010,0,0,565,565,
Tulsa,President,Mitt Romney,REP,720010,0,0,28,28,
Tulsa,U.S. House,John Olson,DEM,720010,0,0,544,544,01
Tulsa,U.S. House,Jim Bridenstine,REP,720010,0,0,32,32,01
Tulsa,U.S. House,Craig Allen,IND,720010,0,0,14,14,01
Tulsa,State Senate,Jabar Shumate,DEM,720010,0,0,549,549,11
Tulsa,State Senate,Dave Bell,REP,720010,0,0,20,20,11
Tulsa,State Senate,Curtis Mullins,IND,720010,0,0,23,23,11
Tulsa,President,Barack Obama,DEM,720011,0,0,364,364,
Tulsa,President,Mitt Romney,REP,720011,0,0,173,173,
Tulsa,U.S. House,John Olson,DEM,720011,0,0,348,348,01
Tulsa,U.S. House,Jim Bridenstine,REP,720011,0,0,156,156,01
Tulsa,U.S. House,Craig Allen,IND,720011,0,0,30,30,01
Tulsa,State Senate,Jabar Shumate,DEM,720011,0,0,334,334,11
Tulsa,State Senate,Dave Bell,REP,720011,0,0,146,146,11
Tulsa,State Senate,Curtis Mullins,IND,720011,0,0,52,52,11
Tulsa,State House,Seneca Scott,DEM,720011,0,0,412,412,72
Tulsa,State House,Randall Reese,REP,720011,0,0,114,114,72
Tulsa,President,Barack Obama,DEM,720012,0,0,375,375,
Tulsa,President,Mitt Romney,REP,720012,0,0,140,140,
Tulsa,U.S. House,John Olson,DEM,720012,0,0,354,354,01
Tulsa,U.S. House,Jim Bridenstine,REP,720012,0,0,130,130,01
Tulsa,U.S. House,Craig Allen,IND,720012,0,0,27,27,01
Tulsa,State Senate,Jabar Shumate,DEM,720012,0,0,341,341,11
Tulsa,State Senate,Dave Bell,REP,720012,0,0,118,118,11
Tulsa,State Senate,Curtis Mullins,IND,720012,0,0,52,52,11
Tulsa,State House,Seneca Scott,DEM,720012,0,0,404,404,72
Tulsa,State House,Randall Reese,REP,720012,0,0,105,105,72
Tulsa,President,Barack Obama,DEM,720013,0,0,913,913,
Tulsa,President,Mitt Romney,REP,720013,0,0,28,28,
Tulsa,U.S. House,John Olson,DEM,720013,0,0,883,883,01
Tulsa,U.S. House,Jim Bridenstine,REP,720013,0,0,29,29,01
Tulsa,U.S. House,Craig Allen,IND,720013,0,0,22,22,01
Tulsa,State Senate,Jabar Shumate,DEM,720013,0,0,870,870,11
Tulsa,State Senate,Dave Bell,REP,720013,0,0,23,23,11
Tulsa,State Senate,Curtis Mullins,IND,720013,0,0,40,40,11
Tulsa,President,Barack Obama,DEM,720014,0,0,354,354,
Tulsa,President,Mitt Romney,REP,720014,0,0,39,39,
Tulsa,U.S. House,John Olson,DEM,720014,0,0,337,337,01
Tulsa,U.S. House,Jim Bridenstine,REP,720014,0,0,38,38,01
Tulsa,U.S. House,Craig Allen,IND,720014,0,0,14,14,01
Tulsa,State Senate,Jabar Shumate,DEM,720014,0,0,342,342,11
Tulsa,State Senate,Dave Bell,REP,720014,0,0,24,24,11
Tulsa,State Senate,Curtis Mullins,IND,720014,0,0,23,23,11
Tulsa,President,Barack Obama,DEM,720015,0,0,324,324,
Tulsa,President,Mitt Romney,REP,720015,0,0,68,68,
Tulsa,U.S. House,John Olson,DEM,720015,0,0,314,314,01
Tulsa,U.S. House,Jim Bridenstine,REP,720015,0,0,60,60,01
Tulsa,U.S. House,Craig Allen,IND,720015,0,0,16,16,01
Tulsa,State Senate,Jabar Shumate,DEM,720015,0,0,305,305,11
Tulsa,State Senate,Dave Bell,REP,720015,0,0,61,61,11
Tulsa,State Senate,Curtis Mullins,IND,720015,0,0,24,24,11
Tulsa,President,Barack Obama,DEM,720016,0,0,86,86,
Tulsa,President,Mitt Romney,REP,720016,0,0,76,76,
Tulsa,U.S. House,John Olson,DEM,720016,0,0,76,76,01
Tulsa,U.S. House,Jim Bridenstine,REP,720016,0,0,76,76,01
Tulsa,U.S. House,Craig Allen,IND,720016,0,0,11,11,01
Tulsa,State Senate,Jabar Shumate,DEM,720016,0,0,83,83,11
Tulsa,State Senate,Dave Bell,REP,720016,0,0,66,66,11
Tulsa,State Senate,Curtis Mullins,IND,720016,0,0,13,13,11
Tulsa,President,Barack Obama,DEM,720017,0,0,192,192,
Tulsa,President,Mitt Romney,REP,720017,0,0,141,141,
Tulsa,U.S. House,John Olson,DEM,720017,0,0,176,176,01
Tulsa,U.S. House,Jim Bridenstine,REP,720017,0,0,125,125,01
Tulsa,U.S. House,Craig Allen,IND,720017,0,0,33,33,01
Tulsa,State Senate,Jabar Shumate,DEM,720017,0,0,174,174,11
Tulsa,State Senate,Dave Bell,REP,720017,0,0,104,104,11
Tulsa,State Senate,Curtis Mullins,IND,720017,0,0,56,56,11
Tulsa,State House,Seneca Scott,DEM,720017,0,0,230,230,72
Tulsa,State House,Randall Reese,REP,720017,0,0,102,102,72
Tulsa,President,Barack Obama,DEM,720018,0,0,213,213,
Tulsa,President,Mitt Romney,REP,720018,0,0,181,181,
Tulsa,U.S. House,John Olson,DEM,720018,0,0,192,192,01
Tulsa,U.S. House,Jim Bridenstine,REP,720018,0,0,165,165,01
Tulsa,U.S. House,Craig Allen,IND,720018,0,0,31,31,01
Tulsa,State Senate,Jabar Shumate,DEM,720018,0,0,193,193,11
Tulsa,State Senate,Dave Bell,REP,720018,0,0,132,132,11
Tulsa,State Senate,Curtis Mullins,IND,720018,0,0,65,65,11
Tulsa,State House,Seneca Scott,DEM,720018,0,0,267,267,72
Tulsa,State House,Randall Reese,REP,720018,0,0,118,118,72
Tulsa,President,Barack Obama,DEM,720019,0,0,277,277,
Tulsa,President,Mitt Romney,REP,720019,0,0,245,245,
Tulsa,U.S. House,John Olson,DEM,720019,0,0,258,258,01
Tulsa,U.S. House,Jim Bridenstine,REP,720019,0,0,221,221,01
Tulsa,U.S. House,Craig Allen,IND,720019,0,0,38,38,01
Tulsa,State Senate,Jabar Shumate,DEM,720019,0,0,214,214,11
Tulsa,State Senate,Dave Bell,REP,720019,0,0,209,209,11
Tulsa,State Senate,Curtis Mullins,IND,720019,0,0,89,89,11
Tulsa,President,Barack Obama,DEM,720020,0,0,260,260,
Tulsa,President,Mitt Romney,REP,720020,0,0,198,198,
Tulsa,U.S. House,John Olson,DEM,720020,0,0,225,225,01
Tulsa,U.S. House,Jim Bridenstine,REP,720020,0,0,187,187,01
Tulsa,U.S. House,Craig Allen,IND,720020,0,0,43,43,01
Tulsa,State Senate,Jabar Shumate,DEM,720020,0,0,216,216,11
Tulsa,State Senate,Dave Bell,REP,720020,0,0,184,184,11
Tulsa,State Senate,Curtis Mullins,IND,720020,0,0,52,52,11
Tulsa,State House,Seneca Scott,DEM,720020,0,0,292,292,72
Tulsa,State House,Randall Reese,REP,720020,0,0,152,152,72
Tulsa,President,Barack Obama,DEM,720021,0,0,14,14,
Tulsa,President,Mitt Romney,REP,720021,0,0,33,33,
Tulsa,U.S. House,John Olson,DEM,720021,0,0,13,13,01
Tulsa,U.S. House,Jim Bridenstine,REP,720021,0,0,30,30,01
Tulsa,U.S. House,Craig Allen,IND,720021,0,0,3,3,01
Tulsa,State House,Seneca Scott,DEM,720021,0,0,17,17,72
Tulsa,State House,Randall Reese,REP,720021,0,0,25,25,72
Tulsa,President,Barack Obama,DEM,720022,0,0,236,236,
Tulsa,President,Mitt Romney,REP,720022,0,0,335,335,
Tulsa,U.S. House,John Olson,DEM,720022,0,0,219,219,01
Tulsa,U.S. House,Jim Bridenstine,REP,720022,0,0,317,317,01
Tulsa,U.S. House,Craig Allen,IND,720022,0,0,32,32,01
Tulsa,President,Barack Obama,DEM,720023,0,0,96,96,
Tulsa,President,Mitt Romney,REP,720023,0,0,214,214,
Tulsa,U.S. House,John Olson,DEM,720023,0,0,85,85,01
Tulsa,U.S. House,Jim Bridenstine,REP,720023,0,0,207,207,01
Tulsa,U.S. House,Craig Allen,IND,720023,0,0,17,17,01
Tulsa,President,Barack Obama,DEM,720024,0,0,222,222,
Tulsa,President,Mitt Romney,REP,720024,0,0,279,279,
Tulsa,U.S. House,John Olson,DEM,720024,0,0,209,209,01
Tulsa,U.S. House,Jim Bridenstine,REP,720024,0,0,260,260,01
Tulsa,U.S. House,Craig Allen,IND,720024,0,0,32,32,01
Tulsa,President,Barack Obama,DEM,720025,0,0,197,197,
Tulsa,President,Mitt Romney,REP,720025,0,0,203,203,
Tulsa,U.S. House,John Olson,DEM,720025,0,0,189,189,01
Tulsa,U.S. House,Jim Bridenstine,REP,720025,0,0,188,188,01
Tulsa,U.S. House,Craig Allen,IND,720025,0,0,15,15,01
Tulsa,State Senate,Jabar Shumate,DEM,720025,0,0,172,172,11
Tulsa,State Senate,Dave Bell,REP,720025,0,0,169,169,11
Tulsa,State Senate,Curtis Mullins,IND,720025,0,0,55,55,11
Tulsa,President,Barack Obama,DEM,720026,0,0,280,280,
Tulsa,President,Mitt Romney,REP,720026,0,0,232,232,
Tulsa,U.S. House,John Olson,DEM,720026,0,0,262,262,01
Tulsa,U.S. House,Jim Bridenstine,REP,720026,0,0,206,206,01
Tulsa,U.S. House,Craig Allen,IND,720026,0,0,37,37,01
Tulsa,State Senate,Jabar Shumate,DEM,720026,0,0,235,235,11
Tulsa,State Senate,Dave Bell,REP,720026,0,0,204,204,11
Tulsa,State Senate,Curtis Mullins,IND,720026,0,0,65,65,11
Tulsa,President,Barack Obama,DEM,720027,0,0,223,223,
Tulsa,President,Mitt Romney,REP,720027,0,0,215,215,
Tulsa,U.S. House,John Olson,DEM,720027,0,0,212,212,01
Tulsa,U.S. House,Jim Bridenstine,REP,720027,0,0,206,206,01
Tulsa,U.S. House,Craig Allen,IND,720027,0,0,23,23,01
Tulsa,State Senate,Jabar Shumate,DEM,720027,0,0,198,198,11
Tulsa,State Senate,Dave Bell,REP,720027,0,0,186,186,11
Tulsa,State Senate,Curtis Mullins,IND,720027,0,0,54,54,11
Tulsa,President,Barack Obama,DEM,720028,0,0,271,271,
Tulsa,President,Mitt Romney,REP,720028,0,0,305,305,
Tulsa,U.S. House,John Olson,DEM,720028,0,0,262,262,01
Tulsa,U.S. House,Jim Bridenstine,REP,720028,0,0,273,273,01
Tulsa,U.S. House,Craig Allen,IND,720028,0,0,41,41,01
Tulsa,President,Barack Obama,DEM,720029,0,0,217,217,
Tulsa,President,Mitt Romney,REP,720029,0,0,248,248,
Tulsa,U.S. House,John Olson,DEM,720029,0,0,198,198,01
Tulsa,U.S. House,Jim Bridenstine,REP,720029,0,0,234,234,01
Tulsa,U.S. House,Craig Allen,IND,720029,0,0,32,32,01
Tulsa,President,Barack Obama,DEM,720030,0,0,287,287,
Tulsa,President,Mitt Romney,REP,720030,0,0,196,196,
Tulsa,U.S. House,John Olson,DEM,720030,0,0,260,260,01
Tulsa,U.S. House,Jim Bridenstine,REP,720030,0,0,183,183,01
Tulsa,U.S. House,Craig Allen,IND,720030,0,0,32,32,01
Tulsa,State Senate,Jabar Shumate,DEM,720030,0,0,257,257,11
Tulsa,State Senate,Dave Bell,REP,720030,0,0,160,160,11
Tulsa,State Senate,Curtis Mullins,IND,720030,0,0,53,53,11
Tulsa,President,Barack Obama,DEM,720031,0,0,175,175,
Tulsa,President,Mitt Romney,REP,720031,0,0,115,115,
Tulsa,U.S. House,John Olson,DEM,720031,0,0,152,152,01
Tulsa,U.S. House,Jim Bridenstine,REP,720031,0,0,113,113,01
Tulsa,U.S. House,Craig Allen,IND,720031,0,0,21,21,01
Tulsa,State Senate,Jabar Shumate,DEM,720031,0,0,143,143,11
Tulsa,State Senate,Dave Bell,REP,720031,0,0,102,102,11
Tulsa,State Senate,Curtis Mullins,IND,720031,0,0,37,37,11
Tulsa,President,Barack Obama,DEM,720032,0,0,252,252,
Tulsa,President,Mitt Romney,REP,720032,0,0,182,182,
Tulsa,U.S. House,John Olson,DEM,720032,0,0,233,233,01
Tulsa,U.S. House,Jim Bridenstine,REP,720032,0,0,158,158,01
Tulsa,U.S. House,Craig Allen,IND,720032,0,0,34,34,01
Tulsa,State Senate,Jabar Shumate,DEM,720032,0,0,225,225,11
Tulsa,State Senate,Dave Bell,REP,720032,0,0,144,144,11
Tulsa,State Senate,Curtis Mullins,IND,720032,0,0,55,55,11
Tulsa,State House,Seneca Scott,DEM,720032,0,0,291,291,72
Tulsa,State House,Randall Reese,REP,720032,0,0,130,130,72
Tulsa,President,Barack Obama,DEM,720033,0,0,212,212,
Tulsa,President,Mitt Romney,REP,720033,0,0,142,142,
Tulsa,U.S. House,John Olson,DEM,720033,0,0,200,200,01
Tulsa,U.S. House,Jim Bridenstine,REP,720033,0,0,142,142,01
Tulsa,U.S. House,Craig Allen,IND,720033,0,0,17,17,01
Tulsa,State House,Seneca Scott,DEM,720033,0,0,244,244,72
Tulsa,State House,Randall Reese,REP,720033,0,0,105,105,72
Tulsa,President,Barack Obama,DEM,720034,0,0,149,149,
Tulsa,President,Mitt Romney,REP,720034,0,0,137,137,
Tulsa,U.S. House,John Olson,DEM,720034,0,0,146,146,01
Tulsa,U.S. House,Jim Bridenstine,REP,720034,0,0,117,117,01
Tulsa,U.S. House,Craig Allen,IND,720034,0,0,19,19,01
Tulsa,President,Barack Obama,DEM,720035,0,0,441,441,
Tulsa,President,Mitt Romney,REP,720035,0,0,505,505,
Tulsa,U.S. House,John Olson,DEM,720035,0,0,414,414,01
Tulsa,U.S. House,Jim Bridenstine,REP,720035,0,0,456,456,01
Tulsa,U.S. House,Craig Allen,IND,720035,0,0,67,67,01
Tulsa,State Senate,Julie Hall,DEM,720035,0,0,497,497,39
Tulsa,State Senate,Brian Crain,REP,720035,0,0,434,434,39
Tulsa,President,Barack Obama,DEM,720036,0,0,456,456,
Tulsa,President,Mitt Romney,REP,720036,0,0,466,466,
Tulsa,U.S. House,John Olson,DEM,720036,0,0,422,422,01
Tulsa,U.S. House,Jim Bridenstine,REP,720036,0,0,442,442,01
Tulsa,U.S. House,Craig Allen,IND,720036,0,0,52,52,01
Tulsa,State Senate,Julie Hall,DEM,720036,0,0,521,521,39
Tulsa,State Senate,Brian Crain,REP,720036,0,0,383,383,39
Tulsa,President,Barack Obama,DEM,720037,0,0,133,133,
Tulsa,President,Mitt Romney,REP,720037,0,0,75,75,
Tulsa,U.S. House,John Olson,DEM,720037,0,0,113,113,01
Tulsa,U.S. House,Jim Bridenstine,REP,720037,0,0,73,73,01
Tulsa,U.S. House,Craig Allen,IND,720037,0,0,21,21,01
Tulsa,State House,Seneca Scott,DEM,720037,0,0,138,138,72
Tulsa,State House,Randall Reese,REP,720037,0,0,67,67,72
Tulsa,President,Barack Obama,DEM,720038,0,0,209,209,
Tulsa,President,Mitt Romney,REP,720038,0,0,268,268,
Tulsa,U.S. House,John Olson,DEM,720038,0,0,191,191,01
Tulsa,U.S. House,Jim Bridenstine,REP,720038,0,0,250,250,01
Tulsa,U.S. House,Craig Allen,IND,720038,0,0,37,37,01
Tulsa,State Senate,Julie Hall,DEM,720038,0,0,242,242,39
Tulsa,State Senate,Brian Crain,REP,720038,0,0,227,227,39
Tulsa,President,Barack Obama,DEM,720039,0,0,293,293,
Tulsa,President,Mitt Romney,REP,720039,0,0,403,403,
Tulsa,U.S. House,John Olson,DEM,720039,0,0,269,269,01
Tulsa,U.S. House,Jim Bridenstine,REP,720039,0,0,380,380,01
Tulsa,U.S. House,Craig Allen,IND,720039,0,0,41,41,01
Tulsa,State Senate,Julie Hall,DEM,720039,0,0,333,333,39
Tulsa,State Senate,Brian Crain,REP,720039,0,0,345,345,39
Tulsa,President,Barack Obama,DEM,720040,0,0,125,125,
Tulsa,President,Mitt Romney,REP,720040,0,0,113,113,
Tulsa,U.S. House,John Olson,DEM,720040,0,0,116,116,01
Tulsa,U.S. House,Jim Bridenstine,REP,720040,0,0,103,103,01
Tulsa,U.S. House,Craig Allen,IND,720040,0,0,14,14,01
Tulsa,President,Barack Obama,DEM,720041,0,0,183,183,
Tulsa,President,Mitt Romney,REP,720041,0,0,209,209,
Tulsa,U.S. House,John Olson,DEM,720041,0,0,164,164,01
Tulsa,U.S. House,Jim Bridenstine,REP,720041,0,0,213,213,01
Tulsa,U.S. House,Craig Allen,IND,720041,0,0,15,15,01
Tulsa,President,Barack Obama,DEM,720042,0,0,130,130,
Tulsa,President,Mitt Romney,REP,720042,0,0,317,317,
Tulsa,U.S. House,John Olson,DEM,720042,0,0,120,120,01
Tulsa,U.S. House,Jim Bridenstine,REP,720042,0,0,290,290,01
Tulsa,U.S. House,Craig Allen,IND,720042,0,0,30,30,01
Tulsa,State House,Shawna Keller,DEM,720042,0,0,148,148,23
Tulsa,State House,Terry O'Donnell,REP,720042,0,0,294,294,23
Tulsa,President,Barack Obama,DEM,720043,0,0,144,144,
Tulsa,President,Mitt Romney,REP,720043,0,0,320,320,
Tulsa,U.S. House,John Olson,DEM,720043,0,0,128,128,01
Tulsa,U.S. House,Jim Bridenstine,REP,720043,0,0,311,311,01
Tulsa,U.S. House,Craig Allen,IND,720043,0,0,24,24,01
Tulsa,President,Barack Obama,DEM,720044,0,0,283,283,
Tulsa,President,Mitt Romney,REP,720044,0,0,492,492,
Tulsa,U.S. House,John Olson,DEM,720044,0,0,285,285,01
Tulsa,U.S. House,Jim Bridenstine,REP,720044,0,0,466,466,01
Tulsa,U.S. House,Craig Allen,IND,720044,0,0,24,24,01
Tulsa,State House,Shawna Keller,DEM,720044,0,0,323,323,23
Tulsa,State House,Terry O'Donnell,REP,720044,0,0,449,449,23
Tulsa,President,Barack Obama,DEM,720045,0,0,0,0,
Tulsa,President,Mitt Romney,REP,720045,0,0,0,0,
Tulsa,U.S. House,John Olson,DEM,720045,0,0,0,0,01
Tulsa,U.S. House,Jim Bridenstine,REP,720045,0,0,0,0,01
Tulsa,U.S. House,Craig Allen,IND,720045,0,0,0,0,01
Tulsa,State House,Shawna Keller,DEM,720045,0,0,0,0,23
Tulsa,State House,Terry O'Donnell,REP,720045,0,0,0,0,23
Tulsa,President,Barack Obama,DEM,720046,0,0,712,712,
Tulsa,President,Mitt Romney,REP,720046,0,0,507,507,
Tulsa,U.S. House,John Olson,DEM,720046,0,0,656,656,01
Tulsa,U.S. House,Jim Bridenstine,REP,720046,0,0,487,487,01
Tulsa,U.S. House,Craig Allen,IND,720046,0,0,71,71,01
Tulsa,State House,David Iii,DEM,720046,0,0,690,690,66
Tulsa,State House,Jadine Nollan,REP,720046,0,0,493,493,66
Tulsa,President,Barack Obama,DEM,720047,0,0,99,99,
Tulsa,President,Mitt Romney,REP,720047,0,0,51,51,
Tulsa,U.S. House,John Olson,DEM,720047,0,0,94,94,01
Tulsa,U.S. House,Jim Bridenstine,REP,720047,0,0,50,50,01
Tulsa,U.S. House,Craig Allen,IND,720047,0,0,7,7,01
Tulsa,State Senate,Jabar Shumate,DEM,720047,0,0,91,91,11
Tulsa,State Senate,Dave Bell,REP,720047,0,0,42,42,11
Tulsa,State Senate,Curtis Mullins,IND,720047,0,0,17,17,11
Tulsa,State House,Jeannie Mcdaniel,DEM,720047,0,0,105,105,78
Tulsa,State House,Paul Catalano,REP,720047,0,0,44,44,78
Tulsa,President,Barack Obama,DEM,720048,0,0,519,519,
Tulsa,President,Mitt Romney,REP,720048,0,0,353,353,
Tulsa,U.S. House,John Olson,DEM,720048,0,0,488,488,01
Tulsa,U.S. House,Jim Bridenstine,REP,720048,0,0,333,333,01
Tulsa,U.S. House,Craig Allen,IND,720048,0,0,50,50,01
Tulsa,State House,Jeannie Mcdaniel,DEM,720048,0,0,571,571,78
Tulsa,State House,Paul Catalano,REP,720048,0,0,284,284,78
Tulsa,President,Barack Obama,DEM,720049,0,0,226,226,
Tulsa,President,Mitt Romney,REP,720049,0,0,122,122,
Tulsa,U.S. House,John Olson,DEM,720049,0,0,206,206,01
Tulsa,U.S. House,Jim Bridenstine,REP,720049,0,0,112,112,01
Tulsa,U.S. House,Craig Allen,IND,720049,0,0,31,31,01
Tulsa,State Senate,Jabar Shumate,DEM,720049,0,0,200,200,11
Tulsa,State Senate,Dave Bell,REP,720049,0,0,99,99,11
Tulsa,State Senate,Curtis Mullins,IND,720049,0,0,47,47,11
Tulsa,State House,Seneca Scott,DEM,720049,0,0,242,242,72
Tulsa,State House,Randall Reese,REP,720049,0,0,99,99,72
Tulsa,President,Barack Obama,DEM,720050,0,0,303,303,
Tulsa,President,Mitt Romney,REP,720050,0,0,211,211,
Tulsa,U.S. House,John Olson,DEM,720050,0,0,280,280,01
Tulsa,U.S. House,Jim Bridenstine,REP,720050,0,0,206,206,01
Tulsa,U.S. House,Craig Allen,IND,720050,0,0,25,25,01
Tulsa,State House,Jeannie Mcdaniel,DEM,720050,0,0,346,346,78
Tulsa,State House,Paul Catalano,REP,720050,0,0,158,158,78
Tulsa,President,Barack Obama,DEM,720051,0,0,394,394,
Tulsa,President,Mitt Romney,REP,720051,0,0,322,322,
Tulsa,U.S. House,John Olson,DEM,720051,0,0,348,348,01
Tulsa,U.S. House,Jim Bridenstine,REP,720051,0,0,308,308,01
Tulsa,U.S. House,Craig Allen,IND,720051,0,0,52,52,01
Tulsa,State House,Jeannie Mcdaniel,DEM,720051,0,0,459,459,78
Tulsa,State House,Paul Catalano,REP,720051,0,0,243,243,78
Tulsa,President,Barack Obama,DEM,720052,0,0,640,640,
Tulsa,President,Mitt Romney,REP,720052,0,0,666,666,
Tulsa,U.S. House,John Olson,DEM,720052,0,0,594,594,01
Tulsa,U.S. House,Jim Bridenstine,REP,720052,0,0,639,639,01
Tulsa,U.S. House,Craig Allen,IND,720052,0,0,59,59,01
Tulsa,State House,Jeannie Mcdaniel,DEM,720052,0,0,827,827,78
Tulsa,State House,Paul Catalano,REP,720052,0,0,466,466,78
Tulsa,President,Barack Obama,DEM,720053,0,0,479,479,
Tulsa,President,Mitt Romney,REP,720053,0,0,634,634,
Tulsa,U.S. House,John Olson,DEM,720053,0,0,449,449,01
Tulsa,U.S. House,Jim Bridenstine,REP,720053,0,0,611,611,01
Tulsa,U.S. House,Craig Allen,IND,720053,0,0,50,50,01
Tulsa,State House,Shawna Keller,DEM,720053,0,0,560,560,23
Tulsa,State House,Terry O'Donnell,REP,720053,0,0,543,543,23
Tulsa,President,Barack Obama,DEM,720054,0,0,587,587,
Tulsa,President,Mitt Romney,REP,720054,0,0,625,625,
Tulsa,U.S. House,John Olson,DEM,720054,0,0,521,521,01
Tulsa,U.S. House,Jim Bridenstine,REP,720054,0,0,591,591,01
Tulsa,U.S. House,Craig Allen,IND,720054,0,0,86,86,01
Tulsa,State Senate,Julie Hall,DEM,720054,0,0,603,603,39
Tulsa,State Senate,Brian Crain,REP,720054,0,0,576,576,39
Tulsa,State House,Jeannie Mcdaniel,DEM,720054,0,0,745,745,78
Tulsa,State House,Paul Catalano,REP,720054,0,0,437,437,78
Tulsa,President,Barack Obama,DEM,720055,0,0,319,319,
Tulsa,President,Mitt Romney,REP,720055,0,0,404,404,
Tulsa,U.S. House,John Olson,DEM,720055,0,0,267,267,01
Tulsa,U.S. House,Jim Bridenstine,REP,720055,0,0,395,395,01
Tulsa,U.S. House,Craig Allen,IND,720055,0,0,57,57,01
Tulsa,State Senate,Julie Hall,DEM,720055,0,0,354,354,39
Tulsa,State Senate,Brian Crain,REP,720055,0,0,352,352,39
Tulsa,State House,Jeannie Mcdaniel,DEM,720055,0,0,447,447,78
Tulsa,State House,Paul Catalano,REP,720055,0,0,263,263,78
Tulsa,President,Barack Obama,DEM,720056,0,0,391,391,
Tulsa,President,Mitt Romney,REP,720056,0,0,465,465,
Tulsa,U.S. House,John Olson,DEM,720056,0,0,350,350,01
Tulsa,U.S. House,Jim Bridenstine,REP,720056,0,0,440,440,01
Tulsa,U.S. House,Craig Allen,IND,720056,0,0,59,59,01
Tulsa,State Senate,Julie Hall,DEM,720056,0,0,423,423,39
Tulsa,State Senate,Brian Crain,REP,720056,0,0,415,415,39
Tulsa,State House,Jeannie Mcdaniel,DEM,720056,0,0,517,517,78
Tulsa,State House,Paul Catalano,REP,720056,0,0,320,320,78
Tulsa,President,Barack Obama,DEM,720057,0,0,136,136,
Tulsa,President,Mitt Romney,REP,720057,0,0,191,191,
Tulsa,U.S. House,John Olson,DEM,720057,0,0,122,122,01
Tulsa,U.S. House,Jim Bridenstine,REP,720057,0,0,184,184,01
Tulsa,U.S. House,Craig Allen,IND,720057,0,0,19,19,01
Tulsa,State Senate,Julie Hall,DEM,720057,0,0,155,155,39
Tulsa,State Senate,Brian Crain,REP,720057,0,0,168,168,39
Tulsa,State House,Jeannie Mcdaniel,DEM,720057,0,0,190,190,78
Tulsa,State House,Paul Catalano,REP,720057,0,0,132,132,78
Tulsa,President,Barack Obama,DEM,720058,0,0,130,130,
Tulsa,President,Mitt Romney,REP,720058,0,0,273,273,
Tulsa,U.S. House,John Olson,DEM,720058,0,0,122,122,01
Tulsa,U.S. House,Jim Bridenstine,REP,720058,0,0,260,260,01
Tulsa,U.S. House,Craig Allen,IND,720058,0,0,13,13,01
Tulsa,State House,Jeannie Mcdaniel,DEM,720058,0,0,226,226,78
Tulsa,State House,Paul Catalano,REP,720058,0,0,172,172,78
Tulsa,President,Barack Obama,DEM,720059,0,0,208,208,
Tulsa,President,Mitt Romney,REP,720059,0,0,260,260,
Tulsa,U.S. House,John Olson,DEM,720059,0,0,178,178,01
Tulsa,U.S. House,Jim Bridenstine,REP,720059,0,0,259,259,01
Tulsa,U.S. House,Craig Allen,IND,720059,0,0,30,30,01
Tulsa,State House,Jeannie Mcdaniel,DEM,720059,0,0,297,297,78
Tulsa,State House,Paul Catalano,REP,720059,0,0,163,163,78
Tulsa,President,Barack Obama,DEM,720060,0,0,292,292,
Tulsa,President,Mitt Romney,REP,720060,0,0,366,366,
Tulsa,U.S. House,John Olson,DEM,720060,0,0,271,271,01
Tulsa,U.S. House,Jim Bridenstine,REP,720060,0,0,353,353,01
Tulsa,U.S. House,Craig Allen,IND,720060,0,0,32,32,01
Tulsa,State House,Shawna Keller,DEM,720060,0,0,326,326,23
Tulsa,State House,Terry O'Donnell,REP,720060,0,0,327,327,23
Tulsa,President,Barack Obama,DEM,720061,0,0,440,440,
Tulsa,President,Mitt Romney,REP,720061,0,0,448,448,
Tulsa,U.S. House,John Olson,DEM,720061,0,0,407,407,01
Tulsa,U.S. House,Jim Bridenstine,REP,720061,0,0,419,419,01
Tulsa,U.S. House,Craig Allen,IND,720061,0,0,49,49,01
Tulsa,State House,Shawna Keller,DEM,720061,0,0,495,495,23
Tulsa,State House,Terry O'Donnell,REP,720061,0,0,385,385,23
Tulsa,President,Barack Obama,DEM,720062,0,0,613,613,
Tulsa,President,Mitt Romney,REP,720062,0,0,802,802,
Tulsa,U.S. House,John Olson,DEM,720062,0,0,614,614,01
Tulsa,U.S. House,Jim Bridenstine,REP,720062,0,0,740,740,01
Tulsa,U.S. House,Craig Allen,IND,720062,0,0,50,50,01
Tulsa,State House,Dan Arthrell,DEM,720062,0,0,639,639,71
Tulsa,State House,Katie Henke,REP,720062,0,0,765,765,71
Tulsa,President,Barack Obama,DEM,720063,0,0,326,326,
Tulsa,President,Mitt Romney,REP,720063,0,0,275,275,
Tulsa,U.S. House,John Olson,DEM,720063,0,0,305,305,01
Tulsa,U.S. House,Jim Bridenstine,REP,720063,0,0,242,242,01
Tulsa,U.S. House,Craig Allen,IND,720063,0,0,43,43,01
Tulsa,State House,Dan Arthrell,DEM,720063,0,0,315,315,71
Tulsa,State House,Katie Henke,REP,720063,0,0,276,276,71
Tulsa,President,Barack Obama,DEM,720064,0,0,391,391,
Tulsa,President,Mitt Romney,REP,720064,0,0,432,432,
Tulsa,U.S. House,John Olson,DEM,720064,0,0,359,359,01
Tulsa,U.S. House,Jim Bridenstine,REP,720064,0,0,393,393,01
Tulsa,U.S. House,Craig Allen,IND,720064,0,0,57,57,01
Tulsa,State House,Dan Arthrell,DEM,720064,0,0,396,396,71
Tulsa,State House,Katie Henke,REP,720064,0,0,418,418,71
Tulsa,President,Barack Obama,DEM,720065,0,0,321,321,
Tulsa,President,Mitt Romney,REP,720065,0,0,639,639,
Tulsa,U.S. House,John Olson,DEM,720065,0,0,347,347,01
Tulsa,U.S. House,Jim Bridenstine,REP,720065,0,0,579,579,01
Tulsa,U.S. House,Craig Allen,IND,720065,0,0,23,23,01
Tulsa,State Senate,Julie Hall,DEM,720065,0,0,355,355,39
Tulsa,State Senate,Brian Crain,REP,720065,0,0,580,580,39
Tulsa,State House,Dan Arthrell,DEM,720065,0,0,351,351,71
Tulsa,State House,Katie Henke,REP,720065,0,0,603,603,71
Tulsa,President,Barack Obama,DEM,720066,0,0,321,321,
Tulsa,President,Mitt Romney,REP,720066,0,0,541,541,
Tulsa,U.S. House,John Olson,DEM,720066,0,0,326,326,01
Tulsa,U.S. House,Jim Bridenstine,REP,720066,0,0,503,503,01
Tulsa,U.S. House,Craig Allen,IND,720066,0,0,24,24,01
Tulsa,State House,Dan Arthrell,DEM,720066,0,0,335,335,71
Tulsa,State House,Katie Henke,REP,720066,0,0,521,521,71
Tulsa,President,Barack Obama,DEM,720067,0,0,287,287,
Tulsa,President,Mitt Romney,REP,720067,0,0,490,490,
Tulsa,U.S. House,John Olson,DEM,720067,0,0,279,279,01
Tulsa,U.S. House,Jim Bridenstine,REP,720067,0,0,463,463,01
Tulsa,U.S. House,Craig Allen,IND,720067,0,0,32,32,01
Tulsa,State House,Dan Arthrell,DEM,720067,0,0,302,302,71
Tulsa,State House,Katie Henke,REP,720067,0,0,463,463,71
Tulsa,President,Barack Obama,DEM,720068,0,0,350,350,
Tulsa,President,Mitt Romney,REP,720068,0,0,362,362,
Tulsa,U.S. House,John Olson,DEM,720068,0,0,307,307,01
Tulsa,U.S. House,Jim Bridenstine,REP,720068,0,0,351,351,01
Tulsa,U.S. House,Craig Allen,IND,720068,0,0,48,48,01
Tulsa,State House,Dan Arthrell,DEM,720068,0,0,355,355,71
Tulsa,State House,Katie Henke,REP,720068,0,0,348,348,71
Tulsa,President,Barack Obama,DEM,720069,0,0,548,548,
Tulsa,President,Mitt Romney,REP,720069,0,0,714,714,
Tulsa,U.S. House,John Olson,DEM,720069,0,0,501,501,01
Tulsa,U.S. House,Jim Bridenstine,REP,720069,0,0,690,690,01
Tulsa,U.S. House,Craig Allen,IND,720069,0,0,68,68,01
Tulsa,State House,Dan Arthrell,DEM,720069,0,0,552,552,71
Tulsa,State House,Katie Henke,REP,720069,0,0,703,703,71
Tulsa,President,Barack Obama,DEM,720070,0,0,125,125,
Tulsa,President,Mitt Romney,REP,720070,0,0,147,147,
Tulsa,U.S. House,John Olson,DEM,720070,0,0,115,115,01
Tulsa,U.S. House,Jim Bridenstine,REP,720070,0,0,146,146,01
Tulsa,U.S. House,Craig Allen,IND,720070,0,0,11,11,01
Tulsa,State House,Jeannie Mcdaniel,DEM,720070,0,0,163,163,78
Tulsa,State House,Paul Catalano,REP,720070,0,0,105,105,78
Tulsa,President,Barack Obama,DEM,720071,0,0,641,641,
Tulsa,President,Mitt Romney,REP,720071,0,0,1068,1068,
Tulsa,U.S. House,John Olson,DEM,720071,0,0,620,620,01
Tulsa,U.S. House,Jim Bridenstine,REP,720071,0,0,1007,1007,01
Tulsa,U.S. House,Craig Allen,IND,720071,0,0,63,63,01
Tulsa,State Senate,Julie Hall,DEM,720071,0,0,683,683,39
Tulsa,State Senate,Brian Crain,REP,720071,0,0,971,971,39
Tulsa,President,Barack Obama,DEM,720072,0,0,245,245,
Tulsa,President,Mitt Romney,REP,720072,0,0,419,419,
Tulsa,U.S. House,John Olson,DEM,720072,0,0,258,258,01
Tulsa,U.S. House,Jim Bridenstine,REP,720072,0,0,380,380,01
Tulsa,U.S. House,Craig Allen,IND,720072,0,0,19,19,01
Tulsa,President,Barack Obama,DEM,720073,0,0,224,224,
Tulsa,President,Mitt Romney,REP,720073,0,0,455,455,
Tulsa,U.S. House,John Olson,DEM,720073,0,0,236,236,01
Tulsa,U.S. House,Jim Bridenstine,REP,720073,0,0,422,422,01
Tulsa,U.S. House,Craig Allen,IND,720073,0,0,18,18,01
Tulsa,President,Barack Obama,DEM,720074,0,0,322,322,
Tulsa,President,Mitt Romney,REP,720074,0,0,630,630,
Tulsa,U.S. House,John Olson,DEM,720074,0,0,322,322,01
Tulsa,U.S. House,Jim Bridenstine,REP,720074,0,0,596,596,01
Tulsa,U.S. House,Craig Allen,IND,720074,0,0,33,33,01
Tulsa,President,Barack Obama,DEM,720075,0,0,292,292,
Tulsa,President,Mitt Romney,REP,720075,0,0,299,299,
Tulsa,U.S. House,John Olson,DEM,720075,0,0,264,264,01
Tulsa,U.S. House,Jim Bridenstine,REP,720075,0,0,279,279,01
Tulsa,U.S. House,Craig Allen,IND,720075,0,0,48,48,01
Tulsa,State Senate,Julie Hall,DEM,720075,0,0,320,320,39
Tulsa,State Senate,Brian Crain,REP,720075,0,0,262,262,39
Tulsa,President,Barack Obama,DEM,720076,0,0,351,351,
Tulsa,President,Mitt Romney,REP,720076,0,0,478,478,
Tulsa,U.S. House,John Olson,DEM,720076,0,0,320,320,01
Tulsa,U.S. House,Jim Bridenstine,REP,720076,0,0,461,461,01
Tulsa,U.S. House,Craig Allen,IND,720076,0,0,43,43,01
Tulsa,State Senate,Julie Hall,DEM,720076,0,0,387,387,39
Tulsa,State Senate,Brian Crain,REP,720076,0,0,425,425,39
Tulsa,President,Barack Obama,DEM,720077,0,0,413,413,
Tulsa,President,Mitt Romney,REP,720077,0,0,496,496,
Tulsa,U.S. House,John Olson,DEM,720077,0,0,379,379,01
Tulsa,U.S. House,Jim Bridenstine,REP,720077,0,0,467,467,01
Tulsa,U.S. House,Craig Allen,IND,720077,0,0,53,53,01
Tulsa,State Senate,Julie Hall,DEM,720077,0,0,454,454,39
Tulsa,State Senate,Brian Crain,REP,720077,0,0,437,437,39
Tulsa,State House,Jeannie Mcdaniel,DEM,720077,0,0,546,546,78
Tulsa,State House,Paul Catalano,REP,720077,0,0,351,351,78
Tulsa,President,Barack Obama,DEM,720078,0,0,419,419,
Tulsa,President,Mitt Romney,REP,720078,0,0,655,655,
Tulsa,U.S. House,John Olson,DEM,720078,0,0,376,376,01
Tulsa,U.S. House,Jim Bridenstine,REP,720078,0,0,631,631,01
Tulsa,U.S. House,Craig Allen,IND,720078,0,0,70,70,01
Tulsa,State Senate,Julie Hall,DEM,720078,0,0,458,458,39
Tulsa,State Senate,Brian Crain,REP,720078,0,0,602,602,39
Tulsa,State House,Jeannie Mcdaniel,DEM,720078,0,0,628,628,78
Tulsa,State House,Paul Catalano,REP,720078,0,0,432,432,78
Tulsa,President,Barack Obama,DEM,720079,0,0,441,441,
Tulsa,President,Mitt Romney,REP,720079,0,0,555,555,
Tulsa,U.S. House,John Olson,DEM,720079,0,0,402,402,01
Tulsa,U.S. House,Jim Bridenstine,REP,720079,0,0,537,537,01
Tulsa,U.S. House,Craig Allen,IND,720079,0,0,56,56,01
Tulsa,State Senate,Julie Hall,DEM,720079,0,0,500,500,39
Tulsa,State Senate,Brian Crain,REP,720079,0,0,483,483,39
Tulsa,State House,Jeannie Mcdaniel,DEM,720079,0,0,609,609,78
Tulsa,State House,Paul Catalano,REP,720079,0,0,378,378,78
Tulsa,President,Barack Obama,DEM,720080,0,0,115,115,
Tulsa,President,Mitt Romney,REP,720080,0,0,105,105,
Tulsa,U.S. House,John Olson,DEM,720080,0,0,103,103,01
Tulsa,U.S. House,Jim Bridenstine,REP,720080,0,0,107,107,01
Tulsa,U.S. House,Craig Allen,IND,720080,0,0,8,8,01
Tulsa,State Senate,Julie Hall,DEM,720080,0,0,120,120,39
Tulsa,State Senate,Brian Crain,REP,720080,0,0,97,97,39
Tulsa,President,Barack Obama,DEM,720081,0,0,472,472,
Tulsa,President,Mitt Romney,REP,720081,0,0,648,648,
Tulsa,U.S. House,John Olson,DEM,720081,0,0,440,440,01
Tulsa,U.S. House,Jim Bridenstine,REP,720081,0,0,622,622,01
Tulsa,U.S. House,Craig Allen,IND,720081,0,0,51,51,01
Tulsa,State Senate,Julie Hall,DEM,720081,0,0,517,517,39
Tulsa,State Senate,Brian Crain,REP,720081,0,0,569,569,39
Tulsa,President,Barack Obama,DEM,720082,0,0,314,314,
Tulsa,President,Mitt Romney,REP,720082,0,0,429,429,
Tulsa,U.S. House,John Olson,DEM,720082,0,0,309,309,01
Tulsa,U.S. House,Jim Bridenstine,REP,720082,0,0,398,398,01
Tulsa,U.S. House,Craig Allen,IND,720082,0,0,31,31,01
Tulsa,State Senate,Julie Hall,DEM,720082,0,0,323,323,39
Tulsa,State Senate,Brian Crain,REP,720082,0,0,407,407,39
Tulsa,President,Barack Obama,DEM,720083,0,0,344,344,
Tulsa,President,Mitt Romney,REP,720083,0,0,390,390,
Tulsa,U.S. House,John Olson,DEM,720083,0,0,306,306,01
Tulsa,U.S. House,Jim Bridenstine,REP,720083,0,0,362,362,01
Tulsa,U.S. House,Craig Allen,IND,720083,0,0,52,52,01
Tulsa,State Senate,Julie Hall,DEM,720083,0,0,365,365,39
Tulsa,State Senate,Brian Crain,REP,720083,0,0,351,351,39
Tulsa,President,Barack Obama,DEM,720084,0,0,273,273,
Tulsa,President,Mitt Romney,REP,720084,0,0,399,399,
Tulsa,U.S. House,John Olson,DEM,720084,0,0,253,253,01
Tulsa,U.S. House,Jim Bridenstine,REP,720084,0,0,398,398,01
Tulsa,U.S. House,Craig Allen,IND,720084,0,0,28,28,01
Tulsa,State Senate,Julie Hall,DEM,720084,0,0,294,294,39
Tulsa,State Senate,Brian Crain,REP,720084,0,0,371,371,39
Tulsa,President,Barack Obama,DEM,720085,0,0,177,177,
Tulsa,President,Mitt Romney,REP,720085,0,0,172,172,
Tulsa,U.S. House,John Olson,DEM,720085,0,0,175,175,01
Tulsa,U.S. House,Jim Bridenstine,REP,720085,0,0,157,157,01
Tulsa,U.S. House,Craig Allen,IND,720085,0,0,16,16,01
Tulsa,State Senate,Julie Hall,DEM,720085,0,0,202,202,39
Tulsa,State Senate,Brian Crain,REP,720085,0,0,140,140,39
Tulsa,President,Barack Obama,DEM,720086,0,0,370,370,
Tulsa,President,Mitt Romney,REP,720086,0,0,586,586,
Tulsa,U.S. House,John Olson,DEM,720086,0,0,329,329,01
Tulsa,U.S. House,Jim Bridenstine,REP,720086,0,0,564,564,01
Tulsa,U.S. House,Craig Allen,IND,720086,0,0,48,48,01
Tulsa,President,Barack Obama,DEM,720087,0,0,401,401,
Tulsa,President,Mitt Romney,REP,720087,0,0,550,550,
Tulsa,U.S. House,John Olson,DEM,720087,0,0,360,360,01
Tulsa,U.S. House,Jim Bridenstine,REP,720087,0,0,525,525,01
Tulsa,U.S. House,Craig Allen,IND,720087,0,0,59,59,01
Tulsa,State Senate,Julie Hall,DEM,720087,0,0,407,407,39
Tulsa,State Senate,Brian Crain,REP,720087,0,0,522,522,39
Tulsa,President,Barack Obama,DEM,720088,0,0,118,118,
Tulsa,President,Mitt Romney,REP,720088,0,0,128,128,
Tulsa,U.S. House,John Olson,DEM,720088,0,0,101,101,01
Tulsa,U.S. House,Jim Bridenstine,REP,720088,0,0,127,127,01
Tulsa,U.S. House,Craig Allen,IND,720088,0,0,12,12,01
Tulsa,President,Barack Obama,DEM,720089,0,0,179,179,
Tulsa,President,Mitt Romney,REP,720089,0,0,212,212,
Tulsa,U.S. House,John Olson,DEM,720089,0,0,168,168,01
Tulsa,U.S. House,Jim Bridenstine,REP,720089,0,0,199,199,01
Tulsa,U.S. House,Craig Allen,IND,720089,0,0,25,25,01
Tulsa,State Senate,Julie Hall,DEM,720089,0,0,197,197,39
Tulsa,State Senate,Brian Crain,REP,720089,0,0,192,192,39
Tulsa,President,Barack Obama,DEM,720090,0,0,219,219,
Tulsa,President,Mitt Romney,REP,720090,0,0,177,177,
Tulsa,U.S. House,John Olson,DEM,720090,0,0,199,199,01
Tulsa,U.S. House,Jim Bridenstine,REP,720090,0,0,174,174,01
Tulsa,U.S. House,Craig Allen,IND,720090,0,0,22,22,01
Tulsa,President,Barack Obama,DEM,720091,0,0,259,259,
Tulsa,President,Mitt Romney,REP,720091,0,0,295,295,
Tulsa,U.S. House,John Olson,DEM,720091,0,0,241,241,01
Tulsa,U.S. House,Jim Bridenstine,REP,720091,0,0,271,271,01
Tulsa,U.S. House,Craig Allen,IND,720091,0,0,30,30,01
Tulsa,President,Barack Obama,DEM,720092,0,0,201,201,
Tulsa,President,Mitt Romney,REP,720092,0,0,275,275,
Tulsa,U.S. House,John Olson,DEM,720092,0,0,184,184,01
Tulsa,U.S. House,Jim Bridenstine,REP,720092,0,0,256,256,01
Tulsa,U.S. House,Craig Allen,IND,720092,0,0,36,36,01
Tulsa,State Senate,Julie Hall,DEM,720092,0,0,228,228,39
Tulsa,State Senate,Brian Crain,REP,720092,0,0,243,243,39
Tulsa,State House,Jeannie Mcdaniel,DEM,720092,0,0,273,273,78
Tulsa,State House,Paul Catalano,REP,720092,0,0,195,195,78
Tulsa,President,Barack Obama,DEM,720093,0,0,173,173,
Tulsa,President,Mitt Romney,REP,720093,0,0,306,306,
Tulsa,U.S. House,John Olson,DEM,720093,0,0,155,155,01
Tulsa,U.S. House,Jim Bridenstine,REP,720093,0,0,296,296,01
Tulsa,U.S. House,Craig Allen,IND,720093,0,0,26,26,01
Tulsa,State Senate,Julie Hall,DEM,720093,0,0,205,205,39
Tulsa,State Senate,Brian Crain,REP,720093,0,0,264,264,39
Tulsa,State House,Jeannie Mcdaniel,DEM,720093,0,0,236,236,78
Tulsa,State House,Paul Catalano,REP,720093,0,0,233,233,78
Tulsa,President,Barack Obama,DEM,720094,0,0,318,318,
Tulsa,President,Mitt Romney,REP,720094,0,0,504,504,
Tulsa,U.S. House,John Olson,DEM,720094,0,0,283,283,01
Tulsa,U.S. House,Jim Bridenstine,REP,720094,0,0,487,487,01
Tulsa,U.S. House,Craig Allen,IND,720094,0,0,42,42,01
Tulsa,State House,Jeannie Mcdaniel,DEM,720094,0,0,411,411,78
Tulsa,State House,Paul Catalano,REP,720094,0,0,392,392,78
Tulsa,President,Barack Obama,DEM,720095,0,0,283,283,
Tulsa,President,Mitt Romney,REP,720095,0,0,519,519,
Tulsa,U.S. House,John Olson,DEM,720095,0,0,267,267,01
Tulsa,U.S. House,Jim Bridenstine,REP,720095,0,0,485,485,01
Tulsa,U.S. House,Craig Allen,IND,720095,0,0,49,49,01
Tulsa,State House,Jeannie Mcdaniel,DEM,720095,0,0,410,410,78
Tulsa,State House,Paul Catalano,REP,720095,0,0,373,373,78
Tulsa,President,Barack Obama,DEM,720096,0,0,272,272,
Tulsa,President,Mitt Romney,REP,720096,0,0,359,359,
Tulsa,U.S. House,John Olson,DEM,720096,0,0,238,238,01
Tulsa,U.S. House,Jim Bridenstine,REP,720096,0,0,350,350,01
Tulsa,U.S. House,Craig Allen,IND,720096,0,0,38,38,01
Tulsa,President,Barack Obama,DEM,720097,0,0,470,470,
Tulsa,President,Mitt Romney,REP,720097,0,0,499,499,
Tulsa,U.S. House,John Olson,DEM,720097,0,0,425,425,01
Tulsa,U.S. House,Jim Bridenstine,REP,720097,0,0,485,485,01
Tulsa,U.S. House,Craig Allen,IND,720097,0,0,56,56,01
Tulsa,State House,Shawna Keller,DEM,720097,0,0,498,498,23
Tulsa,State House,Terry O'Donnell,REP,720097,0,0,464,464,23
Tulsa,President,Barack Obama,DEM,720098,0,0,281,281,
Tulsa,President,Mitt Romney,REP,720098,0,0,353,353,
Tulsa,U.S. House,John Olson,DEM,720098,0,0,268,268,01
Tulsa,U.S. House,Jim Bridenstine,REP,720098,0,0,334,334,01
Tulsa,U.S. House,Craig Allen,IND,720098,0,0,35,35,01
Tulsa,State House,Shawna Keller,DEM,720098,0,0,299,299,23
Tulsa,State House,Terry O'Donnell,REP,720098,0,0,330,330,23
Tulsa,President,Barack Obama,DEM,720099,0,0,277,277,
Tulsa,President,Mitt Romney,REP,720099,0,0,291,291,
Tulsa,U.S. House,John Olson,DEM,720099,0,0,255,255,01
Tulsa,U.S. House,Jim Bridenstine,REP,720099,0,0,267,267,01
Tulsa,U.S. House,Craig Allen,IND,720099,0,0,32,32,01
Tulsa,State House,Shawna Keller,DEM,720099,0,0,285,285,23
Tulsa,State House,Terry O'Donnell,REP,720099,0,0,271,271,23
Tulsa,President,Barack Obama,DEM,720100,0,0,119,119,
Tulsa,President,Mitt Romney,REP,720100,0,0,193,193,
Tulsa,U.S. House,John Olson,DEM,720100,0,0,114,114,01
Tulsa,U.S. House,Jim Bridenstine,REP,720100,0,0,185,185,01
Tulsa,U.S. House,Craig Allen,IND,720100,0,0,12,12,01
Tulsa,President,Barack Obama,DEM,720101,0,0,459,459,
Tulsa,President,Mitt Romney,REP,720101,0,0,579,579,
Tulsa,U.S. House,John Olson,DEM,720101,0,0,444,444,01
Tulsa,U.S. House,Jim Bridenstine,REP,720101,0,0,535,535,01
Tulsa,U.S. House,Craig Allen,IND,720101,0,0,50,50,01
Tulsa,President,Barack Obama,DEM,720102,0,0,429,429,
Tulsa,President,Mitt Romney,REP,720102,0,0,496,496,
Tulsa,U.S. House,John Olson,DEM,720102,0,0,386,386,01
Tulsa,U.S. House,Jim Bridenstine,REP,720102,0,0,467,467,01
Tulsa,U.S. House,Craig Allen,IND,720102,0,0,63,63,01
Tulsa,President,Barack Obama,DEM,720103,0,0,167,167,
Tulsa,President,Mitt Romney,REP,720103,0,0,298,298,
Tulsa,U.S. House,John Olson,DEM,720103,0,0,156,156,01
Tulsa,U.S. House,Jim Bridenstine,REP,720103,0,0,275,275,01
Tulsa,U.S. House,Craig Allen,IND,720103,0,0,30,30,01
Tulsa,President,Barack Obama,DEM,720104,0,0,240,240,
Tulsa,President,Mitt Romney,REP,720104,0,0,325,325,
Tulsa,U.S. House,John Olson,DEM,720104,0,0,216,216,01
Tulsa,U.S. House,Jim Bridenstine,REP,720104,0,0,311,311,01
Tulsa,U.S. House,Craig Allen,IND,720104,0,0,30,30,01
Tulsa,President,Barack Obama,DEM,720105,0,0,351,351,
Tulsa,President,Mitt Romney,REP,720105,0,0,469,469,
Tulsa,U.S. House,John Olson,DEM,720105,0,0,327,327,01
Tulsa,U.S. House,Jim Bridenstine,REP,720105,0,0,438,438,01
Tulsa,U.S. House,Craig Allen,IND,720105,0,0,39,39,01
Tulsa,President,Barack Obama,DEM,720106,0,0,169,169,
Tulsa,President,Mitt Romney,REP,720106,0,0,231,231,
Tulsa,U.S. House,John Olson,DEM,720106,0,0,155,155,01
Tulsa,U.S. House,Jim Bridenstine,REP,720106,0,0,225,225,01
Tulsa,U.S. House,Craig Allen,IND,720106,0,0,18,18,01
Tulsa,President,Barack Obama,DEM,720107,0,0,469,469,
Tulsa,President,Mitt Romney,REP,720107,0,0,565,565,
Tulsa,U.S. House,John Olson,DEM,720107,0,0,436,436,01
Tulsa,U.S. House,Jim Bridenstine,REP,720107,0,0,549,549,01
Tulsa,U.S. House,Craig Allen,IND,720107,0,0,45,45,01
Tulsa,State House,Dan Arthrell,DEM,720107,0,0,470,470,71
Tulsa,State House,Katie Henke,REP,720107,0,0,551,551,71
Tulsa,President,Barack Obama,DEM,720108,0,0,296,296,
Tulsa,President,Mitt Romney,REP,720108,0,0,354,354,
Tulsa,U.S. House,John Olson,DEM,720108,0,0,263,263,01
Tulsa,U.S. House,Jim Bridenstine,REP,720108,0,0,344,344,01
Tulsa,U.S. House,Craig Allen,IND,720108,0,0,36,36,01
Tulsa,State House,Dan Arthrell,DEM,720108,0,0,293,293,71
Tulsa,State House,Katie Henke,REP,720108,0,0,350,350,71
Tulsa,President,Barack Obama,DEM,720109,0,0,269,269,
Tulsa,President,Mitt Romney,REP,720109,0,0,195,195,
Tulsa,U.S. House,John Olson,DEM,720109,0,0,243,243,01
Tulsa,U.S. House,Jim Bridenstine,REP,720109,0,0,191,191,01
Tulsa,U.S. House,Craig Allen,IND,720109,0,0,26,26,01
Tulsa,State House,Dan Arthrell,DEM,720109,0,0,260,260,71
Tulsa,State House,Katie Henke,REP,720109,0,0,198,198,71
Tulsa,President,Barack Obama,DEM,720110,0,0,376,376,
Tulsa,President,Mitt Romney,REP,720110,0,0,410,410,
Tulsa,U.S. House,John Olson,DEM,720110,0,0,341,341,01
Tulsa,U.S. House,Jim Bridenstine,REP,720110,0,0,402,402,01
Tulsa,U.S. House,Craig Allen,IND,720110,0,0,38,38,01
Tulsa,State House,Dan Arthrell,DEM,720110,0,0,354,354,71
Tulsa,State House,Katie Henke,REP,720110,0,0,422,422,71
Tulsa,President,Barack Obama,DEM,720111,0,0,329,329,
Tulsa,President,Mitt Romney,REP,720111,0,0,286,286,
Tulsa,U.S. House,John Olson,DEM,720111,0,0,302,302,01
Tulsa,U.S. House,Jim Bridenstine,REP,720111,0,0,281,281,01
Tulsa,U.S. House,Craig Allen,IND,720111,0,0,31,31,01
Tulsa,State House,Dan Arthrell,DEM,720111,0,0,327,327,71
Tulsa,State House,Katie Henke,REP,720111,0,0,284,284,71
Tulsa,President,Barack Obama,DEM,720112,0,0,372,372,
Tulsa,President,Mitt Romney,REP,720112,0,0,391,391,
Tulsa,U.S. House,John Olson,DEM,720112,0,0,332,332,01
Tulsa,U.S. House,Jim Bridenstine,REP,720112,0,0,388,388,01
Tulsa,U.S. House,Craig Allen,IND,720112,0,0,35,35,01
Tulsa,State House,Dan Arthrell,DEM,720112,0,0,355,355,71
Tulsa,State House,Katie Henke,REP,720112,0,0,399,399,71
Tulsa,President,Barack Obama,DEM,720113,0,0,339,339,
Tulsa,President,Mitt Romney,REP,720113,0,0,484,484,
Tulsa,U.S. House,John Olson,DEM,720113,0,0,289,289,01
Tulsa,U.S. House,Jim Bridenstine,REP,720113,0,0,478,478,01
Tulsa,U.S. House,Craig Allen,IND,720113,0,0,44,44,01
Tulsa,President,Barack Obama,DEM,720114,0,0,193,193,
Tulsa,President,Mitt Romney,REP,720114,0,0,264,264,
Tulsa,U.S. House,John Olson,DEM,720114,0,0,163,163,01
Tulsa,U.S. House,Jim Bridenstine,REP,720114,0,0,267,267,01
Tulsa,U.S. House,Craig Allen,IND,720114,0,0,21,21,01
Tulsa,President,Barack Obama,DEM,720115,0,0,155,155,
Tulsa,President,Mitt Romney,REP,720115,0,0,389,389,
Tulsa,U.S. House,John Olson,DEM,720115,0,0,158,158,01
Tulsa,U.S. House,Jim Bridenstine,REP,720115,0,0,372,372,01
Tulsa,U.S. House,Craig Allen,IND,720115,0,0,15,15,01
Tulsa,President,Barack Obama,DEM,720116,0,0,218,218,
Tulsa,President,Mitt Romney,REP,720116,0,0,618,618,
Tulsa,U.S. House,John Olson,DEM,720116,0,0,194,194,01
Tulsa,U.S. House,Jim Bridenstine,REP,720116,0,0,605,605,01
Tulsa,U.S. House,Craig Allen,IND,720116,0,0,32,32,01
Tulsa,President,Barack Obama,DEM,720117,0,0,454,454,
Tulsa,President,Mitt Romney,REP,720117,0,0,1135,1135,
Tulsa,U.S. House,John Olson,DEM,720117,0,0,413,413,01
Tulsa,U.S. House,Jim Bridenstine,REP,720117,0,0,1093,1093,01
Tulsa,U.S. House,Craig Allen,IND,720117,0,0,70,70,01
Tulsa,President,Barack Obama,DEM,720118,0,0,312,312,
Tulsa,President,Mitt Romney,REP,720118,0,0,1070,1070,
Tulsa,U.S. House,John Olson,DEM,720118,0,0,291,291,01
Tulsa,U.S. House,Jim Bridenstine,REP,720118,0,0,1034,1034,01
Tulsa,U.S. House,Craig Allen,IND,720118,0,0,40,40,01
Tulsa,State Senate,Julie Hall,DEM,720118,0,0,333,333,39
Tulsa,State Senate,Brian Crain,REP,720118,0,0,1011,1011,39
Tulsa,President,Barack Obama,DEM,720119,0,0,201,201,
Tulsa,President,Mitt Romney,REP,720119,0,0,706,706,
Tulsa,U.S. House,John Olson,DEM,720119,0,0,193,193,01
Tulsa,U.S. House,Jim Bridenstine,REP,720119,0,0,692,692,01
Tulsa,U.S. House,Craig Allen,IND,720119,0,0,16,16,01
Tulsa,President,Barack Obama,DEM,720120,0,0,256,256,
Tulsa,President,Mitt Romney,REP,720120,0,0,442,442,
Tulsa,U.S. House,John Olson,DEM,720120,0,0,219,219,01
Tulsa,U.S. House,Jim Bridenstine,REP,720120,0,0,438,438,01
Tulsa,U.S. House,Craig Allen,IND,720120,0,0,35,35,01
Tulsa,President,Barack Obama,DEM,720121,0,0,358,358,
Tulsa,President,Mitt Romney,REP,720121,0,0,530,530,
Tulsa,U.S. House,John Olson,DEM,720121,0,0,308,308,01
Tulsa,U.S. House,Jim Bridenstine,REP,720121,0,0,514,514,01
Tulsa,U.S. House,Craig Allen,IND,720121,0,0,50,50,01
Tulsa,State Senate,Julie Hall,DEM,720121,0,0,373,373,39
Tulsa,State Senate,Brian Crain,REP,720121,0,0,489,489,39
Tulsa,President,Barack Obama,DEM,720122,0,0,133,133,
Tulsa,President,Mitt Romney,REP,720122,0,0,312,312,
Tulsa,U.S. House,John Olson,DEM,720122,0,0,116,116,01
Tulsa,U.S. House,Jim Bridenstine,REP,720122,0,0,312,312,01
Tulsa,U.S. House,Craig Allen,IND,720122,0,0,19,19,01
Tulsa,State Senate,Julie Hall,DEM,720122,0,0,153,153,39
Tulsa,State Senate,Brian Crain,REP,720122,0,0,291,291,39
Tulsa,President,Barack Obama,DEM,720123,0,0,343,343,
Tulsa,President,Mitt Romney,REP,720123,0,0,727,727,
Tulsa,U.S. House,John Olson,DEM,720123,0,0,312,312,01
Tulsa,U.S. House,Jim Bridenstine,REP,720123,0,0,695,695,01
Tulsa,U.S. House,Craig Allen,IND,720123,0,0,49,49,01
Tulsa,State Senate,Julie Hall,DEM,720123,0,0,381,381,39
Tulsa,State Senate,Brian Crain,REP,720123,0,0,662,662,39
Tulsa,President,Barack Obama,DEM,720124,0,0,325,325,
Tulsa,President,Mitt Romney,REP,720124,0,0,695,695,
Tulsa,U.S. House,John Olson,DEM,720124,0,0,292,292,01
Tulsa,U.S. House,Jim Bridenstine,REP,720124,0,0,666,666,01
Tulsa,U.S. House,Craig Allen,IND,720124,0,0,48,48,01
Tulsa,State Senate,Julie Hall,DEM,720124,0,0,329,329,39
Tulsa,State Senate,Brian Crain,REP,720124,0,0,655,655,39
Tulsa,President,Barack Obama,DEM,720125,0,0,286,286,
Tulsa,President,Mitt Romney,REP,720125,0,0,598,598,
Tulsa,U.S. House,John Olson,DEM,720125,0,0,273,273,01
Tulsa,U.S. House,Jim Bridenstine,REP,720125,0,0,575,575,01
Tulsa,U.S. House,Craig Allen,IND,720125,0,0,32,32,01
Tulsa,State Senate,Julie Hall,DEM,720125,0,0,306,306,39
Tulsa,State Senate,Brian Crain,REP,720125,0,0,557,557,39
Tulsa,President,Barack Obama,DEM,720126,0,0,238,238,
Tulsa,President,Mitt Romney,REP,720126,0,0,554,554,
Tulsa,U.S. House,John Olson,DEM,720126,0,0,215,215,01
Tulsa,U.S. House,Jim Bridenstine,REP,720126,0,0,538,538,01
Tulsa,U.S. House,Craig Allen,IND,720126,0,0,28,28,01
Tulsa,State Senate,Julie Hall,DEM,720126,0,0,271,271,39
Tulsa,State Senate,Brian Crain,REP,720126,0,0,499,499,39
Tulsa,President,Barack Obama,DEM,720127,0,0,191,191,
Tulsa,President,Mitt Romney,REP,720127,0,0,439,439,
Tulsa,U.S. House,John Olson,DEM,720127,0,0,171,171,01
Tulsa,U.S. House,Jim Bridenstine,REP,720127,0,0,423,423,01
Tulsa,U.S. House,Craig Allen,IND,720127,0,0,35,35,01
Tulsa,State Senate,Julie Hall,DEM,720127,0,0,210,210,39
Tulsa,State Senate,Brian Crain,REP,720127,0,0,407,407,39
Tulsa,President,Barack Obama,DEM,720128,0,0,322,322,
Tulsa,President,Mitt Romney,REP,720128,0,0,582,582,
Tulsa,U.S. House,John Olson,DEM,720128,0,0,292,292,01
Tulsa,U.S. House,Jim Bridenstine,REP,720128,0,0,566,566,01
Tulsa,U.S. House,Craig Allen,IND,720128,0,0,43,43,01
Tulsa,State Senate,Julie Hall,DEM,720128,0,0,340,340,39
Tulsa,State Senate,Brian Crain,REP,720128,0,0,551,551,39
Tulsa,President,Barack Obama,DEM,720129,0,0,292,292,
Tulsa,President,Mitt Romney,REP,720129,0,0,609,609,
Tulsa,U.S. House,John Olson,DEM,720129,0,0,254,254,01
Tulsa,U.S. House,Jim Bridenstine,REP,720129,0,0,610,610,01
Tulsa,U.S. House,Craig Allen,IND,720129,0,0,35,35,01
Tulsa,President,Barack Obama,DEM,720130,0,0,368,368,
Tulsa,President,Mitt Romney,REP,720130,0,0,602,602,
Tulsa,U.S. House,John Olson,DEM,720130,0,0,341,341,01
Tulsa,U.S. House,Jim Bridenstine,REP,720130,0,0,592,592,01
Tulsa,U.S. House,Craig Allen,IND,720130,0,0,35,35,01
Tulsa,President,Barack Obama,DEM,720131,0,0,142,142,
Tulsa,President,Mitt Romney,REP,720131,0,0,110,110,
Tulsa,U.S. House,John Olson,DEM,720131,0,0,121,121,01
Tulsa,U.S. House,Jim Bridenstine,REP,720131,0,0,109,109,01
Tulsa,U.S. House,Craig Allen,IND,720131,0,0,18,18,01
Tulsa,President,Barack Obama,DEM,720132,0,0,241,241,
Tulsa,President,Mitt Romney,REP,720132,0,0,590,590,
Tulsa,U.S. House,John Olson,DEM,720132,0,0,205,205,01
Tulsa,U.S. House,Jim Bridenstine,REP,720132,0,0,580,580,01
Tulsa,U.S. House,Craig Allen,IND,720132,0,0,38,38,01
Tulsa,President,Barack Obama,DEM,720133,0,0,290,290,
Tulsa,President,Mitt Romney,REP,720133,0,0,585,585,
Tulsa,U.S. House,John Olson,DEM,720133,0,0,254,254,01
Tulsa,U.S. House,Jim Bridenstine,REP,720133,0,0,584,584,01
Tulsa,U.S. House,Craig Allen,IND,720133,0,0,37,37,01
Tulsa,President,Barack Obama,DEM,720134,0,0,317,317,
Tulsa,President,Mitt Romney,REP,720134,0,0,693,693,
Tulsa,U.S. House,John Olson,DEM,720134,0,0,283,283,01
Tulsa,U.S. House,Jim Bridenstine,REP,720134,0,0,688,688,01
Tulsa,U.S. House,Craig Allen,IND,720134,0,0,31,31,01
Tulsa,President,Barack Obama,DEM,720135,0,0,388,388,
Tulsa,President,Mitt Romney,REP,720135,0,0,1034,1034,
Tulsa,U.S. House,John Olson,DEM,720135,0,0,332,332,01
Tulsa,U.S. House,Jim Bridenstine,REP,720135,0,0,1014,1014,01
Tulsa,U.S. House,Craig Allen,IND,720135,0,0,50,50,01
Tulsa,President,Barack Obama,DEM,720136,0,0,202,202,
Tulsa,President,Mitt Romney,REP,720136,0,0,683,683,
Tulsa,U.S. House,John Olson,DEM,720136,0,0,181,181,01
Tulsa,U.S. House,Jim Bridenstine,REP,720136,0,0,673,673,01
Tulsa,U.S. House,Craig Allen,IND,720136,0,0,26,26,01
Tulsa,President,Barack Obama,DEM,720137,0,0,282,282,
Tulsa,President,Mitt Romney,REP,720137,0,0,352,352,
Tulsa,U.S. House,John Olson,DEM,720137,0,0,259,259,01
Tulsa,U.S. House,Jim Bridenstine,REP,720137,0,0,321,321,01
Tulsa,U.S. House,Craig Allen,IND,720137,0,0,43,43,01
Tulsa,President,Barack Obama,DEM,720138,0,0,50,50,
Tulsa,President,Mitt Romney,REP,720138,0,0,88,88,
Tulsa,U.S. House,John Olson,DEM,720138,0,0,46,46,01
Tulsa,U.S. House,Jim Bridenstine,REP,720138,0,0,84,84,01
Tulsa,U.S. House,Craig Allen,IND,720138,0,0,8,8,01
Tulsa,President,Barack Obama,DEM,720139,0,0,353,353,
Tulsa,President,Mitt Romney,REP,720139,0,0,168,168,
Tulsa,U.S. House,John Olson,DEM,720139,0,0,305,305,01
Tulsa,U.S. House,Jim Bridenstine,REP,720139,0,0,165,165,01
Tulsa,U.S. House,Craig Allen,IND,720139,0,0,39,39,01
Tulsa,President,Barack Obama,DEM,720140,0,0,219,219,
Tulsa,President,Mitt Romney,REP,720140,0,0,123,123,
Tulsa,U.S. House,John Olson,DEM,720140,0,0,204,204,01
Tulsa,U.S. House,Jim Bridenstine,REP,720140,0,0,121,121,01
Tulsa,U.S. House,Craig Allen,IND,720140,0,0,19,19,01
Tulsa,State Senate,Jabar Shumate,DEM,720140,0,0,195,195,11
Tulsa,State Senate,Dave Bell,REP,720140,0,0,102,102,11
Tulsa,State Senate,Curtis Mullins,IND,720140,0,0,44,44,11
Tulsa,State House,David Iii,DEM,720140,0,0,215,215,66
Tulsa,State House,Jadine Nollan,REP,720140,0,0,125,125,66
Tulsa,President,Barack Obama,DEM,720141,0,0,392,392,
Tulsa,President,Mitt Romney,REP,720141,0,0,681,681,
Tulsa,U.S. House,John Olson,DEM,720141,0,0,358,358,01
Tulsa,U.S. House,Jim Bridenstine,REP,720141,0,0,652,652,01
Tulsa,U.S. House,Craig Allen,IND,720141,0,0,59,59,01
Tulsa,President,Barack Obama,DEM,720142,0,0,176,176,
Tulsa,President,Mitt Romney,REP,720142,0,0,495,495,
Tulsa,U.S. House,John Olson,DEM,720142,0,0,174,174,01
Tulsa,U.S. House,Jim Bridenstine,REP,720142,0,0,452,452,01
Tulsa,U.S. House,Craig Allen,IND,720142,0,0,39,39,01
Tulsa,President,Barack Obama,DEM,720143,0,0,219,219,
Tulsa,President,Mitt Romney,REP,720143,0,0,394,394,
Tulsa,U.S. House,John Olson,DEM,720143,0,0,212,212,01
Tulsa,U.S. House,Jim Bridenstine,REP,720143,0,0,368,368,01
Tulsa,U.S. House,Craig Allen,IND,720143,0,0,31,31,01
Tulsa,President,Barack Obama,DEM,720144,0,0,602,602,
Tulsa,President,Mitt Romney,REP,720144,0,0,756,756,
Tulsa,U.S. House,John Olson,DEM,720144,0,0,544,544,01
Tulsa,U.S. House,Jim Bridenstine,REP,720144,0,0,720,720,01
Tulsa,U.S. House,Craig Allen,IND,720144,0,0,85,85,01
Tulsa,President,Barack Obama,DEM,720145,0,0,201,201,
Tulsa,President,Mitt Romney,REP,720145,0,0,749,749,
Tulsa,U.S. House,John Olson,DEM,720145,0,0,169,169,01
Tulsa,U.S. House,Jim Bridenstine,REP,720145,0,0,738,738,01
Tulsa,U.S. House,Craig Allen,IND,720145,0,0,33,33,01
Tulsa,President,Barack Obama,DEM,720146,0,0,317,317,
Tulsa,President,Mitt Romney,REP,720146,0,0,724,724,
Tulsa,U.S. House,John Olson,DEM,720146,0,0,278,278,01
Tulsa,U.S. House,Jim Bridenstine,REP,720146,0,0,703,703,01
Tulsa,U.S. House,Craig Allen,IND,720146,0,0,54,54,01
Tulsa,President,Barack Obama,DEM,720147,0,0,180,180,
Tulsa,President,Mitt Romney,REP,720147,0,0,92,92,
Tulsa,U.S. House,John Olson,DEM,720147,0,0,159,159,01
Tulsa,U.S. House,Jim Bridenstine,REP,720147,0,0,91,91,01
Tulsa,U.S. House,Craig Allen,IND,720147,0,0,22,22,01
Tulsa,State House,David Iii,DEM,720147,0,0,175,175,66
Tulsa,State House,Jadine Nollan,REP,720147,0,0,94,94,66
Tulsa,President,Barack Obama,DEM,720148,0,0,221,221,
Tulsa,President,Mitt Romney,REP,720148,0,0,363,363,
Tulsa,U.S. House,John Olson,DEM,720148,0,0,223,223,01
Tulsa,U.S. House,Jim Bridenstine,REP,720148,0,0,320,320,01
Tulsa,U.S. House,Craig Allen,IND,720148,0,0,37,37,01
Tulsa,State House,David Iii,DEM,720148,0,0,234,234,66
Tulsa,State House,Jadine Nollan,REP,720148,0,0,344,344,66
Tulsa,President,Barack Obama,DEM,720149,0,0,220,220,
Tulsa,President,Mitt Romney,REP,720149,0,0,295,295,
Tulsa,U.S. House,John Olson,DEM,720149,0,0,215,215,01
Tulsa,U.S. House,Jim Bridenstine,REP,720149,0,0,263,263,01
Tulsa,U.S. House,Craig Allen,IND,720149,0,0,36,36,01
Tulsa,State House,David Iii,DEM,720149,0,0,230,230,66
Tulsa,State House,Jadine Nollan,REP,720149,0,0,279,279,66
Tulsa,President,Barack Obama,DEM,720150,0,0,303,303,
Tulsa,President,Mitt Romney,REP,720150,0,0,1206,1206,
Tulsa,U.S. House,John Olson,DEM,720150,0,0,282,282,01
Tulsa,U.S. House,Jim Bridenstine,REP,720150,0,0,1172,1172,01
Tulsa,U.S. House,Craig Allen,IND,720150,0,0,39,39,01
Tulsa,President,Barack Obama,DEM,720151,0,0,137,137,
Tulsa,President,Mitt Romney,REP,720151,0,0,264,264,
Tulsa,U.S. House,John Olson,DEM,720151,0,0,122,122,01
Tulsa,U.S. House,Jim Bridenstine,REP,720151,0,0,250,250,01
Tulsa,U.S. House,Craig Allen,IND,720151,0,0,21,21,01
Tulsa,President,Barack Obama,DEM,720152,0,0,140,140,
Tulsa,President,Mitt Romney,REP,720152,0,0,536,536,
Tulsa,U.S. House,John Olson,DEM,720152,0,0,129,129,01
Tulsa,U.S. House,Jim Bridenstine,REP,720152,0,0,523,523,01
Tulsa,U.S. House,Craig Allen,IND,720152,0,0,23,23,01
Tulsa,President,Barack Obama,DEM,720153,0,0,257,257,
Tulsa,President,Mitt Romney,REP,720153,0,0,738,738,
Tulsa,U.S. House,John Olson,DEM,720153,0,0,243,243,01
Tulsa,U.S. House,Jim Bridenstine,REP,720153,0,0,715,715,01
Tulsa,U.S. House,Craig Allen,IND,720153,0,0,34,34,01
Tulsa,President,Barack Obama,DEM,720154,0,0,370,370,
Tulsa,President,Mitt Romney,REP,720154,0,0,1033,1033,
Tulsa,U.S. House,John Olson,DEM,720154,0,0,330,330,01
Tulsa,U.S. House,Jim Bridenstine,REP,720154,0,0,992,992,01
Tulsa,U.S. House,Craig Allen,IND,720154,0,0,66,66,01
Tulsa,President,Barack Obama,DEM,720155,0,0,295,295,
Tulsa,President,Mitt Romney,REP,720155,0,0,1374,1374,
Tulsa,U.S. House,John Olson,DEM,720155,0,0,276,276,01
Tulsa,U.S. House,Jim Bridenstine,REP,720155,0,0,1345,1345,01
Tulsa,U.S. House,Craig Allen,IND,720155,0,0,37,37,01
Tulsa,President,Barack Obama,DEM,720156,0,0,114,114,
Tulsa,President,Mitt Romney,REP,720156,0,0,165,165,
Tulsa,U.S. House,John Olson,DEM,720156,0,0,99,99,01
Tulsa,U.S. House,Jim Bridenstine,REP,720156,0,0,155,155,01
Tulsa,U.S. House,Craig Allen,IND,720156,0,0,22,22,01
Tulsa,President,Barack Obama,DEM,720157,0,0,303,303,
Tulsa,President,Mitt Romney,REP,720157,0,0,1359,1359,
Tulsa,U.S. House,John Olson,DEM,720157,0,0,282,282,01
Tulsa,U.S. House,Jim Bridenstine,REP,720157,0,0,1324,1324,01
Tulsa,U.S. House,Craig Allen,IND,720157,0,0,42,42,01
Tulsa,President,Barack Obama,DEM,720158,0,0,255,255,
Tulsa,President,Mitt Romney,REP,720158,0,0,793,793,
Tulsa,U.S. House,John Olson,DEM,720158,0,0,239,239,01
Tulsa,U.S. House,Jim Bridenstine,REP,720158,0,0,757,757,01
Tulsa,U.S. House,Craig Allen,IND,720158,0,0,39,39,01
Tulsa,President,Barack Obama,DEM,720159,0,0,323,323,
Tulsa,President,Mitt Romney,REP,720159,0,0,895,895,
Tulsa,U.S. House,John Olson,DEM,720159,0,0,297,297,01
Tulsa,U.S. House,Jim Bridenstine,REP,720159,0,0,877,877,01
Tulsa,U.S. House,Craig Allen,IND,720159,0,0,40,40,01
Tulsa,President,Barack Obama,DEM,720160,0,0,466,466,
Tulsa,President,Mitt Romney,REP,720160,0,0,806,806,
Tulsa,U.S. House,John Olson,DEM,720160,0,0,431,431,01
Tulsa,U.S. House,Jim Bridenstine,REP,720160,0,0,769,769,01
Tulsa,U.S. House,Craig Allen,IND,720160,0,0,62,62,01
Tulsa,State Senate,Julie Hall,DEM,720160,0,0,520,520,39
Tulsa,State Senate,Brian Crain,REP,720160,0,0,719,719,39
Tulsa,President,Barack Obama,DEM,720161,0,0,407,407,
Tulsa,President,Mitt Romney,REP,720161,0,0,260,260,
Tulsa,U.S. House,John Olson,DEM,720161,0,0,375,375,01
Tulsa,U.S. House,Jim Bridenstine,REP,720161,0,0,242,242,01
Tulsa,U.S. House,Craig Allen,IND,720161,0,0,44,44,01
Tulsa,State House,Dan Arthrell,DEM,720161,0,0,391,391,71
Tulsa,State House,Katie Henke,REP,720161,0,0,269,269,71
Tulsa,President,Barack Obama,DEM,720162,0,0,59,59,
Tulsa,President,Mitt Romney,REP,720162,0,0,130,130,
Tulsa,U.S. House,John Olson,DEM,720162,0,0,41,41,01
Tulsa,U.S. House,Jim Bridenstine,REP,720162,0,0,125,125,01
Tulsa,U.S. House,Craig Allen,IND,720162,0,0,19,19,01
Tulsa,President,Barack Obama,DEM,720163,0,0,329,329,
Tulsa,President,Mitt Romney,REP,720163,0,0,581,581,
Tulsa,U.S. House,John Olson,DEM,720163,0,0,313,313,01
Tulsa,U.S. House,Jim Bridenstine,REP,720163,0,0,552,552,01
Tulsa,U.S. House,Craig Allen,IND,720163,0,0,36,36,01
Tulsa,President,Barack Obama,DEM,720164,0,0,132,132,
Tulsa,President,Mitt Romney,REP,720164,0,0,264,264,
Tulsa,U.S. House,John Olson,DEM,720164,0,0,115,115,01
Tulsa,U.S. House,Jim Bridenstine,REP,720164,0,0,261,261,01
Tulsa,U.S. House,Craig Allen,IND,720164,0,0,15,15,01
Tulsa,State Senate,Julie Hall,DEM,720164,0,0,141,141,39
Tulsa,State Senate,Brian Crain,REP,720164,0,0,244,244,39
Tulsa,President,Barack Obama,DEM,720165,0,0,137,137,
Tulsa,President,Mitt Romney,REP,720165,0,0,430,430,
Tulsa,U.S. House,John Olson,DEM,720165,0,0,121,121,01
Tulsa,U.S. House,Jim Bridenstine,REP,720165,0,0,415,415,01
Tulsa,U.S. House,Craig Allen,IND,720165,0,0,30,30,01
Tulsa,State Senate,Julie Hall,DEM,720165,0,0,136,136,39
Tulsa,State Senate,Brian Crain,REP,720165,0,0,421,421,39
Tulsa,President,Barack Obama,DEM,720166,0,0,324,324,
Tulsa,President,Mitt Romney,REP,720166,0,0,986,986,
Tulsa,U.S. House,John Olson,DEM,720166,0,0,289,289,01
Tulsa,U.S. House,Jim Bridenstine,REP,720166,0,0,973,973,01
Tulsa,U.S. House,Craig Allen,IND,720166,0,0,49,49,01
Tulsa,State Senate,Julie Hall,DEM,720166,0,0,347,347,39
Tulsa,State Senate,Brian Crain,REP,720166,0,0,931,931,39
Tulsa,President,Barack Obama,DEM,720167,0,0,164,164,
Tulsa,President,Mitt Romney,REP,720167,0,0,872,872,
Tulsa,U.S. House,John Olson,DEM,720167,0,0,164,164,01
Tulsa,U.S. House,Jim Bridenstine,REP,720167,0,0,843,843,01
Tulsa,U.S. House,Craig Allen,IND,720167,0,0,23,23,01
Tulsa,President,Barack Obama,DEM,720168,0,0,277,277,
Tulsa,President,Mitt Romney,REP,720168,0,0,642,642,
Tulsa,U.S. House,John Olson,DEM,720168,0,0,257,257,01
Tulsa,U.S. House,Jim Bridenstine,REP,720168,0,0,630,630,01
Tulsa,U.S. House,Craig Allen,IND,720168,0,0,29,29,01
Tulsa,President,Barack Obama,DEM,720169,0,0,330,330,
Tulsa,President,Mitt Romney,REP,720169,0,0,521,521,
Tulsa,U.S. House,John Olson,DEM,720169,0,0,310,310,01
Tulsa,U.S. House,Jim Bridenstine,REP,720169,0,0,487,487,01
Tulsa,U.S. House,Craig Allen,IND,720169,0,0,39,39,01
Tulsa,President,Barack Obama,DEM,720170,0,0,99,99,
Tulsa,President,Mitt Romney,REP,720170,0,0,528,528,
Tulsa,U.S. House,John Olson,DEM,720170,0,0,101,101,01
Tulsa,U.S. House,Jim Bridenstine,REP,720170,0,0,505,505,01
Tulsa,U.S. House,Craig Allen,IND,720170,0,0,15,15,01
Tulsa,President,Barack Obama,DEM,720171,0,0,197,197,
Tulsa,President,Mitt Romney,REP,720171,0,0,480,480,
Tulsa,U.S. House,John Olson,DEM,720171,0,0,176,176,01
Tulsa,U.S. House,Jim Bridenstine,REP,720171,0,0,474,474,01
Tulsa,U.S. House,Craig Allen,IND,720171,0,0,27,27,01
Tulsa,President,Barack Obama,DEM,720172,0,0,309,309,
Tulsa,President,Mitt Romney,REP,720172,0,0,616,616,
Tulsa,U.S. House,John Olson,DEM,720172,0,0,273,273,01
Tulsa,U.S. House,Jim Bridenstine,REP,720172,0,0,609,609,01
Tulsa,U.S. House,Craig Allen,IND,720172,0,0,35,35,01
Tulsa,President,Barack Obama,DEM,720173,0,0,317,317,
Tulsa,President,Mitt Romney,REP,720173,0,0,767,767,
Tulsa,U.S. House,John Olson,DEM,720173,0,0,292,292,01
Tulsa,U.S. House,Jim Bridenstine,REP,720173,0,0,762,762,01
Tulsa,U.S. House,Craig Allen,IND,720173,0,0,29,29,01
Tulsa,President,Barack Obama,DEM,720174,0,0,0,0,
Tulsa,President,Mitt Romney,REP,720174,0,0,0,0,
Tulsa,U.S. House,John Olson,DEM,720174,0,0,0,0,01
Tulsa,U.S. House,Jim Bridenstine,REP,720174,0,0,0,0,01
Tulsa,U.S. House,Craig Allen,IND,720174,0,0,0,0,01
Tulsa,State Senate,Jabar Shumate,DEM,720174,0,0,0,0,11
Tulsa,State Senate,Dave Bell,REP,720174,0,0,0,0,11
Tulsa,State Senate,Curtis Mullins,IND,720174,0,0,0,0,11
Tulsa,President,Barack Obama,DEM,720175,0,0,0,0,
Tulsa,President,Mitt Romney,REP,720175,0,0,0,0,
Tulsa,U.S. House,John Olson,DEM,720175,0,0,0,0,01
Tulsa,U.S. House,Jim Bridenstine,REP,720175,0,0,0,0,01
Tulsa,U.S. House,Craig Allen,IND,720175,0,0,0,0,01
Tulsa,State Senate,Jabar Shumate,DEM,720175,0,0,0,0,11
Tulsa,State Senate,Dave Bell,REP,720175,0,0,0,0,11
Tulsa,State Senate,Curtis Mullins,IND,720175,0,0,0,0,11
Tulsa,President,Barack Obama,DEM,720176,0,0,0,0,
Tulsa,President,Mitt Romney,REP,720176,0,0,0,0,
Tulsa,U.S. House,John Olson,DEM,720176,0,0,0,0,01
Tulsa,U.S. House,Jim Bridenstine,REP,720176,0,0,0,0,01
Tulsa,U.S. House,Craig Allen,IND,720176,0,0,0,0,01
Tulsa,State House,Jeannie Mcdaniel,DEM,720176,0,0,0,0,78
Tulsa,State House,Paul Catalano,REP,720176,0,0,0,0,78
Tulsa,President,Barack Obama,DEM,720351,0,0,354,354,
Tulsa,President,Mitt Romney,REP,720351,0,0,1149,1149,
Tulsa,U.S. House,John Olson,DEM,720351,0,0,328,328,01
Tulsa,U.S. House,Jim Bridenstine,REP,720351,0,0,1104,1104,01
Tulsa,U.S. House,Craig Allen,IND,720351,0,0,63,63,01
Tulsa,President,Barack Obama,DEM,720352,0,0,162,162,
Tulsa,President,Mitt Romney,REP,720352,0,0,668,668,
Tulsa,U.S. House,John Olson,DEM,720352,0,0,158,158,01
Tulsa,U.S. House,Jim Bridenstine,REP,720352,0,0,636,636,01
Tulsa,U.S. House,Craig Allen,IND,720352,0,0,31,31,01
Tulsa,President,Barack Obama,DEM,720353,0,0,30,30,
Tulsa,President,Mitt Romney,REP,720353,0,0,128,128,
Tulsa,U.S. House,John Olson,DEM,720353,0,0,31,31,01
Tulsa,U.S. House,Jim Bridenstine,REP,720353,0,0,122,122,01
Tulsa,U.S. House,Craig Allen,IND,720353,0,0,5,5,01
Tulsa,State House,Jerry Shoemake,DEM,720353,0,0,46,46,16
Tulsa,State House,James Delso,REP,720353,0,0,110,110,16
Tulsa,President,Barack Obama,DEM,720354,0,0,35,35,
Tulsa,President,Mitt Romney,REP,720354,0,0,127,127,
Tulsa,U.S. House,John Olson,DEM,720354,0,0,43,43,01
Tulsa,U.S. House,Jim Bridenstine,REP,720354,0,0,111,111,01
Tulsa,U.S. House,Craig Allen,IND,720354,0,0,8,8,01
Tulsa,President,Barack Obama,DEM,720355,0,0,61,61,
Tulsa,President,Mitt Romney,REP,720355,0,0,173,173,
Tulsa,U.S. House,John Olson,DEM,720355,0,0,52,52,01
Tulsa,U.S. House,Jim Bridenstine,REP,720355,0,0,172,172,01
Tulsa,U.S. House,Craig Allen,IND,720355,0,0,9,9,01
Tulsa,President,Barack Obama,DEM,720356,0,0,26,26,
Tulsa,President,Mitt Romney,REP,720356,0,0,228,228,
Tulsa,U.S. House,John Olson,DEM,720356,0,0,21,21,01
Tulsa,U.S. House,Jim Bridenstine,REP,720356,0,0,229,229,01
Tulsa,U.S. House,Craig Allen,IND,720356,0,0,3,3,01
Tulsa,President,Barack Obama,DEM,720400,0,0,238,238,
Tulsa,President,Mitt Romney,REP,720400,0,0,1075,1075,
Tulsa,U.S. House,John Olson,DEM,720400,0,0,214,214,01
Tulsa,U.S. House,Jim Bridenstine,REP,720400,0,0,1045,1045,01
Tulsa,U.S. House,Craig Allen,IND,720400,0,0,43,43,01
Tulsa,President,Barack Obama,DEM,720401,0,0,216,216,
Tulsa,President,Mitt Romney,REP,720401,0,0,1124,1124,
Tulsa,U.S. House,John Olson,DEM,720401,0,0,214,214,01
Tulsa,U.S. House,Jim Bridenstine,REP,720401,0,0,1079,1079,01
Tulsa,U.S. House,Craig Allen,IND,720401,0,0,40,40,01
Tulsa,President,Barack Obama,DEM,720402,0,0,177,177,
Tulsa,President,Mitt Romney,REP,720402,0,0,584,584,
Tulsa,U.S. House,John Olson,DEM,720402,0,0,165,165,01
Tulsa,U.S. House,Jim Bridenstine,REP,720402,0,0,558,558,01
Tulsa,U.S. House,Craig Allen,IND,720402,0,0,40,40,01
Tulsa,President,Barack Obama,DEM,720403,0,0,421,421,
Tulsa,President,Mitt Romney,REP,720403,0,0,1496,1496,
Tulsa,U.S. House,John Olson,DEM,720403,0,0,378,378,01
Tulsa,U.S. House,Jim Bridenstine,REP,720403,0,0,1447,1447,01
Tulsa,U.S. House,Craig Allen,IND,720403,0,0,74,74,01
Tulsa,President,Barack Obama,DEM,720404,0,0,209,209,
Tulsa,President,Mitt Romney,REP,720404,0,0,866,866,
Tulsa,U.S. House,John Olson,DEM,720404,0,0,179,179,01
Tulsa,U.S. House,Jim Bridenstine,REP,720404,0,0,868,868,01
Tulsa,U.S. House,Craig Allen,IND,720404,0,0,23,23,01
Tulsa,President,Barack Obama,DEM,720405,0,0,10,10,
Tulsa,President,Mitt Romney,REP,720405,0,0,68,68,
Tulsa,U.S. House,John Olson,DEM,720405,0,0,6,6,01
Tulsa,U.S. House,Jim Bridenstine,REP,720405,0,0,70,70,01
Tulsa,U.S. House,Craig Allen,IND,720405,0,0,3,3,01
Tulsa,President,Barack Obama,DEM,720406,0,0,250,250,
Tulsa,President,Mitt Romney,REP,720406,0,0,1016,1016,
Tulsa,U.S. House,John Olson,DEM,720406,0,0,235,235,01
Tulsa,U.S. House,Jim Bridenstine,REP,720406,0,0,991,991,01
Tulsa,U.S. House,Craig Allen,IND,720406,0,0,32,32,01
Tulsa,President,Barack Obama,DEM,720407,0,0,239,239,
Tulsa,President,Mitt Romney,REP,720407,0,0,933,933,
Tulsa,U.S. House,John Olson,DEM,720407,0,0,213,213,01
Tulsa,U.S. House,Jim Bridenstine,REP,720407,0,0,911,911,01
Tulsa,U.S. House,Craig Allen,IND,720407,0,0,38,38,01
Tulsa,President,Barack Obama,DEM,720408,0,0,264,264,
Tulsa,President,Mitt Romney,REP,720408,0,0,949,949,
Tulsa,U.S. House,John Olson,DEM,720408,0,0,233,233,01
Tulsa,U.S. House,Jim Bridenstine,REP,720408,0,0,919,919,01
Tulsa,U.S. House,Craig Allen,IND,720408,0,0,58,58,01
Tulsa,President,Barack Obama,DEM,720409,0,0,277,277,
Tulsa,President,Mitt Romney,REP,720409,0,0,979,979,
Tulsa,U.S. House,John Olson,DEM,720409,0,0,238,238,01
Tulsa,U.S. House,Jim Bridenstine,REP,720409,0,0,968,968,01
Tulsa,U.S. House,Craig Allen,IND,720409,0,0,47,47,01
Tulsa,President,Barack Obama,DEM,720410,0,0,80,80,
Tulsa,President,Mitt Romney,REP,720410,0,0,419,419,
Tulsa,U.S. House,John Olson,DEM,720410,0,0,73,73,01
Tulsa,U.S. House,Jim Bridenstine,REP,720410,0,0,413,413,01
Tulsa,U.S. House,Craig Allen,IND,720410,0,0,16,16,01
Tulsa,President,Barack Obama,DEM,720411,0,0,112,112,
Tulsa,President,Mitt Romney,REP,720411,0,0,411,411,
Tulsa,U.S. House,John Olson,DEM,720411,0,0,103,103,01
Tulsa,U.S. House,Jim Bridenstine,REP,720411,0,0,404,404,01
Tulsa,U.S. House,Craig Allen,IND,720411,0,0,20,20,01
Tulsa,President,Barack Obama,DEM,720451,0,0,272,272,
Tulsa,President,Mitt Romney,REP,720451,0,0,687,687,
Tulsa,U.S. House,John Olson,DEM,720451,0,0,234,234,01
Tulsa,U.S. House,Jim Bridenstine,REP,720451,0,0,663,663,01
Tulsa,U.S. House,Craig Allen,IND,720451,0,0,58,58,01
Tulsa,State House,Glenda Puett,DEM,720451,0,0,303,303,76
Tulsa,State House,David Brumbaugh,REP,720451,0,0,641,641,76
Tulsa,President,Barack Obama,DEM,720452,0,0,474,474,
Tulsa,President,Mitt Romney,REP,720452,0,0,1234,1234,
Tulsa,U.S. House,John Olson,DEM,720452,0,0,425,425,01
Tulsa,U.S. House,Jim Bridenstine,REP,720452,0,0,1185,1185,01
Tulsa,U.S. House,Craig Allen,IND,720452,0,0,83,83,01
Tulsa,President,Barack Obama,DEM,720453,0,0,241,241,
Tulsa,President,Mitt Romney,REP,720453,0,0,749,749,
Tulsa,U.S. House,John Olson,DEM,720453,0,0,221,221,01
Tulsa,U.S. House,Jim Bridenstine,REP,720453,0,0,725,725,01
Tulsa,U.S. House,Craig Allen,IND,720453,0,0,36,36,01
Tulsa,President,Barack Obama,DEM,720454,0,0,418,418,
Tulsa,President,Mitt Romney,REP,720454,0,0,1010,1010,
Tulsa,U.S. House,John Olson,DEM,720454,0,0,369,369,01
Tulsa,U.S. House,Jim Bridenstine,REP,720454,0,0,1000,1000,01
Tulsa,U.S. House,Craig Allen,IND,720454,0,0,47,47,01
Tulsa,State House,Glenda Puett,DEM,720454,0,0,463,463,76
Tulsa,State House,David Brumbaugh,REP,720454,0,0,931,931,76
Tulsa,President,Barack Obama,DEM,720455,0,0,187,187,
Tulsa,President,Mitt Romney,REP,720455,0,0,451,451,
Tulsa,U.S. House,John Olson,DEM,720455,0,0,171,171,01
Tulsa,U.S. House,Jim Bridenstine,REP,720455,0,0,436,436,01
Tulsa,U.S. House,Craig Allen,IND,720455,0,0,30,30,01
Tulsa,State House,Glenda Puett,DEM,720455,0,0,203,203,76
Tulsa,State House,David Brumbaugh,REP,720455,0,0,425,425,76
Tulsa,President,Barack Obama,DEM,720456,0,0,265,265,
Tulsa,President,Mitt Romney,REP,720456,0,0,738,738,
Tulsa,U.S. House,John Olson,DEM,720456,0,0,239,239,01
Tulsa,U.S. House,Jim Bridenstine,REP,720456,0,0,709,709,01
Tulsa,U.S. House,Craig Allen,IND,720456,0,0,46,46,01
Tulsa,State House,Glenda Puett,DEM,720456,0,0,274,274,76
Tulsa,State House,David Brumbaugh,REP,720456,0,0,709,709,76
Tulsa,President,Barack Obama,DEM,720457,0,0,13,13,
Tulsa,President,Mitt Romney,REP,720457,0,0,33,33,
Tulsa,U.S. House,John Olson,DEM,720457,0,0,14,14,01
Tulsa,U.S. House,Jim Bridenstine,REP,720457,0,0,30,30,01
Tulsa,U.S. House,Craig Allen,IND,720457,0,0,2,2,01
Tulsa,President,Barack Obama,DEM,720458,0,0,467,467,
Tulsa,President,Mitt Romney,REP,720458,0,0,1264,1264,
Tulsa,U.S. House,John Olson,DEM,720458,0,0,416,416,01
Tulsa,U.S. House,Jim Bridenstine,REP,720458,0,0,1218,1218,01
Tulsa,U.S. House,Craig Allen,IND,720458,0,0,88,88,01
Tulsa,State House,Glenda Puett,DEM,720458,0,0,503,503,76
Tulsa,State House,David Brumbaugh,REP,720458,0,0,1193,1193,76
Tulsa,President,Barack Obama,DEM,720459,0,0,180,180,
Tulsa,President,Mitt Romney,REP,720459,0,0,498,498,
Tulsa,U.S. House,John Olson,DEM,720459,0,0,155,155,01
Tulsa,U.S. House,Jim Bridenstine,REP,720459,0,0,486,486,01
Tulsa,U.S. House,Craig Allen,IND,720459,0,0,35,35,01
Tulsa,President,Barack Obama,DEM,720460,0,0,147,147,
Tulsa,President,Mitt Romney,REP,720460,0,0,688,688,
Tulsa,U.S. House,John Olson,DEM,720460,0,0,130,130,01
Tulsa,U.S. House,Jim Bridenstine,REP,720460,0,0,681,681,01
Tulsa,U.S. House,Craig Allen,IND,720460,0,0,20,20,01
Tulsa,President,Barack Obama,DEM,720461,0,0,292,292,
Tulsa,President,Mitt Romney,REP,720461,0,0,688,688,
Tulsa,U.S. House,John Olson,DEM,720461,0,0,257,257,01
Tulsa,U.S. House,Jim Bridenstine,REP,720461,0,0,671,671,01
Tulsa,U.S. House,Craig Allen,IND,720461,0,0,50,50,01
Tulsa,President,Barack Obama,DEM,720462,0,0,369,369,
Tulsa,President,Mitt Romney,REP,720462,0,0,1032,1032,
Tulsa,U.S. House,John Olson,DEM,720462,0,0,332,332,01
Tulsa,U.S. House,Jim Bridenstine,REP,720462,0,0,1005,1005,01
Tulsa,U.S. House,Craig Allen,IND,720462,0,0,57,57,01
Tulsa,State House,Glenda Puett,DEM,720462,0,0,389,389,76
Tulsa,State House,David Brumbaugh,REP,720462,0,0,989,989,76
Tulsa,President,Barack Obama,DEM,720463,0,0,269,269,
Tulsa,President,Mitt Romney,REP,720463,0,0,646,646,
Tulsa,U.S. House,John Olson,DEM,720463,0,0,228,228,01
Tulsa,U.S. House,Jim Bridenstine,REP,720463,0,0,627,627,01
Tulsa,U.S. House,Craig Allen,IND,720463,0,0,50,50,01
Tulsa,State House,Glenda Puett,DEM,720463,0,0,283,283,76
Tulsa,State House,David Brumbaugh,REP,720463,0,0,610,610,76
Tulsa,President,Barack Obama,DEM,720464,0,0,447,447,
Tulsa,President,Mitt Romney,REP,720464,0,0,1393,1393,
Tulsa,U.S. House,John Olson,DEM,720464,0,0,407,407,01
Tulsa,U.S. House,Jim Bridenstine,REP,720464,0,0,1349,1349,01
Tulsa,U.S. House,Craig Allen,IND,720464,0,0,70,70,01
Tulsa,President,Barack Obama,DEM,720465,0,0,636,636,
Tulsa,President,Mitt Romney,REP,720465,0,0,996,996,
Tulsa,U.S. House,John Olson,DEM,720465,0,0,587,587,01
Tulsa,U.S. House,Jim Bridenstine,REP,720465,0,0,965,965,01
Tulsa,U.S. House,Craig Allen,IND,720465,0,0,70,70,01
Tulsa,State House,Glenda Puett,DEM,720465,0,0,669,669,76
Tulsa,State House,David Brumbaugh,REP,720465,0,0,926,926,76
Tulsa,President,Barack Obama,DEM,720466,0,0,304,304,
Tulsa,President,Mitt Romney,REP,720466,0,0,886,886,
Tulsa,U.S. House,John Olson,DEM,720466,0,0,289,289,01
Tulsa,U.S. House,Jim Bridenstine,REP,720466,0,0,854,854,01
Tulsa,U.S. House,Craig Allen,IND,720466,0,0,36,36,01
Tulsa,President,Barack Obama,DEM,720467,0,0,20,20,
Tulsa,President,Mitt Romney,REP,720467,0,0,107,107,
Tulsa,U.S. House,John Olson,DEM,720467,0,0,16,16,01
Tulsa,U.S. House,Jim Bridenstine,REP,720467,0,0,109,109,01
Tulsa,U.S. House,Craig Allen,IND,720467,0,0,2,2,01
Tulsa,President,Barack Obama,DEM,720468,0,0,381,381,
Tulsa,President,Mitt Romney,REP,720468,0,0,984,984,
Tulsa,U.S. House,John Olson,DEM,720468,0,0,324,324,01
Tulsa,U.S. House,Jim Bridenstine,REP,720468,0,0,971,971,01
Tulsa,U.S. House,Craig Allen,IND,720468,0,0,60,60,01
Tulsa,State House,Glenda Puett,DEM,720468,0,0,421,421,76
Tulsa,State House,David Brumbaugh,REP,720468,0,0,923,923,76
Tulsa,President,Barack Obama,DEM,720469,0,0,108,108,
Tulsa,President,Mitt Romney,REP,720469,0,0,190,190,
Tulsa,U.S. House,John Olson,DEM,720469,0,0,90,90,01
Tulsa,U.S. House,Jim Bridenstine,REP,720469,0,0,188,188,01
Tulsa,U.S. House,Craig Allen,IND,720469,0,0,17,17,01
Tulsa,President,Barack Obama,DEM,720470,0,0,409,409,
Tulsa,President,Mitt Romney,REP,720470,0,0,1080,1080,
Tulsa,U.S. House,John Olson,DEM,720470,0,0,377,377,01
Tulsa,U.S. House,Jim Bridenstine,REP,720470,0,0,1044,1044,01
Tulsa,U.S. House,Craig Allen,IND,720470,0,0,58,58,01
Tulsa,State House,Glenda Puett,DEM,720470,0,0,459,459,76
Tulsa,State House,David Brumbaugh,REP,720470,0,0,1003,1003,76
Tulsa,President,Barack Obama,DEM,720471,0,0,137,137,
Tulsa,President,Mitt Romney,REP,720471,0,0,528,528,
Tulsa,U.S. House,John Olson,DEM,720471,0,0,126,126,01
Tulsa,U.S. House,Jim Bridenstine,REP,720471,0,0,515,515,01
Tulsa,U.S. House,Craig Allen,IND,720471,0,0,21,21,01
Tulsa,State House,Glenda Puett,DEM,720471,0,0,174,174,76
Tulsa,State House,David Brumbaugh,REP,720471,0,0,478,478,76
Tulsa,President,Barack Obama,DEM,720472,0,0,107,107,
Tulsa,President,Mitt Romney,REP,720472,0,0,382,382,
Tulsa,U.S. House,John Olson,DEM,720472,0,0,102,102,01
Tulsa,U.S. House,Jim Bridenstine,REP,720472,0,0,372,372,01
Tulsa,U.S. House,Craig Allen,IND,720472,0,0,15,15,01
Tulsa,President,Barack Obama,DEM,720473,0,0,178,178,
Tulsa,President,Mitt Romney,REP,720473,0,0,634,634,
Tulsa,U.S. House,John Olson,DEM,720473,0,0,159,159,01
Tulsa,U.S. House,Jim Bridenstine,REP,720473,0,0,608,608,01
Tulsa,U.S. House,Craig Allen,IND,720473,0,0,45,45,01
Tulsa,President,Barack Obama,DEM,720474,0,0,450,450,
Tulsa,President,Mitt Romney,REP,720474,0,0,1212,1212,
Tulsa,U.S. House,John Olson,DEM,720474,0,0,422,422,01
Tulsa,U.S. House,Jim Bridenstine,REP,720474,0,0,1152,1152,01
Tulsa,U.S. House,Craig Allen,IND,720474,0,0,74,74,01
Tulsa,State House,Glenda Puett,DEM,720474,0,0,564,564,76
Tulsa,State House,David Brumbaugh,REP,720474,0,0,1065,1065,76
Tulsa,President,Barack Obama,DEM,720475,0,0,340,340,
Tulsa,President,Mitt Romney,REP,720475,0,0,1055,1055,
Tulsa,U.S. House,John Olson,DEM,720475,0,0,314,314,01
Tulsa,U.S. House,Jim Bridenstine,REP,720475,0,0,1035,1035,01
Tulsa,U.S. House,Craig Allen,IND,720475,0,0,38,38,01
Tulsa,President,Barack Obama,DEM,720476,0,0,112,112,
Tulsa,President,Mitt Romney,REP,720476,0,0,363,363,
Tulsa,U.S. House,John Olson,DEM,720476,0,0,101,101,01
Tulsa,U.S. House,Jim Bridenstine,REP,720476,0,0,354,354,01
Tulsa,U.S. House,Craig Allen,IND,720476,0,0,15,15,01
Tulsa,President,Barack Obama,DEM,720501,0,0,116,116,
Tulsa,President,Mitt Romney,REP,720501,0,0,416,416,
Tulsa,U.S. House,John Olson,DEM,720501,0,0,117,117,01
Tulsa,U.S. House,Jim Bridenstine,REP,720501,0,0,390,390,01
Tulsa,U.S. House,Craig Allen,IND,720501,0,0,15,15,01
Tulsa,State House,Jim Massey,DEM,720501,0,0,137,137,36
Tulsa,State House,Sean Roberts,REP,720501,0,0,384,384,36
Tulsa,President,Barack Obama,DEM,720502,0,0,349,349,
Tulsa,President,Mitt Romney,REP,720502,0,0,954,954,
Tulsa,U.S. House,John Olson,DEM,720502,0,0,329,329,01
Tulsa,U.S. House,Jim Bridenstine,REP,720502,0,0,898,898,01
Tulsa,U.S. House,Craig Allen,IND,720502,0,0,61,61,01
Tulsa,President,Barack Obama,DEM,720503,0,0,218,218,
Tulsa,President,Mitt Romney,REP,720503,0,0,627,627,
Tulsa,U.S. House,John Olson,DEM,720503,0,0,210,210,01
Tulsa,U.S. House,Jim Bridenstine,REP,720503,0,0,573,573,01
Tulsa,U.S. House,Craig Allen,IND,720503,0,0,65,65,01
Tulsa,President,Barack Obama,DEM,720504,0,0,288,288,
Tulsa,President,Mitt Romney,REP,720504,0,0,816,816,
Tulsa,U.S. House,John Olson,DEM,720504,0,0,271,271,01
Tulsa,U.S. House,Jim Bridenstine,REP,720504,0,0,774,774,01
Tulsa,U.S. House,Craig Allen,IND,720504,0,0,53,53,01
Tulsa,President,Barack Obama,DEM,720551,0,0,127,127,
Tulsa,President,Mitt Romney,REP,720551,0,0,182,182,
Tulsa,U.S. House,John Olson,DEM,720551,0,0,124,124,01
Tulsa,U.S. House,Jim Bridenstine,REP,720551,0,0,165,165,01
Tulsa,U.S. House,Craig Allen,IND,720551,0,0,19,19,01
Tulsa,State House,Seneca Scott,DEM,720551,0,0,173,173,72
Tulsa,State House,Randall Reese,REP,720551,0,0,133,133,72
Tulsa,President,Barack Obama,DEM,720552,0,0,159,159,
Tulsa,President,Mitt Romney,REP,720552,0,0,427,427,
Tulsa,U.S. House,John Olson,DEM,720552,0,0,156,156,01
Tulsa,U.S. House,Jim Bridenstine,REP,720552,0,0,395,395,01
Tulsa,U.S. House,Craig Allen,IND,720552,0,0,27,27,01
Tulsa,State House,Jim Massey,DEM,720552,0,0,209,209,36
Tulsa,State House,Sean Roberts,REP,720552,0,0,362,362,36
Tulsa,President,Barack Obama,DEM,720553,0,0,100,100,
Tulsa,President,Mitt Romney,REP,720553,0,0,238,238,
Tulsa,U.S. House,John Olson,DEM,720553,0,0,98,98,01
Tulsa,U.S. House,Jim Bridenstine,REP,720553,0,0,211,211,01
Tulsa,U.S. House,Craig Allen,IND,720553,0,0,24,24,01
Tulsa,State House,Seneca Scott,DEM,720553,0,0,143,143,72
Tulsa,State House,Randall Reese,REP,720553,0,0,183,183,72
Tulsa,President,Barack Obama,DEM,720700,0,0,277,277,
Tulsa,President,Mitt Romney,REP,720700,0,0,1102,1102,
Tulsa,U.S. House,John Olson,DEM,720700,0,0,251,251,01
Tulsa,U.S. House,Jim Bridenstine,REP,720700,0,0,1073,1073,01
Tulsa,U.S. House,Craig Allen,IND,720700,0,0,49,49,01
Tulsa,President,Barack Obama,DEM,720701,0,0,358,358,
Tulsa,President,Mitt Romney,REP,720701,0,0,1217,1217,
Tulsa,U.S. House,John Olson,DEM,720701,0,0,340,340,01
Tulsa,U.S. House,Jim Bridenstine,REP,720701,0,0,1189,1189,01
Tulsa,U.S. House,Craig Allen,IND,720701,0,0,42,42,01
Tulsa,President,Barack Obama,DEM,720702,0,0,292,292,
Tulsa,President,Mitt Romney,REP,720702,0,0,618,618,
Tulsa,U.S. House,John Olson,DEM,720702,0,0,265,265,01
Tulsa,U.S. House,Jim Bridenstine,REP,720702,0,0,596,596,01
Tulsa,U.S. House,Craig Allen,IND,720702,0,0,48,48,01
Tulsa,President,Barack Obama,DEM,720703,0,0,309,309,
Tulsa,President,Mitt Romney,REP,720703,0,0,1069,1069,
Tulsa,U.S. House,John Olson,DEM,720703,0,0,268,268,01
Tulsa,U.S. House,Jim Bridenstine,REP,720703,0,0,1046,1046,01
Tulsa,U.S. House,Craig Allen,IND,720703,0,0,53,53,01
Tulsa,President,Barack Obama,DEM,720704,0,0,205,205,
Tulsa,President,Mitt Romney,REP,720704,0,0,951,951,
Tulsa,U.S. House,John Olson,DEM,720704,0,0,183,183,01
Tulsa,U.S. House,Jim Bridenstine,REP,720704,0,0,941,941,01
Tulsa,U.S. House,Craig Allen,IND,720704,0,0,29,29,01
Tulsa,President,Barack Obama,DEM,720705,0,0,249,249,
Tulsa,President,Mitt Romney,REP,720705,0,0,564,564,
Tulsa,U.S. House,John Olson,DEM,720705,0,0,208,208,01
Tulsa,U.S. House,Jim Bridenstine,REP,720705,0,0,563,563,01
Tulsa,U.S. House,Craig Allen,IND,720705,0,0,39,39,01
Tulsa,President,Barack Obama,DEM,720706,0,0,460,460,
Tulsa,President,Mitt Romney,REP,720706,0,0,1237,1237,
Tulsa,U.S. House,John Olson,DEM,720706,0,0,393,393,01
Tulsa,U.S. House,Jim Bridenstine,REP,720706,0,0,1209,1209,01
Tulsa,U.S. House,Craig Allen,IND,720706,0,0,88,88,01
Tulsa,President,Barack Obama,DEM,720707,0,0,187,187,
Tulsa,President,Mitt Romney,REP,720707,0,0,468,468,
Tulsa,U.S. House,John Olson,DEM,720707,0,0,162,162,01
Tulsa,U.S. House,Jim Bridenstine,REP,720707,0,0,462,462,01
Tulsa,U.S. House,Craig Allen,IND,720707,0,0,32,32,01
Tulsa,President,Barack Obama,DEM,720708,0,0,275,275,
Tulsa,President,Mitt Romney,REP,720708,0,0,650,650,
Tulsa,U.S. House,John Olson,DEM,720708,0,0,236,236,01
Tulsa,U.S. House,Jim Bridenstine,REP,720708,0,0,634,634,01
Tulsa,U.S. House,Craig Allen,IND,720708,0,0,53,53,01
Tulsa,President,Barack Obama,DEM,720709,0,0,269,269,
Tulsa,President,Mitt Romney,REP,720709,0,0,779,779,
Tulsa,U.S. House,John Olson,DEM,720709,0,0,239,239,01
Tulsa,U.S. House,Jim Bridenstine,REP,720709,0,0,765,765,01
Tulsa,U.S. House,Craig Allen,IND,720709,0,0,40,40,01
Tulsa,President,Barack Obama,DEM,720710,0,0,56,56,
Tulsa,President,Mitt Romney,REP,720710,0,0,249,249,
Tulsa,U.S. House,John Olson,DEM,720710,0,0,46,46,01
Tulsa,U.S. House,Jim Bridenstine,REP,720710,0,0,242,242,01
Tulsa,U.S. House,Craig Allen,IND,720710,0,0,13,13,01
Tulsa,President,Barack Obama,DEM,720750,0,0,270,270,
Tulsa,President,Mitt Romney,REP,720750,0,0,858,858,
Tulsa,U.S. House,John Olson,DEM,720750,0,0,242,242,01
Tulsa,U.S. House,Jim Bridenstine,REP,720750,0,0,829,829,01
Tulsa,U.S. House,Craig Allen,IND,720750,0,0,40,40,01
Tulsa,President,Barack Obama,DEM,720751,0,0,365,365,
Tulsa,President,Mitt Romney,REP,720751,0,0,1041,1041,
Tulsa,U.S. House,John Olson,DEM,720751,0,0,344,344,01
Tulsa,U.S. House,Jim Bridenstine,REP,720751,0,0,993,993,01
Tulsa,U.S. House,Craig Allen,IND,720751,0,0,64,64,01
Tulsa,President,Barack Obama,DEM,720752,0,0,224,224,
Tulsa,President,Mitt Romney,REP,720752,0,0,699,699,
Tulsa,U.S. House,John Olson,DEM,720752,0,0,208,208,01
Tulsa,U.S. House,Jim Bridenstine,REP,720752,0,0,672,672,01
Tulsa,U.S. House,Craig Allen,IND,720752,0,0,43,43,01
Tulsa,State House,Jim Massey,DEM,720752,0,0,249,249,36
Tulsa,State House,Sean Roberts,REP,720752,0,0,664,664,36
Tulsa,President,Barack Obama,DEM,720753,0,0,255,255,
Tulsa,President,Mitt Romney,REP,720753,0,0,614,614,
Tulsa,U.S. House,John Olson,DEM,720753,0,0,242,242,01
Tulsa,U.S. House,Jim Bridenstine,REP,720753,0,0,580,580,01
Tulsa,U.S. House,Craig Allen,IND,720753,0,0,45,45,01
Tulsa,State House,Seneca Scott,DEM,720753,0,0,317,317,72
Tulsa,State House,Randall Reese,REP,720753,0,0,525,525,72
Tulsa,President,Barack Obama,DEM,720754,0,0,435,435,
Tulsa,President,Mitt Romney,REP,720754,0,0,1204,1204,
Tulsa,U.S. House,John Olson,DEM,720754,0,0,387,387,01
Tulsa,U.S. House,Jim Bridenstine,REP,720754,0,0,1147,1147,01
Tulsa,U.S. House,Craig Allen,IND,720754,0,0,92,92,01
Tulsa,President,Barack Obama,DEM,720755,0,0,486,486,
Tulsa,President,Mitt Romney,REP,720755,0,0,1399,1399,
Tulsa,U.S. House,John Olson,DEM,720755,0,0,438,438,01
Tulsa,U.S. House,Jim Bridenstine,REP,720755,0,0,1354,1354,01
Tulsa,U.S. House,Craig Allen,IND,720755,0,0,78,78,01
Tulsa,President,Barack Obama,DEM,720756,0,0,21,21,
Tulsa,President,Mitt Romney,REP,720756,0,0,67,67,
Tulsa,U.S. House,John Olson,DEM,720756,0,0,21,21,01
Tulsa,U.S. House,Jim Bridenstine,REP,720756,0,0,61,61,01
Tulsa,U.S. House,Craig Allen,IND,720756,0,0,5,5,01
Tulsa,President,Barack Obama,DEM,720757,0,0,397,397,
Tulsa,President,Mitt Romney,REP,720757,0,0,1576,1576,
Tulsa,U.S. House,John Olson,DEM,720757,0,0,359,359,01
Tulsa,U.S. House,Jim Bridenstine,REP,720757,0,0,1519,1519,01
Tulsa,U.S. House,Craig Allen,IND,720757,0,0,85,85,01
Tulsa,President,Barack Obama,DEM,720758,0,0,88,88,
Tulsa,President,Mitt Romney,REP,720758,0,0,198,198,
Tulsa,U.S. House,John Olson,DEM,720758,0,0,79,79,01
Tulsa,U.S. House,Jim Bridenstine,REP,720758,0,0,194,194,01
Tulsa,U.S. House,Craig Allen,IND,720758,0,0,6,6,01
Tulsa,State House,Jim Massey,DEM,720758,0,0,87,87,36
Tulsa,State House,Sean Roberts,REP,720758,0,0,190,190,36
Tulsa,President,Barack Obama,DEM,720759,0,0,305,305,
Tulsa,President,Mitt Romney,REP,720759,0,0,891,891,
Tulsa,U.S. House,John Olson,DEM,720759,0,0,292,292,01
Tulsa,U.S. House,Jim Bridenstine,REP,720759,0,0,838,838,01
Tulsa,U.S. House,Craig Allen,IND,720759,0,0,60,60,01
Tulsa,President,Barack Obama,DEM,720760,0,0,286,286,
Tulsa,President,Mitt Romney,REP,720760,0,0,909,909,
Tulsa,U.S. House,John Olson,DEM,720760,0,0,248,248,01
Tulsa,U.S. House,Jim Bridenstine,REP,720760,0,0,867,867,01
Tulsa,U.S. House,Craig Allen,IND,720760,0,0,67,67,01
Tulsa,President,Barack Obama,DEM,720801,0,0,193,193,
Tulsa,President,Mitt Romney,REP,720801,0,0,603,603,
Tulsa,U.S. House,John Olson,DEM,720801,0,0,191,191,01
Tulsa,U.S. House,Jim Bridenstine,REP,720801,0,0,576,576,01
Tulsa,U.S. House,Craig Allen,IND,720801,0,0,22,22,01
Tulsa,State House,David Iii,DEM,720801,0,0,184,184,66
Tulsa,State House,Jadine Nollan,REP,720801,0,0,594,594,66
Tulsa,President,Barack Obama,DEM,720802,0,0,163,163,
Tulsa,President,Mitt Romney,REP,720802,0,0,308,308,
Tulsa,U.S. House,John Olson,DEM,720802,0,0,147,147,01
Tulsa,U.S. House,Jim Bridenstine,REP,720802,0,0,303,303,01
Tulsa,U.S. House,Craig Allen,IND,720802,0,0,16,16,01
Tulsa,President,Barack Obama,DEM,720851,0,0,266,266,
Tulsa,President,Mitt Romney,REP,720851,0,0,555,555,
Tulsa,U.S. House,John Olson,DEM,720851,0,0,231,231,01
Tulsa,U.S. House,Jim Bridenstine,REP,720851,0,0,559,559,01
Tulsa,U.S. House,Craig Allen,IND,720851,0,0,29,29,01
Tulsa,State House,David Iii,DEM,720851,0,0,215,215,66
Tulsa,State House,Jadine Nollan,REP,720851,0,0,606,606,66
Tulsa,President,Barack Obama,DEM,720852,0,0,244,244,
Tulsa,President,Mitt Romney,REP,720852,0,0,350,350,
Tulsa,U.S. House,John Olson,DEM,720852,0,0,207,207,01
Tulsa,U.S. House,Jim Bridenstine,REP,720852,0,0,339,339,01
Tulsa,U.S. House,Craig Allen,IND,720852,0,0,38,38,01
Tulsa,State House,David Iii,DEM,720852,0,0,202,202,66
Tulsa,State House,Jadine Nollan,REP,720852,0,0,384,384,66
Tulsa,President,Barack Obama,DEM,720853,0,0,218,218,
Tulsa,President,Mitt Romney,REP,720853,0,0,514,514,
Tulsa,U.S. House,John Olson,DEM,720853,0,0,199,199,01
Tulsa,U.S. House,Jim Bridenstine,REP,720853,0,0,489,489,01
Tulsa,U.S. House,Craig Allen,IND,720853,0,0,39,39,01
Tulsa,State House,David Iii,DEM,720853,0,0,185,185,66
Tulsa,State House,Jadine Nollan,REP,720853,0,0,542,542,66
Tulsa,President,Barack Obama,DEM,720854,0,0,380,380,
Tulsa,President,Mitt Romney,REP,720854,0,0,1045,1045,
Tulsa,U.S. House,John Olson,DEM,720854,0,0,346,346,01
Tulsa,U.S. House,Jim Bridenstine,REP,720854,0,0,1018,1018,01
Tulsa,U.S. House,Craig Allen,IND,720854,0,0,48,48,01
Tulsa,State House,David Iii,DEM,720854,0,0,306,306,66
Tulsa,State House,Jadine Nollan,REP,720854,0,0,1109,1109,66
Tulsa,President,Barack Obama,DEM,720855,0,0,377,377,
Tulsa,President,Mitt Romney,REP,720855,0,0,938,938,
Tulsa,U.S. House,John Olson,DEM,720855,0,0,326,326,01
Tulsa,U.S. House,Jim Bridenstine,REP,720855,0,0,907,907,01
Tulsa,U.S. House,Craig Allen,IND,720855,0,0,60,60,01
Tulsa,State House,David Iii,DEM,720855,0,0,310,310,66
Tulsa,State House,Jadine Nollan,REP,720855,0,0,992,992,66
Tulsa,President,Barack Obama,DEM,720856,0,0,361,361,
Tulsa,President,Mitt Romney,REP,720856,0,0,1002,1002,
Tulsa,U.S. House,John Olson,DEM,720856,0,0,324,324,01
Tulsa,U.S. House,Jim Bridenstine,REP,720856,0,0,960,960,01
Tulsa,U.S. House,Craig Allen,IND,720856,0,0,60,60,01
Tulsa,State House,David Iii,DEM,720856,0,0,339,339,66
Tulsa,State House,Jadine Nollan,REP,720856,0,0,998,998,66
Tulsa,President,Barack Obama,DEM,720857,0,0,394,394,
Tulsa,President,Mitt Romney,REP,720857,0,0,616,616,
Tulsa,U.S. House,John Olson,DEM,720857,0,0,341,341,01
Tulsa,U.S. House,Jim Bridenstine,REP,720857,0,0,598,598,01
Tulsa,U.S. House,Craig Allen,IND,720857,0,0,70,70,01
Tulsa,State House,David Iii,DEM,720857,0,0,338,338,66
Tulsa,State House,Jadine Nollan,REP,720857,0,0,664,664,66
Tulsa,President,Barack Obama,DEM,720858,0,0,119,119,
Tulsa,President,Mitt Romney,REP,720858,0,0,335,335,
Tulsa,U.S. House,John Olson,DEM,720858,0,0,116,116,01
Tulsa,U.S. House,Jim Bridenstine,REP,720858,0,0,310,310,01
Tulsa,U.S. House,Craig Allen,IND,720858,0,0,26,26,01
Tulsa,State House,David Narcomey,DEM,720858,0,0,116,116,29
Tulsa,State House,Skye Mcniel,REP,720858,0,0,331,331,29
Tulsa,President,Barack Obama,DEM,720880,0,0,305,305,
Tulsa,President,Mitt Romney,REP,720880,0,0,779,779,
Tulsa,U.S. House,John Olson,DEM,720880,0,0,275,275,01
Tulsa,U.S. House,Jim Bridenstine,REP,720880,0,0,737,737,01
Tulsa,U.S. House,Craig Allen,IND,720880,0,0,66,66,01
Tulsa,State House,David Narcomey,DEM,720880,0,0,296,296,29
Tulsa,State House,Skye Mcniel,REP,720880,0,0,769,769,29
Tulsa,President,Barack Obama,DEM,720881,0,0,240,240,
Tulsa,President,Mitt Romney,REP,720881,0,0,568,568,
Tulsa,U.S. House,John Olson,DEM,720881,0,0,224,224,01
Tulsa,U.S. House,Jim Bridenstine,REP,720881,0,0,544,544,01
Tulsa,U.S. House,Craig Allen,IND,720881,0,0,35,35,01
Tulsa,State House,David Iii,DEM,720881,0,0,229,229,66
Tulsa,State House,Jadine Nollan,REP,720881,0,0,571,571,66
Tulsa,President,Barack Obama,DEM,720900,0,0,286,286,
Tulsa,President,Mitt Romney,REP,720900,0,0,792,792,
Tulsa,U.S. House,John Olson,DEM,720900,0,0,266,266,01
Tulsa,U.S. House,Jim Bridenstine,REP,720900,0,0,740,740,01
Tulsa,U.S. House,Craig Allen,IND,720900,0,0,64,64,01
Tulsa,State House,Jim Massey,DEM,720900,0,0,358,358,36
Tulsa,State House,Sean Roberts,REP,720900,0,0,708,708,36
Tulsa,President,Barack Obama,DEM,729999,3786,5055,1,8842,
Tulsa,President,Mitt Romney,REP,729999,7562,4016,1,11579,
Tulsa,U.S. House,John Olson,DEM,729999,3556,4843,1,8400,01
Tulsa,U.S. House,Jim Bridenstine,REP,729999,7185,3923,0,11108,01
Tulsa,U.S. House,Craig Allen,IND,729999,398,271,0,669,01
Tulsa,State Senate,Jabar Shumate,DEM,729999,575,1781,1,2357,11
Tulsa,State Senate,Dave Bell,REP,729999,148,161,0,309,11
Tulsa,State Senate,Curtis Mullins,IND,729999,29,74,0,103,11
Tulsa,State Senate,Julie Hall,DEM,729999,787,628,0,1415,39
Tulsa,State Senate,Brian Crain,REP,729999,1166,599,0,1765,39
Tulsa,State House,Jerry Shoemake,DEM,729999,1,0,0,1,16
Tulsa,State House,James Delso,REP,729999,4,0,0,4,16
Tulsa,State House,Shawna Keller,DEM,729999,88,147,0,235,23
Tulsa,State House,Terry O'Donnell,REP,729999,101,57,0,158,23
Tulsa,State House,David Narcomey,DEM,729999,10,13,0,23,29
Tulsa,State House,Skye Mcniel,REP,729999,33,31,0,64,29
Tulsa,State House,Jim Massey,DEM,729999,44,31,0,75,36
Tulsa,State House,Sean Roberts,REP,729999,126,51,0,177,36
Tulsa,State House,David Iii,DEM,729999,168,220,0,388,66
Tulsa,State House,Jadine Nollan,REP,729999,294,252,0,546,66
Tulsa,State House,Dan Arthrell,DEM,729999,367,409,0,776,71
Tulsa,State House,Katie Henke,REP,729999,492,302,0,794,71
Tulsa,State House,Seneca Scott,DEM,729999,181,455,1,637,72
Tulsa,State House,Randall Reese,REP,729999,78,80,0,158,72
Tulsa,State House,Glenda Puett,DEM,729999,177,218,0,395,76
Tulsa,State House,David Brumbaugh,REP,729999,551,235,0,786,76
Tulsa,State House,Jeannie Mcdaniel,DEM,729999,422,394,0,816,78
Tulsa,State House,Paul Catalano,REP,729999,226,167,0,393,78
Wagoner,President,Barack Obama,DEM,730101,12,5,244,261,
Wagoner,President,Mitt Romney,REP,730101,16,10,479,505,
Wagoner,U.S. House,John Olson,DEM,730101,13,5,232,250,01
Wagoner,U.S. House,Jim Bridenstine,REP,730101,15,10,455,480,01
Wagoner,U.S. House,Craig Allen,IND,730101,1,0,34,35,01
Wagoner,State House,Shawna Keller,DEM,730101,12,7,277,296,23
Wagoner,State House,Terry O'Donnell,REP,730101,16,8,438,462,23
Wagoner,President,Barack Obama,DEM,730102,4,5,188,197,
Wagoner,President,Mitt Romney,REP,730102,23,15,604,642,
Wagoner,U.S. House,John Olson,DEM,730102,3,5,176,184,01
Wagoner,U.S. House,Jim Bridenstine,REP,730102,20,15,579,614,01
Wagoner,U.S. House,Craig Allen,IND,730102,1,0,32,33,01
Wagoner,President,Barack Obama,DEM,730103,10,13,500,523,
Wagoner,President,Mitt Romney,REP,730103,40,27,1285,1352,
Wagoner,U.S. House,John Olson,DEM,730103,8,13,446,467,01
Wagoner,U.S. House,Jim Bridenstine,REP,730103,41,26,1240,1307,01
Wagoner,U.S. House,Craig Allen,IND,730103,1,1,91,93,01
Wagoner,President,Barack Obama,DEM,730104,0,0,0,0,
Wagoner,President,Mitt Romney,REP,730104,0,0,0,0,
Wagoner,U.S. House,John Olson,DEM,730104,0,0,0,0,01
Wagoner,U.S. House,Jim Bridenstine,REP,730104,0,0,0,0,01
Wagoner,U.S. House,Craig Allen,IND,730104,0,0,0,0,01
Wagoner,State House,Wade Rousselot,DEM,730104,0,0,0,0,12
Wagoner,State House,David Tackett,REP,730104,0,0,0,0,12
Wagoner,President,Barack Obama,DEM,730105,0,0,0,0,
Wagoner,President,Mitt Romney,REP,730105,0,0,6,6,
Wagoner,U.S. House,John Olson,DEM,730105,0,0,0,0,01
Wagoner,U.S. House,Jim Bridenstine,REP,730105,0,0,6,6,01
Wagoner,U.S. House,Craig Allen,IND,730105,0,0,0,0,01
Wagoner,President,Barack Obama,DEM,730106,26,13,465,504,
Wagoner,President,Mitt Romney,REP,730106,79,46,1304,1429,
Wagoner,U.S. House,John Olson,DEM,730106,23,11,413,447,01
Wagoner,U.S. House,Jim Bridenstine,REP,730106,76,45,1271,1392,01
Wagoner,U.S. House,Craig Allen,IND,730106,5,2,81,88,01
Wagoner,President,Barack Obama,DEM,730107,22,15,425,462,
Wagoner,President,Mitt Romney,REP,730107,72,47,1173,1292,
Wagoner,U.S. House,John Olson,DEM,730107,25,15,379,419,01
Wagoner,U.S. House,Jim Bridenstine,REP,730107,62,47,1140,1249,01
Wagoner,U.S. House,Craig Allen,IND,730107,6,0,72,78,01
Wagoner,President,Barack Obama,DEM,730108,16,22,202,240,
Wagoner,President,Mitt Romney,REP,730108,56,40,590,686,
Wagoner,U.S. House,John Olson,DEM,730108,19,22,172,213,01
Wagoner,U.S. House,Jim Bridenstine,REP,730108,48,36,593,677,01
Wagoner,U.S. House,Craig Allen,IND,730108,1,4,25,30,01
Wagoner,State House,Wade Rousselot,DEM,730108,20,25,287,332,12
Wagoner,State House,David Tackett,REP,730108,46,37,506,589,12
Wagoner,President,Barack Obama,DEM,730109,13,21,159,193,
Wagoner,President,Mitt Romney,REP,730109,29,38,639,706,
Wagoner,U.S. House,John Olson,DEM,730109,13,19,145,177,01
Wagoner,U.S. House,Jim Bridenstine,REP,730109,29,39,625,693,01
Wagoner,U.S. House,Craig Allen,IND,730109,0,1,28,29,01
Wagoner,State House,Wade Rousselot,DEM,730109,18,26,305,349,12
Wagoner,State House,David Tackett,REP,730109,23,33,489,545,12
Wagoner,President,Barack Obama,DEM,730201,8,18,221,247,
Wagoner,President,Mitt Romney,REP,730201,35,50,843,928,
Wagoner,U.S. House,John Olson,DEM,730201,5,17,204,226,01
Wagoner,U.S. House,Jim Bridenstine,REP,730201,38,47,805,890,01
Wagoner,U.S. House,Craig Allen,IND,730201,0,3,44,47,01
Wagoner,State House,Wade Rousselot,DEM,730201,11,30,406,447,12
Wagoner,State House,David Tackett,REP,730201,32,37,647,716,12
Wagoner,President,Barack Obama,DEM,730202,10,13,240,263,
Wagoner,President,Mitt Romney,REP,730202,32,55,962,1049,
Wagoner,U.S. House,John Olson,DEM,730202,10,15,245,270,01
Wagoner,U.S. House,Jim Bridenstine,REP,730202,31,50,902,983,01
Wagoner,U.S. House,Craig Allen,IND,730202,0,3,52,55,01
Wagoner,State House,Wade Rousselot,DEM,730202,15,26,505,546,12
Wagoner,State House,David Tackett,REP,730202,24,42,692,758,12
Wagoner,President,Barack Obama,DEM,730203,14,76,369,459,
Wagoner,President,Mitt Romney,REP,730203,34,184,755,973,
Wagoner,U.S. House,John Olson,DEM,730203,16,82,384,482,01
Wagoner,U.S. House,Jim Bridenstine,REP,730203,30,163,652,845,01
Wagoner,U.S. House,Craig Allen,IND,730203,4,12,75,91,01
Wagoner,State House,Wade Rousselot,DEM,730203,24,169,721,914,12
Wagoner,State House,David Tackett,REP,730203,24,89,401,514,12
Wagoner,President,Barack Obama,DEM,730204,11,24,252,287,
Wagoner,President,Mitt Romney,REP,730204,13,50,458,521,
Wagoner,U.S. House,John Olson,DEM,730204,9,24,248,281,01
Wagoner,U.S. House,Jim Bridenstine,REP,730204,12,46,413,471,01
Wagoner,U.S. House,Craig Allen,IND,730204,2,4,48,54,01
Wagoner,State House,Wade Rousselot,DEM,730204,9,39,420,468,12
Wagoner,State House,David Tackett,REP,730204,13,35,295,343,12
Wagoner,President,Barack Obama,DEM,730205,0,2,38,40,
Wagoner,President,Mitt Romney,REP,730205,2,12,87,101,
Wagoner,U.S. House,John Olson,DEM,730205,1,1,36,38,01
Wagoner,U.S. House,Jim Bridenstine,REP,730205,1,13,79,93,01
Wagoner,U.S. House,Craig Allen,IND,730205,0,0,9,9,01
Wagoner,State House,Wade Rousselot,DEM,730205,1,6,62,69,12
Wagoner,State House,David Tackett,REP,730205,1,8,64,73,12
Wagoner,President,Barack Obama,DEM,730206,0,0,13,13,
Wagoner,President,Mitt Romney,REP,730206,5,0,37,42,
Wagoner,U.S. House,John Olson,DEM,730206,0,0,15,15,01
Wagoner,U.S. House,Jim Bridenstine,REP,730206,4,0,33,37,01
Wagoner,U.S. House,Craig Allen,IND,730206,0,0,2,2,01
Wagoner,State House,Wade Rousselot,DEM,730206,0,0,19,19,12
Wagoner,State House,David Tackett,REP,730206,2,0,32,34,12
Wagoner,President,Barack Obama,DEM,730207,10,25,296,331,
Wagoner,President,Mitt Romney,REP,730207,2,20,152,174,
Wagoner,U.S. House,John Olson,DEM,730207,9,24,289,322,01
Wagoner,U.S. House,Jim Bridenstine,REP,730207,2,19,136,157,01
Wagoner,U.S. House,Craig Allen,IND,730207,1,1,19,21,01
Wagoner,State House,Wade Rousselot,DEM,730207,9,32,357,398,12
Wagoner,State House,David Tackett,REP,730207,3,13,86,102,12
Wagoner,President,Barack Obama,DEM,730208,16,129,531,676,
Wagoner,President,Mitt Romney,REP,730208,30,240,866,1136,
Wagoner,U.S. House,John Olson,DEM,730208,15,122,569,706,01
Wagoner,U.S. House,Jim Bridenstine,REP,730208,29,229,727,985,01
Wagoner,U.S. House,Craig Allen,IND,730208,2,14,83,99,01
Wagoner,State House,Wade Rousselot,DEM,730208,26,227,947,1200,12
Wagoner,State House,David Tackett,REP,730208,20,141,444,605,12
Wagoner,President,Barack Obama,DEM,730209,1,23,104,128,
Wagoner,President,Mitt Romney,REP,730209,14,25,241,280,
Wagoner,U.S. House,John Olson,DEM,730209,2,22,99,123,01
Wagoner,U.S. House,Jim Bridenstine,REP,730209,13,25,231,269,01
Wagoner,U.S. House,Craig Allen,IND,730209,0,1,11,12,01
Wagoner,State House,Wade Rousselot,DEM,730209,3,32,173,208,12
Wagoner,State House,David Tackett,REP,730209,11,16,172,199,12
Wagoner,President,Barack Obama,DEM,730210,7,46,371,424,
Wagoner,President,Mitt Romney,REP,730210,21,79,657,757,
Wagoner,U.S. House,John Olson,DEM,730210,7,49,383,439,01
Wagoner,U.S. House,Jim Bridenstine,REP,730210,18,65,549,632,01
Wagoner,U.S. House,Craig Allen,IND,730210,2,10,83,95,01
Wagoner,State House,Wade Rousselot,DEM,730210,17,95,777,889,12
Wagoner,State House,David Tackett,REP,730210,10,32,259,301,12
Wagoner,President,Barack Obama,DEM,730301,9,16,224,249,
Wagoner,President,Mitt Romney,REP,730301,66,44,771,881,
Wagoner,U.S. House,John Olson,DEM,730301,11,15,204,230,01
Wagoner,U.S. House,Jim Bridenstine,REP,730301,63,43,754,860,01
Wagoner,U.S. House,Craig Allen,IND,730301,2,2,36,40,01
Wagoner,President,Barack Obama,DEM,730302,18,17,312,347,
Wagoner,President,Mitt Romney,REP,730302,73,55,1293,1421,
Wagoner,U.S. House,John Olson,DEM,730302,19,20,282,321,01
Wagoner,U.S. House,Jim Bridenstine,REP,730302,69,51,1265,1385,01
Wagoner,U.S. House,Craig Allen,IND,730302,3,1,48,52,01
Wagoner,President,Barack Obama,DEM,730303,5,14,135,154,
Wagoner,President,Mitt Romney,REP,730303,26,25,477,528,
Wagoner,U.S. House,John Olson,DEM,730303,5,14,115,134,01
Wagoner,U.S. House,Jim Bridenstine,REP,730303,25,24,467,516,01
Wagoner,U.S. House,Craig Allen,IND,730303,2,1,31,34,01
Wagoner,State House,Wade Rousselot,DEM,730303,4,19,170,193,12
Wagoner,State House,David Tackett,REP,730303,28,20,433,481,12
Wagoner,President,Barack Obama,DEM,730304,12,8,205,225,
Wagoner,President,Mitt Romney,REP,730304,24,23,674,721,
Wagoner,U.S. House,John Olson,DEM,730304,12,9,194,215,01
Wagoner,U.S. House,Jim Bridenstine,REP,730304,21,22,650,693,01
Wagoner,U.S. House,Craig Allen,IND,730304,2,1,32,35,01
Wagoner,President,Barack Obama,DEM,730305,1,1,13,15,
Wagoner,President,Mitt Romney,REP,730305,6,12,79,97,
Wagoner,U.S. House,John Olson,DEM,730305,1,1,11,13,01
Wagoner,U.S. House,Jim Bridenstine,REP,730305,6,11,75,92,01
Wagoner,U.S. House,Craig Allen,IND,730305,0,0,5,5,01
Wagoner,State House,Wade Rousselot,DEM,730305,1,3,32,36,12
Wagoner,State House,David Tackett,REP,730305,6,9,59,74,12
Wagoner,President,Barack Obama,DEM,730306,16,9,263,288,
Wagoner,President,Mitt Romney,REP,730306,53,26,1046,1125,
Wagoner,U.S. House,John Olson,DEM,730306,16,8,234,258,01
Wagoner,U.S. House,Jim Bridenstine,REP,730306,49,27,1019,1095,01
Wagoner,U.S. House,Craig Allen,IND,730306,1,0,58,59,01
Wagoner,President,Barack Obama,DEM,730307,8,11,195,214,
Wagoner,President,Mitt Romney,REP,730307,42,43,774,859,
Wagoner,U.S. House,John Olson,DEM,730307,8,11,200,219,01
Wagoner,U.S. House,Jim Bridenstine,REP,730307,37,41,732,810,01
Wagoner,U.S. House,Craig Allen,IND,730307,3,3,36,42,01
Wagoner,State House,Jerry Shoemake,DEM,730307,11,16,280,307,16
Wagoner,State House,James Delso,REP,730307,37,38,666,741,16
Wagoner,President,Barack Obama,DEM,730308,11,6,175,192,
Wagoner,President,Mitt Romney,REP,730308,28,34,575,637,
Wagoner,U.S. House,John Olson,DEM,730308,7,6,181,194,01
Wagoner,U.S. House,Jim Bridenstine,REP,730308,30,33,545,608,01
Wagoner,U.S. House,Craig Allen,IND,730308,1,0,19,20,01
Wagoner,State House,Jerry Shoemake,DEM,730308,16,13,261,290,16
Wagoner,State House,James Delso,REP,730308,21,25,481,527,16
Wagoner,President,Barack Obama,DEM,730309,11,11,284,306,
Wagoner,President,Mitt Romney,REP,730309,20,32,726,778,
Wagoner,U.S. House,John Olson,DEM,730309,9,13,281,303,01
Wagoner,U.S. House,Jim Bridenstine,REP,730309,18,29,667,714,01
Wagoner,U.S. House,Craig Allen,IND,730309,3,1,61,65,01
Wagoner,State House,Wade Rousselot,DEM,730309,15,20,506,541,12
Wagoner,State House,David Tackett,REP,730309,12,23,503,538,12
Wagoner,President,Barack Obama,DEM,730310,5,0,74,79,
Wagoner,President,Mitt Romney,REP,730310,14,6,325,345,
Wagoner,U.S. House,John Olson,DEM,730310,2,0,73,75,01
Wagoner,U.S. House,Jim Bridenstine,REP,730310,13,6,315,334,01
Wagoner,U.S. House,Craig Allen,IND,730310,4,0,15,19,01
Wagoner,State House,Jerry Shoemake,DEM,730310,4,0,158,162,16
Wagoner,State House,James Delso,REP,730310,14,6,245,265,16
Wagoner,President,Barack Obama,DEM,730311,4,3,56,63,
Wagoner,President,Mitt Romney,REP,730311,6,11,191,208,
Wagoner,U.S. House,John Olson,DEM,730311,4,7,57,68,01
Wagoner,U.S. House,Jim Bridenstine,REP,730311,5,7,182,194,01
Wagoner,U.S. House,Craig Allen,IND,730311,1,0,6,7,01
Wagoner,State House,Jerry Shoemake,DEM,730311,5,9,105,119,16
Wagoner,State House,James Delso,REP,730311,4,5,134,143,16
Wagoner,President,Barack Obama,DEM,730312,13,18,235,266,
Wagoner,President,Mitt Romney,REP,730312,19,38,470,527,
Wagoner,U.S. House,John Olson,DEM,730312,11,19,246,276,01
Wagoner,U.S. House,Jim Bridenstine,REP,730312,20,32,421,473,01
Wagoner,U.S. House,Craig Allen,IND,730312,1,4,33,38,01
Wagoner,State House,Wade Rousselot,DEM,730312,21,34,442,497,12
Wagoner,State House,David Tackett,REP,730312,11,22,267,300,12
Wagoner,President,Barack Obama,DEM,730313,3,8,134,145,
Wagoner,President,Mitt Romney,REP,730313,9,19,166,194,
Wagoner,U.S. House,John Olson,DEM,730313,4,9,138,151,01
Wagoner,U.S. House,Jim Bridenstine,REP,730313,6,14,148,168,01
Wagoner,U.S. House,Craig Allen,IND,730313,1,2,11,14,01
Wagoner,State House,Wade Rousselot,DEM,730313,9,16,213,238,12
Wagoner,State House,David Tackett,REP,730313,2,10,88,100,12
Washington,President,Barack Obama,DEM,740011,13,43,205,261,
Washington,President,Mitt Romney,REP,740011,48,106,556,710,
Washington,U.S. House,John Olson,DEM,740011,12,41,216,269,01
Washington,U.S. House,Jim Bridenstine,REP,740011,44,106,521,671,01
Washington,U.S. House,Craig Allen,IND,740011,4,3,21,28,01
Washington,President,Barack Obama,DEM,740012,4,8,69,81,
Washington,President,Mitt Romney,REP,740012,12,26,162,200,
Washington,U.S. House,John Olson,DEM,740012,4,6,70,80,01
Washington,U.S. House,Jim Bridenstine,REP,740012,12,27,151,190,01
Washington,U.S. House,Craig Allen,IND,740012,0,2,10,12,01
Washington,President,Barack Obama,DEM,740013,7,26,233,266,
Washington,President,Mitt Romney,REP,740013,34,79,644,757,
Washington,U.S. House,John Olson,DEM,740013,8,25,217,250,01
Washington,U.S. House,Jim Bridenstine,REP,740013,27,75,615,717,01
Washington,U.S. House,Craig Allen,IND,740013,6,5,44,55,01
Washington,President,Barack Obama,DEM,740015,8,30,230,268,
Washington,President,Mitt Romney,REP,740015,21,105,736,862,
Washington,U.S. House,John Olson,DEM,740015,7,28,212,247,01
Washington,U.S. House,Jim Bridenstine,REP,740015,22,98,708,828,01
Washington,U.S. House,Craig Allen,IND,740015,0,5,42,47,01
Washington,President,Barack Obama,DEM,740022,26,132,307,465,
Washington,President,Mitt Romney,REP,740022,130,400,1355,1885,
Washington,U.S. House,John Olson,DEM,740022,27,128,311,466,01
Washington,U.S. House,Jim Bridenstine,REP,740022,125,391,1317,1833,01
Washington,U.S. House,Craig Allen,IND,740022,3,11,31,45,01
Washington,President,Barack Obama,DEM,740027,5,30,132,167,
Washington,President,Mitt Romney,REP,740027,9,43,273,325,
Washington,U.S. House,John Olson,DEM,740027,1,29,127,157,01
Washington,U.S. House,Jim Bridenstine,REP,740027,9,39,264,312,01
Washington,U.S. House,Craig Allen,IND,740027,4,5,17,26,01
Washington,President,Barack Obama,DEM,740028,15,100,410,525,
Washington,President,Mitt Romney,REP,740028,84,307,1342,1733,
Washington,U.S. House,John Olson,DEM,740028,14,97,405,516,01
Washington,U.S. House,Jim Bridenstine,REP,740028,78,298,1275,1651,01
Washington,U.S. House,Craig Allen,IND,740028,2,12,70,84,01
Washington,President,Barack Obama,DEM,740031,20,103,551,674,
Washington,President,Mitt Romney,REP,740031,51,166,972,1189,
Washington,U.S. House,John Olson,DEM,740031,19,107,509,635,01
Washington,U.S. House,Jim Bridenstine,REP,740031,48,153,920,1121,01
Washington,U.S. House,Craig Allen,IND,740031,4,9,93,106,01
Washington,President,Barack Obama,DEM,740033,6,16,251,273,
Washington,President,Mitt Romney,REP,740033,12,16,283,311,
Washington,U.S. House,John Olson,DEM,740033,5,15,257,277,01
Washington,U.S. House,Jim Bridenstine,REP,740033,9,14,235,258,01
Washington,U.S. House,Craig Allen,IND,740033,4,3,43,50,01
Washington,President,Barack Obama,DEM,740046,1,12,201,214,
Washington,President,Mitt Romney,REP,740046,7,17,337,361,
Washington,U.S. House,John Olson,DEM,740046,1,11,186,198,01
Washington,U.S. House,Jim Bridenstine,REP,740046,7,16,322,345,01
Washington,U.S. House,Craig Allen,IND,740046,0,2,28,30,01
Washington,President,Barack Obama,DEM,740048,14,43,234,291,
Washington,President,Mitt Romney,REP,740048,14,46,456,516,
Washington,U.S. House,John Olson,DEM,740048,12,38,216,266,01
Washington,U.S. House,Jim Bridenstine,REP,740048,15,43,418,476,01
Washington,U.S. House,Craig Allen,IND,740048,1,7,57,65,01
Washington,President,Barack Obama,DEM,740051,16,34,216,266,
Washington,President,Mitt Romney,REP,740051,42,138,801,981,
Washington,U.S. House,John Olson,DEM,740051,16,34,217,267,01
Washington,U.S. House,Jim Bridenstine,REP,740051,40,131,762,933,01
Washington,U.S. House,Craig Allen,IND,740051,1,7,32,40,01
Washington,President,Barack Obama,DEM,740054,16,57,325,398,
Washington,President,Mitt Romney,REP,740054,68,146,1057,1271,
Washington,U.S. House,John Olson,DEM,740054,16,55,323,394,01
Washington,U.S. House,Jim Bridenstine,REP,740054,64,140,1008,1212,01
Washington,U.S. House,Craig Allen,IND,740054,2,8,48,58,01
Washington,President,Barack Obama,DEM,740062,11,7,288,306,
Washington,President,Mitt Romney,REP,740062,31,51,766,848,
Washington,U.S. House,John Olson,DEM,740062,11,11,276,298,01
Washington,U.S. House,Jim Bridenstine,REP,740062,29,43,722,794,01
Washington,U.S. House,Craig Allen,IND,740062,0,2,48,50,01
Washington,President,Barack Obama,DEM,740071,3,10,195,208,
Washington,President,Mitt Romney,REP,740071,16,25,590,631,
Washington,U.S. House,John Olson,DEM,740071,2,7,200,209,01
Washington,U.S. House,Jim Bridenstine,REP,740071,13,25,534,572,01
Washington,U.S. House,Craig Allen,IND,740071,3,3,40,46,01
Washington,President,Barack Obama,DEM,740073,2,7,76,85,
Washington,President,Mitt Romney,REP,740073,6,24,381,411,
Washington,U.S. House,John Olson,DEM,740073,2,7,76,85,01
Washington,U.S. House,Jim Bridenstine,REP,740073,6,24,359,389,01
Washington,U.S. House,Craig Allen,IND,740073,0,0,20,20,01
Washington,President,Barack Obama,DEM,740074,1,3,66,70,
Washington,President,Mitt Romney,REP,740074,13,27,264,304,
Washington,U.S. House,John Olson,DEM,740074,1,3,53,57,01
Washington,U.S. House,Jim Bridenstine,REP,740074,16,27,260,303,01
Washington,U.S. House,Craig Allen,IND,740074,1,0,15,16,01
Washington,President,Barack Obama,DEM,740075,2,12,98,112,
Washington,President,Mitt Romney,REP,740075,21,48,452,521,
Washington,U.S. House,John Olson,DEM,740075,3,13,93,109,01
Washington,U.S. House,Jim Bridenstine,REP,740075,21,44,438,503,01
Washington,U.S. House,Craig Allen,IND,740075,0,2,16,18,01
Washington,President,Barack Obama,DEM,740076,0,22,92,114,
Washington,President,Mitt Romney,REP,740076,20,10,278,308,
Washington,U.S. House,John Olson,DEM,740076,2,23,95,120,01
Washington,U.S. House,Jim Bridenstine,REP,740076,18,8,264,290,01
Washington,U.S. House,Craig Allen,IND,740076,0,1,11,12,01
Washington,President,Barack Obama,DEM,740077,7,5,128,140,
Washington,President,Mitt Romney,REP,740077,10,17,498,525,
Washington,U.S. House,John Olson,DEM,740077,6,6,129,141,01
Washington,U.S. House,Jim Bridenstine,REP,740077,10,16,459,485,01
Washington,U.S. House,Craig Allen,IND,740077,1,0,36,37,01
Washington,President,Barack Obama,DEM,740078,12,2,149,163,
Washington,President,Mitt Romney,REP,740078,8,21,405,434,
Washington,U.S. House,John Olson,DEM,740078,11,2,155,168,01
Washington,U.S. House,Jim Bridenstine,REP,740078,7,20,382,409,01
Washington,U.S. House,Craig Allen,IND,740078,2,1,13,16,01
Washington,President,Barack Obama,DEM,740079,9,7,149,165,
Washington,President,Mitt Romney,REP,740079,6,13,418,437,
Washington,U.S. House,John Olson,DEM,740079,6,8,135,149,01
Washington,U.S. House,Jim Bridenstine,REP,740079,7,12,397,416,01
Washington,U.S. House,Craig Allen,IND,740079,2,0,34,36,01
Washington,President,Barack Obama,DEM,740711,0,2,18,20,
Washington,President,Mitt Romney,REP,740711,3,18,127,148,
Washington,U.S. House,John Olson,DEM,740711,0,1,17,18,01
Washington,U.S. House,Jim Bridenstine,REP,740711,3,17,117,137,01
Washington,U.S. House,Craig Allen,IND,740711,0,1,11,12,01
Washita,President,Barack Obama,DEM,750003,6,0,14,20,
Washita,President,Mitt Romney,REP,750003,14,11,88,113,
Washita,U.S. House,Timothy Ray Murray,DEM,750003,2,0,11,13,03
Washita,U.S. House,Frank Lucas,REP,750003,19,11,89,119,03
Washita,U.S. House,William Sanders,IND,750003,1,0,2,3,03
Washita,President,Barack Obama,DEM,750004,10,38,150,198,
Washita,President,Mitt Romney,REP,750004,31,124,553,708,
Washita,U.S. House,Timothy Ray Murray,DEM,750004,9,25,94,128,03
Washita,U.S. House,Frank Lucas,REP,750004,32,136,576,744,03
Washita,U.S. House,William Sanders,IND,750004,0,2,36,38,03
Washita,President,Barack Obama,DEM,750007,1,0,27,28,
Washita,President,Mitt Romney,REP,750007,10,9,299,318,
Washita,U.S. House,Timothy Ray Murray,DEM,750007,1,0,21,22,03
Washita,U.S. House,Frank Lucas,REP,750007,10,9,292,311,03
Washita,U.S. House,William Sanders,IND,750007,0,0,6,6,03
Washita,President,Barack Obama,DEM,750009,6,3,25,34,
Washita,President,Mitt Romney,REP,750009,2,24,144,170,
Washita,U.S. House,Timothy Ray Murray,DEM,750009,4,1,15,20,03
Washita,U.S. House,Frank Lucas,REP,750009,3,25,143,171,03
Washita,U.S. House,William Sanders,IND,750009,0,1,11,12,03
Washita,President,Barack Obama,DEM,750012,0,3,29,32,
Washita,President,Mitt Romney,REP,750012,9,10,175,194,
Washita,U.S. House,Timothy Ray Murray,DEM,750012,0,3,18,21,03
Washita,U.S. House,Frank Lucas,REP,750012,9,10,182,201,03
Washita,U.S. House,William Sanders,IND,750012,0,0,7,7,03
Washita,President,Barack Obama,DEM,750014,2,2,78,82,
Washita,President,Mitt Romney,REP,750014,6,3,366,375,
Washita,U.S. House,Timothy Ray Murray,DEM,750014,0,0,51,51,03
Washita,U.S. House,Frank Lucas,REP,750014,7,4,378,389,03
Washita,U.S. House,William Sanders,IND,750014,0,1,15,16,03
Washita,President,Barack Obama,DEM,750016,4,6,87,97,
Washita,President,Mitt Romney,REP,750016,30,21,382,433,
Washita,U.S. House,Timothy Ray Murray,DEM,750016,3,5,66,74,03
Washita,U.S. House,Frank Lucas,REP,750016,31,21,384,436,03
Washita,U.S. House,William Sanders,IND,750016,0,1,16,17,03
Washita,President,Barack Obama,DEM,750017,1,2,50,53,
Washita,President,Mitt Romney,REP,750017,1,11,180,192,
Washita,U.S. House,Timothy Ray Murray,DEM,750017,1,2,30,33,03
Washita,U.S. House,Frank Lucas,REP,750017,1,9,190,200,03
Washita,U.S. House,William Sanders,IND,750017,0,0,9,9,03
Washita,President,Barack Obama,DEM,750018,4,8,42,54,
Washita,President,Mitt Romney,REP,750018,16,14,208,238,
Washita,U.S. House,Timothy Ray Murray,DEM,750018,3,3,29,35,03
Washita,U.S. House,Frank Lucas,REP,750018,16,19,214,249,03
Washita,U.S. House,William Sanders,IND,750018,1,0,5,6,03
Washita,President,Barack Obama,DEM,750019,1,4,69,74,
Washita,President,Mitt Romney,REP,750019,18,5,287,310,
Washita,U.S. House,Timothy Ray Murray,DEM,750019,0,3,46,49,03
Washita,U.S. House,Frank Lucas,REP,750019,19,6,303,328,03
Washita,U.S. House,William Sanders,IND,750019,0,0,9,9,03
Washita,President,Barack Obama,DEM,750020,6,3,38,47,
Washita,President,Mitt Romney,REP,750020,3,7,138,148,
Washita,U.S. House,Timothy Ray Murray,DEM,750020,1,1,30,32,03
Washita,U.S. House,Frank Lucas,REP,750020,8,8,145,161,03
Washita,U.S. House,William Sanders,IND,750020,0,1,3,4,03
Washita,President,Barack Obama,DEM,750030,2,17,84,103,
Washita,President,Mitt Romney,REP,750030,17,60,218,295,
Washita,U.S. House,Timothy Ray Murray,DEM,750030,1,8,59,68,03
Washita,U.S. House,Frank Lucas,REP,750030,18,68,236,322,03
Washita,U.S. House,William Sanders,IND,750030,0,1,5,6,03
Woods,President,Barack Obama,DEM,760001,9,61,158,228,
Woods,President,Mitt Romney,REP,760001,27,124,619,770,
Woods,U.S. House,Timothy Ray Murray,DEM,760001,8,45,94,147,03
Woods,U.S. House,Frank Lucas,REP,760001,28,132,643,803,03
Woods,U.S. House,William Sanders,IND,760001,1,7,38,46,03
Woods,State Senate,A. Bryce Marlatt,REP,760001,28,134,635,797,27
Woods,State Senate,Tommy Nicholson,IND,760001,5,45,119,169,27
Woods,President,Barack Obama,DEM,760002,5,8,80,93,
Woods,President,Mitt Romney,REP,760002,17,19,404,440,
Woods,U.S. House,Timothy Ray Murray,DEM,760002,2,6,57,65,03
Woods,U.S. House,Frank Lucas,REP,760002,20,19,406,445,03
Woods,U.S. House,William Sanders,IND,760002,2,1,19,22,03
Woods,State Senate,A. Bryce Marlatt,REP,760002,17,17,362,396,27
Woods,State Senate,Tommy Nicholson,IND,760002,6,7,112,125,27
Woods,President,Barack Obama,DEM,760003,7,15,68,90,
Woods,President,Mitt Romney,REP,760003,20,56,232,308,
Woods,U.S. House,Timothy Ray Murray,DEM,760003,5,12,38,55,03
Woods,U.S. House,Frank Lucas,REP,760003,18,57,246,321,03
Woods,U.S. House,William Sanders,IND,760003,4,1,17,22,03
Woods,State Senate,A. Bryce Marlatt,REP,760003,17,53,240,310,27
Woods,State Senate,Tommy Nicholson,IND,760003,8,13,54,75,27
Woods,President,Barack Obama,DEM,760004,1,1,22,24,
Woods,President,Mitt Romney,REP,760004,2,11,60,73,
Woods,U.S. House,Timothy Ray Murray,DEM,760004,0,2,15,17,03
Woods,U.S. House,Frank Lucas,REP,760004,2,10,64,76,03
Woods,U.S. House,William Sanders,IND,760004,1,0,3,4,03
Woods,State Senate,A. Bryce Marlatt,REP,760004,0,10,57,67,27
Woods,State Senate,Tommy Nicholson,IND,760004,3,2,22,27,27
Woods,President,Barack Obama,DEM,760005,15,38,151,204,
Woods,President,Mitt Romney,REP,760005,37,173,638,848,
Woods,U.S. House,Timothy Ray Murray,DEM,760005,10,32,95,137,03
Woods,U.S. House,Frank Lucas,REP,760005,36,174,659,869,03
Woods,U.S. House,William Sanders,IND,760005,5,6,38,49,03
Woods,State Senate,A. Bryce Marlatt,REP,760005,40,171,639,850,27
Woods,State Senate,Tommy Nicholson,IND,760005,7,29,137,173,27
Woods,President,Barack Obama,DEM,760007,0,2,12,14,
Woods,President,Mitt Romney,REP,760007,3,6,66,75,
Woods,U.S. House,Timothy Ray Murray,DEM,760007,0,2,3,5,03
Woods,U.S. House,Frank Lucas,REP,760007,3,6,75,84,03
Woods,U.S. House,William Sanders,IND,760007,0,0,0,0,03
Woods,State Senate,A. Bryce Marlatt,REP,760007,3,6,69,78,27
Woods,State Senate,Tommy Nicholson,IND,760007,0,1,8,9,27
Woods,President,Barack Obama,DEM,760008,0,0,18,18,
Woods,President,Mitt Romney,REP,760008,10,4,199,213,
Woods,U.S. House,Timothy Ray Murray,DEM,760008,0,0,12,12,03
Woods,U.S. House,Frank Lucas,REP,760008,10,4,196,210,03
Woods,U.S. House,William Sanders,IND,760008,0,0,9,9,03
Woods,State Senate,A. Bryce Marlatt,REP,760008,6,4,191,201,27
Woods,State Senate,Tommy Nicholson,IND,760008,3,0,23,26,27
Woodward,President,Barack Obama,DEM,770101,2,27,129,158,
Woodward,President,Mitt Romney,REP,770101,15,103,466,584,
Woodward,U.S. House,Timothy Ray Murray,DEM,770101,0,12,76,88,03
Woodward,U.S. House,Frank Lucas,REP,770101,17,110,479,606,03
Woodward,U.S. House,William Sanders,IND,770101,0,8,39,47,03
Woodward,State Senate,A. Bryce Marlatt,REP,770101,15,108,478,601,27
Woodward,State Senate,Tommy Nicholson,IND,770101,1,20,94,115,27
Woodward,President,Barack Obama,DEM,770102,1,7,82,90,
Woodward,President,Mitt Romney,REP,770102,10,51,289,350,
Woodward,U.S. House,Timothy Ray Murray,DEM,770102,0,8,47,55,03
Woodward,U.S. House,Frank Lucas,REP,770102,10,47,307,364,03
Woodward,U.S. House,William Sanders,IND,770102,1,3,19,23,03
Woodward,State Senate,A. Bryce Marlatt,REP,770102,10,47,283,340,27
Woodward,State Senate,Tommy Nicholson,IND,770102,1,10,79,90,27
Woodward,President,Barack Obama,DEM,770104,0,0,0,0,
Woodward,President,Mitt Romney,REP,770104,2,1,3,6,
Woodward,U.S. House,Timothy Ray Murray,DEM,770104,0,0,0,0,03
Woodward,U.S. House,Frank Lucas,REP,770104,2,1,3,6,03
Woodward,U.S. House,William Sanders,IND,770104,0,0,0,0,03
Woodward,State Senate,A. Bryce Marlatt,REP,770104,2,1,3,6,27
Woodward,State Senate,Tommy Nicholson,IND,770104,0,0,0,0,27
Woodward,President,Barack Obama,DEM,770105,8,4,108,120,
Woodward,President,Mitt Romney,REP,770105,24,59,624,707,
Woodward,U.S. House,Timothy Ray Murray,DEM,770105,5,4,66,75,03
Woodward,U.S. House,Frank Lucas,REP,770105,26,57,646,729,03
Woodward,U.S. House,William Sanders,IND,770105,1,2,21,24,03
Woodward,State Senate,A. Bryce Marlatt,REP,770105,24,50,600,674,27
Woodward,State Senate,Tommy Nicholson,IND,770105,5,10,121,136,27
Woodward,President,Barack Obama,DEM,770106,0,2,9,11,
Woodward,President,Mitt Romney,REP,770106,12,8,67,87,
Woodward,U.S. House,Timothy Ray Murray,DEM,770106,0,0,7,7,03
Woodward,U.S. House,Frank Lucas,REP,770106,12,10,67,89,03
Woodward,U.S. House,William Sanders,IND,770106,0,0,2,2,03
Woodward,State Senate,A. Bryce Marlatt,REP,770106,12,9,59,80,27
Woodward,State Senate,Tommy Nicholson,IND,770106,0,1,15,16,27
Woodward,President,Barack Obama,DEM,770201,6,27,146,179,
Woodward,President,Mitt Romney,REP,770201,36,138,544,718,
Woodward,U.S. House,Timothy Ray Murray,DEM,770201,1,16,83,100,03
Woodward,U.S. House,Frank Lucas,REP,770201,36,144,574,754,03
Woodward,U.S. House,William Sanders,IND,770201,4,4,30,38,03
Woodward,State Senate,A. Bryce Marlatt,REP,770201,35,144,562,741,27
Woodward,State Senate,Tommy Nicholson,IND,770201,5,20,120,145,27
Woodward,President,Barack Obama,DEM,770202,6,38,167,211,
Woodward,President,Mitt Romney,REP,770202,31,206,834,1071,
Woodward,U.S. House,Timothy Ray Murray,DEM,770202,6,24,101,131,03
Woodward,U.S. House,Frank Lucas,REP,770202,30,212,862,1104,03
Woodward,U.S. House,William Sanders,IND,770202,1,6,32,39,03
Woodward,State Senate,A. Bryce Marlatt,REP,770202,32,205,855,1092,27
Woodward,State Senate,Tommy Nicholson,IND,770202,3,34,123,160,27
Woodward,President,Barack Obama,DEM,770203,0,3,40,43,
Woodward,President,Mitt Romney,REP,770203,13,30,361,404,
Woodward,U.S. House,Timothy Ray Murray,DEM,770203,0,2,19,21,03
Woodward,U.S. House,Frank Lucas,REP,770203,13,30,375,418,03
Woodward,U.S. House,William Sanders,IND,770203,0,1,10,11,03
Woodward,State Senate,A. Bryce Marlatt,REP,770203,12,31,357,400,27
Woodward,State Senate,Tommy Nicholson,IND,770203,1,2,42,45,27
Woodward,President,Barack Obama,DEM,770204,0,3,17,20,
Woodward,President,Mitt Romney,REP,770204,11,18,150,179,
Woodward,U.S. House,Timothy Ray Murray,DEM,770204,0,1,12,13,03
Woodward,U.S. House,Frank Lucas,REP,770204,11,17,151,179,03
Woodward,U.S. House,William Sanders,IND,770204,0,3,4,7,03
Woodward,State Senate,A. Bryce Marlatt,REP,770204,10,18,144,172,27
Woodward,State Senate,Tommy Nicholson,IND,770204,0,3,20,23,27
Woodward,President,Barack Obama,DEM,770301,0,8,34,42,
Woodward,President,Mitt Romney,REP,770301,4,47,137,188,
Woodward,U.S. House,Timothy Ray Murray,DEM,770301,0,5,13,18,03
Woodward,U.S. House,Frank Lucas,REP,770301,4,48,149,201,03
Woodward,U.S. House,William Sanders,IND,770301,0,2,7,9,03
Woodward,State Senate,A. Bryce Marlatt,REP,770301,4,47,142,193,27
Woodward,State Senate,Tommy Nicholson,IND,770301,0,8,22,30,27
Woodward,President,Barack Obama,DEM,770302,0,15,25,40,
Woodward,President,Mitt Romney,REP,770302,12,70,147,229,
Woodward,U.S. House,Timothy Ray Murray,DEM,770302,0,6,14,20,03
Woodward,U.S. House,Frank Lucas,REP,770302,12,77,153,242,03
Woodward,U.S. House,William Sanders,IND,770302,0,2,5,7,03
Woodward,State Senate,A. Bryce Marlatt,REP,770302,12,72,144,228,27
Woodward,State Senate,Tommy Nicholson,IND,770302,0,9,24,33,27
Woodward,President,Barack Obama,DEM,770303,0,0,0,0,
Woodward,President,Mitt Romney,REP,770303,2,0,0,2,
Woodward,U.S. House,Timothy Ray Murray,DEM,770303,0,0,0,0,03
Woodward,U.S. House,Frank Lucas,REP,770303,1,0,0,1,03
Woodward,U.S. House,William Sanders,IND,770303,0,0,0,0,03
Woodward,State Senate,A. Bryce Marlatt,REP,770303,1,0,0,1,27
Woodward,State Senate,Tommy Nicholson,IND,770303,0,0,0,0,27
Woodward,President,Barack Obama,DEM,770304,0,3,28,31,
Woodward,President,Mitt Romney,REP,770304,4,22,143,169,
Woodward,U.S. House,Timothy Ray Murray,DEM,770304,0,1,19,20,03
Woodward,U.S. House,Frank Lucas,REP,770304,4,22,151,177,03
Woodward,U.S. House,William Sanders,IND,770304,0,2,2,4,03
Woodward,State Senate,A. Bryce Marlatt,REP,770304,4,18,145,167,27
Woodward,State Senate,Tommy Nicholson,IND,770304,0,7,26,33,27
Woodward,President,Barack Obama,DEM,770306,9,29,114,152,
Woodward,President,Mitt Romney,REP,770306,48,216,878,1142,
Woodward,U.S. House,Timothy Ray Murray,DEM,770306,4,17,59,80,03
Woodward,U.S. House,Frank Lucas,REP,770306,50,217,887,1154,03
Woodward,U.S. House,William Sanders,IND,770306,2,12,41,55,03
Woodward,State Senate,A. Bryce Marlatt,REP,770306,49,214,866,1129,27
Woodward,State Senate,Tommy Nicholson,IND,770306,6,29,117,152,27
Woodward,President,Barack Obama,DEM,770307,1,1,34,36,
Woodward,President,Mitt Romney,REP,770307,0,8,101,109,
Woodward,U.S. House,Timothy Ray Murray,DEM,770307,0,1,14,15,03
Woodward,U.S. House,Frank Lucas,REP,770307,1,7,115,123,03
Woodward,U.S. House,William Sanders,IND,770307,0,1,8,9,03
Woodward,State Senate,A. Bryce Marlatt,REP,770307,1,8,107,116,27
Woodward,State Senate,Tommy Nicholson,IND,770307,0,0,28,28,27
